team,n,rank,w,d,l,gf,ga,gd,pts
Hibernian,0,1,19,12,5,57,30,27,69
Morton,0,2,17,12,7,58,41,17,63
Falkirk,0,3,16,10,10,58,44,14,58
Dundee Utd,0,4,16,10,10,56,44,12,58
Queen of S't,0,5,12,9,15,47,49,-2,45
Dunfermline,0,6,11,11,14,47,50,-3,44
St Mirren,0,7,9,13,14,41,50,-9,40
Dumbarton,0,8,9,12,15,51,64,-13,39
Raith,0,9,10,8,18,39,57,-18,38
Ayr,0,10,6,13,17,34,59,-25,31
Hibernian,1,1,19,13,4,56,23,33,70
Morton,1,2,19,10,7,55,34,21,67
Falkirk,1,3,16,10,10,57,44,13,58
Dundee Utd,1,4,16,10,10,49,39,10,58
Dunfermline,1,5,12,12,12,48,46,2,48
Queen of S't,1,6,12,11,13,45,46,-1,47
Raith,1,7,9,10,17,37,55,-18,37
Ayr,1,8,8,11,17,33,58,-25,35
Dumbarton,1,9,8,10,18,45,62,-17,34
St Mirren,1,10,7,11,18,38,56,-18,32
Hibernian,2,1,21,11,4,56,23,33,74
Morton,2,2,19,10,7,49,31,18,67
Dundee Utd,2,3,19,8,9,56,35,21,65
Falkirk,2,4,15,11,10,53,39,14,56
Queen of S't,2,5,13,8,15,48,49,-1,47
Dunfermline,2,6,9,14,13,43,46,-3,41
Raith,2,7,9,12,15,33,50,-17,39
Ayr,2,8,8,11,17,31,54,-23,35
Dumbarton,2,9,7,12,17,46,67,-21,33
St Mirren,2,10,6,11,19,36,57,-21,29
Hibernian,3,1,18,13,5,55,27,28,67
Morton,3,2,16,13,7,53,39,14,61
Dundee Utd,3,3,16,10,10,51,42,9,58
Falkirk,3,4,14,11,11,54,43,11,53
Queen of S't,3,5,13,9,14,44,50,-6,48
Raith,3,6,12,9,15,35,44,-9,45
Dunfermline,3,7,9,14,13,47,52,-5,41
Dumbarton,3,8,9,12,15,50,54,-4,39
St Mirren,3,9,9,11,16,42,55,-13,38
Ayr,3,10,6,14,16,34,59,-25,32
Hibernian,4,1,20,12,4,59,27,32,72
Dundee Utd,4,2,17,9,10,50,37,13,60
Falkirk,4,3,15,11,10,53,44,9,56
Morton,4,4,14,13,9,52,42,10,55
Raith,4,5,11,11,14,40,47,-7,44
Queen of S't,4,6,11,10,15,44,49,-5,43
Dunfermline,4,7,10,12,14,47,50,-3,42
St Mirren,4,8,9,11,16,43,56,-13,38
Ayr,4,9,9,11,16,36,61,-25,38
Dumbarton,4,10,8,12,16,49,60,-11,36
Hibernian,5,1,22,10,4,62,25,37,76
Morton,5,2,16,12,8,51,38,13,60
Falkirk,5,3,16,9,11,56,42,14,57
Dundee Utd,5,4,16,9,11,47,39,8,57
Dunfermline,5,5,12,12,12,47,46,1,48
Queen of S't,5,6,12,9,15,41,49,-8,45
Dumbarton,5,7,10,12,14,46,52,-6,42
Raith,5,8,10,8,18,32,49,-17,38
St Mirren,5,9,9,9,18,42,58,-16,36
Ayr,5,10,7,10,19,33,59,-26,31
Hibernian,6,1,21,10,5,59,26,33,73
Dundee Utd,6,2,19,8,9,51,36,15,65
Morton,6,3,18,10,8,51,35,16,64
Falkirk,6,4,16,10,10,58,41,17,58
Queen of S't,6,5,14,9,13,51,47,4,51
Dumbarton,6,6,9,13,14,49,55,-6,40
Ayr,6,7,9,10,17,34,58,-24,37
Dunfermline,6,8,8,11,17,42,56,-14,35
St Mirren,6,9,8,11,17,38,55,-17,35
Raith,6,10,8,8,20,33,57,-24,32
Hibernian,7,1,20,11,5,58,24,34,71
Dundee Utd,7,2,18,8,10,56,39,17,62
Morton,7,3,17,9,10,50,44,6,60
Falkirk,7,4,15,11,10,60,42,18,56
Queen of S't,7,5,15,8,13,55,51,4,53
Raith,7,6,12,8,16,37,50,-13,44
Dunfermline,7,7,8,14,14,42,48,-6,38
Dumbarton,7,8,8,14,14,53,62,-9,38
Ayr,7,9,8,12,16,34,58,-24,36
St Mirren,7,10,6,11,19,34,61,-27,29
Hibernian,8,1,20,12,4,57,25,32,72
Falkirk,8,2,16,11,9,54,37,17,59
Morton,8,3,15,11,10,46,40,6,56
Dundee Utd,8,4,14,11,11,46,40,6,53
Dunfermline,8,5,11,13,12,47,46,1,46
Queen of S't,8,6,12,10,14,46,52,-6,46
Raith,8,7,11,9,16,34,44,-10,42
Dumbarton,8,8,9,12,15,49,57,-8,39
Ayr,8,9,7,15,14,34,52,-18,36
St Mirren,8,10,7,12,17,37,57,-20,33
Hibernian,9,1,17,12,7,56,34,22,63
Dundee Utd,9,2,17,9,10,52,34,18,60
Falkirk,9,3,16,9,11,59,45,14,57
Morton,9,4,13,16,7,44,35,9,55
Queen of S't,9,5,14,9,13,48,46,2,51
Dunfermline,9,6,12,13,11,53,46,7,49
Raith,9,7,10,11,15,37,48,-11,41
St Mirren,9,8,9,10,17,36,57,-21,37
Dumbarton,9,9,8,12,16,44,62,-18,36
Ayr,9,10,8,11,17,33,55,-22,35
Hibernian,10,1,19,14,3,56,27,29,71
Falkirk,10,2,16,12,8,58,40,18,60
Morton,10,3,16,12,8,46,33,13,60
Dundee Utd,10,4,15,12,9,46,36,10,57
Raith,10,5,12,9,15,38,47,-9,45
Queen of S't,10,6,11,8,17,45,52,-7,41
Dunfermline,10,7,8,14,14,39,44,-5,38
St Mirren,10,8,9,10,17,47,54,-7,37
Dumbarton,10,9,9,10,17,46,65,-19,37
Ayr,10,10,8,13,15,34,57,-23,37
Hibernian,11,1,19,14,3,59,21,38,71
Morton,11,2,19,9,8,54,39,15,66
Dundee Utd,11,3,17,8,11,52,38,14,59
Falkirk,11,4,15,10,11,61,46,15,55
Queen of S't,11,5,12,10,14,47,50,-3,46
Dunfermline,11,6,9,13,14,43,50,-7,40
Raith,11,7,10,9,17,36,53,-17,39
Dumbarton,11,8,9,11,16,48,62,-14,38
Ayr,11,9,9,11,16,34,60,-26,38
St Mirren,11,10,9,9,18,42,57,-15,36
Morton,12,1,18,12,6,50,31,19,66
Hibernian,12,2,18,11,7,51,26,25,65
Falkirk,12,3,17,10,9,61,40,21,61
Dundee Utd,12,4,15,9,12,44,38,6,54
Queen of S't,12,5,12,9,15,43,51,-8,45
Dunfermline,12,6,9,15,12,48,49,-1,42
Ayr,12,7,10,12,14,37,51,-14,42
St Mirren,12,8,9,11,16,42,55,-13,38
Dumbarton,12,9,8,12,16,49,64,-15,36
Raith,12,10,9,9,18,37,57,-20,36
Hibernian,13,1,20,12,4,55,23,32,72
Falkirk,13,2,16,11,9,60,39,21,59
Morton,13,3,16,11,9,51,33,18,59
Dundee Utd,13,4,15,12,9,48,39,9,57
Queen of S't,13,5,12,9,15,44,53,-9,45
Dunfermline,13,6,9,14,13,48,54,-6,41
Ayr,13,7,10,11,15,34,51,-17,41
St Mirren,13,8,9,12,15,43,54,-11,39
Raith,13,9,9,9,18,32,54,-22,36
Dumbarton,13,10,7,13,16,48,63,-15,34
Hibernian,14,1,19,11,6,52,25,27,68
Falkirk,14,2,19,10,7,66,38,28,67
Morton,14,3,16,11,9,48,38,10,59
Dundee Utd,14,4,14,10,12,47,42,5,52
Queen of S't,14,5,13,9,14,44,45,-1,48
Dunfermline,14,6,12,11,13,46,46,0,47
Raith,14,7,10,9,17,33,48,-15,39
Ayr,14,8,9,11,16,36,55,-19,38
St Mirren,14,9,9,10,17,40,53,-13,37
Dumbarton,14,10,8,10,18,42,64,-22,34
Hibernian,15,1,18,13,5,53,25,28,67
Morton,15,2,18,12,6,54,33,21,66
Dundee Utd,15,3,16,10,10,48,40,8,58
Falkirk,15,4,14,13,9,56,40,16,55
Queen of S't,15,5,14,10,12,51,47,4,52
Dunfermline,15,6,9,13,14,43,49,-6,40
Raith,15,7,10,9,17,37,57,-20,39
St Mirren,15,8,9,10,17,44,55,-11,37
Dumbarton,15,9,8,12,16,48,62,-14,36
Ayr,15,10,7,12,17,29,55,-26,33
Hibernian,16,1,18,13,5,56,28,28,67
Falkirk,16,2,16,12,8,61,43,18,60
Morton,16,3,15,12,9,47,41,6,57
Dundee Utd,16,4,16,8,12,51,44,7,56
Dunfermline,16,5,13,12,11,59,46,13,51
Queen of S't,16,6,11,10,15,49,54,-5,43
Ayr,16,7,10,10,16,35,55,-20,40
Dumbarton,16,8,9,12,15,48,59,-11,39
Raith,16,9,9,11,16,37,54,-17,38
St Mirren,16,10,8,10,18,42,61,-19,34
Hibernian,17,1,19,12,5,57,31,26,69
Falkirk,17,2,17,11,8,62,43,19,62
Dundee Utd,17,3,17,9,10,51,40,11,60
Morton,17,4,16,10,10,54,40,14,58
Dunfermline,17,5,12,11,13,48,50,-2,47
Queen of S't,17,6,11,9,16,43,47,-4,42
Raith,17,7,10,9,17,34,50,-16,39
Ayr,17,8,9,12,15,35,58,-23,39
St Mirren,17,9,9,10,17,49,57,-8,37
Dumbarton,17,10,8,11,17,49,66,-17,35
Hibernian,18,1,20,12,4,59,22,37,72
Morton,18,2,18,10,8,56,38,18,64
Falkirk,18,3,16,9,11,61,44,17,57
Dundee Utd,18,4,15,9,12,47,39,8,54
Queen of S't,18,5,12,10,14,46,49,-3,46
Ayr,18,6,10,14,12,36,50,-14,44
Dunfermline,18,7,9,13,14,48,55,-7,40
Dumbarton,18,8,8,13,15,45,60,-15,37
Raith,18,9,9,9,18,36,56,-20,36
St Mirren,18,10,8,11,17,37,58,-21,35
Falkirk,19,1,18,9,9,62,37,25,63
Hibernian,19,2,17,12,7,54,29,25,63
Morton,19,3,14,14,8,45,39,6,56
Dundee Utd,19,4,14,11,11,44,39,5,53
Dunfermline,19,5,11,14,11,48,45,3,47
Queen of S't,19,6,12,9,15,45,54,-9,45
Raith,19,7,11,9,16,36,49,-13,42
St Mirren,19,8,10,11,15,43,54,-11,41
Dumbarton,19,9,9,11,16,50,64,-14,38
Ayr,19,10,8,12,16,38,55,-17,36
Hibernian,20,1,20,12,4,54,23,31,72
Dundee Utd,20,2,18,10,8,54,38,16,64
Morton,20,3,17,9,10,49,40,9,60
Falkirk,20,4,14,11,11,58,44,14,53
Queen of S't,20,5,12,9,15,49,53,-4,45
Dunfermline,20,6,10,12,14,48,49,-1,42
Raith,20,7,11,9,16,35,50,-15,42
Ayr,20,8,8,13,15,33,52,-19,37
St Mirren,20,9,9,9,18,41,56,-15,36
Dumbarton,20,10,8,12,16,44,60,-16,36
Hibernian,21,1,18,12,6,50,27,23,66
Falkirk,21,2,17,10,9,55,37,18,61
Dundee Utd,21,3,17,10,9,52,36,16,61
Morton,21,4,16,12,8,46,35,11,60
Queen of S't,21,5,12,9,15,47,52,-5,45
Dunfermline,21,6,9,14,13,43,49,-6,41
Raith,21,7,10,11,15,34,45,-11,41
Dumbarton,21,8,9,12,15,45,55,-10,39
Ayr,21,9,8,12,16,35,54,-19,36
St Mirren,21,10,8,10,18,37,54,-17,34
Hibernian,22,1,19,13,4,57,28,29,70
Falkirk,22,2,17,11,8,61,41,20,62
Morton,22,3,17,11,8,54,39,15,62
Dundee Utd,22,4,15,9,12,47,38,9,54
Queen of S't,22,5,12,11,13,48,49,-1,47
Dunfermline,22,6,11,13,12,52,51,1,46
Raith,22,7,10,10,16,38,50,-12,40
Ayr,22,8,9,11,16,32,53,-21,38
Dumbarton,22,9,7,12,17,47,64,-17,33
St Mirren,22,10,7,11,18,40,63,-23,32
Hibernian,23,1,21,11,4,61,25,36,74
Morton,23,2,17,13,6,54,36,18,64
Falkirk,23,3,16,11,9,62,40,22,59
Dundee Utd,23,4,15,10,11,43,39,4,55
Dunfermline,23,5,11,15,10,49,44,5,48
Queen of S't,23,6,11,9,16,42,54,-12,42
Raith,23,7,10,9,17,38,56,-18,39
St Mirren,23,8,8,12,16,39,56,-17,36
Dumbarton,23,9,7,13,16,43,57,-14,34
Ayr,23,10,7,11,18,33,57,-24,32
Hibernian,24,1,17,15,4,56,30,26,66
Morton,24,2,17,14,5,56,36,20,65
Falkirk,24,3,15,13,8,67,44,23,58
Dundee Utd,24,4,14,12,10,51,43,8,54
Queen of S't,24,5,11,12,13,47,50,-3,45
Dunfermline,24,6,10,13,13,50,54,-4,43
Ayr,24,7,8,14,14,38,56,-18,38
Dumbarton,24,8,8,12,16,48,62,-14,36
St Mirren,24,9,8,12,16,41,57,-16,36
Raith,24,10,9,9,18,38,60,-22,36
Hibernian,25,1,20,12,4,60,26,34,72
Falkirk,25,2,16,12,8,62,46,16,60
Morton,25,3,16,12,8,54,43,11,60
Dundee Utd,25,4,15,13,8,49,38,11,58
Dunfermline,25,5,11,13,12,52,53,-1,46
Queen of S't,25,6,12,8,16,50,55,-5,44
Dumbarton,25,7,10,11,15,48,56,-8,41
Raith,25,8,10,10,16,36,49,-13,40
Ayr,25,9,7,14,15,32,52,-20,35
St Mirren,25,10,6,9,21,38,63,-25,27
Hibernian,26,1,17,13,6,54,28,26,64
Morton,26,2,16,12,8,51,40,11,60
Falkirk,26,3,16,10,10,60,41,19,58
Dundee Utd,26,4,14,11,11,44,41,3,53
Queen of S't,26,5,12,10,14,45,48,-3,46
Raith,26,6,11,11,14,40,47,-7,44
Dunfermline,26,7,9,15,12,45,48,-3,42
Dumbarton,26,8,10,12,14,50,56,-6,42
Ayr,26,9,9,12,15,33,52,-19,39
St Mirren,26,10,8,10,18,35,56,-21,34
Hibernian,27,1,17,14,5,55,28,27,65
Morton,27,2,18,11,7,51,35,16,65
Dundee Utd,27,3,18,8,10,57,42,15,62
Falkirk,27,4,14,10,12,56,44,12,52
Queen of S't,27,5,13,10,13,47,46,1,49
Dunfermline,27,6,10,12,14,44,50,-6,42
Dumbarton,27,7,10,11,15,49,56,-7,41
Raith,27,8,10,9,17,33,50,-17,39
St Mirren,27,9,9,10,17,41,58,-17,37
Ayr,27,10,8,11,17,33,57,-24,35
Hibernian,28,1,19,13,4,53,23,30,70
Morton,28,2,17,12,7,49,35,14,63
Falkirk,28,3,17,9,10,62,41,21,60
Dundee Utd,28,4,16,11,9,52,40,12,59
Raith,28,5,11,10,15,32,44,-12,43
Dunfermline,28,6,10,12,14,46,48,-2,42
Dumbarton,28,7,10,11,15,49,61,-12,41
Queen of S't,28,8,10,9,17,41,54,-13,39
Ayr,28,9,8,11,17,37,59,-22,35
St Mirren,28,10,8,10,18,37,53,-16,34
Hibernian,29,1,18,14,4,50,24,26,68
Dundee Utd,29,2,19,8,9,58,39,19,65
Morton,29,3,16,11,9,51,41,10,59
Falkirk,29,4,16,10,10,60,43,17,58
Queen of S't,29,5,13,9,14,49,48,1,48
Dumbarton,29,6,11,10,15,55,61,-6,43
Dunfermline,29,7,9,13,14,46,54,-8,40
Raith,29,8,9,10,17,36,53,-17,37
Ayr,29,9,8,11,17,32,56,-24,35
St Mirren,29,10,8,10,18,39,57,-18,34
Hibernian,30,1,19,11,6,58,26,32,68
Morton,30,2,18,9,9,48,37,11,63
Dundee Utd,30,3,15,11,10,51,40,11,56
Falkirk,30,4,13,12,11,51,45,6,51
Queen of S't,30,5,12,10,14,48,50,-2,46
Raith,30,6,12,9,15,38,47,-9,45
St Mirren,30,7,10,11,15,45,54,-9,41
Dunfermline,30,8,9,13,14,44,48,-4,40
Ayr,30,9,9,12,15,37,56,-19,39
Dumbarton,30,10,8,12,16,44,61,-17,36
Hibernian,31,1,20,11,5,59,25,34,71
Morton,31,2,17,11,8,54,42,12,62
Dundee Utd,31,3,16,12,8,54,39,15,60
Falkirk,31,4,15,11,10,56,40,16,56
Queen of S't,31,5,11,12,13,46,50,-4,45
Dunfermline,31,6,9,12,15,44,54,-10,39
Dumbarton,31,7,9,12,15,48,60,-12,39
Raith,31,8,10,9,17,35,52,-17,39
Ayr,31,9,9,12,15,34,51,-17,39
St Mirren,31,10,8,10,18,41,58,-17,34
Hibernian,32,1,18,15,3,58,25,33,69
Dundee Utd,32,2,18,8,10,56,45,11,62
Falkirk,32,3,16,11,9,60,44,16,59
Morton,32,4,14,12,10,47,40,7,54
Queen of S't,32,5,12,10,14,47,51,-4,46
Dumbarton,32,6,11,11,14,56,58,-2,44
Ayr,32,7,10,10,16,36,57,-21,40
Raith,32,8,9,11,16,34,49,-15,38
St Mirren,32,9,9,11,16,41,57,-16,38
Dunfermline,32,10,7,13,16,46,55,-9,34
Hibernian,33,1,19,13,4,54,25,29,70
Morton,33,2,19,10,7,56,35,21,67
Falkirk,33,3,16,12,8,60,42,18,60
Dunfermline,33,4,12,14,10,51,45,6,50
Queen of S't,33,5,13,9,14,50,48,2,48
Dundee Utd,33,6,13,9,14,46,46,0,48
Dumbarton,33,7,10,12,14,52,58,-6,42
Ayr,33,8,8,12,16,34,60,-26,36
Raith,33,9,9,8,19,37,57,-20,35
St Mirren,33,10,7,9,20,36,60,-24,30
Hibernian,34,1,22,10,4,58,22,36,76
Falkirk,34,2,17,11,8,61,37,24,62
Dundee Utd,34,3,17,9,10,48,35,13,60
Morton,34,4,16,12,8,51,39,12,60
Queen of S't,34,5,11,10,15,44,51,-7,43
Dunfermline,34,6,9,14,13,44,51,-7,41
Ayr,34,7,9,12,15,32,49,-17,39
St Mirren,34,8,9,9,18,38,57,-19,36
Dumbarton,34,9,8,11,17,43,56,-13,35
Raith,34,10,8,10,18,30,52,-22,34
Hibernian,35,1,20,13,3,62,27,35,73
Morton,35,2,16,11,9,45,36,9,59
Dundee Utd,35,3,16,9,11,49,40,9,57
Falkirk,35,4,14,11,11,58,46,12,53
Raith,35,5,11,11,14,40,47,-7,44
Dunfermline,35,6,10,13,13,45,48,-3,43
Queen of S't,35,7,11,10,15,45,54,-9,43
Dumbarton,35,8,10,10,16,50,59,-9,40
St Mirren,35,9,9,10,17,42,57,-15,37
Ayr,35,10,8,12,16,35,57,-22,36
Hibernian,36,1,20,13,3,58,26,32,73
Morton,36,2,18,10,8,51,34,17,64
Dundee Utd,36,3,16,8,12,49,43,6,56
Falkirk,36,4,14,11,11,57,44,13,53
Queen of S't,36,5,12,11,13,43,46,-3,47
Dumbarton,36,6,10,12,14,46,54,-8,42
Dunfermline,36,7,8,15,13,45,49,-4,39
Raith,36,8,10,9,17,40,53,-13,39
Ayr,36,9,8,12,16,36,58,-22,36
St Mirren,36,10,8,11,17,39,57,-18,35
Hibernian,37,1,19,13,4,61,26,35,70
Falkirk,37,2,16,12,8,62,42,20,60
Morton,37,3,16,11,9,50,40,10,59
Dundee Utd,37,4,15,10,11,49,41,8,55
Dunfermline,37,5,11,12,13,46,49,-3,45
Queen of S't,37,6,11,9,16,51,57,-6,42
Raith,37,7,11,9,16,35,50,-15,42
St Mirren,37,8,9,12,15,46,60,-14,39
Ayr,37,9,9,11,16,38,58,-20,38
Dumbarton,37,10,8,11,17,47,62,-15,35
Hibernian,38,1,19,12,5,59,27,32,69
Morton,38,2,19,9,8,55,38,17,66
Falkirk,38,3,16,13,7,59,40,19,61
Dundee Utd,38,4,15,10,11,56,48,8,55
Queen of S't,38,5,12,11,13,46,50,-4,47
Raith,38,6,10,10,16,33,48,-15,40
Dunfermline,38,7,9,12,15,48,55,-7,39
St Mirren,38,8,9,11,16,42,56,-14,38
Dumbarton,38,9,8,12,16,49,60,-11,36
Ayr,38,10,7,12,17,33,58,-25,33
Hibernian,39,1,20,12,4,58,25,33,72
Morton,39,2,17,12,7,51,33,18,63
Falkirk,39,3,17,10,9,55,37,18,61
Dundee Utd,39,4,15,9,12,44,41,3,54
Queen of S't,39,5,14,9,13,50,47,3,51
Raith,39,6,11,8,17,34,51,-17,41
St Mirren,39,7,9,12,15,44,52,-8,39
Dumbarton,39,8,9,10,17,42,55,-13,37
Dunfermline,39,9,8,12,16,43,49,-6,36
Ayr,39,10,8,10,18,30,61,-31,34
Hibernian,40,1,18,13,5,55,26,29,67
Falkirk,40,2,17,9,10,61,45,16,60
Dundee Utd,40,3,17,8,11,53,38,15,59
Morton,40,4,16,11,9,49,40,9,59
Dunfermline,40,5,12,11,13,49,47,2,47
Queen of S't,40,6,12,9,15,48,52,-4,45
Raith,40,7,11,9,16,41,52,-11,42
Ayr,40,8,10,11,15,37,56,-19,41
St Mirren,40,9,9,9,18,36,56,-20,36
Dumbarton,40,10,8,10,18,46,63,-17,34
Hibernian,41,1,21,11,4,57,24,33,74
Morton,41,2,20,10,6,51,34,17,70
Falkirk,41,3,16,12,8,57,37,20,60
Dundee Utd,41,4,17,9,10,52,35,17,60
Raith,41,5,11,9,16,35,46,-11,42
Queen of S't,41,6,11,8,17,42,49,-7,41
Dumbarton,41,7,10,11,15,48,56,-8,41
Dunfermline,41,8,9,12,15,40,49,-9,39
Ayr,41,9,7,12,17,29,55,-26,33
St Mirren,41,10,6,10,20,34,60,-26,28
Hibernian,42,1,18,14,4,52,24,28,68
Falkirk,42,2,17,10,9,61,41,20,61
Dundee Utd,42,3,16,9,11,48,40,8,57
Morton,42,4,14,14,8,49,40,9,56
Queen of S't,42,5,12,12,12,48,48,0,48
Dumbarton,42,6,12,11,13,55,55,0,47
Dunfermline,42,7,9,15,12,46,49,-3,42
St Mirren,42,8,9,10,17,40,53,-13,37
Raith,42,9,8,10,18,31,52,-21,34
Ayr,42,10,6,13,17,33,61,-28,31
Hibernian,43,1,18,12,6,54,29,25,66
Morton,43,2,17,12,7,53,36,17,63
Falkirk,43,3,16,9,11,58,42,16,57
Dundee Utd,43,4,16,9,11,47,35,12,57
Queen of S't,43,5,16,8,12,51,43,8,56
Dunfermline,43,6,10,12,14,46,54,-8,42
St Mirren,43,7,11,9,16,43,55,-12,42
Dumbarton,43,8,9,12,15,45,56,-11,39
Raith,43,9,8,10,18,33,54,-21,34
Ayr,43,10,6,13,17,29,55,-26,31
Hibernian,44,1,20,11,5,54,25,29,71
Morton,44,2,18,11,7,51,36,15,65
Falkirk,44,3,16,11,9,57,36,21,59
Dundee Utd,44,4,15,10,11,53,44,9,55
Dunfermline,44,5,11,13,12,49,46,3,46
Ayr,44,6,11,11,14,38,52,-14,44
Queen of S't,44,7,11,10,15,43,51,-8,43
St Mirren,44,8,8,11,17,36,56,-20,35
Raith,44,9,8,10,18,33,53,-20,34
Dumbarton,44,10,7,12,17,45,60,-15,33
Hibernian,45,1,21,11,4,60,22,38,74
Morton,45,2,17,12,7,53,37,16,63
Dundee Utd,45,3,17,10,9,52,40,12,61
Falkirk,45,4,16,11,9,56,42,14,59
Raith,45,5,12,11,13,38,43,-5,47
Dumbarton,45,6,10,11,15,48,56,-8,41
Dunfermline,45,7,9,11,16,49,55,-6,38
Queen of S't,45,8,10,8,18,43,55,-12,38
St Mirren,45,9,8,11,17,35,56,-21,35
Ayr,45,10,6,12,18,30,58,-28,30
Hibernian,46,1,20,11,5,55,24,31,71
Morton,46,2,20,10,6,51,32,19,70
Falkirk,46,3,14,11,11,56,45,11,53
Dundee Utd,46,4,14,11,11,48,41,7,53
Queen of S't,46,5,13,8,15,49,52,-3,47
Raith,46,6,12,8,16,35,46,-11,44
Ayr,46,7,11,11,14,37,51,-14,44
Dunfermline,46,8,9,11,16,42,50,-8,38
Dumbarton,46,9,9,11,16,48,59,-11,38
St Mirren,46,10,6,12,18,34,55,-21,30
Hibernian,47,1,18,12,6,54,27,27,66
Morton,47,2,18,10,8,52,38,14,64
Dundee Utd,47,3,18,8,10,55,39,16,62
Falkirk,47,4,16,9,11,60,47,13,57
Dunfermline,47,5,12,12,12,50,47,3,48
Queen of S't,47,6,11,12,13,49,53,-4,45
Raith,47,7,10,10,16,38,53,-15,40
Dumbarton,47,8,9,12,15,49,61,-12,39
St Mirren,47,9,8,10,18,42,59,-17,34
Ayr,47,10,6,13,17,36,61,-25,31
Hibernian,48,1,19,12,5,56,27,29,69
Morton,48,2,17,11,8,49,35,14,62
Dundee Utd,48,3,17,9,10,54,38,16,60
Falkirk,48,4,14,10,12,53,41,12,52
Queen of S't,48,5,12,10,14,50,49,1,46
Dumbarton,48,6,12,10,14,55,58,-3,46
St Mirren,48,7,10,10,16,41,56,-15,40
Raith,48,8,10,9,17,35,53,-18,39
Dunfermline,48,9,8,13,15,41,55,-14,37
Ayr,48,10,8,12,16,36,58,-22,36
Hibernian,49,1,21,12,3,55,23,32,75
Falkirk,49,2,16,10,10,58,44,14,58
Dundee Utd,49,3,16,9,11,51,41,10,57
Morton,49,4,15,12,9,48,38,10,57
Queen of S't,49,5,12,9,15,46,48,-2,45
Dumbarton,49,6,10,11,15,49,57,-8,41
Raith,49,7,11,8,17,34,50,-16,41
St Mirren,49,8,10,10,16,41,51,-10,40
Dunfermline,49,9,9,12,15,44,51,-7,39
Ayr,49,10,8,11,17,35,58,-23,35
Hibernian,50,1,20,11,5,56,26,30,71
Dundee Utd,50,2,18,9,9,55,36,19,63
Morton,50,3,17,11,8,50,35,15,62
Falkirk,50,4,15,10,11,56,44,12,55
Queen of S't,50,5,13,9,14,51,48,3,48
St Mirren,50,6,12,9,15,43,52,-9,45
Dunfermline,50,7,9,12,15,43,57,-14,39
Raith,50,8,9,10,17,31,47,-16,37
Ayr,50,9,7,14,15,31,54,-23,35
Dumbarton,50,10,7,11,18,44,61,-17,32
Hibernian,51,1,21,11,4,60,24,36,74
Falkirk,51,2,18,10,8,65,41,24,64
Dundee Utd,51,3,17,9,10,52,35,17,60
Morton,51,4,15,11,10,49,41,8,56
Queen of S't,51,5,10,12,14,46,55,-9,42
Dumbarton,51,6,9,13,14,49,59,-10,40
Raith,51,7,10,9,17,37,55,-18,39
Dunfermline,51,8,8,14,14,41,50,-9,38
St Mirren,51,9,9,10,17,39,56,-17,37
Ayr,51,10,7,13,16,30,52,-22,34
Hibernian,52,1,20,11,5,60,26,34,71
Morton,52,2,17,11,8,47,39,8,62
Falkirk,52,3,17,9,10,55,42,13,60
Dundee Utd,52,4,16,11,9,51,39,12,59
Queen of S't,52,5,11,10,15,46,53,-7,43
Raith,52,6,11,10,15,38,50,-12,43
Dunfermline,52,7,10,12,14,49,50,-1,42
Ayr,52,8,9,13,14,38,55,-17,40
St Mirren,52,9,7,12,17,42,57,-15,33
Dumbarton,52,10,7,11,18,42,57,-15,32
Hibernian,53,1,20,12,4,58,25,33,72
Dundee Utd,53,2,16,12,8,55,39,16,60
Morton,53,3,15,14,7,52,39,13,59
Falkirk,53,4,15,12,9,56,38,18,57
Dunfermline,53,5,10,15,11,44,43,1,45
Raith,53,6,11,10,15,36,47,-11,43
Queen of S't,53,7,11,9,16,44,54,-10,42
Dumbarton,53,8,8,13,15,46,60,-14,37
St Mirren,53,9,7,12,17,37,56,-19,33
Ayr,53,10,7,11,18,32,59,-27,32
Hibernian,54,1,21,11,4,57,24,33,74
Dundee Utd,54,2,17,11,8,53,36,17,62
Morton,54,3,17,11,8,49,35,14,62
Falkirk,54,4,16,9,11,62,43,19,57
Dunfermline,54,5,10,13,13,44,47,-3,43
Queen of S't,54,6,10,11,15,43,51,-8,41
Raith,54,7,11,8,17,37,52,-15,41
Ayr,54,8,10,10,16,39,55,-16,40
St Mirren,54,9,8,10,18,39,58,-19,34
Dumbarton,54,10,7,12,17,44,66,-22,33
Hibernian,55,1,19,11,6,60,26,34,68
Morton,55,2,18,10,8,54,40,14,64
Dundee Utd,55,3,15,10,11,49,45,4,55
Falkirk,55,4,14,11,11,56,44,12,53
Queen of S't,55,5,13,10,13,48,47,1,49
Raith,55,6,11,9,16,38,47,-9,42
Dunfermline,55,7,9,14,13,41,47,-6,41
Dumbarton,55,8,9,13,14,53,59,-6,40
St Mirren,55,9,10,9,17,38,58,-20,39
Ayr,55,10,8,11,17,32,56,-24,35
Hibernian,56,1,21,12,3,57,20,37,75
Falkirk,56,2,17,10,9,63,38,25,61
Morton,56,3,16,13,7,52,34,18,61
Dundee Utd,56,4,14,12,10,49,40,9,54
Queen of S't,56,5,11,11,14,46,53,-7,44
Dunfermline,56,6,9,15,12,45,48,-3,42
Dumbarton,56,7,9,10,17,46,61,-15,37
Raith,56,8,9,10,17,33,48,-15,37
Ayr,56,9,8,12,16,32,55,-23,36
St Mirren,56,10,9,9,18,38,64,-26,36
Hibernian,57,1,18,13,5,58,28,30,67
Morton,57,2,17,9,10,47,42,5,60
Dundee Utd,57,3,16,10,10,57,42,15,58
Falkirk,57,4,15,12,9,57,43,14,57
Dunfermline,57,5,11,13,12,55,49,6,46
Dumbarton,57,6,11,12,13,50,56,-6,45
Raith,57,7,12,9,15,38,47,-9,45
Queen of S't,57,8,10,8,18,44,54,-10,38
Ayr,57,9,9,11,16,36,55,-19,38
St Mirren,57,10,8,9,19,40,66,-26,33
Hibernian,58,1,21,10,5,56,28,28,73
Falkirk,58,2,16,11,9,56,40,16,59
Dundee Utd,58,3,16,10,10,51,41,10,58
Morton,58,4,15,11,10,49,37,12,56
Dunfermline,58,5,13,12,11,52,47,5,51
Ayr,58,6,11,10,15,40,56,-16,43
Dumbarton,58,7,10,12,14,49,56,-7,42
Queen of S't,58,8,11,8,17,44,54,-10,41
St Mirren,58,9,8,9,19,41,60,-19,33
Raith,58,10,8,9,19,36,55,-19,33
Hibernian,59,1,20,12,4,53,24,29,72
Morton,59,2,16,12,8,58,40,18,60
Falkirk,59,3,16,9,11,61,43,18,57
Dundee Utd,59,4,14,13,9,48,39,9,55
Queen of S't,59,5,12,11,13,52,48,4,47
Dunfermline,59,6,11,12,13,45,53,-8,45
Raith,59,7,10,10,16,32,46,-14,40
Ayr,59,8,8,14,14,32,50,-18,38
Dumbarton,59,9,8,12,16,46,62,-16,36
St Mirren,59,10,8,9,19,39,61,-22,33
Hibernian,60,1,20,13,3,58,24,34,73
Morton,60,2,17,10,9,52,38,14,61
Dundee Utd,60,3,16,10,10,52,39,13,58
Falkirk,60,4,15,12,9,54,36,18,57
Queen of S't,60,5,11,10,15,44,57,-13,43
Dumbarton,60,6,9,12,15,45,56,-11,39
St Mirren,60,7,9,11,16,43,55,-12,38
Raith,60,8,9,11,16,34,52,-18,38
Ayr,60,9,8,14,14,36,55,-19,38
Dunfermline,60,10,8,13,15,44,50,-6,37
Hibernian,61,1,18,12,6,55,29,26,66
Morton,61,2,17,12,7,49,36,13,63
Falkirk,61,3,16,9,11,57,45,12,57
Dundee Utd,61,4,14,8,14,47,45,2,50
Dumbarton,61,5,12,12,12,53,54,-1,48
Queen of S't,61,6,13,8,15,45,50,-5,47
Dunfermline,61,7,11,13,12,48,46,2,46
Raith,61,8,9,11,16,34,47,-13,38
Ayr,61,9,9,11,16,36,52,-16,38
St Mirren,61,10,8,10,18,38,58,-20,34
Hibernian,62,1,21,11,4,56,24,32,74
Morton,62,2,18,11,7,53,38,15,65
Falkirk,62,3,16,10,10,57,42,15,58
Dundee Utd,62,4,16,9,11,54,40,14,57
Dunfermline,62,5,12,11,13,49,43,6,47
Queen of S't,62,6,10,10,16,40,51,-11,40
Ayr,62,7,9,12,15,38,55,-17,39
Dumbarton,62,8,9,11,16,46,59,-13,38
St Mirren,62,9,9,9,18,44,62,-18,36
Raith,62,10,8,10,18,32,55,-23,34
Hibernian,63,1,18,13,5,52,26,26,67
Morton,63,2,17,11,8,46,31,15,62
Dundee Utd,63,3,16,9,11,50,41,9,57
Falkirk,63,4,14,11,11,52,40,12,53
Queen of S't,63,5,13,9,14,48,47,1,48
Dumbarton,63,6,11,11,14,48,52,-4,44
Dunfermline,63,7,10,12,14,45,50,-5,42
Ayr,63,8,9,12,15,38,55,-17,39
Raith,63,9,9,10,17,33,54,-21,37
St Mirren,63,10,7,14,15,37,53,-16,35
Hibernian,64,1,19,12,5,55,24,31,69
Dundee Utd,64,2,18,8,10,51,37,14,62
Morton,64,3,16,11,9,52,40,12,59
Falkirk,64,4,15,10,11,56,45,11,55
Queen of S't,64,5,12,9,15,48,50,-2,45
Dumbarton,64,6,11,11,14,54,57,-3,44
Raith,64,7,11,10,15,37,48,-11,43
St Mirren,64,8,10,11,15,41,53,-12,41
Ayr,64,9,9,11,16,35,54,-19,38
Dunfermline,64,10,7,11,18,41,62,-21,32
Hibernian,65,1,21,11,4,60,27,33,74
Falkirk,65,2,17,11,8,57,36,21,62
Morton,65,3,17,10,9,53,40,13,61
Dundee Utd,65,4,14,10,12,47,43,4,52
Ayr,65,5,11,11,14,37,52,-15,44
Raith,65,6,11,10,15,35,47,-12,43
Dunfermline,65,7,9,14,13,46,50,-4,41
Queen of S't,65,8,10,10,16,42,50,-8,40
Dumbarton,65,9,9,12,15,50,60,-10,39
St Mirren,65,10,7,9,20,38,60,-22,30
Hibernian,66,1,18,14,4,53,24,29,68
Morton,66,2,18,12,6,49,29,20,66
Dundee Utd,66,3,16,10,10,48,37,11,58
Falkirk,66,4,14,9,13,52,45,7,51
Dunfermline,66,5,11,14,11,45,43,2,47
Raith,66,6,11,11,14,39,46,-7,44
Dumbarton,66,7,10,11,15,48,61,-13,41
Queen of S't,66,8,10,10,16,46,55,-9,40
Ayr,66,9,7,13,16,38,58,-20,34
St Mirren,66,10,7,12,17,38,58,-20,33
Hibernian,67,1,19,12,5,56,26,30,69
Morton,67,2,16,13,7,56,41,15,61
Dundee Utd,67,3,17,9,10,55,38,17,60
Falkirk,67,4,15,10,11,55,44,11,55
Queen of S't,67,5,12,9,15,47,50,-3,45
Dumbarton,67,6,10,12,14,50,57,-7,42
Dunfermline,67,7,9,12,15,41,54,-13,39
Raith,67,8,10,9,17,38,51,-13,39
Ayr,67,9,9,11,16,36,59,-23,38
St Mirren,67,10,8,13,15,40,54,-14,37
Hibernian,68,1,19,13,4,60,24,36,70
Morton,68,2,17,12,7,53,34,19,63
Dundee Utd,68,3,16,11,9,50,40,10,59
Falkirk,68,4,15,13,8,60,43,17,58
Queen of S't,68,5,11,9,16,41,50,-9,42
Raith,68,6,11,9,16,38,51,-13,42
Dunfermline,68,7,9,14,13,47,51,-4,41
Dumbarton,68,8,8,14,14,50,60,-10,38
Ayr,68,9,7,13,16,31,53,-22,34
St Mirren,68,10,7,12,17,40,64,-24,33
Hibernian,69,1,19,14,3,63,26,37,71
Dundee Utd,69,2,20,8,8,56,35,21,68
Morton,69,3,18,10,8,54,37,17,64
Falkirk,69,4,16,12,8,58,37,21,60
Raith,69,5,11,9,16,36,51,-15,42
Queen of S't,69,6,10,10,16,42,56,-14,40
Dumbarton,69,7,9,11,16,45,58,-13,38
St Mirren,69,8,9,10,17,36,52,-16,37
Dunfermline,69,9,7,14,15,42,53,-11,35
Ayr,69,10,7,10,19,32,59,-27,31
Hibernian,70,1,19,12,5,62,28,34,69
Morton,70,2,19,11,6,61,38,23,68
Falkirk,70,3,15,11,10,58,44,14,56
Dundee Utd,70,4,14,10,12,53,47,6,52
Queen of S't,70,5,13,10,13,50,50,0,49
Dunfermline,70,6,11,11,14,46,49,-3,44
Raith,70,7,10,11,15,35,49,-14,41
Dumbarton,70,8,9,12,15,46,58,-12,39
Ayr,70,9,8,12,16,35,58,-23,36
St Mirren,70,10,7,10,19,37,62,-25,31
Hibernian,71,1,19,11,6,53,29,24,68
Falkirk,71,2,17,11,8,64,41,23,62
Dundee Utd,71,3,16,10,10,52,41,11,58
Morton,71,4,16,10,10,48,38,10,58
Dunfermline,71,5,10,14,12,48,48,0,44
Queen of S't,71,6,11,9,16,45,53,-8,42
Raith,71,7,11,9,16,38,50,-12,42
Ayr,71,8,10,11,15,35,52,-17,41
Dumbarton,71,9,8,12,16,49,62,-13,36
St Mirren,71,10,9,9,18,39,57,-18,36
Hibernian,72,1,18,12,6,54,28,26,66
Dundee Utd,72,2,17,9,10,56,41,15,60
Falkirk,72,3,16,11,9,55,38,17,59
Morton,72,4,15,13,8,51,38,13,58
Dunfermline,72,5,11,13,12,47,49,-2,46
Queen of S't,72,6,12,9,15,46,52,-6,45
Ayr,72,7,9,12,15,35,56,-21,39
Raith,72,8,9,11,16,33,45,-12,38
St Mirren,72,9,8,12,16,42,56,-14,36
Dumbarton,72,10,7,14,15,51,67,-16,35
Hibernian,73,1,19,10,7,53,27,26,67
Morton,73,2,18,9,9,48,37,11,63
Falkirk,73,3,17,10,9,60,39,21,61
Dundee Utd,73,4,17,10,9,53,39,14,61
Queen of S't,73,5,12,9,15,43,50,-7,45
Dumbarton,73,6,11,11,14,51,57,-6,44
Dunfermline,73,7,10,13,13,45,45,0,43
Raith,73,8,10,8,18,36,53,-17,38
Ayr,73,9,8,12,16,38,58,-20,36
St Mirren,73,10,7,10,19,37,59,-22,31
Hibernian,74,1,17,12,7,49,25,24,63
Morton,74,2,17,12,7,55,38,17,63
Falkirk,74,3,16,10,10,56,41,15,58
Dundee Utd,74,4,16,10,10,52,39,13,58
Dunfermline,74,5,10,15,11,49,48,1,45
Raith,74,6,12,9,15,39,46,-7,45
Queen of S't,74,7,12,8,16,46,51,-5,44
Ayr,74,8,8,13,15,30,55,-25,37
Dumbarton,74,9,7,14,15,45,61,-16,35
St Mirren,74,10,8,11,17,39,56,-17,35
Hibernian,75,1,18,12,6,54,25,29,66
Falkirk,75,2,17,11,8,58,39,19,62
Morton,75,3,16,11,9,48,36,12,59
Dundee Utd,75,4,15,10,11,47,40,7,55
Dunfermline,75,5,11,12,13,44,48,-4,45
Dumbarton,75,6,10,12,14,52,55,-3,42
Raith,75,7,10,11,15,35,45,-10,41
Queen of S't,75,8,9,11,16,47,59,-12,38
St Mirren,75,9,9,11,16,40,57,-17,38
Ayr,75,10,8,13,15,38,59,-21,37
Hibernian,76,1,19,12,5,56,25,31,69
Morton,76,2,18,12,6,56,33,23,66
Dundee Utd,76,3,19,8,9,67,44,23,65
Falkirk,76,4,15,9,12,53,43,10,54
Dumbarton,76,5,11,10,15,50,55,-5,43
Queen of S't,76,6,11,10,15,45,57,-12,43
Dunfermline,76,7,10,12,14,44,53,-9,42
Raith,76,8,10,10,16,36,47,-11,40
St Mirren,76,9,8,9,19,39,62,-23,33
Ayr,76,10,7,12,17,32,59,-27,33
Hibernian,77,1,19,12,5,55,27,28,69
Morton,77,2,19,10,7,57,33,24,67
Dundee Utd,77,3,17,10,9,53,39,14,61
Falkirk,77,4,15,12,9,56,41,15,57
Queen of S't,77,5,13,9,14,45,49,-4,48
Raith,77,6,11,8,17,34,46,-12,41
Dumbarton,77,7,9,12,15,50,58,-8,39
Dunfermline,77,8,9,12,15,43,51,-8,39
Ayr,77,9,7,12,17,32,59,-27,33
St Mirren,77,10,7,11,18,36,58,-22,32
Hibernian,78,1,19,11,6,53,25,28,68
Morton,78,2,18,13,5,50,32,18,67
Queen of S't,78,3,15,9,12,51,48,3,54
Falkirk,78,4,14,10,12,55,45,10,52
Dundee Utd,78,5,14,10,12,45,38,7,52
Dunfermline,78,6,10,13,13,47,47,0,43
Dumbarton,78,7,10,12,14,49,57,-8,42
Ayr,78,8,9,11,16,34,54,-20,38
Raith,78,9,8,12,16,34,50,-16,36
St Mirren,78,10,7,11,18,35,57,-22,32
Hibernian,79,1,18,13,5,55,30,25,67
Morton,79,2,18,11,7,53,33,20,65
Dundee Utd,79,3,16,9,11,52,42,10,57
Falkirk,79,4,14,10,12,55,47,8,52
Raith,79,5,11,11,14,37,46,-9,44
Dunfermline,79,6,10,13,13,48,51,-3,43
Queen of S't,79,7,11,10,15,46,52,-6,43
Dumbarton,79,8,10,11,15,47,56,-9,41
St Mirren,79,9,9,10,17,40,54,-14,37
Ayr,79,10,8,12,16,36,58,-22,36
Hibernian,80,1,20,10,6,56,25,31,70
Morton,80,2,18,12,6,52,36,16,66
Falkirk,80,3,16,10,10,64,43,21,58
Dundee Utd,80,4,15,9,12,50,42,8,54
Queen of S't,80,5,13,9,14,46,51,-5,48
Ayr,80,6,10,11,15,37,55,-18,41
Dunfermline,80,7,9,13,14,44,51,-7,40
Dumbarton,80,8,9,13,14,50,60,-10,40
Raith,80,9,9,11,16,34,48,-14,38
St Mirren,80,10,6,12,18,38,60,-22,30
Hibernian,81,1,20,11,5,60,25,35,71
Morton,81,2,16,11,9,48,36,12,59
Dundee Utd,81,3,15,11,10,48,37,11,56
Falkirk,81,4,14,11,11,51,40,11,53
Queen of S't,81,5,13,9,14,42,48,-6,48
Dumbarton,81,6,11,11,14,47,53,-6,44
Dunfermline,81,7,9,15,12,43,46,-3,42
Ayr,81,8,9,12,15,35,56,-21,39
Raith,81,9,9,11,16,34,48,-14,38
St Mirren,81,10,8,10,18,41,60,-19,34
Hibernian,82,1,19,10,7,54,26,28,67
Morton,82,2,18,9,9,51,33,18,63
Dundee Utd,82,3,18,8,10,58,43,15,62
Falkirk,82,4,17,10,9,57,41,16,61
Raith,82,5,12,9,15,37,46,-9,45
Dunfermline,82,6,11,11,14,43,45,-2,44
Dumbarton,82,7,11,11,14,49,53,-4,44
Queen of S't,82,8,10,8,18,44,55,-11,38
Ayr,82,9,8,11,17,31,57,-26,35
St Mirren,82,10,7,11,18,35,60,-25,32
Hibernian,83,1,21,12,3,59,24,35,75
Falkirk,83,2,17,9,10,57,42,15,60
Morton,83,3,14,14,8,50,39,11,56
Dundee Utd,83,4,14,12,10,52,42,10,54
Queen of S't,83,5,12,11,13,43,44,-1,47
St Mirren,83,6,11,9,16,46,56,-10,42
Dunfermline,83,7,9,13,14,43,49,-6,40
Raith,83,8,10,10,16,35,50,-15,40
Dumbarton,83,9,8,11,17,44,61,-17,35
Ayr,83,10,6,15,15,31,53,-22,33
Hibernian,84,1,22,10,4,59,22,37,76
Falkirk,84,2,19,9,8,61,36,25,66
Morton,84,3,16,10,10,49,37,12,58
Dundee Utd,84,4,15,10,11,49,41,8,55
Dunfermline,84,5,10,14,12,46,48,-2,44
Queen of S't,84,6,10,10,16,41,52,-11,40
Raith,84,7,10,9,17,33,50,-17,39
Ayr,84,8,9,12,15,35,54,-19,39
Dumbarton,84,9,8,13,15,42,52,-10,37
St Mirren,84,10,7,11,18,39,62,-23,32
Hibernian,85,1,19,12,5,57,28,29,69
Morton,85,2,17,11,8,47,33,14,62
Falkirk,85,3,16,10,10,59,39,20,58
Dundee Utd,85,4,16,9,11,48,42,6,57
Raith,85,5,13,8,15,39,51,-12,47
Dunfermline,85,6,10,13,13,46,50,-4,43
Queen of S't,85,6,11,10,15,46,50,-4,43
Dumbarton,85,8,8,13,15,44,56,-12,37
St Mirren,85,9,9,10,17,41,54,-13,37
Ayr,85,10,7,12,17,34,58,-24,33
Hibernian,86,1,19,11,6,56,30,26,68
Morton,86,2,19,10,7,53,32,21,67
Falkirk,86,3,17,10,9,55,36,19,61
Dundee Utd,86,4,17,9,10,58,36,22,60
Dunfermline,86,5,11,12,13,45,48,-3,45
Queen of S't,86,6,11,10,15,42,52,-10,43
Dumbarton,86,7,9,13,14,46,56,-10,40
Ayr,86,8,9,11,16,36,59,-23,38
Raith,86,9,9,9,18,34,50,-16,36
St Mirren,86,10,7,9,20,34,60,-26,30
Hibernian,87,1,18,11,7,54,27,27,65
Falkirk,87,2,17,11,8,63,41,22,62
Morton,87,3,15,11,10,49,43,6,56
Dundee Utd,87,4,14,12,10,50,42,8,54
Raith,87,5,13,9,14,44,50,-6,48
Dunfermline,87,6,11,12,13,53,51,2,45
Queen of S't,87,7,12,9,15,46,55,-9,45
Dumbarton,87,8,10,12,14,47,55,-8,42
Ayr,87,9,7,14,15,35,56,-21,35
St Mirren,87,10,8,9,19,36,57,-21,33
Hibernian,88,1,19,14,3,55,24,31,71
Morton,88,2,18,12,6,50,32,18,66
Dundee Utd,88,3,18,8,10,53,38,15,62
Falkirk,88,4,14,12,10,57,44,13,54
Queen of S't,88,5,13,8,15,45,47,-2,47
Raith,88,6,10,12,14,32,45,-13,42
Dunfermline,88,7,9,13,14,45,47,-2,40
St Mirren,88,8,8,11,17,41,57,-16,35
Dumbarton,88,9,7,12,17,47,65,-18,33
Ayr,88,10,7,12,17,32,58,-26,33
Hibernian,89,1,18,13,5,50,23,27,67
Dundee Utd,89,2,17,11,8,51,39,12,62
Falkirk,89,3,16,12,8,59,37,22,60
Morton,89,4,16,12,8,47,39,8,60
Raith,89,5,11,10,15,35,45,-10,43
Queen of S't,89,6,11,8,17,41,52,-11,41
Dunfermline,89,7,9,13,14,47,51,-4,40
Ayr,89,8,9,12,15,33,51,-18,39
Dumbarton,89,9,9,11,16,53,59,-6,38
St Mirren,89,10,8,10,18,38,58,-20,34
Hibernian,90,1,18,11,7,53,31,22,65
Falkirk,90,2,18,9,9,66,38,28,63
Morton,90,3,17,10,9,52,38,14,61
Dundee Utd,90,4,16,8,12,48,42,6,56
St Mirren,90,5,11,10,15,43,52,-9,43
Dunfermline,90,6,9,15,12,44,49,-5,42
Queen of S't,90,7,11,9,16,42,52,-10,42
Ayr,90,8,10,10,16,33,54,-21,40
Dumbarton,90,9,9,12,15,49,57,-8,39
Raith,90,10,9,10,17,38,55,-17,37
Hibernian,91,1,20,10,6,56,27,29,70
Dundee Utd,91,2,18,9,9,59,45,14,63
Morton,91,3,17,11,8,54,39,15,62
Falkirk,91,4,15,10,11,59,43,16,55
Queen of S't,91,5,13,9,14,51,50,1,48
Dunfermline,91,6,11,11,14,49,54,-5,44
Raith,91,7,11,10,15,36,50,-14,43
Ayr,91,8,8,12,16,40,62,-22,36
Dumbarton,91,9,8,11,17,45,61,-16,35
St Mirren,91,10,7,11,18,42,60,-18,32
Hibernian,92,1,19,11,6,58,26,32,68
Dundee Utd,92,2,18,10,8,59,37,22,64
Morton,92,3,16,11,9,46,38,8,59
Falkirk,92,4,16,9,11,58,43,15,57
Queen of S't,92,5,12,10,14,51,50,1,46
Dunfermline,92,6,10,13,13,47,50,-3,43
Dumbarton,92,7,11,10,15,48,60,-12,43
Raith,92,8,10,10,16,34,52,-18,40
Ayr,92,9,8,11,17,35,62,-27,35
St Mirren,92,10,7,11,18,36,54,-18,32
Hibernian,93,1,21,11,4,60,23,37,74
Dundee Utd,93,2,17,10,9,54,36,18,61
Morton,93,3,16,12,8,50,37,13,60
Falkirk,93,4,13,10,13,52,47,5,49
Raith,93,5,13,9,14,39,48,-9,48
Dumbarton,93,6,11,13,12,50,52,-2,46
Queen of S't,93,7,12,9,15,43,47,-4,45
Dunfermline,93,8,8,12,16,45,54,-9,36
Ayr,93,9,7,12,17,29,59,-30,33
St Mirren,93,10,6,14,16,35,54,-19,32
Hibernian,94,1,19,11,6,55,28,27,68
Morton,94,2,17,13,6,56,38,18,64
Dundee Utd,94,3,18,8,10,51,37,14,62
Falkirk,94,4,17,10,9,58,39,19,61
Raith,94,5,11,10,15,35,47,-12,43
Queen of S't,94,6,11,9,16,44,52,-8,42
Dunfermline,94,7,8,14,14,41,47,-6,38
Ayr,94,8,9,11,16,36,55,-19,38
St Mirren,94,9,9,10,17,38,55,-17,37
Dumbarton,94,10,7,12,17,48,64,-16,33
Hibernian,95,1,21,12,3,59,25,34,75
Falkirk,95,2,18,9,9,61,38,23,63
Morton,95,3,16,13,7,49,35,14,61
Dundee Utd,95,4,13,9,14,46,44,2,48
Dumbarton,95,5,11,12,13,54,57,-3,45
Queen of S't,95,6,11,9,16,44,51,-7,42
Dunfermline,95,7,9,14,13,43,49,-6,41
Raith,95,8,10,9,17,34,48,-14,39
Ayr,95,9,8,13,15,36,54,-18,37
St Mirren,95,10,8,10,18,40,65,-25,34
Hibernian,96,1,19,10,7,55,28,27,67
Morton,96,2,17,10,9,48,37,11,61
Falkirk,96,3,17,9,10,59,42,17,60
Dundee Utd,96,4,14,9,13,46,47,-1,51
Dunfermline,96,5,12,12,12,48,46,2,48
Queen of S't,96,6,13,8,15,50,51,-1,47
Dumbarton,96,7,10,11,15,52,63,-11,41
St Mirren,96,8,10,10,16,42,57,-15,40
Ayr,96,9,10,10,16,38,53,-15,40
Raith,96,10,9,9,18,35,49,-14,36
Hibernian,97,1,18,14,4,54,26,28,68
Morton,97,2,18,11,7,55,36,19,65
Dundee Utd,97,3,17,11,8,51,39,12,62
Falkirk,97,4,16,10,10,56,41,15,58
Queen of S't,97,5,11,9,16,40,48,-8,42
Dunfermline,97,6,9,14,13,47,50,-3,41
Raith,97,7,10,9,17,35,52,-17,39
Dumbarton,97,8,9,11,16,47,56,-9,38
Ayr,97,9,9,11,16,33,51,-18,38
St Mirren,97,10,8,10,18,38,57,-19,34
Hibernian,98,1,18,14,4,54,26,28,68
Falkirk,98,2,18,10,8,58,36,22,64
Morton,98,3,17,12,7,51,35,16,63
Dundee Utd,98,4,17,9,10,51,38,13,60
Queen of S't,98,5,11,10,15,43,47,-4,43
Ayr,98,6,10,11,15,39,56,-17,41
Raith,98,7,10,9,17,33,48,-15,39
Dunfermline,98,8,8,14,14,41,48,-7,38
Dumbarton,98,9,7,14,15,47,64,-17,35
St Mirren,98,10,8,9,19,39,58,-19,33
Hibernian,99,1,19,12,5,56,25,31,69
Falkirk,99,2,18,10,8,59,39,20,64
Morton,99,3,17,12,7,50,30,20,63
Dundee Utd,99,4,18,8,10,53,42,11,62
Queen of S't,99,5,10,11,15,43,50,-7,41
Raith,99,6,10,11,15,35,48,-13,41
Dunfermline,99,7,9,12,15,42,52,-10,39
Dumbarton,99,8,8,14,14,44,55,-11,38
Ayr,99,9,8,11,17,33,56,-23,35
St Mirren,99,10,7,11,18,42,60,-18,32
Hibernian,100,1,18,15,3,56,25,31,69
Falkirk,100,2,15,12,9,59,43,16,57
Morton,100,3,15,12,9,49,39,10,57
Dundee Utd,100,4,15,9,12,49,43,6,54
Dunfermline,100,5,12,13,11,49,45,4,49
Queen of S't,100,6,11,10,15,46,51,-5,43
Raith,100,7,10,12,14,42,50,-8,42
St Mirren,100,8,9,12,15,41,55,-14,39
Ayr,100,9,9,11,16,33,58,-25,38
Dumbarton,100,10,8,10,18,49,64,-15,34
Hibernian,101,1,20,11,5,55,25,30,71
Morton,101,2,16,10,10,46,37,9,58
Falkirk,101,3,15,11,10,56,41,15,56
Dundee Utd,101,4,16,8,12,47,43,4,56
Queen of S't,101,5,12,11,13,51,50,1,47
Ayr,101,6,12,11,13,41,51,-10,47
Raith,101,7,10,12,14,37,46,-9,42
Dunfermline,101,8,8,13,15,43,50,-7,37
Dumbarton,101,9,9,10,17,49,65,-16,37
St Mirren,101,10,8,11,17,38,55,-17,35
Hibernian,102,1,20,11,5,58,24,34,71
Morton,102,2,18,11,7,56,37,19,65
Falkirk,102,3,16,10,10,63,44,19,58
Dundee Utd,102,4,15,8,13,52,51,1,53
Dunfermline,102,5,12,11,13,46,49,-3,47
Queen of S't,102,6,12,9,15,48,51,-3,45
Raith,102,7,9,12,15,36,48,-12,39
Dumbarton,102,8,9,10,17,45,58,-13,37
St Mirren,102,9,9,10,17,38,56,-18,37
Ayr,102,10,9,10,17,35,59,-24,37
Hibernian,103,1,21,11,4,59,25,34,74
Dundee Utd,103,2,20,8,8,60,36,24,68
Morton,103,3,17,9,10,53,38,15,60
Falkirk,103,4,14,11,11,54,43,11,53
Queen of S't,103,5,13,10,13,49,48,1,49
Raith,103,6,10,9,17,35,51,-16,39
Dumbarton,103,7,9,11,16,47,61,-14,38
St Mirren,103,8,9,10,17,42,56,-14,37
Dunfermline,103,9,8,12,16,44,62,-18,36
Ayr,103,10,8,11,17,32,55,-23,35
Hibernian,104,1,20,10,6,58,26,32,70
Morton,104,2,18,10,8,51,34,17,64
Dundee Utd,104,3,15,11,10,49,38,11,56
Falkirk,104,4,14,12,10,54,43,11,54
Queen of S't,104,5,12,10,14,46,48,-2,46
Ayr,104,6,10,12,14,36,52,-16,42
Dunfermline,104,7,9,14,13,48,50,-2,41
Raith,104,8,9,12,15,31,48,-17,39
St Mirren,104,9,9,10,17,39,55,-16,37
Dumbarton,104,10,8,11,17,45,63,-18,35
Hibernian,105,1,18,12,6,58,33,25,66
Falkirk,105,2,18,10,8,59,35,24,64
Morton,105,3,15,10,11,50,44,6,55
Dundee Utd,105,4,14,11,11,43,39,4,53
Queen of S't,105,5,13,8,15,45,49,-4,47
Raith,105,6,12,9,15,44,47,-3,45
Dunfermline,105,7,10,14,12,44,45,-1,44
Dumbarton,105,8,10,10,16,48,57,-9,40
Ayr,105,9,9,12,15,38,61,-23,39
St Mirren,105,10,7,12,17,42,61,-19,33
Hibernian,106,1,19,13,4,55,26,29,70
Morton,106,2,16,13,7,48,36,12,61
Falkirk,106,3,16,10,10,58,39,19,58
Dundee Utd,106,4,16,9,11,51,41,10,57
Queen of S't,106,5,13,9,14,49,53,-4,48
Ayr,106,6,10,12,14,37,51,-14,42
Dunfermline,106,7,9,13,14,48,48,0,40
Raith,106,8,9,13,14,35,47,-12,40
St Mirren,106,9,9,10,17,39,54,-15,37
Dumbarton,106,10,7,10,19,43,68,-25,31
Hibernian,107,1,20,11,5,55,25,30,71
Morton,107,2,17,12,7,49,34,15,63
Falkirk,107,3,17,10,9,57,38,19,61
Dundee Utd,107,4,17,8,11,54,40,14,59
Queen of S't,107,5,14,9,13,46,45,1,51
Raith,107,6,11,10,15,37,49,-12,43
Dunfermline,107,7,8,12,16,41,50,-9,36
Dumbarton,107,8,8,12,16,47,63,-16,36
Ayr,107,9,7,13,16,34,56,-22,34
St Mirren,107,10,7,11,18,35,55,-20,32
Hibernian,108,1,20,11,5,56,26,30,71
Falkirk,108,2,16,11,9,58,42,16,59
Morton,108,3,15,12,9,50,45,5,57
Dundee Utd,108,4,16,8,12,52,40,12,56
Dunfermline,108,5,10,14,12,47,45,2,44
Dumbarton,108,6,10,11,15,52,61,-9,41
Ayr,108,7,10,11,15,39,54,-15,41
Queen of S't,108,8,10,9,17,44,56,-12,39
Raith,108,9,9,12,15,35,50,-15,39
St Mirren,108,10,9,11,16,43,57,-14,38
Hibernian,109,1,18,14,4,56,28,28,68
Morton,109,2,18,10,8,54,35,19,64
Falkirk,109,3,15,13,8,61,45,16,58
Dundee Utd,109,4,16,10,10,54,38,16,58
Queen of S't,109,5,12,11,13,46,48,-2,47
Dunfermline,109,6,9,14,13,45,48,-3,41
Raith,109,7,10,10,16,37,51,-14,40
St Mirren,109,8,9,11,16,46,58,-12,38
Dumbarton,109,9,7,13,16,48,64,-16,34
Ayr,109,10,7,12,17,33,65,-32,33
Falkirk,110,1,18,11,7,62,39,23,65
Hibernian,110,2,16,15,5,50,26,24,63
Morton,110,3,17,12,7,47,34,13,63
Dundee Utd,110,4,15,11,10,49,40,9,56
Raith,110,5,11,10,15,39,50,-11,43
Dunfermline,110,6,10,12,14,44,47,-3,42
Dumbarton,110,7,10,10,16,51,62,-11,40
Queen of S't,110,8,10,9,17,41,55,-14,39
Ayr,110,9,9,12,15,35,52,-17,39
St Mirren,110,10,7,12,17,42,55,-13,33
Falkirk,111,1,18,9,9,61,40,21,63
Hibernian,111,2,17,11,8,50,27,23,62
Morton,111,3,17,10,9,48,37,11,61
Dundee Utd,111,4,15,8,13,47,40,7,53
Queen of S't,111,5,13,9,14,47,50,-3,48
Dumbarton,111,6,11,11,14,48,56,-8,44
Ayr,111,7,11,11,14,35,52,-17,44
Raith,111,8,10,11,15,39,49,-10,41
Dunfermline,111,9,9,13,14,43,48,-5,40
St Mirren,111,10,8,9,19,38,57,-19,33
Hibernian,112,1,19,11,6,53,26,27,68
Dundee Utd,112,2,17,10,9,54,38,16,61
Falkirk,112,3,16,11,9,60,40,20,59
Morton,112,4,15,12,9,46,35,11,57
Dunfermline,112,5,12,11,13,47,47,0,47
Queen of S't,112,6,11,8,17,44,52,-8,41
Raith,112,7,10,11,15,37,49,-12,41
Ayr,112,8,9,12,15,34,55,-21,39
Dumbarton,112,9,9,11,16,44,60,-16,38
St Mirren,112,10,7,13,16,38,55,-17,34
Hibernian,113,1,19,13,4,55,24,31,70
Dundee Utd,113,2,17,11,8,49,37,12,62
Falkirk,113,3,17,9,10,60,40,20,60
Morton,113,4,16,12,8,46,34,12,60
Dunfermline,113,5,10,13,13,47,50,-3,43
Queen of S't,113,6,10,10,16,43,53,-10,40
St Mirren,113,7,10,9,17,44,59,-15,39
Raith,113,8,10,8,18,35,51,-16,38
Ayr,113,9,9,11,16,35,56,-21,38
Dumbarton,113,10,9,10,17,47,57,-10,37
Hibernian,114,1,17,12,7,55,30,25,63
Falkirk,114,2,17,9,10,59,42,17,60
Morton,114,3,15,14,7,52,42,10,59
Dundee Utd,114,4,16,10,10,52,42,10,58
Raith,114,5,12,9,15,40,48,-8,45
Dumbarton,114,6,11,11,14,54,58,-4,44
Dunfermline,114,7,10,13,13,49,51,-2,43
Queen of S't,114,8,10,10,16,43,54,-11,40
St Mirren,114,9,10,9,17,42,57,-15,39
Ayr,114,10,8,11,17,33,55,-22,35
Hibernian,115,1,19,13,4,53,23,30,70
Morton,115,2,17,12,7,50,34,16,63
Falkirk,115,3,15,10,11,54,42,12,55
Dundee Utd,115,4,14,10,12,45,40,5,52
St Mirren,115,5,12,10,14,44,50,-6,46
Dumbarton,115,6,10,11,15,49,57,-8,41
Queen of S't,115,7,11,8,17,41,53,-12,41
Raith,115,8,10,10,16,35,49,-14,40
Dunfermline,115,9,9,12,15,41,46,-5,39
Ayr,115,10,9,12,15,32,50,-18,39
Hibernian,116,1,18,12,6,58,29,29,66
Morton,116,2,16,13,7,48,34,14,61
Falkirk,116,3,16,10,10,56,41,15,58
Dundee Utd,116,4,16,10,10,53,40,13,58
Dunfermline,116,5,11,14,11,46,43,3,47
Queen of S't,116,6,10,11,15,42,49,-7,41
St Mirren,116,7,10,11,15,45,56,-11,41
Raith,116,8,10,10,16,32,50,-18,40
Dumbarton,116,9,8,12,16,45,57,-12,36
Ayr,116,10,8,11,17,30,56,-26,35
Hibernian,117,1,19,14,3,62,24,38,71
Morton,117,2,16,13,7,51,41,10,61
Dundee Utd,117,3,16,10,10,52,41,11,58
Falkirk,117,4,14,12,10,56,42,14,54
Queen of S't,117,5,13,10,13,52,49,3,49
Raith,117,6,12,8,16,40,52,-12,44
Dunfermline,117,7,9,12,15,46,52,-6,39
St Mirren,117,8,9,12,15,43,54,-11,39
Dumbarton,117,9,8,13,15,48,61,-13,37
Ayr,117,10,6,12,18,30,64,-34,30
Hibernian,118,1,17,11,8,51,30,21,62
Falkirk,118,2,17,10,9,57,36,21,61
Morton,118,3,16,11,9,50,40,10,59
Dundee Utd,118,4,14,11,11,48,45,3,53
Queen of S't,118,5,13,10,13,45,47,-2,49
Raith,118,6,13,8,15,40,47,-7,47
St Mirren,118,7,11,10,15,41,50,-9,43
Dumbarton,118,8,9,12,15,49,57,-8,39
Ayr,118,9,8,13,15,37,57,-20,37
Dunfermline,118,10,7,14,15,43,52,-9,35
Hibernian,119,1,19,11,6,53,27,26,68
Morton,119,2,17,11,8,51,36,15,62
Dundee Utd,119,3,17,10,9,50,36,14,61
Falkirk,119,4,17,9,10,56,42,14,60
Queen of S't,119,5,14,8,14,45,48,-3,50
Dumbarton,119,6,10,11,15,51,56,-5,41
Dunfermline,119,7,9,13,14,47,51,-4,40
Ayr,119,8,8,12,16,38,57,-19,36
St Mirren,119,9,8,11,17,42,59,-17,35
Raith,119,10,8,10,18,31,52,-21,34
Hibernian,120,1,20,13,3,55,22,33,73
Morton,120,2,16,13,7,50,37,13,61
Falkirk,120,3,17,9,10,58,40,18,60
Dundee Utd,120,4,17,8,11,51,37,14,59
Dunfermline,120,5,11,11,14,43,44,-1,44
Queen of S't,120,6,10,10,16,46,59,-13,40
Ayr,120,7,9,12,15,33,55,-22,39
Dumbarton,120,8,9,10,17,47,59,-12,37
St Mirren,120,9,8,12,16,37,52,-15,36
Raith,120,10,8,12,16,36,51,-15,36
Hibernian,121,1,19,12,5,65,25,40,69
Morton,121,2,16,11,9,52,43,9,59
Falkirk,121,3,16,10,10,56,45,11,58
Dundee Utd,121,4,16,10,10,50,42,8,58
Queen of S't,121,5,12,9,15,46,48,-2,45
Raith,121,6,12,8,16,39,53,-14,44
Dumbarton,121,7,10,13,13,52,55,-3,43
Dunfermline,121,8,9,12,15,50,55,-5,39
Ayr,121,9,9,11,16,37,58,-21,38
St Mirren,121,10,8,10,18,40,63,-23,34
Hibernian,122,1,20,12,4,54,24,30,72
Dundee Utd,122,2,17,9,10,54,42,12,60
Falkirk,122,3,15,12,9,57,42,15,57
Morton,122,4,13,11,12,46,44,2,50
Dunfermline,122,5,12,12,12,55,48,7,48
Queen of S't,122,6,12,11,13,49,49,0,47
St Mirren,122,7,10,10,16,46,55,-9,40
Dumbarton,122,8,8,13,15,45,57,-12,37
Ayr,122,9,8,13,15,35,58,-23,37
Raith,122,10,9,9,18,35,57,-22,36
Morton,123,1,18,11,7,50,35,15,65
Hibernian,123,2,16,14,6,47,25,22,62
Falkirk,123,3,16,11,9,57,40,17,59
Dundee Utd,123,4,16,10,10,53,44,9,58
Queen of S't,123,5,12,12,12,48,48,0,48
Dunfermline,123,6,9,13,14,45,48,-3,40
Raith,123,7,10,10,16,38,53,-15,40
St Mirren,123,8,8,13,15,38,52,-14,37
Dumbarton,123,9,8,12,16,48,59,-11,36
Ayr,123,10,8,12,16,34,54,-20,36
Hibernian,124,1,21,11,4,61,28,33,74
Morton,124,2,16,11,9,49,41,8,59
Dundee Utd,124,3,16,10,10,53,41,12,58
Falkirk,124,4,15,9,12,57,46,11,54
Queen of S't,124,5,11,12,13,47,49,-2,45
Dunfermline,124,6,10,12,14,45,47,-2,42
Dumbarton,124,7,9,13,14,49,55,-6,40
Ayr,124,8,8,15,13,37,53,-16,39
St Mirren,124,9,9,10,17,40,57,-17,37
Raith,124,10,8,11,17,33,54,-21,35
Hibernian,125,1,21,10,5,56,23,33,73
Dundee Utd,125,2,17,10,9,55,39,16,61
Falkirk,125,3,16,10,10,58,43,15,58
Morton,125,4,14,13,9,46,38,8,55
Queen of S't,125,5,12,11,13,45,47,-2,47
Raith,125,6,12,10,14,40,48,-8,46
Dunfermline,125,7,10,14,12,47,49,-2,44
Dumbarton,125,8,8,12,16,44,60,-16,36
St Mirren,125,9,8,11,17,40,57,-17,35
Ayr,125,10,6,11,19,31,58,-27,29
Hibernian,126,1,20,11,5,54,24,30,71
Morton,126,2,19,11,6,51,32,19,68
Falkirk,126,3,17,9,10,61,41,20,60
Dundee Utd,126,4,16,9,11,56,43,13,57
Queen of S't,126,5,12,9,15,48,51,-3,45
Dumbarton,126,6,10,11,15,52,64,-12,41
Raith,126,7,11,8,17,36,52,-16,41
Dunfermline,126,8,8,13,15,41,53,-12,37
St Mirren,126,9,8,10,18,42,59,-17,34
Ayr,126,10,7,13,16,33,55,-22,34
Hibernian,127,1,20,11,5,56,25,31,71
Morton,127,2,18,10,8,49,34,15,64
Dundee Utd,127,3,16,11,9,51,38,13,59
Falkirk,127,4,15,11,10,54,39,15,56
Queen of S't,127,5,11,10,15,46,53,-7,43
Dunfermline,127,6,9,13,14,42,48,-6,40
Raith,127,7,10,10,16,34,47,-13,40
Dumbarton,127,8,9,12,15,47,57,-10,39
Ayr,127,9,8,13,15,32,53,-21,37
St Mirren,127,10,8,11,17,41,58,-17,35
Hibernian,128,1,19,13,4,57,23,34,70
Morton,128,2,16,14,6,51,37,14,62
Dundee Utd,128,3,16,11,9,47,37,10,59
Falkirk,128,4,13,13,10,53,43,10,52
Queen of S't,128,5,11,11,14,44,48,-4,44
Dumbarton,128,6,10,13,13,50,56,-6,43
Dunfermline,128,7,8,16,12,43,46,-3,40
Raith,128,8,9,11,16,33,49,-16,38
Ayr,128,9,8,11,17,31,56,-25,35
St Mirren,128,10,7,13,16,40,54,-14,34
Hibernian,129,1,18,13,5,55,27,28,67
Morton,129,2,17,10,9,46,36,10,61
Dundee Utd,129,3,15,11,10,50,36,14,56
Falkirk,129,4,14,13,9,55,41,14,55
Dumbarton,129,5,12,11,13,52,53,-1,47
Queen of S't,129,6,12,10,14,45,49,-4,46
Dunfermline,129,7,11,12,13,43,45,-2,45
St Mirren,129,8,8,13,15,36,50,-14,37
Raith,129,9,8,10,18,31,51,-20,34
Ayr,129,10,6,15,15,31,56,-25,33
Hibernian,130,1,20,10,6,55,27,28,70
Morton,130,2,17,11,8,47,33,14,62
Falkirk,130,3,17,10,9,58,37,21,61
Dundee Utd,130,4,15,10,11,50,39,11,55
Dunfermline,130,5,11,13,12,48,45,3,46
Queen of S't,130,6,11,10,15,47,53,-6,43
St Mirren,130,7,11,9,16,42,52,-10,42
Raith,130,8,10,10,16,32,47,-15,40
Ayr,130,9,8,12,16,35,56,-21,36
Dumbarton,130,10,7,11,18,42,67,-25,32
Hibernian,131,1,20,13,3,59,25,34,73
Morton,131,2,17,11,8,52,38,14,62
Falkirk,131,3,17,10,9,60,40,20,61
Dundee Utd,131,4,16,10,10,52,40,12,58
Queen of S't,131,5,11,11,14,48,54,-6,44
Dunfermline,131,6,9,15,12,47,48,-1,42
Raith,131,7,9,11,16,35,52,-17,38
St Mirren,131,8,9,9,18,43,60,-17,36
Dumbarton,131,9,8,11,17,43,62,-19,35
Ayr,131,10,7,13,16,35,55,-20,34
Hibernian,132,1,21,11,4,55,22,33,74
Morton,132,2,17,12,7,50,33,17,63
Falkirk,132,3,14,12,10,57,47,10,54
Dundee Utd,132,4,14,10,12,53,47,6,52
Dunfermline,132,5,11,13,12,47,42,5,46
Ayr,132,6,10,11,15,36,54,-18,41
Queen of S't,132,7,10,10,16,41,51,-10,40
Raith,132,8,10,10,16,34,50,-16,40
St Mirren,132,9,9,11,16,44,56,-12,38
Dumbarton,132,10,7,14,15,47,62,-15,35
Hibernian,133,1,21,11,4,61,22,39,74
Dundee Utd,133,2,18,9,9,56,40,16,63
Morton,133,3,15,12,9,51,45,6,57
Falkirk,133,4,14,11,11,51,40,11,53
Queen of S't,133,5,12,9,15,42,47,-5,45
Raith,133,6,10,12,14,34,44,-10,42
Dumbarton,133,7,10,11,15,48,55,-7,41
Dunfermline,133,8,9,12,15,48,57,-9,39
St Mirren,133,9,9,10,17,41,56,-15,37
Ayr,133,10,8,11,17,35,61,-26,35
Hibernian,134,1,18,14,4,55,28,27,68
Morton,134,2,16,14,6,53,36,17,62
Dundee Utd,134,3,15,12,9,51,38,13,57
Falkirk,134,4,14,14,8,57,41,16,56
Queen of S't,134,5,11,11,14,48,52,-4,44
Dunfermline,134,6,10,12,14,51,58,-7,42
Ayr,134,7,9,13,14,38,51,-13,40
St Mirren,134,8,8,13,15,41,54,-13,37
Raith,134,9,9,10,17,36,56,-20,37
Dumbarton,134,10,8,11,17,46,62,-16,35
Hibernian,135,1,19,13,4,57,26,31,70
Morton,135,2,18,10,8,52,36,16,64
Falkirk,135,3,17,9,10,57,38,19,60
Dundee Utd,135,4,16,9,11,53,42,11,57
Queen of S't,135,5,11,9,16,45,57,-12,42
Dunfermline,135,6,9,14,13,49,54,-5,41
Raith,135,7,11,8,17,37,52,-15,41
St Mirren,135,8,10,9,17,40,53,-13,39
Ayr,135,9,9,11,16,37,56,-19,38
Dumbarton,135,10,9,10,17,47,60,-13,37
Hibernian,136,1,17,15,4,52,24,28,66
Dundee Utd,136,2,17,9,10,47,36,11,60
Falkirk,136,3,16,11,9,59,41,18,59
Morton,136,4,14,14,8,45,36,9,56
Queen of S't,136,5,13,10,13,45,47,-2,49
Dunfermline,136,6,11,13,12,44,43,1,46
Ayr,136,7,8,14,14,35,53,-18,38
Dumbarton,136,8,9,10,17,45,59,-14,37
St Mirren,136,9,8,12,16,44,58,-14,36
Raith,136,10,8,10,18,29,48,-19,34
Falkirk,137,1,19,9,8,64,42,22,66
Hibernian,137,2,17,13,6,55,31,24,64
Morton,137,3,17,12,7,52,37,15,63
Dundee Utd,137,4,14,10,12,50,45,5,52
Dunfermline,137,5,11,14,11,49,45,4,47
Queen of S't,137,6,12,11,13,46,47,-1,47
Raith,137,7,9,11,16,33,50,-17,38
Dumbarton,137,8,8,12,16,54,67,-13,36
St Mirren,137,9,8,11,17,45,56,-11,35
Ayr,137,10,7,13,16,39,67,-28,34
Hibernian,138,1,20,12,4,58,24,34,72
Falkirk,138,2,16,11,9,57,40,17,59
Dundee Utd,138,3,16,11,9,47,36,11,59
Morton,138,4,15,10,11,45,40,5,55
Dunfermline,138,5,11,12,13,47,49,-2,45
Ayr,138,6,9,14,13,35,50,-15,41
Queen of S't,138,7,10,10,16,44,52,-8,40
Raith,138,8,9,13,14,33,47,-14,40
Dumbarton,138,9,8,12,16,44,55,-11,36
St Mirren,138,10,8,11,17,39,56,-17,35
Hibernian,139,1,20,12,4,61,28,33,72
Morton,139,2,17,13,6,50,32,18,64
Falkirk,139,3,16,11,9,59,40,19,59
Dundee Utd,139,4,16,10,10,53,39,14,58
Dumbarton,139,5,10,12,14,49,57,-8,42
Queen of S't,139,6,11,8,17,43,51,-8,41
Dunfermline,139,7,9,12,15,41,49,-8,39
Raith,139,8,9,11,16,33,48,-15,38
Ayr,139,9,8,12,16,32,55,-23,36
St Mirren,139,10,8,11,17,40,62,-22,35
Hibernian,140,1,18,11,7,54,32,22,65
Morton,140,2,18,11,7,56,36,20,65
Falkirk,140,3,16,11,9,65,40,25,59
Dundee Utd,140,4,16,11,9,50,39,11,59
Queen of S't,140,5,12,11,13,45,51,-6,47
Raith,140,6,11,9,16,35,46,-11,42
Dunfermline,140,7,8,15,13,46,50,-4,39
Ayr,140,8,9,11,16,36,54,-18,38
St Mirren,140,9,9,10,17,34,52,-18,37
Dumbarton,140,10,8,10,18,43,64,-21,34
Hibernian,141,1,19,13,4,55,22,33,70
Dundee Utd,141,2,17,11,8,50,37,13,62
Morton,141,3,15,13,8,48,38,10,58
Falkirk,141,4,14,10,12,60,49,11,52
Queen of S't,141,5,13,9,14,50,54,-4,48
Dunfermline,141,6,10,12,14,49,50,-1,42
St Mirren,141,7,11,9,16,45,55,-10,42
Raith,141,8,11,9,16,40,52,-12,42
Ayr,141,9,7,14,15,32,54,-22,35
Dumbarton,141,10,7,12,17,43,61,-18,33
Hibernian,142,1,18,14,4,57,28,29,68
Falkirk,142,2,16,10,10,55,43,12,58
Dundee Utd,142,3,16,9,11,52,39,13,57
Morton,142,4,15,12,9,55,43,12,57
Queen of S't,142,5,11,12,13,41,45,-4,45
Dunfermline,142,6,10,13,13,51,55,-4,43
Raith,142,7,10,11,15,41,52,-11,41
Dumbarton,142,8,9,12,15,43,53,-10,39
St Mirren,142,9,9,11,16,43,56,-13,38
Ayr,142,10,8,12,16,33,57,-24,36
Hibernian,143,1,20,11,5,59,29,30,71
Falkirk,143,2,19,9,8,64,41,23,66
Morton,143,3,17,12,7,54,38,16,63
Dundee Utd,143,4,17,10,9,54,38,16,61
Dunfermline,143,5,10,13,13,49,49,0,43
Ayr,143,6,10,10,16,34,55,-21,40
Raith,143,7,10,9,17,38,53,-15,39
Queen of S't,143,8,10,8,18,46,57,-11,38
Dumbarton,143,9,7,13,16,44,63,-19,34
St Mirren,143,10,8,9,19,42,61,-19,33
Hibernian,144,1,21,11,4,58,24,34,74
Morton,144,2,18,9,9,52,32,20,63
Falkirk,144,3,16,12,8,60,40,20,60
Dundee Utd,144,4,16,10,10,49,41,8,58
Dunfermline,144,5,11,12,13,46,47,-1,45
Dumbarton,144,6,11,12,13,50,54,-4,45
Ayr,144,7,10,11,15,38,58,-20,41
Queen of S't,144,8,10,8,18,42,56,-14,38
Raith,144,9,9,9,18,35,53,-18,36
St Mirren,144,10,6,10,20,35,60,-25,28
Hibernian,145,1,20,11,5,56,24,32,71
Morton,145,2,17,10,9,50,36,14,61
Falkirk,145,3,15,11,10,62,45,17,56
Dundee Utd,145,4,15,10,11,49,41,8,55
Dunfermline,145,5,12,12,12,48,50,-2,48
Queen of S't,145,6,13,9,14,48,51,-3,48
St Mirren,145,7,10,11,15,44,53,-9,41
Ayr,145,8,9,12,15,34,56,-22,39
Dumbarton,145,9,7,13,16,45,58,-13,34
Raith,145,10,8,9,19,31,53,-22,33
Hibernian,146,1,20,12,4,57,29,28,72
Dundee Utd,146,2,18,9,9,56,40,16,63
Morton,146,3,17,10,9,48,34,14,61
Falkirk,146,4,15,12,9,59,45,14,57
Queen of S't,146,5,11,11,14,50,52,-2,44
Raith,146,6,10,11,15,36,47,-11,41
Dunfermline,146,7,9,12,15,43,51,-8,39
Dumbarton,146,8,8,13,15,46,56,-10,37
Ayr,146,9,8,12,16,33,56,-23,36
St Mirren,146,10,7,12,17,37,55,-18,33
Hibernian,147,1,21,11,4,59,24,35,74
Dundee Utd,147,2,18,8,10,57,41,16,62
Morton,147,3,16,11,9,52,36,16,59
Falkirk,147,4,15,9,12,54,42,12,54
Dunfermline,147,5,13,11,12,49,44,5,50
Queen of S't,147,6,12,9,15,46,52,-6,45
Dumbarton,147,7,10,10,16,48,59,-11,40
St Mirren,147,8,10,9,17,44,64,-20,39
Raith,147,9,9,11,16,37,54,-17,38
Ayr,147,10,6,11,19,31,61,-30,29
Hibernian,148,1,19,13,4,61,27,34,70
Morton,148,2,15,14,7,54,39,15,59
Falkirk,148,3,15,12,9,58,43,15,57
Dundee Utd,148,4,15,10,11,47,41,6,55
Queen of S't,148,5,12,9,15,49,52,-3,45
Raith,148,6,11,11,14,41,50,-9,44
Dunfermline,148,7,8,15,13,45,52,-7,39
Ayr,148,8,8,15,13,36,49,-13,39
St Mirren,148,9,8,12,16,39,56,-17,36
Dumbarton,148,10,8,11,17,44,65,-21,35
Hibernian,149,1,22,11,3,59,22,37,77
Dundee Utd,149,2,16,11,9,52,42,10,59
Falkirk,149,3,16,10,10,60,44,16,58
Morton,149,4,15,11,10,46,37,9,56
Queen of S't,149,5,11,10,15,49,54,-5,43
Raith,149,6,10,12,14,35,48,-13,42
Dunfermline,149,7,9,14,13,45,49,-4,41
Dumbarton,149,8,9,12,15,50,59,-9,39
St Mirren,149,9,8,13,15,43,58,-15,37
Ayr,149,10,7,10,19,34,60,-26,31
Hibernian,150,1,21,12,3,61,25,36,75
Dundee Utd,150,2,16,11,9,53,41,12,59
Morton,150,3,15,13,8,51,42,9,58
Falkirk,150,4,15,9,12,58,47,11,54
Dumbarton,150,5,11,10,15,52,61,-9,43
Queen of S't,150,6,11,10,15,43,54,-11,43
Raith,150,7,11,9,16,41,51,-10,42
Dunfermline,150,8,9,12,15,47,53,-6,39
Ayr,150,9,8,13,15,38,55,-17,37
St Mirren,150,10,9,9,18,37,52,-15,36
Hibernian,151,1,20,10,6,60,28,32,70
Morton,151,2,18,10,8,55,39,16,64
Dundee Utd,151,3,15,9,12,52,45,7,54
Falkirk,151,4,14,9,13,54,45,9,51
Dunfermline,151,5,11,12,13,52,55,-3,45
Dumbarton,151,6,11,11,14,53,55,-2,44
Queen of S't,151,7,11,10,15,46,53,-7,43
Raith,151,8,11,10,15,36,51,-15,43
St Mirren,151,9,9,10,17,39,56,-17,37
Ayr,151,10,8,13,15,34,54,-20,37
Morton,152,1,19,10,7,54,36,18,67
Falkirk,152,2,18,11,7,63,39,24,65
Hibernian,152,3,18,11,7,55,32,23,65
Dundee Utd,152,4,14,11,11,48,42,6,53
Queen of S't,152,5,13,9,14,47,49,-2,48
Dunfermline,152,6,10,12,14,43,47,-4,42
Raith,152,7,10,9,17,32,46,-14,39
Ayr,152,8,8,14,14,38,55,-17,38
Dumbarton,152,9,8,12,16,45,60,-15,36
St Mirren,152,10,7,11,18,38,57,-19,32
Hibernian,153,1,19,11,6,56,28,28,68
Morton,153,2,18,12,6,54,35,19,66
Dundee Utd,153,3,18,9,9,59,39,20,63
Falkirk,153,4,15,11,10,57,45,12,56
Queen of S't,153,5,13,8,15,44,52,-8,47
Dunfermline,153,6,11,13,12,51,47,4,46
Dumbarton,153,7,9,10,17,45,56,-11,37
St Mirren,153,8,9,10,17,40,57,-17,37
Raith,153,9,8,10,18,35,57,-22,34
Ayr,153,10,7,12,17,34,59,-25,33
Hibernian,154,1,18,11,7,54,31,23,65
Morton,154,2,16,11,9,52,41,11,59
Dundee Utd,154,3,15,11,10,48,41,7,56
Falkirk,154,4,14,11,11,56,42,14,53
Raith,154,5,13,8,15,35,46,-11,47
Queen of S't,154,6,12,9,15,46,50,-4,45
Dunfermline,154,7,10,13,13,47,47,0,43
St Mirren,154,8,11,10,15,51,60,-9,43
Dumbarton,154,9,8,13,15,47,58,-11,37
Ayr,154,10,8,13,15,38,58,-20,37
Hibernian,155,1,19,13,4,58,27,31,70
Morton,155,2,18,12,6,55,37,18,66
Falkirk,155,3,16,11,9,59,41,18,59
Dundee Utd,155,4,13,12,11,49,42,7,51
Queen of S't,155,5,12,10,14,48,52,-4,46
Dunfermline,155,6,9,14,13,44,47,-3,41
Ayr,155,7,8,14,14,39,59,-20,38
Raith,155,8,8,13,15,33,47,-14,37
Dumbarton,155,9,8,12,16,47,65,-18,36
St Mirren,155,10,8,11,17,40,55,-15,35
Hibernian,156,1,18,12,6,50,24,26,66
Morton,156,2,17,13,6,53,37,16,64
Falkirk,156,3,16,10,10,56,46,10,58
Dundee Utd,156,4,15,10,11,48,39,9,55
Dunfermline,156,5,11,14,11,51,45,6,47
Queen of S't,156,6,12,11,13,46,46,0,47
Ayr,156,7,9,13,14,35,52,-17,40
St Mirren,156,8,9,10,17,43,56,-13,37
Raith,156,9,9,9,18,33,48,-15,36
Dumbarton,156,10,7,12,17,44,66,-22,33
Hibernian,157,1,21,11,4,59,21,38,74
Morton,157,2,16,11,9,47,37,10,59
Dundee Utd,157,3,16,9,11,49,41,8,57
Falkirk,157,4,15,10,11,60,42,18,55
Dunfermline,157,5,11,13,12,50,47,3,46
Dumbarton,157,6,10,13,13,50,58,-8,43
Raith,157,7,11,10,15,33,45,-12,43
St Mirren,157,8,10,10,16,40,54,-14,40
Queen of S't,157,9,10,9,17,41,57,-16,39
Ayr,157,10,6,12,18,28,55,-27,30
Hibernian,158,1,21,12,3,58,23,35,75
Morton,158,2,18,10,8,54,37,17,64
Dundee Utd,158,3,16,11,9,64,45,19,59
Falkirk,158,4,16,10,10,59,47,12,58
Queen of S't,158,5,11,9,16,43,52,-9,42
Dumbarton,158,6,9,13,14,50,58,-8,40
Raith,158,7,10,8,18,33,50,-17,38
Ayr,158,8,8,14,14,37,58,-21,38
Dunfermline,158,9,8,13,15,45,50,-5,37
St Mirren,158,10,7,12,17,42,65,-23,33
Hibernian,159,1,22,10,4,63,24,39,76
Falkirk,159,2,17,10,9,59,38,21,61
Dundee Utd,159,3,16,10,10,52,40,12,58
Morton,159,4,14,13,9,43,40,3,55
Raith,159,5,12,8,16,37,50,-13,44
Dumbarton,159,6,10,12,14,52,58,-6,42
Queen of S't,159,7,10,10,16,44,55,-11,40
Dunfermline,159,8,9,12,15,47,52,-5,39
Ayr,159,9,8,12,16,33,58,-25,36
St Mirren,159,10,8,11,17,41,56,-15,35
Hibernian,160,1,17,14,5,52,27,25,65
Morton,160,2,17,12,7,48,31,17,63
Falkirk,160,3,15,11,10,61,46,15,56
Dundee Utd,160,4,13,12,11,46,43,3,51
Queen of S't,160,5,13,11,12,51,50,1,50
Raith,160,6,11,9,16,38,53,-15,42
St Mirren,160,7,10,11,15,44,52,-8,41
Dunfermline,160,8,9,13,14,46,49,-3,40
Dumbarton,160,9,10,10,16,49,60,-11,40
Ayr,160,10,8,11,17,37,61,-24,35
Hibernian,161,1,21,10,5,59,25,34,73
Morton,161,2,16,13,7,50,33,17,61
Dundee Utd,161,3,17,8,11,50,38,12,59
Falkirk,161,4,14,12,10,53,40,13,54
Queen of S't,161,5,14,9,13,47,47,0,51
Dumbarton,161,6,10,11,15,48,58,-10,41
Dunfermline,161,7,9,13,14,42,48,-6,40
St Mirren,161,8,10,10,16,45,63,-18,40
Raith,161,9,9,10,17,36,51,-15,37
Ayr,161,10,6,12,18,32,59,-27,30
Hibernian,162,1,20,10,6,58,28,30,70
Dundee Utd,162,2,16,11,9,59,40,19,59
Falkirk,162,3,16,11,9,63,46,17,59
Morton,162,4,16,11,9,52,40,12,59
Queen of S't,162,5,13,10,13,48,48,0,49
Raith,162,6,10,10,16,37,53,-16,40
Dunfermline,162,7,9,12,15,50,59,-9,39
Dumbarton,162,8,9,12,15,51,63,-12,39
Ayr,162,9,8,12,16,34,59,-25,36
St Mirren,162,10,8,11,17,37,53,-16,35
Hibernian,163,1,20,12,4,52,22,30,72
Falkirk,163,2,16,12,8,58,34,24,60
Dundee Utd,163,3,17,9,10,49,36,13,60
Morton,163,4,16,10,10,49,36,13,58
Ayr,163,5,11,11,14,39,55,-16,44
Queen of S't,163,6,11,9,16,45,52,-7,42
Raith,163,7,10,10,16,36,52,-16,40
Dunfermline,163,8,8,14,14,41,49,-8,38
Dumbarton,163,9,9,11,16,48,63,-15,38
St Mirren,163,10,8,10,18,38,56,-18,34
Hibernian,164,1,18,11,7,55,29,26,65
Dundee Utd,164,2,16,11,9,55,37,18,59
Falkirk,164,3,16,11,9,60,43,17,59
Morton,164,4,14,12,10,44,38,6,54
Queen of S't,164,5,13,8,15,48,56,-8,47
Raith,164,6,13,8,15,37,45,-8,47
Dunfermline,164,7,9,14,13,42,45,-3,41
St Mirren,164,8,10,10,16,43,58,-15,40
Ayr,164,9,9,11,16,38,58,-20,38
Dumbarton,164,10,8,12,16,44,57,-13,36
Hibernian,165,1,18,15,3,58,26,32,69
Morton,165,2,16,13,7,49,37,12,61
Falkirk,165,3,16,11,9,59,43,16,59
Dundee Utd,165,4,16,9,11,55,39,16,57
Dunfermline,165,5,11,13,12,46,45,1,46
Raith,165,6,12,8,16,36,46,-10,44
Queen of S't,165,7,11,9,16,45,58,-13,42
Dumbarton,165,8,9,11,16,47,58,-11,38
St Mirren,165,9,8,10,18,38,57,-19,34
Ayr,165,10,7,13,16,35,59,-24,34
Hibernian,166,1,21,11,4,58,23,35,74
Morton,166,2,18,12,6,50,32,18,66
Dundee Utd,166,3,17,8,11,50,37,13,59
Falkirk,166,4,15,11,10,54,44,10,56
Queen of S't,166,5,12,9,15,47,52,-5,45
Dunfermline,166,6,9,14,13,46,48,-2,41
Raith,166,7,10,9,17,39,54,-15,39
Dumbarton,166,8,9,11,16,44,56,-12,38
Ayr,166,9,9,10,17,34,55,-21,37
St Mirren,166,10,7,11,18,42,63,-21,32
Hibernian,167,1,18,12,6,53,28,25,66
Morton,167,2,18,11,7,53,33,20,65
Falkirk,167,3,17,11,8,61,39,22,62
Dundee Utd,167,4,15,12,9,50,38,12,57
Queen of S't,167,5,13,11,12,49,49,0,50
Dunfermline,167,6,10,13,13,43,46,-3,43
Raith,167,7,9,10,17,31,49,-18,37
Dumbarton,167,8,7,14,15,47,59,-12,35
St Mirren,167,9,8,10,18,40,61,-21,34
Ayr,167,10,6,14,16,31,56,-25,32
Hibernian,168,1,19,12,5,56,29,27,69
Falkirk,168,2,16,12,8,59,38,21,60
Morton,168,3,16,12,8,47,36,11,60
Dundee Utd,168,4,16,11,9,56,38,18,59
Queen of S't,168,5,13,10,13,52,49,3,49
Raith,168,6,9,11,16,35,50,-15,38
Dumbarton,168,7,9,11,16,49,69,-20,38
Dunfermline,168,8,8,13,15,44,55,-11,37
Ayr,168,9,8,13,15,39,56,-17,37
St Mirren,168,10,9,9,18,41,58,-17,36
Hibernian,169,1,17,15,4,50,24,26,66
Falkirk,169,2,16,12,8,58,38,20,60
Morton,169,3,16,12,8,49,38,11,60
Dundee Utd,169,4,12,14,10,45,41,4,50
Queen of S't,169,5,11,12,13,45,48,-3,45
Dumbarton,169,6,10,13,13,50,54,-4,43
Dunfermline,169,7,9,15,12,45,46,-1,42
Raith,169,8,10,10,16,35,49,-14,40
Ayr,169,9,6,17,13,31,50,-19,35
St Mirren,169,10,8,10,18,39,59,-20,34
Hibernian,170,1,20,11,5,57,26,31,71
Morton,170,2,18,10,8,52,39,13,64
Falkirk,170,3,16,9,11,63,46,17,57
Dundee Utd,170,4,15,10,11,47,41,6,55
Dunfermline,170,5,11,13,12,46,47,-1,46
Dumbarton,170,6,11,11,14,56,58,-2,44
Raith,170,7,10,10,16,38,52,-14,40
Queen of S't,170,8,9,11,16,42,56,-14,38
Ayr,170,9,8,13,15,41,59,-18,37
St Mirren,170,10,8,10,18,40,58,-18,34
Hibernian,171,1,17,13,6,55,28,27,64
Morton,171,2,17,13,6,48,33,15,64
Falkirk,171,3,15,12,9,61,40,21,57
Dundee Utd,171,4,15,9,12,46,40,6,54
Queen of S't,171,5,13,9,14,46,48,-2,48
Dumbarton,171,6,11,11,14,50,57,-7,44
St Mirren,171,7,9,12,15,39,53,-14,39
Raith,171,8,10,9,17,37,58,-21,39
Dunfermline,171,9,9,11,16,44,51,-7,38
Ayr,171,10,9,11,16,36,54,-18,38
Hibernian,172,1,19,12,5,55,29,26,69
Morton,172,2,17,14,5,53,34,19,65
Falkirk,172,3,16,9,11,61,43,18,57
Dundee Utd,172,4,16,9,11,46,38,8,57
Dunfermline,172,5,11,12,13,51,50,1,45
Queen of S't,172,6,12,8,16,45,50,-5,44
Raith,172,7,10,9,17,33,50,-17,39
Dumbarton,172,8,8,13,15,47,58,-11,37
Ayr,172,9,8,13,15,34,55,-21,37
St Mirren,172,10,8,11,17,34,52,-18,35
Hibernian,173,1,19,14,3,54,24,30,71
Morton,173,2,16,13,7,50,33,17,61
Falkirk,173,3,16,11,9,59,40,19,59
Dundee Utd,173,4,15,10,11,47,40,7,55
Queen of S't,173,5,12,8,16,43,51,-8,44
Dunfermline,173,6,10,13,13,41,46,-5,43
Raith,173,7,10,10,16,34,45,-11,40
Ayr,173,8,8,15,13,36,52,-16,39
Dumbarton,173,9,8,12,16,46,58,-12,36
St Mirren,173,10,7,12,17,38,59,-21,33
Hibernian,174,1,19,12,5,56,26,30,69
Morton,174,2,17,11,8,54,38,16,62
Falkirk,174,3,17,10,9,63,44,19,61
Dundee Utd,174,4,17,10,9,55,39,16,61
Queen of S't,174,5,11,9,16,42,52,-10,42
Raith,174,6,11,9,16,35,47,-12,42
Dunfermline,174,7,9,13,14,45,51,-6,40
Dumbarton,174,8,8,13,15,51,63,-12,37
Ayr,174,9,8,13,15,37,59,-22,37
St Mirren,174,10,8,10,18,40,59,-19,34
Hibernian,175,1,22,11,3,66,23,43,77
Morton,175,2,17,13,6,49,37,12,64
Falkirk,175,3,16,10,10,56,41,15,58
Dundee Utd,175,4,16,10,10,48,38,10,58
Dumbarton,175,5,10,12,14,51,60,-9,42
Raith,175,6,11,8,17,36,47,-11,41
Queen of S't,175,7,10,10,16,46,53,-7,40
Dunfermline,175,8,8,12,16,47,54,-7,36
St Mirren,175,9,8,11,17,41,60,-19,35
Ayr,175,10,8,11,17,34,61,-27,35
Morton,176,1,18,12,6,53,37,16,66
Hibernian,176,2,16,14,6,49,27,22,62
Falkirk,176,3,16,9,11,57,41,16,57
Dundee Utd,176,4,15,10,11,52,41,11,55
Queen of S't,176,5,14,9,13,47,46,1,51
Dumbarton,176,6,10,12,14,49,57,-8,42
Dunfermline,176,7,8,15,13,40,47,-7,39
Raith,176,8,10,9,17,37,53,-16,39
St Mirren,176,9,9,11,16,42,53,-11,38
Ayr,176,10,7,13,16,30,54,-24,34
Hibernian,177,1,21,10,5,60,24,36,73
Dundee Utd,177,2,19,9,8,60,41,19,66
Falkirk,177,3,16,11,9,60,43,17,59
Morton,177,4,16,11,9,47,37,10,59
Queen of S't,177,5,12,8,16,46,53,-7,44
Raith,177,6,10,11,15,33,45,-12,41
Dumbarton,177,7,9,12,15,50,60,-10,39
St Mirren,177,8,9,11,16,40,54,-14,38
Dunfermline,177,9,8,13,15,43,52,-9,37
Ayr,177,10,7,10,19,31,61,-30,31
Hibernian,178,1,18,13,5,52,28,24,67
Morton,178,2,17,13,6,59,38,21,64
Falkirk,178,3,15,12,9,60,43,17,57
Dundee Utd,178,4,16,9,11,51,47,4,57
Queen of S't,178,5,13,9,14,48,49,-1,48
Dunfermline,178,6,9,14,13,46,50,-4,41
Raith,178,7,10,10,16,34,47,-13,40
Dumbarton,178,8,9,12,15,48,58,-10,39
St Mirren,178,9,9,10,17,38,53,-15,37
Ayr,178,10,7,12,17,34,57,-23,33
Hibernian,179,1,19,11,6,55,27,28,68
Morton,179,2,18,9,9,53,38,15,63
Falkirk,179,3,17,9,10,61,44,17,60
Dundee Utd,179,4,17,8,11,53,42,11,59
Raith,179,5,13,9,14,41,48,-7,48
Dunfermline,179,6,11,12,13,52,56,-4,45
Dumbarton,179,7,10,11,15,51,58,-7,41
Queen of S't,179,8,9,12,15,44,53,-9,39
Ayr,179,9,7,12,17,32,54,-22,33
St Mirren,179,10,7,11,18,41,63,-22,32
Hibernian,180,1,18,14,4,54,26,28,68
Morton,180,2,16,13,7,50,35,15,61
Dundee Utd,180,3,16,10,10,51,36,15,58
Falkirk,180,4,13,15,8,55,40,15,54
Queen of S't,180,5,12,12,12,45,46,-1,48
Ayr,180,6,10,13,13,38,51,-13,43
Dumbarton,180,7,10,11,15,47,58,-11,41
Dunfermline,180,8,7,15,14,39,48,-9,36
Raith,180,9,8,12,16,32,48,-16,36
St Mirren,180,10,7,11,18,37,60,-23,32
Hibernian,181,1,18,13,5,51,27,24,67
Morton,181,2,17,14,5,50,30,20,65
Falkirk,181,3,16,10,10,63,44,19,58
Dundee Utd,181,4,16,9,11,52,45,7,57
Dunfermline,181,5,9,14,13,45,46,-1,41
Queen of S't,181,6,10,11,15,43,52,-9,41
Dumbarton,181,7,10,11,15,50,60,-10,41
Ayr,181,8,10,11,15,35,54,-19,41
Raith,181,9,10,10,16,40,52,-12,40
St Mirren,181,10,8,9,19,40,59,-19,33
Hibernian,182,1,20,12,4,59,26,33,72
Dundee Utd,182,2,18,10,8,50,36,14,64
Falkirk,182,3,17,11,8,60,39,21,62
Morton,182,4,15,12,9,44,35,9,57
Raith,182,5,12,8,16,35,46,-11,44
Dumbarton,182,6,9,14,13,48,53,-5,41
Queen of S't,182,7,10,10,16,44,53,-9,40
Dunfermline,182,8,8,12,16,41,51,-10,36
St Mirren,182,9,8,10,18,36,57,-21,34
Ayr,182,10,7,13,16,33,54,-21,34
Hibernian,183,1,17,13,6,54,31,23,64
Morton,183,2,17,13,6,51,35,16,64
Falkirk,183,3,16,9,11,55,40,15,57
Dundee Utd,183,4,15,11,10,54,45,9,56
Queen of S't,183,5,11,10,15,44,52,-8,43
Ayr,183,6,10,13,13,35,48,-13,43
Dunfermline,183,7,10,12,14,44,48,-4,42
Raith,183,8,10,10,16,33,44,-11,40
Dumbarton,183,9,9,11,16,45,56,-11,38
St Mirren,183,10,8,12,16,39,55,-16,36
Hibernian,184,1,20,11,5,58,30,28,71
Morton,184,2,19,11,6,58,33,25,68
Dundee Utd,184,3,16,12,8,47,36,11,60
Falkirk,184,4,14,13,9,56,43,13,55
Queen of S't,184,5,13,9,14,48,49,-1,48
Dunfermline,184,6,11,12,13,48,49,-1,45
Dumbarton,184,7,8,12,16,44,58,-14,36
Raith,184,8,9,9,18,35,51,-16,36
St Mirren,184,9,8,9,19,36,57,-21,33
Ayr,184,10,7,12,17,31,55,-24,33
Hibernian,185,1,20,12,4,59,26,33,72
Morton,185,2,19,12,5,58,35,23,69
Falkirk,185,3,14,14,8,58,42,16,56
Dundee Utd,185,4,14,10,12,48,42,6,52
Queen of S't,185,5,13,9,14,47,48,-1,48
Raith,185,6,10,11,15,34,49,-15,41
St Mirren,185,7,9,11,16,39,56,-17,38
Ayr,185,8,8,12,16,33,53,-20,36
Dunfermline,185,9,7,14,15,42,52,-10,35
Dumbarton,185,10,8,11,17,44,59,-15,35
Hibernian,186,1,20,11,5,59,27,32,71
Morton,186,2,19,10,7,54,32,22,67
Falkirk,186,3,15,12,9,57,42,15,57
Dundee Utd,186,4,15,10,11,49,42,7,55
Dunfermline,186,5,10,11,15,48,53,-5,41
St Mirren,186,6,10,11,15,44,59,-15,41
Queen of S't,186,7,10,10,16,46,61,-15,40
Raith,186,8,10,9,17,38,53,-15,39
Dumbarton,186,9,9,11,16,50,59,-9,38
Ayr,186,10,8,13,15,38,55,-17,37
Hibernian,187,1,19,13,4,55,25,30,70
Morton,187,2,18,10,8,49,35,14,64
Falkirk,187,3,17,11,8,63,39,24,62
Dundee Utd,187,4,16,8,12,50,44,6,56
Dunfermline,187,5,9,15,12,48,50,-2,42
Queen of S't,187,6,10,12,14,52,58,-6,42
Raith,187,7,10,12,14,37,48,-11,42
Dumbarton,187,8,10,11,15,50,60,-10,41
Ayr,187,9,7,12,17,36,57,-21,33
St Mirren,187,10,7,10,19,40,64,-24,31
Hibernian,188,1,20,12,4,59,29,30,72
Morton,188,2,18,12,6,54,32,22,66
Falkirk,188,3,17,11,8,68,42,26,62
Dundee Utd,188,4,15,10,11,45,38,7,55
Queen of S't,188,5,11,10,15,43,52,-9,43
Dunfermline,188,6,10,12,14,46,48,-2,42
Dumbarton,188,7,10,12,14,49,56,-7,42
Raith,188,8,9,11,16,38,56,-18,38
St Mirren,188,9,8,9,19,35,59,-24,33
Ayr,188,10,7,11,18,30,55,-25,32
Morton,189,1,18,11,7,55,36,19,65
Dundee Utd,189,2,17,10,9,56,37,19,61
Hibernian,189,3,16,11,9,47,32,15,59
Falkirk,189,4,16,10,10,54,38,16,58
Queen of S't,189,5,13,8,15,43,48,-5,47
Raith,189,6,11,8,17,34,46,-12,41
Ayr,189,7,10,11,15,37,55,-18,41
Dunfermline,189,8,9,13,14,43,50,-7,40
St Mirren,189,9,10,10,16,40,55,-15,40
Dumbarton,189,10,9,10,17,49,61,-12,37
Hibernian,190,1,18,12,6,54,31,23,66
Morton,190,2,17,13,6,51,34,17,64
Falkirk,190,3,15,13,8,61,40,21,58
Dundee Utd,190,4,14,13,9,53,43,10,55
Queen of S't,190,5,11,11,14,47,54,-7,44
Dunfermline,190,6,8,17,11,45,46,-1,41
Raith,190,7,10,10,16,33,50,-17,40
Dumbarton,190,8,8,14,14,51,63,-12,38
St Mirren,190,9,9,10,17,45,57,-12,37
Ayr,190,10,7,13,16,37,59,-22,34
Hibernian,191,1,18,14,4,53,24,29,68
Morton,191,2,19,10,7,51,33,18,67
Falkirk,191,3,18,10,8,56,36,20,64
Dundee Utd,191,4,17,8,11,52,38,14,59
Queen of S't,191,5,12,9,15,44,51,-7,45
Dunfermline,191,6,9,13,14,43,49,-6,40
Dumbarton,191,7,10,10,16,48,59,-11,40
Raith,191,8,10,10,16,34,47,-13,40
St Mirren,191,9,7,11,18,36,54,-18,32
Ayr,191,10,7,11,18,30,56,-26,32
Hibernian,192,1,21,10,5,61,26,35,73
Morton,192,2,18,11,7,51,33,18,65
Falkirk,192,3,17,10,9,62,46,16,61
Dundee Utd,192,4,16,9,11,49,41,8,57
Queen of S't,192,5,11,11,14,46,50,-4,44
St Mirren,192,6,10,10,16,44,56,-12,40
Dunfermline,192,7,9,12,15,43,51,-8,39
Dumbarton,192,8,9,11,16,48,58,-10,38
Raith,192,9,8,12,16,35,54,-19,36
Ayr,192,10,7,12,17,34,58,-24,33
Hibernian,193,1,20,12,4,59,26,33,72
Morton,193,2,19,10,7,52,34,18,67
Falkirk,193,3,16,11,9,60,40,20,59
Dundee Utd,193,4,15,11,10,47,38,9,56
Queen of S't,193,5,12,10,14,45,51,-6,46
Dunfermline,193,6,10,14,12,44,46,-2,44
St Mirren,193,7,8,12,16,39,54,-15,36
Ayr,193,8,8,12,16,32,52,-20,36
Raith,193,9,8,10,18,36,57,-21,34
Dumbarton,193,10,7,12,17,41,57,-16,33
Hibernian,194,1,18,13,5,54,24,30,67
Dundee Utd,194,2,17,10,9,56,39,17,61
Morton,194,3,17,9,10,51,40,11,60
Falkirk,194,4,16,10,10,58,40,18,58
Queen of S't,194,5,11,11,14,42,49,-7,44
Dumbarton,194,6,9,13,14,51,58,-7,40
St Mirren,194,7,10,10,16,41,55,-14,40
Dunfermline,194,8,9,12,15,42,53,-11,39
Raith,194,9,9,11,16,34,47,-13,38
Ayr,194,10,8,13,15,31,55,-24,37
Hibernian,195,1,19,14,3,58,27,31,71
Dundee Utd,195,2,19,9,8,53,35,18,66
Falkirk,195,3,16,11,9,61,40,21,59
Morton,195,4,16,11,9,51,40,11,59
Queen of S't,195,5,11,11,14,45,50,-5,44
Dunfermline,195,6,8,15,13,45,52,-7,39
Ayr,195,7,9,12,15,35,54,-19,39
Dumbarton,195,8,8,12,16,43,59,-16,36
Raith,195,9,8,12,16,36,52,-16,36
St Mirren,195,10,7,11,18,36,54,-18,32
Hibernian,196,1,19,13,4,58,25,33,70
Falkirk,196,2,18,10,8,63,39,24,64
Morton,196,3,16,13,7,49,37,12,61
Dundee Utd,196,4,17,9,10,53,38,15,60
Dunfermline,196,5,12,11,13,49,48,1,47
Raith,196,6,10,9,17,37,54,-17,39
Queen of S't,196,7,10,8,18,44,58,-14,38
Dumbarton,196,8,8,12,16,44,58,-14,36
St Mirren,196,9,9,9,18,39,58,-19,36
Ayr,196,10,8,12,16,32,53,-21,36
Hibernian,197,1,18,12,6,59,32,27,66
Morton,197,2,17,12,7,50,33,17,63
Falkirk,197,3,16,11,9,55,39,16,59
Dundee Utd,197,4,15,9,12,45,41,4,54
Queen of S't,197,5,12,11,13,45,47,-2,47
Dumbarton,197,6,9,14,13,46,53,-7,41
Raith,197,7,9,12,15,33,50,-17,39
Dunfermline,197,8,8,14,14,42,49,-7,38
Ayr,197,9,8,14,14,35,51,-16,38
St Mirren,197,10,9,9,18,42,57,-15,36
Hibernian,198,1,20,12,4,55,22,33,72
Morton,198,2,17,13,6,48,33,15,64
Falkirk,198,3,16,10,10,57,41,16,58
Dundee Utd,198,4,15,11,10,50,41,9,56
Dumbarton,198,5,10,14,12,47,52,-5,44
Queen of S't,198,6,11,9,16,46,55,-9,42
Dunfermline,198,7,9,14,13,45,48,-3,41
Raith,198,8,10,9,17,36,53,-17,39
St Mirren,198,9,9,10,17,40,53,-13,37
Ayr,198,10,7,10,19,35,61,-26,31
Hibernian,199,1,20,11,5,60,25,35,71
Dundee Utd,199,2,17,11,8,49,37,12,62
Morton,199,3,16,13,7,54,39,15,61
Falkirk,199,4,16,10,10,62,44,18,58
Dunfermline,199,5,12,11,13,47,48,-1,47
Queen of S't,199,6,11,9,16,49,53,-4,42
Ayr,199,7,10,11,15,34,51,-17,41
St Mirren,199,8,9,10,17,39,56,-17,37
Raith,199,9,8,11,17,32,56,-24,35
Dumbarton,199,10,7,11,18,45,62,-17,32
Hibernian,200,1,18,14,4,57,25,32,68
Falkirk,200,2,16,11,9,54,39,15,59
Morton,200,3,15,12,9,44,34,10,57
Dundee Utd,200,4,15,10,11,50,38,12,55
Queen of S't,200,5,11,11,14,47,55,-8,44
Dumbarton,200,6,10,12,14,48,59,-11,42
Dunfermline,200,7,9,14,13,44,48,-4,41
Raith,200,8,10,11,15,34,46,-12,41
St Mirren,200,9,8,13,15,39,53,-14,37
Ayr,200,10,8,12,16,31,51,-20,36
Hibernian,201,1,17,13,6,56,31,25,64
Falkirk,201,2,16,10,10,60,44,16,58
Morton,201,3,15,13,8,50,38,12,58
Dundee Utd,201,4,14,12,10,52,41,11,54
Dunfermline,201,5,10,15,11,49,50,-1,45
Ayr,201,6,11,11,14,36,49,-13,44
Dumbarton,201,7,10,13,13,48,54,-6,43
Queen of S't,201,8,11,9,16,42,52,-10,42
St Mirren,201,9,10,11,15,42,54,-12,41
Raith,201,10,8,9,19,33,55,-22,33
Hibernian,202,1,19,14,3,55,24,31,71
Dundee Utd,202,2,18,10,8,52,36,16,64
Morton,202,3,17,11,8,52,36,16,62
Falkirk,202,4,16,10,10,58,39,19,58
Queen of S't,202,5,11,9,16,47,51,-4,42
Dunfermline,202,6,9,14,13,48,48,0,41
Raith,202,7,10,9,17,36,55,-19,39
Dumbarton,202,8,8,14,14,45,57,-12,38
St Mirren,202,9,8,11,17,39,60,-21,35
Ayr,202,10,8,10,18,32,58,-26,34
Morton,203,1,19,10,7,57,37,20,67
Hibernian,203,2,17,11,8,53,30,23,62
Dundee Utd,203,3,18,8,10,54,42,12,62
Falkirk,203,4,17,10,9,59,40,19,61
St Mirren,203,5,12,9,15,44,51,-7,45
Queen of S't,203,6,11,11,14,41,47,-6,44
Dunfermline,203,7,9,13,14,47,50,-3,40
Raith,203,8,9,10,17,31,51,-20,37
Dumbarton,203,9,7,13,16,47,62,-15,34
Ayr,203,10,7,13,16,33,56,-23,34
Hibernian,204,1,19,13,4,55,27,28,70
Morton,204,2,17,11,8,51,36,15,62
Falkirk,204,3,16,11,9,61,41,20,59
Dundee Utd,204,4,16,10,10,51,39,12,58
Dunfermline,204,5,11,12,13,50,53,-3,45
Queen of S't,204,6,11,10,15,41,48,-7,43
Raith,204,7,11,8,17,31,47,-16,41
Ayr,204,8,9,11,16,31,54,-23,38
Dumbarton,204,9,8,12,16,45,57,-12,36
St Mirren,204,10,8,10,18,37,51,-14,34
Hibernian,205,1,18,12,6,52,25,27,66
Falkirk,205,2,16,11,9,57,40,17,59
Morton,205,3,15,14,7,52,41,11,59
Dundee Utd,205,4,16,10,10,50,40,10,58
Queen of S't,205,5,12,10,14,48,51,-3,46
Raith,205,6,10,11,15,39,52,-13,41
Dumbarton,205,7,9,13,14,49,57,-8,40
Dunfermline,205,8,8,15,13,45,49,-4,39
St Mirren,205,9,8,12,16,41,58,-17,36
Ayr,205,10,7,14,15,34,54,-20,35
Hibernian,206,1,21,10,5,60,24,36,73
Dundee Utd,206,2,18,9,9,56,39,17,63
Morton,206,3,17,12,7,48,32,16,63
Falkirk,206,4,16,10,10,57,40,17,58
Queen of S't,206,5,11,9,16,41,56,-15,42
Raith,206,6,11,8,17,35,52,-17,41
Dunfermline,206,7,9,12,15,46,54,-8,39
Dumbarton,206,8,9,12,15,46,56,-10,39
Ayr,206,9,9,11,16,34,53,-19,38
St Mirren,206,10,7,11,18,38,55,-17,32
Hibernian,207,1,21,10,5,61,25,36,73
Dundee Utd,207,2,17,11,8,56,40,16,62
Morton,207,3,16,14,6,48,34,14,62
Falkirk,207,4,17,9,10,62,43,19,60
Queen of S't,207,5,11,10,15,45,52,-7,43
St Mirren,207,6,10,11,15,39,53,-14,41
Dunfermline,207,7,8,13,15,46,59,-13,37
Raith,207,8,9,10,17,34,51,-17,37
Dumbarton,207,9,8,11,17,53,65,-12,35
Ayr,207,10,8,11,17,34,56,-22,35
Hibernian,208,1,20,12,4,59,24,35,72
Falkirk,208,2,18,10,8,67,44,23,64
Morton,208,3,16,13,7,52,41,11,61
Dundee Utd,208,4,14,10,12,50,42,8,52
Queen of S't,208,5,11,10,15,42,59,-17,43
Dunfermline,208,6,9,15,12,49,46,3,42
Dumbarton,208,7,9,14,13,50,57,-7,41
Raith,208,8,9,10,17,37,53,-16,37
St Mirren,208,9,8,11,17,39,56,-17,35
Ayr,208,10,8,11,17,35,58,-23,35
Hibernian,209,1,21,11,4,59,25,34,74
Morton,209,2,17,10,9,51,39,12,61
Dundee Utd,209,3,16,11,9,53,40,13,59
Falkirk,209,4,15,11,10,56,44,12,56
Raith,209,5,12,10,14,40,44,-4,46
Dunfermline,209,6,9,14,13,44,45,-1,41
Dumbarton,209,7,9,12,15,49,63,-14,39
Ayr,209,8,8,13,15,30,52,-22,37
St Mirren,209,9,9,9,18,41,55,-14,36
Queen of S't,209,10,9,9,18,44,60,-16,36
Morton,210,1,19,10,7,53,34,19,67
Hibernian,210,2,17,12,7,52,29,23,63
Dundee Utd,210,3,16,10,10,52,39,13,58
Falkirk,210,4,14,10,12,53,42,11,52
Dunfermline,210,5,13,12,11,51,46,5,51
Queen of S't,210,6,11,12,13,47,52,-5,45
St Mirren,210,7,10,10,16,45,54,-9,40
Raith,210,8,10,10,16,32,47,-15,40
Dumbarton,210,9,8,14,14,47,62,-15,38
Ayr,210,10,6,12,18,32,59,-27,30
Hibernian,211,1,22,11,3,59,22,37,77
Morton,211,2,17,11,8,49,34,15,62
Falkirk,211,3,15,11,10,52,42,10,56
Dundee Utd,211,4,14,10,12,44,41,3,52
Queen of S't,211,5,12,10,14,48,52,-4,46
Raith,211,6,12,10,14,41,49,-8,46
Dumbarton,211,7,9,11,16,46,58,-12,38
Ayr,211,8,9,11,16,34,55,-21,38
Dunfermline,211,9,8,13,15,48,51,-3,37
St Mirren,211,10,8,10,18,36,53,-17,34
Hibernian,212,1,21,10,5,56,25,31,73
Morton,212,2,17,13,6,49,32,17,64
Dundee Utd,212,3,17,10,9,54,43,11,61
Falkirk,212,4,15,10,11,58,41,17,55
Dunfermline,212,5,9,15,12,46,49,-3,42
Ayr,212,6,8,15,13,38,53,-15,39
Queen of S't,212,7,9,11,16,44,57,-13,38
Dumbarton,212,8,8,13,15,48,57,-9,37
St Mirren,212,9,9,10,17,36,54,-18,37
Raith,212,10,9,9,18,32,50,-18,36
Hibernian,213,1,20,11,5,60,27,33,71
Morton,213,2,20,11,5,57,33,24,71
Falkirk,213,3,19,9,8,59,36,23,66
Dundee Utd,213,4,15,9,12,46,38,8,54
Queen of S't,213,5,12,9,15,44,51,-7,45
Dunfermline,213,6,10,13,13,47,54,-7,43
Dumbarton,213,7,9,11,16,46,58,-12,38
Ayr,213,8,8,11,17,34,58,-24,35
Raith,213,9,8,10,18,31,48,-17,34
St Mirren,213,10,7,10,19,35,56,-21,31
Hibernian,214,1,20,11,5,58,25,33,71
Falkirk,214,2,17,11,8,59,37,22,62
Morton,214,3,16,10,10,48,40,8,58
Dundee Utd,214,4,15,9,12,50,43,7,54
Queen of S't,214,5,13,8,15,49,54,-5,47
Dumbarton,214,6,11,11,14,55,60,-5,44
Raith,214,7,10,9,17,35,48,-13,39
Dunfermline,214,8,8,14,14,45,49,-4,38
Ayr,214,9,9,11,16,34,58,-24,38
St Mirren,214,10,9,10,17,43,62,-19,37
Hibernian,215,1,19,13,4,60,26,34,70
Morton,215,2,18,9,9,49,36,13,63
Falkirk,215,3,16,11,9,61,42,19,59
Dundee Utd,215,4,14,10,12,48,45,3,52
Dunfermline,215,5,11,13,12,48,45,3,46
Dumbarton,215,6,10,12,14,52,59,-7,42
Queen of S't,215,7,10,10,16,47,60,-13,40
Raith,215,8,10,9,17,34,53,-19,39
Ayr,215,9,8,14,14,39,54,-15,38
St Mirren,215,10,9,9,18,42,60,-18,36
Morton,216,1,21,9,6,53,31,22,72
Hibernian,216,2,16,13,7,48,26,22,61
Dundee Utd,216,3,16,9,11,55,40,15,57
Falkirk,216,4,15,11,10,56,41,15,56
Queen of S't,216,5,12,9,15,45,49,-4,45
Dumbarton,216,6,11,10,15,54,63,-9,43
Raith,216,7,11,9,16,35,45,-10,42
Dunfermline,216,8,9,12,15,42,52,-10,39
Ayr,216,9,9,11,16,35,55,-20,38
St Mirren,216,10,9,9,18,37,58,-21,36
Hibernian,217,1,20,11,5,53,26,27,71
Morton,217,2,18,12,6,50,31,19,66
Falkirk,217,3,15,11,10,55,39,16,56
Dundee Utd,217,4,15,11,10,50,39,11,56
Queen of S't,217,5,11,11,14,41,46,-5,44
Dumbarton,217,6,10,12,14,51,54,-3,42
Dunfermline,217,7,9,12,15,43,53,-10,39
Raith,217,8,10,9,17,35,48,-13,39
Ayr,217,9,9,11,16,32,56,-24,38
St Mirren,217,10,7,12,17,40,58,-18,33
Hibernian,218,1,19,12,5,60,28,32,69
Morton,218,2,17,11,8,50,35,15,62
Falkirk,218,3,15,11,10,54,41,13,56
Dundee Utd,218,4,15,10,11,47,38,9,55
Dunfermline,218,5,11,11,14,48,49,-1,44
Dumbarton,218,6,11,11,14,50,57,-7,44
Queen of S't,218,7,11,10,15,45,53,-8,43
Raith,218,8,10,9,17,36,52,-16,39
Ayr,218,9,9,12,15,38,56,-18,39
St Mirren,218,10,9,9,18,38,57,-19,36
Hibernian,219,1,17,13,6,51,29,22,64
Falkirk,219,2,17,10,9,62,42,20,61
Dundee Utd,219,3,17,10,9,55,40,15,61
Morton,219,4,17,10,9,52,39,13,61
Dunfermline,219,5,12,11,13,50,49,1,47
Queen of S't,219,6,12,8,16,42,52,-10,44
St Mirren,219,7,10,10,16,44,55,-11,40
Dumbarton,219,8,9,10,17,50,63,-13,37
Raith,219,9,9,10,17,35,49,-14,37
Ayr,219,10,8,12,16,38,61,-23,36
Hibernian,220,1,20,11,5,59,24,35,71
Morton,220,2,16,11,9,49,37,12,59
Dundee Utd,220,3,16,9,11,51,44,7,57
Falkirk,220,4,15,11,10,58,43,15,56
Queen of S't,220,5,13,10,13,47,44,3,49
Dunfermline,220,6,11,12,13,43,45,-2,45
Raith,220,7,10,9,17,32,52,-20,39
Dumbarton,220,8,9,11,16,45,56,-11,38
Ayr,220,9,9,10,17,36,60,-24,37
St Mirren,220,10,8,12,16,42,57,-15,36
Hibernian,221,1,19,11,6,56,27,29,68
Falkirk,221,2,16,11,9,56,38,18,59
Morton,221,3,15,13,8,48,38,10,58
Dundee Utd,221,4,13,13,10,47,40,7,52
Dumbarton,221,5,10,13,13,45,51,-6,43
Raith,221,6,10,12,14,32,43,-11,42
Queen of S't,221,7,10,11,15,41,52,-11,41
Dunfermline,221,8,9,13,14,43,48,-5,40
St Mirren,221,9,9,13,14,41,52,-11,40
Ayr,221,10,7,14,15,35,55,-20,35
Hibernian,222,1,20,11,5,55,24,31,71
Dundee Utd,222,2,17,11,8,58,42,16,62
Falkirk,222,3,17,9,10,60,41,19,60
Morton,222,4,17,9,10,53,46,7,60
Queen of S't,222,5,13,9,14,46,50,-4,48
Dunfermline,222,6,10,12,14,48,49,-1,42
Dumbarton,222,7,10,10,16,50,61,-11,40
Raith,222,8,9,10,17,36,49,-13,37
St Mirren,222,9,8,11,17,44,60,-16,35
Ayr,222,10,7,12,17,35,63,-28,33
Hibernian,223,1,21,12,3,59,23,36,75
Morton,223,2,19,10,7,52,32,20,67
Falkirk,223,3,16,12,8,53,35,18,60
Dundee Utd,223,4,15,10,11,46,39,7,55
Dumbarton,223,5,10,12,14,49,54,-5,42
Ayr,223,6,10,11,15,33,53,-20,41
Dunfermline,223,7,8,14,14,44,52,-8,38
Queen of S't,223,8,9,11,16,39,50,-11,38
Raith,223,9,9,10,17,30,47,-17,37
St Mirren,223,10,7,10,19,36,56,-20,31
Hibernian,224,1,19,13,4,56,26,30,70
Falkirk,224,2,17,11,8,59,39,20,62
Morton,224,3,16,13,7,49,34,15,61
Dundee Utd,224,4,16,11,9,52,37,15,59
Queen of S't,224,5,12,8,16,45,51,-6,44
Raith,224,6,10,10,16,32,46,-14,40
Ayr,224,7,10,10,16,32,54,-22,40
Dunfermline,224,8,8,14,14,46,53,-7,38
St Mirren,224,9,9,11,16,41,53,-12,38
Dumbarton,224,10,7,11,18,44,63,-19,32
Hibernian,225,1,20,11,5,57,28,29,71
Morton,225,2,17,9,10,50,40,10,60
Falkirk,225,3,15,13,8,60,41,19,58
Dundee Utd,225,4,15,11,10,51,43,8,56
Queen of S't,225,5,11,10,15,44,53,-9,43
Dumbarton,225,6,10,12,14,47,55,-8,42
Dunfermline,225,7,9,14,13,47,48,-1,41
Ayr,225,8,9,14,13,35,51,-16,41
Raith,225,9,10,10,16,39,51,-12,40
St Mirren,225,10,7,10,19,36,56,-20,31
Hibernian,226,1,20,12,4,58,24,34,72
Dundee Utd,226,2,18,10,8,52,38,14,64
Morton,226,3,16,13,7,49,37,12,61
Falkirk,226,4,16,12,8,60,40,20,60
Queen of S't,226,5,11,10,15,40,50,-10,43
Raith,226,6,10,11,15,36,46,-10,41
Dunfermline,226,7,8,14,14,46,50,-4,38
Dumbarton,226,8,8,12,16,44,59,-15,36
Ayr,226,9,8,11,17,35,54,-19,35
St Mirren,226,10,8,9,19,36,58,-22,33
Hibernian,227,1,19,12,5,53,25,28,69
Dundee Utd,227,2,17,11,8,56,36,20,62
Morton,227,3,16,12,8,48,35,13,60
Falkirk,227,4,16,11,9,55,39,16,59
Queen of S't,227,5,13,9,14,45,47,-2,48
Dunfermline,227,6,10,13,13,44,47,-3,43
Raith,227,7,10,11,15,32,44,-12,41
St Mirren,227,8,9,9,18,40,58,-18,36
Dumbarton,227,9,7,12,17,43,61,-18,33
Ayr,227,10,6,14,16,31,55,-24,32
Hibernian,228,1,19,11,6,55,25,30,68
Morton,228,2,18,10,8,52,33,19,64
Dundee Utd,228,3,15,10,11,56,49,7,55
Falkirk,228,4,14,12,10,53,43,10,54
Dunfermline,228,5,11,12,13,50,49,1,45
Raith,228,6,11,11,14,34,44,-10,44
Queen of S't,228,7,10,11,15,44,51,-7,41
Dumbarton,228,8,9,13,14,48,58,-10,40
St Mirren,228,9,9,12,15,44,56,-12,39
Ayr,228,10,7,12,17,31,59,-28,33
Hibernian,229,1,19,12,5,56,29,27,69
Dundee Utd,229,2,17,9,10,50,38,12,60
Morton,229,3,16,10,10,51,42,9,58
Falkirk,229,4,15,11,10,57,41,16,56
Queen of S't,229,5,12,9,15,45,49,-4,45
Raith,229,6,10,11,15,39,50,-11,41
Dumbarton,229,7,10,11,15,48,61,-13,41
St Mirren,229,8,9,12,15,42,53,-11,39
Ayr,229,9,9,12,15,37,54,-17,39
Dunfermline,229,10,7,15,14,41,49,-8,36
Hibernian,230,1,21,11,4,57,23,34,74
Morton,230,2,18,12,6,51,35,16,66
Dundee Utd,230,3,16,10,10,54,40,14,58
Falkirk,230,4,14,10,12,54,45,9,52
Raith,230,5,13,8,15,41,48,-7,47
Dumbarton,230,6,10,13,13,48,56,-8,43
Queen of S't,230,7,10,10,16,42,49,-7,40
Dunfermline,230,8,9,11,16,42,51,-9,38
St Mirren,230,9,8,11,17,37,56,-19,35
Ayr,230,10,6,14,16,32,55,-23,32
Hibernian,231,1,18,13,5,56,26,30,67
Morton,231,2,17,11,8,51,36,15,62
Dundee Utd,231,3,14,14,8,47,36,11,56
Falkirk,231,4,14,12,10,56,43,13,54
Dunfermline,231,5,11,13,12,48,47,1,46
Queen of S't,231,6,11,12,13,42,48,-6,45
St Mirren,231,7,11,10,15,47,56,-9,43
Dumbarton,231,8,10,11,15,45,54,-9,41
Raith,231,9,8,10,18,34,57,-23,34
Ayr,231,10,6,14,16,31,54,-23,32
Hibernian,232,1,20,10,6,59,27,32,70
Morton,232,2,18,13,5,52,33,19,67
Falkirk,232,3,16,10,10,56,39,17,58
Dundee Utd,232,4,14,12,10,55,44,11,54
St Mirren,232,5,11,10,15,44,52,-8,43
Queen of S't,232,6,11,10,15,46,56,-10,43
Dunfermline,232,7,9,13,14,51,55,-4,40
Ayr,232,8,8,13,15,36,56,-20,37
Raith,232,9,9,10,17,33,53,-20,37
Dumbarton,232,10,7,13,16,47,64,-17,34
Hibernian,233,1,22,10,4,58,24,34,76
Morton,233,2,19,9,8,53,37,16,66
Falkirk,233,3,15,11,10,55,42,13,56
Dundee Utd,233,4,15,10,11,47,42,5,55
Queen of S't,233,5,12,11,13,47,49,-2,47
Dunfermline,233,6,10,12,14,50,48,2,42
Raith,233,7,10,8,18,35,51,-16,38
Ayr,233,8,9,11,16,33,54,-21,38
Dumbarton,233,9,8,12,16,49,63,-14,36
St Mirren,233,10,8,10,18,44,61,-17,34
Hibernian,234,1,22,10,4,67,29,38,76
Dundee Utd,234,2,17,10,9,50,40,10,61
Morton,234,3,16,10,10,51,40,11,58
Falkirk,234,4,15,10,11,59,46,13,55
Queen of S't,234,5,12,10,14,45,51,-6,46
St Mirren,234,6,11,10,15,47,53,-6,43
Dunfermline,234,7,10,12,14,49,52,-3,42
Dumbarton,234,8,8,12,16,49,60,-11,36
Raith,234,9,9,9,18,32,55,-23,36
Ayr,234,10,8,11,17,33,56,-23,35
Hibernian,235,1,17,14,5,51,24,27,65
Morton,235,2,18,11,7,54,38,16,65
Dundee Utd,235,3,18,9,9,57,37,20,63
Falkirk,235,4,15,10,11,55,41,14,55
Dumbarton,235,5,11,10,15,55,64,-9,43
Dunfermline,235,6,9,15,12,42,47,-5,42
Raith,235,7,11,9,16,37,48,-11,42
Queen of S't,235,8,10,9,17,40,52,-12,39
Ayr,235,9,8,12,16,36,60,-24,36
St Mirren,235,10,8,11,17,43,59,-16,35
Hibernian,236,1,18,12,6,54,30,24,66
Morton,236,2,18,11,7,55,37,18,65
Dundee Utd,236,3,17,10,9,54,38,16,61
Falkirk,236,4,16,10,10,59,42,17,58
Queen of S't,236,5,12,10,14,46,50,-4,46
Dunfermline,236,6,11,12,13,46,46,0,45
Raith,236,7,10,9,17,33,50,-17,39
Ayr,236,8,9,12,15,38,58,-20,39
Dumbarton,236,9,8,11,17,46,65,-19,35
St Mirren,236,10,7,11,18,42,57,-15,32
Hibernian,237,1,19,12,5,57,28,29,69
Morton,237,2,18,11,7,54,37,17,65
Dundee Utd,237,3,17,10,9,51,40,11,61
Falkirk,237,4,16,12,8,61,44,17,60
Dunfermline,237,5,11,12,13,54,51,3,45
Raith,237,6,11,8,17,38,52,-14,41
Queen of S't,237,7,10,10,16,41,50,-9,40
Dumbarton,237,8,9,12,15,50,61,-11,39
Ayr,237,9,7,13,16,32,53,-21,34
St Mirren,237,10,7,10,19,38,60,-22,31
Hibernian,238,1,17,13,6,51,26,25,64
Morton,238,2,16,12,8,49,38,11,60
Dundee Utd,238,3,16,9,11,51,42,9,57
Falkirk,238,4,15,11,10,56,41,15,56
Queen of S't,238,5,12,11,13,47,47,0,47
Dunfermline,238,6,10,13,13,44,49,-5,43
Raith,238,7,10,11,15,36,49,-13,41
Dumbarton,238,8,9,13,14,49,59,-10,40
Ayr,238,9,8,13,15,38,55,-17,37
St Mirren,238,10,8,12,16,39,54,-15,36
Hibernian,239,1,20,11,5,60,27,33,71
Morton,239,2,16,11,9,48,39,9,59
Falkirk,239,3,16,9,11,60,43,17,57
Dundee Utd,239,4,16,9,11,49,39,10,57
Queen of S't,239,5,12,9,15,43,53,-10,45
Dumbarton,239,6,10,13,13,56,58,-2,43
Dunfermline,239,7,9,15,12,49,48,1,42
Raith,239,8,9,11,16,33,50,-17,38
Ayr,239,9,8,13,15,33,55,-22,37
St Mirren,239,10,8,11,17,40,59,-19,35
Hibernian,240,1,19,12,5,57,28,29,69
Falkirk,240,2,16,13,7,63,39,24,61
Dundee Utd,240,3,16,11,9,49,38,11,59
Morton,240,4,16,11,9,50,40,10,59
Queen of S't,240,5,13,9,14,48,51,-3,48
Raith,240,6,10,10,16,34,50,-16,40
Dunfermline,240,7,9,12,15,45,51,-6,39
Ayr,240,8,9,11,16,39,57,-18,38
Dumbarton,240,9,8,12,16,49,61,-12,36
St Mirren,240,10,8,11,17,39,58,-19,35
Hibernian,241,1,18,13,5,56,27,29,67
Morton,241,2,16,12,8,49,37,12,60
Dundee Utd,241,3,17,8,11,49,37,12,59
Falkirk,241,4,16,10,10,60,44,16,58
Dunfermline,241,5,13,12,11,53,49,4,51
Queen of S't,241,6,12,9,15,46,51,-5,45
Dumbarton,241,7,10,10,16,53,61,-8,40
Ayr,241,8,9,11,16,35,57,-22,38
St Mirren,241,9,8,11,17,42,59,-17,35
Raith,241,10,9,8,19,34,55,-21,35
Hibernian,242,1,17,14,5,53,26,27,65
Morton,242,2,17,12,7,50,34,16,63
Falkirk,242,3,15,11,10,59,43,16,56
Dundee Utd,242,4,15,9,12,49,43,6,54
Queen of S't,242,5,14,9,13,48,45,3,51
Raith,242,6,11,11,14,39,47,-8,44
Ayr,242,7,10,12,14,36,56,-20,42
Dumbarton,242,8,9,11,16,49,60,-11,38
St Mirren,242,9,8,13,15,40,56,-16,37
Dunfermline,242,10,7,12,17,38,51,-13,33
Hibernian,243,1,20,11,5,57,27,30,71
Morton,243,2,15,12,9,49,43,6,57
Dundee Utd,243,3,15,11,10,50,37,13,56
Falkirk,243,4,13,11,12,51,44,7,50
Ayr,243,5,11,12,13,36,48,-12,45
Queen of S't,243,6,11,11,14,44,50,-6,44
Raith,243,7,11,9,16,41,48,-7,42
St Mirren,243,8,10,11,15,42,52,-10,41
Dumbarton,243,9,10,11,15,45,57,-12,41
Dunfermline,243,10,7,15,14,42,51,-9,36
Morton,244,1,20,10,6,54,30,24,70
Hibernian,244,2,19,12,5,58,29,29,69
Falkirk,244,3,16,11,9,59,42,17,59
Dundee Utd,244,4,16,8,12,49,40,9,56
Queen of S't,244,5,11,12,13,44,47,-3,45
Dumbarton,244,6,10,11,15,49,58,-9,41
Raith,244,7,10,10,16,31,48,-17,40
Ayr,244,8,9,11,16,32,53,-21,38
Dunfermline,244,9,8,12,16,41,53,-12,36
St Mirren,244,10,8,9,19,42,59,-17,33
Hibernian,245,1,18,13,5,56,26,30,67
Morton,245,2,18,12,6,52,34,18,66
Dundee Utd,245,3,18,9,9,54,39,15,63
Falkirk,245,4,15,11,10,54,39,15,56
Dunfermline,245,5,10,14,12,47,49,-2,44
Queen of S't,245,6,11,10,15,45,49,-4,43
St Mirren,245,7,10,9,17,42,56,-14,39
Raith,245,8,10,8,18,33,52,-19,38
Dumbarton,245,9,8,12,16,45,61,-16,36
Ayr,245,10,7,12,17,34,57,-23,33
Hibernian,246,1,21,10,5,60,28,32,73
Morton,246,2,18,10,8,53,37,16,64
Falkirk,246,3,17,10,9,61,41,20,61
Dundee Utd,246,4,15,9,12,49,42,7,54
Dumbarton,246,5,12,11,13,54,56,-2,47
Queen of S't,246,6,11,10,15,45,49,-4,43
Raith,246,7,11,10,15,35,49,-14,43
Dunfermline,246,8,9,11,16,45,53,-8,38
Ayr,246,9,6,16,14,34,57,-23,34
St Mirren,246,10,6,11,19,36,60,-24,29
Hibernian,247,1,18,12,6,52,29,23,66
Morton,247,2,17,12,7,51,33,18,63
Falkirk,247,3,17,11,8,58,39,19,62
Dundee Utd,247,4,14,13,9,48,38,10,55
Queen of S't,247,5,11,11,14,45,48,-3,44
Dunfermline,247,6,9,14,13,44,47,-3,41
Raith,247,7,10,10,16,33,49,-16,40
Ayr,247,8,7,16,13,38,52,-14,37
Dumbarton,247,9,8,13,15,45,61,-16,37
St Mirren,247,10,6,14,16,36,54,-18,32
Hibernian,248,1,20,11,5,59,24,35,71
Morton,248,2,19,9,8,54,35,19,66
Dundee Utd,248,3,18,9,9,49,35,14,63
Falkirk,248,4,16,10,10,59,42,17,58
Dunfermline,248,5,10,13,13,44,49,-5,43
Queen of S't,248,6,11,8,17,43,54,-11,41
Raith,248,7,10,11,15,31,43,-12,41
Dumbarton,248,8,9,11,16,44,56,-12,38
St Mirren,248,9,9,10,17,42,55,-13,37
Ayr,248,10,7,10,19,30,62,-32,31
Hibernian,249,1,20,11,5,60,25,35,71
Morton,249,2,20,10,6,59,33,26,70
Falkirk,249,3,16,11,9,59,41,18,59
Dundee Utd,249,4,14,9,13,47,44,3,51
Queen of S't,249,5,12,9,15,42,47,-5,45
Dunfermline,249,6,10,14,12,49,48,1,44
St Mirren,249,7,10,9,17,46,58,-12,39
Dumbarton,249,8,9,11,16,43,60,-17,38
Raith,249,9,10,8,18,32,53,-21,38
Ayr,249,10,7,12,17,31,59,-28,33
Hibernian,250,1,19,13,4,56,25,31,70
Morton,250,2,18,11,7,52,35,17,65
Dundee Utd,250,3,16,9,11,52,41,11,57
Falkirk,250,4,15,10,11,58,42,16,55
Queen of S't,250,5,13,9,14,48,48,0,48
Dunfermline,250,6,9,14,13,47,50,-3,41
Raith,250,7,11,8,17,36,55,-19,41
St Mirren,250,8,9,11,16,41,55,-14,38
Ayr,250,9,9,11,16,34,56,-22,38
Dumbarton,250,10,7,12,17,41,58,-17,33
Hibernian,251,1,19,13,4,58,25,33,70
Dundee Utd,251,2,17,9,10,50,38,12,60
Morton,251,3,16,11,9,45,37,8,59
Falkirk,251,4,16,10,10,58,42,16,58
Queen of S't,251,5,12,9,15,48,52,-4,45
Dunfermline,251,6,9,17,10,42,42,0,44
Raith,251,7,10,10,16,33,45,-12,40
Ayr,251,8,9,10,17,35,56,-21,37
Dumbarton,251,9,8,12,16,48,65,-17,36
St Mirren,251,10,8,11,17,41,56,-15,35
Hibernian,252,1,17,13,6,50,27,23,64
Falkirk,252,2,16,11,9,58,39,19,59
Morton,252,3,15,12,9,46,35,11,57
Dundee Utd,252,4,15,11,10,46,39,7,56
Queen of S't,252,5,13,9,14,50,49,1,48
Dunfermline,252,6,11,12,13,50,52,-2,45
Raith,252,7,11,9,16,34,47,-13,42
Ayr,252,8,9,12,15,34,53,-19,39
Dumbarton,252,9,9,11,16,47,60,-13,38
St Mirren,252,10,8,12,16,41,55,-14,36
Hibernian,253,1,18,14,4,52,24,28,68
Morton,253,2,18,10,8,57,37,20,64
Dundee Utd,253,3,17,10,9,52,38,14,61
Falkirk,253,4,16,11,9,59,41,18,59
Dumbarton,253,5,11,10,15,51,58,-7,43
Raith,253,6,10,11,15,41,50,-9,41
Dunfermline,253,7,8,15,13,45,49,-4,39
Ayr,253,8,9,12,15,34,54,-20,39
Queen of S't,253,9,9,11,16,40,57,-17,38
St Mirren,253,10,6,12,18,36,59,-23,30
Hibernian,254,1,19,11,6,58,28,30,68
Morton,254,2,19,9,8,53,37,16,66
Falkirk,254,3,18,10,8,65,41,24,64
Dundee Utd,254,4,15,10,11,47,40,7,55
Dumbarton,254,5,10,13,13,49,54,-5,43
Ayr,254,6,10,12,14,34,49,-15,42
Dunfermline,254,7,9,13,14,45,51,-6,40
Queen of S't,254,8,9,11,16,42,52,-10,38
Raith,254,9,9,10,17,32,50,-18,37
St Mirren,254,10,8,9,19,36,59,-23,33
Hibernian,255,1,18,14,4,55,28,27,68
Morton,255,2,19,10,7,55,36,19,67
Falkirk,255,3,15,11,10,57,43,14,56
Dundee Utd,255,4,14,11,11,48,44,4,53
Queen of S't,255,5,11,12,13,48,47,1,45
Raith,255,6,9,14,13,40,50,-10,41
Dunfermline,255,7,9,12,15,45,55,-10,39
Dumbarton,255,8,8,14,14,45,55,-10,38
St Mirren,255,9,8,12,16,40,54,-14,36
Ayr,255,10,7,14,15,35,56,-21,35
Hibernian,256,1,20,11,5,59,30,29,71
Falkirk,256,2,18,11,7,61,38,23,65
Morton,256,3,16,13,7,53,39,14,61
Dundee Utd,256,4,16,11,9,48,37,11,59
Dunfermline,256,5,9,15,12,44,45,-1,42
Queen of S't,256,6,10,11,15,43,50,-7,41
Dumbarton,256,7,8,13,15,45,58,-13,37
Raith,256,8,9,10,17,36,52,-16,37
Ayr,256,9,8,13,15,36,56,-20,37
St Mirren,256,10,7,10,19,38,58,-20,31
Hibernian,257,1,22,10,4,59,24,35,76
Falkirk,257,2,16,10,10,57,40,17,58
Dundee Utd,257,3,15,11,10,52,39,13,56
Morton,257,4,15,11,10,46,39,7,56
Dumbarton,257,5,11,12,13,53,56,-3,45
Queen of S't,257,6,11,10,15,42,50,-8,43
Dunfermline,257,7,9,13,14,45,54,-9,40
Ayr,257,8,9,13,14,33,51,-18,40
Raith,257,9,9,11,16,34,47,-13,38
St Mirren,257,10,6,13,17,35,56,-21,31
Hibernian,258,1,20,12,4,62,25,37,72
Dundee Utd,258,2,19,9,8,54,37,17,66
Falkirk,258,3,14,13,9,55,42,13,55
Morton,258,4,15,10,11,47,36,11,55
Queen of S't,258,5,12,11,13,47,48,-1,47
Dunfermline,258,6,10,12,14,43,50,-7,42
Dumbarton,258,7,10,11,15,50,56,-6,41
Ayr,258,8,10,11,15,36,56,-20,41
Raith,258,9,9,9,18,34,52,-18,36
St Mirren,258,10,7,10,19,36,62,-26,31
Hibernian,259,1,19,13,4,58,24,34,70
Dundee Utd,259,2,18,9,9,55,39,16,63
Falkirk,259,3,17,9,10,58,38,20,60
Morton,259,4,16,11,9,50,37,13,59
Queen of S't,259,5,11,9,16,43,51,-8,42
Ayr,259,6,9,13,14,33,52,-19,40
Raith,259,7,10,9,17,34,52,-18,39
Dunfermline,259,8,8,14,14,46,56,-10,38
St Mirren,259,9,9,11,16,43,59,-16,38
Dumbarton,259,10,8,12,16,45,57,-12,36
Hibernian,260,1,20,11,5,58,29,29,71
Morton,260,2,16,11,9,53,39,14,59
Dundee Utd,260,3,15,12,9,56,39,17,57
Falkirk,260,4,15,11,10,56,41,15,56
Queen of S't,260,5,12,10,14,50,50,0,46
Ayr,260,6,11,11,14,37,53,-16,44
Dunfermline,260,7,9,14,13,42,53,-11,41
Dumbarton,260,8,8,13,15,45,61,-16,37
St Mirren,260,9,8,12,16,39,52,-13,36
Raith,260,10,9,9,18,33,52,-19,36
Hibernian,261,1,18,14,4,57,27,30,68
Falkirk,261,2,16,10,10,61,45,16,58
Dundee Utd,261,3,15,13,8,49,36,13,58
Morton,261,4,14,13,9,45,35,10,55
Raith,261,5,12,9,15,38,49,-11,45
Dunfermline,261,6,10,14,12,49,46,3,44
Queen of S't,261,7,11,10,15,43,51,-8,43
Dumbarton,261,8,9,11,16,45,59,-14,38
Ayr,261,9,8,13,15,36,57,-21,37
St Mirren,261,10,8,11,17,41,59,-18,35
Hibernian,262,1,19,12,5,51,22,29,69
Morton,262,2,15,10,11,47,42,5,55
Falkirk,262,3,14,11,11,50,38,12,53
Dundee Utd,262,4,14,11,11,45,40,5,53
Dunfermline,262,5,11,14,11,46,44,2,47
Queen of S't,262,6,12,10,14,44,47,-3,46
Raith,262,7,12,10,14,36,44,-8,46
St Mirren,262,8,9,12,15,37,50,-13,39
Ayr,262,9,9,12,15,31,49,-18,39
Dumbarton,262,10,8,12,16,44,55,-11,36
Hibernian,263,1,17,14,5,57,30,27,65
Morton,263,2,17,12,7,49,34,15,63
Dundee Utd,263,3,17,9,10,47,40,7,60
Queen of S't,263,4,14,10,12,51,45,6,52
Falkirk,263,5,13,11,12,55,47,8,50
Dunfermline,263,6,9,15,12,45,47,-2,42
St Mirren,263,7,10,10,16,48,60,-12,40
Raith,263,8,9,13,14,36,48,-12,40
Dumbarton,263,9,8,14,14,50,60,-10,38
Ayr,263,10,6,12,18,33,60,-27,30
Hibernian,264,1,18,12,6,52,27,25,66
Falkirk,264,2,17,11,8,69,43,26,62
Morton,264,3,17,11,8,49,35,14,62
Dundee Utd,264,4,17,9,10,51,41,10,60
Dunfermline,264,5,10,12,14,48,54,-6,42
Queen of S't,264,6,10,10,16,46,55,-9,40
Ayr,264,7,8,15,13,38,50,-12,39
St Mirren,264,8,8,14,14,43,54,-11,38
Raith,264,9,9,10,17,33,55,-22,37
Dumbarton,264,10,8,12,16,48,63,-15,36
Hibernian,265,1,20,11,5,56,26,30,71
Morton,265,2,17,11,8,53,40,13,62
Dundee Utd,265,3,16,9,11,50,38,12,57
Falkirk,265,4,15,10,11,55,44,11,55
Dunfermline,265,5,12,12,12,48,42,6,48
Raith,265,6,11,9,16,36,52,-16,42
Queen of S't,265,7,11,8,17,44,57,-13,41
Ayr,265,8,10,11,15,38,53,-15,41
St Mirren,265,9,8,12,16,39,52,-13,36
Dumbarton,265,10,8,11,17,45,60,-15,35
Morton,266,1,19,10,7,55,39,16,67
Hibernian,266,2,15,15,6,51,31,20,60
Dundee Utd,266,3,17,9,10,59,43,16,60
Falkirk,266,4,14,12,10,58,46,12,54
Queen of S't,266,5,11,10,15,42,45,-3,43
Dunfermline,266,6,9,14,13,46,50,-4,41
Raith,266,7,10,11,15,37,50,-13,41
Dumbarton,266,8,9,13,14,51,61,-10,40
St Mirren,266,9,9,12,15,45,55,-10,39
Ayr,266,10,7,14,15,36,60,-24,35
Hibernian,267,1,19,12,5,55,24,31,69
Dundee Utd,267,2,19,8,9,60,39,21,65
Falkirk,267,3,18,10,8,59,36,23,64
Morton,267,4,17,9,10,50,44,6,60
Raith,267,5,11,9,16,39,52,-13,42
Queen of S't,267,6,11,8,17,45,56,-11,41
Dumbarton,267,7,9,11,16,47,62,-15,38
Dunfermline,267,8,8,13,15,44,55,-11,37
St Mirren,267,9,8,12,16,41,54,-13,36
Ayr,267,10,8,12,16,40,58,-18,36
Hibernian,268,1,19,13,4,52,23,29,70
Dundee Utd,268,2,17,8,11,53,42,11,59
Falkirk,268,3,15,11,10,55,41,14,56
Morton,268,4,15,11,10,49,40,9,56
Queen of S't,268,5,14,8,14,47,46,1,50
Dunfermline,268,6,9,13,14,44,51,-7,40
Raith,268,7,10,10,16,33,47,-14,40
Dumbarton,268,8,9,12,15,47,56,-9,39
St Mirren,268,9,8,13,15,43,56,-13,37
Ayr,268,10,8,13,15,34,55,-21,37
Hibernian,269,1,19,11,6,57,25,32,68
Morton,269,2,16,12,8,48,37,11,60
Dundee Utd,269,3,15,11,10,46,38,8,56
Falkirk,269,4,13,15,8,56,41,15,54
Queen of S't,269,5,12,11,13,43,49,-6,47
Dunfermline,269,6,10,13,13,47,48,-1,43
St Mirren,269,7,10,10,16,42,56,-14,40
Raith,269,8,9,12,15,32,50,-18,39
Ayr,269,9,9,11,16,36,52,-16,38
Dumbarton,269,10,8,12,16,45,56,-11,36
Hibernian,270,1,19,13,4,55,27,28,70
Dundee Utd,270,2,17,9,10,53,37,16,60
Morton,270,3,15,14,7,47,38,9,59
Falkirk,270,4,15,10,11,58,44,14,55
Queen of S't,270,5,12,9,15,45,50,-5,45
Dunfermline,270,6,10,13,13,44,48,-4,43
St Mirren,270,7,10,10,16,40,52,-12,40
Ayr,270,8,9,12,15,36,55,-19,39
Raith,270,9,9,10,17,34,49,-15,37
Dumbarton,270,10,8,12,16,45,57,-12,36
Hibernian,271,1,18,13,5,54,27,27,67
Falkirk,271,2,18,10,8,64,40,24,64
Morton,271,3,16,12,8,47,37,10,60
Dundee Utd,271,4,13,11,12,48,41,7,50
Dumbarton,271,5,11,11,14,50,53,-3,44
Ayr,271,6,10,13,13,34,50,-16,43
Dunfermline,271,7,9,15,12,48,48,0,42
Queen of S't,271,8,10,11,15,42,51,-9,41
St Mirren,271,9,9,10,17,38,58,-20,37
Raith,271,10,8,10,18,32,52,-20,34
Hibernian,272,1,19,11,6,59,29,30,68
Falkirk,272,2,16,13,7,63,40,23,61
Morton,272,3,16,13,7,52,38,14,61
Dundee Utd,272,4,15,10,11,46,41,5,55
Queen of S't,272,5,11,11,14,42,46,-4,44
Dunfermline,272,6,9,14,13,45,48,-3,41
Raith,272,7,10,11,15,32,48,-16,41
Dumbarton,272,8,8,14,14,46,58,-12,38
St Mirren,272,9,8,12,16,41,55,-14,36
Ayr,272,10,7,13,16,29,52,-23,34
Hibernian,273,1,19,13,4,58,24,34,70
Falkirk,273,2,16,13,7,58,37,21,61
Morton,273,3,16,12,8,47,38,9,60
Dundee Utd,273,4,14,10,12,46,41,5,52
Queen of S't,273,5,11,12,13,47,51,-4,45
Dunfermline,273,6,9,14,13,45,48,-3,41
Ayr,273,7,9,13,14,37,54,-17,40
Raith,273,8,9,11,16,33,51,-18,38
St Mirren,273,9,9,10,17,44,58,-14,37
Dumbarton,273,10,8,12,16,49,62,-13,36
Hibernian,274,1,18,12,6,52,29,23,66
Morton,274,2,17,11,8,51,35,16,62
Dundee Utd,274,3,15,11,10,51,40,11,56
Falkirk,274,4,13,13,10,53,43,10,52
Dunfermline,274,5,13,12,11,51,44,7,51
Queen of S't,274,6,10,12,14,45,51,-6,42
Dumbarton,274,7,9,13,14,46,53,-7,40
Raith,274,8,10,10,16,36,49,-13,40
Ayr,274,9,8,13,15,32,56,-24,37
St Mirren,274,10,7,13,16,36,53,-17,34
Hibernian,275,1,19,11,6,56,27,29,68
Morton,275,2,16,13,7,49,34,15,61
Dundee Utd,275,3,16,10,10,53,37,16,58
Falkirk,275,4,14,10,12,51,40,11,52
Raith,275,5,13,8,15,39,47,-8,47
Dunfermline,275,6,10,14,12,45,45,0,44
St Mirren,275,7,10,11,15,43,54,-11,41
Dumbarton,275,8,9,13,14,44,57,-13,40
Queen of S't,275,9,10,9,17,41,54,-13,39
Ayr,275,10,8,11,17,33,59,-26,35
Morton,276,1,19,11,6,55,33,22,68
Hibernian,276,2,18,12,6,54,28,26,66
Dundee Utd,276,3,17,8,11,51,41,10,59
Falkirk,276,4,16,10,10,65,42,23,58
Queen of S't,276,5,13,10,13,47,47,0,49
Dunfermline,276,6,9,16,11,47,45,2,43
Raith,276,7,10,11,15,35,48,-13,41
St Mirren,276,8,9,10,17,39,58,-19,37
Dumbarton,276,9,8,11,17,42,67,-25,35
Ayr,276,10,6,11,19,32,58,-26,29
Morton,277,1,20,11,5,51,30,21,71
Hibernian,277,2,19,13,4,57,25,32,70
Dundee Utd,277,3,17,9,10,53,37,16,60
Falkirk,277,4,16,11,9,59,43,16,59
Queen of S't,277,5,12,10,14,46,49,-3,46
Dunfermline,277,6,10,11,15,50,52,-2,41
Ayr,277,7,9,11,16,38,56,-18,38
Dumbarton,277,8,8,12,16,45,65,-20,36
Raith,277,9,8,9,19,36,58,-22,33
St Mirren,277,10,7,11,18,43,63,-20,32
Hibernian,278,1,18,12,6,52,28,24,66
Morton,278,2,17,12,7,48,34,14,63
Falkirk,278,3,15,10,11,64,48,16,55
Dundee Utd,278,4,14,10,12,47,42,5,52
Queen of S't,278,5,14,9,13,48,50,-2,51
Raith,278,6,14,8,14,41,46,-5,50
Ayr,278,7,9,13,14,38,54,-16,40
Dunfermline,278,8,9,11,16,49,55,-6,38
Dumbarton,278,9,9,11,16,50,60,-10,38
St Mirren,278,10,8,10,18,38,58,-20,34
Hibernian,279,1,20,12,4,59,27,32,72
Falkirk,279,2,19,9,8,63,36,27,66
Morton,279,3,16,12,8,51,39,12,60
Dundee Utd,279,4,13,13,10,50,43,7,52
Queen of S't,279,5,12,9,15,57,58,-1,45
Dunfermline,279,6,9,12,15,41,53,-12,39
St Mirren,279,7,9,12,15,38,50,-12,39
Dumbarton,279,8,8,13,15,48,61,-13,37
Ayr,279,9,8,13,15,33,55,-22,37
Raith,279,10,8,11,17,33,51,-18,35
Hibernian,280,1,20,12,4,60,23,37,72
Morton,280,2,17,11,8,51,36,15,62
Dundee Utd,280,3,17,10,9,54,40,14,61
Falkirk,280,4,14,12,10,55,43,12,54
Raith,280,5,10,12,14,37,48,-11,42
Queen of S't,280,6,10,10,16,42,54,-12,40
Ayr,280,7,10,10,16,35,53,-18,40
Dunfermline,280,8,9,12,15,46,56,-10,39
Dumbarton,280,9,9,12,15,50,62,-12,39
St Mirren,280,10,8,11,17,43,58,-15,35
Hibernian,281,1,21,10,5,59,25,34,73
Morton,281,2,16,11,9,47,38,9,59
Falkirk,281,3,16,10,10,58,39,19,58
Dundee Utd,281,4,14,10,12,48,43,5,52
Dunfermline,281,5,11,11,14,45,47,-2,44
Dumbarton,281,6,11,11,14,50,58,-8,44
Queen of S't,281,7,11,11,14,40,49,-9,44
Raith,281,8,10,10,16,37,50,-13,40
St Mirren,281,9,8,12,16,40,54,-14,36
Ayr,281,10,8,12,16,36,57,-21,36
Hibernian,282,1,20,11,5,56,26,30,71
Morton,282,2,16,11,9,52,43,9,59
Falkirk,282,3,16,10,10,58,43,15,58
Dundee Utd,282,4,16,9,11,50,40,10,57
Queen of S't,282,5,12,10,14,45,50,-5,46
Dunfermline,282,6,9,14,13,48,52,-4,41
Raith,282,7,10,10,16,36,48,-12,40
St Mirren,282,8,10,9,17,48,57,-9,39
Dumbarton,282,9,9,12,15,47,58,-11,39
Ayr,282,10,9,10,17,37,60,-23,37
Hibernian,283,1,19,11,6,50,25,25,68
Dundee Utd,283,2,17,10,9,54,37,17,61
Morton,283,3,17,10,9,51,36,15,61
Falkirk,283,4,14,13,9,52,37,15,55
Dumbarton,283,5,11,12,13,51,53,-2,45
Dunfermline,283,6,10,12,14,45,52,-7,42
Ayr,283,7,10,11,15,38,55,-17,41
Queen of S't,283,8,10,9,17,44,56,-12,39
Raith,283,9,9,10,17,31,47,-16,37
St Mirren,283,10,9,10,17,44,62,-18,37
Hibernian,284,1,18,13,5,54,28,26,67
Dundee Utd,284,2,18,9,9,58,38,20,63
Falkirk,284,3,16,11,9,58,43,15,59
Morton,284,4,15,14,7,48,34,14,59
Dunfermline,284,5,12,12,12,54,52,2,48
Queen of S't,284,6,11,9,16,47,54,-7,42
Dumbarton,284,7,9,11,16,53,69,-16,38
Ayr,284,8,8,14,14,38,56,-18,38
Raith,284,9,8,12,16,34,51,-17,36
St Mirren,284,10,7,11,18,40,59,-19,32
Hibernian,285,1,18,11,7,54,27,27,65
Morton,285,2,17,11,8,50,40,10,62
Falkirk,285,3,16,10,10,58,43,15,58
Dundee Utd,285,4,14,10,12,49,45,4,52
Dunfermline,285,5,12,13,11,50,44,6,49
Queen of S't,285,6,11,11,14,46,49,-3,44
Dumbarton,285,7,10,11,15,47,57,-10,41
Raith,285,8,10,9,17,38,53,-15,39
Ayr,285,9,9,12,15,35,55,-20,39
St Mirren,285,10,8,12,16,38,52,-14,36
Hibernian,286,1,18,14,4,55,28,27,68
Morton,286,2,17,10,9,53,41,12,61
Falkirk,286,3,16,11,9,58,39,19,59
Dundee Utd,286,4,16,8,12,50,40,10,56
Dunfermline,286,5,12,13,11,51,46,5,49
Dumbarton,286,6,10,11,15,49,61,-12,41
Ayr,286,7,10,11,15,36,54,-18,41
Queen of S't,286,8,10,10,16,42,53,-11,40
Raith,286,9,10,9,17,37,50,-13,39
St Mirren,286,10,7,11,18,35,54,-19,32
Hibernian,287,1,21,12,3,57,22,35,75
Morton,287,2,16,10,10,50,38,12,58
Falkirk,287,3,15,12,9,57,40,17,57
Dundee Utd,287,4,15,9,12,52,44,8,54
Raith,287,5,11,11,14,39,47,-8,44
Dunfermline,287,6,10,12,14,46,53,-7,42
Queen of S't,287,7,10,10,16,41,50,-9,40
St Mirren,287,8,10,10,16,43,53,-10,40
Dumbarton,287,9,10,10,16,47,59,-12,40
Ayr,287,10,9,10,17,34,60,-26,37
Hibernian,288,1,19,13,4,59,28,31,70
Morton,288,2,17,10,9,53,39,14,61
Falkirk,288,3,16,10,10,58,42,16,58
Dundee Utd,288,4,15,12,9,49,38,11,57
Raith,288,5,11,10,15,37,51,-14,43
Dunfermline,288,6,9,15,12,44,47,-3,42
Dumbarton,288,7,9,13,14,50,56,-6,40
Queen of S't,288,8,9,11,16,44,57,-13,38
Ayr,288,9,7,16,13,35,52,-17,37
St Mirren,288,10,7,12,17,38,57,-19,33
Hibernian,289,1,19,12,5,59,28,31,69
Falkirk,289,2,16,10,10,57,43,14,58
Dundee Utd,289,3,15,11,10,53,38,15,56
Morton,289,4,14,14,8,47,40,7,56
Queen of S't,289,5,14,8,14,50,51,-1,50
Dunfermline,289,6,12,12,12,50,45,5,48
Raith,289,7,10,9,17,34,48,-14,39
St Mirren,289,8,10,9,17,42,57,-15,39
Ayr,289,9,8,13,15,39,56,-17,37
Dumbarton,289,10,7,12,17,43,68,-25,33
Hibernian,290,1,18,12,6,53,26,27,66
Morton,290,2,18,12,6,54,34,20,66
Falkirk,290,3,16,11,9,54,36,18,59
Dundee Utd,290,4,15,10,11,48,42,6,55
Dunfermline,290,5,11,14,11,45,43,2,47
Queen of S't,290,6,10,12,14,42,49,-7,42
St Mirren,290,7,10,9,17,37,50,-13,39
Ayr,290,8,9,11,16,35,57,-22,38
Dumbarton,290,9,8,12,16,46,58,-12,36
Raith,290,10,9,9,18,32,51,-19,36
Hibernian,291,1,20,13,3,61,26,35,73
Dundee Utd,291,2,18,9,9,57,40,17,63
Falkirk,291,3,17,10,9,56,40,16,61
Morton,291,4,15,11,10,49,41,8,56
Queen of S't,291,5,11,12,13,48,49,-1,45
Raith,291,6,12,9,15,40,46,-6,45
Dunfermline,291,7,9,13,14,44,50,-6,40
Dumbarton,291,8,9,11,16,47,60,-13,38
Ayr,291,9,7,13,16,36,61,-25,34
St Mirren,291,10,7,9,20,41,66,-25,30
Hibernian,292,1,19,11,6,60,29,31,68
Morton,292,2,19,10,7,55,35,20,67
Falkirk,292,3,14,13,9,58,43,15,55
Dundee Utd,292,4,13,10,13,50,47,3,49
Queen of S't,292,5,13,9,14,45,51,-6,48
Ayr,292,6,11,11,14,37,53,-16,44
Dunfermline,292,7,10,13,13,48,48,0,43
Raith,292,8,9,11,16,37,52,-15,38
Dumbarton,292,9,8,13,15,46,58,-12,37
St Mirren,292,10,9,9,18,41,61,-20,36
Hibernian,293,1,19,12,5,58,27,31,69
Morton,293,2,17,14,5,57,36,21,65
Falkirk,293,3,17,10,9,55,37,18,61
Dundee Utd,293,4,14,12,10,51,43,8,54
Dumbarton,293,5,10,12,14,51,57,-6,42
Queen of S't,293,6,10,12,14,42,50,-8,42
Dunfermline,293,7,9,14,13,50,52,-2,41
Raith,293,8,9,11,16,34,53,-19,38
Ayr,293,9,8,13,15,37,59,-22,37
St Mirren,293,10,7,10,19,39,60,-21,31
Morton,294,1,17,12,7,53,36,17,63
Hibernian,294,2,16,14,6,53,29,24,62
Dundee Utd,294,3,16,10,10,50,40,10,58
Falkirk,294,4,15,12,9,55,41,14,57
Dunfermline,294,5,11,13,12,49,47,2,46
Queen of S't,294,6,12,10,14,48,52,-4,46
Raith,294,7,11,11,14,40,49,-9,44
Dumbarton,294,8,9,14,13,47,52,-5,41
Ayr,294,9,8,10,18,31,57,-26,34
St Mirren,294,10,7,10,19,39,62,-23,31
Falkirk,295,1,17,11,8,63,39,24,62
Hibernian,295,2,17,11,8,54,34,20,62
Dundee Utd,295,3,17,11,8,53,34,19,62
Morton,295,4,17,11,8,51,38,13,62
Queen of S't,295,5,11,10,15,44,51,-7,43
Dunfermline,295,6,10,12,14,44,49,-5,42
St Mirren,295,7,11,9,16,43,52,-9,42
Dumbarton,295,8,10,10,16,47,58,-11,40
Raith,295,9,9,10,17,31,49,-18,37
Ayr,295,10,8,11,17,33,59,-26,35
Hibernian,296,1,21,11,4,57,24,33,74
Falkirk,296,2,17,10,9,58,42,16,61
Dundee Utd,296,3,17,8,11,56,41,15,59
Morton,296,4,14,12,10,50,40,10,54
Dunfermline,296,5,11,12,13,52,49,3,45
Queen of S't,296,6,11,10,15,47,56,-9,43
Raith,296,7,11,9,16,37,50,-13,42
Dumbarton,296,8,9,11,16,49,61,-12,38
St Mirren,296,9,9,10,17,43,62,-19,37
Ayr,296,10,6,15,15,30,54,-24,33
Falkirk,297,1,18,10,8,57,36,21,64
Morton,297,2,17,12,7,49,38,11,63
Hibernian,297,3,17,11,8,46,28,18,62
Dundee Utd,297,4,16,9,11,55,46,9,57
Queen of S't,297,5,12,8,16,47,50,-3,44
Dunfermline,297,6,10,13,13,48,52,-4,43
Ayr,297,7,10,12,14,40,51,-11,42
Dumbarton,297,8,9,11,16,50,61,-11,38
St Mirren,297,9,9,11,16,39,51,-12,38
Raith,297,10,9,9,18,30,48,-18,36
Hibernian,298,1,21,12,3,60,24,36,75
Morton,298,2,17,11,8,53,40,13,62
Dundee Utd,298,3,17,8,11,49,42,7,59
Falkirk,298,4,14,14,8,57,41,16,56
Queen of S't,298,5,11,11,14,48,50,-2,44
Dumbarton,298,6,10,10,16,51,63,-12,40
Raith,298,7,10,10,16,38,51,-13,40
Dunfermline,298,8,8,13,15,44,52,-8,37
St Mirren,298,9,9,10,17,40,54,-14,37
Ayr,298,10,8,11,17,33,56,-23,35
Hibernian,299,1,20,12,4,55,23,32,72
Dundee Utd,299,2,17,9,10,55,40,15,60
Morton,299,3,16,10,10,48,37,11,58
Falkirk,299,4,16,9,11,61,51,10,57
Dunfermline,299,5,11,13,12,50,46,4,46
Queen of S't,299,6,12,8,16,48,53,-5,44
Raith,299,7,11,11,14,36,45,-9,44
Dumbarton,299,8,9,12,15,48,59,-11,39
St Mirren,299,9,8,10,18,43,61,-18,34
Ayr,299,10,7,12,17,33,62,-29,33
Hibernian,300,1,20,11,5,56,27,29,71
Morton,300,2,18,10,8,56,38,18,64
Dundee Utd,300,3,18,8,10,55,37,18,62
Falkirk,300,4,16,10,10,58,43,15,58
Dunfermline,300,5,11,12,13,50,49,1,45
Queen of S't,300,6,11,9,16,42,51,-9,42
Raith,300,7,10,10,16,37,52,-15,40
Ayr,300,8,9,10,17,35,57,-22,37
Dumbarton,300,9,8,11,17,49,64,-15,35
St Mirren,300,10,8,11,17,39,59,-20,35
Hibernian,301,1,20,11,5,59,28,31,71
Morton,301,2,17,10,9,52,39,13,61
Falkirk,301,3,16,10,10,56,41,15,58
Dundee Utd,301,4,14,9,13,50,50,0,51
Dunfermline,301,5,12,12,12,47,45,2,48
Queen of S't,301,6,11,9,16,44,52,-8,42
Ayr,301,7,10,12,14,42,60,-18,42
Dumbarton,301,8,10,11,15,52,56,-4,41
St Mirren,301,9,10,9,17,43,56,-13,39
Raith,301,10,9,9,18,33,51,-18,36
Hibernian,302,1,21,11,4,63,25,38,74
Dundee Utd,302,2,17,10,9,47,35,12,61
Morton,302,3,15,14,7,47,37,10,59
Falkirk,302,4,15,11,10,53,38,15,56
Queen of S't,302,5,12,9,15,43,45,-2,45
Raith,302,6,12,9,15,35,47,-12,45
Dunfermline,302,7,11,11,14,45,47,-2,44
Dumbarton,302,8,8,12,16,47,58,-11,36
St Mirren,302,9,7,11,18,40,61,-21,32
Ayr,302,10,6,14,16,34,61,-27,32
Hibernian,303,1,19,12,5,55,28,27,69
Morton,303,2,19,9,8,55,35,20,66
Falkirk,303,3,17,10,9,65,41,24,61
Dundee Utd,303,4,16,11,9,52,42,10,59
Queen of S't,303,5,12,9,15,45,53,-8,45
St Mirren,303,6,11,10,15,45,52,-7,43
Raith,303,7,10,9,17,36,51,-15,39
Dunfermline,303,8,8,12,16,47,59,-12,36
Ayr,303,9,8,12,16,32,55,-23,36
Dumbarton,303,10,8,10,18,46,62,-16,34
Hibernian,304,1,17,13,6,55,29,26,64
Morton,304,2,18,10,8,49,38,11,64
Falkirk,304,3,17,10,9,59,40,19,61
Dundee Utd,304,4,17,9,10,52,39,13,60
Queen of S't,304,5,12,10,14,44,48,-4,46
St Mirren,304,6,11,10,15,44,52,-8,43
Dunfermline,304,7,9,12,15,44,52,-8,39
Raith,304,8,9,11,16,34,48,-14,38
Dumbarton,304,9,9,10,17,47,62,-15,37
Ayr,304,10,8,11,17,33,53,-20,35
Hibernian,305,1,18,12,6,50,26,24,66
Morton,305,2,18,12,6,54,35,19,66
Falkirk,305,3,16,11,9,61,44,17,59
Dundee Utd,305,4,16,10,10,53,44,9,58
Ayr,305,5,11,12,13,38,51,-13,45
Queen of S't,305,6,12,8,16,45,50,-5,44
Dumbarton,305,7,10,10,16,50,58,-8,40
Dunfermline,305,8,8,14,14,44,52,-8,38
St Mirren,305,9,9,9,18,47,61,-14,36
Raith,305,10,9,8,19,32,53,-21,35
Hibernian,306,1,19,11,6,61,27,34,68
Falkirk,306,2,17,9,10,59,41,18,60
Dundee Utd,306,3,17,8,11,49,41,8,59
Morton,306,4,16,10,10,48,38,10,58
Dunfermline,306,5,11,13,12,47,49,-2,46
St Mirren,306,6,11,10,15,45,52,-7,43
Queen of S't,306,7,11,10,15,42,54,-12,43
Dumbarton,306,8,9,11,16,44,57,-13,38
Raith,306,9,9,10,17,35,52,-17,37
Ayr,306,10,9,10,17,36,55,-19,37
Morton,307,1,19,12,5,53,32,21,69
Hibernian,307,2,17,12,7,51,34,17,63
Falkirk,307,3,17,10,9,58,38,20,61
Dundee Utd,307,4,15,10,11,56,44,12,55
St Mirren,307,5,11,10,15,47,52,-5,43
Dunfermline,307,6,9,13,14,47,50,-3,40
Queen of S't,307,7,10,10,16,41,52,-11,40
Dumbarton,307,8,9,11,16,44,58,-14,38
Raith,307,9,9,11,16,33,49,-16,38
Ayr,307,10,8,13,15,35,56,-21,37
Hibernian,308,1,20,12,4,61,27,34,72
Morton,308,2,17,13,6,55,36,19,64
Dundee Utd,308,3,17,10,9,51,41,10,61
Falkirk,308,4,14,12,10,59,45,14,54
Dumbarton,308,5,11,11,14,53,57,-4,44
Queen of S't,308,6,11,10,15,44,51,-7,43
Dunfermline,308,7,9,14,13,46,51,-5,41
Ayr,308,8,9,11,16,35,57,-22,38
Raith,308,9,9,10,17,34,52,-18,37
St Mirren,308,10,6,11,19,37,58,-21,29
Hibernian,309,1,19,11,6,56,30,26,68
Morton,309,2,19,10,7,53,35,18,67
Falkirk,309,3,17,11,8,60,41,19,62
Dundee Utd,309,4,15,9,12,50,43,7,54
Queen of S't,309,5,11,10,15,44,50,-6,43
Dunfermline,309,6,9,14,13,48,49,-1,41
Raith,309,7,10,10,16,36,51,-15,40
St Mirren,309,8,8,13,15,39,54,-15,37
Dumbarton,309,9,8,12,16,49,61,-12,36
Ayr,309,10,8,12,16,36,57,-21,36
Hibernian,310,1,19,11,6,57,23,34,68
Morton,310,2,18,12,6,51,31,20,66
Falkirk,310,3,18,10,8,61,37,24,64
Dundee Utd,310,4,15,11,10,46,35,11,56
Queen of S't,310,5,14,8,14,47,49,-2,50
Dumbarton,310,6,9,12,15,50,61,-11,39
Ayr,310,7,9,12,15,33,53,-20,39
Raith,310,8,8,11,17,33,52,-19,35
Dunfermline,310,9,7,13,16,37,54,-17,34
St Mirren,310,10,8,10,18,41,61,-20,34
Hibernian,311,1,18,15,3,54,25,29,69
Falkirk,311,2,16,13,7,59,37,22,61
Dundee Utd,311,3,16,11,9,57,43,14,59
Morton,311,4,16,11,9,51,39,12,59
Queen of S't,311,5,11,10,15,49,55,-6,43
St Mirren,311,6,10,10,16,44,60,-16,40
Raith,311,7,9,12,15,33,47,-14,39
Dunfermline,311,8,8,14,14,44,52,-8,38
Ayr,311,9,8,13,15,36,55,-19,37
Dumbarton,311,10,8,11,17,49,63,-14,35
Hibernian,312,1,18,12,6,55,33,22,66
Dundee Utd,312,2,17,10,9,54,40,14,61
Falkirk,312,3,17,9,10,62,42,20,60
Morton,312,4,15,14,7,51,36,15,59
Dunfermline,312,5,11,13,12,52,50,2,46
Queen of S't,312,6,12,8,16,47,56,-9,44
Ayr,312,7,10,11,15,37,57,-20,41
St Mirren,312,8,9,11,16,40,53,-13,38
Dumbarton,312,9,9,10,17,45,56,-11,37
Raith,312,10,9,8,19,37,57,-20,35
Hibernian,313,1,18,12,6,55,26,29,66
Morton,313,2,17,11,8,53,42,11,62
Falkirk,313,3,15,10,11,56,45,11,55
Queen of S't,313,4,15,9,12,48,44,4,54
Dundee Utd,313,5,13,11,12,48,42,6,50
Dunfermline,313,6,10,13,13,48,47,1,43
Dumbarton,313,7,11,10,15,48,62,-14,43
Raith,313,8,10,10,16,33,47,-14,40
St Mirren,313,9,9,12,15,47,53,-6,39
Ayr,313,10,8,10,18,31,59,-28,34
Hibernian,314,1,20,11,5,60,26,34,71
Dundee Utd,314,2,17,10,9,57,37,20,61
Morton,314,3,16,12,8,52,39,13,60
Falkirk,314,4,15,11,10,58,39,19,56
Queen of S't,314,5,13,8,15,49,48,1,47
Raith,314,6,12,9,15,42,51,-9,45
Dumbarton,314,7,9,13,14,50,63,-13,40
Ayr,314,8,9,12,15,35,53,-18,39
Dunfermline,314,9,8,13,15,42,61,-19,37
St Mirren,314,10,7,9,20,37,65,-28,30
Hibernian,315,1,22,11,3,59,26,33,77
Dundee Utd,315,2,17,8,11,49,36,13,59
Falkirk,315,3,15,11,10,56,44,12,56
Morton,315,4,15,9,12,46,41,5,54
Dunfermline,315,5,12,11,13,53,46,7,47
Queen of S't,315,6,12,9,15,45,52,-7,45
Dumbarton,315,7,10,11,15,47,54,-7,41
Raith,315,8,10,10,16,36,51,-15,40
Ayr,315,9,8,13,15,35,55,-20,37
St Mirren,315,10,7,11,18,38,59,-21,32
Hibernian,316,1,21,11,4,62,25,37,74
Morton,316,2,16,13,7,49,35,14,61
Dundee Utd,316,3,17,9,10,50,37,13,60
Falkirk,316,4,15,10,11,52,40,12,55
Dunfermline,316,5,11,12,13,50,51,-1,45
Queen of S't,316,6,11,12,13,44,45,-1,45
St Mirren,316,7,10,9,17,40,56,-16,39
Raith,316,8,9,10,17,30,50,-20,37
Dumbarton,316,9,8,12,16,51,63,-12,36
Ayr,316,10,7,12,17,32,58,-26,33
Hibernian,317,1,20,12,4,60,27,33,72
Morton,317,2,17,12,7,51,34,17,63
Falkirk,317,3,15,11,10,57,46,11,56
Dundee Utd,317,4,14,10,12,48,42,6,52
Queen of S't,317,5,14,8,14,52,51,1,50
St Mirren,317,6,11,11,14,45,52,-7,44
Raith,317,7,10,11,15,34,46,-12,41
Dunfermline,317,8,9,12,15,43,53,-10,39
Dumbarton,317,9,9,10,17,47,59,-12,37
Ayr,317,10,7,11,18,34,61,-27,32
Hibernian,318,1,19,12,5,59,25,34,69
Morton,318,2,18,11,7,51,37,14,65
Falkirk,318,3,15,13,8,54,36,18,58
Dundee Utd,318,4,16,9,11,49,41,8,57
Dunfermline,318,5,10,14,12,48,49,-1,44
St Mirren,318,6,10,11,15,43,53,-10,41
Queen of S't,318,7,10,10,16,43,57,-14,40
Dumbarton,318,8,9,12,15,49,58,-9,39
Raith,318,9,9,9,18,35,53,-18,36
Ayr,318,10,8,11,17,37,59,-22,35
Hibernian,319,1,21,12,3,56,20,36,75
Morton,319,2,16,12,8,48,36,12,60
Falkirk,319,3,16,10,10,59,41,18,58
Dundee Utd,319,4,16,10,10,49,38,11,58
Dunfermline,319,5,10,13,13,46,53,-7,43
Queen of S't,319,6,11,9,16,47,55,-8,42
Raith,319,7,9,12,15,35,48,-13,39
Ayr,319,8,8,13,15,36,53,-17,37
St Mirren,319,9,9,9,18,41,56,-15,36
Dumbarton,319,10,8,12,16,46,63,-17,36
Hibernian,320,1,19,12,5,59,26,33,69
Morton,320,2,19,11,6,48,32,16,68
Falkirk,320,3,16,11,9,60,39,21,59
Dundee Utd,320,4,15,10,11,52,42,10,55
Queen of S't,320,5,14,9,13,45,47,-2,51
Raith,320,6,11,10,15,37,48,-11,43
Dunfermline,320,7,9,13,14,47,52,-5,40
Dumbarton,320,8,8,11,17,48,65,-17,35
Ayr,320,9,8,11,17,38,60,-22,35
St Mirren,320,10,7,10,19,36,59,-23,31
Hibernian,321,1,18,14,4,53,25,28,68
Morton,321,2,17,11,8,50,35,15,62
Dundee Utd,321,3,16,10,10,46,36,10,58
Falkirk,321,4,15,10,11,56,44,12,55
Queen of S't,321,5,12,11,13,43,45,-2,47
Dunfermline,321,6,10,13,13,44,46,-2,43
Raith,321,7,11,10,15,37,49,-12,43
Dumbarton,321,8,10,12,14,48,55,-7,42
St Mirren,321,9,9,9,18,41,58,-17,36
Ayr,321,10,6,12,18,29,54,-25,30
Hibernian,322,1,20,10,6,57,29,28,70
Morton,322,2,17,12,7,57,39,18,63
Falkirk,322,3,15,12,9,57,39,18,57
Dundee Utd,322,4,15,11,10,50,40,10,56
Queen of S't,322,5,12,9,15,44,48,-4,45
Dunfermline,322,6,10,13,13,45,47,-2,43
Dumbarton,322,7,9,13,14,47,56,-9,40
Ayr,322,8,9,12,15,35,54,-19,39
Raith,322,9,9,9,18,31,52,-21,36
St Mirren,322,10,8,11,17,40,59,-19,35
Hibernian,323,1,19,12,5,57,24,33,69
Morton,323,2,18,12,6,57,35,22,66
Falkirk,323,3,17,9,10,62,45,17,60
Dundee Utd,323,4,16,11,9,52,40,12,59
Dumbarton,323,5,10,11,15,50,62,-12,41
Raith,323,6,11,8,17,35,50,-15,41
Queen of S't,323,7,10,10,16,40,51,-11,40
Dunfermline,323,8,8,15,13,47,50,-3,39
Ayr,323,9,8,12,16,33,57,-24,36
St Mirren,323,10,8,10,18,42,61,-19,34
Hibernian,324,1,20,12,4,56,24,32,72
Falkirk,324,2,17,10,9,60,38,22,61
Dundee Utd,324,3,17,9,10,49,37,12,60
Morton,324,4,16,11,9,50,36,14,59
Dunfermline,324,5,11,12,13,48,49,-1,45
St Mirren,324,6,11,10,15,48,58,-10,43
Dumbarton,324,7,10,10,16,52,60,-8,40
Queen of S't,324,8,10,8,18,42,59,-17,38
Raith,324,9,10,8,18,33,54,-21,38
Ayr,324,10,7,12,17,36,59,-23,33
Hibernian,325,1,21,12,3,60,24,36,75
Morton,325,2,16,13,7,51,40,11,61
Dundee Utd,325,3,16,11,9,49,36,13,59
Falkirk,325,4,15,11,10,55,39,16,56
Dumbarton,325,5,12,10,14,51,56,-5,46
Queen of S't,325,6,12,8,16,45,53,-8,44
Dunfermline,325,7,8,13,15,41,48,-7,37
Raith,325,8,9,10,17,35,52,-17,37
Ayr,325,9,8,12,16,33,54,-21,36
St Mirren,325,10,7,12,17,38,56,-18,33
Hibernian,326,1,19,12,5,56,24,32,69
Morton,326,2,18,10,8,56,38,18,64
Dundee Utd,326,3,17,10,9,62,48,14,61
Falkirk,326,4,16,11,9,55,39,16,59
Dumbarton,326,5,11,12,13,54,56,-2,45
Queen of S't,326,6,11,9,16,53,56,-3,42
Dunfermline,326,7,8,13,15,43,53,-10,37
St Mirren,326,8,9,10,17,38,57,-19,37
Ayr,326,9,8,13,15,37,57,-20,37
Raith,326,10,8,10,18,29,55,-26,34
Hibernian,327,1,18,13,5,55,26,29,67
Morton,327,2,19,10,7,56,36,20,67
Dundee Utd,327,3,18,9,9,56,38,18,63
Falkirk,327,4,15,10,11,56,42,14,55
Queen of S't,327,5,11,9,16,44,56,-12,42
Dunfermline,327,6,9,14,13,45,47,-2,41
Raith,327,7,10,10,16,35,49,-14,40
Dumbarton,327,8,10,10,16,49,65,-16,40
St Mirren,327,9,9,10,17,41,54,-13,37
Ayr,327,10,7,13,16,36,60,-24,34
Hibernian,328,1,21,12,3,64,26,38,75
Falkirk,328,2,16,13,7,65,41,24,61
Dundee Utd,328,3,17,10,9,52,37,15,61
Morton,328,4,15,15,6,51,37,14,60
Queen of S't,328,5,13,8,15,44,52,-8,47
Dunfermline,328,6,8,14,14,44,54,-10,38
Raith,328,7,9,11,16,38,54,-16,38
Dumbarton,328,8,8,11,17,49,63,-14,35
St Mirren,328,9,8,11,17,41,59,-18,35
Ayr,328,10,7,11,18,33,58,-25,32
Hibernian,329,1,21,10,5,55,25,30,73
Morton,329,2,17,11,8,50,34,16,62
Falkirk,329,3,15,12,9,61,44,17,57
Dundee Utd,329,4,15,9,12,48,43,5,54
Raith,329,5,12,9,15,40,48,-8,45
Dunfermline,329,6,10,14,12,44,43,1,44
Dumbarton,329,7,9,13,14,46,55,-9,40
Queen of S't,329,8,10,9,17,45,57,-12,39
Ayr,329,9,9,12,15,36,57,-21,39
St Mirren,329,10,7,11,18,39,58,-19,32
Hibernian,330,1,20,12,4,56,24,32,72
Dundee Utd,330,2,18,9,9,62,39,23,63
Morton,330,3,16,13,7,48,34,14,61
Falkirk,330,4,16,11,9,60,37,23,59
Raith,330,5,11,10,15,34,47,-13,43
Queen of S't,330,6,10,10,16,40,50,-10,40
Ayr,330,7,9,11,16,36,57,-21,38
Dunfermline,330,8,8,13,15,43,55,-12,37
Dumbarton,330,9,8,13,15,45,61,-16,37
St Mirren,330,10,8,10,18,41,61,-20,34
Hibernian,331,1,19,12,5,51,25,26,69
Dundee Utd,331,2,18,9,9,59,38,21,63
Morton,331,3,16,13,7,50,36,14,61
Falkirk,331,4,14,12,10,53,41,12,54
Dunfermline,331,5,11,13,12,48,46,2,46
Queen of S't,331,6,12,9,15,44,49,-5,45
Dumbarton,331,7,10,10,16,49,61,-12,40
Raith,331,8,9,10,17,34,48,-14,37
Ayr,331,9,8,13,15,36,56,-20,37
St Mirren,331,10,7,11,18,33,57,-24,32
Hibernian,332,1,18,12,6,53,28,25,66
Morton,332,2,15,13,8,47,37,10,58
Falkirk,332,3,16,9,11,58,45,13,57
Dundee Utd,332,4,14,13,9,48,36,12,55
Queen of S't,332,5,12,10,14,48,47,1,46
St Mirren,332,6,11,10,15,43,50,-7,43
Dunfermline,332,7,9,14,13,47,50,-3,41
Dumbarton,332,8,9,13,14,55,67,-12,40
Raith,332,9,10,9,17,32,50,-18,39
Ayr,332,10,8,13,15,39,60,-21,37
Hibernian,333,1,20,11,5,59,29,30,71
Morton,333,2,16,14,6,51,36,15,62
Falkirk,333,3,15,11,10,57,46,11,56
Dundee Utd,333,4,14,9,13,46,40,6,51
Dunfermline,333,5,12,12,12,49,46,3,48
Queen of S't,333,6,13,9,14,46,49,-3,48
Ayr,333,7,9,13,14,35,50,-15,40
Dumbarton,333,8,9,11,16,45,56,-11,38
Raith,333,9,9,10,17,34,51,-17,37
St Mirren,333,10,7,12,17,36,55,-19,33
Hibernian,334,1,18,13,5,51,26,25,67
Dundee Utd,334,2,19,9,8,60,35,25,66
Falkirk,334,3,16,10,10,55,43,12,58
Morton,334,4,14,14,8,46,37,9,56
Dumbarton,334,5,11,10,15,47,56,-9,43
Dunfermline,334,6,9,14,13,44,47,-3,41
Queen of S't,334,7,10,11,15,43,51,-8,41
St Mirren,334,8,9,11,16,41,55,-14,38
Ayr,334,9,9,11,16,35,56,-21,38
Raith,334,10,8,11,17,34,50,-16,35
Hibernian,335,1,18,13,5,55,28,27,67
Morton,335,2,16,12,8,53,41,12,60
Falkirk,335,3,16,11,9,57,36,21,59
Dundee Utd,335,4,15,11,10,52,40,12,56
Queen of S't,335,5,12,10,14,47,52,-5,46
Dunfermline,335,6,10,14,12,54,50,4,44
Dumbarton,335,7,10,12,14,47,57,-10,42
Raith,335,8,11,9,16,39,52,-13,42
Ayr,335,9,8,12,16,34,58,-24,36
St Mirren,335,10,6,12,18,36,60,-24,30
Hibernian,336,1,17,14,5,54,31,23,65
Falkirk,336,2,18,9,9,60,37,23,63
Morton,336,3,16,13,7,48,34,14,61
Dundee Utd,336,4,16,11,9,48,38,10,59
Raith,336,5,12,9,15,37,46,-9,45
Dunfermline,336,6,9,15,12,45,45,0,42
Queen of S't,336,7,10,11,15,40,48,-8,41
St Mirren,336,8,9,10,17,41,56,-15,37
Dumbarton,336,9,8,12,16,42,54,-12,36
Ayr,336,10,6,14,16,28,54,-26,32
Hibernian,337,1,18,13,5,52,24,28,67
Falkirk,337,2,18,10,8,66,39,27,64
Morton,337,3,17,11,8,48,38,10,62
Dundee Utd,337,4,14,10,12,46,40,6,52
Queen of S't,337,5,11,12,13,43,47,-4,45
Dunfermline,337,6,10,13,13,47,51,-4,43
Dumbarton,337,7,9,12,15,50,62,-12,39
Ayr,337,8,8,14,14,33,49,-16,38
St Mirren,337,9,9,10,17,38,55,-17,37
Raith,337,10,8,11,17,31,49,-18,35
Hibernian,338,1,20,12,4,64,28,36,72
Falkirk,338,2,17,12,7,63,38,25,63
Morton,338,3,15,12,9,53,41,12,57
Dundee Utd,338,4,14,9,13,49,44,5,51
Queen of S't,338,5,13,9,14,46,52,-6,48
St Mirren,338,6,10,11,15,38,51,-13,41
Dunfermline,338,7,8,16,12,45,52,-7,40
Raith,338,8,10,9,17,39,51,-12,39
Dumbarton,338,9,8,13,15,44,56,-12,37
Ayr,338,10,8,11,17,34,62,-28,35
Morton,339,1,20,10,6,54,32,22,70
Hibernian,339,2,18,12,6,55,25,30,66
Falkirk,339,3,16,11,9,57,39,18,59
Dundee Utd,339,4,16,9,11,50,41,9,57
Queen of S't,339,5,14,8,14,48,50,-2,50
Ayr,339,6,11,11,14,37,52,-15,44
Dunfermline,339,7,9,14,13,48,46,2,41
Dumbarton,339,8,8,11,17,47,61,-14,35
Raith,339,9,9,8,19,34,57,-23,35
St Mirren,339,10,7,10,19,37,64,-27,31
Hibernian,340,1,18,12,6,52,27,25,66
Morton,340,2,19,9,8,49,32,17,66
Falkirk,340,3,16,11,9,58,44,14,59
Dundee Utd,340,4,15,9,12,51,46,5,54
Dunfermline,340,5,11,13,12,48,44,4,46
Queen of S't,340,6,11,9,16,46,53,-7,42
Dumbarton,340,7,9,12,15,51,61,-10,39
Ayr,340,8,9,12,15,38,56,-18,39
St Mirren,340,9,9,11,16,39,55,-16,38
Raith,340,10,9,10,17,32,46,-14,37
Hibernian,341,1,18,14,4,51,22,29,68
Falkirk,341,2,16,12,8,61,36,25,60
Morton,341,3,15,11,10,49,39,10,56
Dundee Utd,341,4,14,11,11,46,42,4,53
Dumbarton,341,5,11,11,14,49,57,-8,44
Dunfermline,341,6,10,13,13,42,44,-2,43
Queen of S't,341,7,11,10,15,45,55,-10,43
St Mirren,341,8,10,10,16,43,55,-12,40
Ayr,341,9,8,14,14,37,52,-15,38
Raith,341,10,9,10,17,34,55,-21,37
Hibernian,342,1,18,12,6,63,31,32,66
Morton,342,2,18,9,9,55,38,17,63
Dundee Utd,342,3,16,9,11,47,39,8,57
Falkirk,342,4,14,10,12,54,45,9,52
Dunfermline,342,5,10,14,12,45,47,-2,44
Dumbarton,342,6,11,11,14,51,57,-6,44
Queen of S't,342,7,11,10,15,43,49,-6,43
Raith,342,8,11,10,15,34,46,-12,43
St Mirren,342,9,8,13,15,41,55,-14,37
Ayr,342,10,8,12,16,31,57,-26,36
Hibernian,343,1,19,12,5,56,26,30,69
Morton,343,2,18,10,8,52,37,15,64
Dundee Utd,343,3,18,9,9,58,36,22,63
Falkirk,343,4,15,10,11,57,43,14,55
Raith,343,5,14,9,13,36,40,-4,51
Queen of S't,343,6,10,10,16,44,55,-11,40
Dunfermline,343,7,9,12,15,46,51,-5,39
Ayr,343,8,9,11,16,33,56,-23,38
Dumbarton,343,9,8,12,16,43,58,-15,36
St Mirren,343,10,8,9,19,40,63,-23,33
Hibernian,344,1,19,14,3,58,21,37,71
Falkirk,344,2,15,12,9,56,40,16,57
Dundee Utd,344,3,16,9,11,51,43,8,57
Morton,344,4,15,10,11,48,42,6,55
Queen of S't,344,5,12,11,13,44,47,-3,47
Dunfermline,344,6,11,11,14,45,50,-5,44
Dumbarton,344,7,10,11,15,51,64,-13,41
Raith,344,8,11,8,17,37,50,-13,41
St Mirren,344,9,9,10,17,43,53,-10,37
Ayr,344,10,8,12,16,35,58,-23,36
Hibernian,345,1,19,12,5,61,33,28,69
Dundee Utd,345,2,17,11,8,56,40,16,62
Falkirk,345,3,16,11,9,58,42,16,59
Morton,345,4,15,13,8,47,39,8,58
Queen of S't,345,5,10,12,14,47,52,-5,42
Raith,345,6,10,11,15,36,48,-12,41
Dunfermline,345,7,9,13,14,45,48,-3,40
Dumbarton,345,8,9,13,14,50,57,-7,40
St Mirren,345,9,8,11,17,41,59,-18,35
Ayr,345,10,7,13,16,34,57,-23,34
Dundee Utd,346,1,20,8,8,59,34,25,68
Hibernian,346,2,17,13,6,56,34,22,64
Morton,346,3,17,11,8,53,38,15,62
Falkirk,346,4,16,12,8,62,42,20,60
Dunfermline,346,5,11,12,13,53,54,-1,45
Queen of S't,346,6,11,9,16,43,51,-8,42
Raith,346,7,10,10,16,36,53,-17,40
St Mirren,346,8,8,11,17,41,59,-18,35
Ayr,346,9,8,11,17,34,57,-23,35
Dumbarton,346,10,7,13,16,42,57,-15,34
Hibernian,347,1,19,12,5,53,27,26,69
Dundee Utd,347,2,17,11,8,55,35,20,62
Falkirk,347,3,16,12,8,57,35,22,60
Morton,347,4,15,12,9,48,38,10,57
Queen of S't,347,5,12,10,14,47,48,-1,46
Dunfermline,347,6,9,14,13,42,49,-7,41
Dumbarton,347,7,9,13,14,46,54,-8,40
Raith,347,8,9,10,17,36,55,-19,37
St Mirren,347,9,8,11,17,35,55,-20,35
Ayr,347,10,7,13,16,33,56,-23,34
Hibernian,348,1,19,13,4,54,26,28,70
Morton,348,2,18,10,8,51,34,17,64
Dundee Utd,348,3,15,11,10,51,42,9,56
Falkirk,348,4,14,11,11,55,45,10,53
Dunfermline,348,5,11,13,12,45,43,2,46
Raith,348,6,11,10,15,37,48,-11,43
Queen of S't,348,7,10,11,15,42,47,-5,41
Dumbarton,348,8,9,13,14,45,55,-10,40
St Mirren,348,9,8,12,16,44,58,-14,36
Ayr,348,10,8,10,18,34,60,-26,34
Hibernian,349,1,18,14,4,59,29,30,68
Dundee Utd,349,2,17,10,9,51,36,15,61
Falkirk,349,3,16,10,10,60,43,17,58
Morton,349,4,15,11,10,44,37,7,56
Dunfermline,349,5,11,12,13,47,45,2,45
Dumbarton,349,6,11,11,14,47,53,-6,44
Queen of S't,349,7,10,11,15,42,51,-9,41
Ayr,349,8,8,14,14,36,53,-17,38
Raith,349,9,9,10,17,32,52,-20,37
St Mirren,349,10,8,11,17,40,59,-19,35
Morton,350,1,18,12,6,53,32,21,66
Hibernian,350,2,18,11,7,54,27,27,65
Dundee Utd,350,3,16,9,11,50,38,12,57
Falkirk,350,4,15,9,12,54,46,8,54
Queen of S't,350,5,13,9,14,52,49,3,48
Raith,350,6,12,9,15,44,50,-6,45
Dumbarton,350,7,10,12,14,52,58,-6,42
Dunfermline,350,8,10,11,15,42,54,-12,41
Ayr,350,9,8,13,15,34,55,-21,37
St Mirren,350,10,8,9,19,42,68,-26,33
Hibernian,351,1,19,13,4,60,27,33,70
Morton,351,2,18,11,7,50,35,15,65
Falkirk,351,3,16,11,9,55,38,17,59
Dundee Utd,351,4,16,11,9,46,35,11,59
Queen of S't,351,5,11,13,12,44,45,-1,46
Dumbarton,351,6,9,13,14,46,54,-8,40
Ayr,351,7,9,12,15,34,52,-18,39
Raith,351,8,9,11,16,32,47,-15,38
Dunfermline,351,9,8,13,15,40,49,-9,37
St Mirren,351,10,6,10,20,34,59,-25,28
Hibernian,352,1,19,12,5,54,24,30,69
Morton,352,2,17,11,8,49,37,12,62
Falkirk,352,3,16,11,9,61,39,22,59
Dundee Utd,352,4,14,10,12,50,44,6,52
Dunfermline,352,5,10,15,11,47,48,-1,45
Dumbarton,352,6,10,13,13,47,53,-6,43
St Mirren,352,7,11,10,15,39,52,-13,43
Raith,352,8,10,8,18,37,53,-16,38
Ayr,352,9,8,13,15,37,59,-22,37
Queen of S't,352,10,9,9,18,44,56,-12,36
Hibernian,353,1,18,11,7,54,28,26,65
Morton,353,2,17,11,8,52,37,15,62
Falkirk,353,3,17,10,9,64,39,25,61
Dundee Utd,353,4,16,8,12,51,44,7,56
Dunfermline,353,5,11,13,12,45,47,-2,46
Queen of S't,353,6,12,9,15,45,49,-4,45
Raith,353,7,11,8,17,36,55,-19,41
Dumbarton,353,8,9,12,15,49,58,-9,39
Ayr,353,9,9,11,16,37,57,-20,38
St Mirren,353,10,9,9,18,36,55,-19,36
Hibernian,354,1,19,12,5,60,25,35,69
Morton,354,2,18,11,7,54,39,15,65
Falkirk,354,3,16,10,10,62,47,15,58
Dundee Utd,354,4,16,10,10,52,40,12,58
Dunfermline,354,5,11,12,13,47,48,-1,45
Queen of S't,354,6,10,10,16,44,53,-9,40
Dumbarton,354,7,9,13,14,55,66,-11,40
Ayr,354,8,8,13,15,33,52,-19,37
Raith,354,9,9,10,17,32,52,-20,37
St Mirren,354,10,9,9,18,45,62,-17,36
Hibernian,355,1,20,12,4,56,25,31,72
Dundee Utd,355,2,18,10,8,56,34,22,64
Falkirk,355,3,15,10,11,56,44,12,55
Morton,355,4,14,10,12,47,43,4,52
Dunfermline,355,5,12,11,13,48,49,-1,47
Raith,355,6,12,8,16,38,47,-9,44
St Mirren,355,7,11,10,15,43,52,-9,43
Dumbarton,355,8,10,10,16,47,61,-14,40
Queen of S't,355,9,10,9,17,42,50,-8,39
Ayr,355,10,8,10,18,31,59,-28,34
Hibernian,356,1,22,11,3,59,24,35,77
Dundee Utd,356,2,17,9,10,55,40,15,60
Falkirk,356,3,16,11,9,61,43,18,59
Morton,356,4,16,11,9,47,35,12,59
Queen of S't,356,5,12,10,14,48,50,-2,46
Dunfermline,356,6,9,13,14,42,47,-5,40
St Mirren,356,7,9,11,16,42,55,-13,38
Dumbarton,356,8,7,15,14,47,57,-10,36
Raith,356,9,9,8,19,32,51,-19,35
Ayr,356,10,8,11,17,33,64,-31,35
Hibernian,357,1,20,11,5,58,24,34,71
Morton,357,2,18,12,6,52,33,19,66
Falkirk,357,3,17,9,10,55,36,19,60
Dundee Utd,357,4,17,9,10,54,43,11,60
Dunfermline,357,5,10,13,13,49,49,0,43
Queen of S't,357,6,10,10,16,41,49,-8,40
Raith,357,7,10,9,17,34,55,-21,39
St Mirren,357,8,9,11,16,44,57,-13,38
Dumbarton,357,9,8,11,17,47,64,-17,35
Ayr,357,10,8,11,17,30,54,-24,35
Hibernian,358,1,19,12,5,53,25,28,69
Morton,358,2,19,10,7,53,33,20,67
Dundee Utd,358,3,17,9,10,56,40,16,60
Falkirk,358,4,15,12,9,57,43,14,57
Queen of S't,358,5,11,10,15,45,51,-6,43
Dunfermline,358,6,9,13,14,42,50,-8,40
Dumbarton,358,7,9,12,15,48,55,-7,39
St Mirren,358,8,9,12,15,45,53,-8,39
Ayr,358,9,8,12,16,35,61,-26,36
Raith,358,10,8,10,18,31,54,-23,34
Hibernian,359,1,21,11,4,57,21,36,74
Morton,359,2,16,13,7,50,38,12,61
Dundee Utd,359,3,17,10,9,49,38,11,61
Falkirk,359,4,16,11,9,63,46,17,59
Queen of S't,359,5,11,8,17,45,55,-10,41
Ayr,359,6,10,10,16,40,55,-15,40
Dunfermline,359,7,8,14,14,45,52,-7,38
Dumbarton,359,8,9,11,16,46,58,-12,38
St Mirren,359,9,9,11,16,39,51,-12,38
Raith,359,10,9,9,18,34,54,-20,36
Hibernian,360,1,19,12,5,55,24,31,69
Morton,360,2,18,11,7,53,37,16,65
Falkirk,360,3,15,13,8,61,42,19,58
Dundee Utd,360,4,16,10,10,48,37,11,58
Dunfermline,360,5,10,15,11,50,46,4,45
Queen of S't,360,6,12,8,16,43,49,-6,44
Ayr,360,7,9,11,16,35,56,-21,38
St Mirren,360,8,9,10,17,39,54,-15,37
Raith,360,9,9,9,18,32,51,-19,36
Dumbarton,360,10,7,13,16,49,69,-20,34
Hibernian,361,1,20,10,6,57,27,30,70
Morton,361,2,17,12,7,51,37,14,63
Falkirk,361,3,16,11,9,63,46,17,59
Dundee Utd,361,4,14,12,10,48,46,2,54
Dunfermline,361,5,11,14,11,49,47,2,47
Queen of S't,361,6,11,9,16,48,55,-7,42
Dumbarton,361,7,9,13,14,52,54,-2,40
Raith,361,8,9,10,17,39,54,-15,37
Ayr,361,9,8,13,15,32,52,-20,37
St Mirren,361,10,8,10,18,40,61,-21,34
Hibernian,362,1,20,13,3,55,23,32,73
Dundee Utd,362,2,16,11,9,53,39,14,59
Morton,362,3,16,11,9,46,38,8,59
Falkirk,362,4,15,9,12,57,45,12,54
Raith,362,5,11,10,15,38,48,-10,43
Queen of S't,362,6,11,9,16,42,50,-8,42
Dunfermline,362,7,9,14,13,41,45,-4,41
St Mirren,362,8,10,10,16,46,61,-15,40
Dumbarton,362,9,9,12,15,51,58,-7,39
Ayr,362,10,7,13,16,35,57,-22,34
Hibernian,363,1,19,12,5,59,27,32,69
Morton,363,2,18,10,8,55,40,15,64
Falkirk,363,3,17,11,8,63,38,25,62
Dundee Utd,363,4,17,10,9,56,40,16,61
Queen of S't,363,5,12,11,13,45,48,-3,47
Raith,363,6,11,9,16,36,48,-12,42
Dunfermline,363,7,8,14,14,43,50,-7,38
Dumbarton,363,8,8,13,15,42,57,-15,37
St Mirren,363,9,8,10,18,38,63,-25,34
Ayr,363,10,7,10,19,35,61,-26,31
Hibernian,364,1,17,13,6,55,31,24,64
Morton,364,2,18,10,8,52,36,16,64
Falkirk,364,3,17,10,9,61,47,14,61
Dunfermline,364,4,13,11,12,55,46,9,50
Dundee Utd,364,5,13,10,13,49,48,1,49
Queen of S't,364,6,11,11,14,50,53,-3,44
Dumbarton,364,7,9,14,13,50,57,-7,41
Ayr,364,8,10,11,15,33,51,-18,41
Raith,364,9,10,10,16,35,51,-16,40
St Mirren,364,10,6,12,18,36,56,-20,30
Morton,365,1,20,10,6,53,34,19,70
Hibernian,365,2,19,11,6,55,25,30,68
Dundee Utd,365,3,17,9,10,52,35,17,60
Falkirk,365,4,14,12,10,51,38,13,54
Ayr,365,5,10,12,14,42,57,-15,42
Dunfermline,365,6,9,13,14,41,49,-8,40
Queen of S't,365,7,10,9,17,39,51,-12,39
Raith,365,8,10,9,17,34,51,-17,39
Dumbarton,365,9,8,13,15,44,56,-12,37
St Mirren,365,10,8,12,16,40,55,-15,36
Hibernian,366,1,19,13,4,54,25,29,70
Falkirk,366,2,17,9,10,58,40,18,60
Dundee Utd,366,3,16,9,11,51,43,8,57
Morton,366,4,14,14,8,44,36,8,56
Dunfermline,366,5,11,14,11,49,44,5,47
Queen of S't,366,6,11,8,17,47,58,-11,41
Raith,366,7,10,10,16,34,49,-15,40
Ayr,366,8,10,10,16,35,53,-18,40
Dumbarton,366,9,9,11,16,51,63,-12,38
St Mirren,366,10,9,10,17,46,58,-12,37
Hibernian,367,1,20,12,4,56,23,33,72
Dundee Utd,367,2,16,11,9,53,37,16,59
Falkirk,367,3,16,10,10,57,41,16,58
Morton,367,4,15,11,10,46,41,5,56
Dunfermline,367,5,10,14,12,49,46,3,44
Dumbarton,367,6,10,12,14,52,59,-7,42
Queen of S't,367,7,10,10,16,44,61,-17,40
Raith,367,8,10,9,17,34,47,-13,39
St Mirren,367,9,10,9,17,40,54,-14,39
Ayr,367,10,8,12,16,34,56,-22,36
Hibernian,368,1,16,15,5,54,29,25,63
Morton,368,2,16,13,7,55,41,14,61
Falkirk,368,3,13,13,10,53,42,11,52
Dundee Utd,368,4,14,10,12,47,39,8,52
Queen of S't,368,5,11,13,12,46,45,1,46
Dunfermline,368,6,11,12,13,46,50,-4,45
St Mirren,368,7,11,10,15,45,54,-9,43
Raith,368,8,11,10,15,37,49,-12,43
Dumbarton,368,9,8,14,14,45,54,-9,38
Ayr,368,10,7,14,15,32,57,-25,35
Hibernian,369,1,19,12,5,55,26,29,69
Morton,369,2,18,11,7,48,32,16,65
Falkirk,369,3,15,11,10,57,43,14,56
Dundee Utd,369,4,13,12,11,40,36,4,51
St Mirren,369,5,12,9,15,44,54,-10,45
Dunfermline,369,6,10,14,12,51,49,2,44
Queen of S't,369,7,11,11,14,44,51,-7,44
Dumbarton,369,8,9,10,17,44,57,-13,37
Ayr,369,9,8,13,15,32,50,-18,37
Raith,369,10,9,9,18,37,54,-17,36
Hibernian,370,1,20,11,5,54,25,29,71
Dundee Utd,370,2,16,11,9,49,37,12,59
Falkirk,370,3,16,10,10,59,41,18,58
Morton,370,4,14,13,9,45,38,7,55
Dunfermline,370,5,11,13,12,48,44,4,46
Dumbarton,370,6,10,12,14,46,53,-7,42
Ayr,370,7,9,13,14,36,51,-15,40
Queen of S't,370,8,9,11,16,42,54,-12,38
Raith,370,9,9,11,16,37,55,-18,38
St Mirren,370,10,8,11,17,38,56,-18,35
Hibernian,371,1,21,12,3,60,23,37,75
Morton,371,2,18,9,9,56,39,17,63
Falkirk,371,3,16,11,9,59,41,18,59
Dundee Utd,371,4,15,11,10,47,38,9,56
Dunfermline,371,5,10,14,12,45,44,1,44
Queen of S't,371,6,11,10,15,48,52,-4,43
Dumbarton,371,7,10,11,15,46,60,-14,41
St Mirren,371,8,9,10,17,40,56,-16,37
Raith,371,9,9,8,19,31,53,-22,35
Ayr,371,10,7,12,17,29,55,-26,33
Hibernian,372,1,18,13,5,52,26,26,67
Morton,372,2,18,11,7,55,34,21,65
Falkirk,372,3,14,13,9,60,46,14,55
Dundee Utd,372,4,14,9,13,44,40,4,51
Queen of S't,372,5,13,8,15,43,45,-2,47
Raith,372,6,11,12,13,35,44,-9,45
Dunfermline,372,7,9,14,13,46,53,-7,41
Dumbarton,372,8,10,11,15,49,58,-9,41
Ayr,372,9,9,12,15,33,51,-18,39
St Mirren,372,10,6,13,17,39,59,-20,31
Hibernian,373,1,20,12,4,55,23,32,72
Falkirk,373,2,16,11,9,59,38,21,59
Morton,373,3,15,13,8,44,36,8,58
Dundee Utd,373,4,14,11,11,51,44,7,53
Dunfermline,373,5,11,13,12,50,46,4,46
Queen of S't,373,6,11,12,13,53,51,2,45
Dumbarton,373,7,9,11,16,44,60,-16,38
Raith,373,8,9,11,16,32,50,-18,38
Ayr,373,9,7,15,14,33,53,-20,36
St Mirren,373,10,8,11,17,38,58,-20,35
Hibernian,374,1,17,12,7,54,30,24,63
Morton,374,2,16,13,7,48,34,14,61
Falkirk,374,3,16,11,9,58,38,20,59
Dundee Utd,374,4,15,12,9,50,41,9,57
Dunfermline,374,5,11,11,14,45,47,-2,44
Queen of S't,374,6,11,10,15,44,54,-10,43
St Mirren,374,6,11,10,15,44,54,-10,43
Raith,374,8,10,10,16,36,49,-13,40
Ayr,374,9,8,13,15,41,62,-21,37
Dumbarton,374,10,8,12,16,46,57,-11,36
Hibernian,375,1,22,10,4,62,24,38,76
Dundee Utd,375,2,18,10,8,57,39,18,64
Falkirk,375,3,17,10,9,60,36,24,61
Morton,375,4,15,11,10,53,45,8,56
Dunfermline,375,5,12,13,11,51,44,7,49
Dumbarton,375,6,10,11,15,51,60,-9,41
Queen of S't,375,7,9,9,18,42,60,-18,36
Raith,375,8,9,9,18,31,53,-22,36
St Mirren,375,9,8,11,17,40,57,-17,35
Ayr,375,10,8,10,18,33,62,-29,34
Hibernian,376,1,18,13,5,57,31,26,67
Dundee Utd,376,2,18,8,10,59,41,18,62
Morton,376,3,17,11,8,50,37,13,62
Falkirk,376,4,15,12,9,56,40,16,57
Dumbarton,376,5,11,12,13,50,54,-4,45
Queen of S't,376,6,11,11,14,44,48,-4,44
Dunfermline,376,7,9,14,13,48,52,-4,41
Raith,376,8,9,10,17,35,55,-20,37
Ayr,376,9,7,14,15,32,55,-23,35
St Mirren,376,10,7,11,18,39,57,-18,32
Hibernian,377,1,19,13,4,55,23,32,70
Dundee Utd,377,2,16,11,9,54,40,14,59
Morton,377,3,15,12,9,47,37,10,57
Falkirk,377,4,15,10,11,58,44,14,55
Dunfermline,377,5,11,12,13,50,50,0,45
Queen of S't,377,6,11,12,13,47,49,-2,45
Ayr,377,7,9,13,14,34,51,-17,40
Raith,377,8,9,11,16,32,49,-17,38
Dumbarton,377,9,8,12,16,47,66,-19,36
St Mirren,377,10,7,14,15,39,54,-15,35
Hibernian,378,1,18,11,7,48,25,23,65
Morton,378,2,18,10,8,56,37,19,64
Falkirk,378,3,17,9,10,59,41,18,60
Dundee Utd,378,4,16,10,10,50,40,10,58
Ayr,378,5,12,10,14,45,56,-11,46
Dunfermline,378,6,11,11,14,48,53,-5,44
Queen of S't,378,7,11,10,15,45,52,-7,43
Raith,378,8,10,9,17,33,50,-17,39
St Mirren,378,9,8,11,17,40,57,-17,35
Dumbarton,378,10,7,13,16,47,60,-13,34
Hibernian,379,1,19,11,6,54,27,27,68
Morton,379,2,19,11,6,51,31,20,68
Dundee Utd,379,3,17,10,9,55,39,16,61
Falkirk,379,4,15,10,11,59,45,14,55
Queen of S't,379,5,12,9,15,49,51,-2,45
Dunfermline,379,6,10,12,14,46,50,-4,42
Raith,379,7,11,9,16,35,51,-16,42
St Mirren,379,8,10,10,16,43,55,-12,40
Ayr,379,9,7,13,16,30,56,-26,34
Dumbarton,379,10,7,11,18,41,58,-17,32
Hibernian,380,1,17,14,5,54,29,25,65
Morton,380,2,18,11,7,54,32,22,65
Falkirk,380,3,17,10,9,60,38,22,61
Dundee Utd,380,4,16,8,12,43,38,5,56
Dunfermline,380,5,11,13,12,49,48,1,46
Queen of S't,380,6,10,11,15,45,53,-8,41
Ayr,380,7,9,13,14,36,53,-17,40
Raith,380,8,9,11,16,33,49,-16,38
St Mirren,380,9,9,10,17,42,59,-17,37
Dumbarton,380,10,8,11,17,45,62,-17,35
Hibernian,381,1,20,11,5,57,27,30,71
Morton,381,2,19,10,7,58,35,23,67
Falkirk,381,3,16,9,11,61,51,10,57
Dundee Utd,381,4,15,10,11,51,43,8,55
Queen of S't,381,5,12,9,15,46,50,-4,45
Dumbarton,381,6,9,14,13,50,54,-4,41
Dunfermline,381,7,9,14,13,47,52,-5,41
St Mirren,381,8,9,10,17,43,59,-16,37
Raith,381,9,9,9,18,34,52,-18,36
Ayr,381,10,8,12,16,35,59,-24,36
Falkirk,382,1,19,9,8,58,37,21,66
Hibernian,382,2,17,13,6,47,25,22,64
Morton,382,3,17,12,7,52,36,16,63
Dundee Utd,382,4,17,9,10,52,42,10,60
Queen of S't,382,5,12,11,13,46,45,1,47
Dumbarton,382,6,9,13,14,51,60,-9,40
Raith,382,7,9,10,17,37,49,-12,37
Dunfermline,382,8,7,15,14,43,52,-9,36
St Mirren,382,9,8,11,17,39,58,-19,35
Ayr,382,10,7,13,16,32,53,-21,34
Hibernian,383,1,19,13,4,61,27,34,70
Falkirk,383,2,17,10,9,60,40,20,61
Dundee Utd,383,3,16,10,10,52,39,13,58
Morton,383,4,15,13,8,49,38,11,58
St Mirren,383,5,11,10,15,46,57,-11,43
Raith,383,6,10,10,16,41,52,-11,40
Queen of S't,383,7,10,10,16,47,64,-17,40
Dunfermline,383,8,7,17,12,47,52,-5,38
Dumbarton,383,9,9,11,16,45,58,-13,38
Ayr,383,10,8,12,16,37,58,-21,36
Hibernian,384,1,21,12,3,62,21,41,75
Morton,384,2,18,9,9,52,40,12,63
Dundee Utd,384,3,16,11,9,54,41,13,59
Falkirk,384,4,15,10,11,54,45,9,55
Dunfermline,384,5,10,14,12,44,45,-1,44
Queen of S't,384,6,11,11,14,43,46,-3,44
St Mirren,384,7,9,10,17,43,58,-15,37
Dumbarton,384,8,9,10,17,46,62,-16,37
Raith,384,9,8,12,16,34,51,-17,36
Ayr,384,10,7,13,16,33,56,-23,34
Hibernian,385,1,21,11,4,58,24,34,74
Dundee Utd,385,2,18,9,9,52,40,12,63
Falkirk,385,3,16,11,9,59,41,18,59
Morton,385,4,14,11,11,47,45,2,53
Queen of S't,385,5,12,10,14,48,47,1,46
Raith,385,6,11,9,16,36,46,-10,42
Dunfermline,385,7,9,13,14,45,52,-7,40
St Mirren,385,8,10,9,17,44,56,-12,39
Dumbarton,385,9,8,13,15,45,60,-15,37
Ayr,385,10,7,12,17,31,54,-23,33
Hibernian,386,1,20,13,3,63,26,37,73
Dundee Utd,386,2,19,9,8,59,37,22,66
Morton,386,3,14,11,11,46,37,9,53
Falkirk,386,4,14,10,12,52,42,10,52
Dunfermline,386,5,12,12,12,50,50,0,48
Dumbarton,386,6,10,13,13,49,57,-8,43
Raith,386,7,11,9,16,34,50,-16,42
Queen of S't,386,8,11,8,17,47,57,-10,41
St Mirren,386,9,9,11,16,42,58,-16,38
Ayr,386,10,6,12,18,32,60,-28,30
Hibernian,387,1,19,12,5,58,31,27,69
Morton,387,2,16,13,7,51,37,14,61
Falkirk,387,3,16,11,9,57,39,18,59
Dundee Utd,387,4,13,13,10,44,38,6,52
Raith,387,5,11,9,16,41,47,-6,42
Ayr,387,6,9,14,13,34,50,-16,41
Dumbarton,387,7,9,13,14,48,58,-10,40
Dunfermline,387,8,8,15,13,45,51,-6,39
St Mirren,387,9,9,12,15,41,52,-11,39
Queen of S't,387,10,10,8,18,43,59,-16,38
Hibernian,388,1,18,12,6,53,25,28,66
Morton,388,2,18,11,7,50,32,18,65
Dundee Utd,388,3,15,9,12,47,40,7,54
Falkirk,388,4,14,11,11,57,47,10,53
Raith,388,5,12,10,14,36,44,-8,46
Dunfermline,388,6,11,12,13,42,43,-1,45
Dumbarton,388,7,11,11,14,51,58,-7,44
Queen of S't,388,8,11,11,14,43,50,-7,44
Ayr,388,9,8,12,16,34,55,-21,36
St Mirren,388,10,7,11,18,38,57,-19,32
Hibernian,389,1,18,13,5,54,27,27,67
Dundee Utd,389,2,16,12,8,53,40,13,60
Falkirk,389,3,16,11,9,59,40,19,59
Morton,389,4,15,12,9,45,34,11,57
Queen of S't,389,5,12,10,14,42,49,-7,46
Raith,389,6,11,9,16,40,50,-10,42
Dumbarton,389,7,10,11,15,44,52,-8,41
Dunfermline,389,8,9,13,14,44,50,-6,40
Ayr,389,9,8,14,14,35,55,-20,38
St Mirren,389,10,7,11,18,34,53,-19,32
Hibernian,390,1,19,13,4,59,25,34,70
Dundee Utd,390,2,19,8,9,60,42,18,65
Morton,390,3,16,13,7,48,38,10,61
Falkirk,390,4,16,9,11,58,40,18,57
Queen of S't,390,5,12,10,14,47,51,-4,46
Dunfermline,390,6,8,16,12,46,51,-5,40
Dumbarton,390,7,9,13,14,50,59,-9,40
Ayr,390,8,9,10,17,37,57,-20,37
St Mirren,390,9,8,11,17,43,60,-17,35
Raith,390,10,8,9,19,32,57,-25,33
Morton,391,1,19,10,7,55,35,20,67
Hibernian,391,2,18,12,6,50,26,24,66
Falkirk,391,3,16,11,9,60,39,21,59
Dundee Utd,391,4,16,10,10,51,41,10,58
Queen of S't,391,5,13,8,15,48,52,-4,47
Raith,391,6,10,11,15,35,47,-12,41
Dunfermline,391,7,9,12,15,42,50,-8,39
Dumbarton,391,8,9,10,17,49,62,-13,37
Ayr,391,9,8,13,15,35,55,-20,37
St Mirren,391,10,9,9,18,40,58,-18,36
Hibernian,392,1,19,10,7,55,29,26,67
Morton,392,2,16,13,7,50,36,14,61
Dundee Utd,392,3,16,11,9,54,40,14,59
Falkirk,392,4,15,11,10,59,44,15,56
Queen of S't,392,5,12,11,13,47,48,-1,47
Dumbarton,392,6,11,12,13,52,56,-4,45
Raith,392,7,10,12,14,39,49,-10,42
St Mirren,392,8,9,11,16,43,55,-12,38
Dunfermline,392,9,8,11,17,41,57,-16,35
Ayr,392,10,7,12,17,37,63,-26,33
Hibernian,393,1,19,13,4,56,23,33,70
Falkirk,393,2,17,10,9,62,39,23,61
Morton,393,3,16,13,7,51,38,13,61
Dundee Utd,393,4,15,11,10,52,43,9,56
Dumbarton,393,5,12,11,13,53,56,-3,47
Queen of S't,393,6,11,9,16,47,54,-7,42
Ayr,393,7,10,12,14,39,54,-15,42
Dunfermline,393,8,9,13,14,44,51,-7,40
Raith,393,9,9,10,17,34,54,-20,37
St Mirren,393,10,6,10,20,35,61,-26,28
Hibernian,394,1,19,12,5,55,27,28,69
Morton,394,2,18,10,8,53,39,14,64
Falkirk,394,3,17,11,8,60,38,22,62
Dundee Utd,394,4,14,12,10,52,45,7,54
Dunfermline,394,5,10,15,11,54,51,3,45
Dumbarton,394,6,11,11,14,51,58,-7,44
Queen of S't,394,7,10,10,16,42,54,-12,40
Raith,394,8,9,11,16,35,48,-13,38
Ayr,394,9,7,13,16,34,54,-20,34
St Mirren,394,10,7,11,18,39,61,-22,32
Hibernian,395,1,20,12,4,58,24,34,72
Morton,395,2,16,12,8,45,34,11,60
Falkirk,395,3,16,10,10,61,46,15,58
Dundee Utd,395,4,14,10,12,45,41,4,52
Queen of S't,395,5,13,10,13,54,51,3,49
St Mirren,395,6,11,9,16,42,53,-11,42
Ayr,395,7,10,10,16,37,53,-16,40
Dunfermline,395,8,9,12,15,43,49,-6,39
Dumbarton,395,9,9,11,16,46,62,-16,38
Raith,395,10,9,10,17,34,52,-18,37
Hibernian,396,1,19,13,4,55,23,32,70
Falkirk,396,2,17,11,8,57,35,22,62
Morton,396,3,17,11,8,53,38,15,62
Dundee Utd,396,4,16,12,8,53,38,15,60
Queen of S't,396,5,13,8,15,47,50,-3,47
Dunfermline,396,6,10,12,14,46,50,-4,42
St Mirren,396,7,10,10,16,43,51,-8,40
Raith,396,8,9,9,18,33,51,-18,36
Ayr,396,9,7,13,16,34,63,-29,34
Dumbarton,396,10,7,11,18,44,66,-22,32
Morton,397,1,21,9,6,58,35,23,72
Hibernian,397,2,18,12,6,51,25,26,66
Falkirk,397,3,17,10,9,58,42,16,61
Dundee Utd,397,4,16,8,12,51,38,13,56
Ayr,397,5,11,10,15,37,53,-16,43
Dunfermline,397,6,10,11,15,48,51,-3,41
Dumbarton,397,7,10,11,15,51,57,-6,41
Raith,397,8,10,9,17,33,50,-17,39
Queen of S't,397,9,10,8,18,42,55,-13,38
St Mirren,397,10,8,10,18,35,58,-23,34
Hibernian,398,1,20,11,5,54,25,29,71
Morton,398,2,17,12,7,52,37,15,63
Dundee Utd,398,3,18,8,10,49,39,10,62
Falkirk,398,4,14,10,12,56,44,12,52
Queen of S't,398,5,13,11,12,44,44,0,50
Dumbarton,398,6,11,12,13,56,55,1,45
Dunfermline,398,7,8,14,14,43,50,-7,38
Raith,398,8,9,10,17,33,52,-19,37
Ayr,398,9,8,11,17,33,55,-22,35
St Mirren,398,10,8,9,19,36,55,-19,33
Hibernian,399,1,20,10,6,53,24,29,70
Morton,399,2,19,9,8,56,35,21,66
Dundee Utd,399,3,17,8,11,54,44,10,59
Falkirk,399,4,16,10,10,60,42,18,58
Queen of S't,399,5,13,9,14,46,48,-2,48
St Mirren,399,6,11,10,15,43,53,-10,43
Dunfermline,399,7,9,13,14,47,55,-8,40
Dumbarton,399,8,10,10,16,46,56,-10,40
Raith,399,9,9,10,17,32,50,-18,37
Ayr,399,10,6,11,19,30,60,-30,29
Hibernian,400,1,18,15,3,55,26,29,69
Falkirk,400,2,18,10,8,66,41,25,64
Morton,400,3,16,13,7,48,36,12,61
Dundee Utd,400,4,16,9,11,47,44,3,57
Dumbarton,400,5,9,13,14,48,55,-7,40
Raith,400,6,10,10,16,34,48,-14,40
Queen of S't,400,7,9,12,15,42,50,-8,39
Ayr,400,8,9,12,15,36,51,-15,39
Dunfermline,400,9,8,14,14,45,51,-6,38
St Mirren,400,10,8,10,18,40,59,-19,34
Hibernian,401,1,19,13,4,54,26,28,70
Morton,401,2,16,12,8,49,35,14,60
Falkirk,401,3,16,9,11,59,42,17,57
Dundee Utd,401,4,15,9,12,50,43,7,54
Dunfermline,401,5,11,12,13,51,53,-2,45
Queen of S't,401,6,12,9,15,44,50,-6,45
Raith,401,7,12,8,16,38,49,-11,44
Ayr,401,8,9,13,14,35,52,-17,40
Dumbarton,401,9,8,14,14,46,55,-9,38
St Mirren,401,10,7,11,18,36,57,-21,32
Hibernian,402,1,18,14,4,58,29,29,68
Morton,402,2,19,10,7,52,36,16,67
Falkirk,402,3,15,12,9,59,43,16,57
Dundee Utd,402,4,15,12,9,48,37,11,57
Queen of S't,402,5,11,11,14,43,49,-6,44
Dumbarton,402,6,10,13,13,52,57,-5,43
Raith,402,7,11,9,16,38,50,-12,42
Dunfermline,402,8,8,15,13,44,48,-4,39
St Mirren,402,9,8,10,18,36,54,-18,34
Ayr,402,10,6,12,18,36,63,-27,30
Hibernian,403,1,19,12,5,62,26,36,69
Morton,403,2,17,12,7,50,36,14,63
Falkirk,403,3,14,11,11,53,45,8,53
Dundee Utd,403,4,13,11,12,47,43,4,50
Queen of S't,403,5,13,9,14,46,49,-3,48
Dunfermline,403,6,11,13,12,48,42,6,46
St Mirren,403,7,12,9,15,52,53,-1,45
Raith,403,8,10,9,17,34,56,-22,39
Ayr,403,9,8,13,15,34,57,-23,37
Dumbarton,403,10,8,11,17,45,64,-19,35
Hibernian,404,1,19,12,5,58,25,33,69
Morton,404,2,17,13,6,52,33,19,64
Dundee Utd,404,3,18,10,8,55,37,18,64
Falkirk,404,4,16,11,9,55,40,15,59
Queen of S't,404,5,11,9,16,44,54,-10,42
Dunfermline,404,6,8,14,14,43,52,-9,38
Raith,404,7,9,11,16,35,48,-13,38
Dumbarton,404,8,8,12,16,46,57,-11,36
St Mirren,404,9,8,12,16,37,54,-17,36
Ayr,404,10,8,12,16,35,60,-25,36
Hibernian,405,1,18,15,3,51,22,29,69
Falkirk,405,2,17,11,8,63,42,21,62
Morton,405,3,16,13,7,54,40,14,61
Dundee Utd,405,4,17,8,11,52,42,10,59
Queen of S't,405,5,11,12,13,45,48,-3,45
Raith,405,6,11,9,16,40,52,-12,42
Dumbarton,405,7,9,13,14,45,53,-8,40
Dunfermline,405,8,8,12,16,42,53,-11,36
Ayr,405,9,7,14,15,30,51,-21,35
St Mirren,405,10,7,11,18,39,58,-19,32
Hibernian,406,1,22,10,4,61,27,34,76
Dundee Utd,406,2,18,10,8,53,36,17,64
Falkirk,406,3,16,9,11,59,47,12,57
Morton,406,4,14,14,8,44,35,9,56
Dunfermline,406,5,11,13,12,50,49,1,46
Queen of S't,406,6,11,9,16,46,54,-8,42
Ayr,406,7,10,10,16,40,53,-13,40
Dumbarton,406,8,9,11,16,52,64,-12,38
Raith,406,9,8,11,17,34,55,-21,35
St Mirren,406,10,7,11,18,41,60,-19,32
Hibernian,407,1,18,15,3,57,24,33,69
Morton,407,2,18,13,5,54,34,20,67
Dundee Utd,407,3,17,10,9,55,39,16,61
Falkirk,407,4,14,12,10,54,43,11,54
Raith,407,5,12,9,15,37,49,-12,45
Queen of S't,407,6,12,8,16,53,53,0,44
Dunfermline,407,7,9,12,15,43,50,-7,39
Dumbarton,407,8,8,12,16,46,61,-15,36
St Mirren,407,9,9,9,18,42,62,-20,36
Ayr,407,10,6,14,16,33,59,-26,32
Hibernian,408,1,18,13,5,55,27,28,67
Dundee Utd,408,2,16,10,10,48,37,11,58
Morton,408,3,15,12,9,49,41,8,57
Falkirk,408,4,15,11,10,56,42,14,56
Ayr,408,5,12,10,14,37,51,-14,46
Queen of S't,408,6,11,10,15,47,50,-3,43
Dunfermline,408,7,10,12,14,46,53,-7,42
Raith,408,8,11,9,16,39,50,-11,42
Dumbarton,408,9,10,11,15,45,52,-7,41
St Mirren,408,10,8,10,18,38,57,-19,34
Hibernian,409,1,19,12,5,57,25,32,69
Dundee Utd,409,2,19,8,9,57,39,18,65
Falkirk,409,3,16,11,9,58,40,18,59
Morton,409,4,16,11,9,46,37,9,59
Dunfermline,409,5,13,12,11,55,47,8,51
Queen of S't,409,6,11,10,15,43,50,-7,43
Raith,409,7,10,9,17,33,49,-16,39
Dumbarton,409,8,8,12,16,48,63,-15,36
Ayr,409,9,8,10,18,32,58,-26,34
St Mirren,409,10,7,11,18,34,55,-21,32
Hibernian,410,1,18,11,7,54,30,24,65
Falkirk,410,2,17,11,8,64,40,24,62
Morton,410,3,17,10,9,51,35,16,61
Dundee Utd,410,4,15,12,9,47,38,9,57
Queen of S't,410,5,13,8,15,48,52,-4,47
Dunfermline,410,6,10,13,13,49,47,2,43
Dumbarton,410,7,10,12,14,53,63,-10,42
Raith,410,8,10,10,16,34,51,-17,40
Ayr,410,9,7,14,15,33,60,-27,35
St Mirren,410,10,8,9,19,42,59,-17,33
Hibernian,411,1,19,12,5,57,26,31,69
Dundee Utd,411,2,16,10,10,50,42,8,58
Morton,411,3,16,9,11,53,45,8,57
Falkirk,411,4,15,10,11,52,40,12,55
Dunfermline,411,5,13,12,11,49,42,7,51
Queen of S't,411,6,13,10,13,44,46,-2,49
Dumbarton,411,7,10,11,15,51,55,-4,41
Raith,411,8,9,10,17,35,52,-17,37
St Mirren,411,9,8,11,17,45,60,-15,35
Ayr,411,10,8,11,17,35,63,-28,35
Hibernian,412,1,22,10,4,60,23,37,76
Dundee Utd,412,2,17,10,9,53,41,12,61
Falkirk,412,3,15,12,9,62,43,19,57
Morton,412,4,15,11,10,46,36,10,56
Queen of S't,412,5,14,8,14,49,48,1,50
Dunfermline,412,6,9,14,13,45,53,-8,41
Raith,412,7,10,10,16,33,46,-13,40
Dumbarton,412,8,8,11,17,51,61,-10,35
St Mirren,412,9,8,11,17,39,62,-23,35
Ayr,412,10,8,11,17,33,58,-25,35
Morton,413,1,19,10,7,54,36,18,67
Hibernian,413,2,18,11,7,54,28,26,65
Falkirk,413,3,16,10,10,60,43,17,58
Dundee Utd,413,4,15,11,10,46,41,5,56
Dunfermline,413,5,11,14,11,49,46,3,47
Queen of S't,413,6,10,11,15,41,53,-12,41
Ayr,413,7,9,12,15,32,49,-17,39
St Mirren,413,8,9,11,16,47,58,-11,38
Raith,413,9,10,8,18,32,50,-18,38
Dumbarton,413,10,8,12,16,48,59,-11,36
Hibernian,414,1,19,12,5,56,29,27,69
Morton,414,2,17,10,9,53,39,14,61
Falkirk,414,3,16,12,8,59,40,19,60
Dundee Utd,414,4,15,8,13,50,44,6,53
Dunfermline,414,5,10,14,12,47,46,1,44
Dumbarton,414,6,11,11,14,50,56,-6,44
Ayr,414,7,11,11,14,37,51,-14,44
Queen of S't,414,8,11,10,15,43,51,-8,43
Raith,414,9,10,8,18,32,49,-17,38
St Mirren,414,10,7,10,19,36,58,-22,31
Hibernian,415,1,18,13,5,55,27,28,67
Falkirk,415,2,17,10,9,69,43,26,61
Morton,415,3,16,12,8,47,34,13,60
Dundee Utd,415,4,16,10,10,58,40,18,58
Queen of S't,415,5,12,9,15,48,56,-8,45
Raith,415,6,12,9,15,37,50,-13,45
Dumbarton,415,7,9,12,15,48,63,-15,39
Ayr,415,8,8,14,14,30,49,-19,38
St Mirren,415,9,9,10,17,39,58,-19,37
Dunfermline,415,10,7,13,16,42,53,-11,34
Hibernian,416,1,18,13,5,56,25,31,67
Dundee Utd,416,2,17,10,9,51,38,13,61
Morton,416,3,15,11,10,49,40,9,56
Falkirk,416,4,15,10,11,60,49,11,55
Queen of S't,416,5,13,10,13,50,53,-3,49
Dunfermline,416,6,11,11,14,45,50,-5,44
St Mirren,416,7,9,12,15,42,52,-10,39
Ayr,416,8,8,15,13,36,54,-18,39
Raith,416,9,9,10,17,34,51,-17,37
Dumbarton,416,10,8,12,16,48,59,-11,36
Hibernian,417,1,19,14,3,55,24,31,71
Falkirk,417,2,15,12,9,57,41,16,57
Dundee Utd,417,3,15,11,10,48,37,11,56
Morton,417,4,14,13,9,50,40,10,55
Dunfermline,417,5,10,15,11,47,47,0,45
Raith,417,6,12,8,16,34,49,-15,44
Queen of S't,417,7,11,9,16,43,52,-9,42
St Mirren,417,8,9,12,15,45,57,-12,39
Dumbarton,417,9,8,12,16,46,60,-14,36
Ayr,417,10,8,12,16,36,54,-18,36
Hibernian,418,1,20,12,4,59,25,34,72
Morton,418,2,17,11,8,48,33,15,62
Dundee Utd,418,3,16,11,9,55,41,14,59
Falkirk,418,4,14,11,11,59,48,11,53
Dumbarton,418,5,11,11,14,50,56,-6,44
Queen of S't,418,6,11,11,14,46,53,-7,44
Ayr,418,7,9,12,15,34,54,-20,39
Dunfermline,418,8,8,14,14,47,52,-5,38
St Mirren,418,9,9,9,18,41,58,-17,36
Raith,418,10,8,12,16,35,54,-19,36
Hibernian,419,1,18,13,5,54,28,26,67
Dundee Utd,419,2,17,11,8,54,38,16,62
Morton,419,3,17,9,10,56,43,13,60
Falkirk,419,4,14,11,11,52,40,12,53
Raith,419,5,13,8,15,41,50,-9,47
Dumbarton,419,6,11,10,15,47,52,-5,43
Queen of S't,419,7,11,10,15,45,51,-6,43
St Mirren,419,8,10,10,16,43,55,-12,40
Dunfermline,419,9,9,12,15,43,52,-9,39
Ayr,419,10,7,12,17,33,59,-26,33
Hibernian,420,1,19,11,6,52,29,23,68
Falkirk,420,2,16,12,8,56,37,19,60
Morton,420,3,14,15,7,51,39,12,57
Dundee Utd,420,4,14,11,11,46,41,5,53
Queen of S't,420,5,12,9,15,43,49,-6,45
Dunfermline,420,6,9,15,12,44,45,-1,42
Ayr,420,7,10,12,14,39,51,-12,42
Raith,420,8,11,9,16,34,46,-12,42
St Mirren,420,9,9,12,15,43,56,-13,39
Dumbarton,420,10,7,12,17,44,59,-15,33
Hibernian,421,1,18,14,4,52,25,27,68
Morton,421,2,18,11,7,53,33,20,65
Falkirk,421,3,17,10,9,62,43,19,61
Dundee Utd,421,4,15,13,8,51,38,13,58
Dumbarton,421,5,10,12,14,50,58,-8,42
Raith,421,6,11,9,16,37,47,-10,42
Queen of S't,421,7,10,11,15,44,52,-8,41
Ayr,421,8,8,13,15,35,56,-21,37
Dunfermline,421,9,7,14,15,42,53,-11,35
St Mirren,421,10,7,11,18,35,56,-21,32
Hibernian,422,1,19,14,3,55,22,33,71
Morton,422,2,17,10,9,50,39,11,61
Falkirk,422,3,16,11,9,55,37,18,59
Dundee Utd,422,4,15,12,9,54,42,12,57
Queen of S't,422,5,11,11,14,44,50,-6,44
Dumbarton,422,6,10,13,13,52,58,-6,43
Dunfermline,422,7,9,13,14,48,55,-7,40
Raith,422,8,10,9,17,34,47,-13,39
St Mirren,422,9,8,11,17,37,54,-17,35
Ayr,422,10,7,12,17,30,55,-25,33
Hibernian,423,1,19,11,6,58,29,29,68
Morton,423,2,18,9,9,50,33,17,63
Falkirk,423,3,15,12,9,56,41,15,57
Dundee Utd,423,4,14,11,11,48,41,7,53
Dunfermline,423,5,13,13,10,49,44,5,52
Ayr,423,6,10,12,14,35,50,-15,42
Queen of S't,423,7,9,12,15,41,52,-11,39
Raith,423,8,9,11,16,33,49,-16,38
St Mirren,423,9,8,12,16,42,57,-15,36
Dumbarton,423,10,8,11,17,43,59,-16,35
Morton,424,1,19,10,7,56,36,20,67
Hibernian,424,2,18,10,8,51,29,22,64
Dundee Utd,424,3,16,9,11,49,40,9,57
Falkirk,424,4,15,9,12,54,45,9,54
Queen of S't,424,5,12,9,15,43,50,-7,45
Dumbarton,424,6,11,10,15,51,55,-4,43
Dunfermline,424,7,10,12,14,45,48,-3,42
Ayr,424,8,10,11,15,38,56,-18,41
Raith,424,9,10,10,16,38,50,-12,40
St Mirren,424,10,9,10,17,40,56,-16,37
Hibernian,425,1,18,14,4,54,25,29,68
Morton,425,2,15,12,9,50,39,11,57
Dundee Utd,425,3,15,10,11,53,45,8,55
Falkirk,425,4,13,12,11,54,46,8,51
Dunfermline,425,5,12,13,11,48,47,1,49
Queen of S't,425,6,11,10,15,49,52,-3,43
St Mirren,425,7,11,9,16,44,51,-7,42
Dumbarton,425,8,9,13,14,48,59,-11,40
Raith,425,9,10,10,16,32,49,-17,40
Ayr,425,10,9,11,16,36,55,-19,38
Hibernian,426,1,18,13,5,52,27,25,67
Morton,426,2,16,12,8,50,36,14,60
Falkirk,426,3,16,10,10,60,41,19,58
Dundee Utd,426,4,15,10,11,50,41,9,55
Dunfermline,426,5,13,13,10,51,41,10,52
Queen of S't,426,6,10,12,14,44,55,-11,42
Raith,426,7,9,13,14,30,43,-13,40
Dumbarton,426,8,8,14,14,46,55,-9,38
Ayr,426,9,8,13,15,32,52,-20,37
St Mirren,426,10,7,10,19,36,60,-24,31
Hibernian,427,1,21,11,4,59,23,36,74
Falkirk,427,2,17,9,10,57,42,15,60
Morton,427,3,15,13,8,48,37,11,58
Dundee Utd,427,4,16,9,11,51,38,13,57
Queen of S't,427,5,14,9,13,50,48,2,51
Dunfermline,427,6,10,13,13,48,49,-1,43
Ayr,427,7,10,11,15,38,57,-19,41
Raith,427,8,9,10,17,36,52,-16,37
Dumbarton,427,9,7,12,17,50,69,-19,33
St Mirren,427,10,8,9,19,35,57,-22,33
Hibernian,428,1,20,13,3,57,23,34,73
Falkirk,428,2,17,12,7,59,36,23,63
Morton,428,3,16,13,7,46,34,12,61
Dundee Utd,428,4,16,10,10,48,37,11,58
Queen of S't,428,5,12,9,15,48,53,-5,45
Raith,428,6,10,10,16,37,51,-14,40
Ayr,428,7,10,10,16,34,52,-18,40
Dunfermline,428,8,8,13,15,44,53,-9,37
Dumbarton,428,9,8,11,17,47,61,-14,35
St Mirren,428,10,7,11,18,39,59,-20,32
Morton,429,1,20,10,6,56,36,20,70
Hibernian,429,2,19,10,7,53,28,25,67
Falkirk,429,3,16,11,9,59,41,18,59
Dundee Utd,429,4,15,9,12,47,41,6,54
Queen of S't,429,5,14,9,13,45,45,0,51
Dumbarton,429,6,10,12,14,51,54,-3,42
Ayr,429,7,9,13,14,33,48,-15,40
Dunfermline,429,8,9,12,15,44,56,-12,39
Raith,429,9,8,9,19,31,51,-20,33
St Mirren,429,10,7,11,18,35,54,-19,32
Hibernian,430,1,19,12,5,57,25,32,69
Morton,430,2,16,11,9,50,39,11,59
Dundee Utd,430,3,15,10,11,49,42,7,55
Falkirk,430,4,15,9,12,58,45,13,54
Queen of S't,430,5,14,9,13,44,44,0,51
Dumbarton,430,6,10,12,14,48,54,-6,42
Raith,430,7,11,9,16,34,47,-13,42
Dunfermline,430,8,9,13,14,44,52,-8,40
Ayr,430,9,9,11,16,35,56,-21,38
St Mirren,430,10,9,10,17,42,57,-15,37
Hibernian,431,1,19,13,4,52,23,29,70
Morton,431,2,17,10,9,48,36,12,61
Dundee Utd,431,3,16,11,9,50,39,11,59
Falkirk,431,4,14,11,11,56,44,12,53
Raith,431,5,12,10,14,34,46,-12,46
Dunfermline,431,6,10,13,13,47,45,2,43
Queen of S't,431,7,11,10,15,44,49,-5,43
St Mirren,431,8,9,11,16,47,56,-9,38
Dumbarton,431,9,8,12,16,45,63,-18,36
Ayr,431,10,8,11,17,34,56,-22,35
Hibernian,432,1,18,12,6,58,30,28,66
Morton,432,2,17,9,10,54,43,11,60
Falkirk,432,3,16,10,10,59,48,11,58
Dundee Utd,432,4,14,11,11,49,43,6,53
Dunfermline,432,5,13,13,10,57,42,15,52
Ayr,432,6,11,11,14,38,54,-16,44
Queen of S't,432,7,10,10,16,42,53,-11,40
St Mirren,432,8,10,10,16,41,53,-12,40
Dumbarton,432,9,8,13,15,50,59,-9,37
Raith,432,10,9,9,18,33,56,-23,36
Hibernian,433,1,20,10,6,57,27,30,70
Morton,433,2,17,12,7,52,37,15,63
Dundee Utd,433,3,18,8,10,49,37,12,62
Falkirk,433,4,14,11,11,53,42,11,53
Queen of S't,433,5,13,9,14,51,50,1,48
Raith,433,6,11,11,14,37,47,-10,44
Dumbarton,433,7,10,11,15,50,63,-13,41
Dunfermline,433,8,9,12,15,47,53,-6,39
Ayr,433,9,8,11,17,35,57,-22,35
St Mirren,433,10,7,11,18,37,55,-18,32
Morton,434,1,18,11,7,54,37,17,65
Hibernian,434,2,17,13,6,50,28,22,64
Falkirk,434,3,17,11,8,65,40,25,62
Dundee Utd,434,4,15,9,12,56,46,10,54
Dumbarton,434,5,11,13,12,48,50,-2,46
Queen of S't,434,6,12,8,16,43,50,-7,44
Dunfermline,434,7,10,12,14,45,54,-9,42
Raith,434,8,10,9,17,37,54,-17,39
Ayr,434,9,8,13,15,36,53,-17,37
St Mirren,434,10,7,11,18,37,59,-22,32
Hibernian,435,1,19,13,4,55,25,30,70
Morton,435,2,17,11,8,51,36,15,62
Dundee Utd,435,3,17,9,10,56,38,18,60
Falkirk,435,4,16,10,10,57,42,15,58
Dunfermline,435,5,11,12,13,45,49,-4,45
Queen of S't,435,6,11,10,15,46,54,-8,43
Raith,435,7,11,9,16,39,47,-8,42
Dumbarton,435,8,9,13,14,46,52,-6,40
Ayr,435,9,7,13,16,33,60,-27,34
St Mirren,435,10,7,10,19,38,63,-25,31
Hibernian,436,1,17,14,5,54,26,28,65
Morton,436,2,17,11,8,50,39,11,62
Falkirk,436,3,17,9,10,55,41,14,60
Dundee Utd,436,4,14,11,11,48,42,6,53
Dumbarton,436,5,11,12,13,51,51,0,45
Dunfermline,436,6,11,12,13,47,49,-2,45
Raith,436,7,11,11,14,41,45,-4,44
Queen of S't,436,8,11,8,17,42,54,-12,41
Ayr,436,9,8,13,15,35,56,-21,37
St Mirren,436,10,6,13,17,38,58,-20,31
Hibernian,437,1,18,14,4,56,28,28,68
Dundee Utd,437,2,18,10,8,56,39,17,64
Morton,437,3,14,15,7,50,42,8,57
Falkirk,437,4,14,12,10,56,40,16,54
Dunfermline,437,5,10,14,12,45,46,-1,44
Dumbarton,437,6,10,11,15,48,58,-10,41
Queen of S't,437,7,10,10,16,45,55,-10,40
Raith,437,8,9,11,16,39,53,-14,38
Ayr,437,9,8,13,15,37,58,-21,37
St Mirren,437,10,8,12,16,42,55,-13,36
Hibernian,438,1,20,12,4,64,31,33,72
Falkirk,438,2,17,10,9,60,40,20,61
Morton,438,3,16,13,7,52,38,14,61
Dundee Utd,438,4,14,9,13,52,49,3,51
Queen of S't,438,5,13,11,12,50,49,1,50
Dunfermline,438,6,9,14,13,47,48,-1,41
St Mirren,438,7,10,9,17,42,56,-14,39
Raith,438,8,9,10,17,32,50,-18,37
Ayr,438,9,8,13,15,34,55,-21,37
Dumbarton,438,10,8,11,17,46,63,-17,35
Hibernian,439,1,19,12,5,54,23,31,69
Morton,439,2,19,11,6,54,34,20,68
Dundee Utd,439,3,16,10,10,50,41,9,58
Falkirk,439,4,15,11,10,56,42,14,56
Queen of S't,439,5,12,9,15,43,49,-6,45
Dumbarton,439,6,10,12,14,49,56,-7,42
Dunfermline,439,7,8,16,12,42,46,-4,40
Raith,439,8,9,11,16,35,51,-16,38
Ayr,439,9,7,13,16,31,54,-23,34
St Mirren,439,10,8,9,19,41,59,-18,33
Hibernian,440,1,20,11,5,53,25,28,71
Dundee Utd,440,2,17,10,9,57,40,17,61
Falkirk,440,3,16,11,9,53,37,16,59
Morton,440,4,15,12,9,47,38,9,57
Queen of S't,440,5,12,11,13,49,52,-3,47
Raith,440,6,11,9,16,36,47,-11,42
Dumbarton,440,7,10,10,16,54,67,-13,40
Dunfermline,440,8,8,14,14,47,51,-4,38
Ayr,440,9,8,11,17,37,56,-19,35
St Mirren,440,10,8,11,17,36,56,-20,35
Hibernian,441,1,18,11,7,56,29,27,65
Morton,441,2,17,13,6,50,32,18,64
Falkirk,441,3,13,12,11,54,47,7,51
Dundee Utd,441,4,14,8,14,44,42,2,50
Queen of S't,441,5,12,10,14,45,48,-3,46
Ayr,441,6,11,11,14,34,50,-16,44
Dunfermline,441,7,9,15,12,47,49,-2,42
Dumbarton,441,8,10,12,14,49,58,-9,42
Raith,441,9,10,10,16,33,49,-16,40
St Mirren,441,10,9,12,15,47,55,-8,39
Hibernian,442,1,19,12,5,59,25,34,69
Morton,442,2,20,9,7,54,35,19,69
Falkirk,442,3,15,10,11,55,44,11,55
Dundee Utd,442,4,15,10,11,47,39,8,55
Queen of S't,442,5,13,10,13,49,48,1,49
Dunfermline,442,6,12,12,12,47,41,6,48
St Mirren,442,7,9,11,16,45,59,-14,38
Raith,442,8,9,9,18,32,54,-22,36
Ayr,442,9,8,11,17,34,57,-23,35
Dumbarton,442,10,8,10,18,44,64,-20,34
Hibernian,443,1,20,12,4,55,24,31,72
Morton,443,2,18,11,7,48,34,14,65
Dundee Utd,443,3,15,10,11,49,41,8,55
Falkirk,443,4,15,9,12,53,43,10,54
Raith,443,5,13,8,15,41,49,-8,47
Dunfermline,443,6,11,12,13,49,45,4,45
Queen of S't,443,7,11,9,16,41,53,-12,42
Dumbarton,443,8,9,12,15,50,62,-12,39
St Mirren,443,9,8,10,18,41,56,-15,34
Ayr,443,10,7,13,16,35,55,-20,34
Hibernian,444,1,19,12,5,56,27,29,69
Falkirk,444,2,18,11,7,59,36,23,65
Morton,444,3,16,12,8,49,33,16,60
Dundee Utd,444,4,15,11,10,47,37,10,56
Queen of S't,444,5,13,8,15,49,52,-3,47
Dunfermline,444,6,8,15,13,39,47,-8,39
Ayr,444,7,9,12,15,36,52,-16,39
Dumbarton,444,8,9,11,16,42,55,-13,38
Raith,444,9,9,11,16,30,45,-15,38
St Mirren,444,10,8,9,19,36,59,-23,33
Hibernian,445,1,19,12,5,56,24,32,69
Falkirk,445,2,18,10,8,64,39,25,64
Morton,445,3,17,10,9,49,40,9,61
Dundee Utd,445,4,16,10,10,54,43,11,58
Raith,445,5,12,9,15,38,50,-12,45
Queen of S't,445,6,12,8,16,45,52,-7,44
Ayr,445,7,11,11,14,35,53,-18,44
Dunfermline,445,8,9,12,15,51,54,-3,39
Dumbarton,445,9,8,10,18,45,62,-17,34
St Mirren,445,10,7,10,19,38,58,-20,31
Hibernian,446,1,22,11,3,65,25,40,77
Morton,446,2,18,10,8,56,39,17,64
Dundee Utd,446,3,16,11,9,53,40,13,59
Falkirk,446,4,14,12,10,53,44,9,54
Dunfermline,446,5,11,12,13,50,45,5,45
Queen of S't,446,6,10,11,15,43,54,-11,41
St Mirren,446,7,9,11,16,40,53,-13,38
Dumbarton,446,8,8,12,16,49,65,-16,36
Raith,446,9,9,9,18,32,52,-20,36
Ayr,446,10,6,15,15,32,56,-24,33
Hibernian,447,1,20,12,4,57,26,31,72
Morton,447,2,16,12,8,48,36,12,60
Falkirk,447,3,14,12,10,54,41,13,54
Dundee Utd,447,4,14,11,11,50,41,9,53
Dunfermline,447,5,11,13,12,47,46,1,46
Queen of S't,447,6,12,10,14,44,46,-2,46
St Mirren,447,7,10,10,16,44,55,-11,40
Raith,447,8,9,11,16,33,49,-16,38
Ayr,447,9,8,13,15,35,56,-21,37
Dumbarton,447,10,8,12,16,51,67,-16,36
Hibernian,448,1,21,12,3,55,22,33,75
Morton,448,2,18,10,8,55,35,20,64
Dundee Utd,448,3,17,11,8,52,38,14,62
Falkirk,448,4,17,10,9,58,38,20,61
Queen of S't,448,5,11,9,16,44,52,-8,42
Raith,448,6,11,9,16,37,49,-12,42
St Mirren,448,7,8,12,16,43,53,-10,36
Dunfermline,448,8,8,12,16,41,51,-10,36
Ayr,448,9,7,13,16,32,58,-26,34
Dumbarton,448,10,7,12,17,41,62,-21,33
Hibernian,449,1,17,13,6,55,32,23,64
Dundee Utd,449,2,17,11,8,50,34,16,62
Morton,449,3,16,12,8,51,39,12,60
Falkirk,449,4,15,11,10,56,41,15,56
Queen of S't,449,5,13,10,13,46,46,0,49
Dunfermline,449,6,10,12,14,47,50,-3,42
St Mirren,449,7,10,11,15,45,54,-9,41
Raith,449,8,9,10,17,35,53,-18,37
Dumbarton,449,9,8,12,16,42,55,-13,36
Ayr,449,10,7,14,15,31,54,-23,35
Hibernian,450,1,21,11,4,60,25,35,74
Falkirk,450,2,16,9,11,58,45,13,57
Morton,450,3,15,11,10,48,40,8,56
Dundee Utd,450,4,14,12,10,49,41,8,54
Queen of S't,450,5,14,9,13,53,53,0,51
Dunfermline,450,6,11,13,12,45,47,-2,46
Dumbarton,450,7,11,12,13,52,55,-3,45
Raith,450,8,10,10,16,40,53,-13,40
St Mirren,450,9,7,11,18,40,60,-20,32
Ayr,450,10,6,12,18,31,57,-26,30
Hibernian,451,1,19,11,6,54,30,24,68
Falkirk,451,2,17,10,9,53,35,18,61
Morton,451,3,17,10,9,49,39,10,61
Dundee Utd,451,4,14,10,12,43,36,7,52
Queen of S't,451,5,13,10,13,45,45,0,49
Dunfermline,451,6,9,14,13,42,45,-3,41
St Mirren,451,7,10,10,16,43,50,-7,40
Raith,451,8,10,10,16,33,49,-16,40
Dumbarton,451,9,8,13,15,46,57,-11,37
Ayr,451,10,8,12,16,33,55,-22,36
Hibernian,452,1,18,11,7,53,30,23,65
Morton,452,2,18,11,7,53,36,17,65
Falkirk,452,3,17,10,9,60,42,18,61
Dundee Utd,452,4,16,10,10,57,42,15,58
Queen of S't,452,5,11,11,14,47,49,-2,44
Dunfermline,452,6,10,13,13,49,51,-2,43
Raith,452,7,11,10,15,42,49,-7,43
Dumbarton,452,8,9,10,17,48,63,-15,37
Ayr,452,9,8,13,15,32,56,-24,37
St Mirren,452,10,7,11,18,38,61,-23,32
Hibernian,453,1,21,11,4,60,25,35,74
Morton,453,2,18,13,5,56,33,23,67
Falkirk,453,3,15,11,10,57,45,12,56
Dundee Utd,453,4,15,10,11,51,39,12,55
Dunfermline,453,5,10,12,14,44,49,-5,42
Dumbarton,453,6,10,11,15,47,55,-8,41
Queen of S't,453,7,10,11,15,41,52,-11,41
Raith,453,8,9,13,14,33,44,-11,40
Ayr,453,9,7,14,15,32,57,-25,35
St Mirren,453,10,6,12,18,37,59,-22,30
Morton,454,1,18,11,7,52,35,17,65
Hibernian,454,2,17,13,6,53,33,20,64
Dundee Utd,454,3,17,9,10,57,43,14,60
Falkirk,454,4,15,12,9,58,39,19,57
Queen of S't,454,5,11,12,13,45,48,-3,45
Raith,454,6,12,9,15,36,48,-12,45
Dumbarton,454,7,10,11,15,53,60,-7,41
Dunfermline,454,8,9,13,14,50,57,-7,40
St Mirren,454,9,9,10,17,45,57,-12,37
Ayr,454,10,7,10,19,35,64,-29,31
Hibernian,455,1,19,14,3,56,23,33,71
Falkirk,455,2,16,11,9,54,38,16,59
Morton,455,3,15,12,9,50,41,9,57
Dundee Utd,455,4,14,11,11,50,46,4,53
Dumbarton,455,5,11,12,13,48,53,-5,45
Dunfermline,455,6,10,14,12,45,45,0,44
Queen of S't,455,7,11,8,17,46,53,-7,41
St Mirren,455,8,9,12,15,42,54,-12,39
Raith,455,9,9,11,16,38,53,-15,38
Ayr,455,10,7,13,16,38,61,-23,34
Morton,456,1,18,13,5,52,33,19,67
Hibernian,456,2,17,11,8,52,30,22,62
Falkirk,456,3,16,11,9,58,43,15,59
Dundee Utd,456,4,14,10,12,48,43,5,52
Dunfermline,456,5,11,14,11,51,47,4,47
Queen of S't,456,6,11,11,14,45,49,-4,44
Raith,456,7,11,8,17,38,50,-12,41
St Mirren,456,8,9,13,14,43,54,-11,40
Ayr,456,9,8,12,16,33,58,-25,36
Dumbarton,456,10,8,11,17,45,58,-13,35
Hibernian,457,1,20,11,5,56,24,32,71
Falkirk,457,2,17,12,7,60,36,24,63
Morton,457,3,17,11,8,51,36,15,62
Dundee Utd,457,4,16,11,9,50,40,10,59
Queen of S't,457,5,12,10,14,45,47,-2,46
Dunfermline,457,6,10,13,13,46,48,-2,43
Ayr,457,7,8,13,15,36,55,-19,37
Raith,457,8,8,11,17,33,53,-20,35
St Mirren,457,9,8,10,18,40,62,-22,34
Dumbarton,457,10,7,12,17,49,65,-16,33
Hibernian,458,1,21,12,3,60,25,35,75
Morton,458,2,18,12,6,53,34,19,66
Falkirk,458,3,14,14,8,55,39,16,56
Dundee Utd,458,4,14,10,12,49,43,6,52
Queen of S't,458,5,11,11,14,41,47,-6,44
Ayr,458,6,10,11,15,37,53,-16,41
Dunfermline,458,7,9,13,14,44,54,-10,40
Raith,458,8,9,10,17,32,46,-14,37
Dumbarton,458,9,8,12,16,45,59,-14,36
St Mirren,458,10,8,11,17,40,56,-16,35
Hibernian,459,1,20,11,5,56,23,33,71
Falkirk,459,2,17,10,9,58,38,20,61
Dundee Utd,459,3,17,9,10,51,36,15,60
Morton,459,4,16,12,8,49,39,10,60
Dumbarton,459,5,12,12,12,51,53,-2,48
Queen of S't,459,6,10,12,14,43,50,-7,42
Raith,459,7,10,9,17,35,51,-16,39
Dunfermline,459,8,8,14,14,44,48,-4,38
Ayr,459,9,8,11,17,36,59,-23,35
St Mirren,459,10,7,10,19,38,64,-26,31
Falkirk,460,1,20,9,7,64,35,29,69
Hibernian,460,2,19,11,6,54,25,29,68
Dundee Utd,460,3,16,10,10,53,39,14,58
Morton,460,4,15,12,9,44,37,7,57
Queen of S't,460,5,13,9,14,47,48,-1,48
Raith,460,6,12,9,15,37,45,-8,45
Dumbarton,460,7,8,13,15,45,55,-10,37
Dunfermline,460,8,8,13,15,42,53,-11,37
Ayr,460,9,8,11,17,32,56,-24,35
St Mirren,460,10,7,11,18,36,61,-25,32
Hibernian,461,1,20,13,3,55,23,32,73
Dundee Utd,461,2,16,12,8,53,38,15,60
Morton,461,3,15,15,6,52,39,13,60
Falkirk,461,4,15,11,10,58,39,19,56
Queen of S't,461,5,13,9,14,45,46,-1,48
Dunfermline,461,6,7,16,13,41,50,-9,37
Dumbarton,461,7,8,13,15,44,58,-14,37
Raith,461,8,9,10,17,32,47,-15,37
St Mirren,461,9,7,14,15,39,54,-15,35
Ayr,461,10,8,11,17,30,55,-25,35
Hibernian,462,1,17,14,5,54,30,24,65
Falkirk,462,2,16,11,9,58,38,20,59
Morton,462,3,14,14,8,51,41,10,56
Dundee Utd,462,4,15,10,11,53,42,11,55
Queen of S't,462,5,12,10,14,43,47,-4,46
Dunfermline,462,6,10,14,12,44,45,-1,44
Ayr,462,7,10,13,13,39,54,-15,43
Raith,462,8,10,12,14,34,46,-12,42
Dumbarton,462,9,9,11,16,47,58,-11,38
St Mirren,462,10,7,11,18,38,60,-22,32
Hibernian,463,1,19,10,7,57,30,27,67
Morton,463,2,18,10,8,50,37,13,64
Falkirk,463,3,16,10,10,59,43,16,58
Dundee Utd,463,4,16,10,10,55,39,16,58
Dunfermline,463,5,12,11,13,50,47,3,47
Queen of S't,463,6,12,9,15,46,53,-7,45
St Mirren,463,7,8,13,15,40,52,-12,37
Dumbarton,463,8,9,10,17,48,62,-14,37
Raith,463,9,9,10,17,34,53,-19,37
Ayr,463,10,8,13,15,35,58,-23,37
Hibernian,464,1,17,14,5,56,28,28,65
Morton,464,2,18,11,7,51,39,12,65
Falkirk,464,3,17,10,9,56,39,17,61
Dundee Utd,464,4,15,9,12,51,45,6,54
Queen of S't,464,5,12,11,13,44,45,-1,47
Dunfermline,464,6,10,13,13,53,51,2,43
Raith,464,7,11,9,16,38,46,-8,42
Ayr,464,8,9,12,15,33,55,-22,39
Dumbarton,464,9,8,12,16,47,58,-11,36
St Mirren,464,10,7,11,18,34,57,-23,32
Hibernian,465,1,19,13,4,51,21,30,70
Morton,465,2,17,12,7,52,33,19,63
Dundee Utd,465,3,17,9,10,57,39,18,60
Falkirk,465,4,16,11,9,62,48,14,59
Queen of S't,465,5,13,9,14,48,50,-2,48
Raith,465,6,11,10,15,36,51,-15,43
Dunfermline,465,7,9,13,14,43,48,-5,40
Dumbarton,465,8,9,11,16,48,59,-11,38
Ayr,465,9,8,11,17,32,59,-27,35
St Mirren,465,10,7,9,20,38,59,-21,30
Hibernian,466,1,19,13,4,53,23,30,70
Morton,466,2,15,13,8,47,38,9,58
Falkirk,466,3,15,11,10,56,41,15,56
Dundee Utd,466,4,15,11,10,49,41,8,56
St Mirren,466,5,11,10,15,45,52,-7,43
Queen of S't,466,6,10,12,14,44,50,-6,42
Dumbarton,466,7,10,11,15,48,53,-5,41
Ayr,466,8,10,10,16,35,54,-19,40
Dunfermline,466,9,8,15,13,42,49,-7,39
Raith,466,10,9,10,17,31,49,-18,37
Hibernian,467,1,20,11,5,59,26,33,71
Dundee Utd,467,2,20,8,8,56,33,23,68
Morton,467,3,18,10,8,46,33,13,64
Falkirk,467,4,15,12,9,58,41,17,57
Queen of S't,467,5,10,11,15,44,54,-10,41
Dunfermline,467,6,9,13,14,42,46,-4,40
Dumbarton,467,7,8,14,14,45,54,-9,38
Raith,467,8,9,10,17,32,55,-23,37
Ayr,467,9,8,11,17,35,55,-20,35
St Mirren,467,10,7,12,17,38,58,-20,33
Hibernian,468,1,16,17,3,55,26,29,65
Falkirk,468,2,17,11,8,61,38,23,62
Dundee Utd,468,3,16,9,11,53,42,11,57
Morton,468,4,15,11,10,45,40,5,56
Dunfermline,468,5,12,12,12,49,48,1,48
Dumbarton,468,6,11,11,14,48,54,-6,44
Ayr,468,7,10,13,13,42,53,-11,43
Queen of S't,468,8,10,9,17,45,59,-14,39
Raith,468,9,10,9,17,34,48,-14,39
St Mirren,468,10,7,10,19,37,61,-24,31
Hibernian,469,1,21,11,4,58,25,33,74
Morton,469,2,18,11,7,51,31,20,65
Falkirk,469,3,17,9,10,61,44,17,60
Dundee Utd,469,4,17,9,10,51,42,9,60
Queen of S't,469,5,13,8,15,50,52,-2,47
Dunfermline,469,6,8,15,13,50,53,-3,39
Ayr,469,7,9,12,15,39,57,-18,39
Raith,469,8,10,9,17,36,54,-18,39
Dumbarton,469,9,8,12,16,48,62,-14,36
St Mirren,469,10,6,10,20,38,62,-24,28
Hibernian,470,1,20,11,5,53,23,30,71
Dundee Utd,470,2,19,8,9,54,38,16,65
Morton,470,3,18,11,7,48,33,15,65
Falkirk,470,4,14,10,12,55,45,10,52
Queen of S't,470,5,13,8,15,49,51,-2,47
Raith,470,6,12,9,15,42,48,-6,45
Dunfermline,470,7,10,13,13,47,50,-3,43
Dumbarton,470,8,8,12,16,49,61,-12,36
St Mirren,470,9,7,11,18,39,60,-21,32
Ayr,470,10,6,13,17,29,56,-27,31
Hibernian,471,1,18,13,5,55,26,29,67
Falkirk,471,2,18,10,8,65,39,26,64
Dundee Utd,471,3,17,9,10,52,40,12,60
Morton,471,4,15,11,10,45,39,6,56
Queen of S't,471,5,11,10,15,45,52,-7,43
Raith,471,6,11,10,15,36,49,-13,43
Dunfermline,471,7,9,13,14,44,50,-6,40
St Mirren,471,8,9,11,16,41,54,-13,38
Dumbarton,471,9,9,10,17,46,60,-14,37
Ayr,471,10,8,13,15,33,53,-20,37
Hibernian,472,1,20,12,4,60,29,31,72
Morton,472,2,17,10,9,50,40,10,61
Falkirk,472,3,14,13,9,62,49,13,55
Dundee Utd,472,4,14,10,12,51,46,5,52
Dunfermline,472,5,12,12,12,54,49,5,48
Raith,472,6,11,10,15,45,53,-8,43
Queen of S't,472,7,10,11,15,44,51,-7,41
Ayr,472,8,10,11,15,38,56,-18,41
Dumbarton,472,9,9,13,14,50,57,-7,40
St Mirren,472,10,7,10,19,40,64,-24,31
Dundee Utd,473,1,19,8,9,57,42,15,65
Hibernian,473,2,17,12,7,55,29,26,63
Falkirk,473,3,17,10,9,60,37,23,61
Morton,473,4,15,12,9,44,38,6,57
Ayr,473,5,11,11,14,43,61,-18,44
St Mirren,473,6,11,10,15,46,53,-7,43
Queen of S't,473,7,11,9,16,48,58,-10,42
Dunfermline,473,8,8,15,13,43,47,-4,39
Raith,473,9,9,10,17,37,54,-17,37
Dumbarton,473,10,7,13,16,46,60,-14,34
Hibernian,474,1,19,13,4,58,23,35,70
Morton,474,2,17,12,7,52,37,15,63
Falkirk,474,3,17,10,9,60,47,13,61
Dundee Utd,474,4,17,9,10,58,39,19,60
Queen of S't,474,5,12,9,15,45,53,-8,45
Dunfermline,474,6,10,12,14,46,50,-4,42
Raith,474,7,10,9,17,37,51,-14,39
Dumbarton,474,8,9,11,16,46,58,-12,38
St Mirren,474,9,9,9,18,40,59,-19,36
Ayr,474,10,7,12,17,35,60,-25,33
Hibernian,475,1,20,12,4,64,27,37,72
Dundee Utd,475,2,17,9,10,50,38,12,60
Morton,475,3,16,9,11,46,38,8,57
Falkirk,475,4,15,10,11,56,42,14,55
Dumbarton,475,5,11,13,12,54,53,1,46
Dunfermline,475,6,10,14,12,46,50,-4,44
Raith,475,7,12,8,16,35,51,-16,44
Queen of S't,475,8,11,10,15,44,50,-6,43
Ayr,475,9,8,10,18,30,58,-28,34
St Mirren,475,10,8,9,19,40,58,-18,33
Hibernian,476,1,20,11,5,60,28,32,71
Morton,476,2,17,13,6,54,36,18,64
Dundee Utd,476,3,18,8,10,51,38,13,62
Falkirk,476,4,15,11,10,58,40,18,56
Dunfermline,476,5,12,12,12,46,45,1,48
Queen of S't,476,6,11,10,15,42,50,-8,43
Raith,476,7,9,10,17,35,51,-16,37
St Mirren,476,8,9,9,18,38,60,-22,36
Dumbarton,476,9,7,14,15,47,58,-11,35
Ayr,476,10,7,12,17,34,59,-25,33
Hibernian,477,1,17,12,7,48,26,22,63
Morton,477,2,17,11,8,53,42,11,62
Dundee Utd,477,3,17,8,11,55,42,13,59
Falkirk,477,4,16,10,10,58,42,16,58
Queen of S't,477,5,12,9,15,43,53,-10,45
Dumbarton,477,6,10,13,13,51,57,-6,43
Ayr,477,7,10,12,14,44,55,-11,42
Dunfermline,477,8,9,13,14,52,52,0,40
Raith,477,9,10,8,18,35,55,-20,38
St Mirren,477,10,9,10,17,41,56,-15,37
Hibernian,478,1,21,11,4,56,27,29,74
Falkirk,478,2,17,10,9,64,41,23,61
Morton,478,3,17,10,9,47,34,13,61
Dundee Utd,478,4,14,10,12,45,40,5,52
Dumbarton,478,5,11,12,13,49,56,-7,45
Dunfermline,478,6,10,11,15,44,49,-5,41
Raith,478,7,10,10,16,35,50,-15,40
St Mirren,478,8,9,11,16,41,55,-14,38
Ayr,478,9,9,11,16,36,53,-17,38
Queen of S't,478,10,9,10,17,42,54,-12,37
Hibernian,479,1,19,14,3,56,24,32,71
Morton,479,2,16,13,7,48,35,13,61
Falkirk,479,3,16,9,11,56,41,15,57
Dundee Utd,479,4,15,11,10,49,38,11,56
Queen of S't,479,5,12,11,13,45,49,-4,47
Dunfermline,479,6,11,11,14,47,53,-6,44
Raith,479,7,10,11,15,36,51,-15,41
Dumbarton,479,8,9,10,17,46,56,-10,37
St Mirren,479,9,8,12,16,37,52,-15,36
Ayr,479,10,7,12,17,36,57,-21,33
Hibernian,480,1,20,13,3,56,23,33,73
Dundee Utd,480,2,18,9,9,51,37,14,63
Falkirk,480,3,16,10,10,59,43,16,58
Morton,480,4,16,10,10,50,39,11,58
Queen of S't,480,5,12,11,13,49,50,-1,47
Dunfermline,480,6,10,13,13,45,48,-3,43
Raith,480,7,11,8,17,35,51,-16,41
Dumbarton,480,8,9,11,16,48,58,-10,38
Ayr,480,9,7,13,16,32,54,-22,34
St Mirren,480,10,7,10,19,35,57,-22,31
Hibernian,481,1,18,12,6,51,28,23,66
Morton,481,2,19,9,8,54,33,21,66
Dundee Utd,481,3,18,9,9,50,34,16,63
Falkirk,481,4,17,11,8,61,38,23,62
Queen of S't,481,5,12,10,14,50,54,-4,46
Raith,481,6,10,10,16,33,46,-13,40
Ayr,481,7,9,12,15,36,53,-17,39
St Mirren,481,8,8,12,16,36,52,-16,36
Dunfermline,481,9,8,11,17,40,55,-15,35
Dumbarton,481,10,8,10,18,46,64,-18,34
Hibernian,482,1,18,14,4,53,26,27,68
Dundee Utd,482,2,18,9,9,53,38,15,63
Falkirk,482,3,17,9,10,66,43,23,60
Morton,482,4,15,14,7,44,33,11,59
Dunfermline,482,5,11,13,12,45,44,1,46
Raith,482,6,11,10,15,36,48,-12,43
Queen of S't,482,7,10,9,17,41,56,-15,39
Ayr,482,8,8,13,15,34,53,-19,37
Dumbarton,482,9,8,12,16,50,60,-10,36
St Mirren,482,10,7,11,18,39,60,-21,32
Hibernian,483,1,19,11,6,53,26,27,68
Falkirk,483,2,16,9,11,59,40,19,57
Morton,483,3,15,12,9,53,42,11,57
Dundee Utd,483,4,15,12,9,52,41,11,57
Dunfermline,483,5,11,14,11,47,46,1,47
Dumbarton,483,6,9,14,13,53,58,-5,41
Queen of S't,483,7,10,11,15,46,57,-11,41
Ayr,483,8,9,13,14,36,53,-17,40
Raith,483,9,9,12,15,32,47,-15,39
St Mirren,483,10,7,12,17,37,58,-21,33
Hibernian,484,1,18,12,6,58,33,25,66
Morton,484,2,18,12,6,53,32,21,66
Dundee Utd,484,3,18,9,9,52,40,12,63
Falkirk,484,4,16,11,9,63,44,19,59
Queen of S't,484,5,12,10,14,49,53,-4,46
Dunfermline,484,6,8,14,14,46,56,-10,38
Raith,484,7,9,11,16,37,50,-13,38
Dumbarton,484,8,9,10,17,49,61,-12,37
St Mirren,484,9,9,10,17,38,54,-16,37
Ayr,484,10,7,13,16,35,57,-22,34
Hibernian,485,1,18,12,6,53,27,26,66
Falkirk,485,2,18,10,8,63,39,24,64
Morton,485,3,15,15,6,45,34,11,60
Dundee Utd,485,4,15,10,11,50,43,7,55
Queen of S't,485,5,11,11,14,45,48,-3,44
Ayr,485,6,10,11,15,36,56,-20,41
Dunfermline,485,7,9,13,14,46,50,-4,40
St Mirren,485,8,9,12,15,44,53,-9,39
Raith,485,9,9,10,17,33,52,-19,37
Dumbarton,485,10,7,14,15,44,57,-13,35
Hibernian,486,1,21,10,5,54,26,28,73
Falkirk,486,2,18,9,9,63,41,22,63
Dundee Utd,486,3,16,10,10,50,41,9,58
Morton,486,4,14,12,10,49,42,7,54
Queen of S't,486,5,11,10,15,43,51,-8,43
Dunfermline,486,6,9,13,14,46,50,-4,40
Raith,486,7,10,10,16,37,49,-12,40
Dumbarton,486,8,9,12,15,51,58,-7,39
Ayr,486,9,9,12,15,34,51,-17,39
St Mirren,486,10,8,12,16,38,56,-18,36
Hibernian,487,1,21,11,4,59,27,32,74
Falkirk,487,2,17,10,9,61,39,22,61
Dundee Utd,487,3,17,10,9,52,38,14,61
Morton,487,4,15,12,9,53,44,9,57
Dunfermline,487,5,10,13,13,48,48,0,43
Queen of S't,487,6,11,10,15,45,52,-7,43
Raith,487,7,10,10,16,37,48,-11,40
Dumbarton,487,8,8,13,15,47,62,-15,37
Ayr,487,9,8,13,15,36,58,-22,37
St Mirren,487,10,7,10,19,35,57,-22,31
Hibernian,488,1,17,15,4,52,26,26,66
Falkirk,488,2,17,10,9,59,40,19,61
Dundee Utd,488,3,15,11,10,51,44,7,56
Morton,488,4,14,12,10,50,42,8,54
Dunfermline,488,5,10,13,13,46,47,-1,43
Raith,488,6,11,9,16,38,52,-14,42
Queen of S't,488,7,10,11,15,45,51,-6,41
Ayr,488,8,9,14,13,44,56,-12,41
St Mirren,488,9,9,12,15,44,57,-13,39
Dumbarton,488,10,8,13,15,46,60,-14,37
Hibernian,489,1,21,11,4,58,22,36,74
Falkirk,489,2,18,10,8,58,36,22,64
Morton,489,3,18,10,8,57,40,17,64
Dundee Utd,489,4,16,10,10,56,45,11,58
Queen of S't,489,5,11,11,14,45,51,-6,44
Dumbarton,489,6,9,12,15,46,58,-12,39
Raith,489,7,9,10,17,33,48,-15,37
St Mirren,489,8,9,10,17,39,55,-16,37
Dunfermline,489,9,8,12,16,46,56,-10,36
Ayr,489,10,7,12,17,31,58,-27,33
Hibernian,490,1,20,13,3,58,21,37,73
Morton,490,2,17,12,7,49,35,14,63
Falkirk,490,3,16,10,10,55,40,15,58
Dundee Utd,490,4,13,12,11,45,40,5,51
Dunfermline,490,5,10,14,12,50,48,2,44
Queen of S't,490,6,11,9,16,43,48,-5,42
St Mirren,490,7,10,11,15,43,55,-12,41
Raith,490,8,11,8,17,34,53,-19,41
Dumbarton,490,9,10,10,16,46,59,-13,40
Ayr,490,10,7,11,18,31,55,-24,32
Hibernian,491,1,19,12,5,60,25,35,69
Morton,491,2,18,9,9,52,39,13,63
Falkirk,491,3,17,10,9,62,41,21,61
Dundee Utd,491,4,16,12,8,57,38,19,60
Dumbarton,491,5,11,10,15,49,65,-16,43
Raith,491,6,11,9,16,34,47,-13,42
Dunfermline,491,7,9,14,13,46,50,-4,41
Queen of S't,491,8,11,8,17,43,54,-11,41
St Mirren,491,9,8,10,18,40,60,-20,34
Ayr,491,10,7,12,17,32,56,-24,33
Hibernian,492,1,19,14,3,53,21,32,71
Morton,492,2,18,11,7,49,33,16,65
Dundee Utd,492,3,16,10,10,51,41,10,58
Falkirk,492,4,15,12,9,57,41,16,57
Queen of S't,492,5,11,11,14,46,51,-5,44
Dunfermline,492,6,8,14,14,42,50,-8,38
St Mirren,492,7,9,11,16,40,53,-13,38
Ayr,492,8,9,11,16,36,54,-18,38
Raith,492,9,9,10,17,34,52,-18,37
Dumbarton,492,10,7,14,15,45,57,-12,35
Hibernian,493,1,20,10,6,58,28,30,70
Morton,493,2,17,12,7,57,37,20,63
Falkirk,493,3,17,10,9,59,38,21,61
Dundee Utd,493,4,16,10,10,50,41,9,58
Raith,493,5,11,11,14,36,46,-10,44
Dumbarton,493,6,10,12,14,47,54,-7,42
Queen of S't,493,7,11,9,16,42,54,-12,42
Dunfermline,493,8,9,14,13,46,49,-3,41
Ayr,493,9,8,10,18,31,61,-30,34
St Mirren,493,10,7,10,19,41,59,-18,31
Hibernian,494,1,16,15,5,51,28,23,63
Morton,494,2,17,12,7,54,37,17,63
Falkirk,494,3,17,10,9,62,40,22,61
Dundee Utd,494,4,15,9,12,49,49,0,54
Dunfermline,494,5,11,12,13,52,51,1,45
Queen of S't,494,6,10,13,13,49,52,-3,43
Raith,494,7,10,11,15,36,50,-14,41
St Mirren,494,8,9,11,16,40,53,-13,38
Ayr,494,9,8,14,14,35,54,-19,38
Dumbarton,494,10,7,13,16,42,56,-14,34
Hibernian,495,1,19,12,5,56,26,30,69
Dundee Utd,495,2,18,10,8,56,37,19,64
Morton,495,3,17,12,7,52,37,15,63
Falkirk,495,4,16,10,10,61,40,21,58
Queen of S't,495,5,11,10,15,43,51,-8,43
Dunfermline,495,6,10,12,14,45,50,-5,42
Raith,495,7,9,11,16,35,53,-18,38
Dumbarton,495,8,9,10,17,48,60,-12,37
Ayr,495,9,9,10,17,34,58,-24,37
St Mirren,495,10,7,13,16,38,56,-18,34
Hibernian,496,1,17,12,7,52,28,24,63
Falkirk,496,2,18,9,9,59,37,22,63
Dundee Utd,496,3,15,11,10,52,43,9,56
Morton,496,4,14,14,8,49,40,9,56
Queen of S't,496,5,12,9,15,42,48,-6,45
Dunfermline,496,6,10,13,13,44,46,-2,43
Raith,496,7,11,9,16,34,48,-14,42
Dumbarton,496,8,9,12,15,48,59,-11,39
St Mirren,496,9,9,11,16,40,53,-13,38
Ayr,496,10,8,14,14,34,52,-18,38
Morton,497,1,18,11,7,50,33,17,65
Hibernian,497,2,17,12,7,55,31,24,63
Falkirk,497,3,13,15,8,58,43,15,54
Dundee Utd,497,4,14,10,12,51,45,6,52
Dunfermline,497,5,10,15,11,51,50,1,45
Raith,497,6,11,10,15,36,48,-12,43
St Mirren,497,7,10,10,16,42,52,-10,40
Queen of S't,497,8,10,10,16,41,51,-10,40
Ayr,497,9,9,13,14,37,53,-16,40
Dumbarton,497,10,9,12,15,46,61,-15,39
Hibernian,498,1,18,12,6,54,27,27,66
Falkirk,498,2,19,9,8,64,40,24,66
Morton,498,3,16,13,7,51,38,13,61
Dundee Utd,498,4,13,12,11,46,44,2,51
Dunfermline,498,5,9,15,12,44,47,-3,42
Dumbarton,498,6,10,12,14,48,54,-6,42
Ayr,498,7,10,12,14,41,52,-11,42
Queen of S't,498,8,9,12,15,40,52,-12,39
Raith,498,9,10,9,17,38,51,-13,39
St Mirren,498,10,8,10,18,36,57,-21,34
Hibernian,499,1,19,11,6,58,26,32,68
Falkirk,499,2,17,9,10,59,43,16,60
Morton,499,3,16,11,9,49,40,9,59
Dundee Utd,499,4,16,9,11,53,43,10,57
Queen of S't,499,5,13,8,15,46,53,-7,47
St Mirren,499,6,11,10,15,43,53,-10,43
Dunfermline,499,7,10,11,15,45,49,-4,41
Raith,499,8,11,8,17,40,53,-13,41
Dumbarton,499,9,9,11,16,48,60,-12,38
Ayr,499,10,8,12,16,37,58,-21,36
Hibernian,500,1,20,11,5,56,25,31,71
Falkirk,500,2,17,10,9,61,39,22,61
Morton,500,3,17,10,9,48,38,10,61
Dundee Utd,500,4,16,11,9,50,36,14,59
Dunfermline,500,5,10,13,13,42,45,-3,43
Queen of S't,500,6,11,10,15,42,49,-7,43
Dumbarton,500,7,10,12,14,50,62,-12,42
St Mirren,500,8,8,12,16,43,57,-14,36
Raith,500,9,8,10,18,29,48,-19,34
Ayr,500,10,6,15,15,31,53,-22,33
Dundee Utd,501,1,18,8,10,58,37,21,62
Hibernian,501,2,16,12,8,50,27,23,60
Morton,501,3,16,9,11,49,40,9,57
Falkirk,501,4,16,9,11,55,48,7,57
Dunfermline,501,5,12,13,11,47,47,0,49
Raith,501,6,12,9,15,37,46,-9,45
Queen of S't,501,7,10,10,16,45,53,-8,40
St Mirren,501,8,10,10,16,39,53,-14,40
Dumbarton,501,9,9,12,15,52,61,-9,39
Ayr,501,10,9,12,15,35,55,-20,39
Hibernian,502,1,18,13,5,58,29,29,67
Morton,502,2,17,13,6,54,33,21,64
Falkirk,502,3,17,10,9,64,43,21,61
Dundee Utd,502,4,17,9,10,55,39,16,60
Raith,502,5,11,10,15,37,47,-10,43
Queen of S't,502,6,11,8,17,48,61,-13,41
Dumbarton,502,7,10,10,16,50,59,-9,40
Dunfermline,502,8,9,11,16,43,59,-16,38
St Mirren,502,9,9,10,17,42,56,-14,37
Ayr,502,10,8,12,16,32,57,-25,36
Hibernian,503,1,20,12,4,56,28,28,72
Dundee Utd,503,2,18,9,9,50,36,14,63
Morton,503,3,15,11,10,46,39,7,56
Falkirk,503,4,15,9,12,55,43,12,54
Queen of S't,503,5,13,10,13,48,48,0,49
Dunfermline,503,6,12,11,13,52,48,4,47
Dumbarton,503,7,10,10,16,47,56,-9,40
Ayr,503,8,8,13,15,32,53,-21,37
Raith,503,9,8,12,16,33,49,-16,36
St Mirren,503,10,7,11,18,37,56,-19,32
Morton,504,1,18,12,6,50,33,17,66
Hibernian,504,2,17,14,5,54,27,27,65
Falkirk,504,3,15,13,8,59,40,19,58
Dundee Utd,504,4,16,9,11,47,41,6,57
Queen of S't,504,5,11,10,15,47,55,-8,43
Raith,504,6,10,12,14,37,48,-11,42
Dumbarton,504,7,9,13,14,47,54,-7,40
Dunfermline,504,8,9,12,15,46,50,-4,39
Ayr,504,9,9,12,15,35,53,-18,39
St Mirren,504,10,6,13,17,37,58,-21,31
Hibernian,505,1,20,13,3,58,26,32,73
Morton,505,2,18,12,6,50,30,20,66
Dundee Utd,505,3,17,9,10,53,40,13,60
Falkirk,505,4,15,11,10,60,48,12,56
Dunfermline,505,5,10,12,14,45,50,-5,42
Dumbarton,505,6,10,12,14,49,55,-6,42
Queen of S't,505,7,10,9,17,44,53,-9,39
Raith,505,8,9,11,16,35,49,-14,38
St Mirren,505,9,8,11,17,41,57,-16,35
Ayr,505,10,8,10,18,30,57,-27,34
Hibernian,506,1,20,11,5,56,29,27,71
Morton,506,2,18,11,7,53,34,19,65
Dundee Utd,506,3,16,12,8,51,39,12,60
Falkirk,506,4,15,10,11,59,40,19,55
Queen of S't,506,5,13,9,14,48,50,-2,48
Dumbarton,506,6,11,10,15,49,56,-7,43
Dunfermline,506,7,8,15,13,44,52,-8,39
Raith,506,8,10,9,17,35,50,-15,39
St Mirren,506,9,7,11,18,37,59,-22,32
Ayr,506,10,6,14,16,30,53,-23,32
Hibernian,507,1,18,14,4,56,28,28,68
Falkirk,507,2,18,9,9,62,37,25,63
Dundee Utd,507,3,17,8,11,54,42,12,59
Morton,507,4,15,12,9,46,38,8,57
Dunfermline,507,5,12,13,11,50,47,3,49
Dumbarton,507,6,10,10,16,50,57,-7,40
Raith,507,7,10,10,16,37,52,-15,40
St Mirren,507,8,9,11,16,39,54,-15,38
Ayr,507,9,9,10,17,35,55,-20,37
Queen of S't,507,10,9,9,18,41,60,-19,36
Hibernian,508,1,18,11,7,58,30,28,65
Morton,508,2,15,15,6,49,36,13,60
Falkirk,508,3,15,11,10,57,43,14,56
Dundee Utd,508,4,15,10,11,53,42,11,55
Queen of S't,508,5,14,8,14,51,51,0,50
Dunfermline,508,6,10,16,10,50,48,2,46
Ayr,508,7,11,12,13,44,55,-11,45
St Mirren,508,8,8,12,16,42,60,-18,36
Raith,508,9,8,11,17,35,53,-18,35
Dumbarton,508,10,7,12,17,45,66,-21,33
Hibernian,509,1,21,10,5,62,25,37,73
Morton,509,2,17,11,8,53,42,11,62
Dundee Utd,509,3,16,10,10,48,37,11,58
Falkirk,509,4,13,12,11,52,42,10,51
Dumbarton,509,5,12,11,13,50,54,-4,47
Queen of S't,509,6,11,11,14,47,49,-2,44
Dunfermline,509,7,11,11,14,48,51,-3,44
Raith,509,8,9,11,16,34,52,-18,38
St Mirren,509,9,9,10,17,41,60,-19,37
Ayr,509,10,6,13,17,30,53,-23,31
Hibernian,510,1,20,11,5,56,25,31,71
Morton,510,2,19,10,7,58,36,22,67
Dundee Utd,510,3,17,9,10,50,45,5,60
Falkirk,510,4,14,11,11,56,43,13,53
Queen of S't,510,5,14,8,14,52,52,0,50
Raith,510,6,10,9,17,36,50,-14,39
Dumbarton,510,7,8,13,15,47,58,-11,37
Ayr,510,8,8,13,15,36,56,-20,37
Dunfermline,510,9,8,12,16,41,52,-11,36
St Mirren,510,10,8,12,16,40,55,-15,36
Hibernian,511,1,19,12,5,60,28,32,69
Falkirk,511,2,18,11,7,62,40,22,65
Dundee Utd,511,3,18,10,8,55,36,19,64
Morton,511,4,18,10,8,52,37,15,64
Queen of S't,511,5,11,9,16,47,58,-11,42
Raith,511,6,11,9,16,38,50,-12,42
Dunfermline,511,7,8,13,15,44,52,-8,37
Dumbarton,511,8,8,12,16,46,62,-16,36
Ayr,511,9,7,13,16,33,57,-24,34
St Mirren,511,10,8,9,19,39,56,-17,33
Hibernian,512,1,21,11,4,62,26,36,74
Falkirk,512,2,18,11,7,58,37,21,65
Dundee Utd,512,3,17,10,9,51,36,15,61
Morton,512,4,15,12,9,45,38,7,57
Queen of S't,512,5,11,10,15,43,47,-4,43
Dunfermline,512,6,9,12,15,41,50,-9,39
St Mirren,512,7,9,11,16,38,51,-13,38
Ayr,512,8,9,11,16,33,55,-22,38
Raith,512,9,9,10,17,36,52,-16,37
Dumbarton,512,10,7,12,17,44,59,-15,33
Hibernian,513,1,18,13,5,54,26,28,67
Falkirk,513,2,16,11,9,64,46,18,59
Morton,513,3,15,13,8,49,41,8,58
Dundee Utd,513,4,15,12,9,56,45,11,57
Dunfermline,513,5,11,13,12,46,45,1,46
Queen of S't,513,6,12,10,14,49,51,-2,46
Raith,513,7,10,10,16,34,46,-12,40
Ayr,513,8,9,12,15,35,54,-19,39
St Mirren,513,9,8,12,16,44,59,-15,36
Dumbarton,513,10,7,12,17,50,68,-18,33
Hibernian,514,1,20,12,4,61,28,33,72
Dundee Utd,514,2,17,10,9,50,37,13,61
Falkirk,514,3,16,12,8,61,41,20,60
Morton,514,4,16,11,9,53,42,11,59
Dunfermline,514,5,10,12,14,54,55,-1,42
Queen of S't,514,6,10,12,14,44,52,-8,42
Ayr,514,7,9,13,14,36,52,-16,40
Raith,514,8,10,8,18,34,56,-22,38
Dumbarton,514,9,9,10,17,46,62,-16,37
St Mirren,514,10,7,12,17,38,52,-14,33
Hibernian,515,1,21,11,4,55,22,33,74
Morton,515,2,19,11,6,55,34,21,68
Falkirk,515,3,16,10,10,57,42,15,58
Dundee Utd,515,4,14,10,12,48,46,2,52
Queen of S't,515,5,13,9,14,48,50,-2,48
Raith,515,6,12,9,15,40,46,-6,45
Dunfermline,515,7,9,11,16,44,52,-8,38
Dumbarton,515,8,9,11,16,44,55,-11,38
St Mirren,515,9,9,9,18,36,56,-20,36
Ayr,515,10,7,11,18,35,59,-24,32
Hibernian,516,1,20,10,6,58,27,31,70
Morton,516,2,17,11,8,49,37,12,62
Dundee Utd,516,3,17,10,9,52,40,12,61
Falkirk,516,4,16,11,9,61,42,19,59
Dunfermline,516,5,10,12,14,48,48,0,42
Queen of S't,516,6,11,9,16,40,50,-10,42
Raith,516,7,11,9,16,35,49,-14,42
Dumbarton,516,8,10,11,15,53,58,-5,41
Ayr,516,9,9,11,16,33,53,-20,38
St Mirren,516,10,7,10,19,37,62,-25,31
Hibernian,517,1,19,13,4,57,29,28,70
Morton,517,2,18,12,6,53,35,18,66
Falkirk,517,3,16,10,10,56,44,12,58
Dundee Utd,517,4,15,9,12,46,40,6,54
Queen of S't,517,5,12,10,14,44,47,-3,46
Dunfermline,517,6,10,13,13,47,47,0,43
Dumbarton,517,7,10,10,16,53,61,-8,40
Ayr,517,8,9,13,14,35,51,-16,40
Raith,517,9,9,9,18,36,56,-20,36
St Mirren,517,10,8,9,19,42,59,-17,33
Hibernian,518,1,18,12,6,53,25,28,66
Morton,518,2,17,11,8,50,37,13,62
Falkirk,518,3,16,12,8,64,44,20,60
Dundee Utd,518,4,16,10,10,50,45,5,58
Queen of S't,518,5,12,10,14,53,54,-1,46
Dunfermline,518,6,10,13,13,53,51,2,43
Raith,518,7,10,10,16,34,52,-18,40
Ayr,518,8,9,12,15,33,52,-19,39
Dumbarton,518,9,8,11,17,45,60,-15,35
St Mirren,518,10,7,13,16,37,52,-15,34
Hibernian,519,1,19,13,4,56,27,29,70
Dundee Utd,519,2,18,9,9,55,38,17,63
Morton,519,3,15,14,7,47,35,12,59
Falkirk,519,4,15,10,11,55,45,10,55
Queen of S't,519,5,12,10,14,46,52,-6,46
Dunfermline,519,6,10,12,14,45,48,-3,42
Raith,519,7,9,11,16,36,50,-14,38
Dumbarton,519,8,9,10,17,49,61,-12,37
Ayr,519,9,8,13,15,33,53,-20,37
St Mirren,519,10,8,12,16,47,60,-13,36
Hibernian,520,1,19,13,4,56,27,29,70
Dundee Utd,520,2,19,8,9,58,35,23,65
Morton,520,3,16,10,10,50,39,11,58
Falkirk,520,4,15,11,10,56,41,15,56
Raith,520,5,12,9,15,41,48,-7,45
Queen of S't,520,6,12,8,16,43,50,-7,44
Dunfermline,520,7,10,11,15,44,53,-9,41
Ayr,520,8,9,12,15,36,57,-21,39
Dumbarton,520,9,8,11,17,44,59,-15,35
St Mirren,520,10,7,13,16,39,58,-19,34
Hibernian,521,1,21,12,3,61,24,37,75
Dundee Utd,521,2,17,10,9,54,40,14,61
Falkirk,521,3,15,11,10,58,42,16,56
Morton,521,4,14,14,8,46,37,9,56
Dunfermline,521,5,11,14,11,51,44,7,47
Queen of S't,521,6,11,9,16,42,50,-8,42
Dumbarton,521,7,9,11,16,47,59,-12,38
Ayr,521,8,8,14,14,35,55,-20,38
St Mirren,521,9,8,11,17,41,60,-19,35
Raith,521,10,8,10,18,34,58,-24,34
Hibernian,522,1,20,11,5,54,24,30,71
Falkirk,522,2,17,12,7,63,41,22,63
Dundee Utd,522,3,16,10,10,56,44,12,58
Morton,522,4,15,10,11,48,42,6,55
Raith,522,5,11,12,13,38,46,-8,45
Queen of S't,522,6,12,9,15,44,53,-9,45
Dumbarton,522,7,11,10,15,53,57,-4,43
Dunfermline,522,8,10,12,14,46,56,-10,42
St Mirren,522,9,7,11,18,36,52,-16,32
Ayr,522,10,7,11,18,36,59,-23,32
Morton,523,1,17,11,8,52,41,11,62
Falkirk,523,2,17,10,9,66,39,27,61
Hibernian,523,3,16,12,8,52,32,20,60
Dundee Utd,523,4,16,10,10,49,40,9,58
Raith,523,5,12,10,14,34,47,-13,46
Dunfermline,523,6,10,14,12,46,46,0,44
Dumbarton,523,7,10,11,15,50,60,-10,41
Ayr,523,8,10,11,15,34,51,-17,41
Queen of S't,523,9,10,9,17,41,50,-9,39
St Mirren,523,10,8,10,18,38,56,-18,34
Hibernian,524,1,20,12,4,60,26,34,72
Morton,524,2,17,12,7,54,38,16,63
Falkirk,524,3,16,13,7,57,38,19,61
Dundee Utd,524,4,15,10,11,50,41,9,55
Queen of S't,524,5,12,11,13,44,46,-2,47
Ayr,524,6,10,11,15,34,52,-18,41
Dumbarton,524,7,9,11,16,48,60,-12,38
Dunfermline,524,8,7,15,14,40,51,-11,36
Raith,524,9,8,12,16,34,50,-16,36
St Mirren,524,10,8,9,19,35,54,-19,33
Hibernian,525,1,19,12,5,63,29,34,69
Falkirk,525,2,19,10,7,65,37,28,67
Dundee Utd,525,3,15,10,11,44,42,2,55
Morton,525,4,13,15,8,46,37,9,54
Dumbarton,525,5,12,10,14,52,59,-7,46
Queen of S't,525,6,11,8,17,45,53,-8,41
Dunfermline,525,7,8,16,12,43,48,-5,40
Raith,525,8,10,9,17,32,50,-18,39
St Mirren,525,9,9,10,17,43,57,-14,37
Ayr,525,10,9,10,17,32,53,-21,37
Hibernian,526,1,22,11,3,61,22,39,77
Falkirk,526,2,16,10,10,61,48,13,58
Dundee Utd,526,3,15,13,8,49,36,13,58
Morton,526,4,14,15,7,48,37,11,57
Dumbarton,526,5,10,13,13,52,54,-2,43
Dunfermline,526,6,9,14,13,45,53,-8,41
Raith,526,7,10,10,16,43,54,-11,40
Ayr,526,8,9,13,14,35,50,-15,40
Queen of S't,526,9,9,8,19,39,59,-20,35
St Mirren,526,10,7,11,18,41,61,-20,32
Morton,527,1,18,11,7,55,34,21,65
Hibernian,527,2,17,13,6,52,30,22,64
Falkirk,527,3,16,10,10,61,44,17,58
Dundee Utd,527,4,15,10,11,53,45,8,55
Dunfermline,527,5,11,12,13,52,56,-4,45
Raith,527,6,12,9,15,42,52,-10,45
Queen of S't,527,7,10,13,13,47,52,-5,43
St Mirren,527,8,9,10,17,37,53,-16,37
Ayr,527,9,8,13,15,32,51,-19,37
Dumbarton,527,10,7,13,16,50,64,-14,34
Hibernian,528,1,18,14,4,52,25,27,68
Falkirk,528,2,18,11,7,63,37,26,65
Morton,528,3,17,10,9,51,38,13,61
Dundee Utd,528,4,15,12,9,45,36,9,57
Queen of S't,528,5,11,11,14,40,45,-5,44
Dunfermline,528,6,9,13,14,45,51,-6,40
Dumbarton,528,7,9,11,16,48,58,-10,38
Raith,528,8,9,11,16,33,48,-15,38
Ayr,528,9,8,13,15,32,52,-20,37
St Mirren,528,10,8,10,18,37,56,-19,34
Hibernian,529,1,17,14,5,57,30,27,65
Morton,529,2,17,11,8,47,37,10,62
Falkirk,529,3,17,9,10,59,38,21,60
Dundee Utd,529,4,14,11,11,45,39,6,53
Queen of S't,529,5,13,11,12,53,51,2,50
Raith,529,6,11,11,14,37,48,-11,44
Dunfermline,529,7,9,14,13,45,49,-4,41
Dumbarton,529,8,9,11,16,46,61,-15,38
St Mirren,529,9,8,12,16,41,52,-11,36
Ayr,529,10,6,14,16,29,54,-25,32
Hibernian,530,1,20,10,6,66,30,36,70
Morton,530,2,18,11,7,55,35,20,65
Dundee Utd,530,3,18,9,9,56,43,13,63
Falkirk,530,4,17,10,9,58,40,18,61
Dunfermline,530,5,10,11,15,46,50,-4,41
Queen of S't,530,6,11,8,17,44,57,-13,41
Raith,530,7,10,10,16,36,50,-14,40
Dumbarton,530,8,8,12,16,45,61,-16,36
St Mirren,530,9,9,9,18,44,61,-17,36
Ayr,530,10,7,14,15,32,55,-23,35
Hibernian,531,1,21,12,3,62,21,41,75
Morton,531,2,16,13,7,48,37,11,61
Falkirk,531,3,16,9,11,63,44,19,57
Dundee Utd,531,4,16,9,11,54,40,14,57
Queen of S't,531,5,13,9,14,47,50,-3,48
Dunfermline,531,6,10,12,14,47,50,-3,42
Raith,531,7,10,10,16,39,52,-13,40
Dumbarton,531,8,10,10,16,51,68,-17,40
St Mirren,531,9,9,10,17,48,62,-14,37
Ayr,531,10,6,12,18,33,68,-35,30
Hibernian,532,1,20,11,5,55,24,31,71
Dundee Utd,532,2,18,10,8,55,38,17,64
Falkirk,532,3,17,10,9,61,42,19,61
Morton,532,4,15,10,11,48,39,9,55
Dumbarton,532,5,12,10,14,49,57,-8,46
Dunfermline,532,6,11,12,13,50,48,2,45
Queen of S't,532,7,11,8,17,44,55,-11,41
Raith,532,8,10,9,17,35,53,-18,39
Ayr,532,9,8,11,17,35,57,-22,35
St Mirren,532,10,7,11,18,38,57,-19,32
Hibernian,533,1,19,13,4,55,24,31,70
Morton,533,2,19,12,5,54,32,22,69
Falkirk,533,3,16,9,11,58,45,13,57
Dundee Utd,533,4,16,9,11,51,39,12,57
Queen of S't,533,5,12,10,14,46,50,-4,46
Dunfermline,533,6,10,14,12,46,49,-3,44
Dumbarton,533,7,9,11,16,47,58,-11,38
Ayr,533,8,9,11,16,31,55,-24,38
Raith,533,9,9,9,18,39,55,-16,36
St Mirren,533,10,7,10,19,39,59,-20,31
Hibernian,534,1,20,11,5,60,23,37,71
Dundee Utd,534,2,18,9,9,51,35,16,63
Morton,534,3,18,9,9,51,43,8,63
Falkirk,534,4,15,12,9,57,39,18,57
Dunfermline,534,5,11,13,12,51,46,5,46
Queen of S't,534,6,11,9,16,43,53,-10,42
Ayr,534,7,8,14,14,34,52,-18,38
Raith,534,8,9,10,17,36,56,-20,37
Dumbarton,534,9,8,12,16,44,61,-17,36
St Mirren,534,10,6,13,17,38,57,-19,31
Hibernian,535,1,19,11,6,53,23,30,68
Morton,535,2,19,11,6,49,30,19,68
Falkirk,535,3,18,10,8,61,36,25,64
Dundee Utd,535,4,16,12,8,54,37,17,60
Queen of S't,535,5,10,11,15,41,54,-13,41
Dunfermline,535,6,9,13,14,43,51,-8,40
Raith,535,7,10,10,16,34,46,-12,40
Dumbarton,535,8,8,12,16,51,65,-14,36
Ayr,535,9,7,13,16,31,56,-25,34
St Mirren,535,10,8,9,19,39,58,-19,33
Hibernian,536,1,19,12,5,57,26,31,69
Morton,536,2,19,10,7,53,33,20,67
Falkirk,536,3,16,10,10,56,44,12,58
Dundee Utd,536,4,16,10,10,51,43,8,58
Queen of S't,536,5,12,10,14,47,49,-2,46
Dunfermline,536,6,10,12,14,48,49,-1,42
Dumbarton,536,7,9,12,15,44,56,-12,39
Ayr,536,8,9,11,16,35,54,-19,38
Raith,536,9,9,10,17,34,53,-19,37
St Mirren,536,10,7,11,18,38,56,-18,32
Hibernian,537,1,19,10,7,57,31,26,67
Morton,537,2,18,10,8,55,39,16,64
Dundee Utd,537,3,17,10,9,49,35,14,61
Falkirk,537,4,14,13,9,54,38,16,55
Dunfermline,537,5,11,14,11,47,46,1,47
Queen of S't,537,6,12,10,14,47,51,-4,46
St Mirren,537,7,10,10,16,41,50,-9,40
Dumbarton,537,8,9,12,15,48,61,-13,39
Raith,537,9,8,11,17,30,48,-18,35
Ayr,537,10,7,10,19,30,59,-29,31
Hibernian,538,1,20,12,4,63,28,35,72
Morton,538,2,18,11,7,54,37,17,65
Falkirk,538,3,16,9,11,60,44,16,57
Dundee Utd,538,4,14,10,12,47,40,7,52
Dunfermline,538,5,11,13,12,51,50,1,46
St Mirren,538,6,11,10,15,43,49,-6,43
Ayr,538,7,10,11,15,33,49,-16,41
Queen of S't,538,8,10,10,16,46,55,-9,40
Raith,538,9,9,9,18,34,57,-23,36
Dumbarton,538,10,8,11,17,45,67,-22,35
Morton,539,1,19,10,7,57,32,25,67
Hibernian,539,2,18,12,6,52,27,25,66
Dundee Utd,539,3,16,10,10,55,42,13,58
Falkirk,539,4,15,12,9,50,37,13,57
Queen of S't,539,5,13,10,13,45,43,2,49
Raith,539,6,11,10,15,36,47,-11,43
St Mirren,539,7,10,9,17,46,57,-11,39
Ayr,539,8,9,11,16,44,68,-24,38
Dunfermline,539,9,8,13,15,41,49,-8,37
Dumbarton,539,10,7,11,18,44,68,-24,32
Hibernian,540,1,19,13,4,56,25,31,70
Morton,540,2,17,13,6,52,35,17,64
Dundee Utd,540,3,16,10,10,52,43,9,58
Falkirk,540,4,15,11,10,57,42,15,56
Queen of S't,540,5,10,13,13,40,45,-5,43
Dunfermline,540,6,9,15,12,45,46,-1,42
Raith,540,7,10,9,17,35,52,-17,39
Ayr,540,8,9,12,15,36,55,-19,39
St Mirren,540,9,8,11,17,44,57,-13,35
Dumbarton,540,10,8,11,17,43,60,-17,35
Hibernian,541,1,19,12,5,57,27,30,69
Dundee Utd,541,2,18,9,9,51,38,13,63
Falkirk,541,3,15,12,9,56,40,16,57
Morton,541,4,15,12,9,49,38,11,57
Queen of S't,541,5,12,10,14,44,46,-2,46
Dunfermline,541,6,11,12,13,49,50,-1,45
Dumbarton,541,7,9,12,15,49,59,-10,39
Raith,541,8,9,11,16,36,53,-17,38
St Mirren,541,9,8,12,16,43,57,-14,36
Ayr,541,10,7,12,17,33,59,-26,33
Hibernian,542,1,17,14,5,56,29,27,65
Morton,542,2,17,11,8,52,35,17,62
Falkirk,542,3,16,13,7,62,39,23,61
Dundee Utd,542,4,14,12,10,46,39,7,54
Queen of S't,542,5,12,9,15,44,52,-8,45
Raith,542,6,11,11,14,38,47,-9,44
Dunfermline,542,7,9,15,12,42,46,-4,42
Ayr,542,8,8,13,15,33,53,-20,37
St Mirren,542,9,8,11,17,43,55,-12,35
Dumbarton,542,10,8,11,17,43,64,-21,35
Hibernian,543,1,21,12,3,62,28,34,75
Morton,543,2,16,11,9,47,38,9,59
Falkirk,543,3,16,10,10,57,40,17,58
Dundee Utd,543,4,15,10,11,47,38,9,55
Queen of S't,543,5,13,9,14,50,50,0,48
Dumbarton,543,6,11,12,13,52,56,-4,45
Dunfermline,543,7,9,14,13,44,48,-4,41
Raith,543,8,10,9,17,33,53,-20,39
St Mirren,543,9,8,10,18,45,59,-14,34
Ayr,543,10,7,11,18,31,58,-27,32
Hibernian,544,1,17,15,4,58,32,26,66
Morton,544,2,15,12,9,51,43,8,57
Dundee Utd,544,3,16,9,11,48,43,5,57
Falkirk,544,4,14,10,12,54,45,9,52
Queen of S't,544,5,14,8,14,53,50,3,50
Dunfermline,544,6,11,12,13,50,51,-1,45
Ayr,544,7,10,11,15,42,55,-13,41
Raith,544,8,10,10,16,37,49,-12,40
Dumbarton,544,9,9,12,15,49,63,-14,39
St Mirren,544,10,9,11,16,42,53,-11,38
Hibernian,545,1,20,11,5,55,25,30,71
Morton,545,2,19,10,7,54,35,19,67
Falkirk,545,3,17,10,9,59,40,19,61
Dundee Utd,545,4,13,10,13,47,46,1,49
Raith,545,5,12,9,15,37,50,-13,45
Dumbarton,545,6,10,11,15,49,56,-7,41
Ayr,545,7,10,11,15,37,56,-19,41
Dunfermline,545,8,9,13,14,49,50,-1,40
Queen of S't,545,9,10,9,17,41,56,-15,39
St Mirren,545,10,8,10,18,40,54,-14,34
Hibernian,546,1,20,12,4,56,24,32,72
Dundee Utd,546,2,19,9,8,60,41,19,66
Morton,546,3,15,12,9,47,41,6,57
Falkirk,546,4,15,9,12,53,42,11,54
Dunfermline,546,5,12,12,12,49,44,5,48
Queen of S't,546,6,11,9,16,47,59,-12,42
Ayr,546,7,10,11,15,36,55,-19,41
Raith,546,8,10,10,16,37,50,-13,40
Dumbarton,546,9,8,11,17,43,58,-15,35
St Mirren,546,10,7,11,18,46,60,-14,32
Hibernian,547,1,20,12,4,53,24,29,72
Falkirk,547,2,18,10,8,62,38,24,64
Morton,547,3,17,13,6,51,34,17,64
Dundee Utd,547,4,15,10,11,53,46,7,55
Queen of S't,547,5,10,11,15,45,52,-7,41
Dunfermline,547,6,9,13,14,43,48,-5,40
Raith,547,7,10,10,16,32,46,-14,40
Dumbarton,547,8,9,12,15,50,61,-11,39
St Mirren,547,9,8,12,16,42,57,-15,36
Ayr,547,10,6,13,17,32,57,-25,31
Hibernian,548,1,18,14,4,52,23,29,68
Morton,548,2,17,14,5,51,33,18,65
Falkirk,548,3,16,10,10,60,43,17,58
Dundee Utd,548,4,15,11,10,51,40,11,56
Dunfermline,548,5,11,14,11,50,45,5,47
Dumbarton,548,6,11,10,15,46,52,-6,43
Raith,548,7,11,10,15,45,54,-9,43
Queen of S't,548,8,9,11,16,40,56,-16,38
Ayr,548,9,9,10,17,33,55,-22,37
St Mirren,548,10,6,10,20,34,61,-27,28
Morton,549,1,18,12,6,52,33,19,66
Hibernian,549,2,17,13,6,54,31,23,64
Falkirk,549,3,16,12,8,64,42,22,60
Dundee Utd,549,4,15,10,11,52,43,9,55
Dunfermline,549,5,10,14,12,43,45,-2,44
Raith,549,6,11,10,15,39,50,-11,43
Ayr,549,7,10,12,14,34,53,-19,42
Queen of S't,549,8,9,11,16,42,53,-11,38
St Mirren,549,9,8,11,17,37,53,-16,35
Dumbarton,549,10,7,13,16,44,58,-14,34
Hibernian,550,1,19,13,4,60,26,34,70
Morton,550,2,16,9,11,52,43,9,57
Falkirk,550,3,15,11,10,55,41,14,56
Dundee Utd,550,4,15,11,10,44,38,6,56
Raith,550,5,12,10,14,41,47,-6,46
Queen of S't,550,6,12,9,15,46,53,-7,45
Dumbarton,550,7,10,12,14,50,55,-5,42
Ayr,550,8,9,12,15,30,48,-18,39
Dunfermline,550,9,8,14,14,43,51,-8,38
St Mirren,550,10,8,11,17,40,59,-19,35
Hibernian,551,1,20,12,4,58,28,30,72
Morton,551,2,16,11,9,48,39,9,59
Falkirk,551,3,16,10,10,54,40,14,58
Dundee Utd,551,4,14,9,13,47,41,6,51
Queen of S't,551,5,13,8,15,48,50,-2,47
Dunfermline,551,6,11,12,13,54,52,2,45
Dumbarton,551,7,11,11,14,47,55,-8,44
Ayr,551,8,9,13,14,35,51,-16,40
Raith,551,9,9,9,18,32,53,-21,36
St Mirren,551,10,8,11,17,41,55,-14,35
Hibernian,552,1,19,10,7,53,29,24,67
Morton,552,2,17,10,9,49,36,13,61
Dundee Utd,552,3,16,11,9,48,37,11,59
Falkirk,552,4,16,10,10,60,45,15,58
Dunfermline,552,5,11,15,10,45,42,3,48
Queen of S't,552,6,12,10,14,47,48,-1,46
Dumbarton,552,7,10,11,15,48,56,-8,41
Raith,552,8,11,8,17,34,49,-15,41
St Mirren,552,9,8,9,19,37,56,-19,33
Ayr,552,10,7,12,17,31,54,-23,33
Hibernian,553,1,21,11,4,62,28,34,74
Dundee Utd,553,2,19,8,9,60,37,23,65
Morton,553,3,15,15,6,52,38,14,60
Falkirk,553,4,14,11,11,56,45,11,53
Dunfermline,553,5,9,15,12,50,53,-3,42
Dumbarton,553,6,10,11,15,49,60,-11,41
Queen of S't,553,7,9,11,16,41,53,-12,38
Raith,553,8,9,11,16,37,52,-15,38
St Mirren,553,9,9,10,17,38,56,-18,37
Ayr,553,10,7,13,16,33,56,-23,34
Hibernian,554,1,17,14,5,51,25,26,65
Falkirk,554,2,17,12,7,59,36,23,63
Morton,554,3,17,11,8,52,39,13,62
Dundee Utd,554,4,16,10,10,49,37,12,58
Dunfermline,554,5,10,12,14,47,49,-2,42
Raith,554,6,11,9,16,36,49,-13,42
Queen of S't,554,7,10,11,15,39,48,-9,41
Dumbarton,554,8,9,11,16,47,61,-14,38
Ayr,554,9,9,11,16,33,59,-26,38
St Mirren,554,10,8,11,17,46,56,-10,35
Hibernian,555,1,18,13,5,51,25,26,67
Dundee Utd,555,2,17,10,9,49,36,13,61
Morton,555,3,16,11,9,49,37,12,59
Falkirk,555,4,15,11,10,57,41,16,56
St Mirren,555,5,11,10,15,45,54,-9,43
Dunfermline,555,6,10,12,14,46,49,-3,42
Queen of S't,555,7,10,11,15,43,51,-8,41
Raith,555,8,10,10,16,38,50,-12,40
Ayr,555,9,9,12,15,39,55,-16,39
Dumbarton,555,10,8,12,16,47,66,-19,36
Hibernian,556,1,19,12,5,55,26,29,69
Morton,556,2,15,12,9,49,41,8,57
Dundee Utd,556,3,15,11,10,47,40,7,56
Falkirk,556,4,15,10,11,60,48,12,55
Dunfermline,556,5,11,11,14,46,46,0,44
Ayr,556,6,11,11,14,37,50,-13,44
Queen of S't,556,7,11,10,15,43,50,-7,43
Dumbarton,556,8,9,13,14,52,61,-9,40
Raith,556,9,10,9,17,39,55,-16,39
St Mirren,556,10,9,11,16,44,55,-11,38
Morton,557,1,18,10,8,52,37,15,64
Hibernian,557,2,17,11,8,54,35,19,62
Dundee Utd,557,3,17,11,8,55,40,15,62
Falkirk,557,4,16,11,9,60,41,19,59
Queen of S't,557,5,12,10,14,46,49,-3,46
Dunfermline,557,6,10,12,14,43,48,-5,42
Raith,557,7,11,9,16,38,48,-10,42
Ayr,557,8,8,14,14,38,58,-20,38
Dumbarton,557,9,8,11,17,45,59,-14,35
St Mirren,557,10,8,11,17,43,59,-16,35
Falkirk,558,1,19,9,8,63,39,24,66
Morton,558,2,18,11,7,52,35,17,65
Hibernian,558,3,17,12,7,54,32,22,63
Dundee Utd,558,4,15,10,11,46,38,8,55
Queen of S't,558,5,12,9,15,46,49,-3,45
Dunfermline,558,6,10,13,13,50,54,-4,43
Ayr,558,7,10,11,15,35,54,-19,41
Dumbarton,558,8,9,13,14,49,58,-9,40
Raith,558,9,10,9,17,36,51,-15,39
St Mirren,558,10,6,11,19,35,56,-21,29
Hibernian,559,1,19,13,4,54,25,29,70
Dundee Utd,559,2,19,8,9,60,40,20,65
Morton,559,3,17,11,8,51,36,15,62
Falkirk,559,4,17,10,9,57,38,19,61
Queen of S't,559,5,12,8,16,48,51,-3,44
Dunfermline,559,6,9,14,13,42,47,-5,41
Dumbarton,559,7,9,11,16,46,60,-14,38
Raith,559,8,9,10,17,30,48,-18,37
St Mirren,559,9,8,12,16,39,55,-16,36
Ayr,559,10,7,11,18,32,59,-27,32
Hibernian,560,1,20,12,4,54,22,32,72
Morton,560,2,16,12,8,45,36,9,60
Dundee Utd,560,3,16,9,11,51,39,12,57
Falkirk,560,4,15,11,10,56,42,14,56
Raith,560,5,12,9,15,37,48,-11,45
Dunfermline,560,6,11,11,14,49,51,-2,44
Queen of S't,560,7,12,8,16,46,48,-2,44
Ayr,560,8,9,12,15,34,53,-19,39
Dumbarton,560,9,9,11,16,44,56,-12,38
St Mirren,560,10,8,9,19,41,62,-21,33
Hibernian,561,1,20,12,4,57,27,30,72
Falkirk,561,2,17,10,9,61,43,18,61
Morton,561,3,17,10,9,48,35,13,61
Dundee Utd,561,4,13,11,12,47,43,4,50
Queen of S't,561,5,13,9,14,47,50,-3,48
Dunfermline,561,6,11,12,13,47,46,1,45
Dumbarton,561,7,10,10,16,46,59,-13,40
Raith,561,8,9,10,17,36,50,-14,37
Ayr,561,9,8,13,15,34,56,-22,37
St Mirren,561,10,8,11,17,46,60,-14,35
Hibernian,562,1,19,12,5,52,23,29,69
Morton,562,2,19,10,7,54,34,20,67
Dundee Utd,562,3,17,8,11,47,40,7,59
Falkirk,562,4,16,10,10,60,42,18,58
Queen of S't,562,5,12,9,15,46,50,-4,45
Dunfermline,562,6,10,13,13,51,49,2,43
Dumbarton,562,7,10,10,16,46,57,-11,40
Raith,562,8,8,12,16,33,52,-19,36
Ayr,562,9,8,12,16,33,55,-22,36
St Mirren,562,10,7,12,17,38,58,-20,33
Hibernian,563,1,20,13,3,60,26,34,73
Dundee Utd,563,2,18,8,10,60,36,24,62
Morton,563,3,16,12,8,45,35,10,60
Falkirk,563,4,14,12,10,57,45,12,54
Queen of S't,563,5,11,10,15,40,48,-8,43
Dumbarton,563,6,10,11,15,50,59,-9,41
Dunfermline,563,7,9,12,15,45,52,-7,39
Raith,563,8,10,9,17,33,51,-18,39
St Mirren,563,9,9,11,16,40,54,-14,38
Ayr,563,10,9,10,17,33,57,-24,37
Morton,564,1,19,11,6,52,32,20,68
Hibernian,564,2,18,12,6,56,26,30,66
Falkirk,564,3,16,10,10,55,39,16,58
Dundee Utd,564,4,15,9,12,48,44,4,54
Queen of S't,564,5,11,11,14,43,51,-8,44
Dunfermline,564,6,10,13,13,47,51,-4,43
St Mirren,564,7,10,11,15,43,51,-8,41
Dumbarton,564,8,9,11,16,47,58,-11,38
Ayr,564,9,9,10,17,36,55,-19,37
Raith,564,10,9,10,17,32,52,-20,37
Hibernian,565,1,21,12,3,57,21,36,75
Dundee Utd,565,2,17,10,9,55,41,14,61
Morton,565,3,16,13,7,50,40,10,61
Falkirk,565,4,15,11,10,58,43,15,56
Queen of S't,565,5,13,8,15,50,52,-2,47
Dunfermline,565,6,10,12,14,47,52,-5,42
Dumbarton,565,7,9,12,15,50,55,-5,39
St Mirren,565,8,9,10,17,37,56,-19,37
Raith,565,9,9,9,18,33,52,-19,36
Ayr,565,10,7,11,18,35,60,-25,32
Hibernian,566,1,20,12,4,58,25,33,72
Morton,566,2,20,9,7,57,33,24,69
Dundee Utd,566,3,17,9,10,57,41,16,60
Falkirk,566,4,16,9,11,59,45,14,57
Queen of S't,566,5,13,8,15,46,50,-4,47
Raith,566,6,12,9,15,34,46,-12,45
Dunfermline,566,7,10,11,15,44,54,-10,41
Ayr,566,8,8,12,16,31,52,-21,36
Dumbarton,566,9,7,11,18,43,62,-19,32
St Mirren,566,10,7,10,19,42,63,-21,31
Hibernian,567,1,20,12,4,59,25,34,72
Falkirk,567,2,16,10,10,62,43,19,58
Morton,567,3,15,11,10,48,40,8,56
Dundee Utd,567,4,15,11,10,53,47,6,56
Queen of S't,567,5,13,8,15,48,49,-1,47
Raith,567,6,12,8,16,39,54,-15,44
Dunfermline,567,7,10,13,13,43,46,-3,43
Ayr,567,8,9,12,15,37,54,-17,39
St Mirren,567,9,8,12,16,37,54,-17,36
Dumbarton,567,10,8,11,17,43,57,-14,35
Hibernian,568,1,18,13,5,53,26,27,67
Morton,568,2,19,9,8,54,41,13,66
Falkirk,568,3,16,10,10,56,42,14,58
Dundee Utd,568,4,16,9,11,49,36,13,57
Dunfermline,568,5,10,14,12,47,46,1,44
Raith,568,6,10,12,14,36,46,-10,42
Dumbarton,568,7,9,13,14,46,54,-8,40
Queen of S't,568,8,9,12,15,40,49,-9,39
Ayr,568,9,8,12,16,30,55,-25,36
St Mirren,568,10,8,10,18,40,56,-16,34
Hibernian,569,1,21,11,4,58,27,31,74
Falkirk,569,2,16,10,10,59,43,16,58
Morton,569,3,16,10,10,54,42,12,58
Dundee Utd,569,4,15,10,11,47,39,8,55
Dunfermline,569,5,11,14,11,52,49,3,47
Queen of S't,569,6,12,9,15,45,50,-5,45
Dumbarton,569,7,9,12,15,44,59,-15,39
Ayr,569,8,9,12,15,37,53,-16,39
Raith,569,9,9,11,16,38,53,-15,38
St Mirren,569,10,7,11,18,43,62,-19,32
Hibernian,570,1,20,12,4,59,30,29,72
Falkirk,570,2,15,10,11,58,42,16,55
Morton,570,3,14,13,9,48,40,8,55
Dundee Utd,570,4,14,10,12,50,44,6,52
Raith,570,5,12,10,14,35,44,-9,46
Dumbarton,570,6,11,12,13,51,53,-2,45
Ayr,570,7,11,11,14,37,51,-14,44
Dunfermline,570,8,10,11,15,48,55,-7,41
Queen of S't,570,9,10,11,15,47,55,-8,41
St Mirren,570,10,7,12,17,40,59,-19,33
Hibernian,571,1,17,13,6,53,30,23,64
Falkirk,571,2,17,11,8,60,40,20,62
Morton,571,3,16,11,9,50,39,11,59
Dundee Utd,571,4,16,8,12,52,43,9,56
Dunfermline,571,5,12,13,11,49,44,5,49
Raith,571,6,11,10,15,36,46,-10,43
Ayr,571,7,10,11,15,38,57,-19,41
Queen of S't,571,8,10,10,16,44,53,-9,40
St Mirren,571,9,10,10,16,45,55,-10,40
Dumbarton,571,10,7,11,18,43,63,-20,32
Hibernian,572,1,21,12,3,53,22,31,75
Falkirk,572,2,16,11,9,58,39,19,59
Dundee Utd,572,3,16,11,9,52,40,12,59
Morton,572,4,16,10,10,51,40,11,58
Ayr,572,5,11,12,13,39,51,-12,45
Raith,572,6,11,9,16,33,49,-16,42
Queen of S't,572,7,10,9,17,42,49,-7,39
Dumbarton,572,8,9,12,15,50,59,-9,39
Dunfermline,572,9,8,14,14,43,52,-9,38
St Mirren,572,10,6,12,18,37,57,-20,30
Hibernian,573,1,18,13,5,50,25,25,67
Morton,573,2,16,12,8,49,33,16,60
Falkirk,573,3,16,10,10,59,43,16,58
Dundee Utd,573,4,15,11,10,46,38,8,56
Raith,573,5,11,10,15,37,47,-10,43
St Mirren,573,6,11,10,15,43,55,-12,43
Dunfermline,573,7,10,12,14,44,47,-3,42
Queen of S't,573,8,10,10,16,45,52,-7,40
Ayr,573,9,8,14,14,36,55,-19,38
Dumbarton,573,10,9,10,17,46,60,-14,37
Morton,574,1,18,12,6,55,33,22,66
Falkirk,574,2,17,10,9,62,42,20,61
Dundee Utd,574,3,17,10,9,50,38,12,61
Hibernian,574,4,16,11,9,50,35,15,59
Dunfermline,574,5,10,14,12,51,52,-1,44
Dumbarton,574,6,11,11,14,53,57,-4,44
Queen of S't,574,7,11,10,15,45,51,-6,43
Raith,574,8,10,9,17,37,51,-14,39
Ayr,574,9,8,11,17,30,56,-26,35
St Mirren,574,10,7,12,17,35,53,-18,33
Hibernian,575,1,17,14,5,48,24,24,65
Falkirk,575,2,18,10,8,61,36,25,64
Morton,575,3,17,13,6,51,32,19,64
Dundee Utd,575,4,12,12,12,47,44,3,48
Queen of S't,575,5,12,10,14,44,49,-5,46
Dumbarton,575,6,10,12,14,49,59,-10,42
Dunfermline,575,7,9,14,13,48,53,-5,41
Ayr,575,8,9,13,14,33,50,-17,40
St Mirren,575,9,9,10,17,40,53,-13,37
Raith,575,10,8,10,18,30,51,-21,34
Hibernian,576,1,20,10,6,58,28,30,70
Morton,576,2,20,10,6,56,35,21,70
Dundee Utd,576,3,16,11,9,55,43,12,59
Falkirk,576,4,16,10,10,56,39,17,58
Queen of S't,576,5,12,10,14,49,55,-6,46
Dumbarton,576,6,10,10,16,51,64,-13,40
Raith,576,7,10,9,17,34,52,-18,39
Dunfermline,576,8,8,13,15,42,49,-7,37
Ayr,576,9,8,12,16,38,57,-19,36
St Mirren,576,10,8,9,19,42,59,-17,33
Hibernian,577,1,21,10,5,62,32,30,73
Morton,577,2,19,11,6,58,34,24,68
Falkirk,577,3,16,11,9,58,40,18,59
Dundee Utd,577,4,17,8,11,54,41,13,59
Queen of S't,577,5,11,10,15,41,49,-8,43
Dunfermline,577,6,10,12,14,45,52,-7,42
Raith,577,7,10,9,17,35,51,-16,39
Dumbarton,577,8,8,12,16,44,55,-11,36
St Mirren,577,9,8,11,17,39,56,-17,35
Ayr,577,10,7,12,17,33,59,-26,33
Hibernian,578,1,23,10,3,62,20,42,79
Dundee Utd,578,2,18,10,8,52,33,19,64
Falkirk,578,3,15,12,9,56,42,14,57
Morton,578,4,14,13,9,43,35,8,55
Raith,578,5,11,10,15,37,46,-9,43
Queen of S't,578,6,10,11,15,41,50,-9,41
Dunfermline,578,7,9,13,14,43,51,-8,40
Dumbarton,578,8,9,11,16,49,59,-10,38
St Mirren,578,9,7,12,17,37,57,-20,33
Ayr,578,10,7,12,17,29,56,-27,33
Hibernian,579,1,18,12,6,57,32,25,66
Morton,579,2,18,12,6,52,33,19,66
Dundee Utd,579,3,18,9,9,58,41,17,63
Falkirk,579,4,17,10,9,60,39,21,61
Dunfermline,579,5,11,13,12,51,48,3,46
Queen of S't,579,6,12,9,15,47,53,-6,45
Dumbarton,579,7,8,12,16,46,57,-11,36
Raith,579,8,9,9,18,30,50,-20,36
Ayr,579,9,8,12,16,35,58,-23,36
St Mirren,579,10,7,10,19,38,63,-25,31
Hibernian,580,1,21,12,3,63,23,40,75
Morton,580,2,16,12,8,46,37,9,60
Falkirk,580,3,15,10,11,57,43,14,55
Dundee Utd,580,4,15,10,11,50,40,10,55
Dunfermline,580,5,11,14,11,51,47,4,47
Dumbarton,580,6,10,13,13,54,58,-4,43
Raith,580,7,10,10,16,34,51,-17,40
Ayr,580,8,9,12,15,32,50,-18,39
Queen of S't,580,9,10,8,18,37,54,-17,38
St Mirren,580,10,7,11,18,36,57,-21,32
Hibernian,581,1,20,11,5,56,23,33,71
Morton,581,2,18,11,7,52,37,15,65
Falkirk,581,3,15,13,8,58,40,18,58
Dundee Utd,581,4,16,10,10,54,38,16,58
Queen of S't,581,5,11,11,14,44,50,-6,44
Dunfermline,581,6,10,12,14,49,59,-10,42
St Mirren,581,7,10,11,15,42,51,-9,41
Dumbarton,581,8,9,11,16,51,61,-10,38
Raith,581,9,9,10,17,35,50,-15,37
Ayr,581,10,6,12,18,31,63,-32,30
Hibernian,582,1,18,12,6,54,26,28,66
Morton,582,2,17,13,6,54,35,19,64
Falkirk,582,3,16,10,10,57,40,17,58
Dundee Utd,582,4,15,11,10,46,39,7,56
Queen of S't,582,5,14,9,13,48,45,3,51
Raith,582,6,12,8,16,34,47,-13,44
Dunfermline,582,7,8,15,13,45,50,-5,39
Ayr,582,8,9,11,16,33,55,-22,38
Dumbarton,582,9,9,10,17,49,63,-14,37
St Mirren,582,10,8,9,19,38,58,-20,33
Hibernian,583,1,19,11,6,56,25,31,68
Falkirk,583,2,16,11,9,54,38,16,59
Morton,583,3,16,11,9,49,38,11,59
Dundee Utd,583,4,14,11,11,42,37,5,53
Queen of S't,583,5,13,9,14,47,49,-2,48
Dunfermline,583,6,12,11,13,50,47,3,47
Raith,583,7,12,8,16,37,47,-10,44
Dumbarton,583,8,11,10,15,47,56,-9,43
Ayr,583,9,8,12,16,32,56,-24,36
St Mirren,583,10,7,10,19,33,54,-21,31
Hibernian,584,1,18,12,6,60,30,30,66
Dundee Utd,584,2,18,10,8,54,35,19,64
Morton,584,3,18,9,9,49,38,11,63
Falkirk,584,4,13,11,12,55,49,6,50
Queen of S't,584,5,12,9,15,53,58,-5,45
Dunfermline,584,6,10,14,12,45,44,1,44
Raith,584,7,12,8,16,36,47,-11,44
St Mirren,584,8,11,9,16,49,57,-8,42
Dumbarton,584,9,10,12,14,52,62,-10,42
Ayr,584,10,6,10,20,32,65,-33,28
Hibernian,585,1,21,11,4,58,23,35,74
Falkirk,585,2,18,9,9,66,40,26,63
Morton,585,3,17,11,8,51,35,16,62
Dundee Utd,585,4,17,9,10,56,47,9,60
Queen of S't,585,5,12,10,14,50,51,-1,46
Dunfermline,585,6,9,12,15,45,51,-6,39
Raith,585,7,9,11,16,31,48,-17,38
St Mirren,585,8,9,10,17,42,59,-17,37
Ayr,585,9,8,11,17,32,61,-29,35
Dumbarton,585,10,8,10,18,44,60,-16,34
Hibernian,586,1,21,10,5,53,24,29,73
Morton,586,2,18,10,8,52,36,16,64
Dundee Utd,586,3,15,11,10,55,45,10,56
Falkirk,586,4,15,10,11,54,41,13,55
Queen of S't,586,5,12,9,15,46,51,-5,45
Raith,586,6,11,10,15,40,52,-12,43
Dunfermline,586,7,9,12,15,42,48,-6,39
Dumbarton,586,8,9,12,15,51,60,-9,39
Ayr,586,9,9,12,15,39,58,-19,39
St Mirren,586,10,8,10,18,43,60,-17,34
Hibernian,587,1,22,11,3,54,20,34,77
Morton,587,2,17,10,9,46,33,13,61
Falkirk,587,3,15,9,12,54,42,12,54
Dundee Utd,587,4,15,9,12,48,40,8,54
Dunfermline,587,5,10,14,12,44,45,-1,44
Dumbarton,587,6,11,10,15,52,59,-7,43
Queen of S't,587,7,11,9,16,44,51,-7,42
St Mirren,587,8,10,10,16,43,51,-8,40
Ayr,587,9,9,11,16,35,58,-23,38
Raith,587,10,8,11,17,32,53,-21,35
Hibernian,588,1,20,12,4,58,28,30,72
Falkirk,588,2,16,11,9,59,39,20,59
Morton,588,3,15,11,10,44,38,6,56
Dundee Utd,588,4,14,11,11,49,42,7,53
Dunfermline,588,5,12,13,11,50,45,5,49
Queen of S't,588,6,9,13,14,43,51,-8,40
Dumbarton,588,7,9,12,15,49,58,-9,39
Raith,588,8,10,9,17,36,53,-17,39
Ayr,588,9,8,14,14,37,57,-20,38
St Mirren,588,10,9,10,17,47,61,-14,37
Hibernian,589,1,20,11,5,62,27,35,71
Dundee Utd,589,2,17,9,10,48,39,9,60
Falkirk,589,3,16,11,9,57,39,18,59
Morton,589,4,16,11,9,47,41,6,59
Dunfermline,589,5,12,12,12,50,46,4,48
St Mirren,589,6,10,10,16,43,53,-10,40
Queen of S't,589,7,10,10,16,44,56,-12,40
Dumbarton,589,8,9,12,15,46,56,-10,39
Raith,589,9,9,10,17,32,52,-20,37
Ayr,589,10,8,10,18,37,57,-20,34
Hibernian,590,1,19,12,5,55,29,26,69
Morton,590,2,17,13,6,51,34,17,64
Falkirk,590,3,15,13,8,54,37,17,58
Dundee Utd,590,4,16,9,11,48,39,9,57
Queen of S't,590,5,13,9,14,51,51,0,48
Dunfermline,590,6,9,15,12,43,45,-2,42
Ayr,590,7,10,10,16,38,54,-16,40
Raith,590,8,10,9,17,32,47,-15,39
St Mirren,590,9,9,10,17,41,55,-14,37
Dumbarton,590,10,7,10,19,48,70,-22,31
Hibernian,591,1,15,15,6,51,29,22,60
Falkirk,591,2,16,12,8,60,40,20,60
Dundee Utd,591,3,15,12,9,52,40,12,57
Morton,591,4,15,12,9,46,36,10,57
Dumbarton,591,5,12,11,13,52,55,-3,47
Dunfermline,591,6,11,12,13,48,50,-2,45
Raith,591,7,11,9,16,35,49,-14,42
Queen of S't,591,8,10,11,15,44,52,-8,41
St Mirren,591,9,10,11,15,47,59,-12,41
Ayr,591,10,6,13,17,32,57,-25,31
Hibernian,592,1,20,11,5,55,24,31,71
Dundee Utd,592,2,18,8,10,54,37,17,62
Falkirk,592,3,16,9,11,57,42,15,57
Morton,592,4,15,12,9,47,37,10,57
Dunfermline,592,5,12,13,11,49,46,3,49
Queen of S't,592,6,10,10,16,43,53,-10,40
St Mirren,592,7,10,10,16,44,58,-14,40
Raith,592,8,10,9,17,35,53,-18,39
Dumbarton,592,9,8,12,16,48,57,-9,36
Ayr,592,10,8,12,16,33,58,-25,36
Hibernian,593,1,19,11,6,53,25,28,68
Morton,593,2,18,11,7,53,33,20,65
Falkirk,593,3,18,10,8,56,36,20,64
Dundee Utd,593,4,14,10,12,47,44,3,52
Dumbarton,593,5,10,11,15,46,54,-8,41
Queen of S't,593,6,11,8,17,45,55,-10,41
Raith,593,7,10,11,15,36,48,-12,41
Ayr,593,8,9,14,13,37,53,-16,41
Dunfermline,593,9,8,13,15,44,51,-7,37
St Mirren,593,10,8,11,17,41,59,-18,35
Hibernian,594,1,18,11,7,52,28,24,65
Morton,594,2,17,11,8,53,37,16,62
Dundee Utd,594,3,17,10,9,52,36,16,61
Falkirk,594,4,16,10,10,61,47,14,58
Dunfermline,594,5,12,13,11,48,45,3,49
Queen of S't,594,6,11,8,17,46,55,-9,41
Raith,594,7,10,10,16,35,49,-14,40
Ayr,594,8,9,12,15,33,54,-21,39
Dumbarton,594,9,9,11,16,51,62,-11,38
St Mirren,594,10,8,10,18,40,58,-18,34
Morton,595,1,20,10,6,56,35,21,70
Hibernian,595,2,17,13,6,51,26,25,64
Falkirk,595,3,17,12,7,59,35,24,63
Dundee Utd,595,4,15,11,10,51,38,13,56
Dunfermline,595,5,10,12,14,45,50,-5,42
Queen of S't,595,6,10,11,15,44,55,-11,41
Dumbarton,595,7,9,12,15,47,58,-11,39
Raith,595,8,10,9,17,36,53,-17,39
St Mirren,595,9,9,9,18,37,53,-16,36
Ayr,595,10,8,11,17,36,59,-23,35
Hibernian,596,1,20,10,6,53,28,25,70
Morton,596,2,19,10,7,59,35,24,67
Falkirk,596,3,17,9,10,60,39,21,60
Dundee Utd,596,4,16,10,10,51,43,8,58
Queen of S't,596,5,14,9,13,46,45,1,51
Raith,596,6,10,10,16,34,50,-16,40
Dunfermline,596,7,9,11,16,46,50,-4,38
Dumbarton,596,8,8,12,16,44,62,-18,36
Ayr,596,9,8,12,16,38,60,-22,36
St Mirren,596,10,8,9,19,39,58,-19,33
Hibernian,597,1,19,12,5,56,24,32,69
Morton,597,2,17,12,7,48,34,14,63
Falkirk,597,3,16,11,9,53,41,12,59
Dundee Utd,597,4,16,10,10,52,39,13,58
Dunfermline,597,5,9,15,12,43,45,-2,42
Dumbarton,597,6,10,12,14,48,52,-4,42
Raith,597,7,11,9,16,36,47,-11,42
Queen of S't,597,8,9,12,15,41,51,-10,39
Ayr,597,9,8,12,16,35,57,-22,36
St Mirren,597,10,7,11,18,38,60,-22,32
Hibernian,598,1,22,11,3,60,22,38,77
Falkirk,598,2,18,9,9,62,40,22,63
Dundee Utd,598,3,16,9,11,51,41,10,57
Morton,598,4,15,10,11,48,41,7,55
Dunfermline,598,5,11,11,14,47,49,-2,44
Queen of S't,598,6,10,10,16,42,51,-9,40
Dumbarton,598,7,9,12,15,44,57,-13,39
St Mirren,598,8,10,9,17,41,55,-14,39
Raith,598,9,10,8,18,34,52,-18,38
Ayr,598,10,9,11,16,34,55,-21,38
Morton,599,1,20,11,5,55,33,22,71
Hibernian,599,2,17,15,4,50,22,28,66
Falkirk,599,3,16,9,11,56,41,15,57
Dundee Utd,599,4,14,11,11,49,40,9,53
Dunfermline,599,5,10,13,13,44,43,1,43
Raith,599,6,11,10,15,36,48,-12,43
St Mirren,599,7,10,10,16,43,54,-11,40
Queen of S't,599,8,10,9,17,40,55,-15,39
Dumbarton,599,9,9,10,17,44,64,-20,37
Ayr,599,10,8,12,16,32,49,-17,36
Hibernian,600,1,18,12,6,57,27,30,66
Morton,600,2,15,12,9,47,39,8,57
Dundee Utd,600,3,15,10,11,47,37,10,55
Falkirk,600,4,14,11,11,55,44,11,53
Queen of S't,600,5,15,8,13,50,46,4,53
Raith,600,6,13,9,14,41,49,-8,48
Dunfermline,600,7,11,13,12,48,49,-1,46
Dumbarton,600,8,9,12,15,52,60,-8,39
Ayr,600,9,8,12,16,33,58,-25,36
St Mirren,600,10,8,9,19,37,58,-21,33
Hibernian,601,1,19,12,5,55,32,23,69
Morton,601,2,18,10,8,54,33,21,64
Falkirk,601,3,15,12,9,57,42,15,57
Dundee Utd,601,4,13,13,10,49,45,4,52
Dunfermline,601,5,11,13,12,47,44,3,46
Queen of S't,601,6,10,11,15,46,53,-7,41
Dumbarton,601,7,10,11,15,49,59,-10,41
Raith,601,8,10,10,16,35,47,-12,40
St Mirren,601,9,9,11,16,41,56,-15,38
Ayr,601,10,7,13,16,36,58,-22,34
Hibernian,602,1,19,13,4,59,27,32,70
Morton,602,2,15,14,7,51,37,14,59
Falkirk,602,3,16,10,10,59,42,17,58
Dundee Utd,602,4,16,9,11,51,41,10,57
Dunfermline,602,5,13,11,12,53,47,6,50
Queen of S't,602,6,13,9,14,44,48,-4,48
Raith,602,7,11,11,14,35,47,-12,44
Dumbarton,602,8,8,12,16,49,63,-14,36
St Mirren,602,9,8,10,18,41,58,-17,34
Ayr,602,10,6,11,19,30,62,-32,29
Hibernian,603,1,18,13,5,53,27,26,67
Morton,603,2,17,12,7,50,34,16,63
Dundee Utd,603,3,17,10,9,52,37,15,61
Falkirk,603,4,16,10,10,57,42,15,58
Queen of S't,603,5,12,9,15,47,47,0,45
Dunfermline,603,6,9,12,15,40,50,-10,39
St Mirren,603,7,9,12,15,41,53,-12,39
Raith,603,8,9,12,15,34,47,-13,39
Dumbarton,603,9,7,14,15,46,61,-15,35
Ayr,603,10,7,14,15,31,53,-22,35
Hibernian,604,1,17,12,7,52,29,23,63
Falkirk,604,2,16,11,9,61,42,19,59
Dundee Utd,604,3,16,11,9,52,41,11,59
Morton,604,4,15,12,9,42,32,10,57
Dunfermline,604,5,11,12,13,51,48,3,45
Queen of S't,604,6,11,11,14,45,51,-6,44
Ayr,604,7,10,13,13,39,50,-11,43
Raith,604,8,11,10,15,37,50,-13,43
Dumbarton,604,9,8,12,16,48,65,-17,36
St Mirren,604,10,7,12,17,39,58,-19,33
Hibernian,605,1,19,10,7,51,30,21,67
Dundee Utd,605,2,18,9,9,56,36,20,63
Falkirk,605,3,17,9,10,60,43,17,60
Morton,605,4,14,15,7,46,34,12,57
Queen of S't,605,5,13,9,14,48,50,-2,48
Dunfermline,605,6,11,12,13,46,48,-2,45
Raith,605,7,9,11,16,36,53,-17,38
St Mirren,605,8,8,12,16,39,53,-14,36
Ayr,605,9,8,12,16,35,55,-20,36
Dumbarton,605,10,8,11,17,47,62,-15,35
Hibernian,606,1,19,12,5,53,26,27,69
Falkirk,606,2,16,10,10,61,41,20,58
Morton,606,3,15,13,8,49,39,10,58
Dundee Utd,606,4,13,11,12,46,43,3,50
Queen of S't,606,5,13,9,14,47,49,-2,48
Dunfermline,606,6,10,14,12,45,46,-1,44
St Mirren,606,7,11,9,16,41,52,-11,42
Ayr,606,8,9,13,14,40,58,-18,40
Dumbarton,606,9,9,11,16,45,59,-14,38
Raith,606,10,9,10,17,35,49,-14,37
Hibernian,607,1,18,11,7,54,28,26,65
Morton,607,2,16,14,6,52,35,17,62
Dundee Utd,607,3,15,11,10,49,37,12,56
Falkirk,607,4,15,9,12,56,41,15,54
Queen of S't,607,5,14,9,13,49,49,0,51
Dunfermline,607,6,10,13,13,48,55,-7,43
Ayr,607,7,10,13,13,38,53,-15,43
Dumbarton,607,8,8,14,14,47,58,-11,38
Raith,607,9,9,9,18,35,56,-21,36
St Mirren,607,10,8,11,17,41,57,-16,35
Morton,608,1,18,13,5,53,34,19,67
Dundee Utd,608,2,18,9,9,57,42,15,63
Hibernian,608,3,16,14,6,47,23,24,62
Falkirk,608,4,15,11,10,53,39,14,56
Dunfermline,608,5,11,12,13,51,51,0,45
Queen of S't,608,6,11,10,15,48,49,-1,43
Dumbarton,608,7,9,12,15,50,61,-11,39
Raith,608,8,10,9,17,33,50,-17,39
St Mirren,608,9,9,9,18,39,56,-17,36
Ayr,608,10,8,11,17,33,59,-26,35
Morton,609,1,19,12,5,55,34,21,69
Hibernian,609,2,17,16,3,54,26,28,67
Falkirk,609,3,18,9,9,58,36,22,63
Dundee Utd,609,4,15,8,13,46,42,4,53
Queen of S't,609,5,13,8,15,44,50,-6,47
Dunfermline,609,6,9,12,15,43,49,-6,39
Dumbarton,609,7,9,10,17,44,57,-13,37
St Mirren,609,8,9,10,17,39,53,-14,37
Raith,609,9,9,10,17,33,50,-17,37
Ayr,609,10,8,13,15,34,53,-19,37
Hibernian,610,1,21,11,4,60,30,30,74
Falkirk,610,2,16,11,9,60,40,20,59
Dundee Utd,610,3,16,10,10,54,38,16,58
Morton,610,4,15,10,11,47,40,7,55
Dunfermline,610,5,12,12,12,44,44,0,48
Queen of S't,610,6,12,9,15,48,53,-5,45
Dumbarton,610,7,10,10,16,48,59,-11,40
St Mirren,610,8,10,9,17,38,52,-14,39
Raith,610,9,10,8,18,34,54,-20,38
Ayr,610,10,8,10,18,37,60,-23,34
Hibernian,611,1,18,14,4,53,24,29,68
Falkirk,611,2,19,10,7,66,38,28,67
Morton,611,3,16,12,8,50,38,12,60
Dundee Utd,611,4,15,11,10,47,38,9,56
Dunfermline,611,5,11,12,13,50,49,1,45
Queen of S't,611,6,10,10,16,40,54,-14,40
Dumbarton,611,7,9,12,15,48,59,-11,39
Raith,611,8,10,8,18,34,54,-20,38
St Mirren,611,9,9,10,17,42,55,-13,37
Ayr,611,10,7,13,16,32,53,-21,34
Hibernian,612,1,20,11,5,58,27,31,71
Morton,612,2,18,11,7,51,35,16,65
Dundee Utd,612,3,16,11,9,50,35,15,59
Falkirk,612,4,13,10,13,53,50,3,49
Queen of S't,612,5,13,10,13,49,48,1,49
Dunfermline,612,6,11,13,12,47,44,3,46
Dumbarton,612,7,9,12,15,47,56,-9,39
St Mirren,612,8,9,10,17,40,55,-15,37
Raith,612,9,8,11,17,31,49,-18,35
Ayr,612,10,8,11,17,33,60,-27,35
Hibernian,613,1,20,12,4,58,25,33,72
Morton,613,2,15,14,7,54,39,15,59
Falkirk,613,3,14,11,11,54,41,13,53
Dundee Utd,613,4,14,11,11,48,47,1,53
Queen of S't,613,5,12,10,14,44,49,-5,46
Dunfermline,613,6,10,13,13,46,48,-2,43
Ayr,613,7,8,16,12,38,50,-12,40
Dumbarton,613,8,9,12,15,49,60,-11,39
St Mirren,613,9,8,13,15,42,53,-11,37
Raith,613,10,9,10,17,32,53,-21,37
Hibernian,614,1,18,10,8,54,35,19,64
Morton,614,2,17,11,8,52,38,14,62
Falkirk,614,3,17,10,9,65,44,21,61
Dundee Utd,614,4,16,11,9,55,40,15,59
Dunfermline,614,5,11,12,13,45,47,-2,45
Queen of S't,614,6,12,9,15,47,50,-3,45
Dumbarton,614,7,11,11,14,50,58,-8,44
Raith,614,8,10,10,16,38,53,-15,40
Ayr,614,9,7,14,15,37,58,-21,35
St Mirren,614,10,7,10,19,38,58,-20,31
Hibernian,615,1,19,13,4,54,25,29,70
Morton,615,2,17,13,6,54,35,19,64
Dundee Utd,615,3,15,11,10,48,40,8,56
Falkirk,615,4,14,9,13,56,46,10,51
Queen of S't,615,5,13,9,14,47,48,-1,48
Dunfermline,615,6,10,14,12,50,49,1,44
Ayr,615,7,9,12,15,35,56,-21,39
Dumbarton,615,8,9,11,16,48,61,-13,38
Raith,615,9,9,10,17,37,52,-15,37
St Mirren,615,10,9,10,17,38,55,-17,37
Morton,616,1,20,10,6,54,32,22,70
Hibernian,616,2,17,14,5,53,28,25,65
Falkirk,616,3,17,9,10,57,43,14,60
Dundee Utd,616,4,15,10,11,54,43,11,55
Queen of S't,616,5,13,9,14,51,48,3,48
Dunfermline,616,6,9,14,13,43,47,-4,41
Raith,616,7,10,10,16,32,47,-15,40
St Mirren,616,8,9,10,17,45,60,-15,37
Ayr,616,9,8,12,16,36,55,-19,36
Dumbarton,616,10,7,12,17,48,70,-22,33
Hibernian,617,1,20,12,4,57,23,34,72
Morton,617,2,16,11,9,49,36,13,59
Falkirk,617,3,15,12,9,58,40,18,57
Dundee Utd,617,4,16,8,12,46,39,7,56
Queen of S't,617,5,12,9,15,43,48,-5,45
Dunfermline,617,6,11,11,14,46,50,-4,44
Dumbarton,617,7,10,12,14,47,54,-7,42
Raith,617,8,11,8,17,32,48,-16,41
St Mirren,617,9,9,11,16,43,57,-14,38
Ayr,617,10,7,12,17,31,57,-26,33
Hibernian,618,1,19,14,3,55,23,32,71
Morton,618,2,18,10,8,51,36,15,64
Falkirk,618,3,17,10,9,57,38,19,61
Dundee Utd,618,4,16,9,11,53,46,7,57
Queen of S't,618,5,12,8,16,48,53,-5,44
Dunfermline,618,6,9,14,13,49,53,-4,41
Dumbarton,618,7,10,11,15,50,56,-6,41
Raith,618,8,10,9,17,36,55,-19,39
St Mirren,618,9,9,11,16,42,56,-14,38
Ayr,618,10,7,10,19,37,62,-25,31
Hibernian,619,1,22,10,4,59,25,34,76
Dundee Utd,619,2,19,9,8,51,35,16,66
Falkirk,619,3,18,9,9,59,38,21,63
Morton,619,4,16,10,10,50,36,14,58
Dunfermline,619,5,10,11,15,43,47,-4,41
Queen of S't,619,6,10,10,16,42,52,-10,40
Raith,619,7,10,9,17,35,51,-16,39
Dumbarton,619,8,8,12,16,50,68,-18,36
St Mirren,619,9,8,11,17,45,61,-16,35
Ayr,619,10,8,11,17,38,59,-21,35
Morton,620,1,19,10,7,51,34,17,67
Hibernian,620,2,17,12,7,51,29,22,63
Falkirk,620,3,16,12,8,62,39,23,60
Dunfermline,620,4,13,12,11,52,46,6,51
Dundee Utd,620,5,14,9,13,47,45,2,51
Queen of S't,620,6,11,9,16,45,55,-10,42
St Mirren,620,7,10,11,15,42,54,-12,41
Ayr,620,8,8,13,15,35,53,-18,37
Dumbarton,620,9,7,15,14,44,57,-13,36
Raith,620,10,9,9,18,33,50,-17,36
Hibernian,621,1,19,12,5,57,28,29,69
Morton,621,2,19,10,7,55,37,18,67
Dundee Utd,621,3,17,10,9,48,38,10,61
Falkirk,621,4,15,12,9,52,39,13,57
Queen of S't,621,5,10,12,14,47,55,-8,42
Raith,621,6,11,9,16,40,52,-12,42
Dumbarton,621,7,9,13,14,45,52,-7,40
Dunfermline,621,8,9,12,15,44,48,-4,39
Ayr,621,9,7,14,15,34,53,-19,35
St Mirren,621,10,7,10,19,39,59,-20,31
Hibernian,622,1,19,12,5,56,23,33,69
Falkirk,622,2,18,10,8,61,40,21,64
Morton,622,3,16,12,8,48,39,9,60
Dundee Utd,622,4,15,11,10,48,42,6,56
Ayr,622,5,11,10,15,39,53,-14,43
Dumbarton,622,6,10,10,16,46,56,-10,40
Queen of S't,622,7,10,9,17,42,53,-11,39
Raith,622,8,10,9,17,34,48,-14,39
Dunfermline,622,9,8,14,14,44,52,-8,38
St Mirren,622,10,9,11,16,41,53,-12,38
Hibernian,623,1,21,11,4,60,25,35,74
Falkirk,623,2,19,9,8,62,38,24,66
Morton,623,3,17,11,8,56,37,19,62
Dundee Utd,623,4,15,9,12,48,41,7,54
Dumbarton,623,5,11,11,14,52,58,-6,44
Dunfermline,623,6,10,13,13,48,48,0,43
Queen of S't,623,7,11,9,16,40,54,-14,42
Raith,623,8,9,10,17,34,49,-15,37
St Mirren,623,9,8,10,18,39,62,-23,34
Ayr,623,10,7,11,18,29,56,-27,32
Hibernian,624,1,21,10,5,65,25,40,73
Falkirk,624,2,16,12,8,57,40,17,60
Morton,624,3,16,11,9,50,41,9,59
Dundee Utd,624,4,15,11,10,51,43,8,56
Queen of S't,624,5,11,10,15,47,54,-7,43
Dunfermline,624,6,10,12,14,50,54,-4,42
Ayr,624,7,10,12,14,42,57,-15,42
St Mirren,624,8,10,10,16,47,59,-12,40
Dumbarton,624,9,9,11,16,47,58,-11,38
Raith,624,10,8,9,19,34,59,-25,33
Hibernian,625,1,19,13,4,54,24,30,70
Dundee Utd,625,2,16,10,10,56,46,10,58
Morton,625,3,15,13,8,49,40,9,58
Falkirk,625,4,15,9,12,59,51,8,54
Queen of S't,625,5,14,9,13,56,49,7,51
Dunfermline,625,6,11,13,12,48,49,-1,46
Raith,625,7,11,9,16,35,48,-13,42
St Mirren,625,8,10,10,16,45,54,-9,40
Dumbarton,625,9,9,10,17,50,65,-15,37
Ayr,625,10,7,10,19,29,55,-26,31
Hibernian,626,1,19,13,4,56,25,31,70
Morton,626,2,19,9,8,49,35,14,66
Falkirk,626,3,16,12,8,58,35,23,60
Dundee Utd,626,4,15,12,9,47,36,11,57
Queen of S't,626,5,11,10,15,40,46,-6,43
Dumbarton,626,6,10,12,14,48,56,-8,42
St Mirren,626,7,9,11,16,38,50,-12,38
Raith,626,8,10,8,18,31,52,-21,38
Dunfermline,626,9,8,13,15,44,53,-9,37
Ayr,626,10,7,12,17,31,54,-23,33
Hibernian,627,1,21,10,5,56,25,31,73
Morton,627,2,18,10,8,52,37,15,64
Dundee Utd,627,3,15,12,9,48,38,10,57
Falkirk,627,4,15,11,10,60,40,20,56
Queen of S't,627,5,12,9,15,45,50,-5,45
Dunfermline,627,6,10,14,12,46,48,-2,44
Dumbarton,627,7,9,11,16,45,58,-13,38
Raith,627,8,9,10,17,36,53,-17,37
St Mirren,627,9,9,10,17,44,62,-18,37
Ayr,627,10,7,13,16,33,54,-21,34
Hibernian,628,1,19,11,6,57,27,30,68
Morton,628,2,19,10,7,54,35,19,67
Falkirk,628,3,16,9,11,56,42,14,57
Dundee Utd,628,4,16,9,11,54,40,14,57
Dunfermline,628,5,10,12,14,42,47,-5,42
Queen of S't,628,6,11,9,16,41,54,-13,42
Raith,628,7,10,10,16,36,51,-15,40
Ayr,628,8,9,12,15,35,56,-21,39
St Mirren,628,9,8,13,15,43,52,-9,37
Dumbarton,628,10,8,13,15,44,58,-14,37
Hibernian,629,1,19,13,4,56,22,34,70
Falkirk,629,2,17,11,8,59,38,21,62
Dundee Utd,629,3,17,10,9,48,34,14,61
Morton,629,4,15,12,9,47,37,10,57
Queen of S't,629,5,12,8,16,46,52,-6,44
Dunfermline,629,6,10,12,14,47,51,-4,42
Raith,629,7,10,10,16,37,51,-14,40
Ayr,629,8,8,14,14,37,56,-19,38
Dumbarton,629,9,8,11,17,44,61,-17,35
St Mirren,629,10,8,11,17,39,58,-19,35
Hibernian,630,1,16,14,6,51,29,22,62
Morton,630,2,16,13,7,47,33,14,61
Dundee Utd,630,3,16,10,10,56,41,15,58
Falkirk,630,4,14,11,11,56,43,13,53
Queen of S't,630,5,13,10,13,50,50,0,49
Dunfermline,630,6,10,14,12,47,49,-2,44
Raith,630,7,10,12,14,34,45,-11,42
Dumbarton,630,8,10,12,14,49,61,-12,42
Ayr,630,9,7,14,15,33,54,-21,35
St Mirren,630,10,8,10,18,37,55,-18,34
Morton,631,1,20,11,5,54,34,20,71
Hibernian,631,2,17,12,7,56,28,28,63
Falkirk,631,3,17,11,8,67,44,23,62
Dundee Utd,631,4,15,11,10,47,40,7,56
Queen of S't,631,5,12,8,16,48,56,-8,44
Dunfermline,631,6,9,14,13,45,48,-3,41
Raith,631,7,10,10,16,35,52,-17,40
Dumbarton,631,8,9,11,16,49,61,-12,38
Ayr,631,9,9,11,16,36,55,-19,38
St Mirren,631,10,6,13,17,38,57,-19,31
Hibernian,632,1,21,11,4,61,26,35,74
Morton,632,2,18,11,7,59,34,25,65
Dundee Utd,632,3,15,12,9,46,37,9,57
Falkirk,632,4,14,11,11,57,47,10,53
Queen of S't,632,5,12,8,16,46,54,-8,44
Raith,632,6,12,8,16,39,51,-12,44
Dunfermline,632,7,9,13,14,51,58,-7,40
Ayr,632,8,8,13,15,31,53,-22,37
St Mirren,632,9,8,12,16,39,54,-15,36
Dumbarton,632,10,8,11,17,48,63,-15,35
Hibernian,633,1,19,12,5,53,24,29,69
Falkirk,633,2,17,11,8,59,38,21,62
Dundee Utd,633,3,17,10,9,51,34,17,61
Morton,633,4,16,9,11,47,37,10,57
Queen of S't,633,5,12,9,15,46,53,-7,45
Dunfermline,633,6,10,13,13,45,47,-2,43
Dumbarton,633,7,11,10,15,47,60,-13,43
Raith,633,8,9,11,16,39,52,-13,38
Ayr,633,9,8,11,17,35,54,-19,35
St Mirren,633,10,8,10,18,36,59,-23,34
Morton,634,1,19,12,5,55,34,21,69
Hibernian,634,2,18,13,5,61,28,33,67
Falkirk,634,3,18,10,8,60,39,21,64
Dundee Utd,634,4,13,11,12,48,44,4,50
Raith,634,5,10,10,16,39,52,-13,40
Queen of S't,634,6,10,10,16,44,59,-15,40
Dunfermline,634,7,8,15,13,45,50,-5,39
Dumbarton,634,8,8,14,14,48,57,-9,38
Ayr,634,9,8,14,14,38,57,-19,38
St Mirren,634,10,8,11,17,38,56,-18,35
Hibernian,635,1,17,15,4,54,27,27,66
Morton,635,2,17,13,6,48,32,16,64
Falkirk,635,3,17,11,8,61,40,21,62
Dundee Utd,635,4,16,9,11,46,38,8,57
Raith,635,5,11,10,15,37,48,-11,43
Dunfermline,635,6,10,12,14,44,46,-2,42
Queen of S't,635,7,11,9,16,46,55,-9,42
Dumbarton,635,8,8,13,15,48,58,-10,37
St Mirren,635,9,7,13,16,41,58,-17,34
Ayr,635,10,7,13,16,32,55,-23,34
Hibernian,636,1,19,13,4,59,29,30,70
Falkirk,636,2,17,12,7,60,38,22,63
Morton,636,3,16,13,7,52,37,15,61
Dundee Utd,636,4,16,10,10,50,38,12,58
Dunfermline,636,5,9,15,12,43,44,-1,42
Dumbarton,636,6,10,11,15,48,55,-7,41
Queen of S't,636,7,9,14,13,39,46,-7,41
Raith,636,8,9,11,16,31,48,-17,38
Ayr,636,9,8,13,15,36,59,-23,37
St Mirren,636,10,6,10,20,40,64,-24,28
Morton,637,1,18,12,6,55,36,19,66
Hibernian,637,2,17,14,5,52,27,25,65
Dundee Utd,637,3,18,9,9,53,37,16,63
Falkirk,637,4,15,12,9,63,47,16,57
Dumbarton,637,5,11,11,14,53,58,-5,44
Raith,637,6,10,12,14,37,47,-10,42
Queen of S't,637,7,10,11,15,40,48,-8,41
Dunfermline,637,8,9,11,16,43,51,-8,38
St Mirren,637,9,7,12,17,40,59,-19,33
Ayr,637,10,7,12,17,32,58,-26,33
Hibernian,638,1,19,12,5,59,26,33,69
Morton,638,2,17,12,7,52,36,16,63
Falkirk,638,3,17,10,9,60,40,20,61
Dundee Utd,638,4,16,9,11,51,39,12,57
Queen of S't,638,5,13,9,14,45,51,-6,48
Dumbarton,638,6,10,12,14,50,57,-7,42
Raith,638,7,10,11,15,40,51,-11,41
Dunfermline,638,8,8,12,16,43,55,-12,36
Ayr,638,9,8,12,16,33,54,-21,36
St Mirren,638,10,7,11,18,39,63,-24,32
Hibernian,639,1,19,11,6,58,28,30,68
Morton,639,2,17,12,7,53,38,15,63
Dundee Utd,639,3,16,11,9,47,38,9,59
Falkirk,639,4,16,9,11,58,40,18,57
Dunfermline,639,5,10,13,13,44,49,-5,43
Raith,639,6,11,9,16,40,52,-12,42
Dumbarton,639,7,10,11,15,47,56,-9,41
Queen of S't,639,8,10,11,15,43,53,-10,41
Ayr,639,9,8,13,15,34,53,-19,37
St Mirren,639,10,8,10,18,43,60,-17,34
Hibernian,640,1,19,12,5,50,25,25,69
Morton,640,2,19,11,6,55,31,24,68
Dundee Utd,640,3,16,9,11,60,44,16,57
Falkirk,640,4,14,11,11,56,43,13,53
Queen of S't,640,5,15,8,13,53,46,7,53
Ayr,640,6,10,13,13,39,53,-14,43
Dumbarton,640,7,10,10,16,51,62,-11,40
Raith,640,8,9,11,16,32,52,-20,38
St Mirren,640,9,8,10,18,38,58,-20,34
Dunfermline,640,10,7,11,18,40,60,-20,32
Hibernian,641,1,20,12,4,56,26,30,72
Falkirk,641,2,16,10,10,60,44,16,58
Morton,641,3,16,10,10,43,34,9,58
Dundee Utd,641,4,14,11,11,47,39,8,53
Dunfermline,641,5,11,13,12,46,46,0,46
Dumbarton,641,6,10,12,14,47,53,-6,42
Raith,641,7,11,8,17,35,46,-11,41
Queen of S't,641,8,9,12,15,41,50,-9,39
Ayr,641,9,9,12,15,34,55,-21,39
St Mirren,641,10,8,12,16,39,55,-16,36
Hibernian,642,1,19,12,5,56,24,32,69
Falkirk,642,2,15,12,9,53,35,18,57
Dundee Utd,642,3,15,10,11,51,39,12,55
Morton,642,4,14,12,10,45,44,1,54
Raith,642,5,12,11,13,38,41,-3,47
Queen of S't,642,6,12,9,15,45,52,-7,45
Dumbarton,642,7,11,11,14,51,58,-7,44
Dunfermline,642,8,8,15,13,39,48,-9,39
Ayr,642,9,9,12,15,36,56,-20,39
St Mirren,642,10,8,10,18,36,53,-17,34
Hibernian,643,1,20,11,5,59,27,32,71
Morton,643,2,17,11,8,52,40,12,62
Dundee Utd,643,3,17,10,9,55,39,16,61
Falkirk,643,4,15,12,9,54,40,14,57
Dunfermline,643,5,11,12,13,49,51,-2,45
Raith,643,6,10,11,15,35,48,-13,41
Dumbarton,643,7,9,13,14,50,56,-6,40
Ayr,643,8,9,11,16,35,55,-20,38
Queen of S't,643,9,9,10,17,44,58,-14,37
St Mirren,643,10,7,11,18,34,53,-19,32
Hibernian,644,1,20,12,4,61,29,32,72
Morton,644,2,18,10,8,51,34,17,64
Falkirk,644,3,17,9,10,58,38,20,60
Dundee Utd,644,4,16,9,11,51,42,9,57
Queen of S't,644,5,11,11,14,46,56,-10,44
Dumbarton,644,6,10,12,14,52,58,-6,42
Dunfermline,644,7,9,12,15,50,51,-1,39
Ayr,644,8,9,12,15,34,54,-20,39
Raith,644,9,9,9,18,30,51,-21,36
St Mirren,644,10,8,10,18,38,58,-20,34
Hibernian,645,1,21,10,5,62,25,37,73
Morton,645,2,17,10,9,49,40,9,61
Dundee Utd,645,3,17,8,11,53,37,16,59
Falkirk,645,4,16,11,9,56,42,14,59
Queen of S't,645,5,12,9,15,43,49,-6,45
Dunfermline,645,6,11,11,14,51,50,1,44
St Mirren,645,7,11,11,14,44,50,-6,44
Dumbarton,645,8,9,10,17,49,63,-14,37
Ayr,645,9,8,11,17,34,61,-27,35
Raith,645,10,8,9,19,32,56,-24,33
Hibernian,646,1,22,11,3,59,21,38,77
Dundee Utd,646,2,18,8,10,54,38,16,62
Morton,646,3,16,13,7,52,35,17,61
Falkirk,646,4,15,10,11,51,39,12,55
Queen of S't,646,5,13,8,15,44,52,-8,47
Dumbarton,646,6,10,12,14,48,53,-5,42
Dunfermline,646,7,8,13,15,39,46,-7,37
Ayr,646,8,8,12,16,35,59,-24,36
Raith,646,9,8,11,17,31,51,-20,35
St Mirren,646,10,7,12,17,38,57,-19,33
Hibernian,647,1,20,12,4,54,23,31,72
Falkirk,647,2,17,10,9,56,36,20,61
Dundee Utd,647,3,17,10,9,52,36,16,61
Morton,647,4,15,13,8,53,39,14,58
Queen of S't,647,5,11,10,15,45,52,-7,43
Dunfermline,647,6,9,14,13,50,53,-3,41
Dumbarton,647,7,9,14,13,46,56,-10,41
Raith,647,8,10,10,16,33,48,-15,40
St Mirren,647,9,8,10,18,35,53,-18,34
Ayr,647,10,7,11,18,31,59,-28,32
Hibernian,648,1,18,12,6,51,25,26,66
Morton,648,2,18,11,7,53,35,18,65
Dundee Utd,648,3,17,9,10,54,42,12,60
Falkirk,648,4,16,10,10,57,44,13,58
Queen of S't,648,5,12,10,14,48,50,-2,46
Dunfermline,648,6,10,14,12,47,46,1,44
Dumbarton,648,7,10,10,16,49,56,-7,40
Ayr,648,8,9,12,15,37,61,-24,39
Raith,648,9,9,9,18,32,50,-18,36
St Mirren,648,10,8,9,19,40,59,-19,33
Hibernian,649,1,19,13,4,53,24,29,70
Dundee Utd,649,2,18,9,9,55,38,17,63
Morton,649,3,17,11,8,50,35,15,62
Falkirk,649,4,16,12,8,60,40,20,60
Raith,649,5,12,9,15,43,50,-7,45
Queen of S't,649,6,10,10,16,44,53,-9,40
St Mirren,649,7,9,10,17,43,59,-16,37
Dunfermline,649,8,8,12,16,40,56,-16,36
Ayr,649,9,8,12,16,36,57,-21,36
Dumbarton,649,10,7,14,15,47,59,-12,35
Hibernian,650,1,19,13,4,59,26,33,70
Morton,650,2,18,13,5,50,32,18,67
Dundee Utd,650,3,17,11,8,52,37,15,62
Falkirk,650,4,15,12,9,53,39,14,57
Raith,650,5,10,12,14,35,47,-12,42
Dunfermline,650,6,9,14,13,48,49,-1,41
Queen of S't,650,7,11,8,17,46,55,-9,41
Dumbarton,650,8,9,12,15,50,61,-11,39
Ayr,650,9,7,12,17,34,58,-24,33
St Mirren,650,10,6,11,19,33,56,-23,29
Hibernian,651,1,19,12,5,56,27,29,69
Falkirk,651,2,17,10,9,58,40,18,61
Morton,651,3,14,14,8,46,35,11,56
Dundee Utd,651,4,15,11,10,50,43,7,56
Dunfermline,651,5,9,16,11,48,47,1,43
Dumbarton,651,6,10,13,13,50,54,-4,43
Queen of S't,651,7,11,10,15,47,54,-7,43
Raith,651,8,10,10,16,36,48,-12,40
Ayr,651,9,8,12,16,34,57,-23,36
St Mirren,651,10,7,12,17,41,61,-20,33
Hibernian,652,1,20,10,6,64,28,36,70
Morton,652,2,16,13,7,53,38,15,61
Dundee Utd,652,3,16,11,9,52,39,13,59
Falkirk,652,4,15,11,10,58,46,12,56
Queen of S't,652,5,12,10,14,44,47,-3,46
Dumbarton,652,6,9,13,14,49,53,-4,40
Raith,652,7,10,10,16,39,56,-17,40
Dunfermline,652,8,8,15,13,44,52,-8,39
Ayr,652,9,9,10,17,34,64,-30,37
St Mirren,652,10,9,9,18,43,57,-14,36
Hibernian,653,1,17,12,7,53,29,24,63
Morton,653,2,17,12,7,54,39,15,63
Dundee Utd,653,3,17,11,8,61,42,19,62
Falkirk,653,4,14,12,10,55,44,11,54
Queen of S't,653,5,12,9,15,42,46,-4,45
Raith,653,6,11,11,14,34,45,-11,44
Dunfermline,653,7,10,12,14,47,48,-1,42
Ayr,653,8,9,12,15,39,61,-22,39
Dumbarton,653,9,8,12,16,46,59,-13,36
St Mirren,653,10,8,11,17,40,58,-18,35
Hibernian,654,1,19,14,3,53,22,31,71
Dundee Utd,654,2,18,10,8,62,41,21,64
Falkirk,654,3,16,10,10,56,38,18,58
Morton,654,4,16,10,10,51,43,8,58
Queen of S't,654,5,11,11,14,46,51,-5,44
Dunfermline,654,6,10,12,14,45,50,-5,42
Dumbarton,654,7,9,10,17,49,65,-16,37
Raith,654,8,9,10,17,35,51,-16,37
St Mirren,654,9,9,10,17,36,53,-17,37
Ayr,654,10,7,15,14,33,52,-19,36
Hibernian,655,1,21,11,4,58,26,32,74
Dundee Utd,655,2,17,10,9,56,40,16,61
Falkirk,655,3,15,10,11,57,49,8,55
Morton,655,4,15,10,11,47,42,5,55
Dumbarton,655,5,11,11,14,52,56,-4,44
Dunfermline,655,6,10,13,13,52,49,3,43
Queen of S't,655,7,11,10,15,48,53,-5,43
Raith,655,8,11,10,15,39,50,-11,43
St Mirren,655,9,8,11,17,42,58,-16,35
Ayr,655,10,7,12,17,33,61,-28,33
Hibernian,656,1,18,13,5,50,25,25,67
Dundee Utd,656,2,17,9,10,58,40,18,60
Falkirk,656,3,16,11,9,62,43,19,59
Morton,656,4,15,13,8,50,41,9,58
Queen of S't,656,5,13,9,14,50,50,0,48
Dunfermline,656,6,10,13,13,49,48,1,43
Raith,656,7,11,9,16,37,47,-10,42
St Mirren,656,8,9,10,17,39,57,-18,37
Dumbarton,656,9,8,12,16,51,69,-18,36
Ayr,656,10,8,11,17,30,56,-26,35
Hibernian,657,1,18,15,3,50,20,30,69
Dundee Utd,657,2,18,9,9,53,35,18,63
Morton,657,3,15,11,10,46,41,5,56
Falkirk,657,4,13,13,10,52,41,11,52
Dunfermline,657,5,13,13,10,47,41,6,52
Queen of S't,657,6,10,13,13,41,44,-3,43
Dumbarton,657,7,9,12,15,46,58,-12,39
Raith,657,8,9,11,16,32,45,-13,38
Ayr,657,9,8,12,16,31,51,-20,36
St Mirren,657,10,7,11,18,37,59,-22,32
Hibernian,658,1,17,13,6,49,28,21,64
Morton,658,2,17,12,7,50,36,14,63
Falkirk,658,3,16,12,8,62,40,22,60
Dundee Utd,658,4,16,12,8,55,43,12,60
Queen of S't,658,5,13,8,15,44,46,-2,47
Raith,658,6,12,8,16,37,47,-10,44
Dunfermline,658,7,9,14,13,46,47,-1,41
Dumbarton,658,8,8,12,16,45,59,-14,36
Ayr,658,9,8,11,17,36,57,-21,35
St Mirren,658,10,7,12,17,40,61,-21,33
Hibernian,659,1,21,12,3,63,24,39,75
Falkirk,659,2,16,11,9,60,40,20,59
Morton,659,3,16,11,9,50,36,14,59
Dundee Utd,659,4,15,10,11,51,43,8,55
Queen of S't,659,5,12,9,15,46,54,-8,45
Raith,659,6,11,10,15,36,50,-14,43
Dunfermline,659,7,8,15,13,42,49,-7,39
St Mirren,659,8,9,11,16,45,58,-13,38
Dumbarton,659,9,9,10,17,50,60,-10,37
Ayr,659,10,8,11,17,30,59,-29,35
Hibernian,660,1,20,12,4,58,28,30,72
Falkirk,660,2,18,9,9,63,45,18,63
Morton,660,3,15,12,9,49,40,9,57
Dundee Utd,660,4,16,9,11,50,42,8,57
Queen of S't,660,5,12,8,16,47,54,-7,44
Dunfermline,660,6,9,14,13,43,47,-4,41
Dumbarton,660,7,10,11,15,55,60,-5,41
St Mirren,660,8,10,9,17,41,52,-11,39
Ayr,660,9,9,11,16,36,58,-22,38
Raith,660,10,9,9,18,34,50,-16,36
Morton,661,1,19,11,6,52,35,17,68
Hibernian,661,2,16,13,7,53,32,21,61
Falkirk,661,3,15,12,9,58,39,19,57
Dundee Utd,661,4,13,12,11,44,39,5,51
Raith,661,5,12,9,15,40,47,-7,45
Queen of S't,661,6,11,10,15,45,56,-11,43
Ayr,661,7,10,13,13,35,48,-13,43
Dunfermline,661,8,9,15,12,45,46,-1,42
Dumbarton,661,9,9,12,15,49,60,-11,39
St Mirren,661,10,7,11,18,36,55,-19,32
Hibernian,662,1,19,10,7,55,33,22,67
Morton,662,2,18,13,5,53,33,20,67
Falkirk,662,3,16,10,10,56,41,15,58
Dundee Utd,662,4,14,11,11,47,39,8,53
Dunfermline,662,5,10,13,13,47,49,-2,43
Queen of S't,662,6,11,10,15,46,51,-5,43
Raith,662,7,10,10,16,37,48,-11,40
Ayr,662,8,9,12,15,36,56,-20,39
St Mirren,662,9,8,13,15,39,53,-14,37
Dumbarton,662,10,8,12,16,46,59,-13,36
Hibernian,663,1,19,12,5,54,28,26,69
Morton,663,2,17,11,8,53,41,12,62
Falkirk,663,3,16,10,10,56,36,20,58
Dundee Utd,663,4,16,10,10,57,40,17,58
Queen of S't,663,5,14,9,13,46,45,1,51
Dunfermline,663,6,11,14,11,52,47,5,47
Raith,663,7,10,9,17,36,52,-16,39
Dumbarton,663,8,9,11,16,45,58,-13,38
St Mirren,663,9,8,9,19,39,60,-21,33
Ayr,663,10,7,11,18,33,64,-31,32
Hibernian,664,1,19,14,3,57,23,34,71
Morton,664,2,16,13,7,57,39,18,61
Dundee Utd,664,3,17,10,9,51,39,12,61
Falkirk,664,4,16,11,9,58,37,21,59
Dumbarton,664,5,11,11,14,50,56,-6,44
Dunfermline,664,6,9,13,14,46,53,-7,40
Queen of S't,664,7,9,13,14,41,49,-8,40
Raith,664,8,9,11,16,35,52,-17,38
Ayr,664,9,7,15,14,32,51,-19,36
St Mirren,664,10,7,9,20,38,66,-28,30
Hibernian,665,1,21,10,5,61,30,31,73
Falkirk,665,2,17,10,9,57,38,19,61
Morton,665,3,16,13,7,47,36,11,61
Dundee Utd,665,4,16,9,11,47,37,10,57
Queen of S't,665,5,14,9,13,48,45,3,51
Raith,665,6,11,9,16,40,49,-9,42
Ayr,665,7,9,12,15,36,56,-20,39
Dumbarton,665,8,7,15,14,40,51,-11,36
Dunfermline,665,9,7,13,16,39,50,-11,34
St Mirren,665,10,7,10,19,39,62,-23,31
Hibernian,666,1,20,10,6,55,27,28,70
Morton,666,2,18,10,8,48,35,13,64
Falkirk,666,3,16,11,9,58,41,17,59
Dundee Utd,666,4,16,9,11,49,39,10,57
Raith,666,5,12,9,15,40,47,-7,45
Queen of S't,666,6,11,10,15,43,49,-6,43
Dunfermline,666,7,9,13,14,43,50,-7,40
St Mirren,666,8,10,10,16,43,57,-14,40
Dumbarton,666,9,8,11,17,48,61,-13,35
Ayr,666,10,7,13,16,36,57,-21,34
Morton,667,1,19,10,7,50,33,17,67
Hibernian,667,2,18,11,7,57,27,30,65
Falkirk,667,3,16,12,8,58,38,20,60
Dundee Utd,667,4,15,11,10,49,37,12,56
Queen of S't,667,5,14,9,13,48,48,0,51
Dunfermline,667,6,10,13,13,45,47,-2,43
Raith,667,7,11,9,16,36,50,-14,42
Dumbarton,667,8,9,10,17,46,60,-14,37
St Mirren,667,9,7,12,17,36,56,-20,33
Ayr,667,10,7,11,18,32,61,-29,32
Hibernian,668,1,19,11,6,53,28,25,68
Falkirk,668,2,17,10,9,59,39,20,61
Morton,668,3,16,11,9,50,37,13,59
Dundee Utd,668,4,15,10,11,52,41,11,55
Queen of S't,668,5,12,11,13,46,49,-3,47
Raith,668,6,12,9,15,38,48,-10,45
Ayr,668,7,10,12,14,36,53,-17,42
Dunfermline,668,8,9,14,13,45,49,-4,41
Dumbarton,668,9,8,11,17,44,60,-16,35
St Mirren,668,10,8,9,19,41,60,-19,33
Hibernian,669,1,18,12,6,53,29,24,66
Morton,669,2,18,9,9,52,37,15,63
Falkirk,669,3,17,11,8,61,40,21,62
Dundee Utd,669,4,16,10,10,55,42,13,58
Queen of S't,669,5,12,10,14,46,49,-3,46
Dunfermline,669,6,9,13,14,45,48,-3,40
Dumbarton,669,7,9,12,15,48,59,-11,39
Raith,669,8,9,12,15,36,50,-14,39
St Mirren,669,9,8,12,16,41,56,-15,36
Ayr,669,10,7,13,16,32,59,-27,34
Hibernian,670,1,19,13,4,54,23,31,70
Morton,670,2,18,11,7,50,37,13,65
Falkirk,670,3,16,11,9,61,43,18,59
Dundee Utd,670,4,15,12,9,53,42,11,57
Queen of S't,670,5,12,10,14,49,52,-3,46
St Mirren,670,6,10,11,15,39,50,-11,41
Raith,670,7,11,8,17,37,51,-14,41
Dunfermline,670,8,8,13,15,44,49,-5,37
Ayr,670,9,7,13,16,31,54,-23,34
Dumbarton,670,10,7,12,17,44,61,-17,33
Hibernian,671,1,17,12,7,51,28,23,63
Morton,671,2,18,9,9,53,38,15,63
Falkirk,671,3,17,11,8,57,37,20,62
Dundee Utd,671,4,15,9,12,51,44,7,54
Queen of S't,671,5,12,11,13,45,47,-2,47
Dunfermline,671,6,11,12,13,45,45,0,45
Dumbarton,671,7,10,11,15,51,60,-9,41
Ayr,671,8,10,11,15,39,54,-15,41
St Mirren,671,9,9,10,17,42,59,-17,37
Raith,671,10,8,10,18,31,53,-22,34
Hibernian,672,1,18,13,5,54,28,26,67
Morton,672,2,16,13,7,53,37,16,61
Falkirk,672,3,16,12,8,57,39,18,60
Dundee Utd,672,4,13,12,11,47,41,6,51
Dunfermline,672,5,10,13,13,49,53,-4,43
Queen of S't,672,6,11,10,15,41,50,-9,43
Ayr,672,7,9,14,13,33,47,-14,41
Dumbarton,672,8,9,13,14,47,54,-7,40
Raith,672,9,10,10,16,37,48,-11,40
St Mirren,672,10,7,12,17,36,57,-21,33
Hibernian,673,1,21,11,4,60,24,36,74
Morton,673,2,17,11,8,49,35,14,62
Falkirk,673,3,16,10,10,53,41,12,58
Dundee Utd,673,4,16,9,11,49,38,11,57
Queen of S't,673,5,11,9,16,47,56,-9,42
Dunfermline,673,6,9,13,14,50,53,-3,40
Dumbarton,673,7,9,13,14,49,57,-8,40
Raith,673,8,10,10,16,35,48,-13,40
St Mirren,673,9,10,9,17,40,56,-16,39
Ayr,673,10,7,13,16,33,57,-24,34
Hibernian,674,1,19,12,5,56,26,30,69
Morton,674,2,15,14,7,54,39,15,59
Falkirk,674,3,15,11,10,57,41,16,56
Dundee Utd,674,4,14,9,13,46,42,4,51
Dunfermline,674,5,12,11,13,53,50,3,47
Queen of S't,674,6,12,10,14,43,49,-6,46
Raith,674,7,11,10,15,36,45,-9,43
Ayr,674,8,10,11,15,39,58,-19,41
Dumbarton,674,9,8,14,14,50,66,-16,38
St Mirren,674,10,8,10,18,40,58,-18,34
Morton,675,1,19,11,6,53,33,20,68
Hibernian,675,2,17,13,6,50,30,20,64
Falkirk,675,3,16,11,9,59,40,19,59
Dundee Utd,675,4,15,9,12,52,42,10,54
Queen of S't,675,5,12,10,14,46,50,-4,46
Dunfermline,675,6,11,12,13,47,45,2,45
St Mirren,675,7,10,10,16,46,57,-11,40
Dumbarton,675,8,7,15,14,46,59,-13,36
Raith,675,9,8,11,17,34,52,-18,35
Ayr,675,10,7,14,15,36,61,-25,35
Hibernian,676,1,18,12,6,53,26,27,66
Falkirk,676,2,18,10,8,65,39,26,64
Dundee Utd,676,3,17,10,9,52,37,15,61
Morton,676,4,16,12,8,49,35,14,60
Queen of S't,676,5,11,9,16,44,59,-15,42
Raith,676,6,11,9,16,42,57,-15,42
Dunfermline,676,7,8,14,14,41,48,-7,38
Dumbarton,676,8,9,11,16,46,59,-13,38
Ayr,676,9,9,11,16,39,57,-18,38
St Mirren,676,10,7,14,15,43,57,-14,35
Hibernian,677,1,22,11,3,61,22,39,77
Morton,677,2,15,13,8,50,39,11,58
Dundee Utd,677,3,15,11,10,48,40,8,56
Falkirk,677,4,13,13,10,53,42,11,52
Queen of S't,677,5,12,11,13,47,45,2,47
Dunfermline,677,6,9,13,14,42,50,-8,40
St Mirren,677,7,9,12,15,39,51,-12,39
Dumbarton,677,8,8,13,15,52,61,-9,37
Ayr,677,9,8,13,15,33,54,-21,37
Raith,677,10,9,10,17,32,53,-21,37
Hibernian,678,1,18,13,5,55,27,28,67
Falkirk,678,2,17,10,9,62,39,23,61
Dundee Utd,678,3,17,8,11,52,43,9,59
Morton,678,4,15,10,11,49,42,7,55
Dunfermline,678,5,12,11,13,51,54,-3,47
Queen of S't,678,6,11,11,14,43,49,-6,44
Dumbarton,678,7,10,12,14,50,56,-6,42
Ayr,678,8,8,14,14,41,57,-16,38
Raith,678,9,9,10,17,37,54,-17,37
St Mirren,678,10,8,11,17,40,59,-19,35
Hibernian,679,1,18,14,4,57,26,31,68
Morton,679,2,16,11,9,48,39,9,59
Falkirk,679,3,16,10,10,58,42,16,58
Dundee Utd,679,4,15,10,11,47,38,9,55
Dumbarton,679,5,12,11,13,52,56,-4,47
Queen of S't,679,6,11,11,14,43,47,-4,44
Ayr,679,7,10,11,15,37,51,-14,41
Dunfermline,679,8,9,13,14,42,48,-6,40
Raith,679,9,9,10,17,33,53,-20,37
St Mirren,679,10,7,13,16,41,58,-17,34
Hibernian,680,1,21,11,4,57,26,31,74
Morton,680,2,17,12,7,51,35,16,63
Dundee Utd,680,3,17,11,8,55,35,20,62
Falkirk,680,4,16,9,11,58,45,13,57
Dunfermline,680,5,11,14,11,47,44,3,47
Queen of S't,680,6,10,10,16,45,56,-11,40
Raith,680,7,10,10,16,39,52,-13,40
Dumbarton,680,8,8,13,15,43,55,-12,37
St Mirren,680,9,8,10,18,42,58,-16,34
Ayr,680,10,6,12,18,29,60,-31,30
Hibernian,681,1,21,10,5,59,26,33,73
Morton,681,2,16,13,7,46,35,11,61
Dundee Utd,681,3,16,11,9,53,38,15,59
Falkirk,681,4,15,11,10,54,38,16,56
Dunfermline,681,5,11,13,12,44,44,0,46
Dumbarton,681,6,10,11,15,45,55,-10,41
Queen of S't,681,7,10,10,16,44,52,-8,40
Ayr,681,8,9,13,14,34,52,-18,40
Raith,681,9,8,10,18,32,53,-21,34
St Mirren,681,10,7,12,17,37,55,-18,33
Hibernian,682,1,19,11,6,54,26,28,68
Morton,682,2,17,12,7,47,33,14,63
Falkirk,682,3,16,10,10,61,44,17,58
Dundee Utd,682,4,14,10,12,45,40,5,52
Raith,682,5,12,9,15,37,50,-13,45
Dumbarton,682,6,11,11,14,49,52,-3,44
Dunfermline,682,7,10,12,14,45,47,-2,42
Queen of S't,682,8,10,9,17,41,55,-14,39
Ayr,682,9,8,14,14,36,54,-18,38
St Mirren,682,10,9,10,17,41,55,-14,37
Hibernian,683,1,20,12,4,55,25,30,72
Dundee Utd,683,2,18,9,9,55,39,16,63
Morton,683,3,16,11,9,50,36,14,59
Falkirk,683,4,15,11,10,54,41,13,56
Queen of S't,683,5,13,8,15,48,48,0,47
Dunfermline,683,6,9,14,13,44,48,-4,41
Dumbarton,683,7,10,11,15,47,56,-9,41
Raith,683,8,9,10,17,32,49,-17,37
St Mirren,683,9,7,14,15,40,55,-15,35
Ayr,683,10,7,12,17,33,61,-28,33
Hibernian,684,1,18,15,3,49,20,29,69
Morton,684,2,17,11,8,51,38,13,62
Dundee Utd,684,3,17,8,11,56,45,11,59
Falkirk,684,4,15,13,8,63,42,21,58
Queen of S't,684,5,13,11,12,48,45,3,50
Dunfermline,684,6,9,15,12,44,46,-2,42
Dumbarton,684,7,8,14,14,44,56,-12,38
St Mirren,684,8,8,13,15,40,54,-14,37
Raith,684,9,8,9,19,33,54,-21,33
Ayr,684,10,6,13,17,29,57,-28,31
Hibernian,685,1,18,12,6,54,30,24,66
Falkirk,685,2,16,11,9,58,40,18,59
Dundee Utd,685,3,16,10,10,53,40,13,58
Morton,685,4,14,13,9,49,41,8,55
Dunfermline,685,5,12,13,11,51,45,6,49
Raith,685,6,12,8,16,34,45,-11,44
Queen of S't,685,7,11,8,17,47,55,-8,41
Dumbarton,685,8,10,10,16,48,62,-14,40
Ayr,685,9,10,10,16,36,55,-19,40
St Mirren,685,10,8,11,17,38,55,-17,35
Hibernian,686,1,19,12,5,53,23,30,69
Morton,686,2,17,11,8,50,33,17,62
Falkirk,686,3,15,11,10,53,39,14,56
Dundee Utd,686,4,15,11,10,48,36,12,56
Queen of S't,686,5,12,9,15,44,49,-5,45
Dumbarton,686,6,11,10,15,51,58,-7,43
Raith,686,7,10,12,14,36,44,-8,42
Dunfermline,686,8,9,13,14,40,52,-12,40
Ayr,686,9,9,13,14,32,51,-19,40
St Mirren,686,10,7,10,19,37,59,-22,31
Hibernian,687,1,21,10,5,59,26,33,73
Dundee Utd,687,2,17,10,9,51,37,14,61
Falkirk,687,3,16,12,8,59,37,22,60
Morton,687,4,15,9,12,43,40,3,54
Dunfermline,687,5,10,12,14,47,49,-2,42
Queen of S't,687,6,11,9,16,42,51,-9,42
Dumbarton,687,7,10,11,15,50,61,-11,41
Raith,687,8,11,8,17,33,49,-16,41
Ayr,687,9,9,11,16,32,52,-20,38
St Mirren,687,10,8,12,16,43,57,-14,36
Hibernian,688,1,20,11,5,53,24,29,71
Falkirk,688,2,17,10,9,64,41,23,61
Dundee Utd,688,3,17,9,10,49,39,10,60
Morton,688,4,16,10,10,55,38,17,58
Queen of S't,688,5,13,10,13,50,48,2,49
Dunfermline,688,6,10,13,13,51,51,0,43
St Mirren,688,7,10,10,16,42,53,-11,40
Raith,688,8,10,9,17,31,53,-22,39
Dumbarton,688,9,8,12,16,48,61,-13,36
Ayr,688,10,7,10,19,29,64,-35,31
Hibernian,689,1,19,12,5,54,27,27,69
Morton,689,2,16,11,9,49,37,12,59
Falkirk,689,3,14,11,11,58,44,14,53
Dundee Utd,689,4,14,9,13,46,44,2,51
Queen of S't,689,5,13,10,13,47,46,1,49
Dunfermline,689,6,11,12,13,46,47,-1,45
St Mirren,689,7,10,12,14,43,53,-10,42
Raith,689,8,11,9,16,38,50,-12,42
Dumbarton,689,9,9,12,15,46,58,-12,39
Ayr,689,10,9,10,17,35,56,-21,37
Hibernian,690,1,18,14,4,55,26,29,68
Falkirk,690,2,17,11,8,64,37,27,62
Dundee Utd,690,3,16,10,10,53,39,14,58
Morton,690,4,15,12,9,46,37,9,57
Queen of S't,690,5,11,12,13,43,49,-6,45
Raith,690,6,11,11,14,39,47,-8,44
Dunfermline,690,7,9,14,13,46,51,-5,41
Dumbarton,690,8,8,12,16,46,59,-13,36
Ayr,690,9,7,14,15,33,60,-27,35
St Mirren,690,10,8,10,18,37,57,-20,34
Hibernian,691,1,20,12,4,59,28,31,72
Morton,691,2,16,13,7,52,36,16,61
Dundee Utd,691,3,17,10,9,54,42,12,61
Falkirk,691,4,16,11,9,60,38,22,59
Queen of S't,691,5,11,9,16,45,57,-12,42
Dumbarton,691,6,9,13,14,52,60,-8,40
Raith,691,7,10,10,16,35,52,-17,40
St Mirren,691,8,9,11,16,44,56,-12,38
Ayr,691,9,8,12,16,37,57,-20,36
Dunfermline,691,10,8,11,17,41,53,-12,35
Hibernian,692,1,20,13,3,58,25,33,73
Morton,692,2,16,12,8,50,39,11,60
Falkirk,692,3,15,12,9,58,43,15,57
Dundee Utd,692,4,15,9,12,48,43,5,54
Dumbarton,692,5,12,12,12,52,54,-2,48
Queen of S't,692,6,10,11,15,43,52,-9,41
Dunfermline,692,7,9,13,14,47,53,-6,40
Raith,692,8,10,10,16,34,47,-13,40
St Mirren,692,9,8,11,17,40,55,-15,35
Ayr,692,10,7,13,16,37,56,-19,34
Hibernian,693,1,20,12,4,57,26,31,72
Morton,693,2,19,10,7,52,33,19,67
Falkirk,693,3,18,11,7,62,37,25,65
Dundee Utd,693,4,16,9,11,52,45,7,57
Queen of S't,693,5,11,9,16,43,52,-9,42
Dunfermline,693,6,9,12,15,48,54,-6,39
Dumbarton,693,7,9,12,15,49,57,-8,39
Ayr,693,8,9,10,17,33,55,-22,37
Raith,693,9,8,11,17,35,53,-18,35
St Mirren,693,10,8,10,18,39,58,-19,34
Hibernian,694,1,18,13,5,53,28,25,67
Morton,694,2,17,11,8,53,40,13,62
Falkirk,694,3,14,14,8,60,41,19,56
Dundee Utd,694,4,14,10,12,50,47,3,52
Dunfermline,694,5,10,13,13,49,49,0,43
Queen of S't,694,6,11,10,15,44,51,-7,43
Dumbarton,694,7,9,14,13,52,59,-7,41
St Mirren,694,8,10,11,15,43,52,-9,41
Raith,694,9,10,9,17,35,51,-16,39
Ayr,694,10,8,13,15,33,54,-21,37
Hibernian,695,1,19,13,4,51,23,28,70
Falkirk,695,2,16,11,9,62,44,18,59
Morton,695,3,15,11,10,44,35,9,56
Dundee Utd,695,4,13,12,11,47,44,3,51
Raith,695,5,12,11,13,37,45,-8,47
Queen of S't,695,6,11,8,17,44,50,-6,41
Dunfermline,695,7,8,16,12,47,50,-3,40
Dumbarton,695,8,9,13,14,50,61,-11,40
Ayr,695,9,9,12,15,36,54,-18,39
St Mirren,695,10,8,13,15,41,53,-12,37
Hibernian,696,1,22,11,3,58,22,36,77
Morton,696,2,16,13,7,49,35,14,61
Dundee Utd,696,3,15,13,8,50,37,13,58
Falkirk,696,4,14,11,11,50,41,9,53
Queen of S't,696,5,11,10,15,42,49,-7,43
Dumbarton,696,6,10,12,14,49,55,-6,42
Dunfermline,696,7,9,13,14,46,50,-4,40
St Mirren,696,8,9,11,16,42,55,-13,38
Raith,696,9,9,11,16,34,50,-16,38
Ayr,696,10,7,11,18,30,56,-26,32
Hibernian,697,1,19,12,5,54,25,29,69
Falkirk,697,2,18,11,7,61,36,25,65
Morton,697,3,17,10,9,53,40,13,61
Dundee Utd,697,4,13,11,12,46,45,1,50
Dunfermline,697,5,10,14,12,46,46,0,44
St Mirren,697,6,10,11,15,44,54,-10,41
Ayr,697,7,10,11,15,36,54,-18,41
Queen of S't,697,8,10,10,16,42,50,-8,40
Dumbarton,697,9,9,11,16,51,58,-7,38
Raith,697,10,9,9,18,33,58,-25,36
Hibernian,698,1,19,11,6,51,23,28,68
Falkirk,698,2,17,11,8,60,38,22,62
Morton,698,3,16,12,8,49,34,15,60
Dundee Utd,698,4,15,9,12,48,40,8,54
Queen of S't,698,5,13,9,14,43,47,-4,48
Dunfermline,698,6,11,13,12,47,47,0,46
Dumbarton,698,7,9,12,15,44,55,-11,39
Raith,698,8,9,12,15,36,52,-16,39
St Mirren,698,9,8,10,18,39,58,-19,34
Ayr,698,10,7,13,16,32,55,-23,34
Hibernian,699,1,21,11,4,60,25,35,74
Morton,699,2,18,10,8,52,37,15,64
Falkirk,699,3,17,10,9,59,42,17,61
Dundee Utd,699,4,15,8,13,49,43,6,53
Queen of S't,699,5,13,9,14,46,47,-1,48
Dumbarton,699,6,10,13,13,52,56,-4,43
Dunfermline,699,7,9,12,15,44,51,-7,39
St Mirren,699,8,9,10,17,38,55,-17,37
Raith,699,9,9,9,18,30,53,-23,36
Ayr,699,10,7,12,17,31,52,-21,33
Hibernian,700,1,18,14,4,57,27,30,68
Falkirk,700,2,17,9,10,58,41,17,60
Morton,700,3,16,10,10,46,39,7,58
Queen of S't,700,4,14,10,12,49,46,3,52
Dundee Utd,700,5,14,9,13,48,41,7,51
Dunfermline,700,6,10,13,13,46,47,-1,43
Dumbarton,700,7,10,11,15,47,59,-12,41
Ayr,700,8,10,10,16,32,55,-23,40
Raith,700,9,9,11,16,36,51,-15,38
St Mirren,700,10,8,11,17,40,53,-13,35
Hibernian,701,1,17,15,4,55,27,28,66
Morton,701,2,16,14,6,46,33,13,62
Falkirk,701,3,16,11,9,60,43,17,59
Dundee Utd,701,4,15,11,10,53,42,11,56
Queen of S't,701,5,12,11,13,48,48,0,47
Raith,701,6,10,10,16,37,53,-16,40
Dumbarton,701,7,9,12,15,45,58,-13,39
St Mirren,701,8,9,11,16,45,57,-12,38
Ayr,701,9,8,13,15,33,52,-19,37
Dunfermline,701,10,7,14,15,41,50,-9,35
Hibernian,702,1,22,11,3,63,20,43,77
Falkirk,702,2,16,11,9,55,42,13,59
Morton,702,3,15,12,9,48,37,11,57
Dundee Utd,702,4,15,10,11,51,40,11,55
Queen of S't,702,5,12,8,16,42,51,-9,44
Dumbarton,702,6,11,10,15,49,56,-7,43
Dunfermline,702,7,8,15,13,45,50,-5,39
Raith,702,8,10,9,17,33,49,-16,39
St Mirren,702,9,9,10,17,37,54,-17,37
Ayr,702,10,9,10,17,32,56,-24,37
Hibernian,703,1,20,10,6,55,27,28,70
Morton,703,2,16,10,10,50,39,11,58
Dundee Utd,703,3,16,10,10,48,41,7,58
Falkirk,703,4,16,9,11,57,38,19,57
Queen of S't,703,5,13,11,12,49,50,-1,50
Dunfermline,703,6,9,14,13,45,49,-4,41
Raith,703,7,10,11,15,39,52,-13,41
Dumbarton,703,8,10,10,16,45,55,-10,40
Ayr,703,9,9,10,17,36,52,-16,37
St Mirren,703,10,9,9,18,39,60,-21,36
Hibernian,704,1,18,14,4,54,26,28,68
Morton,704,2,17,12,7,54,39,15,63
Dundee Utd,704,3,16,10,10,54,40,14,58
Falkirk,704,4,14,12,10,57,45,12,54
Queen of S't,704,5,11,10,15,48,55,-7,43
Dumbarton,704,6,10,12,14,52,57,-5,42
Dunfermline,704,7,9,13,14,46,53,-7,40
Raith,704,8,10,10,16,36,50,-14,40
St Mirren,704,9,8,13,15,41,56,-15,37
Ayr,704,10,7,14,15,31,52,-21,35
Hibernian,705,1,18,12,6,52,28,24,66
Falkirk,705,2,17,9,10,65,42,23,60
Morton,705,3,15,12,9,47,39,8,57
Dundee Utd,705,4,15,11,10,55,45,10,56
Dunfermline,705,5,13,11,12,52,45,7,50
Raith,705,6,10,11,15,35,50,-15,41
Queen of S't,705,7,10,10,16,43,54,-11,40
Dumbarton,705,8,9,12,15,51,62,-11,39
St Mirren,705,9,8,13,15,42,56,-14,37
Ayr,705,10,7,15,14,33,54,-21,36
Hibernian,706,1,20,12,4,60,27,33,72
Dundee Utd,706,2,18,10,8,53,35,18,64
Morton,706,3,16,12,8,47,35,12,60
Falkirk,706,4,16,9,11,57,45,12,57
Queen of S't,706,5,13,9,14,52,51,1,48
Dunfermline,706,6,10,12,14,45,47,-2,42
Raith,706,7,11,9,16,36,50,-14,42
St Mirren,706,8,9,10,17,41,53,-12,37
Ayr,706,9,7,12,17,35,60,-25,33
Dumbarton,706,10,7,11,18,42,65,-23,32
Hibernian,707,1,17,13,6,53,25,28,64
Morton,707,2,17,12,7,50,35,15,63
Dundee Utd,707,3,16,9,11,47,37,10,57
Falkirk,707,4,14,12,10,55,40,15,54
Queen of S't,707,5,12,9,15,45,53,-8,45
Dunfermline,707,6,10,14,12,45,47,-2,44
Raith,707,7,11,10,15,35,45,-10,43
Ayr,707,8,11,10,15,34,53,-19,43
Dumbarton,707,9,9,10,17,47,59,-12,37
St Mirren,707,10,9,9,18,44,61,-17,36
Hibernian,708,1,19,10,7,54,29,25,67
Dundee Utd,708,2,17,9,10,50,39,11,60
Falkirk,708,3,15,11,10,55,39,16,56
Morton,708,4,15,10,11,50,45,5,55
Queen of S't,708,5,13,10,13,42,45,-3,49
St Mirren,708,6,10,12,14,45,52,-7,42
Dunfermline,708,7,9,14,13,48,50,-2,41
Dumbarton,708,8,9,12,15,49,60,-11,39
Raith,708,9,9,11,16,33,48,-15,38
Ayr,708,10,8,13,15,35,54,-19,37
Hibernian,709,1,18,13,5,52,25,27,67
Falkirk,709,2,18,9,9,60,38,22,63
Morton,709,3,15,13,8,48,37,11,58
Dundee Utd,709,4,16,9,11,54,43,11,57
Dunfermline,709,5,10,12,14,44,48,-4,42
St Mirren,709,6,10,11,15,42,52,-10,41
Dumbarton,709,7,10,11,15,47,58,-11,41
Queen of S't,709,8,9,12,15,39,48,-9,39
Raith,709,9,9,12,15,35,49,-14,39
Ayr,709,10,8,12,16,37,60,-23,36
Hibernian,710,1,19,11,6,51,27,24,68
Falkirk,710,2,18,11,7,59,34,25,65
Morton,710,3,17,11,8,58,43,15,62
Dundee Utd,710,4,15,10,11,53,43,10,55
Dunfermline,710,5,11,12,13,48,49,-1,45
Queen of S't,710,6,12,8,16,42,47,-5,44
Dumbarton,710,7,10,11,15,50,59,-9,41
Raith,710,8,10,9,17,35,52,-17,39
St Mirren,710,9,9,10,17,36,51,-15,37
Ayr,710,10,7,11,18,32,59,-27,32
Dundee Utd,711,1,19,9,8,54,35,19,66
Hibernian,711,2,17,13,6,51,27,24,64
Falkirk,711,3,17,10,9,61,41,20,61
Morton,711,4,15,10,11,47,41,6,55
Raith,711,5,11,12,13,38,46,-8,45
Dunfermline,711,6,9,14,13,48,49,-1,41
Queen of S't,711,7,10,10,16,41,51,-10,40
Dumbarton,711,8,9,11,16,48,60,-12,38
St Mirren,711,9,9,11,16,43,55,-12,38
Ayr,711,10,9,10,17,32,58,-26,37
Hibernian,712,1,20,12,4,58,24,34,72
Morton,712,2,18,12,6,55,33,22,66
Falkirk,712,3,17,11,8,61,37,24,62
Dundee Utd,712,4,16,9,11,48,40,8,57
Dunfermline,712,5,11,11,14,45,52,-7,44
Queen of S't,712,6,11,10,15,43,55,-12,43
Ayr,712,7,9,11,16,36,54,-18,38
Dumbarton,712,8,8,11,17,45,59,-14,35
St Mirren,712,9,8,11,17,40,56,-16,35
Raith,712,10,8,10,18,33,54,-21,34
Hibernian,713,1,21,12,3,57,23,34,75
Dundee Utd,713,2,17,10,9,54,40,14,61
Morton,713,3,15,12,9,49,40,9,57
Falkirk,713,4,14,11,11,56,43,13,53
Dunfermline,713,5,10,13,13,46,51,-5,43
Raith,713,6,11,9,16,37,51,-14,42
St Mirren,713,7,10,11,15,41,51,-10,41
Ayr,713,8,9,12,15,39,53,-14,39
Dumbarton,713,9,9,11,16,46,60,-14,38
Queen of S't,713,10,9,9,18,39,52,-13,36
Morton,714,1,19,11,6,57,35,22,68
Hibernian,714,2,18,12,6,52,27,25,66
Dundee Utd,714,3,17,8,11,52,44,8,59
Falkirk,714,4,15,10,11,52,37,15,55
Raith,714,5,11,12,13,37,44,-7,45
Queen of S't,714,6,12,8,16,43,50,-7,44
Dumbarton,714,7,10,12,14,49,54,-5,42
Dunfermline,714,8,9,12,15,41,52,-11,39
St Mirren,714,9,9,10,17,39,54,-15,37
Ayr,714,10,7,11,18,30,55,-25,32
Hibernian,715,1,17,16,3,55,25,30,67
Falkirk,715,2,19,10,7,57,33,24,67
Morton,715,3,16,12,8,52,40,12,60
Dundee Utd,715,4,14,10,12,51,49,2,52
Dunfermline,715,5,11,13,12,47,47,0,46
Queen of S't,715,6,11,9,16,44,57,-13,42
Dumbarton,715,7,10,11,15,54,64,-10,41
Raith,715,8,9,10,17,36,47,-11,37
St Mirren,715,9,8,12,16,40,54,-14,36
Ayr,715,10,7,13,16,36,56,-20,34
Hibernian,716,1,22,11,3,57,22,35,77
Dundee Utd,716,2,17,11,8,52,38,14,62
Morton,716,3,17,10,9,49,38,11,61
Falkirk,716,4,15,11,10,60,43,17,56
Queen of S't,716,5,10,11,15,41,50,-9,41
Raith,716,6,10,10,16,39,50,-11,40
Dunfermline,716,7,9,12,15,46,54,-8,39
Ayr,716,8,9,12,15,37,54,-17,39
St Mirren,716,9,9,9,18,39,55,-16,36
Dumbarton,716,10,7,13,16,45,61,-16,34
Hibernian,717,1,18,14,4,61,28,33,68
Morton,717,2,16,12,8,47,39,8,60
Dundee Utd,717,3,16,11,9,51,38,13,59
Falkirk,717,4,15,12,9,58,41,17,57
Queen of S't,717,5,11,11,14,46,51,-5,44
Dunfermline,717,6,10,13,13,44,48,-4,43
Raith,717,7,11,9,16,37,49,-12,42
Ayr,717,8,10,11,15,34,51,-17,41
Dumbarton,717,9,9,12,15,49,61,-12,39
St Mirren,717,10,7,9,20,38,59,-21,30
Hibernian,718,1,21,12,3,59,22,37,75
Dundee Utd,718,2,17,8,11,55,42,13,59
Falkirk,718,3,14,13,9,55,40,15,55
Morton,718,4,14,11,11,47,41,6,53
Queen of S't,718,5,14,9,13,51,50,1,51
Dunfermline,718,6,12,12,12,52,50,2,48
Raith,718,7,9,11,16,33,51,-18,38
St Mirren,718,8,9,10,17,39,57,-18,37
Dumbarton,718,9,8,11,17,42,56,-14,35
Ayr,718,10,7,13,16,34,58,-24,34
Hibernian,719,1,21,11,4,64,24,40,74
Falkirk,719,2,17,9,10,60,43,17,60
Morton,719,3,16,10,10,45,38,7,58
Dundee Utd,719,4,15,12,9,52,41,11,57
Dunfermline,719,5,12,14,10,48,42,6,50
Queen of S't,719,6,9,12,15,42,54,-12,39
Raith,719,7,9,12,15,35,50,-15,39
Ayr,719,8,8,13,15,34,53,-19,37
Dumbarton,719,9,8,12,16,49,64,-15,36
St Mirren,719,10,8,9,19,37,57,-20,33
Hibernian,720,1,21,10,5,60,26,34,73
Dundee Utd,720,2,18,10,8,56,35,21,64
Morton,720,3,17,10,9,51,41,10,61
Falkirk,720,4,14,13,9,56,44,12,55
Dumbarton,720,5,12,10,14,54,56,-2,46
Queen of S't,720,6,12,10,14,47,50,-3,46
Raith,720,7,11,11,14,37,43,-6,44
St Mirren,720,8,8,12,16,38,52,-14,36
Dunfermline,720,9,7,11,18,39,55,-16,32
Ayr,720,10,6,11,19,29,65,-36,29
Hibernian,721,1,20,11,5,61,24,37,71
Falkirk,721,2,17,9,10,59,44,15,60
Dundee Utd,721,3,16,10,10,50,38,12,58
Morton,721,4,15,13,8,43,36,7,58
Queen of S't,721,5,12,10,14,46,49,-3,46
Dunfermline,721,6,10,14,12,48,47,1,44
Ayr,721,7,10,11,15,40,56,-16,41
Dumbarton,721,8,9,11,16,45,56,-11,38
Raith,721,9,9,9,18,35,59,-24,36
St Mirren,721,10,8,10,18,41,59,-18,34
Hibernian,722,1,19,11,6,55,31,24,68
Morton,722,2,18,11,7,54,38,16,65
Falkirk,722,3,18,10,8,58,38,20,64
Dundee Utd,722,4,15,10,11,45,40,5,55
Dunfermline,722,5,10,14,12,53,46,7,44
Queen of S't,722,6,11,10,15,45,52,-7,43
Ayr,722,7,9,12,15,32,51,-19,39
Dumbarton,722,8,8,14,14,46,55,-9,38
Raith,722,9,9,9,18,34,55,-21,36
St Mirren,722,10,7,11,18,38,54,-16,32
Hibernian,723,1,20,13,3,61,25,36,73
Morton,723,2,15,13,8,47,37,10,58
Falkirk,723,3,16,9,11,60,44,16,57
Dundee Utd,723,4,15,11,10,50,39,11,56
Queen of S't,723,5,13,9,14,44,53,-9,48
Dunfermline,723,6,10,14,12,50,47,3,44
Dumbarton,723,7,9,13,14,49,60,-11,40
Ayr,723,8,9,12,15,34,51,-17,39
Raith,723,9,8,11,17,34,54,-20,35
St Mirren,723,10,6,13,17,37,56,-19,31
Hibernian,724,1,19,14,3,54,23,31,71
Dundee Utd,724,2,17,10,9,52,36,16,61
Falkirk,724,3,17,9,10,58,39,19,60
Morton,724,4,15,13,8,46,35,11,58
Dunfermline,724,5,9,14,13,43,46,-3,41
Queen of S't,724,6,10,11,15,42,51,-9,41
Dumbarton,724,7,9,12,15,45,57,-12,39
Raith,724,8,10,9,17,31,47,-16,39
Ayr,724,9,9,12,15,32,50,-18,39
St Mirren,724,10,8,10,18,39,58,-19,34
Hibernian,725,1,18,13,5,55,27,28,67
Dundee Utd,725,2,16,10,10,51,40,11,58
Falkirk,725,3,15,12,9,54,40,14,57
Morton,725,4,15,12,9,48,40,8,57
Queen of S't,725,5,14,9,13,46,50,-4,51
Dumbarton,725,6,10,11,15,52,56,-4,41
Dunfermline,725,7,9,13,14,44,48,-4,40
Raith,725,8,10,10,16,38,52,-14,40
St Mirren,725,9,10,9,17,40,54,-14,39
Ayr,725,10,7,13,16,35,56,-21,34
Hibernian,726,1,19,12,5,53,25,28,69
Dundee Utd,726,2,18,10,8,48,34,14,64
Morton,726,3,16,10,10,51,37,14,58
Falkirk,726,4,15,11,10,55,39,16,56
Dunfermline,726,5,9,15,12,46,48,-2,42
Raith,726,6,11,9,16,33,44,-11,42
Queen of S't,726,7,9,13,14,42,51,-9,40
St Mirren,726,8,10,10,16,39,53,-14,40
Dumbarton,726,9,9,11,16,47,59,-12,38
Ayr,726,10,8,11,17,33,57,-24,35
Hibernian,727,1,19,12,5,55,24,31,69
Morton,727,2,18,9,9,51,35,16,63
Falkirk,727,3,16,10,10,65,46,19,58
Dundee Utd,727,4,16,9,11,51,38,13,57
Queen of S't,727,5,12,9,15,44,51,-7,45
Dunfermline,727,6,10,14,12,47,51,-4,44
Dumbarton,727,7,10,13,13,56,61,-5,43
Raith,727,8,10,9,17,38,49,-11,39
St Mirren,727,9,9,10,17,42,64,-22,37
Ayr,727,10,6,13,17,31,61,-30,31
Hibernian,728,1,19,11,6,55,27,28,68
Falkirk,728,2,19,10,7,66,38,28,67
Morton,728,3,18,11,7,58,35,23,65
Dundee Utd,728,4,14,10,12,46,42,4,52
Queen of S't,728,5,12,8,16,45,54,-9,44
Dumbarton,728,6,10,10,16,47,61,-14,40
Ayr,728,7,9,13,14,35,54,-19,40
Dunfermline,728,8,8,15,13,46,48,-2,39
Raith,728,9,9,10,17,35,55,-20,37
St Mirren,728,10,7,12,17,39,58,-19,33
Hibernian,729,1,19,12,5,60,27,33,69
Falkirk,729,2,17,10,9,60,41,19,61
Morton,729,3,15,13,8,47,39,8,58
Dundee Utd,729,4,13,9,14,44,48,-4,48
Queen of S't,729,5,12,11,13,45,47,-2,47
St Mirren,729,6,11,9,16,44,54,-10,42
Raith,729,7,10,11,15,35,48,-13,41
Dunfermline,729,8,8,15,13,42,46,-4,39
Dumbarton,729,9,9,12,15,46,54,-8,39
Ayr,729,10,9,12,15,33,52,-19,39
Hibernian,730,1,20,10,6,55,24,31,70
Dundee Utd,730,2,17,11,8,50,33,17,62
Falkirk,730,3,16,11,9,60,41,19,59
Morton,730,4,16,9,11,48,37,11,57
Dumbarton,730,5,11,12,13,50,55,-5,45
Raith,730,6,11,10,15,40,50,-10,43
Dunfermline,730,7,10,12,14,44,51,-7,42
Queen of S't,730,8,10,10,16,46,55,-9,40
St Mirren,730,9,9,12,15,37,50,-13,39
Ayr,730,10,6,11,19,31,65,-34,29
Hibernian,731,1,19,12,5,55,26,29,69
Morton,731,2,18,11,7,56,35,21,65
Falkirk,731,3,15,11,10,56,42,14,56
Dundee Utd,731,4,15,11,10,56,44,12,56
Dunfermline,731,5,10,13,13,51,57,-6,43
Queen of S't,731,6,11,10,15,44,51,-7,43
Raith,731,7,9,12,15,30,45,-15,39
St Mirren,731,8,9,11,16,43,57,-14,38
Ayr,731,9,8,14,14,31,51,-20,38
Dumbarton,731,10,8,11,17,54,68,-14,35
Hibernian,732,1,20,11,5,57,26,31,71
Morton,732,2,20,11,5,53,31,22,71
Dundee Utd,732,3,18,8,10,54,43,11,62
Falkirk,732,4,17,9,10,67,47,20,60
Queen of S't,732,5,12,10,14,50,50,0,46
Raith,732,6,11,10,15,34,47,-13,43
Dumbarton,732,7,8,12,16,43,57,-14,36
Dunfermline,732,8,8,11,17,41,51,-10,35
St Mirren,732,9,8,9,19,40,59,-19,33
Ayr,732,10,7,11,18,30,58,-28,32
Morton,733,1,21,10,5,57,34,23,73
Hibernian,733,2,18,12,6,49,22,27,66
Falkirk,733,3,15,12,9,55,37,18,57
Dundee Utd,733,4,14,11,11,49,45,4,53
Dunfermline,733,5,9,15,12,51,50,1,42
Queen of S't,733,6,9,14,13,42,48,-6,41
Ayr,733,7,10,11,15,37,60,-23,41
St Mirren,733,8,10,9,17,44,53,-9,39
Dumbarton,733,9,8,11,17,47,62,-15,35
Raith,733,10,8,11,17,31,51,-20,35
Hibernian,734,1,20,11,5,57,24,33,71
Falkirk,734,2,18,10,8,60,38,22,64
Morton,734,3,18,10,8,51,37,14,64
Dundee Utd,734,4,16,10,10,53,42,11,58
Queen of S't,734,5,13,8,15,48,53,-5,47
Dumbarton,734,6,9,13,14,42,55,-13,40
St Mirren,734,7,10,9,17,46,52,-6,39
Dunfermline,734,8,9,12,15,45,52,-7,39
Raith,734,9,8,10,18,34,55,-21,34
Ayr,734,10,6,13,17,32,60,-28,31
Hibernian,735,1,20,12,4,55,25,30,72
Falkirk,735,2,19,9,8,60,38,22,66
Morton,735,3,16,12,8,45,34,11,60
Dundee Utd,735,4,15,10,11,51,40,11,55
Dumbarton,735,5,10,12,14,50,59,-9,42
Queen of S't,735,6,9,14,13,44,51,-7,41
Dunfermline,735,7,8,14,14,44,50,-6,38
Raith,735,8,9,11,16,34,48,-14,38
St Mirren,735,9,8,12,16,39,53,-14,36
Ayr,735,10,7,12,17,30,54,-24,33
Hibernian,736,1,21,10,5,55,24,31,73
Morton,736,2,18,11,7,48,33,15,65
Dundee Utd,736,3,16,11,9,48,35,13,59
Falkirk,736,4,15,12,9,57,40,17,57
Dunfermline,736,5,10,14,12,43,44,-1,44
Queen of S't,736,6,11,10,15,46,51,-5,43
Dumbarton,736,7,10,10,16,45,60,-15,40
Raith,736,8,9,10,17,33,49,-16,37
Ayr,736,9,7,13,16,36,57,-21,34
St Mirren,736,10,8,9,19,36,54,-18,33
Hibernian,737,1,18,12,6,52,25,27,66
Falkirk,737,2,17,10,9,58,41,17,61
Morton,737,3,16,11,9,46,37,9,59
Dundee Utd,737,4,15,10,11,50,40,10,55
Dunfermline,737,5,10,14,12,45,45,0,44
Queen of S't,737,6,11,10,15,43,50,-7,43
Dumbarton,737,7,10,12,14,49,56,-7,42
Raith,737,8,10,12,14,36,46,-10,42
Ayr,737,9,7,14,15,34,55,-21,35
St Mirren,737,10,7,13,16,39,57,-18,34
Hibernian,738,1,19,12,5,52,27,25,69
Morton,738,2,19,11,6,56,37,19,68
Falkirk,738,3,16,9,11,56,41,15,57
Dundee Utd,738,4,15,10,11,50,44,6,55
Dunfermline,738,5,12,13,11,52,43,9,49
Queen of S't,738,6,12,9,15,46,51,-5,45
St Mirren,738,7,10,10,16,41,53,-12,40
Dumbarton,738,8,9,10,17,51,60,-9,37
Raith,738,9,8,10,18,34,53,-19,34
Ayr,738,10,7,12,17,32,61,-29,33
Dundee Utd,739,1,19,9,8,61,35,26,66
Hibernian,739,2,17,11,8,55,36,19,62
Morton,739,3,16,11,9,47,37,10,59
Falkirk,739,4,15,10,11,53,47,6,55
Dunfermline,739,5,12,12,12,54,49,5,48
Queen of S't,739,6,11,10,15,47,50,-3,43
Raith,739,7,11,10,15,35,46,-11,43
St Mirren,739,8,10,9,17,46,61,-15,39
Dumbarton,739,9,8,12,16,51,66,-15,36
Ayr,739,10,8,12,16,34,56,-22,36
Hibernian,740,1,18,14,4,58,29,29,68
Dundee Utd,740,2,17,9,10,54,43,11,60
Morton,740,3,15,11,10,51,40,11,56
Falkirk,740,4,14,11,11,54,42,12,53
Queen of S't,740,5,12,11,13,48,51,-3,47
Raith,740,6,11,11,14,35,47,-12,44
Dunfermline,740,7,10,13,13,47,49,-2,43
Dumbarton,740,8,10,12,14,53,59,-6,42
St Mirren,740,9,8,11,17,42,60,-18,35
Ayr,740,10,7,13,16,39,61,-22,34
Hibernian,741,1,20,12,4,59,28,31,72
Falkirk,741,2,17,12,7,61,39,22,63
Morton,741,3,16,11,9,48,37,11,59
Dundee Utd,741,4,15,10,11,48,42,6,55
Queen of S't,741,5,11,9,16,42,49,-7,42
Ayr,741,6,9,13,14,39,56,-17,40
Raith,741,7,9,12,15,34,48,-14,39
Dunfermline,741,8,8,14,14,42,48,-6,38
Dumbarton,741,9,9,11,16,47,58,-11,38
St Mirren,741,10,9,10,17,44,59,-15,37
Hibernian,742,1,20,11,5,61,27,34,71
Dundee Utd,742,2,16,12,8,50,37,13,60
Morton,742,3,16,11,9,47,40,7,59
Falkirk,742,4,15,9,12,56,44,12,54
Raith,742,5,12,10,14,43,48,-5,46
Queen of S't,742,6,11,9,16,45,55,-10,42
Dunfermline,742,7,9,13,14,47,53,-6,40
Ayr,742,8,9,12,15,40,56,-16,39
Dumbarton,742,9,9,11,16,46,58,-12,38
St Mirren,742,10,8,12,16,38,55,-17,36
Hibernian,743,1,18,12,6,50,27,23,66
Dundee Utd,743,2,17,10,9,51,37,14,61
Morton,743,3,16,11,9,50,35,15,59
Falkirk,743,4,16,10,10,59,40,19,58
Dunfermline,743,5,11,13,12,43,45,-2,46
Queen of S't,743,6,11,10,15,44,49,-5,43
St Mirren,743,7,11,9,16,41,53,-12,42
Raith,743,8,10,9,17,32,48,-16,39
Dumbarton,743,9,8,12,16,49,61,-12,36
Ayr,743,10,7,14,15,34,58,-24,35
Hibernian,744,1,21,12,3,62,23,39,75
Dundee Utd,744,2,18,9,9,52,36,16,63
Morton,744,3,16,11,9,43,33,10,59
Falkirk,744,4,14,12,10,53,44,9,54
Queen of S't,744,5,12,9,15,45,52,-7,45
Raith,744,6,11,9,16,35,46,-11,42
Dumbarton,744,7,9,12,15,48,55,-7,39
Ayr,744,8,9,11,16,32,52,-20,38
Dunfermline,744,9,8,13,15,42,50,-8,37
St Mirren,744,10,8,10,18,34,55,-21,34
Hibernian,745,1,20,12,4,57,23,34,72
Morton,745,2,17,11,8,50,37,13,62
Dundee Utd,745,3,16,10,10,51,41,10,58
Falkirk,745,4,16,9,11,58,44,14,57
Queen of S't,745,5,13,9,14,52,51,1,48
Raith,745,6,11,9,16,36,48,-12,42
Dumbarton,745,7,9,13,14,48,58,-10,40
Dunfermline,745,8,8,12,16,42,54,-12,36
St Mirren,745,9,8,12,16,40,56,-16,36
Ayr,745,10,7,13,16,33,55,-22,34
Morton,746,1,18,11,7,55,35,20,65
Hibernian,746,2,17,13,6,53,27,26,64
Falkirk,746,3,17,11,8,62,42,20,62
Dundee Utd,746,4,14,10,12,47,43,4,52
Queen of S't,746,5,13,9,14,48,50,-2,48
Raith,746,6,11,10,15,38,51,-13,43
Dunfermline,746,7,10,11,15,46,51,-5,41
Dumbarton,746,8,9,12,15,49,62,-13,39
St Mirren,746,9,8,12,16,40,57,-17,36
Ayr,746,10,7,13,16,36,56,-20,34
Hibernian,747,1,22,11,3,59,23,36,77
Morton,747,2,17,10,9,54,40,14,61
Dundee Utd,747,3,17,8,11,51,42,9,59
Falkirk,747,4,16,9,11,59,41,18,57
Queen of S't,747,5,13,10,13,46,48,-2,49
Raith,747,6,12,8,16,39,50,-11,44
Dunfermline,747,7,10,12,14,47,52,-5,42
Dumbarton,747,8,9,12,15,46,56,-10,39
Ayr,747,9,7,11,18,33,61,-28,32
St Mirren,747,10,6,11,19,35,56,-21,29
Morton,748,1,17,14,5,52,34,18,65
Hibernian,748,2,17,13,6,54,28,26,64
Dundee Utd,748,3,17,11,8,53,39,14,62
Falkirk,748,4,17,9,10,58,39,19,60
Queen of S't,748,5,12,9,15,51,48,3,45
Dunfermline,748,6,10,13,13,43,49,-6,43
Raith,748,7,9,12,15,33,47,-14,39
Ayr,748,8,9,12,15,34,53,-19,39
St Mirren,748,9,8,10,18,37,58,-21,34
Dumbarton,748,10,7,11,18,42,62,-20,32
Morton,749,1,19,10,7,49,33,16,67
Hibernian,749,2,17,14,5,53,27,26,65
Dundee Utd,749,3,15,12,9,50,38,12,57
Falkirk,749,4,15,11,10,55,39,16,56
Raith,749,5,13,9,14,40,47,-7,48
Queen of S't,749,6,11,9,16,45,55,-10,42
Dunfermline,749,7,8,15,13,40,45,-5,39
St Mirren,749,8,10,9,17,41,53,-12,39
Ayr,749,9,7,14,15,31,52,-21,35
Dumbarton,749,10,7,13,16,46,61,-15,34
Morton,750,1,19,10,7,61,40,21,67
Hibernian,750,2,17,15,4,52,27,25,66
Falkirk,750,3,16,10,10,61,42,19,58
Dunfermline,750,4,13,12,11,51,46,5,51
Dundee Utd,750,5,13,10,13,46,44,2,49
Queen of S't,750,6,12,12,12,46,48,-2,48
St Mirren,750,7,10,9,17,46,58,-12,39
Raith,750,8,8,11,17,32,50,-18,35
Ayr,750,9,7,14,15,37,56,-19,35
Dumbarton,750,10,8,11,17,50,71,-21,35
Hibernian,751,1,19,11,6,52,24,28,68
Falkirk,751,2,16,10,10,60,40,20,58
Dundee Utd,751,3,16,9,11,52,44,8,57
Morton,751,4,16,9,11,44,39,5,57
Dunfermline,751,5,12,12,12,53,50,3,48
Queen of S't,751,6,13,9,14,48,56,-8,48
Ayr,751,7,9,13,14,41,54,-13,40
Raith,751,8,10,9,17,36,50,-14,39
St Mirren,751,9,9,10,17,36,55,-19,37
Dumbarton,751,10,8,12,16,49,59,-10,36
Hibernian,752,1,18,14,4,51,24,27,68
Morton,752,2,17,11,8,52,37,15,62
Dundee Utd,752,3,17,9,10,53,40,13,60
Falkirk,752,4,16,11,9,62,43,19,59
Raith,752,5,11,10,15,38,49,-11,43
Dunfermline,752,6,9,14,13,43,49,-6,41
Queen of S't,752,7,10,10,16,42,51,-9,40
St Mirren,752,8,9,11,16,41,57,-16,38
Dumbarton,752,9,8,12,16,47,60,-13,36
Ayr,752,10,8,12,16,36,55,-19,36
Hibernian,753,1,20,13,3,64,25,39,73
Dundee Utd,753,2,17,10,9,55,40,15,61
Morton,753,3,15,14,7,48,37,11,59
Falkirk,753,4,14,10,12,54,51,3,52
Queen of S't,753,5,11,10,15,49,55,-6,43
Ayr,753,6,9,15,12,36,50,-14,42
Dunfermline,753,7,9,14,13,43,49,-6,41
Raith,753,8,10,10,16,35,47,-12,40
St Mirren,753,9,9,10,17,40,55,-15,37
Dumbarton,753,10,8,10,18,49,64,-15,34
Hibernian,754,1,20,11,5,56,27,29,71
Morton,754,2,20,11,5,59,32,27,71
Falkirk,754,3,16,11,9,56,37,19,59
Dundee Utd,754,4,15,11,10,52,43,9,56
Queen of S't,754,5,10,10,16,41,51,-10,40
Dunfermline,754,6,8,15,13,42,47,-5,39
Raith,754,7,10,8,18,35,53,-18,38
Dumbarton,754,8,8,13,15,45,59,-14,37
St Mirren,754,9,8,12,16,41,55,-14,36
Ayr,754,10,8,12,16,30,53,-23,36
Hibernian,755,1,20,11,5,54,29,25,71
Falkirk,755,2,16,11,9,55,39,16,59
Morton,755,3,15,14,7,46,35,11,59
Dundee Utd,755,4,15,10,11,49,40,9,55
Queen of S't,755,5,14,8,14,51,47,4,50
Dumbarton,755,6,10,12,14,48,53,-5,42
Raith,755,7,10,11,15,36,47,-11,41
Ayr,755,8,10,10,16,36,55,-19,40
Dunfermline,755,9,7,16,13,42,50,-8,37
St Mirren,755,10,6,11,19,35,57,-22,29
Hibernian,756,1,19,12,5,55,29,26,69
Dundee Utd,756,2,16,10,10,50,38,12,58
Morton,756,3,15,13,8,46,34,12,58
Falkirk,756,4,15,11,10,63,43,20,56
Dunfermline,756,5,13,12,11,49,46,3,51
Queen of S't,756,6,10,12,14,44,50,-6,42
Raith,756,7,10,12,14,34,45,-11,42
Dumbarton,756,8,9,12,15,49,58,-9,39
Ayr,756,9,7,13,16,32,56,-24,34
St Mirren,756,10,8,9,19,36,59,-23,33
Hibernian,757,1,17,14,5,51,26,25,65
Morton,757,2,16,15,5,49,32,17,63
Falkirk,757,3,16,12,8,56,37,19,60
Dundee Utd,757,4,16,10,10,48,40,8,58
Queen of S't,757,5,12,9,15,50,55,-5,45
St Mirren,757,6,9,12,15,38,50,-12,39
Dumbarton,757,7,8,14,14,48,58,-10,38
Dunfermline,757,8,8,13,15,41,48,-7,37
Raith,757,9,9,10,17,35,51,-16,37
Ayr,757,10,8,13,15,39,58,-19,37
Hibernian,758,1,19,13,4,57,26,31,70
Morton,758,2,18,10,8,54,36,18,64
Falkirk,758,3,16,11,9,63,42,21,59
Dundee Utd,758,4,16,10,10,51,38,13,58
Queen of S't,758,5,12,10,14,50,53,-3,46
Raith,758,6,12,9,15,42,47,-5,45
Dunfermline,758,7,9,13,14,43,52,-9,40
St Mirren,758,8,9,9,18,40,60,-20,36
Dumbarton,758,9,8,11,17,45,64,-19,35
Ayr,758,10,8,10,18,35,62,-27,34
Hibernian,759,1,22,11,3,64,26,38,77
Morton,759,2,17,10,9,52,37,15,61
Dundee Utd,759,3,17,9,10,50,39,11,60
Falkirk,759,4,16,9,11,64,47,17,57
Queen of S't,759,5,12,10,14,46,49,-3,46
Dunfermline,759,6,10,13,13,47,53,-6,43
Raith,759,7,10,9,17,36,50,-14,39
Dumbarton,759,8,9,11,16,50,62,-12,38
St Mirren,759,9,8,10,18,41,61,-20,34
Ayr,759,10,7,12,17,32,58,-26,33
Hibernian,760,1,21,12,3,58,23,35,75
Morton,760,2,16,12,8,46,36,10,60
Dundee Utd,760,3,16,9,11,53,42,11,57
Falkirk,760,4,14,11,11,55,42,13,53
Dunfermline,760,5,11,13,12,50,45,5,46
Queen of S't,760,6,11,10,15,42,49,-7,43
Dumbarton,760,7,10,11,15,48,58,-10,41
Raith,760,8,10,10,16,37,50,-13,40
St Mirren,760,9,8,11,17,39,59,-20,35
Ayr,760,10,7,13,16,37,61,-24,34
Hibernian,761,1,20,11,5,61,24,37,71
Morton,761,2,18,11,7,51,33,18,65
Dundee Utd,761,3,18,10,8,59,39,20,64
Falkirk,761,4,15,12,9,57,45,12,57
Queen of S't,761,5,11,8,17,47,54,-7,41
Dunfermline,761,6,9,13,14,44,52,-8,40
Raith,761,7,10,10,16,34,48,-14,40
Ayr,761,8,9,11,16,34,54,-20,38
Dumbarton,761,9,8,12,16,51,68,-17,36
St Mirren,761,10,8,10,18,39,60,-21,34
Hibernian,762,1,20,12,4,62,30,32,72
Falkirk,762,2,17,10,9,65,45,20,61
Morton,762,3,16,12,8,47,39,8,60
Dundee Utd,762,4,16,9,11,53,42,11,57
Queen of S't,762,5,12,9,15,51,60,-9,45
Dunfermline,762,6,9,15,12,49,50,-1,42
Dumbarton,762,7,9,13,14,47,55,-8,40
Ayr,762,8,8,12,16,35,52,-17,36
Raith,762,9,9,9,18,33,51,-18,36
St Mirren,762,10,8,11,17,39,57,-18,35
Hibernian,763,1,18,13,5,54,25,29,67
Dundee Utd,763,2,18,10,8,64,37,27,64
Morton,763,3,17,12,7,55,39,16,63
Falkirk,763,4,16,11,9,60,42,18,59
Queen of S't,763,5,12,9,15,45,50,-5,45
Raith,763,6,10,10,16,38,50,-12,40
Dunfermline,763,7,8,15,13,45,55,-10,39
Dumbarton,763,8,8,12,16,42,61,-19,36
Ayr,763,9,8,12,16,36,57,-21,36
St Mirren,763,10,8,10,18,42,65,-23,34
Hibernian,764,1,20,10,6,54,26,28,70
Morton,764,2,18,12,6,55,35,20,66
Falkirk,764,3,15,12,9,56,39,17,57
Dundee Utd,764,4,15,9,12,49,41,8,54
Dumbarton,764,5,12,10,14,52,57,-5,46
Queen of S't,764,6,11,10,15,42,49,-7,43
Raith,764,7,11,10,15,38,48,-10,43
Dunfermline,764,8,9,13,14,42,50,-8,40
Ayr,764,9,9,11,16,32,53,-21,38
St Mirren,764,10,6,11,19,37,59,-22,29
Hibernian,765,1,20,13,3,63,26,37,73
Morton,765,2,17,12,7,49,35,14,63
Falkirk,765,3,16,10,10,60,43,17,58
Dundee Utd,765,4,15,8,13,47,42,5,53
Dunfermline,765,5,10,14,12,47,50,-3,44
Raith,765,6,11,10,15,36,47,-11,43
Queen of S't,765,7,11,8,17,43,55,-12,41
Dumbarton,765,8,9,12,15,48,57,-9,39
St Mirren,765,9,9,10,17,38,52,-14,37
Ayr,765,10,8,11,17,31,55,-24,35
Hibernian,766,1,20,10,6,54,26,28,70
Morton,766,2,20,10,6,58,33,25,70
Falkirk,766,3,17,11,8,61,41,20,62
Dundee Utd,766,4,13,11,12,48,45,3,50
Queen of S't,766,5,12,9,15,44,50,-6,45
Raith,766,6,11,9,16,36,48,-12,42
Ayr,766,7,10,11,15,39,53,-14,41
Dunfermline,766,8,8,14,14,43,50,-7,38
Dumbarton,766,9,8,11,17,45,62,-17,35
St Mirren,766,10,7,12,17,41,61,-20,33
Hibernian,767,1,20,11,5,57,27,30,71
Morton,767,2,17,11,8,50,39,11,62
Falkirk,767,3,17,10,9,60,39,21,61
Dundee Utd,767,4,16,8,12,47,41,6,56
Dunfermline,767,5,12,11,13,52,47,5,47
Queen of S't,767,6,12,9,15,45,49,-4,45
Dumbarton,767,7,10,10,16,49,56,-7,40
Raith,767,8,9,13,14,35,51,-16,40
St Mirren,767,9,7,12,17,38,55,-17,33
Ayr,767,10,7,11,18,29,58,-29,32
Hibernian,768,1,18,12,6,52,27,25,66
Morton,768,2,16,14,6,48,33,15,62
Falkirk,768,3,16,10,10,60,44,16,58
Dundee Utd,768,4,14,11,11,51,40,11,53
Dunfermline,768,5,11,13,12,51,48,3,46
Queen of S't,768,6,11,9,16,47,53,-6,42
Dumbarton,768,7,10,10,16,52,62,-10,40
Ayr,768,8,9,13,14,35,54,-19,40
St Mirren,768,9,10,9,17,38,54,-16,39
Raith,768,10,10,9,17,35,54,-19,39
Hibernian,769,1,20,13,3,59,24,35,73
Dundee Utd,769,2,17,9,10,58,36,22,60
Falkirk,769,3,16,10,10,63,45,18,58
Morton,769,4,15,11,10,51,42,9,56
Dunfermline,769,5,12,13,11,53,49,4,49
Queen of S't,769,6,10,12,14,42,51,-9,42
Raith,769,7,11,9,16,38,54,-16,42
Dumbarton,769,8,9,12,15,46,57,-11,39
Ayr,769,9,7,13,16,33,61,-28,34
St Mirren,769,10,7,10,19,37,61,-24,31
Hibernian,770,1,19,11,6,54,27,27,68
Morton,770,2,18,11,7,54,34,20,65
Dundee Utd,770,3,15,9,12,50,44,6,54
Falkirk,770,4,14,11,11,56,49,7,53
Raith,770,5,13,10,13,35,41,-6,49
Dunfermline,770,6,11,13,12,52,49,3,46
Queen of S't,770,7,12,9,15,45,49,-4,45
Dumbarton,770,8,8,12,16,49,59,-10,36
St Mirren,770,9,8,11,17,41,57,-16,35
Ayr,770,10,7,13,16,33,60,-27,34
Hibernian,771,1,19,12,5,55,27,28,69
Morton,771,2,18,10,8,49,36,13,64
Falkirk,771,3,16,12,8,61,39,22,60
Dundee Utd,771,4,15,10,11,51,42,9,55
Raith,771,5,12,10,14,43,49,-6,46
Queen of S't,771,6,12,9,15,46,51,-5,45
Dunfermline,771,7,10,11,15,49,55,-6,41
St Mirren,771,8,10,9,17,44,58,-14,39
Ayr,771,9,9,11,16,35,56,-21,38
Dumbarton,771,10,7,10,19,45,65,-20,31
Hibernian,772,1,21,11,4,62,24,38,74
Falkirk,772,2,18,10,8,64,41,23,64
Morton,772,3,16,12,8,50,40,10,60
Dundee Utd,772,4,16,10,10,55,41,14,58
Queen of S't,772,5,11,11,14,49,52,-3,44
Raith,772,6,10,10,16,35,53,-18,40
St Mirren,772,7,10,9,17,41,55,-14,39
Dunfermline,772,8,8,14,14,41,50,-9,38
Dumbarton,772,9,8,12,16,47,58,-11,36
Ayr,772,10,7,11,18,38,68,-30,32
Hibernian,773,1,20,12,4,59,25,34,72
Morton,773,2,17,13,6,52,32,20,64
Dundee Utd,773,3,18,9,9,59,36,23,63
Falkirk,773,4,15,12,9,56,40,16,57
Queen of S't,773,5,12,10,14,49,55,-6,46
Raith,773,6,10,12,14,33,44,-11,42
St Mirren,773,7,9,10,17,41,58,-17,37
Dumbarton,773,8,8,11,17,48,64,-16,35
Ayr,773,9,8,11,17,32,62,-30,35
Dunfermline,773,10,7,12,17,39,52,-13,33
Hibernian,774,1,18,12,6,55,30,25,66
Dundee Utd,774,2,16,11,9,56,43,13,59
Falkirk,774,3,14,13,9,54,40,14,55
Morton,774,4,14,13,9,47,37,10,55
Dunfermline,774,5,12,13,11,49,44,5,49
Dumbarton,774,6,10,13,13,53,56,-3,43
Queen of S't,774,7,11,9,16,41,51,-10,42
Raith,774,8,10,10,16,34,47,-13,40
Ayr,774,9,9,12,15,35,56,-21,39
St Mirren,774,10,7,12,17,39,59,-20,33
Hibernian,775,1,20,12,4,57,25,32,72
Falkirk,775,2,17,11,8,68,43,25,62
Morton,775,3,16,10,10,48,38,10,58
Dundee Utd,775,4,14,9,13,43,46,-3,51
Queen of S't,775,5,12,11,13,46,48,-2,47
Dunfermline,775,6,10,13,13,45,46,-1,43
Dumbarton,775,7,10,12,14,48,57,-9,42
Raith,775,8,10,10,16,34,47,-13,40
St Mirren,775,9,10,9,17,49,61,-12,39
Ayr,775,10,7,11,18,36,63,-27,32
Hibernian,776,1,20,13,3,53,23,30,73
Morton,776,2,18,11,7,50,33,17,65
Falkirk,776,3,17,10,9,59,40,19,61
Dundee Utd,776,4,17,10,9,53,40,13,61
Queen of S't,776,5,13,8,15,46,51,-5,47
Dumbarton,776,6,9,11,16,45,59,-14,38
St Mirren,776,7,9,10,17,43,56,-13,37
Raith,776,8,9,9,18,34,51,-17,36
Dunfermline,776,9,8,11,17,45,53,-8,35
Ayr,776,10,8,11,17,33,55,-22,35
Hibernian,777,1,18,14,4,55,26,29,68
Morton,777,2,18,13,5,52,33,19,67
Falkirk,777,3,17,11,8,63,43,20,62
Dundee Utd,777,4,14,12,10,53,45,8,54
Queen of S't,777,5,13,10,13,49,49,0,49
Dunfermline,777,6,8,14,14,43,50,-7,38
Raith,777,7,9,10,17,33,49,-16,37
St Mirren,777,8,9,10,17,36,54,-18,37
Dumbarton,777,9,8,11,17,48,62,-14,35
Ayr,777,10,8,11,17,36,57,-21,35
Hibernian,778,1,21,10,5,58,30,28,73
Morton,778,2,19,11,6,60,36,24,68
Dundee Utd,778,3,15,12,9,49,35,14,57
Falkirk,778,4,14,11,11,57,46,11,53
Queen of S't,778,5,13,10,13,50,48,2,49
Raith,778,6,12,9,15,36,45,-9,45
Dunfermline,778,7,8,12,16,42,54,-12,36
Dumbarton,778,8,7,13,16,43,59,-16,34
St Mirren,778,9,7,13,16,39,56,-17,34
Ayr,778,10,7,13,16,37,62,-25,34
Hibernian,779,1,21,10,5,58,24,34,73
Morton,779,2,18,10,8,53,35,18,64
Dundee Utd,779,3,16,11,9,49,39,10,59
Falkirk,779,4,14,12,10,62,45,17,54
Queen of S't,779,5,11,11,14,43,51,-8,44
Dunfermline,779,6,10,13,13,50,52,-2,43
St Mirren,779,7,9,10,17,44,57,-13,37
Raith,779,8,9,10,17,33,53,-20,37
Ayr,779,9,8,13,15,32,53,-21,37
Dumbarton,779,10,8,12,16,49,64,-15,36
Hibernian,780,1,20,11,5,58,24,34,71
Morton,780,2,17,12,7,48,36,12,63
Dundee Utd,780,3,17,8,11,54,43,11,59
Falkirk,780,4,15,13,8,58,39,19,58
Queen of S't,780,5,11,10,15,44,49,-5,43
Dunfermline,780,6,9,14,13,44,48,-4,41
Raith,780,7,10,9,17,34,52,-18,39
St Mirren,780,8,9,11,16,44,57,-13,38
Dumbarton,780,9,8,13,15,49,56,-7,37
Ayr,780,10,8,11,17,31,60,-29,35
Hibernian,781,1,18,12,6,53,27,26,66
Morton,781,2,16,13,7,51,34,17,61
Dundee Utd,781,3,17,9,10,53,41,12,60
Falkirk,781,4,16,11,9,55,37,18,59
Raith,781,5,11,11,14,40,49,-9,44
Queen of S't,781,6,11,10,15,48,54,-6,43
Dumbarton,781,7,9,12,15,51,60,-9,39
Ayr,781,8,9,12,15,38,61,-23,39
Dunfermline,781,9,7,15,14,44,52,-8,36
St Mirren,781,10,7,13,16,36,54,-18,34
Hibernian,782,1,19,12,5,53,25,28,69
Morton,782,2,17,12,7,51,36,15,63
Falkirk,782,3,15,10,11,56,41,15,55
Dundee Utd,782,4,15,9,12,46,40,6,54
Queen of S't,782,5,13,10,13,50,46,4,49
Raith,782,6,11,11,14,37,44,-7,44
Dunfermline,782,7,9,14,13,43,45,-2,41
Ayr,782,8,10,11,15,33,54,-21,41
Dumbarton,782,9,9,12,15,45,62,-17,39
St Mirren,782,10,6,11,19,34,55,-21,29
Hibernian,783,1,19,12,5,52,25,27,69
Dundee Utd,783,2,18,9,9,58,37,21,63
Morton,783,3,15,12,9,50,39,11,57
Falkirk,783,4,14,11,11,53,42,11,53
Dumbarton,783,5,11,12,13,52,57,-5,45
Dunfermline,783,6,10,13,13,47,49,-2,43
Raith,783,7,10,13,13,38,46,-8,43
Queen of S't,783,8,9,13,14,43,51,-8,40
Ayr,783,9,8,12,16,36,61,-25,36
St Mirren,783,10,7,11,18,34,56,-22,32
Hibernian,784,1,20,11,5,57,27,30,71
Morton,784,2,19,11,6,53,35,18,68
Falkirk,784,3,16,10,10,66,43,23,58
Dundee Utd,784,4,16,9,11,53,38,15,57
Queen of S't,784,5,11,9,16,47,54,-7,42
St Mirren,784,6,11,9,16,42,53,-11,42
Dumbarton,784,7,10,10,16,48,56,-8,40
Raith,784,8,10,10,16,37,57,-20,40
Dunfermline,784,9,7,15,14,39,51,-12,36
Ayr,784,10,7,12,17,32,60,-28,33
Morton,785,1,20,10,6,54,36,18,70
Hibernian,785,2,19,11,6,50,25,25,68
Falkirk,785,3,15,13,8,55,38,17,58
Dundee Utd,785,4,15,11,10,51,40,11,56
Queen of S't,785,5,11,12,13,48,50,-2,45
Dumbarton,785,6,10,11,15,49,58,-9,41
Raith,785,7,9,11,16,36,49,-13,38
Dunfermline,785,8,7,16,13,41,46,-5,37
St Mirren,785,9,9,10,17,40,53,-13,37
Ayr,785,10,7,11,18,28,57,-29,32
Hibernian,786,1,20,10,6,54,27,27,70
Morton,786,2,17,10,9,51,38,13,61
Falkirk,786,3,16,10,10,60,44,16,58
Dundee Utd,786,4,15,12,9,50,37,13,57
Queen of S't,786,5,13,10,13,52,48,4,49
Dumbarton,786,6,10,12,14,54,60,-6,42
Raith,786,7,10,10,16,31,46,-15,40
Ayr,786,8,9,12,15,32,56,-24,39
Dunfermline,786,9,8,13,15,43,51,-8,37
St Mirren,786,10,7,11,18,36,56,-20,32
Hibernian,787,1,20,11,5,54,22,32,71
Falkirk,787,2,18,10,8,58,37,21,64
Morton,787,3,15,13,8,49,36,13,58
Dundee Utd,787,4,14,9,13,50,45,5,51
Dumbarton,787,5,11,11,14,52,57,-5,44
Queen of S't,787,6,11,10,15,45,51,-6,43
Dunfermline,787,7,10,12,14,43,50,-7,42
Raith,787,8,10,11,15,40,49,-9,41
Ayr,787,9,9,12,15,38,57,-19,39
St Mirren,787,10,7,11,18,38,63,-25,32
Hibernian,788,1,19,13,4,55,25,30,70
Morton,788,2,18,11,7,57,38,19,65
Falkirk,788,3,17,10,9,58,39,19,61
Dundee Utd,788,4,17,10,9,50,39,11,61
Queen of S't,788,5,12,9,15,47,55,-8,45
Raith,788,6,11,10,15,38,48,-10,43
Dunfermline,788,7,9,12,15,44,49,-5,39
Ayr,788,8,9,11,16,36,54,-18,38
Dumbarton,788,9,7,13,16,45,59,-14,34
St Mirren,788,10,6,11,19,38,62,-24,29
Morton,789,1,19,10,7,56,36,20,67
Hibernian,789,2,18,12,6,53,30,23,66
Falkirk,789,3,16,12,8,61,40,21,60
Dundee Utd,789,4,14,10,12,45,41,4,52
Queen of S't,789,5,14,8,14,47,53,-6,50
Dunfermline,789,6,10,14,12,49,48,1,44
Dumbarton,789,7,9,12,15,55,62,-7,39
Raith,789,8,10,9,17,33,47,-14,39
St Mirren,789,9,9,10,17,38,55,-17,37
Ayr,789,10,7,11,18,30,55,-25,32
Hibernian,790,1,17,14,5,52,26,26,65
Morton,790,2,18,10,8,53,33,20,64
Falkirk,790,3,17,12,7,61,37,24,63
Dundee Utd,790,4,14,11,11,43,39,4,53
Dunfermline,790,5,11,13,12,47,46,1,46
Queen of S't,790,6,11,11,14,42,47,-5,44
St Mirren,790,7,9,12,15,46,55,-9,39
Raith,790,8,9,10,17,33,53,-20,37
Ayr,790,9,7,15,14,33,55,-22,36
Dumbarton,790,10,7,12,17,44,63,-19,33
Hibernian,791,1,18,14,4,57,24,33,68
Dundee Utd,791,2,17,9,10,54,40,14,60
Morton,791,3,17,9,10,49,40,9,60
Falkirk,791,4,14,12,10,54,43,11,54
Dumbarton,791,5,10,13,13,48,56,-8,43
Queen of S't,791,6,11,9,16,44,53,-9,42
St Mirren,791,7,10,12,14,43,52,-9,42
Dunfermline,791,8,8,15,13,46,54,-8,39
Raith,791,9,9,12,15,32,44,-12,39
Ayr,791,10,7,13,16,34,55,-21,34
Hibernian,792,1,19,12,5,51,27,24,69
Morton,792,2,18,10,8,53,33,20,64
Falkirk,792,3,16,10,10,56,44,12,58
Dundee Utd,792,4,13,10,13,43,42,1,49
Queen of S't,792,5,13,10,13,46,46,0,49
Dunfermline,792,6,10,13,13,46,46,0,43
Dumbarton,792,7,9,13,14,47,54,-7,40
St Mirren,792,8,10,10,16,46,55,-9,40
Raith,792,9,10,9,17,33,47,-14,39
Ayr,792,10,8,11,17,33,60,-27,35
Hibernian,793,1,17,14,5,56,30,26,65
Dundee Utd,793,2,17,10,9,56,36,20,61
Morton,793,3,17,10,9,47,38,9,61
Falkirk,793,4,16,9,11,59,44,15,57
Raith,793,5,13,8,15,41,49,-8,47
Queen of S't,793,6,12,9,15,49,55,-6,45
Dunfermline,793,7,9,15,12,44,45,-1,42
Ayr,793,8,9,13,14,36,52,-16,40
St Mirren,793,9,8,10,18,40,58,-18,34
Dumbarton,793,10,7,12,17,42,63,-21,33
Hibernian,794,1,19,11,6,56,27,29,68
Morton,794,2,19,11,6,55,32,23,68
Falkirk,794,3,16,11,9,60,42,18,59
Dundee Utd,794,4,13,10,13,43,44,-1,49
Queen of S't,794,5,12,12,12,44,45,-1,48
Dunfermline,794,6,11,13,12,48,46,2,46
St Mirren,794,7,9,10,17,41,59,-18,37
Ayr,794,8,8,13,15,32,53,-21,37
Dumbarton,794,9,8,12,16,47,60,-13,36
Raith,794,10,9,9,18,35,53,-18,36
Hibernian,795,1,19,12,5,58,28,30,69
Morton,795,2,16,12,8,52,39,13,60
Dundee Utd,795,3,16,11,9,50,33,17,59
Falkirk,795,4,16,10,10,58,44,14,58
Dunfermline,795,5,11,12,13,50,52,-2,45
Queen of S't,795,6,11,10,15,42,49,-7,43
Raith,795,7,10,11,15,37,48,-11,41
Ayr,795,8,10,10,16,34,54,-20,40
St Mirren,795,9,8,11,17,36,54,-18,35
Dumbarton,795,10,7,13,16,42,58,-16,34
Hibernian,796,1,18,13,5,52,24,28,67
Morton,796,2,17,10,9,48,37,11,61
Falkirk,796,3,16,10,10,54,39,15,58
Dundee Utd,796,4,15,10,11,52,41,11,55
Dunfermline,796,5,13,11,12,48,47,1,50
Raith,796,6,11,10,15,36,46,-10,43
Queen of S't,796,7,10,10,16,45,51,-6,40
Dumbarton,796,8,9,11,16,47,62,-15,38
St Mirren,796,9,8,13,15,37,50,-13,37
Ayr,796,10,8,12,16,33,55,-22,36
Hibernian,797,1,22,10,4,58,23,35,76
Morton,797,2,18,10,8,57,40,17,64
Falkirk,797,3,16,10,10,60,43,17,58
Dundee Utd,797,4,15,10,11,47,40,7,55
Queen of S't,797,5,12,9,15,45,50,-5,45
Dumbarton,797,6,10,12,14,50,54,-4,42
Dunfermline,797,7,9,13,14,45,50,-5,40
St Mirren,797,8,8,12,16,42,57,-15,36
Raith,797,9,9,9,18,29,49,-20,36
Ayr,797,10,7,13,16,36,63,-27,34
Hibernian,798,1,21,11,4,59,27,32,74
Morton,798,2,16,12,8,56,40,16,60
Dundee Utd,798,3,17,9,10,52,40,12,60
Falkirk,798,4,15,10,11,55,45,10,55
Queen of S't,798,5,12,10,14,43,46,-3,46
Raith,798,6,11,11,14,35,45,-10,44
Dunfermline,798,7,8,17,11,48,49,-1,41
Dumbarton,798,8,9,11,16,44,56,-12,38
St Mirren,798,9,7,12,17,37,54,-17,33
Ayr,798,10,6,13,17,29,56,-27,31
Hibernian,799,1,20,11,5,55,23,32,71
Morton,799,2,18,9,9,49,38,11,63
Falkirk,799,3,17,10,9,55,36,19,61
Dundee Utd,799,4,15,8,13,47,42,5,53
Queen of S't,799,5,12,10,14,43,49,-6,46
Dunfermline,799,6,11,12,13,51,46,5,45
Raith,799,7,11,8,17,38,54,-16,41
Dumbarton,799,8,9,12,15,47,59,-12,39
Ayr,799,9,9,12,15,34,52,-18,39
St Mirren,799,10,7,10,19,38,58,-20,31
Morton,800,1,19,12,5,56,36,20,69
Hibernian,800,2,17,13,6,52,29,23,64
Falkirk,800,3,17,12,7,61,40,21,63
Dundee Utd,800,4,15,11,10,49,42,7,56
Raith,800,5,11,9,16,35,46,-11,42
Queen of S't,800,6,10,11,15,44,53,-9,41
Dunfermline,800,7,8,14,14,44,48,-4,38
Ayr,800,8,7,17,12,33,49,-16,38
Dumbarton,800,9,7,15,14,52,64,-12,36
St Mirren,800,10,6,12,18,38,57,-19,30
Hibernian,801,1,19,13,4,59,27,32,70
Dundee Utd,801,2,17,10,9,50,38,12,61
Falkirk,801,3,15,12,9,55,41,14,57
Morton,801,4,13,13,10,47,43,4,52
Dunfermline,801,5,11,15,10,53,46,7,48
Queen of S't,801,6,11,10,15,44,52,-8,43
Raith,801,7,10,10,16,34,47,-13,40
St Mirren,801,8,9,12,15,40,53,-13,39
Dumbarton,801,9,7,14,15,47,60,-13,35
Ayr,801,10,7,13,16,32,54,-22,34
Morton,802,1,18,11,7,55,40,15,65
Hibernian,802,2,16,16,4,51,27,24,64
Falkirk,802,3,16,12,8,65,41,24,60
Dundee Utd,802,4,15,11,10,52,41,11,56
Queen of S't,802,5,13,9,14,46,49,-3,48
Dunfermline,802,6,11,13,12,52,47,5,46
St Mirren,802,7,8,12,16,42,60,-18,36
Ayr,802,8,8,12,16,33,54,-21,36
Raith,802,9,9,9,18,34,56,-22,36
Dumbarton,802,10,8,11,17,45,60,-15,35
Hibernian,803,1,19,11,6,56,28,28,68
Morton,803,2,17,12,7,54,37,17,63
Dundee Utd,803,3,17,8,11,51,37,14,59
Falkirk,803,4,15,11,10,57,42,15,56
Ayr,803,5,10,12,14,36,52,-16,42
Dunfermline,803,6,8,16,12,46,50,-4,40
Dumbarton,803,7,9,13,14,49,56,-7,40
Queen of S't,803,8,10,10,16,45,57,-12,40
Raith,803,9,10,9,17,34,51,-17,39
St Mirren,803,10,9,10,17,36,54,-18,37
Hibernian,804,1,17,13,6,52,27,25,64
Falkirk,804,2,18,10,8,61,37,24,64
Morton,804,3,16,12,8,48,39,9,60
Dundee Utd,804,4,16,10,10,53,36,17,58
Queen of S't,804,5,11,10,15,45,55,-10,43
Raith,804,6,11,9,16,36,47,-11,42
Dunfermline,804,7,9,14,13,45,51,-6,41
Ayr,804,8,9,12,15,36,56,-20,39
Dumbarton,804,9,9,10,17,48,61,-13,37
St Mirren,804,10,8,12,16,37,52,-15,36
Hibernian,805,1,18,13,5,56,29,27,67
Falkirk,805,2,18,10,8,62,39,23,64
Morton,805,3,16,12,8,51,40,11,60
Dundee Utd,805,4,15,10,11,44,38,6,55
Dunfermline,805,5,12,12,12,52,48,4,48
Raith,805,6,10,11,15,39,49,-10,41
Ayr,805,7,9,13,14,35,51,-16,40
Queen of S't,805,8,9,12,15,42,51,-9,39
Dumbarton,805,9,9,10,17,47,63,-16,37
St Mirren,805,10,8,9,19,39,59,-20,33
Hibernian,806,1,18,12,6,54,29,25,66
Dundee Utd,806,2,17,9,10,55,40,15,60
Morton,806,3,16,10,10,55,44,11,58
Falkirk,806,4,15,10,11,55,42,13,55
Dunfermline,806,5,11,12,13,48,51,-3,45
Queen of S't,806,6,12,9,15,43,49,-6,45
Raith,806,7,11,10,15,34,45,-11,43
Ayr,806,8,9,13,14,37,56,-19,40
Dumbarton,806,9,9,11,16,51,58,-7,38
St Mirren,806,10,9,10,17,39,57,-18,37
Hibernian,807,1,20,13,3,54,21,33,73
Falkirk,807,2,16,11,9,58,42,16,59
Morton,807,3,16,11,9,46,36,10,59
Dundee Utd,807,4,15,12,9,46,38,8,57
Dunfermline,807,5,9,14,13,46,48,-2,41
Queen of S't,807,6,11,8,17,42,52,-10,41
Raith,807,7,10,11,15,37,50,-13,41
St Mirren,807,8,9,12,15,41,54,-13,39
Dumbarton,807,9,9,10,17,49,59,-10,37
Ayr,807,10,8,12,16,34,53,-19,36
Hibernian,808,1,19,13,4,57,27,30,70
Morton,808,2,18,11,7,55,36,19,65
Falkirk,808,3,16,12,8,59,42,17,60
Dundee Utd,808,4,16,9,11,51,41,10,57
Queen of S't,808,5,11,10,15,45,53,-8,43
Dunfermline,808,6,10,12,14,43,49,-6,42
Raith,808,7,11,9,16,45,52,-7,42
Dumbarton,808,8,9,11,16,49,61,-12,38
St Mirren,808,9,8,12,16,47,60,-13,36
Ayr,808,10,7,11,18,35,65,-30,32
Hibernian,809,1,19,12,5,58,27,31,69
Dundee Utd,809,2,17,11,8,52,36,16,62
Falkirk,809,3,15,12,9,58,38,20,57
Morton,809,4,13,13,10,47,43,4,52
Queen of S't,809,5,13,10,13,45,51,-6,49
St Mirren,809,6,10,12,14,50,54,-4,42
Raith,809,7,11,9,16,39,50,-11,42
Dunfermline,809,8,8,14,14,41,51,-10,38
Dumbarton,809,9,8,12,16,48,64,-16,36
Ayr,809,10,8,11,17,33,57,-24,35
Hibernian,810,1,19,13,4,53,22,31,70
Morton,810,2,18,11,7,50,34,16,65
Dundee Utd,810,3,16,8,12,55,47,8,56
Falkirk,810,4,13,12,11,59,48,11,51
Dunfermline,810,5,11,12,13,51,48,3,45
Queen of S't,810,6,12,9,15,49,57,-8,45
Raith,810,7,11,10,15,34,46,-12,43
St Mirren,810,8,9,11,16,46,56,-10,38
Ayr,810,9,9,11,16,36,55,-19,38
Dumbarton,810,10,8,11,17,49,69,-20,35
Hibernian,811,1,18,14,4,58,28,30,68
Morton,811,2,16,14,6,47,33,14,62
Dundee Utd,811,3,16,11,9,58,40,18,59
Falkirk,811,4,16,10,10,57,42,15,58
Queen of S't,811,5,12,9,15,46,51,-5,45
Dunfermline,811,6,9,13,14,43,51,-8,40
Raith,811,7,10,10,16,33,46,-13,40
Dumbarton,811,8,8,14,14,48,57,-9,38
St Mirren,811,9,8,11,17,44,64,-20,35
Ayr,811,10,7,14,15,34,56,-22,35
Hibernian,812,1,19,12,5,56,25,31,69
Dundee Utd,812,2,15,12,9,51,37,14,57
Morton,812,3,15,11,10,52,43,9,56
Falkirk,812,4,15,10,11,56,42,14,55
Raith,812,5,13,9,14,41,44,-3,48
Queen of S't,812,6,11,11,14,42,48,-6,44
Dunfermline,812,7,10,12,14,45,52,-7,42
Ayr,812,8,10,11,15,36,56,-20,41
Dumbarton,812,9,8,13,15,46,58,-12,37
St Mirren,812,10,8,11,17,40,60,-20,35
Hibernian,813,1,18,14,4,52,26,26,68
Morton,813,2,17,11,8,48,34,14,62
Dundee Utd,813,3,17,9,10,54,40,14,60
Falkirk,813,4,15,11,10,55,40,15,56
Dunfermline,813,5,11,12,13,44,48,-4,45
Queen of S't,813,6,12,9,15,41,46,-5,45
Raith,813,7,11,8,17,40,51,-11,41
Dumbarton,813,8,9,11,16,45,55,-10,38
Ayr,813,9,8,12,16,33,56,-23,36
St Mirren,813,10,8,11,17,40,56,-16,35
Hibernian,814,1,20,11,5,62,27,35,71
Falkirk,814,2,17,9,10,57,39,18,60
Dundee Utd,814,3,14,13,9,46,37,9,55
Morton,814,4,14,12,10,46,39,7,54
Dunfermline,814,5,12,13,11,48,45,3,49
Queen of S't,814,6,13,9,14,48,47,1,48
St Mirren,814,7,9,11,16,38,51,-13,38
Ayr,814,8,9,11,16,34,54,-20,38
Dumbarton,814,9,8,12,16,42,60,-18,36
Raith,814,10,9,9,18,34,56,-22,36
Hibernian,815,1,21,11,4,61,23,38,74
Falkirk,815,2,17,10,9,57,40,17,61
Morton,815,3,15,14,7,49,37,12,59
Dundee Utd,815,4,14,10,12,45,39,6,52
Dunfermline,815,5,11,14,11,49,47,2,47
Queen of S't,815,6,12,8,16,44,53,-9,44
Raith,815,7,10,11,15,40,55,-15,41
Ayr,815,8,8,14,14,36,52,-16,38
Dumbarton,815,9,8,11,17,44,58,-14,35
St Mirren,815,10,7,11,18,39,60,-21,32
Hibernian,816,1,21,12,3,60,23,37,75
Dundee Utd,816,2,19,9,8,62,35,27,66
Morton,816,3,15,12,9,51,38,13,57
Falkirk,816,4,15,10,11,53,43,10,55
Queen of S't,816,5,12,10,14,48,52,-4,46
Dumbarton,816,6,10,11,15,50,58,-8,41
Raith,816,7,9,11,16,36,52,-16,38
Dunfermline,816,8,8,13,15,44,55,-11,37
St Mirren,816,9,9,10,17,47,61,-14,37
Ayr,816,10,7,12,17,34,68,-34,33
Hibernian,817,1,22,11,3,61,25,36,77
Morton,817,2,16,11,9,54,39,15,59
Dundee Utd,817,3,15,10,11,49,44,5,55
Falkirk,817,4,15,9,12,57,45,12,54
Dunfermline,817,5,11,14,11,50,49,1,47
Queen of S't,817,6,10,13,13,40,45,-5,43
Ayr,817,7,10,12,14,46,55,-9,42
Dumbarton,817,8,9,12,15,49,63,-14,39
Raith,817,9,9,10,17,29,50,-21,37
St Mirren,817,10,7,10,19,36,56,-20,31
Hibernian,818,1,20,12,4,60,29,31,72
Morton,818,2,17,11,8,47,34,13,62
Dundee Utd,818,3,18,8,10,49,38,11,62
Falkirk,818,4,15,10,11,54,40,14,55
Queen of S't,818,5,11,10,15,46,50,-4,43
Raith,818,6,11,10,15,37,47,-10,43
Dumbarton,818,7,10,11,15,49,56,-7,41
Dunfermline,818,8,9,12,15,43,50,-7,39
Ayr,818,9,8,12,16,37,57,-20,36
St Mirren,818,10,8,10,18,37,58,-21,34
Hibernian,819,1,22,10,4,55,26,29,76
Morton,819,2,17,11,8,53,35,18,62
Falkirk,819,3,16,11,9,61,40,21,59
Dundee Utd,819,4,16,9,11,50,41,9,57
Queen of S't,819,5,12,8,16,47,55,-8,44
Dunfermline,819,6,10,13,13,45,49,-4,43
Raith,819,7,10,10,16,34,48,-14,40
St Mirren,819,8,9,10,17,39,52,-13,37
Dumbarton,819,9,7,14,15,44,58,-14,35
Ayr,819,10,7,12,17,32,56,-24,33
Morton,820,1,19,12,5,56,32,24,69
Hibernian,820,2,18,12,6,52,29,23,66
Falkirk,820,3,16,10,10,59,39,20,58
Dundee Utd,820,4,16,8,12,55,44,11,56
Dunfermline,820,5,11,14,11,52,44,8,47
Queen of S't,820,6,13,8,15,46,51,-5,47
Raith,820,7,11,9,16,38,51,-13,42
Dumbarton,820,8,9,12,15,47,59,-12,39
Ayr,820,9,7,11,18,31,65,-34,32
St Mirren,820,10,6,12,18,36,58,-22,30
Hibernian,821,1,20,12,4,57,25,32,72
Morton,821,2,18,13,5,55,34,21,67
Falkirk,821,3,17,10,9,64,38,26,61
Dundee Utd,821,4,14,10,12,46,43,3,52
Dumbarton,821,5,10,13,13,52,54,-2,43
Dunfermline,821,6,10,12,14,47,51,-4,42
Ayr,821,7,10,11,15,39,57,-18,41
Raith,821,8,9,11,16,31,46,-15,38
Queen of S't,821,9,10,8,18,44,60,-16,38
St Mirren,821,10,7,10,19,36,63,-27,31
Hibernian,822,1,20,12,4,61,28,33,72
Morton,822,2,17,12,7,54,34,20,63
Falkirk,822,3,18,9,9,58,40,18,63
Dundee Utd,822,4,13,10,13,46,45,1,49
Queen of S't,822,5,12,10,14,46,47,-1,46
Dunfermline,822,6,10,13,13,48,52,-4,43
Dumbarton,822,7,10,11,15,50,58,-8,41
St Mirren,822,8,8,12,16,43,57,-14,36
Ayr,822,9,8,12,16,36,58,-22,36
Raith,822,10,9,9,18,31,54,-23,36
Hibernian,823,1,19,12,5,56,27,29,69
Falkirk,823,2,16,11,9,65,44,21,59
Morton,823,3,16,11,9,53,41,12,59
Dundee Utd,823,4,14,11,11,47,41,6,53
Queen of S't,823,5,13,9,14,48,50,-2,48
Dunfermline,823,6,10,14,12,51,50,1,44
Raith,823,7,10,10,16,40,56,-16,40
Dumbarton,823,8,9,12,15,44,58,-14,39
St Mirren,823,9,10,9,17,42,56,-14,39
Ayr,823,10,7,13,16,31,54,-23,34
Hibernian,824,1,18,12,6,53,29,24,66
Dundee Utd,824,2,18,8,10,52,37,15,62
Morton,824,3,17,11,8,48,36,12,62
Falkirk,824,4,17,9,10,60,39,21,60
Queen of S't,824,5,12,9,15,43,51,-8,45
Dunfermline,824,6,10,13,13,43,46,-3,43
St Mirren,824,7,10,11,15,41,53,-12,41
Raith,824,8,10,8,18,33,52,-19,38
Ayr,824,9,8,13,15,33,50,-17,37
Dumbarton,824,10,8,10,18,48,61,-13,34
Hibernian,825,1,20,12,4,59,24,35,72
Falkirk,825,2,16,9,11,60,42,18,57
Morton,825,3,15,12,9,47,39,8,57
Dundee Utd,825,4,16,8,12,48,40,8,56
Queen of S't,825,5,12,9,15,46,51,-5,45
Dunfermline,825,6,10,13,13,42,44,-2,43
Dumbarton,825,7,10,11,15,52,65,-13,41
Raith,825,8,10,9,17,32,47,-15,39
Ayr,825,9,9,12,15,33,52,-19,39
St Mirren,825,10,9,11,16,43,58,-15,38
Hibernian,826,1,20,12,4,60,22,38,72
Dundee Utd,826,2,18,10,8,54,36,18,64
Morton,826,3,15,13,8,49,37,12,58
Falkirk,826,4,15,11,10,57,45,12,56
Dumbarton,826,5,11,11,14,53,54,-1,44
Queen of S't,826,6,10,12,14,38,45,-7,42
Dunfermline,826,7,9,14,13,43,51,-8,41
Raith,826,8,9,11,16,32,51,-19,38
St Mirren,826,9,7,12,17,36,58,-22,33
Ayr,826,10,6,14,16,30,53,-23,32
Hibernian,827,1,21,11,4,60,25,35,74
Falkirk,827,2,18,10,8,63,36,27,64
Morton,827,3,15,13,8,49,37,12,58
Dundee Utd,827,4,15,9,12,47,42,5,54
Dunfermline,827,5,10,14,12,49,50,-1,44
Queen of S't,827,6,11,11,14,49,52,-3,44
Raith,827,7,10,10,16,32,50,-18,40
Ayr,827,8,9,12,15,35,53,-18,39
Dumbarton,827,9,8,11,17,43,60,-17,35
St Mirren,827,10,7,11,18,39,61,-22,32
Hibernian,828,1,18,14,4,62,31,31,68
Falkirk,828,2,17,10,9,59,42,17,61
Morton,828,3,16,11,9,51,39,12,59
Dundee Utd,828,4,16,10,10,51,43,8,58
Queen of S't,828,5,14,9,13,51,48,3,51
Dumbarton,828,6,11,11,14,51,55,-4,44
Raith,828,7,9,11,16,36,48,-12,38
Dunfermline,828,8,7,14,15,46,56,-10,35
St Mirren,828,9,8,11,17,41,57,-16,35
Ayr,828,10,8,11,17,35,64,-29,35
Hibernian,829,1,21,12,3,54,21,33,75
Falkirk,829,2,19,9,8,65,38,27,66
Morton,829,3,17,10,9,50,35,15,61
Dundee Utd,829,4,14,11,11,48,42,6,53
Queen of S't,829,5,12,9,15,48,48,0,45
Raith,829,6,11,9,16,33,47,-14,42
Dunfermline,829,7,9,13,14,44,51,-7,40
St Mirren,829,8,10,9,17,40,53,-13,39
Dumbarton,829,9,7,12,17,42,63,-21,33
Ayr,829,10,6,14,16,31,57,-26,32
Hibernian,830,1,20,11,5,56,27,29,71
Falkirk,830,2,18,10,8,63,39,24,64
Morton,830,3,18,10,8,53,36,17,64
Dundee Utd,830,4,15,10,11,52,42,10,55
Queen of S't,830,5,11,10,15,46,52,-6,43
Dunfermline,830,6,10,12,14,45,48,-3,42
Raith,830,7,11,9,16,36,49,-13,42
Dumbarton,830,8,9,10,17,43,59,-16,37
St Mirren,830,9,8,11,17,37,54,-17,35
Ayr,830,10,7,13,16,31,56,-25,34
Hibernian,831,1,19,13,4,55,26,29,70
Morton,831,2,17,11,8,53,35,18,62
Falkirk,831,3,15,12,9,56,39,17,57
Dundee Utd,831,4,16,9,11,45,37,8,57
Dunfermline,831,5,9,14,13,42,48,-6,41
Queen of S't,831,6,10,11,15,39,47,-8,41
Dumbarton,831,7,10,11,15,45,54,-9,41
Raith,831,8,10,11,15,36,48,-12,41
Ayr,831,9,9,10,17,33,56,-23,37
St Mirren,831,10,8,12,16,40,54,-14,36
Hibernian,832,1,20,11,5,59,26,33,71
Morton,832,2,17,11,8,53,36,17,62
Falkirk,832,3,17,10,9,60,43,17,61
Dundee Utd,832,4,13,11,12,45,41,4,50
Dumbarton,832,5,12,11,13,56,57,-1,47
Raith,832,6,12,9,15,42,51,-9,45
Queen of S't,832,7,11,9,16,44,53,-9,42
Ayr,832,8,9,11,16,32,55,-23,38
Dunfermline,832,9,7,16,13,44,51,-7,37
St Mirren,832,10,8,9,19,38,60,-22,33
Hibernian,833,1,19,11,6,54,26,28,68
Morton,833,2,19,10,7,50,34,16,67
Falkirk,833,3,16,10,10,60,41,19,58
Dundee Utd,833,4,15,11,10,46,40,6,56
Queen of S't,833,5,12,8,16,43,51,-8,44
Dunfermline,833,6,10,13,13,47,49,-2,43
Raith,833,7,11,10,15,35,43,-8,43
Ayr,833,8,10,10,16,33,51,-18,40
St Mirren,833,9,8,12,16,37,54,-17,36
Dumbarton,833,10,7,11,18,47,63,-16,32
Hibernian,834,1,17,13,6,51,27,24,64
Morton,834,2,17,13,6,51,34,17,64
Dundee Utd,834,3,18,9,9,59,38,21,63
Falkirk,834,4,17,10,9,63,44,19,61
Queen of S't,834,5,12,9,15,43,48,-5,45
Dunfermline,834,6,10,14,12,48,47,1,44
Raith,834,7,11,9,16,37,50,-13,42
St Mirren,834,8,8,11,17,42,57,-15,35
Dumbarton,834,9,7,13,16,45,67,-22,34
Ayr,834,10,6,13,17,32,59,-27,31
Hibernian,835,1,17,15,4,54,26,28,66
Morton,835,2,16,13,7,49,35,14,61
Dundee Utd,835,3,16,10,10,49,41,8,58
Falkirk,835,4,15,12,9,62,40,22,57
Dunfermline,835,5,11,13,12,47,44,3,46
Raith,835,6,12,9,15,35,47,-12,45
Ayr,835,7,10,13,13,34,49,-15,43
Dumbarton,835,8,9,12,15,54,65,-11,39
Queen of S't,835,9,10,9,17,43,58,-15,39
St Mirren,835,10,6,10,20,43,65,-22,28
Hibernian,836,1,21,10,5,61,31,30,73
Morton,836,2,19,11,6,57,33,24,68
Falkirk,836,3,17,11,8,60,36,24,62
Dundee Utd,836,4,16,10,10,51,38,13,58
Dumbarton,836,5,10,13,13,49,53,-4,43
Queen of S't,836,6,11,10,15,41,53,-12,43
Dunfermline,836,7,8,13,15,44,52,-8,37
Raith,836,8,8,12,16,32,47,-15,36
St Mirren,836,9,8,9,19,36,61,-25,33
Ayr,836,10,7,11,18,32,59,-27,32
Hibernian,837,1,18,14,4,51,24,27,68
Falkirk,837,2,17,9,10,56,38,18,60
Morton,837,3,16,12,8,54,40,14,60
Dundee Utd,837,4,14,12,10,49,43,6,54
Queen of S't,837,5,14,9,13,46,45,1,51
Dunfermline,837,6,10,14,12,50,50,0,44
Dumbarton,837,7,9,12,15,49,55,-6,39
Raith,837,8,9,10,17,31,48,-17,37
Ayr,837,9,8,12,16,31,57,-26,36
St Mirren,837,10,8,10,18,39,56,-17,34
Hibernian,838,1,17,14,5,52,23,29,65
Falkirk,838,2,18,10,8,63,38,25,64
Morton,838,3,16,12,8,49,35,14,60
Dundee Utd,838,4,15,11,10,53,43,10,56
Ayr,838,5,11,11,14,38,50,-12,44
Dunfermline,838,6,10,13,13,46,51,-5,43
Queen of S't,838,7,10,9,17,41,56,-15,39
Raith,838,8,10,9,17,35,53,-18,39
Dumbarton,838,9,9,11,16,49,59,-10,38
St Mirren,838,10,8,12,16,41,59,-18,36
Hibernian,839,1,17,11,8,50,29,21,62
Morton,839,2,17,10,9,50,38,12,61
Falkirk,839,3,14,12,10,56,42,14,54
Dundee Utd,839,4,14,12,10,50,40,10,54
Queen of S't,839,5,13,10,13,44,45,-1,49
St Mirren,839,6,12,10,14,48,55,-7,46
Dunfermline,839,7,10,14,12,43,42,1,44
Raith,839,8,10,11,15,32,44,-12,41
Dumbarton,839,9,10,10,16,51,58,-7,40
Ayr,839,10,7,12,17,33,64,-31,33
Hibernian,840,1,21,10,5,57,27,30,73
Morton,840,2,20,10,6,53,35,18,70
Dundee Utd,840,3,16,9,11,54,37,17,57
Falkirk,840,4,14,9,13,55,50,5,51
Dunfermline,840,5,11,11,14,48,51,-3,44
Queen of S't,840,6,12,8,16,47,53,-6,44
Raith,840,7,10,11,15,35,46,-11,41
St Mirren,840,8,9,11,16,48,52,-4,38
Dumbarton,840,9,9,10,17,44,66,-22,37
Ayr,840,10,8,11,17,30,54,-24,35
Hibernian,841,1,18,13,5,51,23,28,67
Falkirk,841,2,18,10,8,64,40,24,64
Morton,841,3,17,11,8,48,35,13,62
Dundee Utd,841,4,16,10,10,53,40,13,58
Raith,841,5,12,10,14,37,44,-7,46
Dunfermline,841,6,10,11,15,46,49,-3,41
Dumbarton,841,7,10,11,15,46,56,-10,41
St Mirren,841,8,8,13,15,43,53,-10,37
Queen of S't,841,9,9,10,17,37,52,-15,37
Ayr,841,10,7,11,18,30,63,-33,32
Morton,842,1,20,9,7,53,36,17,69
Hibernian,842,2,19,11,6,59,31,28,68
Dundee Utd,842,3,16,10,10,52,40,12,58
Falkirk,842,4,15,12,9,57,43,14,57
Queen of S't,842,5,12,10,14,45,50,-5,46
Dunfermline,842,6,11,11,14,50,49,1,44
Ayr,842,7,9,12,15,34,53,-19,39
Dumbarton,842,8,9,11,16,51,64,-13,38
Raith,842,9,9,10,17,32,48,-16,37
St Mirren,842,10,7,10,19,36,55,-19,31
Hibernian,843,1,19,11,6,59,26,33,68
Dundee Utd,843,2,18,10,8,54,38,16,64
Morton,843,3,17,12,7,45,31,14,63
Falkirk,843,4,15,10,11,55,44,11,55
Dumbarton,843,5,12,11,13,51,54,-3,47
Queen of S't,843,6,12,11,13,46,51,-5,47
Raith,843,7,11,10,15,36,46,-10,43
Dunfermline,843,8,8,12,16,42,51,-9,36
St Mirren,843,9,8,11,17,40,54,-14,35
Ayr,843,10,6,10,20,29,62,-33,28
Hibernian,844,1,21,10,5,57,24,33,73
Morton,844,2,16,13,7,47,33,14,61
Falkirk,844,3,16,9,11,55,41,14,57
Dundee Utd,844,4,15,9,12,47,42,5,54
Dunfermline,844,5,10,15,11,41,42,-1,45
Queen of S't,844,6,12,8,16,45,50,-5,44
Ayr,844,7,10,11,15,35,52,-17,41
St Mirren,844,8,10,9,17,42,58,-16,39
Raith,844,9,9,10,17,34,50,-16,37
Dumbarton,844,10,8,12,16,49,60,-11,36
Hibernian,845,1,21,11,4,58,25,33,74
Morton,845,2,17,10,9,48,38,10,61
Falkirk,845,3,15,10,11,55,41,14,55
Dundee Utd,845,4,15,9,12,47,42,5,54
Queen of S't,845,5,14,9,13,50,49,1,51
Dumbarton,845,6,11,11,14,54,58,-4,44
Dunfermline,845,7,9,12,15,43,51,-8,39
Raith,845,8,9,12,15,38,51,-13,39
St Mirren,845,9,8,11,17,46,62,-16,35
Ayr,845,10,8,11,17,33,55,-22,35
Hibernian,846,1,21,10,5,62,27,35,73
Dundee Utd,846,2,18,9,9,53,36,17,63
Falkirk,846,3,15,11,10,60,46,14,56
Morton,846,4,15,10,11,49,44,5,55
Dunfermline,846,5,11,12,13,48,48,0,45
Dumbarton,846,6,10,13,13,49,54,-5,43
Queen of S't,846,7,11,9,16,43,52,-9,42
Raith,846,8,9,14,13,36,47,-11,41
St Mirren,846,9,8,10,18,37,58,-21,34
Ayr,846,10,7,12,17,30,55,-25,33
Hibernian,847,1,19,12,5,56,24,32,69
Morton,847,2,16,15,5,48,32,16,63
Dundee Utd,847,3,17,9,10,52,43,9,60
Falkirk,847,4,15,10,11,57,45,12,55
Queen of S't,847,5,11,12,13,50,48,2,45
Dunfermline,847,6,9,14,13,46,51,-5,41
Ayr,847,7,9,11,16,33,54,-21,38
Dumbarton,847,8,8,13,15,45,58,-13,37
Raith,847,9,9,10,17,35,53,-18,37
St Mirren,847,10,8,12,16,41,55,-14,36
Hibernian,848,1,18,12,6,54,27,27,66
Morton,848,2,16,13,7,52,39,13,61
Falkirk,848,3,16,11,9,55,40,15,59
Dundee Utd,848,4,16,10,10,51,44,7,58
Queen of S't,848,5,13,11,12,49,43,6,50
Dumbarton,848,6,9,14,13,50,58,-8,41
Raith,848,7,10,9,17,34,50,-16,39
Dunfermline,848,8,8,13,15,41,47,-6,37
Ayr,848,9,9,10,17,35,58,-23,37
St Mirren,848,10,8,11,17,44,59,-15,35
Hibernian,849,1,20,11,5,59,28,31,71
Falkirk,849,2,17,11,8,60,38,22,62
Morton,849,3,16,11,9,47,36,11,59
Dundee Utd,849,4,15,9,12,51,45,6,54
Dunfermline,849,5,11,13,12,46,45,1,46
Queen of S't,849,6,12,9,15,46,52,-6,45
Raith,849,7,11,11,14,35,45,-10,44
Dumbarton,849,8,10,11,15,52,62,-10,41
St Mirren,849,9,8,10,18,39,57,-18,34
Ayr,849,10,6,12,18,32,59,-27,30
Hibernian,850,1,17,15,4,53,28,25,66
Morton,850,2,16,12,8,47,36,11,60
Dundee Utd,850,3,16,9,11,48,39,9,57
Falkirk,850,4,14,13,9,57,43,14,55
Queen of S't,850,5,15,9,12,49,46,3,54
Raith,850,6,10,11,15,38,48,-10,41
Dunfermline,850,7,9,13,14,43,49,-6,40
Dumbarton,850,8,9,11,16,44,56,-12,38
St Mirren,850,9,8,11,17,39,53,-14,35
Ayr,850,10,6,16,14,32,52,-20,34
Hibernian,851,1,20,10,6,55,26,29,70
Morton,851,2,18,10,8,53,39,14,64
Dundee Utd,851,3,17,8,11,53,37,16,59
Falkirk,851,4,16,10,10,57,41,16,58
St Mirren,851,5,12,9,15,51,54,-3,45
Raith,851,6,11,10,15,36,45,-9,43
Queen of S't,851,7,11,9,16,43,52,-9,42
Dunfermline,851,8,9,13,14,43,49,-6,40
Dumbarton,851,9,8,11,17,47,62,-15,35
Ayr,851,10,8,10,18,30,63,-33,34
Hibernian,852,1,23,10,3,59,20,39,79
Morton,852,2,18,10,8,53,37,16,64
Falkirk,852,3,16,10,10,55,41,14,58
Dundee Utd,852,4,15,10,11,49,43,6,55
Dunfermline,852,5,11,11,14,47,51,-4,44
Queen of S't,852,6,11,9,16,45,52,-7,42
Dumbarton,852,7,9,12,15,47,60,-13,39
Raith,852,8,10,9,17,36,50,-14,39
Ayr,852,9,9,12,15,37,54,-17,39
St Mirren,852,10,7,9,20,38,58,-20,30
Hibernian,853,1,18,11,7,53,27,26,65
Morton,853,2,17,13,6,49,34,15,64
Falkirk,853,3,14,13,9,57,42,15,55
Dundee Utd,853,4,14,11,11,47,39,8,53
Dunfermline,853,5,12,13,11,49,44,5,49
Dumbarton,853,6,11,11,14,51,58,-7,44
Queen of S't,853,7,11,10,15,46,52,-6,43
Raith,853,8,10,11,15,36,49,-13,41
Ayr,853,9,8,11,17,30,55,-25,35
St Mirren,853,10,8,10,18,38,56,-18,34
Hibernian,854,1,20,10,6,57,26,31,70
Morton,854,2,18,11,7,52,34,18,65
Dundee Utd,854,3,17,9,10,52,42,10,60
Falkirk,854,4,14,12,10,56,42,14,54
Dumbarton,854,5,11,11,14,53,57,-4,44
Queen of S't,854,6,11,9,16,47,57,-10,42
Dunfermline,854,7,9,13,14,49,53,-4,40
Ayr,854,8,9,11,16,38,55,-17,38
St Mirren,854,9,9,10,17,36,55,-19,37
Raith,854,10,9,10,17,33,52,-19,37
Hibernian,855,1,21,12,3,60,23,37,75
Morton,855,2,19,9,8,58,40,18,66
Dundee Utd,855,3,15,11,10,48,40,8,56
Falkirk,855,4,13,13,10,55,46,9,52
Queen of S't,855,5,13,9,14,52,54,-2,48
Dunfermline,855,6,9,15,12,52,51,1,42
St Mirren,855,7,8,13,15,38,53,-15,37
Dumbarton,855,8,8,12,16,48,59,-11,36
Raith,855,9,8,11,17,34,54,-20,35
Ayr,855,10,7,13,16,36,61,-25,34
Hibernian,856,1,20,13,3,56,22,34,73
Falkirk,856,2,16,11,9,60,43,17,59
Dundee Utd,856,3,16,10,10,48,38,10,58
Morton,856,4,14,13,9,42,33,9,55
Dunfermline,856,5,11,14,11,44,40,4,47
Queen of S't,856,6,10,10,16,41,52,-11,40
Raith,856,7,10,10,16,36,52,-16,40
Dumbarton,856,8,9,12,15,46,58,-12,39
St Mirren,856,9,9,9,18,37,53,-16,36
Ayr,856,10,8,12,16,34,53,-19,36
Hibernian,857,1,17,15,4,50,22,28,66
Falkirk,857,2,18,9,9,62,38,24,63
Morton,857,3,15,13,8,45,37,8,58
Dundee Utd,857,4,15,12,9,46,36,10,57
Queen of S't,857,5,12,10,14,41,50,-9,46
Dunfermline,857,6,10,12,14,46,46,0,42
Dumbarton,857,7,10,12,14,49,55,-6,42
Ayr,857,8,9,14,13,35,49,-14,41
Raith,857,9,8,11,17,31,49,-18,35
St Mirren,857,10,7,10,19,40,63,-23,31
Hibernian,858,1,21,11,4,64,26,38,74
Morton,858,2,17,10,9,49,42,7,61
Falkirk,858,3,16,10,10,54,41,13,58
Dundee Utd,858,4,16,9,11,45,37,8,57
Dunfermline,858,5,12,12,12,48,43,5,48
Queen of S't,858,6,11,12,13,43,47,-4,45
Ayr,858,7,9,11,16,32,53,-21,38
St Mirren,858,8,9,10,17,40,53,-13,37
Raith,858,9,9,9,18,32,50,-18,36
Dumbarton,858,10,8,10,18,42,57,-15,34
Hibernian,859,1,21,10,5,65,30,35,73
Falkirk,859,2,18,9,9,58,38,20,63
Dundee Utd,859,3,18,9,9,57,40,17,63
Morton,859,4,18,9,9,53,39,14,63
Queen of S't,859,5,12,9,15,44,51,-7,45
St Mirren,859,6,11,9,16,40,54,-14,42
Dumbarton,859,7,9,10,17,47,57,-10,37
Raith,859,8,9,9,18,30,49,-19,36
Dunfermline,859,9,8,11,17,43,55,-12,35
Ayr,859,10,8,11,17,33,57,-24,35
Hibernian,860,1,18,12,6,49,26,23,66
Falkirk,860,2,18,11,7,63,37,26,65
Morton,860,3,15,10,11,48,40,8,55
Dundee Utd,860,4,15,9,12,46,41,5,54
Dunfermline,860,5,12,11,13,47,47,0,47
Queen of S't,860,6,12,9,15,45,53,-8,45
Ayr,860,7,11,10,15,44,53,-9,43
Raith,860,8,11,8,17,34,49,-15,41
Dumbarton,860,9,8,12,16,48,63,-15,36
St Mirren,860,10,8,12,16,40,55,-15,36
Hibernian,861,1,19,14,3,56,22,34,71
Morton,861,2,16,13,7,53,37,16,61
Falkirk,861,3,15,12,9,56,43,13,57
Dundee Utd,861,4,15,12,9,52,41,11,57
Queen of S't,861,5,11,11,14,42,47,-5,44
Dunfermline,861,6,9,16,11,43,45,-2,43
Raith,861,7,10,10,16,33,50,-17,40
Dumbarton,861,8,9,12,15,51,57,-6,39
Ayr,861,9,7,13,16,31,56,-25,34
St Mirren,861,10,7,11,18,39,58,-19,32
Hibernian,862,1,18,13,5,56,25,31,67
Dundee Utd,862,2,19,9,8,62,38,24,66
Falkirk,862,3,17,9,10,61,47,14,60
Morton,862,4,16,11,9,46,39,7,59
Queen of S't,862,5,13,8,15,45,53,-8,47
Dunfermline,862,6,9,15,12,52,53,-1,42
Raith,862,7,10,9,17,32,48,-16,39
Dumbarton,862,8,8,12,16,47,60,-13,36
St Mirren,862,9,8,11,17,41,56,-15,35
Ayr,862,10,8,11,17,30,53,-23,35
Hibernian,863,1,19,14,3,51,22,29,71
Morton,863,2,17,9,10,52,38,14,60
Falkirk,863,3,16,9,11,59,40,19,57
Dundee Utd,863,4,16,9,11,52,43,9,57
Queen of S't,863,5,14,9,13,45,45,0,51
Raith,863,6,11,9,16,34,52,-18,42
Dunfermline,863,7,9,13,14,47,53,-6,40
St Mirren,863,8,10,10,16,43,55,-12,40
Dumbarton,863,9,8,12,16,50,66,-16,36
Ayr,863,10,8,10,18,33,52,-19,34
Hibernian,864,1,21,11,4,61,23,38,74
Dundee Utd,864,2,19,8,9,53,36,17,65
Morton,864,3,16,12,8,48,35,13,60
Falkirk,864,4,14,12,10,55,43,12,54
Dumbarton,864,5,10,12,14,51,57,-6,42
Dunfermline,864,6,9,14,13,46,50,-4,41
Raith,864,7,10,10,16,39,51,-12,40
Queen of S't,864,8,10,8,18,42,58,-16,38
St Mirren,864,9,8,11,17,44,65,-21,35
Ayr,864,10,7,14,15,35,56,-21,35
Hibernian,865,1,20,13,3,59,24,35,73
Falkirk,865,2,17,10,9,56,37,19,61
Dundee Utd,865,3,17,9,10,49,41,8,60
Morton,865,4,13,12,11,43,43,0,51
Dunfermline,865,5,12,12,12,48,45,3,48
Queen of S't,865,6,11,11,14,46,48,-2,44
St Mirren,865,7,9,11,16,45,57,-12,38
Dumbarton,865,8,8,12,16,40,53,-13,36
Raith,865,9,8,12,16,32,48,-16,36
Ayr,865,10,8,12,16,33,55,-22,36
Hibernian,866,1,19,12,5,56,25,31,69
Morton,866,2,18,10,8,51,36,15,64
Dundee Utd,866,3,17,8,11,51,40,11,59
Falkirk,866,4,15,12,9,55,37,18,57
Dunfermline,866,5,11,12,13,46,49,-3,45
Dumbarton,866,6,11,11,14,52,59,-7,44
Raith,866,7,11,8,17,35,51,-16,41
Queen of S't,866,8,10,9,17,40,50,-10,39
Ayr,866,9,9,11,16,36,55,-19,38
St Mirren,866,10,8,9,19,39,59,-20,33
Hibernian,867,1,18,12,6,53,25,28,66
Morton,867,2,17,11,8,54,38,16,62
Falkirk,867,3,14,12,10,57,43,14,54
Dundee Utd,867,4,14,12,10,52,41,11,54
Dunfermline,867,5,11,13,12,43,45,-2,46
Dumbarton,867,6,11,12,13,54,57,-3,45
St Mirren,867,7,10,11,15,44,57,-13,41
Raith,867,8,10,10,16,36,51,-15,40
Queen of S't,867,9,9,10,17,45,55,-10,37
Ayr,867,10,8,13,15,32,58,-26,37
Hibernian,868,1,20,12,4,55,23,32,72
Dundee Utd,868,2,18,9,9,56,38,18,63
Morton,868,3,17,9,10,48,37,11,60
Falkirk,868,4,15,11,10,58,42,16,56
Queen of S't,868,5,12,10,14,47,50,-3,46
Dumbarton,868,6,11,11,14,54,56,-2,44
Dunfermline,868,7,10,12,14,45,50,-5,42
Ayr,868,8,9,11,16,35,59,-24,38
Raith,868,9,9,10,17,33,50,-17,37
St Mirren,868,10,6,11,19,34,60,-26,29
Morton,869,1,21,10,5,53,30,23,73
Hibernian,869,2,19,12,5,55,23,32,69
Dundee Utd,869,3,17,10,9,57,37,20,61
Falkirk,869,4,16,11,9,58,42,16,59
Dunfermline,869,5,9,13,14,46,50,-4,40
Ayr,869,6,9,13,14,34,53,-19,40
Dumbarton,869,7,9,11,16,53,62,-9,38
Queen of S't,869,8,9,11,16,45,60,-15,38
Raith,869,9,8,10,18,31,50,-19,34
St Mirren,869,10,7,11,18,35,60,-25,32
Hibernian,870,1,19,13,4,60,26,34,70
Dundee Utd,870,2,18,8,10,58,41,17,62
Morton,870,3,14,14,8,49,39,10,56
Falkirk,870,4,14,11,11,57,47,10,53
Queen of S't,870,5,12,10,14,45,50,-5,46
Dumbarton,870,6,10,13,13,47,55,-8,43
Dunfermline,870,7,8,16,12,48,52,-4,40
Raith,870,8,9,12,15,36,48,-12,39
Ayr,870,9,8,13,15,35,56,-21,37
St Mirren,870,10,7,12,17,38,59,-21,33
Hibernian,871,1,20,13,3,57,23,34,73
Falkirk,871,2,16,12,8,60,41,19,60
Morton,871,3,15,10,11,44,39,5,55
Dundee Utd,871,4,14,12,10,49,42,7,54
Queen of S't,871,5,12,12,12,47,48,-1,48
Dunfermline,871,6,11,13,12,53,51,2,46
Ayr,871,7,9,13,14,34,50,-16,40
Raith,871,8,9,11,16,31,46,-15,38
Dumbarton,871,9,8,10,18,47,64,-17,34
St Mirren,871,10,7,12,17,38,56,-18,33
Morton,872,1,19,11,6,53,32,21,68
Hibernian,872,2,17,15,4,50,22,28,66
Falkirk,872,3,15,11,10,54,41,13,56
Dundee Utd,872,4,14,9,13,50,47,3,51
Dunfermline,872,5,10,13,13,46,50,-4,43
Dumbarton,872,6,11,10,15,53,61,-8,43
Queen of S't,872,7,11,9,16,43,50,-7,42
Raith,872,8,10,12,14,37,46,-9,42
St Mirren,872,9,10,10,16,40,54,-14,40
Ayr,872,10,7,12,17,32,55,-23,33
Hibernian,873,1,20,13,3,64,28,36,73
Falkirk,873,2,17,10,9,57,38,19,61
Morton,873,3,16,10,10,52,43,9,58
Dundee Utd,873,4,15,11,10,52,41,11,56
Dunfermline,873,5,11,13,12,49,50,-1,46
Dumbarton,873,6,11,10,15,53,58,-5,43
Queen of S't,873,7,10,10,16,41,52,-11,40
Raith,873,8,10,10,16,32,46,-14,40
St Mirren,873,9,8,12,16,39,54,-15,36
Ayr,873,10,7,11,18,33,62,-29,32
Hibernian,874,1,19,12,5,55,26,29,69
Morton,874,2,17,11,8,53,44,9,62
Dundee Utd,874,3,16,11,9,52,42,10,59
Falkirk,874,4,15,11,10,61,45,16,56
Queen of S't,874,5,11,13,12,50,50,0,46
Dumbarton,874,6,10,12,14,52,59,-7,42
Raith,874,7,10,10,16,33,46,-13,40
Dunfermline,874,8,9,12,15,46,52,-6,39
Ayr,874,9,7,15,14,34,54,-20,36
St Mirren,874,10,8,9,19,39,57,-18,33
Morton,875,1,19,11,6,55,33,22,68
Hibernian,875,2,17,14,5,50,25,25,65
Falkirk,875,3,15,13,8,56,40,16,58
Dundee Utd,875,4,14,12,10,43,37,6,54
Queen of S't,875,5,11,10,15,45,48,-3,43
Raith,875,6,11,10,15,34,45,-11,43
Dumbarton,875,7,8,14,14,48,57,-9,38
St Mirren,875,8,9,11,16,45,57,-12,38
Dunfermline,875,9,8,14,14,42,54,-12,38
Ayr,875,10,8,11,17,32,54,-22,35
Morton,876,1,21,10,5,55,32,23,73
Hibernian,876,2,19,12,5,57,28,29,69
Dundee Utd,876,3,17,10,9,51,35,16,61
Falkirk,876,4,15,10,11,58,48,10,55
Queen of S't,876,5,13,9,14,46,47,-1,48
Dunfermline,876,6,9,12,15,44,49,-5,39
Raith,876,7,10,9,17,33,46,-13,39
St Mirren,876,8,8,13,15,39,56,-17,37
Ayr,876,9,7,12,17,31,54,-23,33
Dumbarton,876,10,7,11,18,43,62,-19,32
Hibernian,877,1,19,13,4,55,27,28,70
Morton,877,2,16,12,8,51,38,13,60
Dundee Utd,877,3,16,10,10,50,37,13,58
Falkirk,877,4,14,12,10,58,47,11,54
Dunfermline,877,5,12,13,11,52,45,7,49
Ayr,877,6,10,12,14,33,50,-17,42
Dumbarton,877,7,10,10,16,50,60,-10,40
Queen of S't,877,8,9,11,16,41,51,-10,38
St Mirren,877,9,9,10,17,40,55,-15,37
Raith,877,10,9,9,18,31,51,-20,36
Hibernian,878,1,18,12,6,53,27,26,66
Dundee Utd,878,2,19,8,9,52,36,16,65
Morton,878,3,17,12,7,47,30,17,63
Falkirk,878,4,17,10,9,58,37,21,61
Dunfermline,878,5,10,13,13,44,46,-2,43
Queen of S't,878,6,11,9,16,46,52,-6,42
Dumbarton,878,7,9,12,15,45,58,-13,39
Raith,878,8,9,10,17,38,56,-18,37
St Mirren,878,9,9,9,18,42,59,-17,36
Ayr,878,10,7,13,16,31,55,-24,34
Hibernian,879,1,23,10,3,67,25,42,79
Morton,879,2,17,11,8,51,37,14,62
Dundee Utd,879,3,15,10,11,53,44,9,55
Falkirk,879,4,15,9,12,62,48,14,54
Raith,879,5,13,8,15,37,46,-9,47
Queen of S't,879,6,12,8,16,41,49,-8,44
Dunfermline,879,7,10,13,13,48,50,-2,43
St Mirren,879,8,10,9,17,42,55,-13,39
Dumbarton,879,9,7,13,16,44,61,-17,34
Ayr,879,10,7,11,18,30,60,-30,32
Hibernian,880,1,19,13,4,53,23,30,70
Falkirk,880,2,17,10,9,62,42,20,61
Morton,880,3,16,13,7,46,33,13,61
Dundee Utd,880,4,15,9,12,52,44,8,54
Queen of S't,880,5,15,9,12,51,47,4,54
Dunfermline,880,6,9,15,12,42,42,0,42
Raith,880,7,10,9,17,34,49,-15,39
Dumbarton,880,8,8,12,16,43,60,-17,36
St Mirren,880,9,8,11,17,40,55,-15,35
Ayr,880,10,6,13,17,31,59,-28,31
Hibernian,881,1,18,12,6,57,30,27,66
Falkirk,881,2,18,10,8,62,37,25,64
Dundee Utd,881,3,17,11,8,53,39,14,62
Morton,881,4,15,11,10,43,36,7,56
Raith,881,5,14,8,14,39,47,-8,50
Dunfermline,881,6,10,13,13,43,45,-2,43
Queen of S't,881,7,11,10,15,43,49,-6,43
Ayr,881,8,7,14,15,35,57,-22,35
Dumbarton,881,9,7,12,17,42,57,-15,33
St Mirren,881,10,7,11,18,37,57,-20,32
Hibernian,882,1,22,10,4,71,20,51,76
Falkirk,882,2,16,11,9,54,42,12,59
Morton,882,3,16,11,9,45,40,5,59
Dundee Utd,882,4,14,11,11,51,41,10,53
Dunfermline,882,5,11,14,11,43,42,1,47
Queen of S't,882,6,11,10,15,46,56,-10,43
Ayr,882,7,10,11,15,37,57,-20,41
Dumbarton,882,8,9,10,17,45,59,-14,37
St Mirren,882,9,8,11,17,38,54,-16,35
Raith,882,10,8,11,17,34,53,-19,35
Morton,883,1,20,10,6,55,31,24,70
Hibernian,883,2,19,12,5,54,25,29,69
Falkirk,883,3,16,10,10,59,44,15,58
Dundee Utd,883,4,14,11,11,48,43,5,53
Queen of S't,883,5,13,8,15,47,54,-7,47
Raith,883,6,11,8,17,35,45,-10,41
Dunfermline,883,7,9,11,16,43,54,-11,38
St Mirren,883,8,9,11,16,42,54,-12,38
Ayr,883,9,8,13,15,33,52,-19,37
Dumbarton,883,10,8,12,16,42,56,-14,36
Hibernian,884,1,18,14,4,56,27,29,68
Dundee Utd,884,2,18,10,8,50,35,15,64
Falkirk,884,3,17,10,9,55,40,15,61
Morton,884,4,16,11,9,50,41,9,59
Raith,884,5,11,11,14,40,46,-6,44
Dumbarton,884,6,10,11,15,48,53,-5,41
Queen of S't,884,7,10,10,16,43,55,-12,40
Dunfermline,884,8,8,13,15,41,50,-9,37
St Mirren,884,9,8,12,16,39,53,-14,36
Ayr,884,10,7,12,17,34,56,-22,33
Hibernian,885,1,18,14,4,56,28,28,68
Falkirk,885,2,17,12,7,59,36,23,63
Morton,885,3,17,11,8,54,39,15,62
Dundee Utd,885,4,16,8,12,54,42,12,56
Queen of S't,885,5,13,10,13,48,50,-2,49
Dunfermline,885,6,9,14,13,43,47,-4,41
Raith,885,7,9,11,16,34,51,-17,38
St Mirren,885,8,9,10,17,42,57,-15,37
Dumbarton,885,9,8,11,17,46,64,-18,35
Ayr,885,10,8,11,17,37,59,-22,35
Hibernian,886,1,18,13,5,54,26,28,67
Morton,886,2,16,12,8,48,36,12,60
Falkirk,886,3,15,13,8,58,40,18,58
Dundee Utd,886,4,14,12,10,46,39,7,54
Queen of S't,886,5,13,8,15,46,48,-2,47
Dunfermline,886,6,9,15,12,46,48,-2,42
Dumbarton,886,7,9,13,14,48,57,-9,40
Raith,886,8,10,9,17,38,54,-16,39
St Mirren,886,9,9,11,16,42,54,-12,38
Ayr,886,10,7,14,15,33,57,-24,35
Hibernian,887,1,20,13,3,56,23,33,73
Morton,887,2,18,12,6,49,30,19,66
Falkirk,887,3,15,12,9,55,41,14,57
Dundee Utd,887,4,16,8,12,50,38,12,56
Queen of S't,887,5,11,11,14,43,48,-5,44
Dunfermline,887,6,9,14,13,44,45,-1,41
Dumbarton,887,7,8,14,14,42,54,-12,38
St Mirren,887,8,9,10,17,42,55,-13,37
Raith,887,9,9,9,18,30,51,-21,36
Ayr,887,10,8,11,17,35,61,-26,35
Hibernian,888,1,20,12,4,61,22,39,72
Dundee Utd,888,2,16,11,9,49,36,13,59
Morton,888,3,15,13,8,47,38,9,58
Falkirk,888,4,15,9,12,57,41,16,54
Queen of S't,888,5,12,10,14,45,49,-4,46
Dunfermline,888,6,10,14,12,44,45,-1,44
Raith,888,7,11,9,16,34,49,-15,42
Dumbarton,888,8,9,13,14,46,55,-9,40
Ayr,888,9,8,13,15,31,57,-26,37
St Mirren,888,10,7,10,19,35,57,-22,31
Hibernian,889,1,18,14,4,51,22,29,68
Dundee Utd,889,2,19,9,8,57,34,23,66
Morton,889,3,16,13,7,50,36,14,61
Falkirk,889,4,15,11,10,56,42,14,56
Queen of S't,889,5,14,8,14,45,47,-2,50
Dunfermline,889,6,9,12,15,47,52,-5,39
Ayr,889,7,8,14,14,35,54,-19,38
St Mirren,889,8,9,10,17,39,55,-16,37
Dumbarton,889,9,7,14,15,45,63,-18,35
Raith,889,10,8,9,19,30,50,-20,33
Hibernian,890,1,20,12,4,58,27,31,72
Morton,890,2,17,11,8,53,39,14,62
Dundee Utd,890,3,17,9,10,55,39,16,60
Falkirk,890,4,15,11,10,63,44,19,56
Dumbarton,890,5,12,10,14,52,59,-7,46
Raith,890,6,12,8,16,39,49,-10,44
Dunfermline,890,7,10,11,15,47,54,-7,41
Queen of S't,890,8,10,9,17,44,53,-9,39
St Mirren,890,9,8,11,17,42,62,-20,35
Ayr,890,10,7,12,17,35,62,-27,33
Hibernian,891,1,21,10,5,56,27,29,73
Morton,891,2,19,10,7,55,37,18,67
Falkirk,891,3,17,11,8,58,39,19,62
Dundee Utd,891,4,14,11,11,49,43,6,53
Dunfermline,891,5,11,14,11,50,46,4,47
Dumbarton,891,6,10,11,15,49,57,-8,41
Queen of S't,891,7,11,8,17,45,54,-9,41
Raith,891,8,10,10,16,36,48,-12,40
St Mirren,891,9,7,11,18,38,58,-20,32
Ayr,891,10,6,12,18,28,55,-27,30
Hibernian,892,1,18,13,5,52,27,25,67
Falkirk,892,2,17,11,8,58,41,17,62
Morton,892,3,14,13,9,45,38,7,55
Dundee Utd,892,4,13,10,13,46,43,3,49
Dunfermline,892,5,11,15,10,46,42,4,48
Raith,892,6,11,10,15,40,50,-10,43
Queen of S't,892,7,10,11,15,43,50,-7,41
Ayr,892,8,9,13,14,33,50,-17,40
Dumbarton,892,9,9,12,15,47,55,-8,39
St Mirren,892,10,9,10,17,39,53,-14,37
Hibernian,893,1,21,12,3,62,23,39,75
Dundee Utd,893,2,17,9,10,54,37,17,60
Falkirk,893,3,16,10,10,57,42,15,58
Morton,893,4,14,14,8,52,42,10,56
Dunfermline,893,5,11,14,11,49,44,5,47
Queen of S't,893,6,11,9,16,43,53,-10,42
Dumbarton,893,7,10,10,16,51,61,-10,40
Ayr,893,8,8,13,15,31,53,-22,37
St Mirren,893,9,7,13,16,38,56,-18,34
Raith,893,10,8,10,18,28,54,-26,34
Hibernian,894,1,20,11,5,60,25,35,71
Morton,894,2,16,13,7,53,42,11,61
Falkirk,894,3,16,11,9,57,40,17,59
Dundee Utd,894,4,15,13,8,50,38,12,58
Queen of S't,894,5,11,10,15,40,50,-10,43
Dunfermline,894,6,9,15,12,47,47,0,42
Raith,894,7,10,10,16,36,52,-16,40
Ayr,894,8,8,13,15,40,61,-21,37
Dumbarton,894,9,7,14,15,48,60,-12,35
St Mirren,894,10,8,10,18,45,61,-16,34
Hibernian,895,1,20,12,4,58,29,29,72
Falkirk,895,2,16,12,8,62,40,22,60
Morton,895,3,16,12,8,52,40,12,60
Dundee Utd,895,4,15,10,11,51,43,8,55
Queen of S't,895,5,12,9,15,45,49,-4,45
Raith,895,6,12,9,15,41,50,-9,45
Dumbarton,895,7,11,10,15,47,54,-7,43
St Mirren,895,8,8,11,17,41,60,-19,35
Ayr,895,9,7,14,15,35,54,-19,35
Dunfermline,895,10,7,13,16,41,54,-13,34
Hibernian,896,1,20,11,5,55,24,31,71
Falkirk,896,2,19,9,8,60,36,24,66
Dundee Utd,896,3,17,10,9,50,36,14,61
Morton,896,4,14,13,9,43,36,7,55
Queen of S't,896,5,11,11,14,46,51,-5,44
Dumbarton,896,6,10,11,15,48,54,-6,41
Dunfermline,896,7,9,13,14,45,51,-6,40
Raith,896,8,9,11,16,31,47,-16,38
St Mirren,896,9,9,10,17,41,57,-16,37
Ayr,896,10,7,11,18,31,58,-27,32
Hibernian,897,1,19,12,5,51,24,27,69
Morton,897,2,15,15,6,45,33,12,60
Falkirk,897,3,15,12,9,58,40,18,57
Dundee Utd,897,4,15,10,11,50,41,9,55
Dunfermline,897,5,11,13,12,50,45,5,46
Queen of S't,897,6,12,9,15,44,49,-5,45
Raith,897,7,11,9,16,38,52,-14,42
St Mirren,897,8,8,13,15,45,59,-14,37
Ayr,897,9,8,12,16,31,56,-25,36
Dumbarton,897,10,7,13,16,46,59,-13,34
Hibernian,898,1,17,13,6,52,29,23,64
Morton,898,2,17,11,8,51,36,15,62
Dundee Utd,898,3,17,9,10,57,44,13,60
Falkirk,898,4,16,10,10,60,43,17,58
Dunfermline,898,5,12,13,11,54,47,7,49
Queen of S't,898,6,10,11,15,44,53,-9,41
Raith,898,7,10,10,16,35,51,-16,40
Dumbarton,898,8,9,11,16,46,60,-14,38
Ayr,898,9,9,11,16,34,53,-19,38
St Mirren,898,10,8,11,17,36,53,-17,35
Hibernian,899,1,20,11,5,56,24,32,71
Morton,899,2,16,13,7,48,34,14,61
Dundee Utd,899,3,17,9,10,54,41,13,60
Falkirk,899,4,15,9,12,59,44,15,54
Queen of S't,899,5,12,10,14,46,51,-5,46
Dunfermline,899,6,10,13,13,50,47,3,43
Ayr,899,7,9,12,15,34,56,-22,39
Raith,899,8,9,11,16,33,49,-16,38
Dumbarton,899,9,9,10,17,45,62,-17,37
St Mirren,899,10,9,10,17,41,58,-17,37
Hibernian,900,1,21,11,4,59,24,35,74
Morton,900,2,18,10,8,52,37,15,64
Falkirk,900,3,14,11,11,55,43,12,53
Dundee Utd,900,4,13,10,13,49,45,4,49
Queen of S't,900,5,12,10,14,44,49,-5,46
Raith,900,6,11,9,16,35,47,-12,42
Ayr,900,7,10,12,14,36,51,-15,42
Dunfermline,900,8,9,14,13,43,47,-4,41
Dumbarton,900,9,10,10,16,44,56,-12,40
St Mirren,900,10,9,9,18,38,56,-18,36
Hibernian,901,1,19,13,4,57,24,33,70
Dundee Utd,901,2,17,10,9,51,36,15,61
Falkirk,901,3,16,11,9,58,40,18,59
Morton,901,4,15,13,8,46,39,7,58
Dumbarton,901,5,12,11,13,54,50,4,47
Dunfermline,901,6,8,16,12,44,48,-4,40
Queen of S't,901,7,10,10,16,40,48,-8,40
Raith,901,8,9,12,15,34,48,-14,39
Ayr,901,9,8,11,17,32,61,-29,35
St Mirren,901,10,7,11,18,35,57,-22,32
Morton,902,1,19,10,7,55,37,18,67
Hibernian,902,2,17,13,6,53,30,23,64
Falkirk,902,3,15,11,10,57,43,14,56
Dundee Utd,902,4,14,10,12,46,43,3,52
Queen of S't,902,5,13,9,14,52,50,2,48
Raith,902,6,11,10,15,39,47,-8,43
Dunfermline,902,7,10,12,14,43,50,-7,42
Ayr,902,8,10,12,14,38,53,-15,42
Dumbarton,902,9,8,12,16,48,65,-17,36
St Mirren,902,10,8,11,17,42,55,-13,35
Hibernian,903,1,18,12,6,52,26,26,66
Morton,903,2,18,10,8,53,36,17,64
Dundee Utd,903,3,16,12,8,49,37,12,60
Falkirk,903,4,15,12,9,57,39,18,57
Dunfermline,903,5,12,11,13,46,49,-3,47
Queen of S't,903,6,12,9,15,46,52,-6,45
Dumbarton,903,7,9,12,15,48,57,-9,39
Ayr,903,8,8,13,15,34,54,-20,37
St Mirren,903,9,7,13,16,38,55,-17,34
Raith,903,10,8,10,18,33,51,-18,34
Hibernian,904,1,18,13,5,55,27,28,67
Morton,904,2,17,11,8,49,35,14,62
Dundee Utd,904,3,17,9,10,54,39,15,60
Falkirk,904,4,15,13,8,55,39,16,58
Dunfermline,904,5,9,14,13,43,46,-3,41
Dumbarton,904,6,9,13,14,48,57,-9,40
Queen of S't,904,7,10,10,16,40,51,-11,40
Ayr,904,8,10,10,16,37,59,-22,40
Raith,904,9,9,11,16,33,47,-14,38
St Mirren,904,10,9,10,17,40,54,-14,37
Hibernian,905,1,22,10,4,58,24,34,76
Morton,905,2,16,11,9,48,39,9,59
Falkirk,905,3,16,9,11,54,41,13,57
Dundee Utd,905,4,13,12,11,49,44,5,51
Queen of S't,905,5,14,8,14,50,51,-1,50
Dunfermline,905,6,10,13,13,47,48,-1,43
Raith,905,7,11,9,16,38,49,-11,42
Dumbarton,905,8,9,13,14,45,56,-11,40
St Mirren,905,9,9,11,16,40,52,-12,38
Ayr,905,10,6,12,18,33,58,-25,30
Hibernian,906,1,20,11,5,59,28,31,71
Morton,906,2,17,10,9,56,40,16,61
Falkirk,906,3,17,9,10,63,45,18,60
Dundee Utd,906,4,15,10,11,48,43,5,55
Queen of S't,906,5,12,10,14,45,49,-4,46
Dunfermline,906,6,11,12,13,53,57,-4,45
Raith,906,7,10,10,16,35,50,-15,40
St Mirren,906,8,9,10,17,43,56,-13,37
Ayr,906,9,7,15,14,35,54,-19,36
Dumbarton,906,10,8,11,17,49,64,-15,35
Hibernian,907,1,19,14,3,53,23,30,71
Morton,907,2,16,13,7,55,39,16,61
Falkirk,907,3,16,9,11,61,47,14,57
Dundee Utd,907,4,15,10,11,52,42,10,55
Queen of S't,907,5,13,11,12,47,44,3,50
Dunfermline,907,6,10,14,12,46,45,1,44
St Mirren,907,7,10,9,17,43,56,-13,39
Raith,907,8,9,11,16,33,50,-17,38
Dumbarton,907,9,8,10,18,48,67,-19,34
Ayr,907,10,7,13,16,31,56,-25,34
Hibernian,908,1,18,14,4,55,27,28,68
Morton,908,2,17,13,6,52,36,16,64
Falkirk,908,3,16,12,8,61,40,21,60
Dundee Utd,908,4,13,12,11,46,44,2,51
Dunfermline,908,5,9,14,13,42,50,-8,41
Ayr,908,6,10,11,15,35,54,-19,41
Queen of S't,908,7,10,10,16,45,55,-10,40
St Mirren,908,8,9,12,15,45,53,-8,39
Dumbarton,908,9,9,11,16,53,61,-8,38
Raith,908,10,8,13,15,34,48,-14,37
Hibernian,909,1,19,12,5,56,28,28,69
Falkirk,909,2,16,10,10,64,42,22,58
Morton,909,3,15,13,8,49,39,10,58
Dundee Utd,909,4,14,11,11,49,42,7,53
Ayr,909,5,11,12,13,38,54,-16,45
Dunfermline,909,6,9,15,12,50,54,-4,42
Queen of S't,909,7,11,9,16,49,53,-4,42
St Mirren,909,8,9,12,15,45,57,-12,39
Dumbarton,909,9,9,11,16,45,57,-12,38
Raith,909,10,9,11,16,38,57,-19,38
Hibernian,910,1,19,13,4,53,22,31,70
Dundee Utd,910,2,18,10,8,55,39,16,64
Falkirk,910,3,15,14,7,57,39,18,59
Morton,910,4,16,10,10,47,37,10,58
Queen of S't,910,5,13,10,13,45,43,2,49
Dumbarton,910,6,9,12,15,52,62,-10,39
Ayr,910,7,9,11,16,35,57,-22,38
Dunfermline,910,8,8,13,15,39,49,-10,37
Raith,910,9,9,10,17,33,47,-14,37
St Mirren,910,10,7,11,18,36,57,-21,32
Hibernian,911,1,19,10,7,56,28,28,67
Morton,911,2,19,9,8,52,35,17,66
Dundee Utd,911,3,18,8,10,55,41,14,62
Falkirk,911,4,15,10,11,57,44,13,55
Queen of S't,911,5,12,9,15,49,52,-3,45
Dunfermline,911,6,10,12,14,45,52,-7,42
St Mirren,911,7,10,10,16,43,54,-11,40
Raith,911,8,10,9,17,35,51,-16,39
Dumbarton,911,9,9,11,16,49,63,-14,38
Ayr,911,10,8,12,16,37,58,-21,36
Morton,912,1,18,13,5,52,33,19,67
Hibernian,912,2,17,15,4,58,32,26,66
Dundee Utd,912,3,16,12,8,55,36,19,60
Falkirk,912,4,16,11,9,60,39,21,59
Queen of S't,912,5,11,11,14,46,52,-6,44
Dunfermline,912,6,9,14,13,46,49,-3,41
St Mirren,912,7,8,12,16,40,54,-14,36
Raith,912,8,8,12,16,36,53,-17,36
Ayr,912,9,7,14,15,37,58,-21,35
Dumbarton,912,10,8,10,18,42,66,-24,34
Hibernian,913,1,17,15,4,55,27,28,66
Morton,913,2,17,12,7,52,39,13,63
Dundee Utd,913,3,17,11,8,59,38,21,62
Falkirk,913,4,16,11,9,56,41,15,59
Dunfermline,913,5,10,12,14,48,50,-2,42
Dumbarton,913,6,9,12,15,50,60,-10,39
Queen of S't,913,7,9,12,15,41,52,-11,39
St Mirren,913,8,9,11,16,43,55,-12,38
Raith,913,9,10,8,18,36,55,-19,38
Ayr,913,10,7,14,15,36,59,-23,35
Hibernian,914,1,19,11,6,55,26,29,68
Morton,914,2,16,14,6,48,32,16,62
Falkirk,914,3,17,9,10,55,40,15,60
Dundee Utd,914,4,16,11,9,51,41,10,59
Queen of S't,914,5,9,13,14,39,46,-7,40
Raith,914,6,10,10,16,36,51,-15,40
St Mirren,914,7,9,12,15,47,58,-11,39
Dunfermline,914,8,8,14,14,45,51,-6,38
Dumbarton,914,9,8,13,15,48,56,-8,37
Ayr,914,10,8,13,15,32,55,-23,37
Hibernian,915,1,20,11,5,55,27,28,71
Morton,915,2,17,10,9,53,41,12,61
Falkirk,915,3,16,9,11,59,45,14,57
Dundee Utd,915,4,15,9,12,47,40,7,54
Dunfermline,915,5,12,11,13,53,50,3,47
Queen of S't,915,6,13,8,15,49,50,-1,47
Raith,915,7,10,9,17,34,50,-16,39
Ayr,915,8,9,12,15,37,54,-17,39
Dumbarton,915,9,9,11,16,48,63,-15,38
St Mirren,915,10,9,10,17,42,57,-15,37
Hibernian,916,1,19,10,7,54,30,24,67
Morton,916,2,18,10,8,48,37,11,64
Falkirk,916,3,15,12,9,59,42,17,57
Dundee Utd,916,4,16,8,12,51,40,11,56
Queen of S't,916,5,14,9,13,50,48,2,51
Dunfermline,916,6,10,13,13,50,51,-1,43
St Mirren,916,7,10,10,16,45,57,-12,40
Dumbarton,916,8,9,12,15,45,55,-10,39
Ayr,916,9,9,10,17,32,56,-24,37
Raith,916,10,8,10,18,33,51,-18,34
Hibernian,917,1,20,10,6,58,30,28,70
Morton,917,2,17,11,8,51,36,15,62
Dundee Utd,917,3,16,10,10,50,37,13,58
Falkirk,917,4,15,11,10,57,44,13,56
Dunfermline,917,5,11,12,13,48,50,-2,45
Queen of S't,917,6,11,9,16,44,54,-10,42
Raith,917,7,10,11,15,39,50,-11,41
Dumbarton,917,8,9,12,15,44,53,-9,39
St Mirren,917,9,9,11,16,45,58,-13,38
Ayr,917,10,8,11,17,33,57,-24,35
Hibernian,918,1,19,11,6,59,29,30,68
Dundee Utd,918,2,18,9,9,57,37,20,63
Falkirk,918,3,17,9,10,58,37,21,60
Morton,918,4,16,12,8,45,35,10,60
Dunfermline,918,5,11,15,10,45,42,3,48
Queen of S't,918,6,10,11,15,43,50,-7,41
St Mirren,918,7,10,9,17,41,58,-17,39
Ayr,918,8,9,11,16,36,56,-20,38
Raith,918,9,9,9,18,32,54,-22,36
Dumbarton,918,10,7,12,17,44,62,-18,33
Hibernian,919,1,18,12,6,53,23,30,66
Morton,919,2,18,11,7,51,39,12,65
Falkirk,919,3,18,10,8,58,35,23,64
Dundee Utd,919,4,17,10,9,52,39,13,61
Queen of S't,919,5,11,9,16,48,56,-8,42
Raith,919,6,11,8,17,38,51,-13,41
Dunfermline,919,7,9,12,15,43,51,-8,39
Ayr,919,8,8,13,15,37,57,-20,37
Dumbarton,919,9,7,15,14,46,59,-13,36
St Mirren,919,10,8,10,18,42,58,-16,34
Hibernian,920,1,19,13,4,56,28,28,70
Dundee Utd,920,2,17,9,10,53,38,15,60
Falkirk,920,3,16,10,10,58,45,13,58
Morton,920,4,14,14,8,49,40,9,56
Queen of S't,920,5,12,10,14,51,49,2,46
Ayr,920,6,10,12,14,33,51,-18,42
Dunfermline,920,7,8,17,11,47,49,-2,41
Raith,920,8,10,11,15,36,49,-13,41
Dumbarton,920,9,8,12,16,45,60,-15,36
St Mirren,920,10,7,10,19,39,58,-19,31
Hibernian,921,1,17,13,6,56,33,23,64
Dundee Utd,921,2,16,11,9,52,37,15,59
Morton,921,3,15,14,7,48,36,12,59
Falkirk,921,4,15,13,8,56,37,19,58
Dunfermline,921,5,12,12,12,47,54,-7,48
Queen of S't,921,6,10,12,14,50,51,-1,42
Dumbarton,921,7,9,11,16,45,56,-11,38
St Mirren,921,8,9,11,16,40,53,-13,38
Ayr,921,9,8,14,14,35,53,-18,38
Raith,921,10,9,9,18,33,52,-19,36
Morton,922,1,18,10,8,53,37,16,64
Hibernian,922,2,17,12,7,48,26,22,63
Dundee Utd,922,3,18,9,9,55,38,17,63
Falkirk,922,4,17,9,10,56,37,19,60
Dunfermline,922,5,11,11,14,50,54,-4,44
Dumbarton,922,6,11,10,15,56,60,-4,43
Queen of S't,922,7,11,9,16,44,52,-8,42
Raith,922,8,9,11,16,34,49,-15,38
St Mirren,922,9,9,9,18,42,60,-18,36
Ayr,922,10,8,12,16,33,58,-25,36
Hibernian,923,1,19,12,5,52,24,28,69
Falkirk,923,2,16,11,9,58,40,18,59
Morton,923,3,16,10,10,45,37,8,58
Dundee Utd,923,4,16,9,11,48,39,9,57
Queen of S't,923,5,13,8,15,45,54,-9,47
Dunfermline,923,6,11,12,13,51,48,3,45
Dumbarton,923,7,10,11,15,48,55,-7,41
St Mirren,923,8,10,10,16,42,53,-11,40
Raith,923,9,10,9,17,31,46,-15,39
Ayr,923,10,8,10,18,32,56,-24,34
Hibernian,924,1,19,13,4,59,23,36,70
Morton,924,2,16,12,8,55,41,14,60
Dundee Utd,924,3,16,11,9,56,40,16,59
Falkirk,924,4,15,11,10,60,45,15,56
Queen of S't,924,5,12,10,14,49,54,-5,46
Raith,924,6,11,9,16,38,49,-11,42
Dumbarton,924,7,10,10,16,51,62,-11,40
St Mirren,924,8,10,10,16,45,59,-14,40
Dunfermline,924,9,8,13,15,44,57,-13,37
Ayr,924,10,7,13,16,33,60,-27,34
Hibernian,925,1,20,12,4,54,22,32,72
Falkirk,925,2,17,10,9,59,35,24,61
Morton,925,3,16,10,10,49,40,9,58
Dundee Utd,925,4,15,10,11,47,41,6,55
Dunfermline,925,5,12,13,11,46,44,2,49
Queen of S't,925,6,10,11,15,42,53,-11,41
Ayr,925,7,10,11,15,40,55,-15,41
Dumbarton,925,8,9,12,15,48,61,-13,39
St Mirren,925,9,8,11,17,42,59,-17,35
Raith,925,10,9,8,19,35,52,-17,35
Hibernian,926,1,20,13,3,60,25,35,73
Morton,926,2,16,12,8,54,38,16,60
Falkirk,926,3,17,9,10,59,45,14,60
Dundee Utd,926,4,14,10,12,44,43,1,52
Queen of S't,926,5,12,10,14,45,50,-5,46
Dunfermline,926,6,11,12,13,47,44,3,45
St Mirren,926,7,9,12,15,45,55,-10,39
Dumbarton,926,8,9,10,17,45,59,-14,37
Raith,926,9,9,10,17,37,57,-20,37
Ayr,926,10,7,14,15,33,53,-20,35
Hibernian,927,1,18,14,4,53,25,28,68
Morton,927,2,17,11,8,47,35,12,62
Falkirk,927,3,16,11,9,56,37,19,59
Dundee Utd,927,4,15,9,12,50,42,8,54
Queen of S't,927,5,11,11,14,43,49,-6,44
Dumbarton,927,6,11,11,14,48,56,-8,44
St Mirren,927,7,10,11,15,48,54,-6,41
Dunfermline,927,8,7,17,12,40,47,-7,38
Raith,927,9,8,13,15,31,46,-15,37
Ayr,927,10,6,14,16,30,55,-25,32
Hibernian,928,1,18,15,3,62,29,33,69
Morton,928,2,16,12,8,52,36,16,60
Falkirk,928,3,16,11,9,62,44,18,59
Dundee Utd,928,4,14,8,14,45,48,-3,50
Dunfermline,928,5,11,15,10,54,49,5,48
Queen of S't,928,6,12,11,13,49,51,-2,47
Ayr,928,7,9,11,16,34,53,-19,38
Dumbarton,928,8,8,13,15,46,57,-11,37
Raith,928,9,9,10,17,35,53,-18,37
St Mirren,928,10,9,10,17,40,59,-19,37
Hibernian,929,1,21,11,4,56,26,30,74
Morton,929,2,18,11,7,53,31,22,65
Falkirk,929,3,16,10,10,57,40,17,58
Dundee Utd,929,4,14,10,12,46,43,3,52
Dunfermline,929,5,11,12,13,50,47,3,45
Queen of S't,929,6,11,10,15,44,49,-5,43
St Mirren,929,7,10,9,17,44,56,-12,39
Dumbarton,929,8,9,12,15,45,59,-14,39
Raith,929,9,9,9,18,30,51,-21,36
Ayr,929,10,7,14,15,32,55,-23,35
Hibernian,930,1,21,12,3,55,21,34,75
Falkirk,930,2,17,11,8,63,40,23,62
Dundee Utd,930,3,14,12,10,52,45,7,54
Morton,930,4,14,12,10,47,40,7,54
Dunfermline,930,5,11,12,13,46,49,-3,45
Queen of S't,930,6,11,11,14,49,53,-4,44
Ayr,930,7,9,13,14,39,53,-14,40
Dumbarton,930,8,9,11,16,49,64,-15,38
Raith,930,9,9,11,16,36,54,-18,38
St Mirren,930,10,8,9,19,43,60,-17,33
Hibernian,931,1,18,14,4,55,26,29,68
Morton,931,2,16,14,6,53,35,18,62
Falkirk,931,3,16,10,10,56,40,16,58
Dundee Utd,931,4,15,11,10,49,43,6,56
Queen of S't,931,5,12,11,13,49,50,-1,47
Ayr,931,6,9,13,14,39,54,-15,40
Dunfermline,931,7,8,15,13,41,48,-7,39
Raith,931,8,9,12,15,37,50,-13,39
Dumbarton,931,9,8,11,17,46,60,-14,35
St Mirren,931,10,8,11,17,38,57,-19,35
Hibernian,932,1,19,13,4,61,27,34,70
Morton,932,2,19,12,5,52,31,21,69
Falkirk,932,3,16,9,11,60,50,10,57
Dundee Utd,932,4,15,10,11,48,42,6,55
Dunfermline,932,5,10,13,13,48,50,-2,43
Raith,932,6,11,9,16,37,49,-12,42
Dumbarton,932,7,10,10,16,50,59,-9,40
Queen of S't,932,8,10,10,16,44,55,-11,40
Ayr,932,9,8,12,16,36,54,-18,36
St Mirren,932,10,8,10,18,38,57,-19,34
Hibernian,933,1,19,12,5,54,26,28,69
Morton,933,2,18,11,7,57,37,20,65
Falkirk,933,3,18,9,9,62,42,20,63
Dundee Utd,933,4,13,11,12,46,46,0,50
Dumbarton,933,5,11,11,14,46,55,-9,44
Dunfermline,933,6,9,15,12,49,52,-3,42
Queen of S't,933,7,10,10,16,44,53,-9,40
Raith,933,8,9,12,15,34,49,-15,39
Ayr,933,9,8,12,16,38,56,-18,36
St Mirren,933,10,7,13,16,37,51,-14,34
Hibernian,934,1,18,12,6,55,28,27,66
Falkirk,934,2,17,11,8,57,37,20,62
Morton,934,3,17,10,9,50,36,14,61
Dundee Utd,934,4,15,11,10,47,37,10,56
Queen of S't,934,5,13,9,14,48,45,3,48
Dumbarton,934,6,11,11,14,52,65,-13,44
Raith,934,7,10,10,16,35,50,-15,40
Dunfermline,934,8,8,15,13,44,49,-5,39
Ayr,934,9,8,11,17,36,60,-24,35
St Mirren,934,10,8,10,18,41,58,-17,34
Hibernian,935,1,19,13,4,52,22,30,70
Morton,935,2,17,10,9,51,38,13,61
Falkirk,935,3,16,12,8,61,43,18,60
Dundee Utd,935,4,16,11,9,53,40,13,59
Queen of S't,935,5,11,11,14,49,54,-5,44
Dumbarton,935,6,9,12,15,57,63,-6,39
Raith,935,7,9,12,15,34,48,-14,39
Ayr,935,8,8,14,14,33,52,-19,38
Dunfermline,935,9,8,12,16,44,55,-11,36
St Mirren,935,10,8,11,17,40,59,-19,35
Hibernian,936,1,17,14,5,52,26,26,65
Morton,936,2,16,12,8,47,36,11,60
Dundee Utd,936,3,16,10,10,52,40,12,58
Falkirk,936,4,15,11,10,60,46,14,56
Raith,936,5,13,9,14,39,44,-5,48
Queen of S't,936,6,11,10,15,46,54,-8,43
Dunfermline,936,7,9,13,14,42,48,-6,40
Dumbarton,936,8,9,13,14,49,56,-7,40
Ayr,936,9,10,10,16,33,52,-19,40
St Mirren,936,10,7,12,17,36,54,-18,33
Hibernian,937,1,18,11,7,57,29,28,65
Morton,937,2,17,13,6,56,36,20,64
Falkirk,937,3,17,10,9,56,37,19,61
Dundee Utd,937,4,16,9,11,54,44,10,57
Queen of S't,937,5,13,9,14,48,50,-2,48
Dunfermline,937,6,11,12,13,45,49,-4,45
Raith,937,7,10,9,17,32,50,-18,39
Dumbarton,937,8,9,11,16,47,59,-12,38
Ayr,937,9,8,13,15,33,55,-22,37
St Mirren,937,10,7,11,18,38,57,-19,32
Hibernian,938,1,19,13,4,56,25,31,70
Falkirk,938,2,16,11,9,55,38,17,59
Dundee Utd,938,3,16,11,9,52,38,14,59
Morton,938,4,14,15,7,50,42,8,57
Queen of S't,938,5,12,9,15,51,55,-4,45
Raith,938,6,11,9,16,36,50,-14,42
Dumbarton,938,7,9,12,15,47,53,-6,39
Dunfermline,938,8,8,14,14,44,55,-11,38
St Mirren,938,9,8,12,16,39,53,-14,36
Ayr,938,10,8,12,16,38,59,-21,36
Hibernian,939,1,19,12,5,57,26,31,69
Morton,939,2,17,11,8,52,36,16,62
Falkirk,939,3,16,9,11,56,42,14,57
Dundee Utd,939,4,14,10,12,47,43,4,52
Queen of S't,939,5,12,10,14,47,50,-3,46
Dunfermline,939,6,11,12,13,43,48,-5,45
St Mirren,939,7,9,12,15,42,54,-12,39
Raith,939,8,9,12,15,37,50,-13,39
Dumbarton,939,9,9,11,16,43,54,-11,38
Ayr,939,10,8,13,15,31,52,-21,37
Hibernian,940,1,19,13,4,56,24,32,70
Falkirk,940,2,17,9,10,58,40,18,60
Dundee Utd,940,3,16,11,9,49,39,10,59
Morton,940,4,15,14,7,44,35,9,59
Queen of S't,940,5,12,10,14,44,46,-2,46
Dunfermline,940,6,9,14,13,43,46,-3,41
Raith,940,7,10,10,16,34,50,-16,40
Dumbarton,940,8,9,11,16,45,59,-14,38
St Mirren,940,9,8,12,16,44,55,-11,36
Ayr,940,10,6,14,16,32,55,-23,32
Hibernian,941,1,20,12,4,61,23,38,72
Morton,941,2,18,12,6,52,36,16,66
Falkirk,941,3,17,10,9,62,40,22,61
Dundee Utd,941,4,16,10,10,54,42,12,58
Queen of S't,941,5,12,8,16,45,54,-9,44
Raith,941,6,11,9,16,35,50,-15,42
Dumbarton,941,7,9,11,16,45,58,-13,38
St Mirren,941,8,8,12,16,39,53,-14,36
Ayr,941,9,8,11,17,33,58,-25,35
Dunfermline,941,10,7,13,16,43,55,-12,34
Hibernian,942,1,20,11,5,60,28,32,71
Falkirk,942,2,17,12,7,67,41,26,63
Morton,942,3,18,9,9,50,39,11,63
Dundee Utd,942,4,15,11,10,50,40,10,56
Dunfermline,942,5,12,12,12,48,45,3,48
Ayr,942,6,10,11,15,39,56,-17,41
Queen of S't,942,7,10,10,16,42,50,-8,40
Dumbarton,942,8,9,11,16,45,57,-12,38
Raith,942,9,9,8,19,35,59,-24,35
St Mirren,942,10,8,9,19,36,57,-21,33
Hibernian,943,1,20,11,5,59,27,32,71
Morton,943,2,18,9,9,51,38,13,63
Falkirk,943,3,17,10,9,59,39,20,61
Dundee Utd,943,4,16,10,10,50,38,12,58
Dunfermline,943,5,10,14,12,43,44,-1,44
Queen of S't,943,6,12,8,16,44,52,-8,44
St Mirren,943,7,9,10,17,44,58,-14,37
Raith,943,8,9,10,17,34,55,-21,37
Ayr,943,9,9,10,17,33,56,-23,37
Dumbarton,943,10,8,12,16,45,55,-10,36
Hibernian,944,1,18,14,4,55,27,28,68
Dundee Utd,944,2,19,8,9,61,36,25,65
Falkirk,944,3,17,11,8,60,39,21,62
Morton,944,4,15,13,8,50,39,11,58
Dunfermline,944,5,11,12,13,47,51,-4,45
Queen of S't,944,6,11,10,15,44,52,-8,43
Ayr,944,7,8,13,15,39,57,-18,37
Raith,944,8,8,12,16,36,53,-17,36
St Mirren,944,9,8,11,17,41,56,-15,35
Dumbarton,944,10,8,10,18,43,66,-23,34
Hibernian,945,1,17,13,6,50,27,23,64
Morton,945,2,16,14,6,47,34,13,62
Falkirk,945,3,16,13,7,62,36,26,61
Dundee Utd,945,4,13,11,12,46,43,3,50
Queen of S't,945,5,13,9,14,44,52,-8,48
Dunfermline,945,6,9,16,11,44,45,-1,43
Dumbarton,945,7,9,14,13,52,55,-3,41
Raith,945,8,9,10,17,33,48,-15,37
St Mirren,945,9,8,12,16,41,55,-14,36
Ayr,945,10,8,12,16,35,59,-24,36
Hibernian,946,1,19,11,6,58,31,27,68
Dundee Utd,946,2,17,9,10,54,42,12,60
Morton,946,3,15,12,9,53,41,12,57
Falkirk,946,4,15,9,12,55,43,12,54
Dunfermline,946,5,12,13,11,51,43,8,49
Queen of S't,946,6,11,10,15,42,53,-11,43
Dumbarton,946,7,10,11,15,51,60,-9,41
St Mirren,946,8,10,9,17,38,53,-15,39
Ayr,946,9,9,12,15,39,55,-16,39
Raith,946,10,9,10,17,33,53,-20,37
Hibernian,947,1,20,12,4,61,25,36,72
Morton,947,2,18,10,8,50,36,14,64
Dundee Utd,947,3,17,9,10,56,43,13,60
Falkirk,947,4,16,11,9,64,45,19,59
Queen of S't,947,5,13,9,14,49,49,0,48
Dunfermline,947,6,9,13,14,41,48,-7,40
Dumbarton,947,7,9,13,14,45,55,-10,40
Raith,947,8,9,12,15,36,48,-12,39
St Mirren,947,9,6,13,17,33,56,-23,31
Ayr,947,10,6,12,18,29,59,-30,30
Hibernian,948,1,20,13,3,56,23,33,73
Morton,948,2,16,13,7,48,33,15,61
Falkirk,948,3,15,12,9,59,40,19,57
Dundee Utd,948,4,14,12,10,52,41,11,54
Queen of S't,948,5,10,12,14,44,50,-6,42
Dunfermline,948,6,8,17,11,46,48,-2,41
Raith,948,7,9,11,16,34,52,-18,38
Ayr,948,8,8,14,14,32,50,-18,38
Dumbarton,948,9,8,13,15,45,59,-14,37
St Mirren,948,10,8,11,17,38,58,-20,35
Hibernian,949,1,20,12,4,55,26,29,72
Falkirk,949,2,16,12,8,59,39,20,60
Dundee Utd,949,3,17,9,10,52,36,16,60
Morton,949,4,16,12,8,52,40,12,60
Queen of S't,949,5,10,10,16,42,51,-9,40
Raith,949,6,9,13,14,37,49,-12,40
Ayr,949,7,9,13,14,37,56,-19,40
Dunfermline,949,8,8,15,13,43,46,-3,39
Dumbarton,949,9,9,10,17,49,66,-17,37
St Mirren,949,10,8,10,18,40,57,-17,34
Hibernian,950,1,19,12,5,54,26,28,69
Morton,950,2,16,13,7,50,37,13,61
Dundee Utd,950,3,17,10,9,49,36,13,61
Falkirk,950,4,14,12,10,57,45,12,54
Dunfermline,950,5,11,12,13,45,47,-2,45
Queen of S't,950,6,11,10,15,45,49,-4,43
Raith,950,7,10,11,15,36,48,-12,41
Dumbarton,950,8,10,10,16,49,60,-11,40
Ayr,950,9,9,11,16,35,54,-19,38
St Mirren,950,10,8,9,19,40,58,-18,33
Hibernian,951,1,19,11,6,55,26,29,68
Morton,951,2,17,11,8,51,36,15,62
Falkirk,951,3,16,11,9,53,36,17,59
Dundee Utd,951,4,16,10,10,49,38,11,58
Raith,951,5,13,8,15,38,49,-11,47
Dunfermline,951,6,10,14,12,50,49,1,44
Queen of S't,951,7,9,11,16,39,52,-13,38
Dumbarton,951,8,8,12,16,48,60,-12,36
St Mirren,951,9,8,12,16,40,55,-15,36
Ayr,951,10,7,14,15,31,53,-22,35
Hibernian,952,1,18,12,6,54,30,24,66
Morton,952,2,17,12,7,48,34,14,63
Dundee Utd,952,3,17,8,11,50,40,10,59
Falkirk,952,4,13,12,11,53,42,11,51
Queen of S't,952,5,12,12,12,45,47,-2,48
Dunfermline,952,6,10,13,13,51,50,1,43
Raith,952,7,9,13,14,34,48,-14,40
St Mirren,952,8,10,9,17,42,55,-13,39
Dumbarton,952,9,9,11,16,47,58,-11,38
Ayr,952,10,8,12,16,34,54,-20,36
Hibernian,953,1,22,11,3,61,22,39,77
Falkirk,953,2,17,10,9,60,38,22,61
Dundee Utd,953,3,17,10,9,53,39,14,61
Morton,953,4,15,12,9,51,40,11,57
Queen of S't,953,5,13,9,14,45,48,-3,48
Ayr,953,6,11,10,15,39,55,-16,43
Dunfermline,953,7,9,12,15,46,58,-12,39
Dumbarton,953,8,8,10,18,50,67,-17,34
St Mirren,953,9,8,10,18,41,60,-19,34
Raith,953,10,8,10,18,34,53,-19,34
Hibernian,954,1,20,12,4,55,23,32,72
Morton,954,2,16,10,10,46,39,7,58
Falkirk,954,3,15,10,11,52,41,11,55
Dundee Utd,954,4,15,8,13,51,47,4,53
Dunfermline,954,5,12,13,11,50,43,7,49
Queen of S't,954,6,12,9,15,48,50,-2,45
Raith,954,7,11,10,15,36,46,-10,43
St Mirren,954,8,9,10,17,42,54,-12,37
Dumbarton,954,9,8,13,15,48,64,-16,37
Ayr,954,10,8,13,15,34,55,-21,37
Hibernian,955,1,18,12,6,52,27,25,66
Dundee Utd,955,2,17,10,9,58,40,18,61
Morton,955,3,16,12,8,45,32,13,60
Falkirk,955,4,15,11,10,55,40,15,56
Dunfermline,955,5,13,12,11,51,48,3,51
Dumbarton,955,6,11,11,14,49,57,-8,44
Queen of S't,955,7,11,10,15,45,52,-7,43
Raith,955,8,10,10,16,37,50,-13,40
Ayr,955,9,8,10,18,34,61,-27,34
St Mirren,955,10,7,10,19,40,59,-19,31
Hibernian,956,1,20,12,4,63,29,34,72
Morton,956,2,17,12,7,55,37,18,63
Dundee Utd,956,3,16,9,11,50,42,8,57
Falkirk,956,4,14,10,12,54,44,10,52
Queen of S't,956,5,13,10,13,48,50,-2,49
Raith,956,6,11,10,15,39,46,-7,43
Dunfermline,956,7,8,16,12,44,48,-4,40
St Mirren,956,8,9,10,17,38,58,-20,37
Dumbarton,956,9,7,14,15,43,57,-14,35
Ayr,956,10,8,11,17,34,57,-23,35
Hibernian,957,1,19,11,6,59,30,29,68
Morton,957,2,18,10,8,53,38,15,64
Dundee Utd,957,3,16,11,9,57,41,16,59
Falkirk,957,4,15,10,11,56,44,12,55
Dumbarton,957,5,11,11,14,55,59,-4,44
Queen of S't,957,6,11,11,14,47,54,-7,44
Raith,957,7,11,9,16,38,55,-17,42
Dunfermline,957,8,9,11,16,47,53,-6,38
Ayr,957,9,8,13,15,35,56,-21,37
St Mirren,957,10,8,11,17,39,56,-17,35
Hibernian,958,1,19,12,5,53,23,30,69
Morton,958,2,17,10,9,52,37,15,61
Dundee Utd,958,3,17,9,10,51,38,13,60
Falkirk,958,4,14,10,12,56,46,10,52
Dumbarton,958,5,12,11,13,48,52,-4,47
Raith,958,6,11,11,14,38,47,-9,44
Dunfermline,958,7,10,13,13,45,51,-6,43
Queen of S't,958,8,10,9,17,45,55,-10,39
Ayr,958,9,9,11,16,34,54,-20,38
St Mirren,958,10,8,10,18,41,60,-19,34
Hibernian,959,1,19,11,6,54,28,26,68
Falkirk,959,2,18,9,9,60,40,20,63
Dundee Utd,959,3,18,9,9,47,34,13,63
Morton,959,4,16,12,8,47,35,12,60
Ayr,959,5,11,13,12,37,49,-12,46
Dunfermline,959,6,11,12,13,42,43,-1,45
Queen of S't,959,7,12,8,16,43,46,-3,44
Raith,959,8,9,9,18,33,53,-20,36
Dumbarton,959,9,7,11,18,42,58,-16,32
St Mirren,959,10,7,10,19,36,55,-19,31
Hibernian,960,1,18,12,6,55,29,26,66
Falkirk,960,2,18,10,8,58,36,22,64
Morton,960,3,18,9,9,51,36,15,63
Dundee Utd,960,4,15,8,13,46,42,4,53
Queen of S't,960,5,13,8,15,45,51,-6,47
Dunfermline,960,6,10,12,14,44,47,-3,42
Ayr,960,7,10,12,14,36,55,-19,42
St Mirren,960,8,10,10,16,43,55,-12,40
Raith,960,9,10,8,18,38,51,-13,38
Dumbarton,960,10,8,11,17,43,57,-14,35
Morton,961,1,18,11,7,55,37,18,65
Hibernian,961,2,17,13,6,52,26,26,64
Dundee Utd,961,3,18,9,9,59,39,20,63
Falkirk,961,4,16,11,9,57,39,18,59
Raith,961,5,11,12,13,39,44,-5,45
Dunfermline,961,6,11,11,14,45,52,-7,44
Ayr,961,7,8,14,14,34,56,-22,38
Queen of S't,961,8,9,10,17,39,54,-15,37
Dumbarton,961,9,8,12,16,49,58,-9,36
St Mirren,961,10,7,11,18,39,63,-24,32
Hibernian,962,1,19,12,5,53,25,28,69
Falkirk,962,2,16,13,7,56,37,19,61
Morton,962,3,14,13,9,47,37,10,55
Dundee Utd,962,4,15,10,11,52,43,9,55
Dunfermline,962,5,11,14,11,49,42,7,47
Raith,962,6,13,8,15,39,48,-9,47
Dumbarton,962,7,10,10,16,45,61,-16,40
Queen of S't,962,8,10,9,17,46,56,-10,39
St Mirren,962,9,9,11,16,41,53,-12,38
Ayr,962,10,8,10,18,35,61,-26,34
Hibernian,963,1,20,11,5,62,29,33,71
Dundee Utd,963,2,16,11,9,55,37,18,59
Morton,963,3,15,11,10,51,45,6,56
Falkirk,963,4,14,10,12,54,45,9,52
Dumbarton,963,5,11,12,13,54,55,-1,45
Queen of S't,963,6,12,9,15,43,53,-10,45
Raith,963,7,11,10,15,38,47,-9,43
Dunfermline,963,8,9,13,14,46,55,-9,40
St Mirren,963,9,10,10,16,46,57,-11,40
Ayr,963,10,7,13,16,34,60,-26,34
Hibernian,964,1,19,13,4,55,26,29,70
Morton,964,2,17,11,8,56,39,17,62
Falkirk,964,3,17,10,9,61,40,21,61
Dundee Utd,964,4,14,12,10,48,42,6,54
Queen of S't,964,5,11,9,16,44,51,-7,42
Dunfermline,964,6,9,14,13,50,53,-3,41
Raith,964,7,10,11,15,37,49,-12,41
Dumbarton,964,8,9,13,14,51,60,-9,40
Ayr,964,9,8,15,13,34,54,-20,39
St Mirren,964,10,6,12,18,42,64,-22,30
Hibernian,965,1,20,10,6,53,26,27,70
Falkirk,965,2,16,11,9,57,42,15,59
Dundee Utd,965,3,16,11,9,53,42,11,59
Morton,965,4,14,12,10,46,40,6,54
Dunfermline,965,5,11,13,12,50,49,1,46
Dumbarton,965,6,10,12,14,56,58,-2,42
Raith,965,7,11,9,16,38,50,-12,42
St Mirren,965,8,10,9,17,44,58,-14,39
Ayr,965,9,9,12,15,34,51,-17,39
Queen of S't,965,10,9,9,18,42,57,-15,36
Hibernian,966,1,20,12,4,58,25,33,72
Morton,966,2,20,10,6,57,32,25,70
Dundee Utd,966,3,17,9,10,56,42,14,60
Falkirk,966,4,16,11,9,57,39,18,59
Raith,966,5,11,10,15,36,46,-10,43
Queen of S't,966,6,10,11,15,43,51,-8,41
Dunfermline,966,7,9,12,15,44,55,-11,39
St Mirren,966,8,8,11,17,46,58,-12,35
Dumbarton,966,9,8,11,17,45,65,-20,35
Ayr,966,10,7,11,18,34,63,-29,32
Morton,967,1,17,14,5,55,38,17,65
Hibernian,967,2,17,13,6,54,27,27,64
Dundee Utd,967,3,16,11,9,51,37,14,59
Falkirk,967,4,15,10,11,57,45,12,55
Queen of S't,967,5,11,9,16,43,54,-11,42
Raith,967,6,10,12,14,36,47,-11,42
Ayr,967,7,9,14,13,39,53,-14,41
Dunfermline,967,8,8,15,13,47,51,-4,39
Dumbarton,967,9,9,12,15,50,61,-11,39
St Mirren,967,10,8,10,18,40,59,-19,34
Hibernian,968,1,20,12,4,58,26,32,72
Dundee Utd,968,2,17,9,10,52,39,13,60
Morton,968,3,16,12,8,49,36,13,60
Falkirk,968,4,16,9,11,58,45,13,57
Queen of S't,968,5,13,9,14,50,49,1,48
Dumbarton,968,6,10,11,15,51,59,-8,41
St Mirren,968,7,10,10,16,51,56,-5,40
Dunfermline,968,8,9,12,15,45,55,-10,39
Raith,968,9,10,9,17,38,54,-16,39
Ayr,968,10,7,11,18,33,66,-33,32
Hibernian,969,1,18,14,4,59,29,30,68
Dundee Utd,969,2,17,9,10,55,39,16,60
Morton,969,3,16,12,8,50,40,10,60
Falkirk,969,4,16,10,10,57,46,11,58
Queen of S't,969,5,13,10,13,50,50,0,49
Dunfermline,969,6,10,11,15,46,51,-5,41
Ayr,969,7,9,13,14,33,53,-20,40
Dumbarton,969,8,8,13,15,46,55,-9,37
St Mirren,969,9,8,11,17,43,58,-15,35
Raith,969,10,8,11,17,33,51,-18,35
Hibernian,970,1,19,12,5,52,23,29,69
Morton,970,2,16,12,8,49,36,13,60
Falkirk,970,3,16,10,10,59,41,18,58
Dundee Utd,970,4,16,10,10,52,40,12,58
Dunfermline,970,5,12,12,12,49,50,-1,48
Dumbarton,970,6,10,13,13,49,55,-6,43
Queen of S't,970,7,11,8,17,40,52,-12,41
Ayr,970,8,9,11,16,36,54,-18,38
Raith,970,9,9,9,18,33,50,-17,36
St Mirren,970,10,7,13,16,37,55,-18,34
Hibernian,971,1,18,14,4,55,27,28,68
Dundee Utd,971,2,16,9,11,54,42,12,57
Morton,971,3,14,15,7,50,41,9,57
Falkirk,971,4,13,12,11,53,44,9,51
Raith,971,5,13,10,13,38,45,-7,49
Queen of S't,971,6,10,11,15,44,52,-8,41
Dumbarton,971,7,9,13,14,53,61,-8,40
St Mirren,971,8,10,10,16,43,55,-12,40
Dunfermline,971,9,8,15,13,48,50,-2,39
Ayr,971,10,8,13,15,33,54,-21,37
Hibernian,972,1,19,13,4,52,21,31,70
Morton,972,2,17,12,7,52,36,16,63
Dundee Utd,972,3,18,8,10,52,40,12,62
Falkirk,972,4,16,10,10,57,40,17,58
Queen of S't,972,5,11,9,16,48,52,-4,42
Dunfermline,972,6,9,14,13,45,47,-2,41
Dumbarton,972,7,10,11,15,52,63,-11,41
St Mirren,972,8,9,10,17,39,57,-18,37
Ayr,972,9,8,12,16,35,57,-22,36
Raith,972,10,8,11,17,31,50,-19,35
Falkirk,973,1,18,10,8,67,41,26,64
Hibernian,973,2,17,13,6,53,27,26,64
Morton,973,3,17,10,9,49,37,12,61
Dundee Utd,973,4,15,11,10,52,45,7,56
Dunfermline,973,5,11,12,13,45,48,-3,45
Raith,973,6,12,8,16,38,49,-11,44
Dumbarton,973,7,9,12,15,53,62,-9,39
Queen of S't,973,8,10,9,17,44,57,-13,39
St Mirren,973,9,9,11,16,43,55,-12,38
Ayr,973,10,8,12,16,33,56,-23,36
Hibernian,974,1,20,12,4,58,25,33,72
Morton,974,2,20,10,6,59,36,23,70
Falkirk,974,3,18,10,8,60,39,21,64
Dundee Utd,974,4,15,9,12,45,39,6,54
Queen of S't,974,5,13,10,13,49,49,0,49
Dunfermline,974,6,9,11,16,44,51,-7,38
Ayr,974,7,9,11,16,31,55,-24,38
Raith,974,8,9,10,17,34,52,-18,37
Dumbarton,974,9,8,10,18,45,62,-17,34
St Mirren,974,10,8,9,19,42,59,-17,33
Hibernian,975,1,19,13,4,59,27,32,70
Morton,975,2,19,10,7,54,39,15,67
Falkirk,975,3,17,10,9,58,39,19,61
Dundee Utd,975,4,14,12,10,48,41,7,54
Dunfermline,975,5,12,13,11,51,48,3,49
Raith,975,6,9,12,15,37,50,-13,39
Queen of S't,975,7,10,8,18,40,54,-14,38
Dumbarton,975,8,8,13,15,47,58,-11,37
Ayr,975,9,7,14,15,32,52,-20,35
St Mirren,975,10,6,13,17,36,54,-18,31
Hibernian,976,1,19,11,6,55,25,30,68
Morton,976,2,18,9,9,51,38,13,63
Dundee Utd,976,3,16,9,11,52,37,15,57
Falkirk,976,4,16,9,11,56,42,14,57
Dunfermline,976,5,11,11,14,45,52,-7,44
Queen of S't,976,6,12,8,16,44,52,-8,44
Raith,976,7,11,8,17,35,49,-14,41
Dumbarton,976,8,10,10,16,49,60,-11,40
St Mirren,976,9,10,10,16,40,53,-13,40
Ayr,976,10,9,11,16,35,54,-19,38
Hibernian,977,1,20,12,4,61,27,34,72
Falkirk,977,2,17,11,8,57,37,20,62
Morton,977,3,16,10,10,51,43,8,58
Dundee Utd,977,4,15,11,10,50,40,10,56
Queen of S't,977,5,12,9,15,49,51,-2,45
Dunfermline,977,6,10,12,14,46,54,-8,42
Ayr,977,7,10,12,14,40,55,-15,42
Dumbarton,977,8,9,10,17,48,64,-16,37
St Mirren,977,9,8,12,16,41,54,-13,36
Raith,977,10,8,11,17,35,53,-18,35
Hibernian,978,1,21,11,4,60,27,33,74
Falkirk,978,2,17,9,10,59,39,20,60
Dundee Utd,978,3,16,10,10,49,40,9,58
Morton,978,4,15,12,9,49,43,6,57
Dumbarton,978,5,11,11,14,53,56,-3,44
Dunfermline,978,6,10,12,14,45,48,-3,42
Queen of S't,978,7,10,10,16,43,52,-9,40
St Mirren,978,8,10,9,17,41,56,-15,39
Raith,978,9,9,11,16,34,49,-15,38
Ayr,978,10,8,11,17,31,54,-23,35
Hibernian,979,1,17,14,5,53,27,26,65
Falkirk,979,2,16,11,9,59,41,18,59
Dundee Utd,979,3,16,10,10,52,42,10,58
Morton,979,4,15,13,8,49,39,10,58
Dunfermline,979,5,11,14,11,45,41,4,47
Queen of S't,979,6,10,11,15,43,50,-7,41
Dumbarton,979,7,9,13,14,49,60,-11,40
St Mirren,979,8,10,10,16,43,56,-13,40
Raith,979,9,10,9,17,35,49,-14,39
Ayr,979,10,8,11,17,35,58,-23,35
Hibernian,980,1,18,12,6,56,30,26,66
Morton,980,2,17,12,7,49,35,14,63
Falkirk,980,3,16,11,9,58,41,17,59
Dundee Utd,980,4,15,9,12,53,42,11,54
Queen of S't,980,5,14,8,14,50,48,2,50
Raith,980,6,10,11,15,32,46,-14,41
Ayr,980,7,9,13,14,35,53,-18,40
Dumbarton,980,8,9,12,15,51,63,-12,39
Dunfermline,980,9,8,13,15,44,53,-9,37
St Mirren,980,10,8,11,17,42,59,-17,35
Hibernian,981,1,22,10,4,63,25,38,76
Dundee Utd,981,2,19,9,8,53,35,18,66
Falkirk,981,3,14,12,10,55,41,14,54
Morton,981,4,15,9,12,48,44,4,54
Dunfermline,981,5,10,14,12,54,51,3,44
Queen of S't,981,6,11,11,14,50,52,-2,44
Raith,981,7,10,11,15,33,49,-16,41
St Mirren,981,8,8,12,16,36,55,-19,36
Dumbarton,981,9,8,11,17,46,61,-15,35
Ayr,981,10,8,11,17,32,57,-25,35
Hibernian,982,1,20,12,4,56,24,32,72
Dundee Utd,982,2,17,10,9,55,37,18,61
Morton,982,3,16,11,9,48,36,12,59
Falkirk,982,4,15,10,11,56,44,12,55
Dumbarton,982,5,13,10,13,53,57,-4,49
Queen of S't,982,6,11,9,16,43,51,-8,42
Dunfermline,982,7,9,13,14,45,50,-5,40
Raith,982,8,10,10,16,34,50,-16,40
St Mirren,982,9,8,12,16,41,56,-15,36
Ayr,982,10,7,11,18,33,59,-26,32
Hibernian,983,1,17,14,5,52,27,25,65
Morton,983,2,17,11,8,55,38,17,62
Dundee Utd,983,3,17,9,10,56,43,13,60
Falkirk,983,4,15,10,11,56,43,13,55
Queen of S't,983,5,14,9,13,49,49,0,51
Dunfermline,983,6,9,14,13,47,50,-3,41
Ayr,983,7,10,11,15,37,51,-14,41
Raith,983,8,9,12,15,38,54,-16,39
St Mirren,983,9,9,10,17,42,55,-13,37
Dumbarton,983,10,8,10,18,46,68,-22,34
Hibernian,984,1,17,13,6,55,30,25,64
Morton,984,2,17,11,8,49,39,10,62
Falkirk,984,3,16,12,8,61,39,22,60
Dundee Utd,984,4,17,9,10,52,40,12,60
Dunfermline,984,5,10,15,11,56,52,4,45
Ayr,984,6,10,11,15,39,59,-20,41
St Mirren,984,7,10,10,16,46,55,-9,40
Raith,984,8,10,10,16,37,48,-11,40
Queen of S't,984,9,9,9,18,43,59,-16,36
Dumbarton,984,10,8,12,16,50,67,-17,36
Dundee Utd,985,1,18,9,9,50,35,15,63
Hibernian,985,2,16,13,7,52,30,22,61
Morton,985,3,16,12,8,49,36,13,60
Falkirk,985,4,15,10,11,54,41,13,55
Dunfermline,985,5,14,12,10,53,44,9,54
Raith,985,6,11,9,16,37,54,-17,42
Queen of S't,985,7,10,10,16,43,50,-7,40
St Mirren,985,8,9,11,16,43,53,-10,38
Dumbarton,985,9,9,10,17,46,61,-15,37
Ayr,985,10,8,12,16,33,56,-23,36
Hibernian,986,1,20,12,4,58,25,33,72
Dundee Utd,986,2,18,10,8,52,37,15,64
Morton,986,3,17,11,8,52,40,12,62
Falkirk,986,4,17,9,10,60,45,15,60
Dunfermline,986,5,10,12,14,51,48,3,42
Dumbarton,986,6,9,11,16,48,62,-14,38
Raith,986,7,9,11,16,35,51,-16,38
Queen of S't,986,8,9,10,17,39,53,-14,37
Ayr,986,9,9,10,17,35,57,-22,37
St Mirren,986,10,8,12,16,42,54,-12,36
Hibernian,987,1,19,11,6,57,26,31,68
Morton,987,2,19,11,6,54,33,21,68
Dundee Utd,987,3,15,11,10,52,41,11,56
Falkirk,987,4,14,11,11,57,47,10,53
Queen of S't,987,5,11,12,13,45,46,-1,45
Raith,987,6,11,9,16,35,53,-18,42
Dunfermline,987,7,9,13,14,47,51,-4,40
Ayr,987,8,9,12,15,40,56,-16,39
Dumbarton,987,9,8,14,14,47,56,-9,38
St Mirren,987,10,8,10,18,38,63,-25,34
Hibernian,988,1,19,13,4,53,23,30,70
Falkirk,988,2,19,10,7,67,40,27,67
Dundee Utd,988,3,17,9,10,50,42,8,60
Morton,988,4,14,10,12,46,42,4,52
Raith,988,5,11,9,16,38,51,-13,42
Dunfermline,988,6,9,14,13,47,51,-4,41
Queen of S't,988,7,10,10,16,44,52,-8,40
St Mirren,988,8,10,10,16,43,55,-12,40
Ayr,988,9,9,12,15,35,52,-17,39
Dumbarton,988,10,7,13,16,44,59,-15,34
Hibernian,989,1,20,12,4,64,25,39,72
Morton,989,2,16,13,7,52,36,16,61
Dundee Utd,989,3,17,8,11,53,40,13,59
Falkirk,989,4,16,10,10,59,43,16,58
Raith,989,5,12,10,14,37,46,-9,46
Dumbarton,989,6,11,12,13,55,56,-1,45
Queen of S't,989,7,10,10,16,41,54,-13,40
Dunfermline,989,8,9,11,16,42,53,-11,38
Ayr,989,9,8,13,15,33,55,-22,37
St Mirren,989,10,6,11,19,37,65,-28,29
Hibernian,990,1,19,12,5,56,26,30,69
Morton,990,2,19,12,5,50,32,18,69
Dundee Utd,990,3,18,9,9,51,38,13,63
Falkirk,990,4,17,10,9,63,43,20,61
Queen of S't,990,5,12,9,15,42,46,-4,45
Dunfermline,990,6,10,13,13,45,46,-1,43
Raith,990,7,9,10,17,33,52,-19,37
Dumbarton,990,8,8,12,16,45,56,-11,36
St Mirren,990,9,8,9,19,35,56,-21,33
Ayr,990,10,6,12,18,29,54,-25,30
Hibernian,991,1,19,12,5,54,28,26,69
Morton,991,2,17,10,9,49,36,13,61
Falkirk,991,3,17,9,10,61,45,16,60
Dundee Utd,991,4,15,10,11,53,41,12,55
Raith,991,5,12,9,15,37,51,-14,45
Dunfermline,991,6,11,11,14,51,49,2,44
Queen of S't,991,7,11,10,15,45,52,-7,43
Dumbarton,991,8,10,11,15,52,60,-8,41
St Mirren,991,9,9,9,18,42,56,-14,36
Ayr,991,10,8,11,17,32,58,-26,35
Hibernian,992,1,20,11,5,61,28,33,71
Falkirk,992,2,17,11,8,59,40,19,62
Morton,992,3,17,10,9,56,39,17,61
Dundee Utd,992,4,16,9,11,48,41,7,57
Queen of S't,992,5,14,8,14,46,49,-3,50
Raith,992,6,10,12,14,36,43,-7,42
Dunfermline,992,7,9,13,14,49,55,-6,40
Dumbarton,992,8,9,11,16,47,61,-14,38
St Mirren,992,9,8,10,18,41,59,-18,34
Ayr,992,10,7,11,18,30,58,-28,32
Hibernian,993,1,22,10,4,57,22,35,76
Falkirk,993,2,16,10,10,54,39,15,58
Dundee Utd,993,3,16,10,10,52,40,12,58
Morton,993,4,15,10,11,50,43,7,55
Queen of S't,993,5,12,11,13,44,43,1,47
St Mirren,993,6,11,10,15,46,58,-12,43
Dumbarton,993,7,10,12,14,54,60,-6,42
Dunfermline,993,8,9,12,15,46,51,-5,39
Raith,993,9,8,10,18,31,52,-21,34
Ayr,993,10,7,13,16,34,60,-26,34
Morton,994,1,18,11,7,53,35,18,65
Hibernian,994,2,17,13,6,55,30,25,64
Falkirk,994,3,16,11,9,62,40,22,59
Dundee Utd,994,4,16,10,10,52,40,12,58
Queen of S't,994,5,12,10,14,44,48,-4,46
Dumbarton,994,6,10,11,15,50,56,-6,41
Dunfermline,994,7,9,12,15,49,58,-9,39
Raith,994,8,9,12,15,35,55,-20,39
Ayr,994,9,8,14,14,32,53,-21,38
St Mirren,994,10,6,14,16,38,55,-17,32
Hibernian,995,1,19,11,6,54,28,26,68
Morton,995,2,18,10,8,50,32,18,64
Falkirk,995,3,16,12,8,64,43,21,60
Dundee Utd,995,4,16,10,10,56,42,14,58
Queen of S't,995,5,11,10,15,52,55,-3,43
Raith,995,6,11,9,16,38,54,-16,42
Dunfermline,995,7,9,12,15,43,54,-11,39
Dumbarton,995,8,8,14,14,51,60,-9,38
St Mirren,995,9,9,11,16,40,55,-15,38
Ayr,995,10,8,11,17,35,60,-25,35
Hibernian,996,1,20,12,4,58,24,34,72
Falkirk,996,2,16,13,7,60,38,22,61
Morton,996,3,16,11,9,52,43,9,59
Dundee Utd,996,4,15,11,10,54,43,11,56
Dunfermline,996,5,11,12,13,46,51,-5,45
Queen of S't,996,6,10,12,14,44,51,-7,42
Dumbarton,996,7,9,12,15,49,58,-9,39
St Mirren,996,8,9,11,16,42,55,-13,38
Raith,996,9,9,9,18,34,53,-19,36
Ayr,996,10,7,13,16,31,54,-23,34
Hibernian,997,1,19,12,5,54,28,26,69
Morton,997,2,17,11,8,49,37,12,62
Dundee Utd,997,3,17,10,9,55,41,14,61
Falkirk,997,4,16,10,10,61,41,20,58
Dunfermline,997,5,10,14,12,45,48,-3,44
Queen of S't,997,6,11,10,15,44,49,-5,43
Raith,997,7,10,10,16,37,49,-12,40
Ayr,997,8,8,13,15,37,54,-17,37
St Mirren,997,9,8,11,17,43,60,-17,35
Dumbarton,997,10,8,11,17,45,63,-18,35
Falkirk,998,1,17,11,8,63,38,25,62
Hibernian,998,2,17,11,8,51,29,22,62
Morton,998,3,17,10,9,51,42,9,61
Dundee Utd,998,4,14,12,10,47,38,9,54
Queen of S't,998,5,13,10,13,48,49,-1,49
Dunfermline,998,6,11,12,13,51,47,4,45
Ayr,998,7,9,13,14,36,52,-16,40
Raith,998,7,10,10,16,36,52,-16,40
St Mirren,998,9,9,11,16,41,56,-15,38
Dumbarton,998,10,7,12,17,43,64,-21,33
Hibernian,999,1,22,11,3,56,22,34,77
Dundee Utd,999,2,17,10,9,54,41,13,61
Falkirk,999,3,15,12,9,56,40,16,57
Morton,999,4,15,12,9,49,42,7,57
Queen of S't,999,5,11,11,14,48,52,-4,44
Ayr,999,6,10,12,14,37,52,-15,42
Dunfermline,999,7,10,11,15,49,51,-2,41
Dumbarton,999,8,9,12,15,48,59,-11,39
St Mirren,999,9,8,10,18,38,56,-18,34
Raith,999,10,8,9,19,34,54,-20,33
Morton,1000,1,19,11,6,52,32,20,68
Hibernian,1000,2,18,12,6,51,25,26,66
Falkirk,1000,3,18,10,8,61,37,24,64
Dundee Utd,1000,4,16,9,11,53,45,8,57
Queen of S't,1000,5,12,10,14,45,52,-7,46
Dumbarton,1000,6,10,11,15,50,57,-7,41
Dunfermline,1000,7,9,13,14,45,50,-5,40
Raith,1000,8,9,10,17,36,53,-17,37
St Mirren,1000,9,8,12,16,39,54,-15,36
Ayr,1000,10,7,10,19,31,58,-27,31
Hibernian,1001,1,21,11,4,56,23,33,74
Dundee Utd,1001,2,17,9,10,53,36,17,60
Morton,1001,3,13,13,10,44,38,6,52
Falkirk,1001,4,13,12,11,52,42,10,51
Queen of S't,1001,5,13,8,15,44,46,-2,47
Dumbarton,1001,6,11,11,14,52,57,-5,44
St Mirren,1001,7,11,11,14,40,50,-10,44
Raith,1001,8,10,10,16,35,49,-14,40
Dunfermline,1001,9,8,15,13,46,55,-9,39
Ayr,1001,10,8,10,18,29,55,-26,34
Hibernian,1002,1,18,12,6,55,29,26,66
Morton,1002,2,17,10,9,51,40,11,61
Falkirk,1002,3,16,11,9,60,41,19,59
Dundee Utd,1002,4,15,8,13,48,46,2,53
Raith,1002,5,12,9,15,39,50,-11,45
Dumbarton,1002,6,10,12,14,53,59,-6,42
Queen of S't,1002,7,11,9,16,48,54,-6,42
Ayr,1002,8,10,12,14,39,54,-15,42
Dunfermline,1002,9,9,13,14,46,51,-5,40
St Mirren,1002,10,9,10,17,40,55,-15,37
Hibernian,1003,1,22,11,3,65,25,40,77
Dundee Utd,1003,2,16,10,10,53,41,12,58
Morton,1003,3,15,13,8,51,42,9,58
Falkirk,1003,4,15,11,10,59,44,15,56
Ayr,1003,5,10,13,13,38,52,-14,43
Dumbarton,1003,6,10,12,14,52,57,-5,42
Dunfermline,1003,7,9,14,13,47,51,-4,41
Raith,1003,8,10,10,16,33,51,-18,40
Queen of S't,1003,9,9,10,17,41,56,-15,37
St Mirren,1003,10,7,10,19,36,56,-20,31
Hibernian,1004,1,20,12,4,60,26,34,72
Falkirk,1004,2,17,9,10,58,43,15,60
Dundee Utd,1004,3,16,9,11,54,46,8,57
Morton,1004,4,15,11,10,47,40,7,56
Dumbarton,1004,5,13,10,13,50,50,0,49
Queen of S't,1004,6,12,8,16,46,49,-3,44
Dunfermline,1004,7,10,12,14,49,55,-6,42
Raith,1004,8,11,9,16,36,47,-11,42
St Mirren,1004,9,8,10,18,37,57,-20,34
Ayr,1004,10,6,14,16,33,57,-24,32
Hibernian,1005,1,21,11,4,58,26,32,74
Dundee Utd,1005,2,17,10,9,57,39,18,61
Morton,1005,3,15,11,10,52,39,13,56
Falkirk,1005,4,14,13,9,58,44,14,55
Raith,1005,5,11,10,15,33,48,-15,43
Ayr,1005,6,11,10,15,44,61,-17,43
Queen of S't,1005,7,11,8,17,44,53,-9,41
Dunfermline,1005,8,9,13,14,44,53,-9,40
Dumbarton,1005,9,9,10,17,48,64,-16,37
St Mirren,1005,10,8,12,16,43,54,-11,36
Hibernian,1006,1,20,12,4,60,27,33,72
Falkirk,1006,2,15,13,8,57,39,18,58
Morton,1006,3,15,13,8,47,35,12,58
Dundee Utd,1006,4,14,11,11,45,42,3,53
Queen of S't,1006,5,13,9,14,51,52,-1,48
Raith,1006,6,10,11,15,32,48,-16,41
St Mirren,1006,7,9,12,15,42,54,-12,39
Ayr,1006,8,9,12,15,36,53,-17,39
Dumbarton,1006,9,8,13,15,50,61,-11,37
Dunfermline,1006,10,7,14,15,42,51,-9,35
Hibernian,1007,1,20,13,3,58,21,37,73
Falkirk,1007,2,18,11,7,66,37,29,65
Morton,1007,3,16,11,9,52,36,16,59
Dundee Utd,1007,4,16,11,9,56,43,13,59
Queen of S't,1007,5,12,9,15,48,52,-4,45
Dunfermline,1007,6,10,12,14,46,52,-6,42
Dumbarton,1007,7,8,13,15,44,59,-15,37
Raith,1007,8,9,9,18,34,54,-20,36
Ayr,1007,9,7,14,15,33,55,-22,35
St Mirren,1007,10,8,9,19,39,67,-28,33
Hibernian,1008,1,19,13,4,57,25,32,70
Dundee Utd,1008,2,18,9,9,58,39,19,63
Falkirk,1008,3,15,12,9,57,42,15,57
Morton,1008,4,15,12,9,49,40,9,57
Queen of S't,1008,5,11,10,15,45,54,-9,43
Ayr,1008,6,10,12,14,38,53,-15,42
Raith,1008,7,11,9,16,35,53,-18,42
Dunfermline,1008,8,9,13,14,43,48,-5,40
Dumbarton,1008,9,8,12,16,49,59,-10,36
St Mirren,1008,10,8,10,18,42,60,-18,34
Morton,1009,1,19,10,7,52,32,20,67
Hibernian,1009,2,18,11,7,52,30,22,65
Falkirk,1009,3,17,10,9,59,40,19,61
Dundee Utd,1009,4,16,9,11,53,47,6,57
Queen of S't,1009,5,13,9,14,45,47,-2,48
Dumbarton,1009,6,11,13,12,53,53,0,46
Raith,1009,7,10,9,17,36,50,-14,39
Ayr,1009,8,8,13,15,36,56,-20,37
St Mirren,1009,9,8,10,18,41,58,-17,34
Dunfermline,1009,10,7,12,17,42,56,-14,33
Hibernian,1010,1,17,12,7,51,26,25,63
Morton,1010,2,17,12,7,48,34,14,63
Falkirk,1010,3,16,11,9,59,40,19,59
Dundee Utd,1010,4,14,13,9,49,43,6,55
Queen of S't,1010,5,12,10,14,49,51,-2,46
Dunfermline,1010,6,10,13,13,43,46,-3,43
St Mirren,1010,7,11,9,16,46,53,-7,42
Raith,1010,8,9,11,16,35,52,-17,38
Dumbarton,1010,9,8,13,15,48,60,-12,37
Ayr,1010,10,7,14,15,34,57,-23,35
Morton,1011,1,18,13,5,52,33,19,67
Hibernian,1011,2,18,12,6,56,28,28,66
Falkirk,1011,3,15,14,7,59,41,18,59
Dundee Utd,1011,4,15,10,11,49,41,8,55
Queen of S't,1011,5,12,10,14,50,48,2,46
Dunfermline,1011,6,10,13,13,45,46,-1,43
Raith,1011,7,9,12,15,35,53,-18,39
St Mirren,1011,8,9,10,17,43,57,-14,37
Dumbarton,1011,9,8,12,16,48,62,-14,36
Ayr,1011,10,7,12,17,31,59,-28,33
Hibernian,1012,1,19,10,7,56,25,31,67
Morton,1012,2,19,10,7,51,35,16,67
Falkirk,1012,3,15,12,9,57,43,14,57
Queen of S't,1012,4,15,8,13,49,47,2,53
Dundee Utd,1012,5,14,10,12,48,43,5,52
Dumbarton,1012,6,10,12,14,48,56,-8,42
Dunfermline,1012,7,9,12,15,43,48,-5,39
Ayr,1012,8,9,12,15,33,50,-17,39
Raith,1012,9,9,9,18,31,51,-20,36
St Mirren,1012,10,8,11,17,41,59,-18,35
Hibernian,1013,1,19,12,5,53,24,29,69
Morton,1013,2,17,11,8,51,39,12,62
Dundee Utd,1013,3,16,10,10,53,45,8,58
Falkirk,1013,4,14,12,10,55,39,16,54
Queen of S't,1013,5,12,9,15,41,48,-7,45
Dumbarton,1013,6,11,11,14,50,60,-10,44
Raith,1013,7,10,11,15,37,47,-10,41
St Mirren,1013,8,9,11,16,43,53,-10,38
Dunfermline,1013,9,8,13,15,45,52,-7,37
Ayr,1013,10,7,14,15,34,55,-21,35
Hibernian,1014,1,19,13,4,56,27,29,70
Falkirk,1014,2,17,11,8,64,39,25,62
Morton,1014,3,16,11,9,50,36,14,59
Dundee Utd,1014,4,15,10,11,51,40,11,55
Raith,1014,5,12,10,14,40,44,-4,46
Queen of S't,1014,6,10,12,14,45,53,-8,42
Dunfermline,1014,7,8,16,12,43,48,-5,40
St Mirren,1014,8,10,9,17,43,61,-18,39
Dumbarton,1014,9,8,11,17,47,67,-20,35
Ayr,1014,10,7,13,16,32,56,-24,34
Hibernian,1015,1,20,11,5,56,29,27,71
Dundee Utd,1015,2,17,11,8,57,38,19,62
Morton,1015,3,17,11,8,52,36,16,62
Falkirk,1015,4,15,12,9,55,38,17,57
Queen of S't,1015,5,11,10,15,47,55,-8,43
Dunfermline,1015,6,9,15,12,46,49,-3,42
Raith,1015,7,10,10,16,33,47,-14,40
Dumbarton,1015,8,8,12,16,44,60,-16,36
Ayr,1015,9,8,12,16,33,53,-20,36
St Mirren,1015,10,7,12,17,38,56,-18,33
Hibernian,1016,1,19,12,5,55,26,29,69
Morton,1016,2,16,12,8,49,35,14,60
Dundee Utd,1016,3,16,10,10,55,43,12,58
Falkirk,1016,4,16,9,11,65,50,15,57
Queen of S't,1016,5,13,9,14,49,50,-1,48
Dunfermline,1016,6,10,13,13,50,55,-5,43
Raith,1016,7,11,9,16,33,47,-14,42
Dumbarton,1016,8,9,13,14,52,62,-10,40
St Mirren,1016,9,9,10,17,45,57,-12,37
Ayr,1016,10,7,11,18,30,58,-28,32
Hibernian,1017,1,20,10,6,55,28,27,70
Falkirk,1017,2,17,11,8,58,40,18,62
Morton,1017,3,17,11,8,56,41,15,62
Dundee Utd,1017,4,15,10,11,51,42,9,55
Queen of S't,1017,5,12,10,14,47,49,-2,46
Dunfermline,1017,6,10,14,12,47,48,-1,44
Ayr,1017,7,10,10,16,37,56,-19,40
St Mirren,1017,8,9,11,16,43,56,-13,38
Raith,1017,9,9,8,19,33,52,-19,35
Dumbarton,1017,10,7,13,16,50,65,-15,34
Hibernian,1018,1,22,11,3,58,22,36,77
Morton,1018,2,17,9,10,49,37,12,60
Dundee Utd,1018,3,16,10,10,50,36,14,58
Falkirk,1018,4,15,11,10,53,39,14,56
Queen of S't,1018,5,13,9,14,45,52,-7,48
Dunfermline,1018,6,10,12,14,45,52,-7,42
Raith,1018,7,10,8,18,36,50,-14,38
Dumbarton,1018,8,8,13,15,42,55,-13,37
Ayr,1018,9,8,13,15,34,53,-19,37
St Mirren,1018,10,8,10,18,41,57,-16,34
Hibernian,1019,1,22,10,4,61,24,37,76
Dundee Utd,1019,2,17,8,11,52,37,15,59
Falkirk,1019,3,15,10,11,57,41,16,55
Morton,1019,4,15,10,11,47,39,8,55
Queen of S't,1019,5,13,9,14,44,49,-5,48
Dunfermline,1019,6,11,14,11,48,46,2,47
Dumbarton,1019,7,10,10,16,49,61,-12,40
Raith,1019,8,10,10,16,34,49,-15,40
St Mirren,1019,9,9,11,16,37,54,-17,38
Ayr,1019,10,7,10,19,30,59,-29,31
Hibernian,1020,1,22,10,4,60,25,35,76
Morton,1020,2,17,12,7,54,37,17,63
Dundee Utd,1020,3,16,10,10,52,43,9,58
Falkirk,1020,4,15,10,11,54,41,13,55
Dunfermline,1020,5,10,14,12,47,48,-1,44
Queen of S't,1020,6,12,8,16,45,49,-4,44
Dumbarton,1020,7,10,12,14,48,54,-6,42
Raith,1020,8,9,12,15,33,47,-14,39
St Mirren,1020,9,8,9,19,38,58,-20,33
Ayr,1020,10,7,11,18,35,64,-29,32
Hibernian,1021,1,21,12,3,63,26,37,75
Falkirk,1021,2,18,10,8,61,37,24,64
Morton,1021,3,16,11,9,49,41,8,59
Dundee Utd,1021,4,16,10,10,57,39,18,58
Dunfermline,1021,5,10,14,12,50,55,-5,44
Queen of S't,1021,6,10,12,14,44,53,-9,42
Raith,1021,7,10,10,16,41,52,-11,40
Dumbarton,1021,8,8,11,17,46,61,-15,35
Ayr,1021,9,8,10,18,34,63,-29,34
St Mirren,1021,10,7,12,17,39,57,-18,33
Hibernian,1022,1,20,11,5,57,28,29,71
Morton,1022,2,16,14,6,51,39,12,62
Falkirk,1022,3,17,10,9,59,39,20,61
Dundee Utd,1022,4,15,11,10,49,39,10,56
Queen of S't,1022,5,11,10,15,45,55,-10,43
Ayr,1022,6,10,12,14,38,52,-14,42
Raith,1022,7,10,10,16,41,51,-10,40
Dunfermline,1022,8,8,14,14,47,52,-5,38
Dumbarton,1022,9,9,10,17,47,61,-14,37
St Mirren,1022,10,8,10,18,36,54,-18,34
Hibernian,1023,1,21,11,4,58,23,35,74
Falkirk,1023,2,17,9,10,58,37,21,60
Dundee Utd,1023,3,17,9,10,54,38,16,60
Morton,1023,4,16,12,8,52,38,14,60
Dunfermline,1023,5,12,12,12,49,48,1,48
Queen of S't,1023,6,10,10,16,43,55,-12,40
Raith,1023,7,10,9,17,36,49,-13,39
St Mirren,1023,8,9,10,17,38,54,-16,37
Dumbarton,1023,9,9,10,17,43,63,-20,37
Ayr,1023,10,7,12,17,29,55,-26,33
Hibernian,1024,1,19,11,6,56,24,32,68
Morton,1024,2,18,10,8,51,37,14,64
Dundee Utd,1024,3,18,9,9,52,37,15,63
Falkirk,1024,4,14,11,11,56,47,9,53
Dunfermline,1024,5,9,15,12,45,50,-5,42
Queen of S't,1024,6,10,11,15,41,50,-9,41
St Mirren,1024,7,10,10,16,40,53,-13,40
Raith,1024,8,10,10,16,34,49,-15,40
Dumbarton,1024,9,9,12,15,50,57,-7,39
Ayr,1024,10,8,11,17,30,51,-21,35
Hibernian,1025,1,18,13,5,57,27,30,67
Morton,1025,2,16,14,6,49,35,14,62
Dundee Utd,1025,3,15,13,8,54,41,13,58
Falkirk,1025,4,15,9,12,57,46,11,54
Dunfermline,1025,5,10,15,11,50,48,2,45
Raith,1025,6,11,11,14,38,49,-11,44
Queen of S't,1025,7,10,12,14,45,51,-6,42
Dumbarton,1025,8,9,11,16,46,62,-16,38
Ayr,1025,9,8,12,16,37,54,-17,36
St Mirren,1025,10,8,10,18,39,59,-20,34
Morton,1026,1,20,10,6,54,34,20,70
Hibernian,1026,2,18,13,5,58,27,31,67
Falkirk,1026,3,16,12,8,60,39,21,60
Dundee Utd,1026,4,16,10,10,48,42,6,58
Dunfermline,1026,5,9,14,13,44,46,-2,41
Queen of S't,1026,6,10,10,16,43,54,-11,40
Dumbarton,1026,7,9,12,15,45,55,-10,39
Raith,1026,8,10,9,17,37,54,-17,39
St Mirren,1026,9,8,11,17,41,56,-15,35
Ayr,1026,10,8,11,17,31,54,-23,35
Hibernian,1027,1,19,12,5,55,24,31,69
Dundee Utd,1027,2,18,9,9,53,37,16,63
Falkirk,1027,3,17,10,9,63,42,21,61
Morton,1027,4,15,13,8,45,34,11,58
Dunfermline,1027,5,11,14,11,48,49,-1,47
Queen of S't,1027,6,11,8,17,48,58,-10,41
Dumbarton,1027,7,8,14,14,46,56,-10,38
Raith,1027,8,10,8,18,36,53,-17,38
St Mirren,1027,9,8,11,17,40,56,-16,35
Ayr,1027,10,8,11,17,36,61,-25,35
Hibernian,1028,1,20,11,5,54,23,31,71
Morton,1028,2,17,12,7,50,34,16,63
Falkirk,1028,3,16,9,11,57,45,12,57
Dundee Utd,1028,4,15,12,9,51,41,10,57
Ayr,1028,5,10,13,13,33,50,-17,43
Dunfermline,1028,6,9,15,12,47,49,-2,42
Queen of S't,1028,7,10,12,14,43,49,-6,42
Raith,1028,8,10,10,16,35,46,-11,40
Dumbarton,1028,9,9,11,16,46,57,-11,38
St Mirren,1028,10,7,9,20,35,57,-22,30
Morton,1029,1,20,10,6,51,31,20,70
Hibernian,1029,2,18,10,8,51,28,23,64
Falkirk,1029,3,17,11,8,62,39,23,62
Dundee Utd,1029,4,17,9,10,49,37,12,60
Raith,1029,5,13,8,15,43,46,-3,47
Queen of S't,1029,6,10,11,15,41,51,-10,41
Dunfermline,1029,7,9,11,16,42,53,-11,38
Dumbarton,1029,8,7,14,15,43,56,-13,35
St Mirren,1029,9,8,11,17,39,55,-16,35
Ayr,1029,10,8,11,17,30,55,-25,35
Hibernian,1030,1,20,10,6,59,29,30,70
Morton,1030,2,18,11,7,49,32,17,65
Dundee Utd,1030,3,18,9,9,61,39,22,63
Falkirk,1030,4,16,10,10,57,43,14,58
Queen of S't,1030,5,12,10,14,46,51,-5,46
Raith,1030,6,10,10,16,36,49,-13,40
Ayr,1030,7,9,13,14,35,54,-19,40
Dunfermline,1030,8,8,12,16,42,52,-10,36
Dumbarton,1030,9,8,12,16,43,56,-13,36
St Mirren,1030,10,7,11,18,38,61,-23,32
Hibernian,1031,1,21,11,4,59,25,34,74
Morton,1031,2,17,11,8,52,41,11,62
Dundee Utd,1031,3,17,10,9,50,38,12,61
Falkirk,1031,4,15,10,11,60,45,15,55
Raith,1031,5,12,9,15,37,48,-11,45
Queen of S't,1031,6,12,8,16,45,49,-4,44
Dunfermline,1031,7,10,12,14,44,48,-4,42
Dumbarton,1031,8,8,13,15,52,64,-12,37
Ayr,1031,9,7,13,16,35,55,-20,34
St Mirren,1031,10,7,11,18,38,59,-21,32
Hibernian,1032,1,17,13,6,57,30,27,64
Falkirk,1032,2,16,10,10,58,48,10,58
Morton,1032,3,16,10,10,49,40,9,58
Dundee Utd,1032,4,16,9,11,57,44,13,57
Dunfermline,1032,5,12,12,12,54,51,3,48
Queen of S't,1032,6,11,12,13,46,50,-4,45
Raith,1032,7,11,9,16,36,47,-11,42
Dumbarton,1032,8,9,12,15,50,61,-11,39
St Mirren,1032,9,9,10,17,38,54,-16,37
Ayr,1032,10,8,13,15,34,54,-20,37
Hibernian,1033,1,18,14,4,53,25,28,68
Morton,1033,2,18,11,7,50,35,15,65
Dundee Utd,1033,3,16,10,10,57,39,18,58
Falkirk,1033,4,15,10,11,57,45,12,55
Queen of S't,1033,5,12,9,15,44,49,-5,45
Dumbarton,1033,6,10,11,15,53,62,-9,41
Ayr,1033,7,10,11,15,38,58,-20,41
Dunfermline,1033,8,9,13,14,44,49,-5,40
St Mirren,1033,9,9,12,15,41,53,-12,39
Raith,1033,10,8,9,19,32,54,-22,33
Hibernian,1034,1,18,13,5,53,26,27,67
Morton,1034,2,16,13,7,48,37,11,61
Falkirk,1034,3,17,9,10,64,43,21,60
Dundee Utd,1034,4,13,12,11,50,49,1,51
Dunfermline,1034,5,13,11,12,52,47,5,50
Dumbarton,1034,6,12,11,13,52,54,-2,47
Raith,1034,7,11,9,16,42,50,-8,42
Queen of S't,1034,8,10,9,17,42,53,-11,39
St Mirren,1034,9,8,12,16,42,56,-14,36
Ayr,1034,10,6,13,17,31,61,-30,31
Hibernian,1035,1,20,11,5,55,24,31,71
Morton,1035,2,15,13,8,47,36,11,58
Falkirk,1035,3,15,12,9,60,42,18,57
Dundee Utd,1035,4,15,11,10,44,36,8,56
Dunfermline,1035,5,10,15,11,45,44,1,45
Ayr,1035,6,11,11,14,38,53,-15,44
Queen of S't,1035,7,11,9,16,45,54,-9,42
Dumbarton,1035,8,9,12,15,45,54,-9,39
Raith,1035,9,8,12,16,35,53,-18,36
St Mirren,1035,10,8,10,18,39,57,-18,34
Morton,1036,1,19,12,5,55,31,24,69
Hibernian,1036,2,17,14,5,50,24,26,65
Falkirk,1036,3,18,9,9,67,44,23,63
Dundee Utd,1036,4,15,9,12,51,42,9,54
Dunfermline,1036,5,10,13,13,47,51,-4,43
Queen of S't,1036,6,11,8,17,39,50,-11,41
Dumbarton,1036,7,9,12,15,49,59,-10,39
Ayr,1036,8,9,12,15,34,54,-20,39
St Mirren,1036,9,8,12,16,40,57,-17,36
Raith,1036,10,8,11,17,32,52,-20,35
Hibernian,1037,1,19,12,5,53,23,30,69
Morton,1037,2,18,11,7,51,35,16,65
Falkirk,1037,3,16,10,10,59,41,18,58
Dundee Utd,1037,4,15,10,11,48,38,10,55
Queen of S't,1037,5,14,9,13,50,48,2,51
Dunfermline,1037,6,10,13,13,48,48,0,43
Raith,1037,7,9,11,16,34,54,-20,38
Dumbarton,1037,8,8,12,16,49,66,-17,36
St Mirren,1037,9,8,11,17,43,59,-16,35
Ayr,1037,10,7,13,16,33,56,-23,34
Hibernian,1038,1,22,10,4,58,23,35,76
Morton,1038,2,15,12,9,46,35,11,57
Falkirk,1038,3,14,11,11,57,46,11,53
Dundee Utd,1038,4,15,8,13,50,44,6,53
Queen of S't,1038,5,13,10,13,44,44,0,49
Dumbarton,1038,6,10,11,15,49,62,-13,41
St Mirren,1038,7,9,13,14,42,54,-12,40
Dunfermline,1038,8,9,12,15,45,49,-4,39
Ayr,1038,9,9,12,15,36,57,-21,39
Raith,1038,10,9,11,16,37,50,-13,38
Hibernian,1039,1,20,11,5,59,27,32,71
Morton,1039,2,17,12,7,54,34,20,63
Dundee Utd,1039,3,16,10,10,57,44,13,58
Falkirk,1039,4,16,9,11,61,45,16,57
Raith,1039,5,12,9,15,38,45,-7,45
Queen of S't,1039,6,12,8,16,48,55,-7,44
Dunfermline,1039,7,9,14,13,49,50,-1,41
Ayr,1039,8,9,13,14,37,56,-19,40
St Mirren,1039,9,8,11,17,40,62,-22,35
Dumbarton,1039,10,7,11,18,44,69,-25,32
Hibernian,1040,1,20,12,4,59,25,34,72
Morton,1040,2,16,13,7,49,34,15,61
Dundee Utd,1040,3,16,9,11,48,40,8,57
Falkirk,1040,4,15,11,10,57,41,16,56
Dunfermline,1040,5,11,11,14,50,55,-5,44
Queen of S't,1040,6,10,13,13,48,54,-6,43
St Mirren,1040,7,9,12,15,44,57,-13,39
Raith,1040,8,9,11,16,38,54,-16,38
Ayr,1040,9,8,13,15,35,55,-20,37
Dumbarton,1040,10,8,11,17,47,60,-13,35
Hibernian,1041,1,20,11,5,59,26,33,71
Morton,1041,2,20,9,7,53,35,18,69
Dundee Utd,1041,3,17,11,8,51,38,13,62
Falkirk,1041,4,15,11,10,57,45,12,56
Dumbarton,1041,5,10,12,14,53,56,-3,42
Queen of S't,1041,6,9,13,14,42,50,-8,40
Raith,1041,7,10,10,16,36,50,-14,40
Dunfermline,1041,8,9,11,16,42,49,-7,38
St Mirren,1041,9,8,10,18,41,59,-18,34
Ayr,1041,10,6,14,16,30,56,-26,32
Hibernian,1042,1,19,12,5,54,26,28,69
Morton,1042,2,18,11,7,55,37,18,65
Dundee Utd,1042,3,16,10,10,53,44,9,58
Falkirk,1042,4,15,10,11,57,43,14,55
Dunfermline,1042,5,13,12,11,53,46,7,51
Raith,1042,6,11,10,15,37,48,-11,43
Queen of S't,1042,7,10,10,16,41,51,-10,40
Ayr,1042,8,9,11,16,39,55,-16,38
Dumbarton,1042,9,8,13,15,49,65,-16,37
St Mirren,1042,10,6,11,19,37,60,-23,29
Hibernian,1043,1,18,11,7,52,27,25,65
Falkirk,1043,2,17,10,9,62,38,24,61
Morton,1043,3,16,12,8,48,36,12,60
Dundee Utd,1043,4,16,10,10,51,38,13,58
Queen of S't,1043,5,13,8,15,44,52,-8,47
Dunfermline,1043,6,11,13,12,51,45,6,46
St Mirren,1043,7,11,10,15,44,53,-9,43
Raith,1043,8,10,9,17,35,53,-18,39
Ayr,1043,9,9,11,16,34,55,-21,38
Dumbarton,1043,10,7,10,19,43,67,-24,31
Hibernian,1044,1,21,10,5,57,25,32,73
Falkirk,1044,2,17,10,9,59,40,19,61
Dundee Utd,1044,3,17,10,9,51,37,14,61
Morton,1044,4,16,10,10,49,43,6,58
Dunfermline,1044,5,10,13,13,46,47,-1,43
Queen of S't,1044,6,11,10,15,44,51,-7,43
Dumbarton,1044,7,10,10,16,48,58,-10,40
Raith,1044,8,9,10,17,33,47,-14,37
Ayr,1044,9,8,13,15,32,50,-18,37
St Mirren,1044,10,8,10,18,40,61,-21,34
Hibernian,1045,1,19,13,4,54,24,30,70
Falkirk,1045,2,15,13,8,60,41,19,58
Morton,1045,3,15,11,10,47,41,6,56
Dundee Utd,1045,4,15,10,11,52,43,9,55
Dunfermline,1045,5,12,12,12,51,46,5,48
Raith,1045,6,11,11,14,36,46,-10,44
Dumbarton,1045,7,10,12,14,51,57,-6,42
Queen of S't,1045,8,10,11,15,44,55,-11,41
Ayr,1045,9,7,14,15,34,57,-23,35
St Mirren,1045,10,7,11,18,37,56,-19,32
Hibernian,1046,1,19,11,6,57,29,28,68
Morton,1046,2,17,12,7,51,33,18,63
Dundee Utd,1046,3,17,10,9,55,37,18,61
Falkirk,1046,4,17,9,10,58,39,19,60
Queen of S't,1046,5,13,9,14,45,50,-5,48
Dunfermline,1046,6,11,13,12,43,43,0,46
Raith,1046,7,10,9,17,36,50,-14,39
Ayr,1046,8,9,10,17,34,58,-24,37
St Mirren,1046,9,8,10,18,39,58,-19,34
Dumbarton,1046,10,7,11,18,42,63,-21,32
Hibernian,1047,1,21,12,3,63,26,37,75
Morton,1047,2,17,11,8,56,42,14,62
Dundee Utd,1047,3,16,10,10,56,42,14,58
Falkirk,1047,4,15,11,10,58,45,13,56
Dumbarton,1047,5,10,13,13,52,60,-8,43
Queen of S't,1047,6,11,9,16,45,52,-7,42
Dunfermline,1047,7,9,12,15,45,52,-7,39
Ayr,1047,8,8,15,13,37,57,-20,39
Raith,1047,9,8,11,17,31,49,-18,35
St Mirren,1047,10,8,10,18,38,56,-18,34
Hibernian,1048,1,19,12,5,54,25,29,69
Morton,1048,2,16,13,7,52,40,12,61
Falkirk,1048,3,16,12,8,65,44,21,60
Dundee Utd,1048,4,16,10,10,57,46,11,58
Dunfermline,1048,5,10,14,12,47,48,-1,44
Queen of S't,1048,6,11,10,15,47,52,-5,43
Raith,1048,7,11,9,16,37,51,-14,42
Dumbarton,1048,8,10,11,15,51,62,-11,41
St Mirren,1048,9,9,10,17,44,57,-13,37
Ayr,1048,10,6,11,19,32,61,-29,29
Hibernian,1049,1,19,12,5,52,27,25,69
Falkirk,1049,2,17,9,10,61,42,19,60
Morton,1049,3,15,11,10,46,37,9,56
Dundee Utd,1049,4,15,9,12,50,47,3,54
Queen of S't,1049,5,14,9,13,53,49,4,51
Dunfermline,1049,6,10,15,11,47,46,1,45
Ayr,1049,7,10,12,14,36,50,-14,42
Raith,1049,8,9,10,17,32,47,-15,37
St Mirren,1049,9,9,10,17,37,53,-16,37
Dumbarton,1049,10,8,11,17,45,61,-16,35
Hibernian,1050,1,22,11,3,64,23,41,77
Morton,1050,2,19,10,7,60,40,20,67
Dundee Utd,1050,3,18,8,10,55,43,12,62
Falkirk,1050,4,16,10,10,60,43,17,58
Queen of S't,1050,5,12,9,15,52,50,2,45
Dumbarton,1050,6,11,10,15,52,65,-13,43
Raith,1050,7,11,10,15,38,53,-15,43
Dunfermline,1050,8,8,13,15,45,51,-6,37
St Mirren,1050,9,7,9,20,38,62,-24,30
Ayr,1050,10,6,10,20,28,62,-34,28
Hibernian,1051,1,19,13,4,56,26,30,70
Morton,1051,2,16,13,7,47,35,12,61
Dundee Utd,1051,3,15,11,10,48,40,8,56
Falkirk,1051,4,15,10,11,58,48,10,55
Dunfermline,1051,5,11,14,11,45,42,3,47
Raith,1051,6,11,11,14,39,48,-9,44
Queen of S't,1051,7,11,10,15,45,49,-4,43
Ayr,1051,8,9,11,16,39,57,-18,38
St Mirren,1051,9,8,11,17,41,56,-15,35
Dumbarton,1051,10,8,10,18,44,61,-17,34
Hibernian,1052,1,20,11,5,54,24,30,71
Falkirk,1052,2,19,9,8,62,41,21,66
Dundee Utd,1052,3,18,8,10,54,41,13,62
Morton,1052,4,17,11,8,52,41,11,62
Queen of S't,1052,5,10,11,15,42,49,-7,41
Dunfermline,1052,6,9,13,14,45,47,-2,40
Ayr,1052,7,10,10,16,38,58,-20,40
Dumbarton,1052,8,9,11,16,47,58,-11,38
St Mirren,1052,9,8,10,18,40,56,-16,34
Raith,1052,10,8,10,18,31,50,-19,34
Hibernian,1053,1,18,13,5,56,26,30,67
Morton,1053,2,19,10,7,60,34,26,67
Falkirk,1053,3,17,10,9,59,41,18,61
Dundee Utd,1053,4,16,8,12,53,43,10,56
Queen of S't,1053,5,11,11,14,47,52,-5,44
Dunfermline,1053,6,9,13,14,46,53,-7,40
St Mirren,1053,7,9,12,15,39,55,-16,39
Ayr,1053,8,9,11,16,35,56,-21,38
Dumbarton,1053,9,9,10,17,49,61,-12,37
Raith,1053,10,9,10,17,36,59,-23,37
Hibernian,1054,1,21,11,4,60,23,37,74
Falkirk,1054,2,18,9,9,59,36,23,63
Dundee Utd,1054,3,18,9,9,56,37,19,63
Morton,1054,4,17,12,7,50,34,16,63
Dunfermline,1054,5,9,15,12,43,45,-2,42
Raith,1054,6,11,9,16,35,50,-15,42
Queen of S't,1054,7,10,10,16,38,52,-14,40
Dumbarton,1054,8,8,12,16,45,60,-15,36
Ayr,1054,9,8,10,18,35,62,-27,34
St Mirren,1054,10,6,11,19,36,58,-22,29
Hibernian,1055,1,18,13,5,60,27,33,67
Dundee Utd,1055,2,17,10,9,55,40,15,61
Morton,1055,3,16,13,7,50,38,12,61
Falkirk,1055,4,13,11,12,53,44,9,50
Dumbarton,1055,5,12,10,14,57,62,-5,46
Queen of S't,1055,6,12,10,14,49,54,-5,46
Dunfermline,1055,7,8,15,13,48,52,-4,39
St Mirren,1055,8,9,10,17,41,56,-15,37
Raith,1055,9,8,13,15,37,56,-19,37
Ayr,1055,10,8,13,15,39,60,-21,37
Hibernian,1056,1,19,11,6,53,28,25,68
Dundee Utd,1056,2,15,12,9,51,40,11,57
Morton,1056,3,15,12,9,50,42,8,57
Falkirk,1056,4,15,10,11,55,45,10,55
Dunfermline,1056,5,11,11,14,52,48,4,44
Queen of S't,1056,6,11,11,14,48,51,-3,44
Raith,1056,7,10,11,15,35,50,-15,41
Ayr,1056,8,9,14,13,35,52,-17,41
Dumbarton,1056,9,9,12,15,45,54,-9,39
St Mirren,1056,10,9,10,17,45,59,-14,37
Hibernian,1057,1,20,12,4,56,25,31,72
Dundee Utd,1057,2,17,9,10,57,38,19,60
Falkirk,1057,3,15,11,10,55,43,12,56
Morton,1057,4,14,11,11,46,42,4,53
Queen of S't,1057,5,12,9,15,46,49,-3,45
St Mirren,1057,6,11,11,14,40,48,-8,44
Dunfermline,1057,7,10,13,13,49,51,-2,43
Raith,1057,8,10,9,17,33,48,-15,39
Ayr,1057,9,9,12,15,37,61,-24,39
Dumbarton,1057,10,8,11,17,42,56,-14,35
Hibernian,1058,1,20,11,5,53,25,28,71
Morton,1058,2,17,10,9,44,33,11,61
Falkirk,1058,3,15,11,10,59,42,17,56
Dundee Utd,1058,4,15,10,11,52,39,13,55
Dumbarton,1058,5,12,11,13,54,55,-1,47
Raith,1058,6,12,8,16,36,47,-11,44
Dunfermline,1058,7,10,12,14,40,45,-5,42
Queen of S't,1058,8,11,9,16,43,52,-9,42
St Mirren,1058,9,9,10,17,38,56,-18,37
Ayr,1058,10,7,12,17,34,59,-25,33
Hibernian,1059,1,20,11,5,58,23,35,71
Dundee Utd,1059,2,16,11,9,53,40,13,59
Morton,1059,3,15,13,8,45,33,12,58
Falkirk,1059,4,14,10,12,57,46,11,52
Queen of S't,1059,5,13,8,15,47,50,-3,47
Dunfermline,1059,6,11,12,13,45,45,0,45
Raith,1059,7,12,8,16,36,56,-20,44
Ayr,1059,8,9,13,14,34,51,-17,40
Dumbarton,1059,9,9,10,17,47,62,-15,37
St Mirren,1059,10,7,12,17,41,57,-16,33
Hibernian,1060,1,19,11,6,55,26,29,68
Falkirk,1060,2,17,10,9,63,40,23,61
Morton,1060,3,17,10,9,52,41,11,61
Dundee Utd,1060,4,15,9,12,46,42,4,54
Dunfermline,1060,5,13,11,12,53,44,9,50
Queen of S't,1060,6,12,9,15,45,53,-8,45
Dumbarton,1060,7,10,12,14,48,55,-7,42
St Mirren,1060,8,9,9,18,39,57,-18,36
Raith,1060,9,9,9,18,36,60,-24,36
Ayr,1060,10,7,14,15,36,55,-19,35
Hibernian,1061,1,18,14,4,56,28,28,68
Morton,1061,2,16,14,6,50,33,17,62
Falkirk,1061,3,17,10,9,58,41,17,61
Dundee Utd,1061,4,17,10,9,51,39,12,61
Dunfermline,1061,5,10,14,12,49,45,4,44
Raith,1061,6,10,9,17,36,52,-16,39
Queen of S't,1061,7,9,10,17,39,51,-12,37
St Mirren,1061,8,9,10,17,41,58,-17,37
Ayr,1061,9,8,13,15,33,54,-21,37
Dumbarton,1061,10,7,14,15,41,53,-12,35
Hibernian,1062,1,18,11,7,52,29,23,65
Morton,1062,2,18,9,9,50,32,18,63
Falkirk,1062,3,17,11,8,57,37,20,62
Dundee Utd,1062,4,18,8,10,53,41,12,62
Queen of S't,1062,5,13,9,14,47,49,-2,48
Raith,1062,6,12,9,15,37,50,-13,45
Dumbarton,1062,7,10,12,14,50,56,-6,42
Ayr,1062,8,9,12,15,34,52,-18,39
Dunfermline,1062,9,8,11,17,42,52,-10,35
St Mirren,1062,10,6,10,20,33,57,-24,28
Hibernian,1063,1,19,12,5,58,28,30,69
Morton,1063,2,18,12,6,53,32,21,66
Dundee Utd,1063,3,16,11,9,52,42,10,59
Falkirk,1063,4,14,9,13,57,46,11,51
Dunfermline,1063,5,11,15,10,49,43,6,48
Raith,1063,6,11,10,15,33,48,-15,43
Queen of S't,1063,7,11,9,16,46,52,-6,42
Dumbarton,1063,8,9,11,16,43,57,-14,38
Ayr,1063,9,8,11,17,34,55,-21,35
St Mirren,1063,10,8,10,18,40,62,-22,34
Hibernian,1064,1,20,13,3,55,24,31,73
Falkirk,1064,2,18,10,8,66,37,29,64
Dundee Utd,1064,3,17,10,9,54,35,19,61
Morton,1064,4,16,12,8,48,35,13,60
Raith,1064,5,11,9,16,34,46,-12,42
St Mirren,1064,6,10,10,16,43,54,-11,40
Dunfermline,1064,7,8,13,15,42,52,-10,37
Queen of S't,1064,8,9,10,17,43,57,-14,37
Ayr,1064,9,8,12,16,33,58,-25,36
Dumbarton,1064,10,8,11,17,43,63,-20,35
Hibernian,1065,1,18,12,6,54,29,25,66
Morton,1065,2,17,11,8,55,40,15,62
Dundee Utd,1065,3,16,11,9,50,40,10,59
Falkirk,1065,4,15,11,10,55,43,12,56
Dumbarton,1065,5,11,12,13,55,56,-1,45
Raith,1065,6,12,9,15,38,46,-8,45
Queen of S't,1065,7,11,10,15,45,51,-6,43
Dunfermline,1065,8,9,13,14,45,52,-7,40
Ayr,1065,9,8,12,16,33,55,-22,36
St Mirren,1065,10,7,11,18,39,57,-18,32
Hibernian,1066,1,19,13,4,57,26,31,70
Falkirk,1066,2,17,11,8,58,37,21,62
Morton,1066,3,16,12,8,56,42,14,60
Dundee Utd,1066,4,14,10,12,47,43,4,52
Queen of S't,1066,5,12,11,13,49,50,-1,47
Raith,1066,6,10,11,15,34,49,-15,41
Dumbarton,1066,7,10,10,16,52,61,-9,40
Dunfermline,1066,8,8,14,14,47,55,-8,38
Ayr,1066,9,8,13,15,34,51,-17,37
St Mirren,1066,10,8,11,17,38,58,-20,35
Hibernian,1067,1,19,12,5,63,29,34,69
Falkirk,1067,2,17,9,10,61,43,18,60
Morton,1067,3,15,14,7,47,34,13,59
Dundee Utd,1067,4,14,9,13,44,44,0,51
St Mirren,1067,5,11,11,14,50,54,-4,44
Dumbarton,1067,6,11,11,14,52,58,-6,44
Queen of S't,1067,7,11,9,16,53,61,-8,42
Dunfermline,1067,8,9,14,13,46,51,-5,41
Ayr,1067,9,9,11,16,35,56,-21,38
Raith,1067,10,9,10,17,35,56,-21,37
Hibernian,1068,1,19,11,6,53,27,26,68
Falkirk,1068,2,18,11,7,61,35,26,65
Morton,1068,3,17,11,8,53,40,13,62
Dundee Utd,1068,4,13,9,14,45,45,0,48
Queen of S't,1068,5,13,8,15,44,52,-8,47
Dunfermline,1068,6,10,14,12,45,45,0,44
Ayr,1068,7,11,10,15,37,49,-12,43
St Mirren,1068,8,10,11,15,39,50,-11,41
Raith,1068,9,9,9,18,35,52,-17,36
Dumbarton,1068,10,7,12,17,43,60,-17,33
Hibernian,1069,1,20,13,3,60,24,36,73
Morton,1069,2,16,13,7,55,39,16,61
Falkirk,1069,3,16,10,10,59,41,18,58
Dundee Utd,1069,4,15,10,11,51,42,9,55
Queen of S't,1069,5,12,8,16,46,50,-4,44
Raith,1069,6,11,11,14,37,48,-11,44
St Mirren,1069,7,9,13,14,47,52,-5,40
Dunfermline,1069,8,8,15,13,48,54,-6,39
Ayr,1069,9,9,10,17,31,59,-28,37
Dumbarton,1069,10,7,11,18,43,68,-25,32
Hibernian,1070,1,20,11,5,56,26,30,71
Morton,1070,2,17,12,7,51,35,16,63
Falkirk,1070,3,16,12,8,54,35,19,60
Dundee Utd,1070,4,14,10,12,44,40,4,52
Ayr,1070,5,12,11,13,38,52,-14,47
Dumbarton,1070,6,10,11,15,47,54,-7,41
Raith,1070,7,11,8,17,37,49,-12,41
Dunfermline,1070,8,9,13,14,41,47,-6,40
Queen of S't,1070,9,10,9,17,40,52,-12,39
St Mirren,1070,10,7,11,18,40,58,-18,32
Hibernian,1071,1,20,13,3,60,25,35,73
Falkirk,1071,2,17,10,9,61,38,23,61
Morton,1071,3,16,10,10,45,41,4,58
Dundee Utd,1071,4,14,10,12,48,42,6,52
Raith,1071,5,12,9,15,40,48,-8,45
Queen of S't,1071,6,12,8,16,46,55,-9,44
Ayr,1071,7,10,11,15,38,55,-17,41
Dumbarton,1071,8,9,11,16,51,58,-7,38
St Mirren,1071,9,9,11,16,44,59,-15,38
Dunfermline,1071,10,8,13,15,43,55,-12,37
Hibernian,1072,1,18,13,5,54,27,27,67
Falkirk,1072,2,17,11,8,56,35,21,62
Morton,1072,3,16,12,8,45,33,12,60
Dundee Utd,1072,4,16,10,10,49,41,8,58
Queen of S't,1072,5,13,9,14,46,47,-1,48
Dunfermline,1072,6,11,11,14,46,47,-1,44
Dumbarton,1072,7,9,12,15,46,55,-9,39
St Mirren,1072,8,9,12,15,40,51,-11,39
Raith,1072,9,9,11,16,34,51,-17,38
Ayr,1072,10,6,11,19,33,62,-29,29
Hibernian,1073,1,19,13,4,54,23,31,70
Dundee Utd,1073,2,17,10,9,50,34,16,61
Morton,1073,3,14,15,7,46,37,9,57
Falkirk,1073,4,15,11,10,59,44,15,56
Dunfermline,1073,5,12,13,11,51,45,6,49
Queen of S't,1073,6,11,9,16,44,54,-10,42
Raith,1073,7,9,12,15,32,46,-14,39
Ayr,1073,8,8,13,15,33,54,-21,37
Dumbarton,1073,9,8,12,16,45,58,-13,36
St Mirren,1073,10,8,10,18,39,58,-19,34
Hibernian,1074,1,19,12,5,57,30,27,69
Morton,1074,2,18,10,8,49,36,13,64
Falkirk,1074,3,15,11,10,59,42,17,56
Dundee Utd,1074,4,15,9,12,47,38,9,54
Dunfermline,1074,5,12,11,13,51,49,2,47
Dumbarton,1074,6,11,12,13,46,49,-3,45
Queen of S't,1074,7,11,11,14,45,50,-5,44
Raith,1074,8,9,10,17,35,55,-20,37
St Mirren,1074,9,8,11,17,38,57,-19,35
Ayr,1074,10,8,11,17,33,54,-21,35
Hibernian,1075,1,19,12,5,56,27,29,69
Falkirk,1075,2,16,10,10,59,39,20,58
Morton,1075,3,16,10,10,47,38,9,58
Dundee Utd,1075,4,14,12,10,47,40,7,54
Queen of S't,1075,5,12,10,14,52,57,-5,46
Dunfermline,1075,6,10,14,12,43,46,-3,44
Dumbarton,1075,7,10,12,14,57,65,-8,42
Ayr,1075,8,9,12,15,35,52,-17,39
Raith,1075,9,9,10,17,32,47,-15,37
St Mirren,1075,10,9,10,17,37,54,-17,37
Hibernian,1076,1,17,13,6,54,32,22,64
Falkirk,1076,2,16,11,9,60,41,19,59
Morton,1076,3,16,10,10,47,39,8,58
Dundee Utd,1076,4,16,9,11,50,40,10,57
Raith,1076,5,11,11,14,40,50,-10,44
Dunfermline,1076,6,10,13,13,45,47,-2,43
Queen of S't,1076,7,11,10,15,45,52,-7,43
Ayr,1076,8,9,13,14,38,53,-15,40
St Mirren,1076,9,9,12,15,40,51,-11,39
Dumbarton,1076,10,9,10,17,46,60,-14,37
Hibernian,1077,1,20,11,5,58,25,33,71
Falkirk,1077,2,15,11,10,55,41,14,56
Morton,1077,3,14,12,10,47,45,2,54
Dundee Utd,1077,4,14,10,12,44,41,3,52
Dunfermline,1077,5,11,14,11,47,45,2,47
Queen of S't,1077,6,12,10,14,48,51,-3,46
Raith,1077,7,12,9,15,42,47,-5,45
Dumbarton,1077,8,10,12,14,49,55,-6,42
Ayr,1077,9,8,14,14,36,58,-22,38
St Mirren,1077,10,7,11,18,39,57,-18,32
Hibernian,1078,1,20,10,6,55,27,28,70
Morton,1078,2,19,10,7,52,31,21,67
Falkirk,1078,3,17,11,8,62,39,23,62
Dundee Utd,1078,4,15,11,10,58,45,13,56
Queen of S't,1078,5,13,9,14,48,48,0,48
Dunfermline,1078,6,9,12,15,48,52,-4,39
Dumbarton,1078,7,9,12,15,46,59,-13,39
Raith,1078,8,9,10,17,38,56,-18,37
Ayr,1078,9,7,13,16,35,57,-22,34
St Mirren,1078,10,8,10,18,38,66,-28,34
Hibernian,1079,1,18,13,5,52,29,23,67
Morton,1079,2,17,12,7,53,35,18,63
Falkirk,1079,3,15,12,9,60,42,18,57
Dundee Utd,1079,4,16,9,11,53,41,12,57
Queen of S't,1079,5,14,8,14,50,52,-2,50
Dunfermline,1079,6,11,14,11,49,45,4,47
St Mirren,1079,7,9,11,16,43,58,-15,38
Raith,1079,8,9,10,17,35,53,-18,37
Dumbarton,1079,9,7,13,16,44,59,-15,34
Ayr,1079,10,7,12,17,33,58,-25,33
Hibernian,1080,1,21,10,5,63,27,36,73
Morton,1080,2,16,10,10,49,39,10,58
Dundee Utd,1080,3,16,9,11,54,42,12,57
Falkirk,1080,4,15,11,10,60,45,15,56
Dunfermline,1080,5,10,14,12,49,49,0,44
Raith,1080,6,11,11,14,39,51,-12,44
Dumbarton,1080,7,10,12,14,55,58,-3,42
Queen of S't,1080,8,9,12,15,42,55,-13,39
St Mirren,1080,9,9,10,17,40,59,-19,37
Ayr,1080,10,8,11,17,36,62,-26,35
Hibernian,1081,1,17,13,6,51,26,25,64
Morton,1081,2,16,12,8,51,41,10,60
Dundee Utd,1081,3,16,11,9,58,42,16,59
Falkirk,1081,4,15,9,12,60,48,12,54
Queen of S't,1081,5,13,9,14,50,47,3,48
Dumbarton,1081,6,11,11,14,53,57,-4,44
Dunfermline,1081,7,8,15,13,44,52,-8,39
Raith,1081,8,9,12,15,36,51,-15,39
Ayr,1081,9,8,14,14,35,58,-23,38
St Mirren,1081,10,9,10,17,41,57,-16,37
Hibernian,1082,1,21,11,4,62,24,38,74
Morton,1082,2,19,11,6,53,34,19,68
Dundee Utd,1082,3,18,8,10,49,37,12,62
Falkirk,1082,4,14,11,11,56,47,9,53
Dunfermline,1082,5,11,11,14,51,47,4,44
Dumbarton,1082,6,9,12,15,49,59,-10,39
Queen of S't,1082,7,9,11,16,43,57,-14,38
St Mirren,1082,8,9,11,16,40,54,-14,38
Raith,1082,9,8,11,17,33,50,-17,35
Ayr,1082,10,8,11,17,33,60,-27,35
Hibernian,1083,1,18,13,5,52,28,24,67
Falkirk,1083,2,16,12,8,59,38,21,60
Morton,1083,3,15,13,8,44,35,9,58
Dundee Utd,1083,4,15,10,11,51,44,7,55
Queen of S't,1083,5,13,10,13,48,46,2,49
Dunfermline,1083,6,11,12,13,49,49,0,45
Dumbarton,1083,7,8,14,14,45,54,-9,38
St Mirren,1083,8,9,11,16,40,57,-17,38
Ayr,1083,9,8,13,15,36,55,-19,37
Raith,1083,10,8,10,18,33,51,-18,34
Hibernian,1084,1,20,11,5,54,25,29,71
Falkirk,1084,2,17,11,8,60,39,21,62
Morton,1084,3,15,12,9,45,36,9,57
Dundee Utd,1084,4,15,11,10,50,44,6,56
Dunfermline,1084,5,10,14,12,49,48,1,44
Dumbarton,1084,6,10,11,15,46,54,-8,41
Queen of S't,1084,7,10,10,16,42,51,-9,40
Raith,1084,8,10,10,16,35,48,-13,40
St Mirren,1084,9,9,11,16,38,52,-14,38
Ayr,1084,10,8,11,17,34,56,-22,35
Hibernian,1085,1,20,12,4,57,25,32,72
Morton,1085,2,18,12,6,55,34,21,66
Dundee Utd,1085,3,16,10,10,52,42,10,58
Falkirk,1085,4,15,11,10,60,43,17,56
Queen of S't,1085,5,11,11,14,45,50,-5,44
Dunfermline,1085,6,9,15,12,45,47,-2,42
Raith,1085,7,10,10,16,34,49,-15,40
Dumbarton,1085,8,8,12,16,48,64,-16,36
St Mirren,1085,9,8,11,17,38,54,-16,35
Ayr,1085,10,6,14,16,29,55,-26,32
Hibernian,1086,1,18,13,5,58,30,28,67
Falkirk,1086,2,17,11,8,63,41,22,62
Morton,1086,3,17,11,8,51,40,11,62
Dundee Utd,1086,4,17,8,11,55,41,14,59
Dunfermline,1086,5,10,14,12,46,44,2,44
St Mirren,1086,6,11,9,16,47,57,-10,42
Ayr,1086,7,9,12,15,35,53,-18,39
Queen of S't,1086,8,9,11,16,40,53,-13,38
Dumbarton,1086,9,8,12,16,46,61,-15,36
Raith,1086,10,8,11,17,31,52,-21,35
Hibernian,1087,1,19,12,5,56,25,31,69
Morton,1087,2,16,12,8,49,40,9,60
Dundee Utd,1087,3,15,10,11,46,39,7,55
Falkirk,1087,4,13,12,11,52,46,6,51
Dunfermline,1087,5,11,12,13,51,47,4,45
Queen of S't,1087,6,10,12,14,46,52,-6,42
Dumbarton,1087,7,10,12,14,50,59,-9,42
Raith,1087,8,11,9,16,42,51,-9,42
St Mirren,1087,9,10,12,14,45,55,-10,42
Ayr,1087,10,7,13,16,34,57,-23,34
Hibernian,1088,1,19,11,6,56,27,29,68
Falkirk,1088,2,18,11,7,66,38,28,65
Morton,1088,3,18,10,8,57,41,16,64
Dundee Utd,1088,4,15,10,11,52,42,10,55
Dunfermline,1088,5,11,12,13,52,49,3,45
Queen of S't,1088,6,12,8,16,42,52,-10,44
Raith,1088,7,10,9,17,35,52,-17,39
Ayr,1088,8,8,13,15,34,54,-20,37
St Mirren,1088,9,8,11,17,41,60,-19,35
Dumbarton,1088,10,8,11,17,44,64,-20,35
Hibernian,1089,1,18,14,4,49,21,28,68
Morton,1089,2,18,10,8,49,36,13,64
Falkirk,1089,3,17,11,8,60,37,23,62
Dundee Utd,1089,4,15,10,11,49,42,7,55
Queen of S't,1089,5,11,10,15,44,50,-6,43
Dunfermline,1089,6,10,12,14,47,49,-2,42
Raith,1089,7,10,9,17,32,49,-17,39
Ayr,1089,8,9,12,15,38,57,-19,39
Dumbarton,1089,9,9,10,17,44,56,-12,37
St Mirren,1089,10,9,10,17,40,55,-15,37
Hibernian,1090,1,21,12,3,61,24,37,75
Morton,1090,2,18,11,7,58,36,22,65
Dundee Utd,1090,3,15,11,10,46,39,7,56
Falkirk,1090,4,15,10,11,53,43,10,55
Queen of S't,1090,5,12,12,12,46,46,0,48
St Mirren,1090,6,10,10,16,45,58,-13,40
Ayr,1090,7,9,12,15,35,53,-18,39
Dunfermline,1090,8,8,14,14,44,52,-8,38
Dumbarton,1090,9,8,11,17,46,63,-17,35
Raith,1090,10,8,9,19,31,51,-20,33
Hibernian,1091,1,21,12,3,61,23,38,75
Falkirk,1091,2,17,10,9,59,40,19,61
Dundee Utd,1091,3,16,8,12,48,40,8,56
Morton,1091,4,15,10,11,46,45,1,55
Queen of S't,1091,5,12,9,15,43,52,-9,45
Ayr,1091,6,11,10,15,40,53,-13,43
Dunfermline,1091,7,10,12,14,49,48,1,42
Dumbarton,1091,8,9,12,15,48,56,-8,39
Raith,1091,9,9,10,17,33,50,-17,37
St Mirren,1091,10,9,9,18,36,56,-20,36
Hibernian,1092,1,18,13,5,51,26,25,67
Morton,1092,2,18,11,7,50,35,15,65
Falkirk,1092,3,16,10,10,57,40,17,58
Dundee Utd,1092,4,14,10,12,45,39,6,52
Dumbarton,1092,5,13,10,13,51,50,1,49
Queen of S't,1092,6,11,10,15,42,48,-6,43
Ayr,1092,7,10,12,14,35,51,-16,42
Raith,1092,8,10,9,17,33,51,-18,39
Dunfermline,1092,9,8,13,15,45,52,-7,37
St Mirren,1092,10,7,12,17,34,51,-17,33
Hibernian,1093,1,18,13,5,60,28,32,67
Dundee Utd,1093,2,17,11,8,59,40,19,62
Morton,1093,3,16,12,8,48,39,9,60
Falkirk,1093,4,15,9,12,54,44,10,54
Queen of S't,1093,5,12,10,14,46,57,-11,46
Dunfermline,1093,6,11,12,13,46,45,1,45
Raith,1093,7,10,10,16,37,50,-13,40
Dumbarton,1093,8,9,10,17,47,57,-10,37
St Mirren,1093,9,9,10,17,41,55,-14,37
Ayr,1093,10,8,13,15,35,58,-23,37
Hibernian,1094,1,21,11,4,66,25,41,74
Morton,1094,2,16,12,8,49,39,10,60
Falkirk,1094,3,15,11,10,56,40,16,56
Dundee Utd,1094,4,14,10,12,47,43,4,52
Dunfermline,1094,5,12,13,11,53,47,6,49
Queen of S't,1094,6,10,12,14,45,49,-4,42
Dumbarton,1094,7,10,10,16,47,61,-14,40
Raith,1094,8,10,9,17,34,51,-17,39
Ayr,1094,9,8,13,15,34,56,-22,37
St Mirren,1094,10,8,11,17,39,59,-20,35
Hibernian,1095,1,19,11,6,58,31,27,68
Falkirk,1095,2,17,10,9,60,40,20,61
Morton,1095,3,16,12,8,53,38,15,60
Dundee Utd,1095,4,17,9,10,54,40,14,60
Dunfermline,1095,5,10,14,12,49,48,1,44
Raith,1095,6,11,9,16,38,52,-14,42
Dumbarton,1095,7,9,13,14,46,56,-10,40
Ayr,1095,8,9,12,15,37,56,-19,39
Queen of S't,1095,9,9,11,16,43,55,-12,38
St Mirren,1095,10,7,11,18,38,60,-22,32
Hibernian,1096,1,20,11,5,58,28,30,71
Morton,1096,2,19,10,7,53,33,20,67
Dundee Utd,1096,3,17,9,10,53,40,13,60
Falkirk,1096,4,16,10,10,55,41,14,58
Queen of S't,1096,5,13,8,15,44,46,-2,47
Dunfermline,1096,6,10,11,15,43,50,-7,41
Dumbarton,1096,7,10,11,15,52,60,-8,41
Raith,1096,8,10,8,18,34,50,-16,38
St Mirren,1096,9,9,10,17,42,57,-15,37
Ayr,1096,10,7,10,19,31,60,-29,31
Morton,1097,1,18,11,7,51,36,15,65
Hibernian,1097,2,17,13,6,52,29,23,64
Falkirk,1097,3,15,13,8,57,37,20,58
Dundee Utd,1097,4,15,10,11,52,41,11,55
Dunfermline,1097,5,10,12,14,45,47,-2,42
Raith,1097,6,11,9,16,36,50,-14,42
Ayr,1097,7,10,11,15,37,57,-20,41
Queen of S't,1097,8,10,10,16,43,51,-8,40
Dumbarton,1097,9,9,12,15,46,57,-11,39
St Mirren,1097,10,8,13,15,41,55,-14,37
Hibernian,1098,1,20,10,6,56,25,31,70
Morton,1098,2,19,10,7,50,34,16,67
Falkirk,1098,3,16,11,9,59,40,19,59
Dundee Utd,1098,4,16,9,11,50,40,10,57
Dunfermline,1098,5,11,12,13,48,48,0,45
Queen of S't,1098,6,11,10,15,45,56,-11,43
Raith,1098,7,10,9,17,35,51,-16,39
Ayr,1098,8,9,12,15,37,56,-19,39
St Mirren,1098,9,9,10,17,40,51,-11,37
Dumbarton,1098,10,7,11,18,45,64,-19,32
Hibernian,1099,1,22,11,3,57,23,34,77
Dundee Utd,1099,2,17,10,9,52,38,14,61
Morton,1099,3,14,10,12,48,41,7,52
Falkirk,1099,4,13,12,11,51,40,11,51
Queen of S't,1099,5,12,10,14,47,46,1,46
Dumbarton,1099,6,11,11,14,51,55,-4,44
Raith,1099,7,10,12,14,36,47,-11,42
Dunfermline,1099,8,9,13,14,44,53,-9,40
Ayr,1099,9,8,13,15,35,59,-24,37
St Mirren,1099,10,7,12,17,36,55,-19,33
Hibernian,1100,1,20,12,4,54,23,31,72
Falkirk,1100,2,19,9,8,62,37,25,66
Dundee Utd,1100,3,17,9,10,58,46,12,60
Morton,1100,4,16,11,9,56,39,17,59
Queen of S't,1100,5,11,11,14,48,52,-4,44
Ayr,1100,6,9,13,14,36,53,-17,40
Dunfermline,1100,7,8,14,14,39,48,-9,38
St Mirren,1100,8,9,10,17,42,57,-15,37
Raith,1100,9,8,11,17,32,53,-21,35
Dumbarton,1100,10,7,12,17,47,66,-19,33
Hibernian,1101,1,21,11,4,62,26,36,74
Morton,1101,2,17,11,8,57,41,16,62
Falkirk,1101,3,17,10,9,59,43,16,61
Dundee Utd,1101,4,14,11,11,49,44,5,53
Queen of S't,1101,5,12,10,14,48,50,-2,46
Dunfermline,1101,6,10,12,14,50,53,-3,42
Dumbarton,1101,7,10,11,15,50,60,-10,41
Raith,1101,8,10,10,16,38,54,-16,40
St Mirren,1101,9,9,10,17,47,62,-15,37
Ayr,1101,10,6,12,18,31,58,-27,30
Hibernian,1102,1,17,15,4,52,25,27,66
Morton,1102,2,15,13,8,46,35,11,58
Dundee Utd,1102,3,16,9,11,50,41,9,57
Falkirk,1102,4,15,11,10,55,39,16,56
Queen of S't,1102,5,12,10,14,42,48,-6,46
Dunfermline,1102,6,9,15,12,43,46,-3,42
Raith,1102,7,11,9,16,40,47,-7,42
St Mirren,1102,8,10,10,16,41,51,-10,40
Dumbarton,1102,9,8,13,15,44,56,-12,37
Ayr,1102,10,8,13,15,32,57,-25,37
Hibernian,1103,1,19,13,4,56,26,30,70
Morton,1103,2,17,11,8,48,36,12,62
Falkirk,1103,3,17,10,9,61,40,21,61
Dundee Utd,1103,4,16,10,10,51,41,10,58
Ayr,1103,5,10,12,14,41,55,-14,42
Queen of S't,1103,6,10,11,15,42,49,-7,41
Dumbarton,1103,7,9,13,14,50,55,-5,40
Raith,1103,8,10,10,16,39,52,-13,40
Dunfermline,1103,9,9,11,16,45,55,-10,38
St Mirren,1103,10,7,11,18,35,59,-24,32
Hibernian,1104,1,19,13,4,56,27,29,70
Morton,1104,2,19,12,5,57,37,20,69
Dundee Utd,1104,3,17,10,9,48,35,13,61
Falkirk,1104,4,15,12,9,57,38,19,57
Queen of S't,1104,5,13,9,14,44,49,-5,48
Dunfermline,1104,6,9,13,14,43,48,-5,40
Raith,1104,7,9,11,16,30,44,-14,38
Ayr,1104,8,7,14,15,36,54,-18,35
Dumbarton,1104,9,7,11,18,44,63,-19,32
St Mirren,1104,10,7,11,18,40,60,-20,32
Hibernian,1105,1,18,13,5,54,28,26,67
Dundee Utd,1105,2,18,10,8,53,36,17,64
Falkirk,1105,3,15,10,11,62,46,16,55
Morton,1105,4,14,12,10,46,39,7,54
Queen of S't,1105,5,13,9,14,53,49,4,48
St Mirren,1105,6,10,11,15,42,55,-13,41
Raith,1105,7,9,13,14,35,50,-15,40
Dunfermline,1105,8,8,15,13,43,47,-4,39
Dumbarton,1105,9,9,12,15,50,60,-10,39
Ayr,1105,10,7,13,16,34,62,-28,34
Hibernian,1106,1,19,11,6,57,31,26,68
Morton,1106,2,18,11,7,59,40,19,65
Falkirk,1106,3,17,11,8,62,38,24,62
Dundee Utd,1106,4,14,11,11,52,44,8,53
Dunfermline,1106,5,11,13,12,45,46,-1,46
Queen of S't,1106,6,12,8,16,47,54,-7,44
Raith,1106,7,10,10,16,33,48,-15,40
Ayr,1106,8,9,11,16,38,56,-18,38
St Mirren,1106,9,8,11,17,35,58,-23,35
Dumbarton,1106,10,7,13,16,47,60,-13,34
Hibernian,1107,1,17,15,4,55,29,26,66
Morton,1107,2,18,12,6,56,38,18,66
Dundee Utd,1107,3,16,11,9,52,40,12,59
Falkirk,1107,4,14,10,12,57,47,10,52
Dunfermline,1107,5,11,13,12,52,48,4,46
Raith,1107,6,11,9,16,38,51,-13,42
Queen of S't,1107,7,10,11,15,45,52,-7,41
Dumbarton,1107,8,9,13,14,49,60,-11,40
St Mirren,1107,9,8,11,17,39,55,-16,35
Ayr,1107,10,7,13,16,35,58,-23,34
Hibernian,1108,1,18,13,5,51,24,27,67
Morton,1108,2,17,14,5,46,29,17,65
Dundee Utd,1108,3,16,8,12,50,37,13,56
Falkirk,1108,4,15,10,11,57,43,14,55
Queen of S't,1108,5,13,9,14,46,44,2,48
Raith,1108,6,11,11,14,37,45,-8,44
Dunfermline,1108,7,9,12,15,44,53,-9,39
Dumbarton,1108,8,9,11,16,46,60,-14,38
Ayr,1108,9,9,11,16,35,58,-23,38
St Mirren,1108,10,8,11,17,40,59,-19,35
Hibernian,1109,1,19,13,4,52,25,27,70
Morton,1109,2,17,11,8,54,39,15,62
Falkirk,1109,3,16,9,11,58,47,11,57
Dundee Utd,1109,4,16,9,11,50,42,8,57
Dumbarton,1109,5,11,11,14,55,58,-3,44
Raith,1109,6,12,8,16,43,46,-3,44
Queen of S't,1109,7,11,10,15,47,55,-8,43
Dunfermline,1109,8,8,15,13,45,53,-8,39
St Mirren,1109,9,9,10,17,39,52,-13,37
Ayr,1109,10,8,10,18,30,56,-26,34
Hibernian,1110,1,20,12,4,58,26,32,72
Dundee Utd,1110,2,18,9,9,52,36,16,63
Morton,1110,3,17,11,8,60,42,18,62
Falkirk,1110,4,15,13,8,57,39,18,58
Queen of S't,1110,5,13,8,15,45,48,-3,47
Raith,1110,6,12,10,14,40,49,-9,46
Ayr,1110,7,8,12,16,35,57,-22,36
Dunfermline,1110,8,8,11,17,44,54,-10,35
St Mirren,1110,9,8,11,17,39,60,-21,35
Dumbarton,1110,10,7,11,18,44,63,-19,32
Hibernian,1111,1,19,11,6,56,28,28,68
Morton,1111,2,17,13,6,52,34,18,64
Dundee Utd,1111,3,18,9,9,52,38,14,63
Falkirk,1111,4,14,11,11,54,43,11,53
St Mirren,1111,5,12,9,15,48,52,-4,45
Queen of S't,1111,6,12,9,15,45,50,-5,45
Dunfermline,1111,7,10,13,13,48,50,-2,43
Dumbarton,1111,8,9,12,15,44,55,-11,39
Raith,1111,9,9,9,18,32,53,-21,36
Ayr,1111,10,6,12,18,29,57,-28,30
Hibernian,1112,1,21,11,4,59,26,33,74
Morton,1112,2,18,9,9,51,39,12,63
Falkirk,1112,3,17,11,8,57,37,20,62
Dundee Utd,1112,4,16,9,11,48,40,8,57
Raith,1112,5,12,8,16,38,46,-8,44
Dumbarton,1112,6,9,12,15,43,54,-11,39
Queen of S't,1112,7,10,9,17,41,52,-11,39
St Mirren,1112,8,10,9,17,39,51,-12,39
Ayr,1112,9,9,11,16,35,56,-21,38
Dunfermline,1112,10,7,13,16,39,49,-10,34
Hibernian,1113,1,19,12,5,57,30,27,69
Falkirk,1113,2,17,10,9,58,39,19,61
Morton,1113,3,16,11,9,47,34,13,59
Dundee Utd,1113,4,16,10,10,48,37,11,58
Queen of S't,1113,5,13,8,15,48,50,-2,47
Dunfermline,1113,6,10,13,13,46,48,-2,43
Ayr,1113,7,10,11,15,37,55,-18,41
St Mirren,1113,8,10,10,16,39,51,-12,40
Raith,1113,9,9,9,18,34,53,-19,36
Dumbarton,1113,10,7,12,17,46,63,-17,33
Hibernian,1114,1,20,12,4,51,22,29,72
Falkirk,1114,2,19,9,8,67,44,23,66
Morton,1114,3,15,11,10,49,40,9,56
Dundee Utd,1114,4,13,11,12,54,48,6,50
Queen of S't,1114,5,13,10,13,52,50,2,49
Dunfermline,1114,6,10,13,13,48,51,-3,43
Dumbarton,1114,7,10,11,15,51,62,-11,41
Raith,1114,8,10,9,17,33,50,-17,39
Ayr,1114,9,9,10,17,41,63,-22,37
St Mirren,1114,10,8,10,18,39,55,-16,34
Hibernian,1115,1,21,10,5,59,25,34,73
Dundee Utd,1115,2,19,8,9,53,36,17,65
Morton,1115,3,16,12,8,48,35,13,60
Falkirk,1115,4,15,11,10,59,44,15,56
Queen of S't,1115,5,11,10,15,47,53,-6,43
Raith,1115,6,10,11,15,34,46,-12,41
Dumbarton,1115,7,10,11,15,49,62,-13,41
Dunfermline,1115,8,8,13,15,47,56,-9,37
St Mirren,1115,9,8,12,16,39,53,-14,36
Ayr,1115,10,7,12,17,33,58,-25,33
Hibernian,1116,1,20,12,4,54,26,28,72
Morton,1116,2,18,11,7,52,36,16,65
Dundee Utd,1116,3,17,10,9,52,36,16,61
Falkirk,1116,4,15,11,10,56,39,17,56
Dunfermline,1116,5,11,11,14,48,51,-3,44
Dumbarton,1116,6,10,11,15,52,60,-8,41
Queen of S't,1116,7,11,8,17,46,61,-15,41
St Mirren,1116,8,9,10,17,39,56,-17,37
Raith,1116,9,9,9,18,36,49,-13,36
Ayr,1116,10,8,11,17,36,57,-21,35
Hibernian,1117,1,20,11,5,54,26,28,71
Falkirk,1117,2,17,11,8,62,39,23,62
Morton,1117,3,17,11,8,47,33,14,62
Dundee Utd,1117,4,14,11,11,46,40,6,53
Queen of S't,1117,5,12,10,14,44,49,-5,46
Dunfermline,1117,6,9,15,12,47,47,0,42
St Mirren,1117,7,10,9,17,42,51,-9,39
Ayr,1117,8,9,12,15,38,57,-19,39
Raith,1117,9,10,8,18,36,55,-19,38
Dumbarton,1117,10,7,12,17,44,63,-19,33
Hibernian,1118,1,20,10,6,57,26,31,70
Falkirk,1118,2,17,11,8,64,42,22,62
Morton,1118,3,16,11,9,52,44,8,59
Dundee Utd,1118,4,14,11,11,45,40,5,53
Queen of S't,1118,5,13,11,12,47,47,0,50
Dunfermline,1118,6,10,14,12,49,48,1,44
Ayr,1118,7,9,12,15,35,52,-17,39
St Mirren,1118,8,9,10,17,43,57,-14,37
Dumbarton,1118,9,8,12,16,46,60,-14,36
Raith,1118,10,8,10,18,32,54,-22,34
Hibernian,1119,1,21,10,5,53,24,29,73
Dundee Utd,1119,2,18,10,8,53,34,19,64
Falkirk,1119,3,15,10,11,54,41,13,55
Morton,1119,4,14,11,11,46,39,7,53
Raith,1119,5,13,9,14,41,44,-3,48
Queen of S't,1119,6,12,10,14,47,48,-1,46
Dunfermline,1119,7,11,12,13,45,48,-3,45
Dumbarton,1119,8,9,12,15,47,59,-12,39
Ayr,1119,9,6,14,16,31,57,-26,32
St Mirren,1119,10,6,12,18,38,61,-23,30
Hibernian,1120,1,21,12,3,59,24,35,75
Falkirk,1120,2,15,12,9,63,46,17,57
Dundee Utd,1120,3,15,11,10,49,39,10,56
Morton,1120,4,15,11,10,44,38,6,56
Dunfermline,1120,5,11,14,11,47,46,1,47
Queen of S't,1120,6,12,10,14,47,47,0,46
Dumbarton,1120,7,10,11,15,49,58,-9,41
Ayr,1120,8,9,12,15,32,52,-20,39
St Mirren,1120,9,7,12,17,35,55,-20,33
Raith,1120,10,8,9,19,31,51,-20,33
Hibernian,1121,1,20,11,5,58,23,35,71
Dundee Utd,1121,2,18,9,9,56,39,17,63
Falkirk,1121,3,17,9,10,60,44,16,60
Morton,1121,4,16,11,9,52,40,12,59
St Mirren,1121,5,11,10,15,41,49,-8,43
Dunfermline,1121,6,9,15,12,41,45,-4,42
Queen of S't,1121,7,11,9,16,45,56,-11,42
Ayr,1121,8,10,12,14,34,49,-15,42
Raith,1121,9,9,8,19,33,51,-18,35
Dumbarton,1121,10,7,10,19,41,65,-24,31
Hibernian,1122,1,23,10,3,59,20,39,79
Falkirk,1122,2,16,11,9,60,39,21,59
Dundee Utd,1122,3,15,10,11,49,42,7,55
Morton,1122,4,15,10,11,44,38,6,55
Dunfermline,1122,5,12,12,12,49,45,4,48
Dumbarton,1122,6,11,11,14,51,55,-4,44
Raith,1122,7,10,9,17,35,52,-17,39
Ayr,1122,8,9,11,16,39,57,-18,38
Queen of S't,1122,9,9,9,18,43,60,-17,36
St Mirren,1122,10,8,11,17,39,60,-21,35
Hibernian,1123,1,19,13,4,54,26,28,70
Falkirk,1123,2,17,11,8,64,41,23,62
Morton,1123,3,16,12,8,47,32,15,60
Dundee Utd,1123,4,15,11,10,49,40,9,56
Dunfermline,1123,5,11,12,13,42,46,-4,45
Queen of S't,1123,6,11,11,14,43,49,-6,44
Dumbarton,1123,7,9,12,15,47,55,-8,39
Raith,1123,8,9,10,17,34,49,-15,37
St Mirren,1123,9,8,11,17,40,59,-19,35
Ayr,1123,10,6,15,15,33,56,-23,33
Hibernian,1124,1,18,12,6,52,28,24,66
Morton,1124,2,17,10,9,51,36,15,61
Falkirk,1124,3,15,11,10,57,43,14,56
Dundee Utd,1124,4,14,11,11,48,41,7,53
Dunfermline,1124,5,11,12,13,46,44,2,45
Queen of S't,1124,6,12,9,15,43,52,-9,45
Dumbarton,1124,7,10,11,15,51,61,-10,41
Raith,1124,8,11,8,17,33,50,-17,41
St Mirren,1124,9,10,10,16,44,54,-10,40
Ayr,1124,10,9,12,15,37,53,-16,39
Hibernian,1125,1,18,13,5,56,30,26,67
Falkirk,1125,2,16,12,8,64,44,20,60
Dundee Utd,1125,3,16,10,10,53,43,10,58
Morton,1125,4,15,12,9,50,40,10,57
Dunfermline,1125,5,11,14,11,48,45,3,47
Dumbarton,1125,6,10,13,13,49,56,-7,43
Queen of S't,1125,7,10,9,17,40,51,-11,39
St Mirren,1125,8,9,11,16,43,55,-12,38
Raith,1125,9,9,10,17,34,52,-18,37
Ayr,1125,10,9,10,17,35,56,-21,37
Hibernian,1126,1,19,12,5,51,25,26,69
Dundee Utd,1126,2,18,10,8,57,39,18,64
Falkirk,1126,3,17,11,8,66,37,29,62
Morton,1126,4,17,11,8,49,31,18,62
Queen of S't,1126,5,11,11,14,43,49,-6,44
Dunfermline,1126,6,10,12,14,48,49,-1,42
Raith,1126,7,11,8,17,37,57,-20,41
Dumbarton,1126,8,7,14,15,43,55,-12,35
St Mirren,1126,9,8,9,19,38,63,-25,33
Ayr,1126,10,6,14,16,34,61,-27,32
Hibernian,1127,1,18,12,6,57,30,27,66
Dundee Utd,1127,2,17,10,9,48,40,8,61
Falkirk,1127,3,14,13,9,56,42,14,55
Morton,1127,4,15,10,11,46,39,7,55
Dunfermline,1127,5,10,16,10,48,44,4,46
Queen of S't,1127,6,12,9,15,50,52,-2,45
Raith,1127,7,11,10,15,34,48,-14,43
St Mirren,1127,8,9,12,15,44,53,-9,39
Dumbarton,1127,9,9,11,16,49,61,-12,38
Ayr,1127,10,7,13,16,34,57,-23,34
Hibernian,1128,1,20,10,6,58,28,30,70
Dundee Utd,1128,2,17,8,11,50,40,10,59
Morton,1128,3,16,10,10,47,39,8,58
Falkirk,1128,4,15,10,11,59,44,15,55
Queen of S't,1128,5,13,11,12,51,50,1,50
Dunfermline,1128,6,12,11,13,50,48,2,47
Dumbarton,1128,7,11,10,15,50,58,-8,43
Raith,1128,8,10,10,16,38,46,-8,40
Ayr,1128,9,8,11,17,34,63,-29,35
St Mirren,1128,10,7,11,18,36,57,-21,32
Hibernian,1129,1,20,13,3,54,23,31,73
Dundee Utd,1129,2,16,10,10,54,40,14,58
Falkirk,1129,3,15,11,10,55,43,12,56
Morton,1129,4,14,12,10,46,42,4,54
Dunfermline,1129,5,12,12,12,50,45,5,48
Queen of S't,1129,6,11,11,14,45,49,-4,44
Dumbarton,1129,7,10,12,14,51,61,-10,42
Raith,1129,8,11,9,16,37,48,-11,42
Ayr,1129,9,7,14,15,32,52,-20,35
St Mirren,1129,10,6,12,18,36,57,-21,30
Hibernian,1130,1,21,12,3,64,24,40,75
Dundee Utd,1130,2,17,10,9,50,38,12,61
Morton,1130,3,16,12,8,47,35,12,60
Falkirk,1130,4,15,12,9,59,45,14,57
Dunfermline,1130,5,9,15,12,43,48,-5,42
Dumbarton,1130,6,10,12,14,51,58,-7,42
Queen of S't,1130,7,9,11,16,43,56,-13,38
Raith,1130,8,9,11,16,31,45,-14,38
Ayr,1130,9,7,13,16,36,57,-21,34
St Mirren,1130,10,7,12,17,44,62,-18,33
Hibernian,1131,1,20,12,4,53,24,29,72
Dundee Utd,1131,2,17,10,9,56,38,18,61
Morton,1131,3,16,13,7,47,33,14,61
Falkirk,1131,4,16,11,9,54,37,17,59
Queen of S't,1131,5,12,8,16,45,55,-10,44
Dunfermline,1131,6,9,14,13,42,46,-4,41
Dumbarton,1131,7,9,12,15,48,58,-10,39
Raith,1131,8,8,13,15,34,48,-14,37
St Mirren,1131,9,8,11,17,42,55,-13,35
Ayr,1131,10,7,12,17,30,57,-27,33
Hibernian,1132,1,19,14,3,59,27,32,71
Dundee Utd,1132,2,17,10,9,48,34,14,61
Morton,1132,3,16,13,7,49,38,11,61
Falkirk,1132,4,16,11,9,57,41,16,59
Dunfermline,1132,5,10,13,13,50,48,2,43
Raith,1132,6,10,11,15,35,50,-15,41
Ayr,1132,7,8,15,13,42,53,-11,39
Queen of S't,1132,8,10,9,17,43,57,-14,39
St Mirren,1132,9,8,10,18,37,54,-17,34
Dumbarton,1132,10,7,12,17,48,66,-18,33
Hibernian,1133,1,17,13,6,54,29,25,64
Morton,1133,2,18,10,8,53,36,17,64
Dundee Utd,1133,3,15,12,9,51,41,10,57
Falkirk,1133,4,14,12,10,51,40,11,54
Queen of S't,1133,5,14,9,13,53,46,7,51
Dunfermline,1133,6,9,14,13,43,48,-5,41
Dumbarton,1133,7,9,13,14,47,60,-13,40
St Mirren,1133,8,9,12,15,39,53,-14,39
Raith,1133,9,9,10,17,33,49,-16,37
Ayr,1133,10,7,13,16,36,58,-22,34
Hibernian,1134,1,19,13,4,64,27,37,70
Falkirk,1134,2,17,11,8,63,41,22,62
Morton,1134,3,16,14,6,48,33,15,62
Dundee Utd,1134,4,14,11,11,45,41,4,53
Queen of S't,1134,5,11,10,15,43,51,-8,43
St Mirren,1134,6,10,11,15,41,54,-13,41
Raith,1134,7,10,9,17,35,57,-22,39
Dunfermline,1134,8,8,14,14,46,51,-5,38
Ayr,1134,9,7,15,14,36,55,-19,36
Dumbarton,1134,10,7,14,15,51,62,-11,35
Hibernian,1135,1,18,14,4,54,26,28,68
Falkirk,1135,2,18,9,9,60,38,22,63
Dundee Utd,1135,3,18,9,9,49,34,15,63
Morton,1135,4,14,12,10,48,41,7,54
Dunfermline,1135,5,10,13,13,48,52,-4,43
Dumbarton,1135,6,11,10,15,49,58,-9,43
Queen of S't,1135,7,11,9,16,45,50,-5,42
Ayr,1135,8,9,14,13,35,50,-15,41
Raith,1135,9,9,9,18,35,56,-21,36
St Mirren,1135,10,7,11,18,36,54,-18,32
Hibernian,1136,1,21,12,3,59,23,36,75
Falkirk,1136,2,17,11,8,58,40,18,62
Morton,1136,3,14,14,8,47,40,7,56
Dundee Utd,1136,4,13,12,11,46,41,5,51
Dunfermline,1136,5,10,15,11,43,42,1,45
Queen of S't,1136,6,10,10,16,46,55,-9,40
St Mirren,1136,7,10,10,16,45,54,-9,40
Dumbarton,1136,8,9,13,14,49,60,-11,40
Raith,1136,9,9,10,17,34,51,-17,37
Ayr,1136,10,8,11,17,33,54,-21,35
Hibernian,1137,1,21,12,3,64,26,38,75
Dundee Utd,1137,2,18,9,9,58,42,16,63
Morton,1137,3,16,11,9,51,38,13,59
Falkirk,1137,4,15,12,9,57,41,16,57
Queen of S't,1137,5,11,9,16,42,52,-10,42
Dunfermline,1137,6,9,13,14,49,53,-4,40
Raith,1137,7,10,9,17,35,53,-18,39
Ayr,1137,8,9,11,16,36,58,-22,38
St Mirren,1137,9,9,10,17,39,56,-17,37
Dumbarton,1137,10,8,12,16,45,57,-12,36
Hibernian,1138,1,20,11,5,52,23,29,71
Morton,1138,2,18,10,8,54,35,19,64
Falkirk,1138,3,15,10,11,52,38,14,55
Dundee Utd,1138,4,14,9,13,46,45,1,51
Queen of S't,1138,5,14,8,14,54,50,4,50
Dunfermline,1138,6,11,12,13,48,49,-1,45
Raith,1138,7,11,8,17,34,49,-15,41
Dumbarton,1138,8,9,13,14,51,60,-9,40
Ayr,1138,9,9,12,15,35,56,-21,39
St Mirren,1138,10,8,9,19,35,56,-21,33
Hibernian,1139,1,19,13,4,56,24,32,70
Falkirk,1139,2,18,9,9,63,40,23,63
Morton,1139,3,16,10,10,56,42,14,58
Dundee Utd,1139,4,16,10,10,53,39,14,58
Queen of S't,1139,5,12,10,14,46,52,-6,46
Raith,1139,6,11,9,16,38,52,-14,42
Dumbarton,1139,7,10,10,16,50,59,-9,40
Dunfermline,1139,8,9,12,15,46,57,-11,39
Ayr,1139,9,8,12,16,32,55,-23,36
St Mirren,1139,10,8,11,17,36,56,-20,35
Hibernian,1140,1,18,13,5,52,23,29,67
Dundee Utd,1140,2,19,8,9,58,40,18,65
Morton,1140,3,17,11,8,54,38,16,62
Falkirk,1140,4,14,12,10,56,44,12,54
Raith,1140,5,13,9,14,39,44,-5,48
Queen of S't,1140,6,11,9,16,47,56,-9,42
Ayr,1140,7,10,12,14,39,55,-16,42
Dunfermline,1140,8,8,13,15,41,54,-13,37
Dumbarton,1140,9,8,11,17,49,65,-16,35
St Mirren,1140,10,8,10,18,43,59,-16,34
Hibernian,1141,1,19,13,4,60,28,32,70
Morton,1141,2,16,12,8,48,36,12,60
Falkirk,1141,3,16,10,10,56,38,18,58
Dundee Utd,1141,4,15,10,11,49,42,7,55
Queen of S't,1141,5,11,10,15,44,50,-6,43
Dunfermline,1141,6,10,12,14,42,46,-4,42
Ayr,1141,7,10,12,14,36,52,-16,42
Raith,1141,8,10,10,16,32,46,-14,40
St Mirren,1141,9,9,11,16,40,54,-14,38
Dumbarton,1141,10,9,10,17,43,58,-15,37
Hibernian,1142,1,21,11,4,62,26,36,74
Morton,1142,2,17,13,6,53,34,19,64
Dundee Utd,1142,3,17,8,11,53,43,10,59
Falkirk,1142,4,14,10,12,56,47,9,52
Queen of S't,1142,5,11,10,15,47,52,-5,43
Dumbarton,1142,6,10,11,15,51,63,-12,41
Dunfermline,1142,7,9,13,14,51,55,-4,40
St Mirren,1142,8,10,9,17,49,62,-13,39
Raith,1142,9,9,10,17,36,55,-19,37
Ayr,1142,10,8,13,15,38,59,-21,37
Hibernian,1143,1,17,13,6,52,27,25,64
Morton,1143,2,17,12,7,50,38,12,63
Falkirk,1143,3,17,11,8,61,38,23,62
Dundee Utd,1143,4,16,10,10,55,44,11,58
Dunfermline,1143,5,11,12,13,48,49,-1,45
Raith,1143,6,12,9,15,38,44,-6,45
Queen of S't,1143,7,10,9,17,42,53,-11,39
St Mirren,1143,8,9,11,16,42,57,-15,38
Dumbarton,1143,9,8,12,16,47,60,-13,36
Ayr,1143,10,8,11,17,38,63,-25,35
Hibernian,1144,1,20,12,4,58,29,29,72
Morton,1144,2,15,12,9,48,36,12,57
Falkirk,1144,3,15,11,10,54,39,15,56
Dundee Utd,1144,4,15,9,12,54,44,10,54
Dunfermline,1144,5,11,12,13,42,45,-3,45
Dumbarton,1144,6,11,10,15,52,58,-6,43
Queen of S't,1144,7,11,10,15,44,50,-6,43
Ayr,1144,8,10,12,14,35,54,-19,42
Raith,1144,9,10,8,18,35,52,-17,38
St Mirren,1144,10,7,14,15,38,53,-15,35
Hibernian,1145,1,20,12,4,58,27,31,72
Morton,1145,2,17,13,6,52,33,19,64
Dundee Utd,1145,3,16,9,11,50,39,11,57
Falkirk,1145,4,15,11,10,59,44,15,56
Dunfermline,1145,5,10,14,12,50,51,-1,44
Dumbarton,1145,6,10,12,14,47,53,-6,42
St Mirren,1145,7,9,11,16,39,55,-16,38
Raith,1145,8,9,11,16,36,54,-18,38
Ayr,1145,9,8,13,15,36,53,-17,37
Queen of S't,1145,10,9,8,19,38,56,-18,35
Hibernian,1146,1,19,11,6,53,27,26,68
Dundee Utd,1146,2,16,11,9,60,40,20,59
Falkirk,1146,3,16,10,10,58,42,16,58
Morton,1146,4,15,12,9,48,40,8,57
Queen of S't,1146,5,13,10,13,48,45,3,49
Dumbarton,1146,6,10,12,14,48,58,-10,42
St Mirren,1146,7,11,9,16,43,56,-13,42
Raith,1146,8,11,8,17,37,48,-11,41
Dunfermline,1146,9,8,13,15,47,57,-10,37
Ayr,1146,10,6,14,16,31,60,-29,32
Morton,1147,1,19,12,5,55,35,20,69
Hibernian,1147,2,19,11,6,55,30,25,68
Dundee Utd,1147,3,16,9,11,47,40,7,57
Falkirk,1147,4,15,10,11,54,41,13,55
Queen of S't,1147,5,12,9,15,46,50,-4,45
Raith,1147,6,12,9,15,42,48,-6,45
Dunfermline,1147,7,9,13,14,43,46,-3,40
Dumbarton,1147,8,9,12,15,51,63,-12,39
Ayr,1147,9,9,11,16,37,57,-20,38
St Mirren,1147,10,6,12,18,39,59,-20,30
Hibernian,1148,1,19,11,6,59,28,31,68
Morton,1148,2,17,11,8,50,36,14,62
Dundee Utd,1148,3,17,9,10,50,40,10,60
Falkirk,1148,4,16,11,9,59,37,22,59
Dunfermline,1148,5,9,14,13,45,47,-2,41
Dumbarton,1148,6,10,11,15,50,56,-6,41
St Mirren,1148,7,9,12,15,45,56,-11,39
Queen of S't,1148,8,9,11,16,39,56,-17,38
Ayr,1148,9,8,14,14,38,57,-19,38
Raith,1148,10,8,12,16,31,53,-22,36
Hibernian,1149,1,18,11,7,53,31,22,65
Morton,1149,2,18,10,8,52,41,11,64
Falkirk,1149,3,16,9,11,57,41,16,57
Dundee Utd,1149,4,15,10,11,49,36,13,55
Dunfermline,1149,5,12,11,13,52,49,3,47
Dumbarton,1149,6,11,11,14,50,57,-7,44
Raith,1149,7,11,9,16,35,47,-12,42
Queen of S't,1149,8,10,11,15,41,49,-8,41
St Mirren,1149,9,9,10,17,39,56,-17,37
Ayr,1149,10,8,12,16,30,51,-21,36
Hibernian,1150,1,20,10,6,55,27,28,70
Falkirk,1150,2,17,10,9,59,39,20,61
Morton,1150,3,16,10,10,49,38,11,58
Dundee Utd,1150,4,16,9,11,50,40,10,57
Queen of S't,1150,5,14,8,14,52,54,-2,50
Dunfermline,1150,6,10,14,12,46,48,-2,44
Raith,1150,7,10,10,16,38,53,-15,40
Ayr,1150,8,8,13,15,35,58,-23,37
Dumbarton,1150,9,8,12,16,50,60,-10,36
St Mirren,1150,10,8,10,18,37,54,-17,34
Hibernian,1151,1,19,13,4,59,29,30,70
Morton,1151,2,18,10,8,51,34,17,64
Falkirk,1151,3,16,12,8,60,43,17,60
Dundee Utd,1151,4,15,10,11,49,38,11,55
Queen of S't,1151,5,12,12,12,44,45,-1,48
Dunfermline,1151,6,9,15,12,47,49,-2,42
Ayr,1151,7,8,14,14,34,52,-18,38
Dumbarton,1151,8,8,12,16,44,58,-14,36
Raith,1151,9,9,8,19,32,53,-21,35
St Mirren,1151,10,8,10,18,37,56,-19,34
Hibernian,1152,1,19,12,5,54,25,29,69
Morton,1152,2,16,10,10,47,36,11,58
Falkirk,1152,3,16,9,11,57,43,14,57
Dundee Utd,1152,4,15,12,9,51,38,13,57
Queen of S't,1152,5,12,10,14,44,47,-3,46
Dunfermline,1152,6,11,11,14,47,50,-3,44
Ayr,1152,7,10,12,14,37,51,-14,42
Raith,1152,8,10,10,16,40,54,-14,40
St Mirren,1152,9,9,11,16,40,57,-17,38
Dumbarton,1152,10,8,11,17,42,58,-16,35
Hibernian,1153,1,21,12,3,56,22,34,75
Morton,1153,2,18,10,8,52,36,16,64
Dundee Utd,1153,3,14,10,12,53,46,7,52
Falkirk,1153,4,13,12,11,55,46,9,51
Raith,1153,5,12,10,14,38,46,-8,46
Queen of S't,1153,6,11,11,14,45,46,-1,44
Dunfermline,1153,7,9,13,14,45,52,-7,40
Dumbarton,1153,8,9,13,14,48,56,-8,40
St Mirren,1153,9,8,11,17,37,55,-18,35
Ayr,1153,10,7,14,15,38,62,-24,35
Hibernian,1154,1,19,13,4,55,23,32,70
Falkirk,1154,2,18,9,9,63,44,19,63
Morton,1154,3,16,13,7,48,35,13,61
Dundee Utd,1154,4,15,11,10,52,41,11,56
Dunfermline,1154,5,10,14,12,52,48,4,44
Queen of S't,1154,6,11,10,15,43,48,-5,43
Raith,1154,7,11,8,17,37,53,-16,41
Dumbarton,1154,8,10,10,16,45,57,-12,40
Ayr,1154,9,7,13,16,32,54,-22,34
St Mirren,1154,10,8,9,19,39,63,-24,33
Hibernian,1155,1,19,13,4,57,24,33,70
Morton,1155,2,19,10,7,50,33,17,67
Dundee Utd,1155,3,17,10,9,59,38,21,61
Falkirk,1155,4,15,11,10,56,45,11,56
Queen of S't,1155,5,12,11,13,46,47,-1,47
St Mirren,1155,6,10,11,15,42,49,-7,41
Dumbarton,1155,7,9,11,16,46,61,-15,38
Raith,1155,8,9,9,18,33,51,-18,36
Ayr,1155,9,8,12,16,33,61,-28,36
Dunfermline,1155,10,7,12,17,44,57,-13,33
Hibernian,1156,1,17,14,5,53,29,24,65
Morton,1156,2,16,14,6,55,39,16,62
Falkirk,1156,3,15,11,10,56,41,15,56
Dundee Utd,1156,4,15,9,12,48,40,8,54
Queen of S't,1156,5,13,8,15,45,48,-3,47
Dunfermline,1156,6,11,12,13,45,49,-4,45
Dumbarton,1156,7,11,11,14,52,58,-6,44
Raith,1156,8,11,9,16,36,48,-12,42
Ayr,1156,9,9,12,15,41,59,-18,39
St Mirren,1156,10,7,10,19,39,59,-20,31
Hibernian,1157,1,21,12,3,61,24,37,75
Dundee Utd,1157,2,15,12,9,49,37,12,57
Morton,1157,3,15,12,9,47,38,9,57
Falkirk,1157,4,14,12,10,55,39,16,54
Queen of S't,1157,5,12,10,14,48,52,-4,46
Dunfermline,1157,6,9,13,14,43,49,-6,40
Raith,1157,7,10,10,16,37,51,-14,40
Ayr,1157,8,9,13,14,38,56,-18,40
Dumbarton,1157,9,9,12,15,44,57,-13,39
St Mirren,1157,10,8,10,18,37,56,-19,34
Hibernian,1158,1,21,11,4,56,21,35,74
Morton,1158,2,17,10,9,48,35,13,61
Dundee Utd,1158,3,16,9,11,51,44,7,57
Falkirk,1158,4,14,11,11,53,41,12,53
Queen of S't,1158,5,12,10,14,47,49,-2,46
Raith,1158,6,12,9,15,38,49,-11,45
Dumbarton,1158,7,10,11,15,46,55,-9,41
Dunfermline,1158,8,9,11,16,43,49,-6,38
St Mirren,1158,9,9,10,17,42,57,-15,37
Ayr,1158,10,9,10,17,36,60,-24,37
Hibernian,1159,1,20,10,6,59,30,29,70
Morton,1159,2,18,12,6,52,37,15,66
Falkirk,1159,3,15,10,11,54,44,10,55
Dundee Utd,1159,4,13,10,13,49,44,5,49
Dunfermline,1159,5,12,12,12,54,46,8,48
Raith,1159,6,12,9,15,37,48,-11,45
Queen of S't,1159,7,11,11,14,46,53,-7,44
St Mirren,1159,8,10,9,17,43,56,-13,39
Dumbarton,1159,9,8,11,17,49,65,-16,35
Ayr,1159,10,7,14,15,33,53,-20,35
Hibernian,1160,1,20,11,5,64,25,39,71
Morton,1160,2,16,13,7,49,38,11,61
Falkirk,1160,3,15,10,11,57,43,14,55
Dundee Utd,1160,4,15,9,12,49,42,7,54
Ayr,1160,5,11,12,13,40,51,-11,45
Dunfermline,1160,6,10,14,12,44,45,-1,44
Dumbarton,1160,7,10,13,13,50,54,-4,43
St Mirren,1160,8,9,11,16,39,61,-22,38
Raith,1160,9,9,10,17,29,47,-18,37
Queen of S't,1160,10,9,9,18,38,53,-15,36
Hibernian,1161,1,17,14,5,53,28,25,65
Morton,1161,2,17,11,8,54,37,17,62
Falkirk,1161,3,17,10,9,60,41,19,61
Dundee Utd,1161,4,15,11,10,49,41,8,56
Queen of S't,1161,5,14,8,14,46,48,-2,50
Dunfermline,1161,6,9,13,14,46,53,-7,40
Ayr,1161,7,9,13,14,36,52,-16,40
Dumbarton,1161,8,9,10,17,51,63,-12,37
St Mirren,1161,9,8,13,15,40,55,-15,37
Raith,1161,10,9,9,18,33,50,-17,36
Hibernian,1162,1,20,11,5,59,29,30,71
Morton,1162,2,17,13,6,53,35,18,64
Dundee Utd,1162,3,17,9,10,53,42,11,60
Falkirk,1162,4,15,11,10,62,45,17,56
Queen of S't,1162,5,13,10,13,53,54,-1,49
Dunfermline,1162,6,10,12,14,47,52,-5,42
Dumbarton,1162,7,8,13,15,45,58,-13,37
Ayr,1162,8,8,12,16,33,55,-22,36
St Mirren,1162,9,8,11,17,36,52,-16,35
Raith,1162,10,8,10,18,32,51,-19,34
Hibernian,1163,1,19,11,6,52,27,25,68
Dundee Utd,1163,2,18,8,10,57,39,18,62
Falkirk,1163,3,17,9,10,55,38,17,60
Morton,1163,4,16,11,9,48,36,12,59
Queen of S't,1163,5,14,8,14,51,51,0,50
Dunfermline,1163,6,12,12,12,47,42,5,48
Dumbarton,1163,7,10,10,16,51,60,-9,40
Ayr,1163,8,9,11,16,32,58,-26,38
Raith,1163,9,9,9,18,34,52,-18,36
St Mirren,1163,10,7,9,20,39,63,-24,30
Hibernian,1164,1,20,11,5,57,27,30,71
Morton,1164,2,17,12,7,53,36,17,63
Falkirk,1164,3,17,10,9,57,40,17,61
Dundee Utd,1164,4,17,10,9,51,35,16,61
Dunfermline,1164,5,9,15,12,48,49,-1,42
Queen of S't,1164,6,10,11,15,43,55,-12,41
Raith,1164,7,9,12,15,35,45,-10,39
Dumbarton,1164,8,8,13,15,46,58,-12,37
St Mirren,1164,9,8,10,18,39,57,-18,34
Ayr,1164,10,7,12,17,31,58,-27,33
Hibernian,1165,1,19,12,5,55,25,30,69
Morton,1165,2,16,12,8,48,37,11,60
Dundee Utd,1165,3,16,8,12,50,42,8,56
Falkirk,1165,4,14,10,12,57,46,11,52
Queen of S't,1165,5,14,10,12,49,45,4,52
Dunfermline,1165,6,10,14,12,45,47,-2,44
Raith,1165,7,11,11,14,38,46,-8,44
Ayr,1165,8,9,12,15,34,53,-19,39
Dumbarton,1165,9,9,11,16,51,61,-10,38
St Mirren,1165,10,6,12,18,33,58,-25,30
Hibernian,1166,1,20,11,5,60,29,31,71
Morton,1166,2,19,9,8,55,38,17,66
Falkirk,1166,3,15,11,10,59,43,16,56
Dundee Utd,1166,4,15,10,11,48,42,6,55
Dunfermline,1166,5,12,12,12,54,51,3,48
Queen of S't,1166,6,11,10,15,44,55,-11,43
Dumbarton,1166,7,10,11,15,50,58,-8,41
St Mirren,1166,8,10,10,16,42,51,-9,40
Raith,1166,9,9,9,18,35,52,-17,36
Ayr,1166,10,7,11,18,33,61,-28,32
Falkirk,1167,1,18,10,8,58,38,20,64
Hibernian,1167,2,16,15,5,50,26,24,63
Morton,1167,3,16,14,6,48,35,13,62
Dundee Utd,1167,4,14,12,10,47,38,9,54
Dunfermline,1167,5,10,14,12,46,47,-1,44
Queen of S't,1167,6,11,11,14,44,47,-3,44
Raith,1167,7,10,11,15,35,47,-12,41
Ayr,1167,8,9,14,13,38,53,-15,41
St Mirren,1167,9,8,10,18,38,54,-16,34
Dumbarton,1167,10,7,11,18,43,62,-19,32
Hibernian,1168,1,20,12,4,59,25,34,72
Falkirk,1168,2,18,10,8,62,36,26,64
Dundee Utd,1168,3,17,9,10,54,43,11,60
Morton,1168,4,16,11,9,50,40,10,59
Dunfermline,1168,5,11,13,12,49,48,1,46
St Mirren,1168,6,11,9,16,40,52,-12,42
Queen of S't,1168,7,10,11,15,41,50,-9,41
Dumbarton,1168,8,8,12,16,44,59,-15,36
Raith,1168,9,8,10,18,31,51,-20,34
Ayr,1168,10,7,11,18,33,59,-26,32
Hibernian,1169,1,17,14,5,54,28,26,65
Morton,1169,2,16,12,8,48,39,9,60
Falkirk,1169,3,15,10,11,56,43,13,55
Dundee Utd,1169,4,14,12,10,53,44,9,54
Dumbarton,1169,5,11,11,14,51,56,-5,44
Queen of S't,1169,6,11,10,15,46,52,-6,43
Ayr,1169,7,10,12,14,32,49,-17,42
Dunfermline,1169,8,9,14,13,49,52,-3,41
Raith,1169,9,10,10,16,33,50,-17,40
St Mirren,1169,10,10,9,17,47,56,-9,39
Morton,1170,1,19,12,5,53,32,21,69
Hibernian,1170,2,18,12,6,53,28,25,66
Falkirk,1170,3,18,10,8,62,39,23,64
Dundee Utd,1170,4,13,9,14,45,47,-2,48
Dunfermline,1170,5,10,12,14,45,47,-2,42
Raith,1170,6,11,9,16,36,46,-10,42
Queen of S't,1170,7,11,8,17,45,57,-12,41
Ayr,1170,8,9,13,14,39,56,-17,40
Dumbarton,1170,9,8,14,14,42,52,-10,38
St Mirren,1170,10,8,11,17,37,53,-16,35
Hibernian,1171,1,20,13,3,57,23,34,73
Falkirk,1171,2,17,11,8,59,38,21,62
Morton,1171,3,16,10,10,52,46,6,58
Dundee Utd,1171,4,14,13,9,47,37,10,55
Dunfermline,1171,5,10,13,13,48,50,-2,43
Raith,1171,6,11,10,15,37,50,-13,43
Queen of S't,1171,7,9,13,14,46,55,-9,40
Dumbarton,1171,8,9,12,15,50,57,-7,39
Ayr,1171,9,7,13,16,33,56,-23,34
St Mirren,1171,10,7,12,17,35,52,-17,33
Morton,1172,1,20,9,7,54,34,20,69
Hibernian,1172,2,17,10,9,54,33,21,61
Dundee Utd,1172,3,17,9,10,46,36,10,60
Falkirk,1172,4,16,11,9,59,41,18,59
Queen of S't,1172,5,13,9,14,47,50,-3,48
Raith,1172,6,11,10,15,40,49,-9,43
Dunfermline,1172,7,9,12,15,47,54,-7,39
Dumbarton,1172,8,9,12,15,49,59,-10,39
St Mirren,1172,9,8,13,15,42,56,-14,37
Ayr,1172,10,7,11,18,32,58,-26,32
Hibernian,1173,1,18,14,4,56,26,30,68
Dundee Utd,1173,2,16,11,9,53,40,13,59
Morton,1173,3,16,11,9,50,38,12,59
Falkirk,1173,4,15,10,11,54,41,13,55
Queen of S't,1173,5,13,10,13,49,47,2,49
Dunfermline,1173,6,9,15,12,44,47,-3,42
Ayr,1173,7,10,11,15,39,60,-21,41
Dumbarton,1173,8,9,12,15,47,60,-13,39
St Mirren,1173,9,9,9,18,43,58,-15,36
Raith,1173,10,9,9,18,31,49,-18,36
Hibernian,1174,1,20,13,3,57,22,35,73
Falkirk,1174,2,18,10,8,62,38,24,64
Dundee Utd,1174,3,15,11,10,47,39,8,56
Morton,1174,4,14,13,9,46,38,8,55
Dunfermline,1174,5,11,13,12,47,45,2,46
Queen of S't,1174,6,11,10,15,48,53,-5,43
Raith,1174,7,11,8,17,36,48,-12,41
Dumbarton,1174,8,9,11,16,46,63,-17,38
Ayr,1174,9,8,12,16,32,53,-21,36
St Mirren,1174,10,6,13,17,37,59,-22,31
Hibernian,1175,1,19,13,4,55,27,28,70
Morton,1175,2,19,11,6,54,33,21,68
Falkirk,1175,3,16,11,9,58,40,18,59
Dundee Utd,1175,4,14,11,11,47,40,7,53
Queen of S't,1175,5,12,10,14,48,51,-3,46
Dunfermline,1175,6,11,12,13,46,50,-4,45
Raith,1175,7,11,8,17,39,50,-11,41
St Mirren,1175,8,8,11,17,40,56,-16,35
Dumbarton,1175,9,8,10,18,45,63,-18,34
Ayr,1175,10,7,13,16,33,55,-22,34
Hibernian,1176,1,20,11,5,53,25,28,71
Morton,1176,2,18,11,7,55,34,21,65
Falkirk,1176,3,17,11,8,60,40,20,62
Dundee Utd,1176,4,15,10,11,46,40,6,55
Queen of S't,1176,5,12,10,14,45,50,-5,46
Dumbarton,1176,6,10,12,14,54,54,0,42
St Mirren,1176,7,9,11,16,41,54,-13,38
Raith,1176,8,9,11,16,35,51,-16,38
Dunfermline,1176,9,7,13,16,40,54,-14,34
Ayr,1176,10,7,12,17,32,59,-27,33
Hibernian,1177,1,19,12,5,57,25,32,69
Morton,1177,2,18,11,7,50,35,15,65
Falkirk,1177,3,16,10,10,60,44,16,58
Dundee Utd,1177,4,15,10,11,45,37,8,55
Queen of S't,1177,5,12,11,13,44,47,-3,47
Dumbarton,1177,6,11,12,13,51,55,-4,45
Raith,1177,7,10,9,17,35,50,-15,39
Dunfermline,1177,8,9,11,16,44,52,-8,38
St Mirren,1177,9,8,11,17,43,62,-19,35
Ayr,1177,10,7,13,16,31,53,-22,34
Hibernian,1178,1,19,13,4,56,30,26,70
Dundee Utd,1178,2,17,10,9,55,37,18,61
Morton,1178,3,16,11,9,49,40,9,59
Falkirk,1178,4,14,12,10,55,46,9,54
Queen of S't,1178,5,13,11,12,48,44,4,50
Dumbarton,1178,6,11,12,13,54,57,-3,45
Dunfermline,1178,7,9,13,14,44,47,-3,40
Raith,1178,8,9,10,17,37,52,-15,37
St Mirren,1178,9,8,10,18,37,58,-21,34
Ayr,1178,10,7,12,17,32,56,-24,33
Hibernian,1179,1,18,14,4,55,27,28,68
Morton,1179,2,18,12,6,59,36,23,66
Falkirk,1179,3,17,10,9,62,40,22,61
Dundee Utd,1179,4,14,11,11,46,45,1,53
Queen of S't,1179,5,13,8,15,47,53,-6,47
Raith,1179,6,11,11,14,43,53,-10,44
Dumbarton,1179,7,10,11,15,49,58,-9,41
Dunfermline,1179,8,9,13,14,48,51,-3,40
St Mirren,1179,9,8,11,17,42,58,-16,35
Ayr,1179,10,6,11,19,30,60,-30,29
Hibernian,1180,1,22,10,4,62,22,40,76
Morton,1180,2,16,13,7,46,33,13,61
Dundee Utd,1180,3,15,9,12,51,39,12,54
Falkirk,1180,4,14,11,11,53,43,10,53
Queen of S't,1180,5,13,9,14,48,51,-3,48
Dunfermline,1180,6,10,14,12,44,45,-1,44
Raith,1180,7,11,10,15,35,45,-10,43
Ayr,1180,8,9,13,14,32,51,-19,40
St Mirren,1180,9,8,10,18,36,55,-19,34
Dumbarton,1180,10,7,11,18,43,66,-23,32
Hibernian,1181,1,20,13,3,58,23,35,73
Dundee Utd,1181,2,18,10,8,58,39,19,64
Falkirk,1181,3,15,10,11,59,44,15,55
Morton,1181,4,13,13,10,45,40,5,52
Queen of S't,1181,5,12,9,15,48,56,-8,45
Raith,1181,6,12,8,16,39,51,-12,44
Dunfermline,1181,7,8,15,13,42,48,-6,39
Dumbarton,1181,8,9,12,15,48,58,-10,39
St Mirren,1181,9,9,11,16,40,57,-17,38
Ayr,1181,10,6,15,15,32,53,-21,33
Hibernian,1182,1,19,13,4,57,25,32,70
Dundee Utd,1182,2,18,10,8,61,41,20,64
Morton,1182,3,17,11,8,53,39,14,62
Falkirk,1182,4,15,10,11,58,47,11,55
Raith,1182,5,13,8,15,41,48,-7,47
Queen of S't,1182,6,12,8,16,47,54,-7,44
Dunfermline,1182,7,9,13,14,45,51,-6,40
Dumbarton,1182,8,9,11,16,48,59,-11,38
St Mirren,1182,9,8,11,17,37,54,-17,35
Ayr,1182,10,7,11,18,32,61,-29,32
Hibernian,1183,1,21,11,4,60,23,37,74
Falkirk,1183,2,17,10,9,57,39,18,61
Morton,1183,3,16,13,7,50,39,11,61
Dundee Utd,1183,4,15,10,11,50,40,10,55
Queen of S't,1183,5,12,10,14,49,52,-3,46
Dunfermline,1183,6,10,13,13,51,51,0,43
St Mirren,1183,7,10,9,17,39,55,-16,39
Dumbarton,1183,8,8,12,16,47,64,-17,36
Raith,1183,9,9,9,18,35,53,-18,36
Ayr,1183,10,7,13,16,30,52,-22,34
Hibernian,1184,1,21,12,3,57,22,35,75
Falkirk,1184,2,16,12,8,60,41,19,60
Morton,1184,3,15,11,10,52,43,9,56
Dundee Utd,1184,4,13,14,9,49,40,9,53
Queen of S't,1184,5,11,11,14,47,50,-3,44
Dumbarton,1184,6,11,11,14,52,58,-6,44
Dunfermline,1184,7,9,15,12,48,48,0,42
Raith,1184,8,11,9,16,36,49,-13,42
Ayr,1184,9,7,12,17,30,57,-27,33
St Mirren,1184,10,7,11,18,42,65,-23,32
Hibernian,1185,1,21,10,5,61,26,35,73
Morton,1185,2,16,12,8,50,43,7,60
Dundee Utd,1185,3,16,11,9,52,43,9,59
Falkirk,1185,4,14,10,12,55,45,10,52
Queen of S't,1185,5,14,9,13,49,49,0,51
Dunfermline,1185,6,10,13,13,55,56,-1,43
Raith,1185,7,11,9,16,34,45,-11,42
Dumbarton,1185,8,10,11,15,51,56,-5,41
St Mirren,1185,9,7,11,18,36,55,-19,32
Ayr,1185,10,6,14,16,31,56,-25,32
Hibernian,1186,1,18,13,5,53,26,27,67
Morton,1186,2,16,11,9,45,35,10,59
Dundee Utd,1186,3,16,10,10,49,40,9,58
Falkirk,1186,4,14,11,11,53,43,10,53
Dunfermline,1186,5,12,12,12,51,46,5,48
Queen of S't,1186,6,12,9,15,42,49,-7,45
Raith,1186,7,11,9,16,36,49,-13,42
Dumbarton,1186,8,10,11,15,48,53,-5,41
St Mirren,1186,9,9,12,15,40,52,-12,39
Ayr,1186,10,7,12,17,32,56,-24,33
Hibernian,1187,1,21,11,4,57,25,32,74
Falkirk,1187,2,17,10,9,66,44,22,61
Morton,1187,3,17,10,9,52,41,11,61
Dundee Utd,1187,4,15,11,10,53,44,9,56
Queen of S't,1187,5,12,10,14,44,45,-1,46
Dunfermline,1187,6,10,12,14,49,51,-2,42
Raith,1187,7,11,9,16,35,50,-15,42
Dumbarton,1187,8,9,12,15,47,56,-9,39
St Mirren,1187,9,7,12,17,40,60,-20,33
Ayr,1187,10,6,13,17,30,57,-27,31
Hibernian,1188,1,20,12,4,59,26,33,72
Dundee Utd,1188,2,18,10,8,58,36,22,64
Morton,1188,3,17,12,7,50,31,19,63
Falkirk,1188,4,15,10,11,56,44,12,55
Queen of S't,1188,5,12,8,16,46,55,-9,44
Raith,1188,6,10,10,16,36,51,-15,40
Dunfermline,1188,7,9,12,15,45,54,-9,39
Ayr,1188,8,9,12,15,35,57,-22,39
Dumbarton,1188,9,9,11,16,46,61,-15,38
St Mirren,1188,10,8,9,19,40,56,-16,33
Morton,1189,1,19,10,7,51,36,15,67
Hibernian,1189,2,18,12,6,53,31,22,66
Falkirk,1189,3,16,11,9,62,39,23,59
Dundee Utd,1189,4,16,11,9,53,37,16,59
Queen of S't,1189,5,13,9,14,46,50,-4,48
Dumbarton,1189,6,11,10,15,48,59,-11,43
Raith,1189,7,10,10,16,39,53,-14,40
Dunfermline,1189,8,8,13,15,43,50,-7,37
St Mirren,1189,9,8,11,17,42,55,-13,35
Ayr,1189,10,7,11,18,32,59,-27,32
Hibernian,1190,1,17,13,6,58,33,25,64
Dundee Utd,1190,2,17,11,8,52,38,14,62
Morton,1190,3,15,14,7,51,41,10,59
Falkirk,1190,4,14,14,8,58,42,16,56
Queen of S't,1190,5,12,10,14,49,50,-1,46
Dunfermline,1190,6,11,12,13,53,49,4,45
St Mirren,1190,7,9,12,15,40,54,-14,39
Raith,1190,8,9,12,15,34,49,-15,39
Dumbarton,1190,9,9,11,16,49,60,-11,38
Ayr,1190,10,6,13,17,30,58,-28,31
Hibernian,1191,1,19,12,5,54,27,27,69
Morton,1191,2,17,11,8,55,38,17,62
Dundee Utd,1191,3,17,10,9,56,39,17,61
Falkirk,1191,4,15,9,12,58,43,15,54
Raith,1191,5,13,9,14,40,45,-5,48
Dunfermline,1191,6,9,15,12,45,50,-5,42
Queen of S't,1191,7,11,8,17,44,53,-9,41
Dumbarton,1191,8,9,12,15,47,61,-14,39
Ayr,1191,9,8,12,16,34,59,-25,36
St Mirren,1191,10,8,10,18,41,59,-18,34
Hibernian,1192,1,20,11,5,57,27,30,71
Morton,1192,2,17,11,8,45,34,11,62
Falkirk,1192,3,15,11,10,61,43,18,56
Dundee Utd,1192,4,14,12,10,50,39,11,54
Dunfermline,1192,5,11,13,12,49,53,-4,46
St Mirren,1192,6,10,11,15,39,50,-11,41
Queen of S't,1192,7,10,10,16,44,51,-7,40
Ayr,1192,8,9,13,14,35,51,-16,40
Dumbarton,1192,9,9,12,15,50,59,-9,39
Raith,1192,10,9,8,19,33,56,-23,35
Hibernian,1193,1,19,13,4,58,26,32,70
Morton,1193,2,18,13,5,54,33,21,67
Dundee Utd,1193,3,17,10,9,53,37,16,61
Falkirk,1193,4,16,11,9,59,41,18,59
Dunfermline,1193,5,9,13,14,42,47,-5,40
Queen of S't,1193,6,10,10,16,40,48,-8,40
Dumbarton,1193,7,9,12,15,47,59,-12,39
St Mirren,1193,8,8,12,16,43,61,-18,36
Raith,1193,9,8,11,17,35,56,-21,35
Ayr,1193,10,6,15,15,34,57,-23,33
Hibernian,1194,1,20,13,3,58,24,34,73
Dundee Utd,1194,2,17,8,11,51,41,10,59
Falkirk,1194,3,15,11,10,57,43,14,56
Morton,1194,4,14,13,9,48,40,8,55
Dumbarton,1194,5,11,13,12,50,51,-1,46
Queen of S't,1194,6,11,10,15,45,53,-8,43
Raith,1194,7,11,9,16,39,54,-15,42
Ayr,1194,8,9,12,15,37,55,-18,39
Dunfermline,1194,9,8,13,15,43,53,-10,37
St Mirren,1194,10,8,10,18,44,58,-14,34
Hibernian,1195,1,18,12,6,58,29,29,66
Morton,1195,2,17,13,6,49,32,17,64
Falkirk,1195,3,16,9,11,55,40,15,57
Dundee Utd,1195,4,14,13,9,46,39,7,55
Queen of S't,1195,5,13,10,13,48,48,0,49
Dunfermline,1195,6,10,13,13,42,43,-1,43
Dumbarton,1195,7,9,13,14,48,58,-10,40
Raith,1195,8,10,9,17,34,50,-16,39
Ayr,1195,9,6,16,14,33,53,-20,34
St Mirren,1195,10,8,10,18,36,57,-21,34
Hibernian,1196,1,18,14,4,54,25,29,68
Morton,1196,2,16,13,7,49,34,15,61
Falkirk,1196,3,16,11,9,59,44,15,59
Dundee Utd,1196,4,17,8,11,50,37,13,59
Dunfermline,1196,5,10,13,13,50,51,-1,43
Queen of S't,1196,6,10,12,14,41,48,-7,42
Ayr,1196,7,10,12,14,36,51,-15,42
Dumbarton,1196,8,8,12,16,46,61,-15,36
St Mirren,1196,9,8,12,16,42,57,-15,36
Raith,1196,10,9,9,18,33,52,-19,36
Hibernian,1197,1,17,13,6,56,28,28,64
Falkirk,1197,2,17,11,8,59,38,21,62
Morton,1197,3,17,11,8,52,35,17,62
Dundee Utd,1197,4,16,10,10,50,37,13,58
Dunfermline,1197,5,12,12,12,50,45,5,48
Dumbarton,1197,6,10,12,14,53,57,-4,42
Queen of S't,1197,7,10,11,15,42,57,-15,41
Raith,1197,8,8,13,15,32,48,-16,37
Ayr,1197,9,8,11,17,34,58,-24,35
St Mirren,1197,10,8,10,18,35,60,-25,34
Hibernian,1198,1,19,12,5,58,31,27,69
Dundee Utd,1198,2,18,10,8,56,42,14,64
Morton,1198,3,17,12,7,53,38,15,63
Falkirk,1198,4,15,11,10,64,46,18,56
Dunfermline,1198,5,11,13,12,51,48,3,46
Queen of S't,1198,6,11,10,15,44,51,-7,43
Raith,1198,7,11,9,16,38,51,-13,42
St Mirren,1198,8,9,10,17,46,57,-11,37
Dumbarton,1198,9,7,12,17,46,65,-19,33
Ayr,1198,10,6,13,17,29,56,-27,31
Hibernian,1199,1,18,15,3,53,20,33,69
Morton,1199,2,16,10,10,46,38,8,58
Dundee Utd,1199,3,15,10,11,43,35,8,55
Falkirk,1199,4,13,14,9,53,40,13,53
Ayr,1199,5,12,11,13,37,50,-13,47
Dunfermline,1199,6,10,15,11,50,47,3,45
Queen of S't,1199,7,11,11,14,41,46,-5,44
Dumbarton,1199,8,9,12,15,48,60,-12,39
St Mirren,1199,9,9,9,18,38,56,-18,36
Raith,1199,10,8,11,17,31,48,-17,35
Hibernian,1200,1,20,12,4,55,23,32,72
Falkirk,1200,2,18,9,9,60,38,22,63
Morton,1200,3,17,10,9,49,38,11,61
Dundee Utd,1200,4,16,9,11,51,44,7,57
Raith,1200,5,12,10,14,40,45,-5,46
Dunfermline,1200,6,10,12,14,46,49,-3,42
Queen of S't,1200,7,11,9,16,47,52,-5,42
Dumbarton,1200,8,9,10,17,49,64,-15,37
Ayr,1200,9,7,13,16,37,59,-22,34
St Mirren,1200,9,8,10,18,37,59,-22,34
Hibernian,1201,1,21,11,4,64,25,39,74
Morton,1201,2,18,11,7,53,36,17,65
Falkirk,1201,3,17,9,10,58,44,14,60
Dundee Utd,1201,4,16,11,9,49,39,10,59
Queen of S't,1201,5,11,9,16,45,51,-6,42
Raith,1201,6,11,8,17,35,51,-16,41
Dumbarton,1201,7,9,12,15,46,55,-9,39
St Mirren,1201,8,9,10,17,40,53,-13,37
Dunfermline,1201,9,7,14,15,45,53,-8,35
Ayr,1201,10,8,11,17,32,60,-28,35
Hibernian,1202,1,18,11,7,54,25,29,65
Morton,1202,2,18,9,9,51,42,9,63
Falkirk,1202,3,17,9,10,59,42,17,60
Dundee Utd,1202,4,16,10,10,53,42,11,58
Queen of S't,1202,5,11,12,13,45,50,-5,45
Raith,1202,6,12,9,15,37,45,-8,45
Dunfermline,1202,7,10,13,13,47,50,-3,43
Dumbarton,1202,8,9,11,16,46,60,-14,38
St Mirren,1202,9,8,11,17,43,56,-13,35
Ayr,1202,10,7,13,16,33,56,-23,34
Hibernian,1203,1,19,12,5,65,32,33,69
Morton,1203,2,18,10,8,55,39,16,64
Falkirk,1203,3,16,11,9,59,41,18,59
Dundee Utd,1203,4,17,8,11,55,41,14,59
Dunfermline,1203,5,11,13,12,54,50,4,46
Dumbarton,1203,6,9,13,14,51,62,-11,40
Queen of S't,1203,7,10,9,17,43,58,-15,39
Ayr,1203,8,9,12,15,35,53,-18,39
Raith,1203,9,10,8,18,37,53,-16,38
St Mirren,1203,10,8,10,18,39,64,-25,34
Hibernian,1204,1,19,14,3,56,27,29,71
Dundee Utd,1204,2,18,9,9,54,36,18,63
Falkirk,1204,3,15,11,10,54,41,13,56
Morton,1204,4,14,12,10,44,37,7,54
Queen of S't,1204,5,11,10,15,44,50,-6,43
Raith,1204,6,10,11,15,33,45,-12,41
Dumbarton,1204,7,9,12,15,48,59,-11,39
Ayr,1204,8,9,12,15,33,52,-19,39
Dunfermline,1204,9,8,14,14,44,50,-6,38
St Mirren,1204,10,8,13,15,38,51,-13,37
Hibernian,1205,1,20,11,5,60,25,35,71
Falkirk,1205,2,17,12,7,58,35,23,63
Dundee Utd,1205,3,18,9,9,52,37,15,63
Morton,1205,4,15,12,9,49,44,5,57
Raith,1205,5,12,9,15,38,47,-9,45
Dunfermline,1205,6,10,12,14,47,51,-4,42
Queen of S't,1205,7,10,11,15,45,53,-8,41
Dumbarton,1205,8,8,12,16,46,59,-13,36
Ayr,1205,9,8,11,17,36,57,-21,35
St Mirren,1205,10,7,11,18,38,61,-23,32
Morton,1206,1,20,10,6,58,37,21,70
Falkirk,1206,2,18,10,8,59,38,21,64
Hibernian,1206,3,17,12,7,56,29,27,63
Dundee Utd,1206,4,15,9,12,52,45,7,54
Dunfermline,1206,5,11,11,14,48,50,-2,44
Queen of S't,1206,6,11,10,15,45,50,-5,43
Ayr,1206,7,10,11,15,36,59,-23,41
St Mirren,1206,8,10,9,17,44,55,-11,39
Raith,1206,9,9,10,17,33,50,-17,37
Dumbarton,1206,10,7,12,17,48,66,-18,33
Hibernian,1207,1,17,13,6,55,28,27,64
Falkirk,1207,2,17,11,8,66,40,26,62
Morton,1207,3,16,13,7,50,35,15,61
Dundee Utd,1207,4,14,10,12,47,41,6,52
Queen of S't,1207,5,12,10,14,49,52,-3,46
Dunfermline,1207,6,10,14,12,44,50,-6,44
Dumbarton,1207,7,10,13,13,48,56,-8,43
Ayr,1207,8,10,12,14,39,53,-14,42
Raith,1207,9,10,10,16,35,49,-14,40
St Mirren,1207,10,6,10,20,39,68,-29,28
Hibernian,1208,1,21,11,4,60,26,34,74
Falkirk,1208,2,17,10,9,61,40,21,61
Dundee Utd,1208,3,17,10,9,51,38,13,61
Morton,1208,4,15,11,10,48,39,9,56
Dunfermline,1208,5,11,14,11,51,47,4,47
Queen of S't,1208,6,11,9,16,43,50,-7,42
Raith,1208,7,10,10,16,37,51,-14,40
Dumbarton,1208,8,9,11,16,49,62,-13,38
Ayr,1208,9,8,12,16,33,57,-24,36
St Mirren,1208,10,7,10,19,37,60,-23,31
Hibernian,1209,1,19,12,5,52,22,30,69
Dundee Utd,1209,2,19,9,8,58,37,21,66
Morton,1209,3,16,13,7,50,34,16,61
Falkirk,1209,4,16,9,11,51,41,10,57
Queen of S't,1209,5,12,10,14,42,53,-11,46
Dumbarton,1209,6,9,13,14,47,55,-8,40
Dunfermline,1209,7,9,12,15,44,50,-6,39
St Mirren,1209,8,10,9,17,40,55,-15,39
Raith,1209,9,10,8,18,39,51,-12,38
Ayr,1209,10,6,13,17,31,56,-25,31
Hibernian,1210,1,19,11,6,54,28,26,68
Morton,1210,2,15,14,7,51,37,14,59
Dundee Utd,1210,3,16,11,9,49,35,14,59
Falkirk,1210,4,15,10,11,52,39,13,55
Dunfermline,1210,5,10,15,11,45,44,1,45
St Mirren,1210,6,11,11,14,46,53,-7,44
Queen of S't,1210,7,10,11,15,43,51,-8,41
Ayr,1210,8,10,11,15,38,56,-18,41
Dumbarton,1210,9,9,10,17,43,58,-15,37
Raith,1210,10,8,10,18,31,51,-20,34
Hibernian,1211,1,18,13,5,50,24,26,67
Morton,1211,2,18,11,7,53,39,14,65
Dundee Utd,1211,3,18,8,10,50,37,13,62
Falkirk,1211,4,16,11,9,55,37,18,59
Queen of S't,1211,5,13,8,15,47,51,-4,47
St Mirren,1211,6,11,9,16,46,56,-10,42
Raith,1211,7,10,9,17,36,50,-14,39
Dunfermline,1211,8,9,11,16,50,56,-6,38
Dumbarton,1211,9,8,12,16,46,59,-13,36
Ayr,1211,10,7,12,17,29,53,-24,33
Morton,1212,1,18,11,7,57,40,17,65
Hibernian,1212,2,16,13,7,51,31,20,61
Falkirk,1212,3,16,10,10,57,41,16,58
Dundee Utd,1212,4,15,12,9,48,36,12,57
Dunfermline,1212,5,11,13,12,45,46,-1,46
Ayr,1212,6,9,14,13,43,56,-13,41
Queen of S't,1212,7,10,10,16,42,51,-9,40
St Mirren,1212,8,8,14,14,43,55,-12,38
Raith,1212,9,9,11,16,35,49,-14,38
Dumbarton,1212,10,8,12,16,44,60,-16,36
Hibernian,1213,1,20,12,4,54,24,30,72
Falkirk,1213,2,17,9,10,59,42,17,60
Morton,1213,3,17,9,10,48,37,11,60
Dundee Utd,1213,4,15,9,12,49,38,11,54
Queen of S't,1213,5,14,8,14,46,51,-5,50
Raith,1213,6,11,10,15,38,45,-7,43
Dunfermline,1213,7,10,12,14,43,47,-4,42
Dumbarton,1213,8,9,10,17,48,63,-15,37
Ayr,1213,9,8,13,15,33,52,-19,37
St Mirren,1213,10,8,10,18,38,57,-19,34
Falkirk,1214,1,18,11,7,56,33,23,65
Hibernian,1214,2,18,10,8,52,30,22,64
Morton,1214,3,16,13,7,48,36,12,61
Dundee Utd,1214,4,15,10,11,53,42,11,55
Dunfermline,1214,5,11,13,12,48,45,3,46
Ayr,1214,6,11,11,14,41,55,-14,44
Queen of S't,1214,7,11,9,16,44,53,-9,42
Raith,1214,8,10,10,16,34,48,-14,40
St Mirren,1214,9,9,11,16,37,54,-17,38
Dumbarton,1214,10,7,10,19,45,62,-17,31
Hibernian,1215,1,20,11,5,60,25,35,71
Morton,1215,2,18,11,7,49,33,16,65
Dundee Utd,1215,3,17,10,9,50,38,12,61
Falkirk,1215,4,14,11,11,57,47,10,53
Queen of S't,1215,5,14,9,13,46,46,0,51
Dumbarton,1215,6,9,12,15,48,57,-9,39
Raith,1215,7,10,9,17,36,54,-18,39
St Mirren,1215,8,9,11,16,37,52,-15,38
Dunfermline,1215,9,8,12,16,42,48,-6,36
Ayr,1215,10,8,10,18,32,57,-25,34
Hibernian,1216,1,18,14,4,53,23,30,68
Dundee Utd,1216,2,18,9,9,54,38,16,63
Morton,1216,3,16,13,7,48,37,11,61
Falkirk,1216,4,15,11,10,56,41,15,56
Queen of S't,1216,5,10,11,15,39,49,-10,41
Dunfermline,1216,6,9,13,14,45,47,-2,40
Dumbarton,1216,7,9,13,14,43,55,-12,40
Raith,1216,8,10,10,16,32,44,-12,40
Ayr,1216,9,8,13,15,33,53,-20,37
St Mirren,1216,10,8,11,17,38,54,-16,35
Hibernian,1217,1,21,10,5,60,27,33,73
Morton,1217,2,16,12,8,51,39,12,60
Dundee Utd,1217,3,14,12,10,48,39,9,54
Falkirk,1217,4,14,11,11,55,43,12,53
Queen of S't,1217,5,12,10,14,48,54,-6,46
Dunfermline,1217,6,11,12,13,48,47,1,45
Raith,1217,7,10,10,16,38,51,-13,40
Ayr,1217,8,8,15,13,38,53,-15,39
St Mirren,1217,9,9,10,17,42,59,-17,37
Dumbarton,1217,10,8,12,16,43,59,-16,36
Hibernian,1218,1,18,13,5,53,28,25,67
Morton,1218,2,17,12,7,51,32,19,63
Falkirk,1218,3,16,13,7,61,38,23,61
Dundee Utd,1218,4,16,9,11,50,45,5,57
Queen of S't,1218,5,14,8,14,49,50,-1,50
Dunfermline,1218,6,11,12,13,47,48,-1,45
Raith,1218,7,10,9,17,35,51,-16,39
Dumbarton,1218,8,7,14,15,48,60,-12,35
St Mirren,1218,9,8,10,18,35,56,-21,34
Ayr,1218,10,7,12,17,35,56,-21,33
Falkirk,1219,1,20,9,7,64,37,27,69
Hibernian,1219,2,18,11,7,50,25,25,65
Morton,1219,3,18,11,7,51,35,16,65
Dundee Utd,1219,4,12,11,13,40,43,-3,47
Raith,1219,5,11,10,15,36,46,-10,43
Queen of S't,1219,6,10,12,14,42,51,-9,42
St Mirren,1219,7,10,11,15,44,51,-7,41
Dumbarton,1219,8,9,13,14,49,55,-6,40
Ayr,1219,9,8,12,16,31,55,-24,36
Dunfermline,1219,10,7,14,15,41,50,-9,35
Hibernian,1220,1,21,11,4,56,24,32,74
Falkirk,1220,2,16,13,7,61,39,22,61
Morton,1220,3,17,9,10,47,39,8,60
Dundee Utd,1220,4,13,12,11,47,40,7,51
Dunfermline,1220,5,10,14,12,46,46,0,44
Queen of S't,1220,6,10,10,16,43,51,-8,40
Ayr,1220,7,9,13,14,36,53,-17,40
Raith,1220,8,10,9,17,35,53,-18,39
Dumbarton,1220,9,8,13,15,46,58,-12,37
St Mirren,1220,10,9,10,17,40,54,-14,37
Hibernian,1221,1,19,13,4,59,25,34,70
Dundee Utd,1221,2,17,11,8,52,37,15,62
Morton,1221,3,15,14,7,49,37,12,59
Falkirk,1221,4,14,11,11,55,45,10,53
Queen of S't,1221,5,11,9,16,39,49,-10,42
Raith,1221,6,11,9,16,33,48,-15,42
Dumbarton,1221,7,10,11,15,47,56,-9,41
Dunfermline,1221,8,9,13,14,44,49,-5,40
Ayr,1221,9,9,11,16,34,54,-20,38
St Mirren,1221,10,9,10,17,41,53,-12,37
Hibernian,1222,1,20,10,6,55,26,29,70
Dundee Utd,1222,2,18,9,9,51,35,16,63
Morton,1222,3,16,10,10,53,41,12,58
Falkirk,1222,4,15,11,10,58,43,15,56
Dunfermline,1222,5,10,13,13,47,48,-1,43
Raith,1222,6,11,10,15,40,51,-11,43
Queen of S't,1222,7,10,11,15,44,53,-9,41
St Mirren,1222,8,10,9,17,41,57,-16,39
Ayr,1222,9,9,11,16,36,56,-20,38
Dumbarton,1222,10,8,12,16,44,59,-15,36
Hibernian,1223,1,19,13,4,57,24,33,70
Morton,1223,2,18,11,7,49,33,16,65
Falkirk,1223,3,16,11,9,60,44,16,59
Dundee Utd,1223,4,15,10,11,52,43,9,55
Dunfermline,1223,5,12,12,12,50,47,3,48
Queen of S't,1223,6,10,9,17,44,56,-12,39
Raith,1223,7,10,9,17,32,52,-20,39
Ayr,1223,8,8,14,14,35,52,-17,38
Dumbarton,1223,9,8,12,16,45,59,-14,36
St Mirren,1223,10,8,11,17,39,53,-14,35
Hibernian,1224,1,21,11,4,57,23,34,74
Falkirk,1224,2,17,10,9,64,38,26,61
Morton,1224,3,16,10,10,47,35,12,58
Dundee Utd,1224,4,16,9,11,48,39,9,57
Raith,1224,5,12,9,15,37,52,-15,45
Dunfermline,1224,6,10,12,14,48,50,-2,42
Ayr,1224,7,10,10,16,36,58,-22,40
Queen of S't,1224,8,10,9,17,42,55,-13,39
Dumbarton,1224,9,7,16,13,45,55,-10,37
St Mirren,1224,10,7,12,17,38,57,-19,33
Hibernian,1225,1,21,12,3,56,20,36,75
Morton,1225,2,16,15,5,48,32,16,63
Dundee Utd,1225,3,14,12,10,47,39,8,54
Falkirk,1225,4,13,12,11,54,47,7,51
Dunfermline,1225,5,10,12,14,44,46,-2,42
Queen of S't,1225,6,11,9,16,43,51,-8,42
Dumbarton,1225,7,9,13,14,54,62,-8,40
Raith,1225,8,10,10,16,34,49,-15,40
St Mirren,1225,9,9,11,16,39,52,-13,38
Ayr,1225,10,9,10,17,33,54,-21,37
Hibernian,1226,1,18,13,5,58,31,27,67
Dundee Utd,1226,2,18,9,9,60,42,18,63
Morton,1226,3,17,10,9,50,38,12,61
Falkirk,1226,4,15,11,10,57,42,15,56
Queen of S't,1226,5,11,10,15,44,50,-6,43
St Mirren,1226,6,10,12,14,42,51,-9,42
Dunfermline,1226,7,9,13,14,48,53,-5,40
Dumbarton,1226,8,9,13,14,49,58,-9,40
Raith,1226,9,9,11,16,32,50,-18,38
Ayr,1226,10,8,10,18,34,59,-25,34
Hibernian,1227,1,20,12,4,56,23,33,72
Morton,1227,2,16,10,10,50,42,8,58
Dundee Utd,1227,3,15,12,9,51,41,10,57
Falkirk,1227,4,14,12,10,55,41,14,54
Dunfermline,1227,5,10,15,11,50,49,1,45
Queen of S't,1227,6,11,10,15,44,50,-6,43
Dumbarton,1227,7,9,12,15,49,60,-11,39
Raith,1227,8,10,9,17,33,49,-16,39
St Mirren,1227,9,9,11,16,42,53,-11,38
Ayr,1227,10,9,11,16,32,54,-22,38
Hibernian,1228,1,20,12,4,59,24,35,72
Morton,1228,2,16,10,10,53,42,11,58
Dundee Utd,1228,3,16,10,10,49,41,8,58
Falkirk,1228,4,14,11,11,55,45,10,53
Queen of S't,1228,5,13,11,12,46,45,1,50
Dunfermline,1228,6,9,14,13,48,51,-3,41
Raith,1228,7,10,9,17,36,52,-16,39
Dumbarton,1228,8,8,14,14,48,60,-12,38
Ayr,1228,9,8,14,14,38,54,-16,38
St Mirren,1228,10,9,9,18,42,60,-18,36
Hibernian,1229,1,20,11,5,63,31,32,71
Morton,1229,2,18,12,6,53,36,17,66
Falkirk,1229,3,16,11,9,58,40,18,59
Dundee Utd,1229,4,16,10,10,55,43,12,58
Dumbarton,1229,5,11,12,13,50,53,-3,45
Queen of S't,1229,6,11,11,14,47,51,-4,44
Raith,1229,7,10,10,16,36,50,-14,40
Dunfermline,1229,8,8,11,17,44,55,-11,35
Ayr,1229,9,8,11,17,33,59,-26,35
St Mirren,1229,10,7,11,18,34,55,-21,32
Hibernian,1230,1,19,12,5,54,23,31,69
Falkirk,1230,2,18,10,8,63,36,27,64
Dundee Utd,1230,3,17,10,9,51,36,15,61
Morton,1230,4,14,15,7,44,34,10,57
Dunfermline,1230,5,11,13,12,45,46,-1,46
Queen of S't,1230,6,12,8,16,44,52,-8,44
Raith,1230,7,10,11,15,35,49,-14,41
St Mirren,1230,8,8,11,17,41,61,-20,35
Dumbarton,1230,9,7,12,17,46,63,-17,33
Ayr,1230,10,7,12,17,31,54,-23,33
Hibernian,1231,1,18,13,5,57,27,30,67
Morton,1231,2,17,12,7,50,36,14,63
Dundee Utd,1231,3,18,8,10,56,42,14,62
Falkirk,1231,4,16,12,8,58,41,17,60
Queen of S't,1231,5,12,10,14,48,52,-4,46
Dumbarton,1231,6,10,12,14,56,60,-4,42
Raith,1231,7,9,10,17,34,49,-15,37
Dunfermline,1231,8,8,12,16,41,52,-11,36
St Mirren,1231,9,8,12,16,40,58,-18,36
Ayr,1231,10,7,13,16,33,56,-23,34
Hibernian,1232,1,18,12,6,51,28,23,66
Falkirk,1232,2,17,11,8,59,36,23,62
Morton,1232,3,15,14,7,50,37,13,59
Dundee Utd,1232,4,15,9,12,50,45,5,54
Dunfermline,1232,5,10,14,12,50,51,-1,44
Queen of S't,1232,6,11,10,15,44,51,-7,43
Raith,1232,7,10,12,14,38,49,-11,42
Dumbarton,1232,8,9,11,16,46,60,-14,38
Ayr,1232,9,8,14,14,36,50,-14,38
St Mirren,1232,10,8,11,17,41,58,-17,35
Hibernian,1233,1,21,12,3,53,20,33,75
Morton,1233,2,16,12,8,52,37,15,60
Falkirk,1233,3,15,11,10,59,44,15,56
Dundee Utd,1233,4,14,11,11,49,46,3,53
Dunfermline,1233,5,11,12,13,47,48,-1,45
Queen of S't,1233,6,12,8,16,47,50,-3,44
Dumbarton,1233,7,11,11,14,51,60,-9,44
Raith,1233,8,10,9,17,37,54,-17,39
Ayr,1233,9,8,12,16,44,63,-19,36
St Mirren,1233,10,7,12,17,43,60,-17,33
Hibernian,1234,1,17,13,6,52,28,24,64
Falkirk,1234,2,17,11,8,57,36,21,62
Morton,1234,3,17,11,8,51,35,16,62
Dundee Utd,1234,4,14,9,13,46,47,-1,51
Dunfermline,1234,5,12,12,12,49,46,3,48
Raith,1234,6,11,12,13,40,45,-5,45
Queen of S't,1234,7,11,9,16,44,51,-7,42
Dumbarton,1234,8,9,12,15,48,55,-7,39
Ayr,1234,9,8,12,16,36,59,-23,36
St Mirren,1234,10,8,11,17,36,57,-21,35
Hibernian,1235,1,15,16,5,49,27,22,61
Falkirk,1235,2,16,12,8,58,39,19,60
Dundee Utd,1235,3,16,8,12,46,40,6,56
Morton,1235,4,14,12,10,45,37,8,54
Dunfermline,1235,5,12,12,12,48,46,2,48
Queen of S't,1235,6,11,10,15,43,50,-7,43
St Mirren,1235,7,11,10,15,42,52,-10,43
Raith,1235,8,10,11,15,35,48,-13,41
Ayr,1235,9,9,12,15,36,52,-16,39
Dumbarton,1235,10,8,13,15,47,58,-11,37
Hibernian,1236,1,18,13,5,55,29,26,67
Morton,1236,2,16,13,7,54,38,16,61
Falkirk,1236,3,16,10,10,58,42,16,58
Dundee Utd,1236,4,14,11,11,49,45,4,53
Dunfermline,1236,5,11,14,11,56,50,6,47
Dumbarton,1236,6,12,11,13,51,55,-4,47
Queen of S't,1236,7,12,10,14,48,50,-2,46
St Mirren,1236,8,9,10,17,37,53,-16,37
Ayr,1236,9,7,13,16,35,56,-21,34
Raith,1236,10,8,9,19,34,59,-25,33
Hibernian,1237,1,19,13,4,55,24,31,70
Morton,1237,2,17,12,7,49,33,16,63
Falkirk,1237,3,14,12,10,59,45,14,54
Dundee Utd,1237,4,14,11,11,52,44,8,53
Raith,1237,5,12,9,15,34,44,-10,45
Dumbarton,1237,6,11,11,14,50,57,-7,44
Dunfermline,1237,7,10,13,13,45,45,0,43
Queen of S't,1237,8,10,9,17,40,52,-12,39
Ayr,1237,9,8,13,15,33,59,-26,37
St Mirren,1237,10,8,11,17,40,54,-14,35
Hibernian,1238,1,20,11,5,61,25,36,71
Morton,1238,2,17,10,9,52,40,12,61
Dundee Utd,1238,3,17,9,10,54,40,14,60
Falkirk,1238,4,16,9,11,59,47,12,57
Queen of S't,1238,5,13,9,14,49,47,2,48
Dumbarton,1238,6,10,11,15,50,58,-8,41
Dunfermline,1238,7,10,11,15,42,52,-10,41
Raith,1238,8,10,8,18,34,51,-17,38
Ayr,1238,9,9,11,16,33,57,-24,38
St Mirren,1238,10,9,9,18,38,55,-17,36
Hibernian,1239,1,19,11,6,53,27,26,68
Morton,1239,2,18,10,8,54,39,15,64
Falkirk,1239,3,17,10,9,59,39,20,61
Dundee Utd,1239,4,15,11,10,47,39,8,56
Dunfermline,1239,5,11,13,12,49,47,2,46
Queen of S't,1239,6,10,10,16,40,53,-13,40
St Mirren,1239,7,9,11,16,42,54,-12,38
Dumbarton,1239,8,9,11,16,50,63,-13,38
Raith,1239,9,10,8,18,31,46,-15,38
Ayr,1239,10,8,13,15,33,51,-18,37
Morton,1240,1,18,11,7,57,40,17,65
Hibernian,1240,2,17,13,6,55,31,24,64
Dundee Utd,1240,3,17,9,10,54,42,12,60
Falkirk,1240,4,15,12,9,61,41,20,57
Dumbarton,1240,5,11,12,13,52,57,-5,45
Queen of S't,1240,6,11,11,14,47,53,-6,44
Raith,1240,7,11,10,15,43,54,-11,43
Dunfermline,1240,8,8,14,14,44,50,-6,38
Ayr,1240,9,6,15,15,33,58,-25,33
St Mirren,1240,10,6,13,17,37,57,-20,31
Hibernian,1241,1,23,10,3,61,22,39,79
Morton,1241,2,17,11,8,51,36,15,62
Falkirk,1241,3,16,11,9,58,40,18,59
Dundee Utd,1241,4,16,8,12,56,42,14,56
Dunfermline,1241,5,12,11,13,50,52,-2,47
Queen of S't,1241,6,11,10,15,43,51,-8,43
Dumbarton,1241,7,9,14,13,52,59,-7,41
St Mirren,1241,8,8,12,16,39,60,-21,36
Raith,1241,9,9,8,19,34,53,-19,35
Ayr,1241,10,6,11,19,33,62,-29,29
Hibernian,1242,1,19,13,4,57,25,32,70
Falkirk,1242,2,17,10,9,57,37,20,61
Dundee Utd,1242,3,15,10,11,54,40,14,55
Morton,1242,4,14,12,10,47,44,3,54
Dunfermline,1242,5,12,12,12,50,49,1,48
Queen of S't,1242,6,11,10,15,43,48,-5,43
Raith,1242,7,10,10,16,34,51,-17,40
St Mirren,1242,8,9,11,16,42,54,-12,38
Dumbarton,1242,9,9,11,16,47,63,-16,38
Ayr,1242,10,8,13,15,34,54,-20,37
Hibernian,1243,1,19,11,6,53,27,26,68
Morton,1243,2,17,13,6,47,31,16,64
Falkirk,1243,3,16,13,7,58,37,21,61
Dundee Utd,1243,4,14,11,11,45,39,6,53
Queen of S't,1243,5,11,11,14,44,50,-6,44
Raith,1243,6,10,11,15,33,44,-11,41
Dumbarton,1243,7,9,12,15,44,54,-10,39
St Mirren,1243,8,9,12,15,41,53,-12,39
Dunfermline,1243,9,8,14,14,38,47,-9,38
Ayr,1243,10,7,12,17,33,54,-21,33
Hibernian,1244,1,20,12,4,51,24,27,72
Dundee Utd,1244,2,17,11,8,53,40,13,62
Falkirk,1244,3,16,10,10,59,41,18,58
Morton,1244,4,16,10,10,51,41,10,58
Raith,1244,5,12,10,14,41,50,-9,46
Queen of S't,1244,6,11,11,14,51,53,-2,44
Dunfermline,1244,7,9,12,15,47,53,-6,39
Dumbarton,1244,8,9,11,16,53,65,-12,38
Ayr,1244,9,7,14,15,35,53,-18,35
St Mirren,1244,10,7,11,18,37,58,-21,32
Hibernian,1245,1,19,10,7,55,29,26,67
Morton,1245,2,19,10,7,56,36,20,67
Falkirk,1245,3,18,9,9,62,41,21,63
Dundee Utd,1245,4,18,9,9,55,39,16,63
Dunfermline,1245,5,10,14,12,46,49,-3,44
Queen of S't,1245,6,11,11,14,45,51,-6,44
Raith,1245,7,10,10,16,36,48,-12,40
Dumbarton,1245,8,7,13,16,41,55,-14,34
St Mirren,1245,9,8,9,19,38,58,-20,33
Ayr,1245,10,7,11,18,34,62,-28,32
Morton,1246,1,20,9,7,55,36,19,69
Hibernian,1246,2,19,11,6,57,27,30,68
Dundee Utd,1246,3,17,10,9,52,37,15,61
Falkirk,1246,4,15,11,10,56,41,15,56
Dunfermline,1246,5,10,14,12,50,48,2,44
Queen of S't,1246,6,11,10,15,43,54,-11,43
Dumbarton,1246,7,9,12,15,46,55,-9,39
Raith,1246,8,9,10,17,37,50,-13,37
Ayr,1246,9,8,11,17,33,60,-27,35
St Mirren,1246,10,8,10,18,42,63,-21,34
Hibernian,1247,1,18,14,4,53,25,28,68
Morton,1247,2,15,14,7,48,36,12,59
Falkirk,1247,3,15,12,9,62,45,17,57
Dundee Utd,1247,4,15,12,9,53,43,10,57
Dunfermline,1247,5,12,12,12,51,49,2,48
Queen of S't,1247,6,11,10,15,45,52,-7,43
Raith,1247,7,11,9,16,35,49,-14,42
St Mirren,1247,8,9,10,17,42,56,-14,37
Ayr,1247,9,8,12,16,33,55,-22,36
Dumbarton,1247,10,7,13,16,49,61,-12,34
Hibernian,1248,1,21,11,4,58,24,34,74
Morton,1248,2,18,12,6,52,33,19,66
Dundee Utd,1248,3,16,9,11,57,41,16,57
Falkirk,1248,4,14,12,10,57,45,12,54
Queen of S't,1248,5,12,10,14,51,54,-3,46
Raith,1248,6,11,9,16,36,53,-17,42
Dunfermline,1248,7,10,11,15,44,52,-8,41
Dumbarton,1248,8,9,12,15,55,62,-7,39
Ayr,1248,9,8,10,18,36,62,-26,34
St Mirren,1248,10,7,12,17,40,60,-20,33
Hibernian,1249,1,19,12,5,56,28,28,69
Falkirk,1249,2,16,12,8,58,38,20,60
Morton,1249,3,15,13,8,55,41,14,58
Dundee Utd,1249,4,15,12,9,49,39,10,57
Dumbarton,1249,5,12,11,13,51,55,-4,47
Dunfermline,1249,6,10,14,12,52,51,1,44
Raith,1249,7,10,10,16,37,50,-13,40
Ayr,1249,8,10,10,16,34,52,-18,40
Queen of S't,1249,9,9,9,18,44,60,-16,36
St Mirren,1249,10,7,11,18,40,62,-22,32
Hibernian,1250,1,19,12,5,59,23,36,69
Dundee Utd,1250,2,19,9,8,55,39,16,66
Morton,1250,3,16,11,9,48,41,7,59
Falkirk,1250,4,14,13,9,57,45,12,55
Queen of S't,1250,5,11,11,14,49,54,-5,44
Dunfermline,1250,6,10,13,13,51,49,2,43
Dumbarton,1250,7,9,12,15,47,56,-9,39
Raith,1250,8,9,11,16,34,52,-18,38
St Mirren,1250,9,8,11,17,37,56,-19,35
Ayr,1250,10,7,13,16,31,53,-22,34
Falkirk,1251,1,18,11,7,61,35,26,65
Hibernian,1251,2,17,14,5,49,25,24,65
Dundee Utd,1251,3,15,12,9,52,40,12,57
Morton,1251,4,15,12,9,50,39,11,57
Queen of S't,1251,5,10,13,13,43,49,-6,43
St Mirren,1251,6,9,12,15,44,52,-8,39
Raith,1251,7,9,12,15,33,44,-11,39
Dunfermline,1251,8,9,12,15,41,55,-14,39
Dumbarton,1251,9,9,11,16,48,62,-14,38
Ayr,1251,10,8,13,15,32,52,-20,37
Hibernian,1252,1,21,11,4,54,24,30,74
Falkirk,1252,2,17,11,8,59,38,21,62
Dundee Utd,1252,3,17,10,9,49,37,12,61
Morton,1252,4,16,9,11,52,44,8,57
Raith,1252,5,13,10,13,41,48,-7,49
Dumbarton,1252,6,11,12,13,51,53,-2,45
Queen of S't,1252,7,11,9,16,46,52,-6,42
Dunfermline,1252,8,8,13,15,46,53,-7,37
St Mirren,1252,9,7,10,19,32,54,-22,31
Ayr,1252,10,6,11,19,30,57,-27,29
Hibernian,1253,1,21,10,5,55,24,31,73
Falkirk,1253,2,17,9,10,57,43,14,60
Morton,1253,3,16,10,10,47,35,12,58
Dundee Utd,1253,4,15,11,10,52,42,10,56
Queen of S't,1253,5,12,11,13,50,50,0,47
Dumbarton,1253,6,10,13,13,52,56,-4,43
Dunfermline,1253,7,10,12,14,46,48,-2,42
Raith,1253,8,10,9,17,37,57,-20,39
St Mirren,1253,9,8,10,18,45,61,-16,34
Ayr,1253,10,7,13,16,32,57,-25,34
Hibernian,1254,1,19,11,6,53,24,29,68
Morton,1254,2,18,10,8,51,39,12,64
Falkirk,1254,3,17,9,10,63,48,15,60
Dundee Utd,1254,4,17,9,10,52,38,14,60
Raith,1254,5,12,8,16,38,48,-10,44
Dunfermline,1254,6,10,12,14,46,48,-2,42
Queen of S't,1254,7,11,8,17,44,58,-14,41
Dumbarton,1254,8,9,11,16,52,61,-9,38
Ayr,1254,9,9,11,16,35,55,-20,38
St Mirren,1254,10,8,11,17,39,54,-15,35
Hibernian,1255,1,20,11,5,56,26,30,71
Morton,1255,2,19,9,8,53,34,19,66
Dundee Utd,1255,3,19,8,9,55,39,16,65
Falkirk,1255,4,15,12,9,63,44,19,57
Dunfermline,1255,5,11,12,13,48,48,0,45
Queen of S't,1255,6,10,10,16,44,57,-13,40
Ayr,1255,7,9,12,15,37,55,-18,39
Dumbarton,1255,8,8,12,16,47,61,-14,36
St Mirren,1255,9,9,9,18,39,53,-14,36
Raith,1255,10,8,9,19,32,57,-25,33
Morton,1256,1,19,11,6,56,34,22,68
Hibernian,1256,2,18,10,8,56,31,25,64
Falkirk,1256,3,16,12,8,54,38,16,60
Dundee Utd,1256,4,15,10,11,46,39,7,55
Queen of S't,1256,5,12,10,14,46,47,-1,46
St Mirren,1256,6,10,11,15,43,53,-10,41
Raith,1256,7,10,10,16,34,47,-13,40
Dumbarton,1256,8,9,11,16,45,59,-14,38
Ayr,1256,9,9,11,16,32,53,-21,38
Dunfermline,1256,10,8,12,16,39,50,-11,36
Hibernian,1257,1,19,12,5,59,28,31,69
Morton,1257,2,18,10,8,52,39,13,64
Falkirk,1257,3,16,11,9,59,42,17,59
Dundee Utd,1257,4,16,11,9,49,38,11,59
Queen of S't,1257,5,12,9,15,45,49,-4,45
Dunfermline,1257,6,10,12,14,48,50,-2,42
Raith,1257,7,10,10,16,35,49,-14,40
Dumbarton,1257,8,9,11,16,45,57,-12,38
Ayr,1257,9,8,12,16,37,58,-21,36
St Mirren,1257,10,7,12,17,40,59,-19,33
Hibernian,1258,1,18,13,5,60,28,32,67
Falkirk,1258,2,17,10,9,56,39,17,61
Morton,1258,3,16,12,8,54,37,17,60
Dundee Utd,1258,4,15,11,10,50,41,9,56
Dumbarton,1258,5,11,13,12,56,58,-2,46
Dunfermline,1258,6,10,12,14,47,52,-5,42
Queen of S't,1258,7,11,9,16,42,51,-9,42
Raith,1258,8,10,10,16,35,48,-13,40
St Mirren,1258,9,9,11,16,41,55,-14,38
Ayr,1258,10,7,11,18,35,67,-32,32
Morton,1259,1,19,11,6,59,36,23,68
Hibernian,1259,2,19,10,7,59,29,30,67
Falkirk,1259,3,18,10,8,63,39,24,64
Dundee Utd,1259,4,17,9,10,52,41,11,60
Queen of S't,1259,5,12,8,16,45,50,-5,44
Raith,1259,6,11,10,15,37,51,-14,43
Dunfermline,1259,7,9,13,14,47,53,-6,40
Dumbarton,1259,8,9,11,16,48,62,-14,38
St Mirren,1259,9,7,11,18,38,61,-23,32
Ayr,1259,10,7,11,18,32,58,-26,32
Hibernian,1260,1,21,11,4,61,22,39,74
Falkirk,1260,2,17,10,9,60,42,18,61
Morton,1260,3,16,10,10,48,37,11,58
Dundee Utd,1260,4,15,10,11,54,45,9,55
Queen of S't,1260,5,12,9,15,49,56,-7,45
Raith,1260,6,12,9,15,39,50,-11,45
Dumbarton,1260,7,10,12,14,46,53,-7,42
Ayr,1260,8,8,13,15,35,56,-21,37
Dunfermline,1260,9,8,11,17,40,54,-14,35
St Mirren,1260,10,8,11,17,41,58,-17,35
Hibernian,1261,1,17,12,7,50,30,20,63
Morton,1261,2,17,12,7,48,34,14,63
Falkirk,1261,3,15,10,11,57,41,16,55
Dundee Utd,1261,4,14,9,13,49,44,5,51
Dunfermline,1261,5,11,13,12,51,49,2,46
Queen of S't,1261,6,11,11,14,44,50,-6,44
Dumbarton,1261,7,10,13,13,49,55,-6,43
Raith,1261,8,11,9,16,34,47,-13,42
St Mirren,1261,9,10,11,15,40,52,-12,41
Ayr,1261,10,8,12,16,36,56,-20,36
Hibernian,1262,1,19,13,4,56,25,31,70
Dundee Utd,1262,2,15,12,9,45,35,10,57
Morton,1262,3,15,12,9,49,40,9,57
Falkirk,1262,4,14,12,10,55,38,17,54
Queen of S't,1262,5,12,10,14,44,48,-4,46
Dunfermline,1262,6,10,14,12,49,47,2,44
Raith,1262,7,11,10,15,38,50,-12,43
Dumbarton,1262,8,9,12,15,47,63,-16,39
Ayr,1262,9,8,12,16,37,57,-20,36
St Mirren,1262,10,8,11,17,39,56,-17,35
Hibernian,1263,1,19,11,6,54,28,26,68
Morton,1263,2,16,13,7,52,39,13,61
Dundee Utd,1263,3,16,11,9,52,38,14,59
Falkirk,1263,4,15,9,12,53,46,7,54
Dunfermline,1263,5,11,13,12,45,43,2,46
Raith,1263,6,11,11,14,43,50,-7,44
St Mirren,1263,7,10,11,15,46,55,-9,41
Dumbarton,1263,8,9,12,15,46,56,-10,39
Queen of S't,1263,9,9,9,18,42,58,-16,36
Ayr,1263,10,7,14,15,35,55,-20,35
Hibernian,1264,1,20,11,5,55,26,29,71
Falkirk,1264,2,18,10,8,68,42,26,64
Dundee Utd,1264,3,15,10,11,49,42,7,55
Morton,1264,4,14,11,11,45,42,3,53
Dunfermline,1264,5,13,13,10,52,47,5,52
Raith,1264,6,13,8,15,41,49,-8,47
Queen of S't,1264,7,10,10,16,45,53,-8,40
Ayr,1264,8,8,13,15,33,52,-19,37
Dumbarton,1264,9,8,11,17,45,61,-16,35
St Mirren,1264,10,7,11,18,39,58,-19,32
Hibernian,1265,1,20,11,5,54,26,28,71
Falkirk,1265,2,16,10,10,58,42,16,58
Morton,1265,3,16,10,10,51,43,8,58
Dundee Utd,1265,4,16,8,12,52,44,8,56
Dunfermline,1265,5,11,13,12,55,50,5,46
Ayr,1265,6,11,11,14,40,55,-15,44
Queen of S't,1265,7,11,10,15,44,49,-5,43
Raith,1265,8,10,11,15,38,47,-9,41
Dumbarton,1265,9,9,11,16,49,63,-14,38
St Mirren,1265,10,7,11,18,40,62,-22,32
Hibernian,1266,1,21,11,4,60,27,33,74
Dundee Utd,1266,2,18,9,9,51,40,11,63
Morton,1266,3,15,11,10,48,38,10,56
Falkirk,1266,4,13,11,12,52,41,11,50
Dunfermline,1266,5,11,12,13,49,49,0,45
Queen of S't,1266,6,12,8,16,48,55,-7,44
Raith,1266,7,11,9,16,36,50,-14,42
Dumbarton,1266,8,10,11,15,46,55,-9,41
St Mirren,1266,9,9,11,16,42,56,-14,38
Ayr,1266,10,8,11,17,36,57,-21,35
Hibernian,1267,1,19,12,5,53,25,28,69
Morton,1267,2,16,12,8,46,34,12,60
Falkirk,1267,3,15,10,11,58,44,14,55
Dundee Utd,1267,4,15,10,11,46,40,6,55
Queen of S't,1267,5,11,10,15,45,53,-8,43
Dumbarton,1267,6,10,12,14,46,55,-9,42
Raith,1267,7,10,11,15,36,46,-10,41
Ayr,1267,8,9,13,14,35,48,-13,40
St Mirren,1267,9,10,10,16,37,51,-14,40
Dunfermline,1267,10,8,14,14,40,46,-6,38
Hibernian,1268,1,19,10,7,58,28,30,67
Morton,1268,2,16,12,8,48,36,12,60
Dundee Utd,1268,3,17,8,11,54,41,13,59
Falkirk,1268,4,16,9,11,59,43,16,57
Dumbarton,1268,5,11,11,14,50,60,-10,44
Queen of S't,1268,6,12,8,16,45,56,-11,44
Raith,1268,7,11,9,16,41,49,-8,42
Dunfermline,1268,8,9,13,14,47,56,-9,40
St Mirren,1268,9,10,9,17,41,55,-14,39
Ayr,1268,10,9,11,16,39,58,-19,38
Hibernian,1269,1,19,12,5,53,24,29,69
Morton,1269,2,19,10,7,50,34,16,67
Falkirk,1269,3,15,11,10,56,42,14,56
Dundee Utd,1269,4,15,10,11,51,44,7,55
Queen of S't,1269,5,12,10,14,51,55,-4,46
Dunfermline,1269,6,11,11,14,50,51,-1,44
Raith,1269,7,10,10,16,36,52,-16,40
Dumbarton,1269,8,8,13,15,46,59,-13,37
St Mirren,1269,9,8,12,16,39,52,-13,36
Ayr,1269,10,8,11,17,36,55,-19,35
Hibernian,1270,1,20,11,5,55,25,30,71
Morton,1270,2,18,10,8,51,37,14,64
Falkirk,1270,3,18,9,9,62,37,25,63
Dundee Utd,1270,4,17,8,11,51,39,12,59
Dunfermline,1270,5,12,11,13,46,44,2,47
Raith,1270,6,12,8,16,36,49,-13,44
Dumbarton,1270,7,10,12,14,48,56,-8,42
Queen of S't,1270,8,11,9,16,46,54,-8,42
St Mirren,1270,9,7,9,20,39,62,-23,30
Ayr,1270,10,6,11,19,26,57,-31,29
Hibernian,1271,1,21,10,5,58,27,31,73
Falkirk,1271,2,16,10,10,63,43,20,58
Dundee Utd,1271,3,16,9,11,48,40,8,57
Morton,1271,4,15,9,12,50,43,7,54
Dunfermline,1271,5,13,12,11,54,45,9,51
Queen of S't,1271,6,14,8,14,48,49,-1,50
St Mirren,1271,7,11,9,16,45,53,-8,42
Raith,1271,8,8,11,17,34,54,-20,35
Dumbarton,1271,9,8,11,17,44,67,-23,35
Ayr,1271,10,7,13,16,31,54,-23,34
Hibernian,1272,1,18,14,4,52,22,30,68
Morton,1272,2,16,14,6,47,34,13,62
Dundee Utd,1272,3,17,10,9,54,38,16,61
Falkirk,1272,4,16,11,9,54,35,19,59
Dunfermline,1272,5,10,12,14,48,49,-1,42
Queen of S't,1272,6,10,10,16,41,54,-13,40
Raith,1272,7,10,10,16,34,50,-16,40
St Mirren,1272,8,10,9,17,46,59,-13,39
Dumbarton,1272,9,9,11,16,50,61,-11,38
Ayr,1272,10,8,11,17,31,55,-24,35
Hibernian,1273,1,18,14,4,55,25,30,68
Falkirk,1273,2,16,12,8,58,36,22,60
Dundee Utd,1273,3,15,12,9,51,39,12,57
Morton,1273,4,15,12,9,45,36,9,57
Raith,1273,5,13,9,14,37,47,-10,48
Dunfermline,1273,6,10,14,12,44,45,-1,44
Queen of S't,1273,7,10,11,15,44,50,-6,41
Dumbarton,1273,8,9,12,15,51,61,-10,39
St Mirren,1273,9,8,11,17,39,57,-18,35
Ayr,1273,10,7,11,18,29,57,-28,32
Hibernian,1274,1,21,11,4,60,22,38,74
Morton,1274,2,19,10,7,54,34,20,67
Falkirk,1274,3,18,9,9,57,35,22,63
Dundee Utd,1274,4,14,12,10,44,40,4,54
Dumbarton,1274,5,11,12,13,48,50,-2,45
Queen of S't,1274,6,12,9,15,43,49,-6,45
Raith,1274,7,11,8,17,37,52,-15,41
Dunfermline,1274,8,8,11,17,40,55,-15,35
Ayr,1274,9,7,12,17,37,63,-26,33
St Mirren,1274,10,6,12,18,37,57,-20,30
Hibernian,1275,1,20,11,5,60,29,31,71
Morton,1275,2,17,12,7,52,36,16,63
Dundee Utd,1275,3,18,8,10,56,39,17,62
Falkirk,1275,4,16,9,11,59,43,16,57
Queen of S't,1275,5,13,8,15,52,53,-1,47
Dunfermline,1275,6,10,13,13,44,47,-3,43
Raith,1275,7,11,9,16,37,52,-15,42
Dumbarton,1275,8,7,13,16,45,61,-16,34
St Mirren,1275,9,8,10,18,38,56,-18,34
Ayr,1275,10,7,13,16,34,61,-27,34
Hibernian,1276,1,19,13,4,58,26,32,70
Morton,1276,2,19,12,5,57,34,23,69
Falkirk,1276,3,15,13,8,61,45,16,58
Dundee Utd,1276,4,16,10,10,55,40,15,58
Queen of S't,1276,5,11,9,16,42,50,-8,42
Raith,1276,6,9,13,14,33,45,-12,40
Ayr,1276,7,8,13,15,30,54,-24,37
Dumbarton,1276,8,8,12,16,45,56,-11,36
Dunfermline,1276,9,7,14,15,44,58,-14,35
St Mirren,1276,10,7,13,16,37,54,-17,34
Hibernian,1277,1,22,10,4,58,24,34,76
Morton,1277,2,18,9,9,51,41,10,63
Falkirk,1277,3,17,10,9,60,38,22,61
Dundee Utd,1277,4,14,10,12,45,38,7,52
Queen of S't,1277,5,13,9,14,49,51,-2,48
Dunfermline,1277,6,11,12,13,46,47,-1,45
Dumbarton,1277,7,10,10,16,50,61,-11,40
St Mirren,1277,8,9,10,17,39,54,-15,37
Raith,1277,9,9,9,18,36,52,-16,36
Ayr,1277,10,7,11,18,35,63,-28,32
Hibernian,1278,1,20,10,6,55,24,31,70
Dundee Utd,1278,2,18,10,8,57,37,20,64
Morton,1278,3,17,10,9,56,39,17,61
Falkirk,1278,4,15,11,10,54,44,10,56
Raith,1278,5,11,11,14,36,46,-10,44
Queen of S't,1278,6,10,13,13,48,53,-5,43
Dunfermline,1278,7,9,14,13,46,51,-5,41
Dumbarton,1278,8,9,11,16,50,64,-14,38
Ayr,1278,9,7,14,15,33,51,-18,35
St Mirren,1278,10,7,10,19,35,61,-26,31
Hibernian,1279,1,20,11,5,53,25,28,71
Morton,1279,2,16,13,7,49,36,13,61
Dundee Utd,1279,3,17,10,9,52,43,9,61
Falkirk,1279,4,14,11,11,53,40,13,53
Dunfermline,1279,5,11,13,12,48,48,0,46
Ayr,1279,6,10,12,14,37,49,-12,42
Dumbarton,1279,7,10,11,15,51,56,-5,41
Queen of S't,1279,8,11,8,17,41,51,-10,41
Raith,1279,9,9,10,17,32,48,-16,37
St Mirren,1279,10,7,11,18,38,58,-20,32
Hibernian,1280,1,21,12,3,58,22,36,75
Dundee Utd,1280,2,17,10,9,54,37,17,61
Morton,1280,3,16,12,8,52,43,9,60
Falkirk,1280,4,15,10,11,55,43,12,55
Queen of S't,1280,5,13,9,14,44,45,-1,48
Dunfermline,1280,6,10,13,13,45,45,0,43
Raith,1280,7,9,10,17,32,52,-20,37
Ayr,1280,8,7,15,14,35,55,-20,36
St Mirren,1280,9,8,11,17,39,57,-18,35
Dumbarton,1280,10,8,10,18,46,61,-15,34
Hibernian,1281,1,18,14,4,55,28,27,68
Falkirk,1281,2,17,10,9,62,42,20,61
Morton,1281,3,16,13,7,58,41,17,61
Dundee Utd,1281,4,15,9,12,51,46,5,54
Raith,1281,5,12,9,15,38,46,-8,45
Dunfermline,1281,6,11,11,14,48,52,-4,44
Queen of S't,1281,7,11,10,15,46,50,-4,43
Dumbarton,1281,8,9,12,15,47,56,-9,39
Ayr,1281,9,9,12,15,37,55,-18,39
St Mirren,1281,10,7,10,19,38,64,-26,31
Hibernian,1282,1,22,10,4,57,23,34,76
Dundee Utd,1282,2,17,10,9,45,33,12,61
Falkirk,1282,3,16,11,9,57,37,20,59
Morton,1282,4,16,10,10,46,36,10,58
Raith,1282,5,12,9,15,38,48,-10,45
Dunfermline,1282,6,11,11,14,46,46,0,44
St Mirren,1282,7,10,9,17,40,54,-14,39
Dumbarton,1282,8,9,11,16,47,59,-12,38
Queen of S't,1282,9,9,9,18,43,58,-15,36
Ayr,1282,10,7,12,17,31,56,-25,33
Hibernian,1283,1,16,15,5,51,26,25,63
Falkirk,1283,2,16,13,7,59,37,22,61
Morton,1283,3,16,11,9,46,36,10,59
Dundee Utd,1283,4,15,9,12,48,39,9,54
Dunfermline,1283,5,13,12,11,52,48,4,51
Queen of S't,1283,6,10,12,14,44,50,-6,42
Raith,1283,7,10,11,15,34,47,-13,41
Dumbarton,1283,8,8,13,15,46,58,-12,37
Ayr,1283,9,8,13,15,33,56,-23,37
St Mirren,1283,10,7,13,16,36,52,-16,34
Hibernian,1284,1,17,14,5,55,30,25,65
Morton,1284,2,18,11,7,51,36,15,65
Dundee Utd,1284,3,17,9,10,55,40,15,60
Falkirk,1284,4,16,11,9,57,39,18,59
Dunfermline,1284,5,10,13,13,45,47,-2,43
Dumbarton,1284,6,10,11,15,47,56,-9,41
Ayr,1284,7,10,10,16,35,58,-23,40
Queen of S't,1284,8,10,9,17,44,55,-11,39
Raith,1284,9,9,10,17,32,49,-17,37
St Mirren,1284,10,8,12,16,47,58,-11,36
Hibernian,1285,1,18,14,4,55,24,31,68
Morton,1285,2,17,13,6,47,33,14,64
Dundee Utd,1285,3,15,11,10,47,40,7,56
Falkirk,1285,4,15,10,11,57,42,15,55
Queen of S't,1285,5,11,10,15,46,51,-5,43
Dunfermline,1285,6,9,15,12,44,48,-4,42
Dumbarton,1285,7,10,12,14,53,59,-6,42
Raith,1285,8,9,12,15,35,50,-15,39
Ayr,1285,9,8,15,13,39,55,-16,39
St Mirren,1285,10,7,10,19,33,54,-21,31
Hibernian,1286,1,17,14,5,54,29,25,65
Falkirk,1286,2,18,11,7,65,42,23,65
Dundee Utd,1286,3,18,8,10,55,40,15,62
Morton,1286,4,16,12,8,52,39,13,60
Dunfermline,1286,5,9,15,12,48,50,-2,42
Queen of S't,1286,6,9,13,14,44,52,-8,40
Dumbarton,1286,7,9,13,14,49,59,-10,40
Ayr,1286,8,9,11,16,34,58,-24,38
Raith,1286,9,9,10,17,37,53,-16,37
St Mirren,1286,10,8,9,19,40,56,-16,33
Hibernian,1287,1,20,11,5,53,25,28,71
Morton,1287,2,16,13,7,49,36,13,61
Dundee Utd,1287,3,16,10,10,48,37,11,58
Falkirk,1287,4,14,10,12,54,44,10,52
Queen of S't,1287,5,11,11,14,44,48,-4,44
Dumbarton,1287,6,10,13,13,49,53,-4,43
Raith,1287,7,10,10,16,37,50,-13,40
Ayr,1287,8,9,12,15,37,55,-18,39
St Mirren,1287,9,9,11,16,40,55,-15,38
Dunfermline,1287,10,8,13,15,45,53,-8,37
Hibernian,1288,1,20,12,4,58,27,31,72
Dundee Utd,1288,2,15,12,9,51,40,11,57
Morton,1288,3,15,12,9,48,38,10,57
Falkirk,1288,4,14,11,11,52,46,6,53
Dunfermline,1288,5,12,11,13,56,52,4,47
Queen of S't,1288,6,12,11,13,43,44,-1,47
Dumbarton,1288,7,10,10,16,50,59,-9,40
St Mirren,1288,8,9,11,16,41,54,-13,38
Raith,1288,9,9,10,17,35,52,-17,37
Ayr,1288,10,8,12,16,30,52,-22,36
Hibernian,1289,1,20,13,3,58,24,34,73
Falkirk,1289,2,17,10,9,62,42,20,61
Dundee Utd,1289,3,17,9,10,54,42,12,60
Morton,1289,4,15,10,11,49,45,4,55
Dunfermline,1289,5,12,11,13,45,47,-2,47
Queen of S't,1289,6,12,9,15,43,50,-7,45
St Mirren,1289,7,10,10,16,43,54,-11,40
Raith,1289,8,10,8,18,34,49,-15,38
Ayr,1289,9,9,10,17,35,53,-18,37
Dumbarton,1289,10,8,10,18,54,71,-17,34
Hibernian,1290,1,20,12,4,53,23,30,72
Falkirk,1290,2,17,11,8,65,38,27,62
Dundee Utd,1290,3,18,8,10,55,42,13,62
Morton,1290,4,17,11,8,48,37,11,62
Queen of S't,1290,5,12,9,15,46,55,-9,45
Dunfermline,1290,6,10,13,13,45,45,0,43
Raith,1290,7,10,11,15,35,46,-11,41
Ayr,1290,8,8,10,18,41,59,-18,34
St Mirren,1290,9,8,10,18,37,57,-20,34
Dumbarton,1290,10,7,11,18,42,65,-23,32
Hibernian,1291,1,19,13,4,54,23,31,70
Morton,1291,2,17,12,7,49,35,14,63
Dundee Utd,1291,3,17,9,10,55,38,17,60
Falkirk,1291,4,16,12,8,54,37,17,60
Dumbarton,1291,5,10,12,14,48,55,-7,42
Queen of S't,1291,6,11,8,17,43,52,-9,41
Dunfermline,1291,7,9,12,15,43,52,-9,39
Raith,1291,8,10,9,17,34,48,-14,39
St Mirren,1291,9,9,11,16,42,58,-16,38
Ayr,1291,10,7,12,17,32,56,-24,33
Hibernian,1292,1,19,11,6,62,34,28,68
Morton,1292,2,19,9,8,63,43,20,66
Dundee Utd,1292,3,18,9,9,54,40,14,63
Falkirk,1292,4,16,9,11,63,44,19,57
Queen of S't,1292,5,13,8,15,48,51,-3,47
Dunfermline,1292,6,10,12,14,50,58,-8,42
Dumbarton,1292,7,9,13,14,49,56,-7,40
Raith,1292,8,10,9,17,38,51,-13,39
Ayr,1292,9,8,12,16,37,62,-25,36
St Mirren,1292,10,7,10,19,37,62,-25,31
Hibernian,1293,1,19,10,7,54,28,26,67
Morton,1293,2,18,9,9,50,36,14,63
Falkirk,1293,3,17,10,9,59,37,22,61
Dundee Utd,1293,4,16,10,10,54,37,17,58
Dunfermline,1293,5,13,12,11,51,44,7,51
Raith,1293,6,10,10,16,35,49,-14,40
Queen of S't,1293,7,10,9,17,41,58,-17,39
St Mirren,1293,8,9,11,16,37,51,-14,38
Ayr,1293,9,8,12,16,31,52,-21,36
Dumbarton,1293,10,8,11,17,43,63,-20,35
Hibernian,1294,1,18,12,6,51,28,23,66
Morton,1294,2,17,11,8,53,39,14,62
Falkirk,1294,3,16,9,11,57,43,14,57
Dundee Utd,1294,4,14,10,12,47,43,4,52
Queen of S't,1294,5,12,10,14,47,49,-2,46
Dunfermline,1294,6,11,12,13,49,49,0,45
Dumbarton,1294,7,10,12,14,57,61,-4,42
Raith,1294,8,10,10,16,36,50,-14,40
St Mirren,1294,9,9,11,16,41,53,-12,38
Ayr,1294,10,8,13,15,33,56,-23,37
Hibernian,1295,1,17,11,8,54,34,20,62
Morton,1295,2,17,10,9,51,40,11,61
Dundee Utd,1295,3,16,9,11,45,38,7,57
Falkirk,1295,4,15,11,10,55,42,13,56
Dunfermline,1295,5,12,14,10,49,44,5,50
Queen of S't,1295,6,12,10,14,43,46,-3,46
Dumbarton,1295,7,10,10,16,46,56,-10,40
Raith,1295,8,10,10,16,35,47,-12,40
Ayr,1295,9,9,13,14,36,52,-16,40
St Mirren,1295,10,8,10,18,41,56,-15,34
Falkirk,1296,1,17,11,8,57,38,19,62
Hibernian,1296,2,16,12,8,56,37,19,60
Morton,1296,3,15,14,7,46,32,14,59
Dundee Utd,1296,4,15,11,10,47,38,9,56
Raith,1296,5,12,9,15,38,46,-8,45
Dunfermline,1296,6,8,17,11,44,47,-3,41
Dumbarton,1296,7,10,11,15,46,56,-10,41
Queen of S't,1296,8,10,10,16,44,54,-10,40
Ayr,1296,9,9,13,14,34,49,-15,40
St Mirren,1296,10,9,10,17,43,58,-15,37
Hibernian,1297,1,19,11,6,55,28,27,68
Dundee Utd,1297,2,19,9,8,57,35,22,66
Morton,1297,3,16,14,6,53,36,17,62
Falkirk,1297,4,17,10,9,62,42,20,61
Dunfermline,1297,5,10,14,12,42,45,-3,44
Dumbarton,1297,6,9,12,15,47,56,-9,39
Queen of S't,1297,7,10,9,17,41,51,-10,39
Ayr,1297,8,8,12,16,33,55,-22,36
Raith,1297,9,9,9,18,32,56,-24,36
St Mirren,1297,10,8,10,18,36,54,-18,34
Hibernian,1298,1,17,13,6,52,28,24,64
Dundee Utd,1298,2,18,10,8,53,33,20,64
Falkirk,1298,3,16,10,10,58,41,17,58
Morton,1298,4,14,13,9,45,36,9,55
Queen of S't,1298,5,11,11,14,49,50,-1,44
Dunfermline,1298,6,9,15,12,45,49,-4,42
Raith,1298,7,9,12,15,33,47,-14,39
Ayr,1298,8,9,12,15,32,51,-19,39
St Mirren,1298,9,9,11,16,37,52,-15,38
Dumbarton,1298,10,9,11,16,47,64,-17,38
Hibernian,1299,1,18,14,4,51,22,29,68
Morton,1299,2,17,14,5,46,28,18,65
Dundee Utd,1299,3,18,9,9,55,40,15,63
Falkirk,1299,4,13,11,12,54,43,11,50
Raith,1299,5,12,10,14,35,46,-11,46
Dunfermline,1299,6,10,13,13,45,47,-2,43
Queen of S't,1299,7,10,10,16,42,51,-9,40
Dumbarton,1299,8,9,11,16,45,59,-14,38
St Mirren,1299,9,8,11,17,37,53,-16,35
Ayr,1299,10,7,13,16,29,50,-21,34
Hibernian,1300,1,19,12,5,51,24,27,69
Dundee Utd,1300,2,19,9,8,59,37,22,66
Morton,1300,3,16,12,8,48,38,10,60
Falkirk,1300,4,16,9,11,55,44,11,57
Queen of S't,1300,5,11,11,14,48,51,-3,44
Dumbarton,1300,6,10,12,14,50,54,-4,42
Dunfermline,1300,7,10,11,15,50,50,0,41
Raith,1300,8,10,10,16,42,56,-14,40
St Mirren,1300,9,8,11,17,40,56,-16,35
Ayr,1300,10,7,11,18,32,65,-33,32
Hibernian,1301,1,20,13,3,60,25,35,73
Morton,1301,2,17,13,6,48,33,15,64
Falkirk,1301,3,17,11,8,63,41,22,62
Dundee Utd,1301,4,15,10,11,49,40,9,55
Queen of S't,1301,5,14,8,14,49,49,0,50
Dunfermline,1301,6,9,13,14,45,51,-6,40
Ayr,1301,7,9,13,14,33,54,-21,40
Raith,1301,8,8,11,17,35,52,-17,35
Dumbarton,1301,9,7,12,17,43,58,-15,33
St Mirren,1301,10,7,10,19,36,58,-22,31
Hibernian,1302,1,21,12,3,62,27,35,75
Falkirk,1302,2,17,10,9,66,41,25,61
Dundee Utd,1302,3,16,11,9,60,42,18,59
Morton,1302,4,15,11,10,46,37,9,56
Dunfermline,1302,5,10,12,14,49,55,-6,42
Queen of S't,1302,6,10,10,16,44,54,-10,40
Raith,1302,7,9,11,16,33,50,-17,38
Ayr,1302,8,8,14,14,38,57,-19,38
St Mirren,1302,9,9,10,17,44,60,-16,37
Dumbarton,1302,10,8,13,15,44,63,-19,37
Hibernian,1303,1,19,13,4,51,24,27,70
Morton,1303,2,17,11,8,55,36,19,62
Dundee Utd,1303,3,17,9,10,58,41,17,60
Falkirk,1303,4,15,12,9,58,41,17,57
Queen of S't,1303,5,12,9,15,45,50,-5,45
Dunfermline,1303,6,10,12,14,44,46,-2,42
Raith,1303,7,10,10,16,34,47,-13,40
St Mirren,1303,8,9,11,16,40,59,-19,38
Dumbarton,1303,9,8,11,17,49,68,-19,35
Ayr,1303,10,7,14,15,35,57,-22,35
Hibernian,1304,1,18,13,5,54,27,27,67
Morton,1304,2,17,13,6,54,35,19,64
Falkirk,1304,3,15,11,10,54,44,10,56
Dundee Utd,1304,4,15,11,10,48,39,9,56
Queen of S't,1304,5,14,8,14,49,48,1,50
Dumbarton,1304,6,10,12,14,46,53,-7,42
Ayr,1304,7,9,13,14,35,50,-15,40
Dunfermline,1304,8,9,12,15,48,52,-4,39
Raith,1304,9,9,11,16,33,50,-17,38
St Mirren,1304,10,6,12,18,35,58,-23,30
Hibernian,1305,1,21,12,3,60,21,39,75
Falkirk,1305,2,17,10,9,61,41,20,61
Dundee Utd,1305,3,17,10,9,55,39,16,61
Morton,1305,4,14,12,10,46,41,5,54
Dumbarton,1305,5,10,13,13,45,53,-8,43
Dunfermline,1305,6,9,15,12,42,45,-3,42
Raith,1305,7,10,11,15,36,50,-14,41
Queen of S't,1305,8,10,10,16,41,51,-10,40
St Mirren,1305,9,8,11,17,40,57,-17,35
Ayr,1305,10,7,10,19,29,57,-28,31
Hibernian,1306,1,21,12,3,60,23,37,75
Morton,1306,2,18,9,9,57,42,15,63
Dundee Utd,1306,3,17,9,10,58,43,15,60
Falkirk,1306,4,16,10,10,61,46,15,58
Raith,1306,5,11,10,15,38,52,-14,43
Dunfermline,1306,6,9,14,13,46,48,-2,41
Queen of S't,1306,7,10,11,15,42,51,-9,41
Dumbarton,1306,8,8,13,15,50,60,-10,37
Ayr,1306,9,8,11,17,31,56,-25,35
St Mirren,1306,10,8,9,19,39,61,-22,33
Hibernian,1307,1,19,13,4,60,29,31,70
Dundee Utd,1307,2,18,8,10,57,36,21,62
Morton,1307,3,17,11,8,51,35,16,62
Falkirk,1307,4,14,14,8,58,41,17,56
Dunfermline,1307,5,12,12,12,48,50,-2,48
Queen of S't,1307,6,11,10,15,44,49,-5,43
Raith,1307,7,9,10,17,34,55,-21,37
Ayr,1307,8,8,13,15,33,57,-24,37
St Mirren,1307,9,8,11,17,36,53,-17,35
Dumbarton,1307,10,7,12,17,45,61,-16,33
Hibernian,1308,1,18,14,4,58,28,30,68
Morton,1308,2,17,9,10,51,40,11,60
Falkirk,1308,3,15,13,8,58,40,18,58
Dundee Utd,1308,4,13,12,11,51,48,3,51
Queen of S't,1308,5,11,10,15,47,50,-3,43
Ayr,1308,6,11,10,15,35,53,-18,43
Dunfermline,1308,7,9,15,12,48,54,-6,42
St Mirren,1308,8,10,11,15,45,54,-9,41
Dumbarton,1308,9,9,12,15,50,57,-7,39
Raith,1308,10,10,8,18,37,56,-19,38
Hibernian,1309,1,19,11,6,55,29,26,68
Falkirk,1309,2,17,11,8,58,40,18,62
Morton,1309,3,17,11,8,49,36,13,62
Dundee Utd,1309,4,14,11,11,45,40,5,53
Queen of S't,1309,5,13,8,15,47,51,-4,47
Dunfermline,1309,6,11,12,13,51,50,1,45
St Mirren,1309,7,10,10,16,44,55,-11,40
Dumbarton,1309,8,9,12,15,50,56,-6,39
Raith,1309,9,9,9,18,35,54,-19,36
Ayr,1309,10,8,11,17,31,54,-23,35
Hibernian,1310,1,17,14,5,55,30,25,65
Morton,1310,2,17,13,6,55,34,21,64
Falkirk,1310,3,17,12,7,59,35,24,63
Dundee Utd,1310,4,13,13,10,47,41,6,52
Queen of S't,1310,5,11,12,13,43,46,-3,45
Dunfermline,1310,6,9,14,13,47,53,-6,41
Raith,1310,7,10,11,15,38,50,-12,41
Dumbarton,1310,8,9,13,14,46,54,-8,40
Ayr,1310,9,7,13,16,33,58,-25,34
St Mirren,1310,10,7,11,18,34,56,-22,32
Hibernian,1311,1,21,12,3,58,23,35,75
Dundee Utd,1311,2,18,9,9,48,35,13,63
Falkirk,1311,3,15,12,9,59,42,17,57
Morton,1311,4,15,11,10,44,39,5,56
Dumbarton,1311,5,11,10,15,51,56,-5,43
Queen of S't,1311,6,11,10,15,44,49,-5,43
Raith,1311,7,11,10,15,36,48,-12,43
Ayr,1311,8,9,11,16,34,54,-20,38
Dunfermline,1311,9,8,13,15,42,51,-9,37
St Mirren,1311,10,7,10,19,37,56,-19,31
Dundee Utd,1312,1,19,9,8,52,35,17,66
Hibernian,1312,2,17,13,6,51,29,22,64
Morton,1312,3,18,10,8,51,37,14,64
Falkirk,1312,4,17,11,8,57,38,19,62
Dunfermline,1312,5,10,15,11,45,44,1,45
Raith,1312,6,12,9,15,39,46,-7,45
Queen of S't,1312,7,10,9,17,43,51,-8,39
Dumbarton,1312,8,9,10,17,46,58,-12,37
Ayr,1312,9,8,10,18,32,57,-25,34
St Mirren,1312,10,7,10,19,36,57,-21,31
Hibernian,1313,1,19,14,3,54,25,29,71
Morton,1313,2,19,11,6,53,32,21,68
Falkirk,1313,3,16,12,8,58,38,20,60
Dundee Utd,1313,4,15,11,10,48,40,8,56
Queen of S't,1313,5,12,9,15,49,49,0,45
Dunfermline,1313,6,10,15,11,46,47,-1,45
St Mirren,1313,7,8,12,16,44,57,-13,36
Raith,1313,8,9,8,19,34,56,-22,35
Dumbarton,1313,9,7,13,16,44,60,-16,34
Ayr,1313,10,7,11,18,34,60,-26,32
Hibernian,1314,1,19,12,5,53,24,29,69
Morton,1314,2,19,10,7,53,35,18,67
Dundee Utd,1314,3,18,9,9,56,43,13,63
Falkirk,1314,4,16,12,8,61,43,18,60
Raith,1314,5,12,10,14,38,46,-8,46
Queen of S't,1314,6,10,10,16,45,53,-8,40
St Mirren,1314,7,9,11,16,42,53,-11,38
Dumbarton,1314,8,8,13,15,48,62,-14,37
Dunfermline,1314,9,8,12,16,45,53,-8,36
Ayr,1314,10,6,11,19,30,59,-29,29
Hibernian,1315,1,18,12,6,53,26,27,66
Morton,1315,2,17,11,8,49,36,13,62
Falkirk,1315,3,16,12,8,57,37,20,60
Dundee Utd,1315,4,14,11,11,48,41,7,53
Queen of S't,1315,5,14,9,13,54,49,5,51
Dunfermline,1315,6,9,13,14,40,47,-7,40
Raith,1315,7,10,10,16,36,49,-13,40
Dumbarton,1315,8,8,15,13,47,59,-12,39
Ayr,1315,9,9,12,15,37,55,-18,39
St Mirren,1315,10,7,11,18,36,58,-22,32
Hibernian,1316,1,18,14,4,58,28,30,68
Morton,1316,2,17,12,7,53,36,17,63
Falkirk,1316,3,15,10,11,59,46,13,55
Dundee Utd,1316,4,14,10,12,46,44,2,52
Queen of S't,1316,5,14,8,14,46,46,0,50
Dumbarton,1316,6,10,11,15,46,53,-7,41
Raith,1316,7,10,10,16,34,50,-16,40
Dunfermline,1316,8,9,12,15,48,53,-5,39
St Mirren,1316,9,9,11,16,42,56,-14,38
Ayr,1316,10,8,14,14,35,55,-20,38
Hibernian,1317,1,18,13,5,54,25,29,67
Morton,1317,2,16,13,7,52,37,15,61
Dundee Utd,1317,3,15,11,10,44,39,5,56
Falkirk,1317,4,14,10,12,53,45,8,52
Queen of S't,1317,5,13,10,13,43,46,-3,49
Raith,1317,6,12,9,15,40,46,-6,45
Dunfermline,1317,7,9,16,11,46,45,1,43
Dumbarton,1317,8,9,14,13,46,53,-7,41
Ayr,1317,9,8,11,17,38,57,-19,35
St Mirren,1317,10,8,9,19,38,61,-23,33
Hibernian,1318,1,19,13,4,54,21,33,70
Morton,1318,2,18,10,8,49,35,14,64
Falkirk,1318,3,16,11,9,60,41,19,59
Dundee Utd,1318,4,15,12,9,47,38,9,57
Queen of S't,1318,5,11,11,14,43,50,-7,44
Dunfermline,1318,6,10,12,14,43,47,-4,42
Dumbarton,1318,7,10,11,15,52,58,-6,41
Raith,1318,8,11,8,17,38,46,-8,41
Ayr,1318,9,8,13,15,34,56,-22,37
St Mirren,1318,10,6,11,19,35,63,-28,29
Hibernian,1319,1,18,14,4,53,26,27,68
Dundee Utd,1319,2,17,11,8,55,38,17,62
Falkirk,1319,3,15,12,9,59,41,18,57
Morton,1319,4,15,12,9,47,38,9,57
Ayr,1319,5,11,11,14,36,50,-14,44
Queen of S't,1319,6,10,12,14,46,53,-7,42
Raith,1319,7,11,9,16,40,51,-11,42
Dumbarton,1319,8,9,13,14,52,60,-8,40
Dunfermline,1319,9,9,12,15,46,55,-9,39
St Mirren,1319,10,6,12,18,36,58,-22,30
Hibernian,1320,1,22,11,3,58,23,35,77
Morton,1320,2,18,10,8,54,38,16,64
Falkirk,1320,3,17,11,8,64,42,22,62
Dundee Utd,1320,4,16,11,9,50,41,9,59
Dunfermline,1320,5,11,12,13,51,50,1,45
Queen of S't,1320,6,11,10,15,40,51,-11,43
Dumbarton,1320,7,8,12,16,45,56,-11,36
Ayr,1320,8,8,11,17,34,57,-23,35
St Mirren,1320,9,8,10,18,42,60,-18,34
Raith,1320,10,8,8,20,33,53,-20,32
Morton,1321,1,17,11,8,49,34,15,62
Hibernian,1321,2,16,13,7,48,29,19,61
Dundee Utd,1321,3,17,10,9,51,35,16,61
Falkirk,1321,4,16,12,8,59,37,22,60
Queen of S't,1321,5,13,9,14,44,49,-5,48
Dunfermline,1321,6,12,11,13,48,46,2,47
Raith,1321,7,10,10,16,34,47,-13,40
Dumbarton,1321,8,8,14,14,44,56,-12,38
St Mirren,1321,9,8,11,17,37,56,-19,35
Ayr,1321,10,6,13,17,31,56,-25,31
Hibernian,1322,1,19,12,5,52,25,27,69
Morton,1322,2,16,13,7,44,34,10,61
Falkirk,1322,3,17,9,10,60,41,19,60
Dundee Utd,1322,4,15,10,11,53,40,13,55
Queen of S't,1322,5,12,9,15,47,52,-5,45
Dunfermline,1322,6,10,13,13,45,47,-2,43
Ayr,1322,7,10,11,15,39,53,-14,41
Raith,1322,8,11,8,17,31,50,-19,41
Dumbarton,1322,9,8,14,14,50,59,-9,38
St Mirren,1322,10,8,9,19,37,57,-20,33
Hibernian,1323,1,20,12,4,58,26,32,72
Falkirk,1323,2,17,11,8,59,35,24,62
Dundee Utd,1323,3,16,11,9,53,41,12,59
Morton,1323,4,16,10,10,49,42,7,58
Dunfermline,1323,5,10,13,13,47,49,-2,43
Queen of S't,1323,6,11,9,16,43,48,-5,42
Raith,1323,7,11,9,16,35,47,-12,42
Dumbarton,1323,8,9,12,15,47,61,-14,39
St Mirren,1323,9,8,10,18,39,57,-18,34
Ayr,1323,10,7,13,16,38,62,-24,34
Hibernian,1324,1,17,15,4,54,25,29,66
Falkirk,1324,2,16,13,7,56,35,21,61
Morton,1324,3,16,12,8,49,37,12,60
Dundee Utd,1324,4,16,11,9,52,39,13,59
Queen of S't,1324,5,12,11,13,44,49,-5,47
Dunfermline,1324,6,9,14,13,47,49,-2,41
Dumbarton,1324,7,9,13,14,45,53,-8,40
Raith,1324,8,10,10,16,33,48,-15,40
St Mirren,1324,9,7,12,17,37,55,-18,33
Ayr,1324,10,6,13,17,30,57,-27,31
Hibernian,1325,1,20,13,3,58,25,33,73
Dundee Utd,1325,2,17,11,8,55,38,17,62
Morton,1325,3,16,14,6,52,37,15,62
Falkirk,1325,4,15,12,9,61,45,16,57
Queen of S't,1325,5,12,9,15,48,53,-5,45
Dunfermline,1325,6,9,13,14,47,54,-7,40
Ayr,1325,7,9,12,15,40,52,-12,39
Dumbarton,1325,8,8,12,16,48,67,-19,36
Raith,1325,9,9,8,19,35,56,-21,35
St Mirren,1325,10,8,10,18,42,59,-17,34
Hibernian,1326,1,20,11,5,55,24,31,71
Falkirk,1326,2,17,11,8,63,38,25,62
Dundee Utd,1326,3,16,10,10,54,44,10,58
Morton,1326,4,15,9,12,48,47,1,54
Dunfermline,1326,5,12,11,13,45,49,-4,47
Raith,1326,6,12,9,15,45,51,-6,45
Queen of S't,1326,7,11,9,16,46,53,-7,42
Dumbarton,1326,8,10,11,15,47,56,-9,41
St Mirren,1326,9,9,10,17,45,58,-13,37
Ayr,1326,10,7,11,18,35,63,-28,32
Hibernian,1327,1,18,12,6,53,22,31,66
Dundee Utd,1327,2,19,9,8,62,35,27,66
Morton,1327,3,16,13,7,48,34,14,61
Falkirk,1327,4,16,9,11,56,40,16,57
Queen of S't,1327,5,11,10,15,48,53,-5,43
Raith,1327,6,10,12,14,37,50,-13,42
Dunfermline,1327,7,9,12,15,42,53,-11,39
St Mirren,1327,8,9,12,15,40,58,-18,39
Ayr,1327,9,9,10,17,34,59,-25,37
Dumbarton,1327,10,8,11,17,44,60,-16,35
Hibernian,1328,1,19,13,4,58,30,28,70
Dundee Utd,1328,2,18,9,9,54,39,15,63
Morton,1328,3,16,12,8,54,37,17,60
Falkirk,1328,4,15,12,9,59,42,17,57
Queen of S't,1328,5,12,9,15,47,51,-4,45
Raith,1328,6,12,9,15,37,47,-10,45
Dunfermline,1328,7,8,13,15,42,54,-12,37
Ayr,1328,8,8,13,15,37,57,-20,37
Dumbarton,1328,9,8,11,17,46,60,-14,35
St Mirren,1328,10,8,11,17,39,56,-17,35
Morton,1329,1,20,9,7,57,37,20,69
Hibernian,1329,2,18,12,6,62,35,27,66
Dundee Utd,1329,3,17,10,9,52,41,11,61
Falkirk,1329,4,16,12,8,62,42,20,60
Dunfermline,1329,5,11,11,14,49,50,-1,44
Raith,1329,6,11,9,16,41,53,-12,42
Dumbarton,1329,7,8,14,14,50,59,-9,38
Ayr,1329,8,8,14,14,35,53,-18,38
Queen of S't,1329,9,9,9,18,43,57,-14,36
St Mirren,1329,10,6,12,18,37,61,-24,30
Hibernian,1330,1,21,10,5,62,28,34,73
Dundee Utd,1330,2,17,10,9,50,37,13,61
Morton,1330,3,16,13,7,50,38,12,61
Falkirk,1330,4,15,11,10,55,41,14,56
Queen of S't,1330,5,11,10,15,46,50,-4,43
Dunfermline,1330,6,10,12,14,44,48,-4,42
St Mirren,1330,7,10,9,17,41,55,-14,39
Raith,1330,8,9,12,15,36,51,-15,39
Ayr,1330,9,7,14,15,32,53,-21,35
Dumbarton,1330,10,7,13,16,46,61,-15,34
Hibernian,1331,1,18,12,6,51,26,25,66
Dundee Utd,1331,2,18,10,8,52,34,18,64
Falkirk,1331,3,16,11,9,60,38,22,59
Morton,1331,4,16,10,10,44,34,10,58
Raith,1331,5,13,10,13,39,44,-5,49
Dunfermline,1331,6,9,13,14,40,48,-8,40
Queen of S't,1331,7,10,10,16,41,51,-10,40
Dumbarton,1331,8,9,12,15,46,58,-12,39
St Mirren,1331,9,8,11,17,37,55,-18,35
Ayr,1331,10,6,15,15,29,51,-22,33
Hibernian,1332,1,17,15,4,54,29,25,66
Falkirk,1332,2,16,10,10,61,42,19,58
Morton,1332,3,15,13,8,50,39,11,58
Dundee Utd,1332,4,16,10,10,49,41,8,58
Dunfermline,1332,5,12,11,13,52,46,6,47
Queen of S't,1332,6,11,11,14,40,48,-8,44
Dumbarton,1332,7,10,11,15,46,58,-12,41
Raith,1332,8,10,11,15,33,45,-12,41
Ayr,1332,9,8,13,15,34,51,-17,37
St Mirren,1332,10,7,11,18,39,59,-20,32
Falkirk,1333,1,20,9,7,71,41,30,69
Hibernian,1333,2,18,14,4,57,28,29,68
Morton,1333,3,17,13,6,50,33,17,64
Dundee Utd,1333,4,15,11,10,52,41,11,56
Raith,1333,5,10,11,15,37,51,-14,41
Queen of S't,1333,6,10,10,16,46,54,-8,40
Dunfermline,1333,7,9,12,15,48,54,-6,39
Dumbarton,1333,8,9,11,16,46,59,-13,38
Ayr,1333,9,8,11,17,33,60,-27,35
St Mirren,1333,10,7,12,17,40,59,-19,33
Hibernian,1334,1,19,13,4,52,23,29,70
Falkirk,1334,2,17,10,9,58,41,17,61
Morton,1334,3,16,12,8,52,40,12,60
Dundee Utd,1334,4,15,10,11,55,46,9,55
Queen of S't,1334,5,13,8,15,49,47,2,47
Dunfermline,1334,6,10,13,13,49,50,-1,43
Raith,1334,7,11,10,15,37,46,-9,43
Ayr,1334,8,9,11,16,36,56,-20,38
St Mirren,1334,9,8,11,17,42,60,-18,35
Dumbarton,1334,10,8,10,18,46,67,-21,34
Hibernian,1335,1,20,11,5,58,27,31,71
Falkirk,1335,2,18,9,9,62,39,23,63
Dundee Utd,1335,3,16,11,9,51,40,11,59
Morton,1335,4,16,11,9,45,38,7,59
Queen of S't,1335,5,13,10,13,50,48,2,49
Dunfermline,1335,6,10,14,12,49,47,2,44
St Mirren,1335,7,9,9,18,37,54,-17,36
Raith,1335,8,9,9,18,35,57,-22,36
Ayr,1335,9,7,14,15,36,54,-18,35
Dumbarton,1335,10,8,10,18,44,63,-19,34
Morton,1336,1,19,11,6,53,29,24,68
Hibernian,1336,2,18,13,5,56,31,25,67
Falkirk,1336,3,17,10,9,60,40,20,61
Dundee Utd,1336,4,16,10,10,53,40,13,58
Dumbarton,1336,5,10,13,13,50,54,-4,43
Raith,1336,6,10,11,15,34,47,-13,41
St Mirren,1336,7,9,11,16,41,55,-14,38
Dunfermline,1336,8,8,13,15,44,54,-10,37
Queen of S't,1336,9,9,9,18,42,57,-15,36
Ayr,1336,10,7,13,16,33,59,-26,34
Hibernian,1337,1,17,12,7,49,29,20,63
Falkirk,1337,2,17,11,8,59,39,20,62
Morton,1337,3,17,11,8,49,34,15,62
Dundee Utd,1337,4,16,10,10,51,43,8,58
Raith,1337,5,11,10,15,35,48,-13,43
Queen of S't,1337,6,10,12,14,41,47,-6,42
Dunfermline,1337,7,9,12,15,45,50,-5,39
Dumbarton,1337,8,8,15,13,46,54,-8,39
Ayr,1337,9,9,12,15,38,54,-16,39
St Mirren,1337,10,8,11,17,39,54,-15,35
Hibernian,1338,1,18,12,6,55,28,27,66
Morton,1338,2,17,13,6,53,35,18,64
Falkirk,1338,3,16,11,9,58,44,14,59
Dundee Utd,1338,4,16,10,10,47,36,11,58
Queen of S't,1338,5,13,10,13,51,50,1,49
Dunfermline,1338,6,10,13,13,50,54,-4,43
Dumbarton,1338,7,8,13,15,47,57,-10,37
Raith,1338,8,9,10,17,35,52,-17,37
St Mirren,1338,9,8,11,17,39,58,-19,35
Ayr,1338,10,8,11,17,31,52,-21,35
Hibernian,1339,1,17,16,3,58,28,30,67
Falkirk,1339,2,17,11,8,61,40,21,62
Dundee Utd,1339,3,17,10,9,56,41,15,61
Morton,1339,4,14,12,10,48,42,6,54
Queen of S't,1339,5,13,10,13,49,49,0,49
Raith,1339,6,10,10,16,35,50,-15,40
Dumbarton,1339,7,9,12,15,54,64,-10,39
St Mirren,1339,8,9,11,16,42,56,-14,38
Dunfermline,1339,9,8,13,15,48,58,-10,37
Ayr,1339,10,8,11,17,36,59,-23,35
Hibernian,1340,1,20,11,5,57,26,31,71
Morton,1340,2,20,9,7,52,34,18,69
Falkirk,1340,3,15,11,10,56,41,15,56
Dundee Utd,1340,4,14,9,13,46,46,0,51
Queen of S't,1340,5,11,10,15,46,49,-3,43
Dunfermline,1340,6,9,14,13,44,50,-6,41
Raith,1340,7,10,10,16,35,47,-12,40
Ayr,1340,8,10,10,16,39,56,-17,40
Dumbarton,1340,9,9,12,15,48,61,-13,39
St Mirren,1340,10,9,10,17,39,52,-13,37
Hibernian,1341,1,17,13,6,51,28,23,64
Dundee Utd,1341,2,18,9,9,60,39,21,63
Morton,1341,3,17,11,8,48,38,10,62
Falkirk,1341,4,16,10,10,57,43,14,58
Queen of S't,1341,5,13,9,14,50,53,-3,48
Raith,1341,6,11,9,16,34,44,-10,42
Ayr,1341,7,10,11,15,39,60,-21,41
Dumbarton,1341,8,10,10,16,48,60,-12,40
Dunfermline,1341,9,9,12,15,51,52,-1,39
St Mirren,1341,10,7,10,19,38,59,-21,31
Hibernian,1342,1,20,12,4,58,27,31,72
Morton,1342,2,15,11,10,46,41,5,56
Falkirk,1342,3,14,12,10,59,47,12,54
Dundee Utd,1342,4,15,9,12,53,42,11,54
Dunfermline,1342,5,10,16,10,50,46,4,46
Queen of S't,1342,6,11,11,14,44,50,-6,44
St Mirren,1342,7,11,10,15,54,58,-4,43
Raith,1342,8,10,10,16,35,52,-17,40
Dumbarton,1342,9,8,13,15,49,60,-11,37
Ayr,1342,10,9,10,17,37,62,-25,37
Hibernian,1343,1,20,11,5,61,29,32,71
Morton,1343,2,18,11,7,54,35,19,65
Dundee Utd,1343,3,17,11,8,55,35,20,62
Falkirk,1343,4,15,12,9,58,43,15,57
Queen of S't,1343,5,11,9,16,46,52,-6,42
Raith,1343,6,11,9,16,38,49,-11,42
Dunfermline,1343,7,9,12,15,48,54,-6,39
St Mirren,1343,8,9,10,17,39,58,-19,37
Dumbarton,1343,9,8,12,16,45,66,-21,36
Ayr,1343,10,8,11,17,35,58,-23,35
Hibernian,1344,1,19,12,5,60,26,34,69
Morton,1344,2,17,13,6,50,35,15,64
Falkirk,1344,3,17,11,8,64,40,24,62
Dundee Utd,1344,4,14,10,12,44,43,1,52
Dunfermline,1344,5,12,12,12,50,46,4,48
Dumbarton,1344,6,10,12,14,48,55,-7,42
Queen of S't,1344,7,11,8,17,45,54,-9,41
Raith,1344,8,10,9,17,35,56,-21,39
Ayr,1344,9,8,13,15,34,54,-20,37
St Mirren,1344,10,6,12,18,37,58,-21,30
Hibernian,1345,1,19,13,4,53,22,31,70
Morton,1345,2,17,11,8,50,42,8,62
Falkirk,1345,3,16,12,8,61,40,21,60
Dundee Utd,1345,4,14,10,12,46,41,5,52
Queen of S't,1345,5,12,9,15,46,52,-6,45
Raith,1345,6,10,12,14,36,48,-12,42
Dumbarton,1345,7,9,12,15,49,57,-8,39
Dunfermline,1345,8,9,11,16,45,52,-7,38
Ayr,1345,9,9,11,16,35,57,-22,38
St Mirren,1345,10,8,13,15,41,51,-10,37
Hibernian,1346,1,20,11,5,57,28,29,71
Dundee Utd,1346,2,15,13,8,52,40,12,58
Morton,1346,3,15,12,9,46,39,7,57
Falkirk,1346,4,14,10,12,57,45,12,52
Queen of S't,1346,5,12,9,15,47,54,-7,45
Dunfermline,1346,6,10,13,13,51,51,0,43
Dumbarton,1346,7,10,12,14,53,57,-4,42
Raith,1346,8,11,9,16,37,48,-11,42
Ayr,1346,9,9,12,15,38,56,-18,39
St Mirren,1346,10,8,11,17,40,60,-20,35
Hibernian,1347,1,18,13,5,50,24,26,67
Morton,1347,2,17,12,7,53,37,16,63
Falkirk,1347,3,17,11,8,61,41,20,62
Dundee Utd,1347,4,17,9,10,51,37,14,60
Queen of S't,1347,5,12,9,15,46,51,-5,45
Dunfermline,1347,6,9,14,13,46,51,-5,41
St Mirren,1347,7,10,11,15,45,53,-8,41
Ayr,1347,8,9,10,17,33,58,-25,37
Raith,1347,9,9,9,18,32,51,-19,36
Dumbarton,1347,10,8,10,18,48,62,-14,34
Hibernian,1348,1,19,13,4,56,25,31,70
Morton,1348,2,17,12,7,51,35,16,63
Falkirk,1348,3,15,14,7,58,38,20,59
Dundee Utd,1348,4,15,13,8,53,36,17,58
Dunfermline,1348,5,10,15,11,48,48,0,45
Queen of S't,1348,6,10,10,16,39,51,-12,40
Raith,1348,7,9,10,17,33,48,-15,37
Dumbarton,1348,8,8,12,16,46,61,-15,36
St Mirren,1348,9,9,9,18,38,58,-20,36
Ayr,1348,10,8,12,16,32,54,-22,36
Morton,1349,1,17,11,8,50,37,13,62
Hibernian,1349,2,16,12,8,56,38,18,60
Falkirk,1349,3,16,11,9,60,41,19,59
Dundee Utd,1349,4,16,9,11,49,39,10,57
Dunfermline,1349,5,13,12,11,57,47,10,51
Queen of S't,1349,6,11,10,15,48,56,-8,43
Raith,1349,7,11,9,16,36,51,-15,42
St Mirren,1349,8,10,10,16,45,54,-9,40
Ayr,1349,9,9,12,15,35,56,-21,39
Dumbarton,1349,10,7,12,17,44,61,-17,33
Hibernian,1350,1,20,11,5,57,25,32,71
Falkirk,1350,2,16,11,9,56,36,20,59
Dundee Utd,1350,3,17,8,11,45,41,4,59
Morton,1350,4,14,12,10,45,41,4,54
Dunfermline,1350,5,10,14,12,46,46,0,44
Queen of S't,1350,6,11,10,15,47,50,-3,43
Dumbarton,1350,7,10,12,14,50,54,-4,42
Ayr,1350,8,9,12,15,33,54,-21,39
St Mirren,1350,9,9,10,17,40,55,-15,37
Raith,1350,10,9,10,17,33,50,-17,37
Hibernian,1351,1,20,12,4,58,22,36,72
Falkirk,1351,2,18,11,7,61,37,24,65
Morton,1351,3,17,11,8,52,39,13,62
Dundee Utd,1351,4,16,11,9,52,39,13,59
Raith,1351,5,11,10,15,39,52,-13,43
Queen of S't,1351,6,10,10,16,42,54,-12,40
Dumbarton,1351,7,8,15,13,48,58,-10,39
Ayr,1351,8,9,10,17,38,59,-21,37
Dunfermline,1351,9,7,13,16,45,55,-10,34
St Mirren,1351,10,7,11,18,39,59,-20,32
Hibernian,1352,1,19,12,5,56,23,33,69
Morton,1352,2,17,10,9,48,39,9,61
Falkirk,1352,3,16,11,9,58,40,18,59
Dundee Utd,1352,4,16,9,11,53,43,10,57
Queen of S't,1352,5,12,9,15,47,50,-3,45
Dunfermline,1352,6,10,13,13,46,52,-6,43
Ayr,1352,7,9,12,15,35,52,-17,39
St Mirren,1352,8,9,11,16,43,56,-13,38
Dumbarton,1352,9,9,11,16,47,62,-15,38
Raith,1352,10,8,12,16,34,50,-16,36
Hibernian,1353,1,19,11,6,59,32,27,68
Morton,1353,2,16,12,8,51,40,11,60
Falkirk,1353,3,16,11,9,60,40,20,59
Dundee Utd,1353,4,16,9,11,50,41,9,57
Dunfermline,1353,5,11,12,13,48,51,-3,45
Dumbarton,1353,6,11,11,14,50,55,-5,44
Queen of S't,1353,7,11,8,17,42,53,-11,41
Ayr,1353,8,10,10,16,38,56,-18,40
Raith,1353,9,9,11,16,37,52,-15,38
St Mirren,1353,10,8,11,17,44,59,-15,35
Hibernian,1354,1,18,14,4,53,24,29,68
Morton,1354,2,18,12,6,52,35,17,66
Falkirk,1354,3,15,11,10,56,38,18,56
Queen of S't,1354,4,14,9,13,47,46,1,51
Dundee Utd,1354,5,14,9,13,44,47,-3,51
Dumbarton,1354,6,12,10,14,48,49,-1,46
Dunfermline,1354,7,10,11,15,46,50,-4,41
Raith,1354,8,9,11,16,33,49,-16,38
Ayr,1354,9,7,13,16,34,55,-21,34
St Mirren,1354,10,7,12,17,38,58,-20,33
Hibernian,1355,1,18,13,5,53,30,23,67
Falkirk,1355,2,18,10,8,66,40,26,64
Morton,1355,3,16,12,8,55,39,16,60
Dundee Utd,1355,4,16,9,11,50,43,7,57
Queen of S't,1355,5,12,10,14,44,48,-4,46
Ayr,1355,6,10,12,14,38,52,-14,42
Dunfermline,1355,7,9,13,14,50,53,-3,40
Raith,1355,8,9,11,16,35,52,-17,38
Dumbarton,1355,9,8,13,15,46,56,-10,37
St Mirren,1355,10,8,9,19,40,64,-24,33
Hibernian,1356,1,19,12,5,53,25,28,69
Morton,1356,2,18,11,7,51,36,15,65
Dundee Utd,1356,3,16,8,12,45,38,7,56
Falkirk,1356,4,15,9,12,54,43,11,54
Queen of S't,1356,5,14,9,13,48,47,1,51
Dumbarton,1356,6,10,12,14,47,53,-6,42
Dunfermline,1356,7,10,11,15,42,48,-6,41
St Mirren,1356,8,10,9,17,45,55,-10,39
Raith,1356,9,9,9,18,37,54,-17,36
Ayr,1356,10,7,14,15,33,56,-23,35
Hibernian,1357,1,19,11,6,57,30,27,68
Falkirk,1357,2,17,12,7,58,36,22,63
Morton,1357,3,16,11,9,50,40,10,59
Dundee Utd,1357,4,16,10,10,51,41,10,58
Queen of S't,1357,5,13,9,14,53,53,0,48
Dunfermline,1357,6,10,12,14,47,51,-4,42
St Mirren,1357,7,10,10,16,45,55,-10,40
Dumbarton,1357,8,10,10,16,48,59,-11,40
Ayr,1357,9,8,11,17,35,57,-22,35
Raith,1357,10,9,8,19,33,55,-22,35
Hibernian,1358,1,21,10,5,59,25,34,73
Morton,1358,2,19,9,8,50,36,14,66
Falkirk,1358,3,17,9,10,56,39,17,60
Dundee Utd,1358,4,14,10,12,46,42,4,52
Queen of S't,1358,5,14,9,13,50,48,2,51
Dunfermline,1358,6,10,11,15,46,51,-5,41
St Mirren,1358,7,10,9,17,41,56,-15,39
Dumbarton,1358,8,9,11,16,45,59,-14,38
Ayr,1358,9,8,12,16,40,57,-17,36
Raith,1358,10,9,8,19,32,52,-20,35
Hibernian,1359,1,20,11,5,54,24,30,71
Morton,1359,2,19,10,7,51,35,16,67
Dundee Utd,1359,3,17,8,11,54,43,11,59
Falkirk,1359,4,16,10,10,57,40,17,58
Queen of S't,1359,5,14,8,14,50,47,3,50
Dunfermline,1359,6,11,13,12,46,48,-2,46
Dumbarton,1359,7,9,11,16,47,61,-14,38
Raith,1359,8,9,9,18,32,50,-18,36
St Mirren,1359,9,8,10,18,40,56,-16,34
Ayr,1359,10,7,10,19,33,60,-27,31
Hibernian,1360,1,20,11,5,57,24,33,71
Dundee Utd,1360,2,18,8,10,48,38,10,62
Falkirk,1360,3,17,10,9,58,37,21,61
Morton,1360,4,14,15,7,46,36,10,57
Queen of S't,1360,5,15,8,13,49,46,3,53
Raith,1360,6,11,10,15,36,48,-12,43
Dunfermline,1360,7,9,13,14,42,48,-6,40
Dumbarton,1360,8,7,13,16,40,54,-14,34
St Mirren,1360,9,7,11,18,38,57,-19,32
Ayr,1360,10,7,11,18,29,55,-26,32
Hibernian,1361,1,19,13,4,54,23,31,70
Morton,1361,2,17,11,8,54,34,20,62
Dundee Utd,1361,3,15,10,11,46,42,4,55
Falkirk,1361,4,14,12,10,56,42,14,54
Queen of S't,1361,5,14,10,12,46,44,2,52
Dunfermline,1361,6,9,13,14,45,47,-2,40
Raith,1361,7,10,9,17,35,53,-18,39
St Mirren,1361,8,9,11,16,41,56,-15,38
Ayr,1361,9,8,13,15,35,57,-22,37
Dumbarton,1361,10,8,12,16,45,59,-14,36
Hibernian,1362,1,19,13,4,54,26,28,70
Falkirk,1362,2,16,10,10,56,41,15,58
Morton,1362,3,15,13,8,47,36,11,58
Dundee Utd,1362,4,14,12,10,46,40,6,54
Queen of S't,1362,5,13,9,14,48,49,-1,48
Dunfermline,1362,6,10,13,13,49,50,-1,43
Raith,1362,7,11,9,16,35,47,-12,42
Ayr,1362,8,9,12,15,36,52,-16,39
St Mirren,1362,9,9,10,17,40,55,-15,37
Dumbarton,1362,10,7,13,16,46,61,-15,34
Hibernian,1363,1,17,13,6,54,29,25,64
Falkirk,1363,2,15,13,8,59,42,17,58
Morton,1363,3,15,12,9,46,37,9,57
Dundee Utd,1363,4,15,11,10,52,41,11,56
Queen of S't,1363,5,14,8,14,48,48,0,50
Dunfermline,1363,6,11,13,12,48,47,1,46
St Mirren,1363,7,10,11,15,46,55,-9,41
Raith,1363,8,10,10,16,36,50,-14,40
Dumbarton,1363,9,9,11,16,47,58,-11,38
Ayr,1363,10,7,12,17,30,59,-29,33
Dundee Utd,1364,1,19,8,9,57,40,17,65
Falkirk,1364,2,18,10,8,67,37,30,64
Hibernian,1364,3,16,13,7,51,30,21,61
Morton,1364,4,16,12,8,49,38,11,60
Queen of S't,1364,5,11,11,14,46,52,-6,44
Raith,1364,6,11,10,15,38,52,-14,43
Dunfermline,1364,7,9,14,13,45,53,-8,41
Ayr,1364,8,9,11,16,34,56,-22,38
St Mirren,1364,9,9,9,18,41,56,-15,36
Dumbarton,1364,10,7,12,17,45,59,-14,33
Hibernian,1365,1,20,13,3,55,22,33,73
Morton,1365,2,18,11,7,55,39,16,65
Dundee Utd,1365,3,17,10,9,57,39,18,61
Falkirk,1365,4,14,10,12,55,43,12,52
Dunfermline,1365,5,11,13,12,48,45,3,46
Raith,1365,6,11,8,17,39,53,-14,41
Ayr,1365,7,9,11,16,38,59,-21,38
Queen of S't,1365,8,9,10,17,39,51,-12,37
St Mirren,1365,9,9,10,17,41,56,-15,37
Dumbarton,1365,10,9,10,17,47,67,-20,37
Hibernian,1366,1,19,12,5,60,25,35,69
Morton,1366,2,18,10,8,52,35,17,64
Falkirk,1366,3,17,10,9,63,42,21,61
Dundee Utd,1366,4,16,10,10,54,43,11,58
Queen of S't,1366,5,11,8,17,45,53,-8,41
Dumbarton,1366,6,10,11,15,51,61,-10,41
Raith,1366,7,11,8,17,34,58,-24,41
Dunfermline,1366,8,9,13,14,48,53,-5,40
Ayr,1366,9,9,11,16,36,58,-22,38
St Mirren,1366,10,9,9,18,39,54,-15,36
Hibernian,1367,1,21,12,3,62,22,40,75
Morton,1367,2,17,10,9,49,40,9,61
Falkirk,1367,3,16,11,9,54,39,15,59
Dundee Utd,1367,4,15,12,9,51,41,10,57
Dumbarton,1367,5,12,11,13,50,53,-3,47
Dunfermline,1367,6,11,11,14,51,47,4,44
Queen of S't,1367,7,11,10,15,44,51,-7,43
Raith,1367,8,8,11,17,33,55,-22,35
St Mirren,1367,9,7,12,17,39,57,-18,33
Ayr,1367,10,6,12,18,31,59,-28,30
Hibernian,1368,1,22,10,4,60,25,35,76
Falkirk,1368,2,18,9,9,59,37,22,63
Morton,1368,3,17,11,8,52,40,12,62
Dundee Utd,1368,4,13,11,12,49,46,3,50
Dumbarton,1368,5,12,10,14,48,56,-8,46
Queen of S't,1368,6,12,8,16,44,51,-7,44
Dunfermline,1368,7,10,12,14,49,51,-2,42
St Mirren,1368,8,9,11,16,44,53,-9,38
Raith,1368,9,10,8,18,36,52,-16,38
Ayr,1368,10,7,10,19,35,65,-30,31
Hibernian,1369,1,20,11,5,56,24,32,71
Falkirk,1369,2,18,11,7,57,35,22,65
Morton,1369,3,17,11,8,49,37,12,62
Dundee Utd,1369,4,14,9,13,46,39,7,51
Queen of S't,1369,5,12,8,16,44,51,-7,44
Raith,1369,6,11,9,16,40,54,-14,42
Ayr,1369,7,10,12,14,37,54,-17,42
Dumbarton,1369,8,10,11,15,46,55,-9,41
Dunfermline,1369,9,8,12,16,42,51,-9,36
St Mirren,1369,10,8,10,18,44,61,-17,34
Hibernian,1370,1,20,11,5,62,27,35,71
Morton,1370,2,18,9,9,54,42,12,63
Dundee Utd,1370,3,16,9,11,51,38,13,57
Falkirk,1370,4,14,12,10,56,46,10,54
Dumbarton,1370,5,12,11,13,50,52,-2,47
Queen of S't,1370,6,12,10,14,45,52,-7,46
Dunfermline,1370,7,9,13,14,45,52,-7,40
Raith,1370,8,10,9,17,40,57,-17,39
St Mirren,1370,9,9,9,18,41,56,-15,36
Ayr,1370,10,7,13,16,31,53,-22,34
Hibernian,1371,1,18,12,6,53,28,25,66
Morton,1371,2,17,10,9,50,42,8,61
Falkirk,1371,3,15,12,9,53,37,16,57
Dundee Utd,1371,4,15,10,11,47,40,7,55
Raith,1371,5,13,9,14,39,46,-7,48
Dumbarton,1371,6,11,12,13,55,55,0,45
Queen of S't,1371,7,11,11,14,41,47,-6,44
Dunfermline,1371,8,9,11,16,45,53,-8,38
St Mirren,1371,9,8,11,17,39,54,-15,35
Ayr,1371,10,6,16,14,34,54,-20,34
Morton,1372,1,17,12,7,52,37,15,63
Hibernian,1372,2,17,11,8,53,32,21,62
Falkirk,1372,3,15,12,9,59,43,16,57
Dundee Utd,1372,4,14,10,12,45,41,4,52
Queen of S't,1372,5,12,11,13,48,48,0,47
Dunfermline,1372,6,11,13,12,43,44,-1,46
Dumbarton,1372,7,11,10,15,49,56,-7,43
Ayr,1372,8,9,14,13,38,51,-13,41
Raith,1372,9,8,12,16,35,52,-17,36
St Mirren,1372,10,7,13,16,42,60,-18,34
Hibernian,1373,1,19,12,5,54,25,29,69
Falkirk,1373,2,17,9,10,64,43,21,60
Morton,1373,3,16,12,8,52,40,12,60
Dundee Utd,1373,4,14,12,10,50,41,9,54
Queen of S't,1373,5,13,9,14,46,48,-2,48
Dunfermline,1373,6,9,14,13,47,52,-5,41
Dumbarton,1373,7,9,13,14,46,57,-11,40
Ayr,1373,8,7,16,13,38,56,-18,37
Raith,1373,8,9,10,17,38,56,-18,37
St Mirren,1373,10,7,13,16,44,61,-17,34
Hibernian,1374,1,21,11,4,59,23,36,74
Morton,1374,2,17,11,8,52,37,15,62
Falkirk,1374,3,15,12,9,53,39,14,57
Dundee Utd,1374,4,14,13,9,49,39,10,55
Queen of S't,1374,5,13,9,14,43,45,-2,48
Dunfermline,1374,6,10,13,13,46,46,0,43
Dumbarton,1374,7,9,12,15,48,60,-12,39
Raith,1374,8,10,9,17,34,49,-15,39
St Mirren,1374,9,9,9,18,40,59,-19,36
Ayr,1374,10,7,11,18,31,58,-27,32
Hibernian,1375,1,20,11,5,55,24,31,71
Falkirk,1375,2,18,9,9,60,37,23,63
Morton,1375,3,16,12,8,55,43,12,60
Dundee Utd,1375,4,13,12,11,50,46,4,51
Dumbarton,1375,5,11,12,13,51,52,-1,45
Raith,1375,6,12,9,15,36,49,-13,45
Dunfermline,1375,7,9,14,13,45,47,-2,41
Queen of S't,1375,8,10,11,15,41,51,-10,41
St Mirren,1375,9,9,9,18,40,55,-15,36
Ayr,1375,10,6,13,17,34,63,-29,31
Hibernian,1376,1,20,11,5,55,24,31,71
Morton,1376,2,19,11,6,51,32,19,68
Falkirk,1376,3,17,10,9,62,39,23,61
Dundee Utd,1376,4,17,9,10,46,38,8,60
Ayr,1376,5,12,10,14,37,47,-10,46
Dunfermline,1376,6,10,13,13,46,47,-1,43
Queen of S't,1376,7,10,10,16,41,49,-8,40
Dumbarton,1376,8,7,12,17,42,60,-18,33
St Mirren,1376,9,8,9,19,38,58,-20,33
Raith,1376,10,8,9,19,28,52,-24,33
Hibernian,1377,1,20,13,3,63,27,36,73
Morton,1377,2,18,11,7,54,35,19,65
Falkirk,1377,3,17,11,8,64,39,25,62
Dundee Utd,1377,4,14,11,11,45,42,3,53
Dunfermline,1377,5,9,15,12,48,48,0,42
Queen of S't,1377,6,10,11,15,45,53,-8,41
Raith,1377,7,11,8,17,35,51,-16,41
Ayr,1377,8,9,11,16,35,60,-25,38
Dumbarton,1377,9,9,10,17,43,60,-17,37
St Mirren,1377,10,8,9,19,41,58,-17,33
Hibernian,1378,1,20,12,4,58,24,34,72
Morton,1378,2,18,12,6,55,34,21,66
Dundee Utd,1378,3,17,9,10,52,40,12,60
Falkirk,1378,4,16,10,10,57,41,16,58
Queen of S't,1378,5,12,9,15,43,46,-3,45
Dunfermline,1378,6,10,14,12,49,49,0,44
Dumbarton,1378,7,8,12,16,46,65,-19,36
Raith,1378,8,9,9,18,30,49,-19,36
Ayr,1378,9,7,14,15,30,56,-26,35
St Mirren,1378,10,8,9,19,38,54,-16,33
Hibernian,1379,1,18,13,5,57,27,30,67
Morton,1379,2,19,10,7,53,36,17,67
Falkirk,1379,3,14,12,10,57,44,13,54
Dundee Utd,1379,4,13,11,12,44,41,3,50
Dunfermline,1379,5,11,14,11,49,44,5,47
Queen of S't,1379,6,12,10,14,48,52,-4,46
Ayr,1379,7,10,12,14,41,55,-14,42
Dumbarton,1379,8,9,13,14,50,60,-10,40
Raith,1379,9,9,10,17,33,52,-19,37
St Mirren,1379,10,8,9,19,38,59,-21,33
Hibernian,1380,1,21,12,3,61,23,38,75
Morton,1380,2,18,9,9,50,40,10,63
Falkirk,1380,3,17,10,9,63,38,25,61
Dundee Utd,1380,4,17,8,11,51,39,12,59
Queen of S't,1380,5,13,9,14,46,50,-4,48
Raith,1380,6,11,10,15,39,50,-11,43
Dunfermline,1380,7,8,13,15,45,52,-7,37
Dumbarton,1380,8,9,10,17,44,62,-18,37
St Mirren,1380,9,9,9,18,43,59,-16,36
Ayr,1380,10,7,10,19,33,62,-29,31
Hibernian,1381,1,19,12,5,55,30,25,69
Morton,1381,2,18,11,7,51,35,16,65
Falkirk,1381,3,18,9,9,61,40,21,63
Dundee Utd,1381,4,18,9,9,49,37,12,63
Queen of S't,1381,5,11,9,16,43,47,-4,42
Ayr,1381,6,10,12,14,36,50,-14,42
Dunfermline,1381,7,9,12,15,45,52,-7,39
Dumbarton,1381,8,9,12,15,48,56,-8,39
Raith,1381,9,9,9,18,34,50,-16,36
St Mirren,1381,10,7,9,20,40,65,-25,30
Hibernian,1382,1,18,11,7,57,32,25,65
Falkirk,1382,2,17,11,8,60,38,22,62
Morton,1382,3,16,13,7,53,39,14,61
Dundee Utd,1382,4,15,11,10,51,46,5,56
Dunfermline,1382,5,12,13,11,54,47,7,49
Queen of S't,1382,6,10,11,15,46,50,-4,41
Raith,1382,7,10,10,16,37,53,-16,40
Dumbarton,1382,8,8,15,13,50,57,-7,39
St Mirren,1382,9,9,12,15,43,54,-11,39
Ayr,1382,10,6,11,19,31,66,-35,29
Hibernian,1383,1,17,14,5,51,23,28,65
Falkirk,1383,2,18,11,7,61,36,25,65
Morton,1383,3,17,11,8,51,30,21,62
Dundee Utd,1383,4,15,8,13,56,47,9,53
Ayr,1383,5,11,11,14,39,54,-15,44
Queen of S't,1383,6,11,10,15,44,52,-8,43
Dunfermline,1383,7,9,13,14,41,50,-9,40
Raith,1383,8,10,9,17,35,49,-14,39
St Mirren,1383,9,10,9,17,41,61,-20,39
Dumbarton,1383,10,9,10,17,46,63,-17,37
Hibernian,1384,1,21,11,4,60,23,37,74
Dundee Utd,1384,2,16,9,11,47,35,12,57
Morton,1384,3,15,11,10,47,43,4,56
Falkirk,1384,4,14,13,9,56,43,13,55
Dunfermline,1384,5,11,14,11,47,46,1,47
Ayr,1384,6,10,12,14,34,49,-15,42
Queen of S't,1384,7,10,11,15,43,50,-7,41
Dumbarton,1384,8,9,12,15,50,59,-9,39
Raith,1384,9,9,11,16,31,46,-15,38
St Mirren,1384,10,8,10,18,36,57,-21,34
Hibernian,1385,1,18,12,6,53,26,27,66
Morton,1385,2,18,10,8,57,35,22,64
Falkirk,1385,3,16,12,8,60,41,19,60
Dundee Utd,1385,4,16,9,11,53,42,11,57
Queen of S't,1385,5,13,10,13,49,49,0,49
Ayr,1385,6,9,14,13,38,52,-14,41
Dunfermline,1385,7,8,14,14,44,55,-11,38
St Mirren,1385,8,9,10,17,44,58,-14,37
Raith,1385,9,9,10,17,34,56,-22,37
Dumbarton,1385,10,8,11,17,49,67,-18,35
Hibernian,1386,1,19,12,5,56,26,30,69
Falkirk,1386,2,19,9,8,62,36,26,66
Morton,1386,3,16,13,7,46,36,10,61
Dundee Utd,1386,4,15,10,11,48,38,10,55
Queen of S't,1386,5,12,8,16,47,55,-8,44
Dunfermline,1386,6,10,12,14,47,46,1,42
Raith,1386,7,11,9,16,38,49,-11,42
St Mirren,1386,8,8,12,16,40,57,-17,36
Ayr,1386,9,8,12,16,33,57,-24,36
Dumbarton,1386,10,8,11,17,41,58,-17,35
Hibernian,1387,1,21,11,4,59,25,34,74
Morton,1387,2,15,14,7,47,34,13,59
Falkirk,1387,3,15,11,10,56,38,18,56
Dundee Utd,1387,4,15,10,11,46,40,6,55
Queen of S't,1387,5,13,9,14,46,50,-4,48
Dunfermline,1387,6,11,14,11,44,44,0,47
Dumbarton,1387,7,8,14,14,44,53,-9,38
Ayr,1387,8,9,11,16,35,54,-19,38
Raith,1387,9,8,11,17,34,53,-19,35
St Mirren,1387,10,7,11,18,38,58,-20,32
Hibernian,1388,1,18,13,5,54,27,27,67
Morton,1388,2,17,11,8,52,39,13,62
Dundee Utd,1388,3,15,10,11,50,44,6,55
Falkirk,1388,4,13,14,9,53,43,10,53
Queen of S't,1388,5,12,10,14,46,48,-2,46
Raith,1388,6,12,10,14,41,48,-7,46
Dunfermline,1388,7,10,12,14,48,51,-3,42
Dumbarton,1388,8,9,11,16,47,58,-11,38
Ayr,1388,9,9,11,16,33,53,-20,38
St Mirren,1388,10,8,12,16,44,57,-13,36
Hibernian,1389,1,20,12,4,55,24,31,72
Falkirk,1389,2,16,10,10,66,46,20,58
Morton,1389,3,14,15,7,49,39,10,57
Dundee Utd,1389,4,14,13,9,54,45,9,55
Queen of S't,1389,5,11,12,13,50,52,-2,45
Raith,1389,6,11,9,16,37,52,-15,42
Ayr,1389,7,8,15,13,37,54,-17,39
St Mirren,1389,8,9,11,16,45,59,-14,38
Dunfermline,1389,9,8,13,15,44,53,-9,37
Dumbarton,1389,10,8,12,16,44,57,-13,36
Hibernian,1390,1,18,13,5,54,27,27,67
Falkirk,1390,2,17,9,10,64,42,22,60
Morton,1390,3,16,12,8,52,40,12,60
Dundee Utd,1390,4,16,8,12,47,42,5,56
Queen of S't,1390,5,11,11,14,45,53,-8,44
Dumbarton,1390,6,10,13,13,53,56,-3,43
Dunfermline,1390,7,9,14,13,47,51,-4,41
Raith,1390,8,10,10,16,35,50,-15,40
St Mirren,1390,9,9,11,16,39,54,-15,38
Ayr,1390,10,7,13,16,36,57,-21,34
Hibernian,1391,1,21,11,4,62,28,34,74
Dundee Utd,1391,2,17,10,9,46,32,14,61
Morton,1391,3,16,11,9,46,34,12,59
Falkirk,1391,4,16,10,10,58,46,12,58
Queen of S't,1391,5,12,9,15,48,52,-4,45
Dunfermline,1391,6,9,14,13,48,53,-5,41
Dumbarton,1391,7,10,10,16,48,58,-10,40
Raith,1391,8,10,9,17,36,52,-16,39
Ayr,1391,9,7,14,15,32,53,-21,35
St Mirren,1391,10,8,10,18,38,54,-16,34
Hibernian,1392,1,18,11,7,53,25,28,65
Morton,1392,2,18,11,7,53,36,17,65
Falkirk,1392,3,16,13,7,56,37,19,61
Dundee Utd,1392,4,17,10,9,52,39,13,61
Dunfermline,1392,5,10,13,13,46,50,-4,43
Queen of S't,1392,6,11,9,16,42,47,-5,42
Ayr,1392,7,9,13,14,38,56,-18,40
Raith,1392,8,9,11,16,36,54,-18,38
Dumbarton,1392,9,7,13,16,46,61,-15,34
St Mirren,1392,10,7,12,17,39,56,-17,33
Hibernian,1393,1,20,13,3,61,24,37,73
Morton,1393,2,16,10,10,49,39,10,58
Falkirk,1393,3,15,12,9,57,46,11,57
Dundee Utd,1393,4,14,11,11,50,44,6,53
Raith,1393,5,11,11,14,38,46,-8,44
Dunfermline,1393,6,10,12,14,46,50,-4,42
Dumbarton,1393,7,10,11,15,54,62,-8,41
Queen of S't,1393,8,10,11,15,46,55,-9,41
Ayr,1393,9,9,12,15,34,54,-20,39
St Mirren,1393,10,7,13,16,44,59,-15,34
Hibernian,1394,1,21,12,3,61,25,36,75
Morton,1394,2,16,12,8,53,42,11,60
Falkirk,1394,3,15,11,10,62,47,15,56
Dundee Utd,1394,4,14,10,12,49,41,8,52
Queen of S't,1394,5,13,8,15,44,49,-5,47
Dunfermline,1394,6,10,14,12,47,49,-2,44
Raith,1394,7,11,10,15,36,47,-11,43
St Mirren,1394,8,8,13,15,42,54,-12,37
Ayr,1394,9,8,12,16,32,56,-24,36
Dumbarton,1394,10,7,12,17,45,61,-16,33
Hibernian,1395,1,20,12,4,57,26,31,72
Dundee Utd,1395,2,18,10,8,54,37,17,64
Morton,1395,3,16,12,8,52,37,15,60
Falkirk,1395,4,14,11,11,54,45,9,53
Dunfermline,1395,5,10,14,12,43,45,-2,44
Queen of S't,1395,6,10,12,14,45,52,-7,42
Dumbarton,1395,7,10,11,15,49,59,-10,41
Raith,1395,8,10,11,15,36,49,-13,41
St Mirren,1395,9,8,10,18,44,58,-14,34
Ayr,1395,10,6,13,17,33,59,-26,31
Hibernian,1396,1,19,11,6,59,36,23,68
Falkirk,1396,2,17,11,8,63,43,20,62
Morton,1396,3,16,10,10,50,40,10,58
Dundee Utd,1396,4,15,10,11,49,42,7,55
Queen of S't,1396,5,13,9,14,45,46,-1,48
Ayr,1396,6,11,11,14,42,55,-13,44
Dunfermline,1396,7,10,13,13,45,48,-3,43
Dumbarton,1396,8,8,13,15,46,59,-13,37
Raith,1396,9,9,10,17,33,49,-16,37
St Mirren,1396,10,8,10,18,44,58,-14,34
Hibernian,1397,1,20,13,3,57,23,34,73
Morton,1397,2,16,12,8,47,38,9,60
Dundee Utd,1397,3,15,11,10,48,40,8,56
Falkirk,1397,4,15,10,11,55,43,12,55
Queen of S't,1397,5,13,9,14,48,44,4,48
Dumbarton,1397,6,10,11,15,50,60,-10,41
Dunfermline,1397,7,8,16,12,45,49,-4,40
St Mirren,1397,8,9,10,17,42,53,-11,37
Ayr,1397,9,8,13,15,33,56,-23,37
Raith,1397,10,9,9,18,33,52,-19,36
Hibernian,1398,1,17,14,5,52,24,28,65
Morton,1398,2,16,14,6,54,36,18,62
Dundee Utd,1398,3,15,12,9,51,39,12,57
Falkirk,1398,4,14,11,11,56,45,11,53
Queen of S't,1398,5,12,10,14,47,48,-1,46
Ayr,1398,6,12,10,14,34,49,-15,46
Dunfermline,1398,7,10,13,13,50,51,-1,43
St Mirren,1398,8,10,10,16,42,57,-15,40
Raith,1398,9,9,9,18,29,52,-23,36
Dumbarton,1398,10,8,11,17,43,57,-14,35
Hibernian,1399,1,21,12,3,53,21,32,75
Falkirk,1399,2,15,11,10,57,41,16,56
Dundee Utd,1399,3,15,10,11,53,45,8,55
Morton,1399,4,14,13,9,47,40,7,55
Queen of S't,1399,5,12,9,15,48,51,-3,45
Dunfermline,1399,6,9,15,12,48,49,-1,42
Dumbarton,1399,7,10,11,15,51,60,-9,41
Raith,1399,8,11,8,17,35,50,-15,41
St Mirren,1399,9,10,10,16,46,55,-9,40
Ayr,1399,10,7,13,16,34,60,-26,34
Hibernian,1400,1,19,13,4,55,24,31,70
Falkirk,1400,2,17,11,8,62,40,22,62
Morton,1400,3,16,12,8,49,35,14,60
Dundee Utd,1400,4,15,12,9,51,38,13,57
Queen of S't,1400,5,11,11,14,45,50,-5,44
Dunfermline,1400,6,8,17,11,44,47,-3,41
Dumbarton,1400,7,9,12,15,47,59,-12,39
Raith,1400,8,9,12,15,33,48,-15,39
St Mirren,1400,9,7,12,17,38,58,-20,33
Ayr,1400,10,7,12,17,31,56,-25,33
Hibernian,1401,1,18,13,5,52,25,27,67
Morton,1401,2,18,11,7,50,37,13,65
Dundee Utd,1401,3,18,9,9,52,35,17,63
Falkirk,1401,4,17,11,8,62,39,23,62
Queen of S't,1401,5,12,10,14,45,48,-3,46
Dunfermline,1401,6,10,11,15,45,51,-6,41
Ayr,1401,7,9,12,15,37,54,-17,39
Dumbarton,1401,8,8,12,16,48,62,-14,36
Raith,1401,9,8,10,18,34,54,-20,34
St Mirren,1401,10,7,11,18,41,61,-20,32
Hibernian,1402,1,22,11,3,66,28,38,77
Morton,1402,2,19,10,7,54,36,18,67
Dundee Utd,1402,3,16,10,10,52,39,13,58
Falkirk,1402,4,15,9,12,59,47,12,54
Dunfermline,1402,5,12,11,13,50,50,0,47
Raith,1402,6,11,8,17,37,52,-15,41
Queen of S't,1402,7,10,9,17,46,55,-9,39
Dumbarton,1402,8,8,12,16,46,61,-15,36
St Mirren,1402,9,8,11,17,43,59,-16,35
Ayr,1402,10,7,13,16,32,58,-26,34
Hibernian,1403,1,20,11,5,58,25,33,71
Falkirk,1403,2,17,11,8,63,37,26,62
Dundee Utd,1403,3,18,8,10,52,36,16,62
Morton,1403,4,15,9,12,43,39,4,54
Dunfermline,1403,5,13,12,11,46,43,3,51
Queen of S't,1403,6,12,8,16,43,50,-7,44
Raith,1403,7,11,8,17,35,51,-16,41
Dumbarton,1403,8,9,10,17,45,60,-15,37
St Mirren,1403,9,9,9,18,40,59,-19,36
Ayr,1403,10,8,10,18,33,58,-25,34
Hibernian,1404,1,18,14,4,54,25,29,68
Morton,1404,2,16,13,7,51,39,12,61
Falkirk,1404,3,15,11,10,57,43,14,56
Dundee Utd,1404,4,15,10,11,52,40,12,55
Queen of S't,1404,5,13,10,13,49,44,5,49
Dumbarton,1404,6,10,12,14,50,63,-13,42
Raith,1404,7,10,12,14,37,51,-14,42
Dunfermline,1404,8,8,14,14,40,50,-10,38
Ayr,1404,9,7,15,14,37,57,-20,36
St Mirren,1404,10,7,11,18,44,59,-15,32
Hibernian,1405,1,19,12,5,55,26,29,69
Dundee Utd,1405,2,17,10,9,54,39,15,61
Morton,1405,3,15,15,6,49,37,12,60
Falkirk,1405,4,15,9,12,58,48,10,54
Queen of S't,1405,5,12,10,14,47,48,-1,46
Dunfermline,1405,6,10,14,12,52,52,0,44
Ayr,1405,7,10,12,14,39,54,-15,42
Dumbarton,1405,8,8,14,14,46,55,-9,38
Raith,1405,9,9,9,18,33,52,-19,36
St Mirren,1405,10,6,13,17,38,60,-22,31
Hibernian,1406,1,19,11,6,58,29,29,68
Falkirk,1406,2,17,11,8,62,43,19,62
Morton,1406,3,15,13,8,50,37,13,58
Dundee Utd,1406,4,15,11,10,50,43,7,56
Dunfermline,1406,5,12,13,11,50,44,6,49
Queen of S't,1406,6,11,10,15,50,55,-5,43
Raith,1406,7,11,8,17,40,53,-13,41
Ayr,1406,8,9,11,16,33,57,-24,38
Dumbarton,1406,9,7,14,15,45,58,-13,35
St Mirren,1406,10,7,12,17,38,57,-19,33
Hibernian,1407,1,21,12,3,54,22,32,75
Dundee Utd,1407,2,16,10,10,48,38,10,58
Morton,1407,3,15,11,10,45,35,10,56
Falkirk,1407,4,14,13,9,55,40,15,55
Dunfermline,1407,5,12,13,11,48,44,4,49
Dumbarton,1407,6,11,12,13,54,56,-2,45
Queen of S't,1407,7,11,9,16,44,52,-8,42
Raith,1407,8,10,10,16,33,46,-13,40
Ayr,1407,9,6,14,16,30,56,-26,32
St Mirren,1407,10,6,12,18,38,60,-22,30
Hibernian,1408,1,19,13,4,54,25,29,70
Morton,1408,2,17,13,6,54,38,16,64
Dundee Utd,1408,3,18,9,9,56,38,18,63
Falkirk,1408,4,15,12,9,58,41,17,57
Queen of S't,1408,5,11,9,16,42,54,-12,42
St Mirren,1408,6,10,11,15,40,53,-13,41
Raith,1408,7,9,12,15,37,49,-12,39
Dunfermline,1408,8,8,13,15,48,54,-6,37
Dumbarton,1408,9,8,12,16,48,60,-12,36
Ayr,1408,10,7,12,17,35,60,-25,33
Hibernian,1409,1,21,10,5,58,29,29,73
Morton,1409,2,18,10,8,55,36,19,64
Dundee Utd,1409,3,17,8,11,52,43,9,59
Falkirk,1409,4,15,11,10,53,41,12,56
Queen of S't,1409,5,12,10,14,49,48,1,46
Dunfermline,1409,6,10,15,11,49,46,3,45
Raith,1409,7,10,11,15,38,50,-12,41
St Mirren,1409,8,8,12,16,37,55,-18,36
Dumbarton,1409,9,7,12,17,44,60,-16,33
Ayr,1409,10,7,11,18,31,58,-27,32
Morton,1410,1,19,12,5,58,37,21,69
Hibernian,1410,2,19,11,6,53,25,28,68
Falkirk,1410,3,16,9,11,61,44,17,57
Dundee Utd,1410,4,15,11,10,52,39,13,56
Queen of S't,1410,5,13,8,15,48,49,-1,47
St Mirren,1410,6,10,11,15,43,54,-11,41
Dumbarton,1410,7,9,12,15,49,61,-12,39
Raith,1410,8,10,9,17,33,52,-19,39
Dunfermline,1410,9,8,12,16,43,54,-11,36
Ayr,1410,10,7,13,16,32,57,-25,34
Hibernian,1411,1,21,11,4,62,25,37,74
Dundee Utd,1411,2,17,10,9,53,35,18,61
Morton,1411,3,17,9,10,48,36,12,60
Falkirk,1411,4,16,10,10,56,40,16,58
Dunfermline,1411,5,12,12,12,47,45,2,48
Raith,1411,6,11,9,16,39,48,-9,42
Queen of S't,1411,7,11,8,17,42,60,-18,41
St Mirren,1411,8,10,9,17,44,55,-11,39
Ayr,1411,9,9,10,17,34,61,-27,37
Dumbarton,1411,10,7,10,19,44,64,-20,31
Hibernian,1412,1,20,10,6,59,27,32,70
Morton,1412,2,19,10,7,54,33,21,67
Falkirk,1412,3,17,10,9,58,38,20,61
Dundee Utd,1412,4,14,10,12,47,42,5,52
Queen of S't,1412,5,13,9,14,52,51,1,48
Dumbarton,1412,6,11,10,15,49,55,-6,43
Dunfermline,1412,7,9,14,13,41,47,-6,41
Raith,1412,8,9,10,17,31,55,-24,37
St Mirren,1412,9,8,11,17,40,57,-17,35
Ayr,1412,10,7,12,17,31,57,-26,33
Hibernian,1413,1,19,12,5,56,27,29,69
Morton,1413,2,18,11,7,53,38,15,65
Dundee Utd,1413,3,16,12,8,50,35,15,60
Falkirk,1413,4,15,10,11,57,46,11,55
Queen of S't,1413,5,12,10,14,46,50,-4,46
Raith,1413,6,10,10,16,37,49,-12,40
Dunfermline,1413,7,9,12,15,49,55,-6,39
Dumbarton,1413,8,8,15,13,49,58,-9,39
Ayr,1413,9,8,13,15,36,53,-17,37
St Mirren,1413,10,7,11,18,39,61,-22,32
Hibernian,1414,1,17,13,6,53,29,24,64
Morton,1414,2,17,13,6,50,34,16,64
Falkirk,1414,3,17,11,8,60,37,23,62
Dundee Utd,1414,4,17,8,11,53,47,6,59
Raith,1414,5,12,8,16,37,50,-13,44
Queen of S't,1414,6,11,10,15,50,54,-4,43
St Mirren,1414,7,9,13,14,42,51,-9,40
Dumbarton,1414,8,9,11,16,47,56,-9,38
Dunfermline,1414,9,8,13,15,45,54,-9,37
Ayr,1414,10,7,12,17,33,58,-25,33
Hibernian,1415,1,18,12,6,57,29,28,66
Morton,1415,2,17,13,6,53,35,18,64
Falkirk,1415,3,17,10,9,62,46,16,61
Dundee Utd,1415,4,17,9,10,55,41,14,60
Dumbarton,1415,5,10,11,15,52,61,-9,41
Queen of S't,1415,6,11,8,17,46,56,-10,41
Raith,1415,7,11,8,17,37,50,-13,41
Dunfermline,1415,8,9,13,14,43,48,-5,40
Ayr,1415,9,9,12,15,38,55,-17,39
St Mirren,1415,10,8,10,18,39,61,-22,34
Hibernian,1416,1,20,11,5,56,25,31,71
Morton,1416,2,18,11,7,51,34,17,65
Falkirk,1416,3,16,11,9,55,37,18,59
Dundee Utd,1416,4,15,10,11,48,42,6,55
Queen of S't,1416,5,11,10,15,40,49,-9,43
Dunfermline,1416,6,9,14,13,47,49,-2,41
St Mirren,1416,7,10,11,15,38,53,-15,41
Ayr,1416,8,9,13,14,38,52,-14,40
Dumbarton,1416,9,7,13,16,44,58,-14,34
Raith,1416,10,8,10,18,32,50,-18,34
Hibernian,1417,1,21,10,5,57,24,33,73
Morton,1417,2,20,9,7,60,34,26,69
Dundee Utd,1417,3,16,11,9,52,42,10,59
Falkirk,1417,4,15,11,10,57,47,10,56
Queen of S't,1417,5,11,11,14,44,48,-4,44
Dunfermline,1417,6,10,12,14,47,51,-4,42
Ayr,1417,7,9,12,15,33,56,-23,39
Dumbarton,1417,8,9,11,16,49,58,-9,38
Raith,1417,9,9,9,18,34,51,-17,36
St Mirren,1417,10,7,10,19,37,59,-22,31
Hibernian,1418,1,19,12,5,53,25,28,69
Falkirk,1418,2,17,11,8,56,37,19,62
Morton,1418,3,16,13,7,50,33,17,61
Dundee Utd,1418,4,17,9,10,52,38,14,60
Queen of S't,1418,5,13,10,13,46,48,-2,49
Dunfermline,1418,6,10,13,13,44,47,-3,43
Dumbarton,1418,7,7,15,14,46,58,-12,36
Raith,1418,8,9,9,18,31,48,-17,36
St Mirren,1418,9,8,11,17,41,58,-17,35
Ayr,1418,10,6,13,17,32,59,-27,31
Hibernian,1419,1,18,11,7,51,26,25,65
Dundee Utd,1419,2,17,10,9,53,39,14,61
Falkirk,1419,3,16,10,10,53,40,13,58
Morton,1419,4,15,11,10,46,38,8,56
Queen of S't,1419,5,14,9,13,50,47,3,51
Dunfermline,1419,6,11,13,12,49,46,3,46
Raith,1419,7,12,8,16,32,46,-14,44
Dumbarton,1419,8,9,11,16,49,63,-14,38
Ayr,1419,9,8,13,15,36,57,-21,37
St Mirren,1419,10,7,10,19,39,56,-17,31
Hibernian,1420,1,20,12,4,56,24,32,72
Dundee Utd,1420,2,18,8,10,50,38,12,62
Morton,1420,3,16,11,9,46,35,11,59
Falkirk,1420,4,13,13,10,52,42,10,52
Queen of S't,1420,5,12,11,13,45,47,-2,47
Dunfermline,1420,6,10,14,12,45,45,0,44
Raith,1420,7,10,10,16,35,50,-15,40
St Mirren,1420,8,10,9,17,40,54,-14,39
Dumbarton,1420,9,9,11,16,46,55,-9,38
Ayr,1420,10,7,11,18,35,60,-25,32
Hibernian,1421,1,19,13,4,53,22,31,70
Morton,1421,2,19,11,6,50,32,18,68
Falkirk,1421,3,16,12,8,57,39,18,60
Dundee Utd,1421,4,14,11,11,49,43,6,53
Queen of S't,1421,5,12,10,14,47,50,-3,46
Ayr,1421,6,10,12,14,37,52,-15,42
Dumbarton,1421,7,10,11,15,49,56,-7,41
Dunfermline,1421,8,9,12,15,44,48,-4,39
Raith,1421,9,8,9,19,32,57,-25,33
St Mirren,1421,10,7,11,18,39,58,-19,32
Hibernian,1422,1,19,13,4,58,27,31,70
Morton,1422,2,16,11,9,49,39,10,59
Falkirk,1422,3,15,12,9,57,40,17,57
Dundee Utd,1422,4,15,8,13,49,44,5,53
Ayr,1422,5,12,11,13,38,49,-11,47
Dunfermline,1422,6,11,12,13,46,48,-2,45
Queen of S't,1422,7,11,10,15,44,52,-8,43
Dumbarton,1422,8,9,12,15,47,57,-10,39
Raith,1422,9,9,11,16,30,46,-16,38
St Mirren,1422,10,7,12,17,39,55,-16,33
Hibernian,1423,1,21,12,3,66,24,42,75
Falkirk,1423,2,17,9,10,56,41,15,60
Dundee Utd,1423,3,16,11,9,51,36,15,59
Morton,1423,4,13,13,10,48,48,0,52
Dumbarton,1423,5,11,12,13,52,54,-2,45
Queen of S't,1423,6,11,9,16,41,51,-10,42
Raith,1423,7,10,11,15,35,48,-13,41
Dunfermline,1423,8,9,13,14,46,52,-6,40
Ayr,1423,9,8,12,16,34,56,-22,36
St Mirren,1423,10,7,12,17,36,55,-19,33
Morton,1424,1,19,12,5,54,35,19,69
Hibernian,1424,2,17,12,7,50,28,22,63
Dundee Utd,1424,3,17,9,10,46,33,13,60
Falkirk,1424,4,15,11,10,61,43,18,56
Queen of S't,1424,5,12,9,15,46,49,-3,45
Dunfermline,1424,6,9,14,13,47,52,-5,41
St Mirren,1424,7,10,9,17,45,58,-13,39
Raith,1424,8,10,9,17,36,54,-18,39
Ayr,1424,9,9,11,16,33,51,-18,38
Dumbarton,1424,10,8,12,16,44,59,-15,36
Hibernian,1425,1,22,11,3,59,21,38,77
Falkirk,1425,2,17,11,8,64,39,25,62
Morton,1425,3,17,10,9,51,41,10,61
Dundee Utd,1425,4,15,11,10,52,41,11,56
Queen of S't,1425,5,12,8,16,42,52,-10,44
Dunfermline,1425,6,10,12,14,46,49,-3,42
Raith,1425,7,10,8,18,36,53,-17,38
St Mirren,1425,8,8,13,15,42,55,-13,37
Dumbarton,1425,9,7,13,16,47,62,-15,34
Ayr,1425,10,7,13,16,33,59,-26,34
Hibernian,1426,1,20,10,6,60,27,33,70
Morton,1426,2,18,10,8,50,34,16,64
Falkirk,1426,3,16,10,10,59,44,15,58
Dundee Utd,1426,4,16,9,11,52,40,12,57
Dunfermline,1426,5,12,13,11,45,43,2,49
Queen of S't,1426,6,12,9,15,50,56,-6,45
Raith,1426,7,11,9,16,36,48,-12,42
Ayr,1426,8,9,10,17,36,58,-22,37
St Mirren,1426,9,8,11,17,39,59,-20,35
Dumbarton,1426,10,7,11,18,43,61,-18,32
Hibernian,1427,1,20,12,4,59,28,31,72
Dundee Utd,1427,2,18,10,8,56,38,18,64
Morton,1427,3,17,12,7,55,38,17,63
Falkirk,1427,4,15,11,10,59,45,14,56
Queen of S't,1427,5,12,9,15,44,47,-3,45
Dumbarton,1427,6,10,11,15,53,58,-5,41
Raith,1427,7,9,12,15,33,48,-15,39
Dunfermline,1427,8,8,13,15,42,50,-8,37
Ayr,1427,9,7,15,14,33,53,-20,36
St Mirren,1427,10,6,11,19,34,63,-29,29
Hibernian,1428,1,20,11,5,61,26,35,71
Falkirk,1428,2,17,10,9,57,39,18,61
Morton,1428,3,16,12,8,48,36,12,60
Dundee Utd,1428,4,15,11,10,48,40,8,56
Dunfermline,1428,5,11,13,12,45,48,-3,46
Queen of S't,1428,6,10,10,16,42,52,-10,40
Dumbarton,1428,7,9,11,16,48,56,-8,38
Raith,1428,8,9,11,16,35,53,-18,38
Ayr,1428,9,8,14,14,34,52,-18,38
St Mirren,1428,10,8,11,17,39,55,-16,35
Morton,1429,1,18,11,7,53,37,16,65
Hibernian,1429,2,17,13,6,58,32,26,64
Falkirk,1429,3,17,11,8,61,39,22,62
Dundee Utd,1429,4,15,11,10,49,42,7,56
Dunfermline,1429,5,11,12,13,47,48,-1,45
Queen of S't,1429,6,11,10,15,47,58,-11,43
Dumbarton,1429,7,10,10,16,46,57,-11,40
Ayr,1429,8,9,11,16,37,52,-15,38
Raith,1429,9,10,8,18,34,54,-20,38
St Mirren,1429,10,8,11,17,43,56,-13,35
Hibernian,1430,1,20,12,4,58,26,32,72
Morton,1430,2,18,11,7,56,38,18,65
Dundee Utd,1430,3,17,9,10,54,38,16,60
Falkirk,1430,4,16,10,10,58,41,17,58
Queen of S't,1430,5,12,9,15,46,50,-4,45
Dumbarton,1430,6,10,11,15,49,59,-10,41
Dunfermline,1430,7,9,12,15,48,54,-6,39
Raith,1430,8,9,10,17,32,49,-17,37
St Mirren,1430,9,9,10,17,38,56,-18,37
Ayr,1430,10,7,12,17,31,59,-28,33
Hibernian,1431,1,19,12,5,55,25,30,69
Falkirk,1431,2,18,11,7,61,37,24,65
Morton,1431,3,17,12,7,47,31,16,63
Dundee Utd,1431,4,14,9,13,45,42,3,51
Dunfermline,1431,5,10,15,11,46,46,0,45
Queen of S't,1431,6,10,11,15,46,54,-8,41
Dumbarton,1431,7,10,11,15,51,60,-9,41
St Mirren,1431,8,9,10,17,39,57,-18,37
Raith,1431,9,8,11,17,35,51,-16,35
Ayr,1431,10,7,14,15,34,56,-22,35
Morton,1432,1,16,14,6,48,35,13,62
Falkirk,1432,2,17,10,9,64,41,23,61
Hibernian,1432,3,15,15,6,47,25,22,60
Dundee Utd,1432,4,15,10,11,51,43,8,55
Queen of S't,1432,5,12,11,13,46,45,1,47
Dunfermline,1432,6,9,14,13,44,48,-4,41
St Mirren,1432,7,10,10,16,42,55,-13,40
Raith,1432,8,9,12,15,31,44,-13,39
Dumbarton,1432,9,9,11,16,44,61,-17,38
Ayr,1432,10,8,13,15,33,53,-20,37
Hibernian,1433,1,19,13,4,57,27,30,70
Morton,1433,2,19,10,7,53,35,18,67
Dundee Utd,1433,3,18,9,9,53,38,15,63
Falkirk,1433,4,16,11,9,57,39,18,59
Queen of S't,1433,5,11,9,16,47,53,-6,42
Dunfermline,1433,6,9,13,14,46,51,-5,40
Ayr,1433,7,9,12,15,35,53,-18,39
Dumbarton,1433,8,9,10,17,50,64,-14,37
Raith,1433,9,9,10,17,31,48,-17,37
St Mirren,1433,10,7,11,18,39,60,-21,32
Morton,1434,1,18,13,5,56,31,25,67
Hibernian,1434,2,18,12,6,54,25,29,66
Dundee Utd,1434,3,18,9,9,59,35,24,63
Falkirk,1434,4,16,11,9,60,46,14,59
Queen of S't,1434,5,13,8,15,47,54,-7,47
Dumbarton,1434,6,10,11,15,49,61,-12,41
Dunfermline,1434,7,9,13,14,45,51,-6,40
St Mirren,1434,8,9,10,17,37,59,-22,37
Raith,1434,9,8,10,18,35,54,-19,34
Ayr,1434,10,7,11,18,29,55,-26,32
Hibernian,1435,1,20,12,4,58,25,33,72
Falkirk,1435,2,17,10,9,54,37,17,61
Morton,1435,3,14,14,8,51,40,11,56
Dundee Utd,1435,4,12,13,11,45,41,4,49
Queen of S't,1435,5,12,11,13,49,47,2,47
Dunfermline,1435,6,10,15,11,44,44,0,45
St Mirren,1435,7,9,13,14,43,54,-11,40
Raith,1435,8,9,10,17,36,54,-18,37
Ayr,1435,9,8,13,15,35,57,-22,37
Dumbarton,1435,10,8,11,17,44,60,-16,35
Hibernian,1436,1,18,13,5,55,25,30,67
Morton,1436,2,16,12,8,51,40,11,60
Dundee Utd,1436,3,17,8,11,52,39,13,59
Falkirk,1436,4,15,12,9,60,45,15,57
Dunfermline,1436,5,10,13,13,46,46,0,43
Queen of S't,1436,6,11,10,15,42,47,-5,43
Raith,1436,7,11,10,15,35,50,-15,43
Dumbarton,1436,8,9,13,14,48,55,-7,40
St Mirren,1436,9,8,12,16,42,61,-19,36
Ayr,1436,10,8,11,17,31,54,-23,35
Hibernian,1437,1,20,12,4,56,24,32,72
Morton,1437,2,17,13,6,51,33,18,64
Dundee Utd,1437,3,17,11,8,51,38,13,62
Falkirk,1437,4,15,10,11,54,44,10,55
Queen of S't,1437,5,12,9,15,46,52,-6,45
Dumbarton,1437,6,9,12,15,46,56,-10,39
Raith,1437,7,10,9,17,39,52,-13,39
Dunfermline,1437,8,8,14,14,40,47,-7,38
St Mirren,1437,9,8,12,16,43,58,-15,36
Ayr,1437,10,6,14,16,33,55,-22,32
Hibernian,1438,1,20,12,4,57,25,32,72
Morton,1438,2,16,13,7,49,35,14,61
Falkirk,1438,3,15,11,10,57,40,17,56
Dundee Utd,1438,4,14,14,8,51,41,10,56
Queen of S't,1438,5,11,11,14,45,53,-8,44
Raith,1438,6,11,10,15,36,49,-13,43
Dunfermline,1438,7,9,13,14,48,52,-4,40
Dumbarton,1438,8,9,12,15,44,55,-11,39
Ayr,1438,9,8,13,15,34,53,-19,37
St Mirren,1438,10,7,11,18,38,56,-18,32
Hibernian,1439,1,18,15,3,60,25,35,69
Morton,1439,2,18,12,6,55,34,21,66
Falkirk,1439,3,15,12,9,56,43,13,57
Dundee Utd,1439,4,16,9,11,55,44,11,57
Dunfermline,1439,5,12,12,12,51,48,3,48
Raith,1439,6,11,9,16,36,48,-12,42
Queen of S't,1439,7,9,11,16,43,55,-12,38
Dumbarton,1439,8,8,14,14,50,63,-13,38
St Mirren,1439,9,8,10,18,41,61,-20,34
Ayr,1439,10,7,12,17,34,60,-26,33
Morton,1440,1,19,12,5,54,33,21,69
Hibernian,1440,2,17,13,6,54,31,23,64
Falkirk,1440,3,16,10,10,58,42,16,58
Dundee Utd,1440,4,15,11,10,52,40,12,56
Dunfermline,1440,5,10,13,13,44,46,-2,43
Ayr,1440,6,10,13,13,43,54,-11,43
Queen of S't,1440,7,10,10,16,45,58,-13,40
St Mirren,1440,8,9,11,16,50,56,-6,38
Dumbarton,1440,9,9,11,16,42,60,-18,38
Raith,1440,10,8,10,18,32,54,-22,34
Hibernian,1441,1,20,13,3,57,26,31,73
Morton,1441,2,18,11,7,52,37,15,65
Falkirk,1441,3,17,11,8,57,37,20,62
Dundee Utd,1441,4,15,11,10,49,40,9,56
Queen of S't,1441,5,13,9,14,48,50,-2,48
Dunfermline,1441,6,9,13,14,43,46,-3,40
Raith,1441,7,10,9,17,40,53,-13,39
Dumbarton,1441,8,8,11,17,46,60,-14,35
St Mirren,1441,9,8,10,18,38,56,-18,34
Ayr,1441,10,7,12,17,34,59,-25,33
Hibernian,1442,1,20,12,4,58,24,34,72
Morton,1442,2,18,10,8,49,34,15,64
Dundee Utd,1442,3,15,11,10,48,41,7,56
Falkirk,1442,4,15,10,11,57,43,14,55
Dunfermline,1442,5,10,14,12,45,47,-2,44
Queen of S't,1442,6,10,11,15,42,51,-9,41
St Mirren,1442,7,10,10,16,45,56,-11,40
Dumbarton,1442,8,8,14,14,46,55,-9,38
Ayr,1442,9,9,11,16,36,56,-20,38
Raith,1442,10,9,9,18,32,51,-19,36
Hibernian,1443,1,18,14,4,55,27,28,68
Falkirk,1443,2,17,10,9,60,41,19,61
Morton,1443,3,15,15,6,51,35,16,60
Dundee Utd,1443,4,15,11,10,49,42,7,56
Raith,1443,5,12,8,16,39,46,-7,44
Queen of S't,1443,6,11,10,15,42,49,-7,43
Dunfermline,1443,7,8,17,11,42,45,-3,41
Ayr,1443,8,8,13,15,34,56,-22,37
Dumbarton,1443,9,8,12,16,44,60,-16,36
St Mirren,1443,10,8,10,18,41,56,-15,34
Hibernian,1444,1,19,12,5,53,25,28,69
Morton,1444,2,19,12,5,56,31,25,69
Falkirk,1444,3,18,9,9,62,38,24,63
Dundee Utd,1444,4,16,8,12,52,45,7,56
Queen of S't,1444,5,13,8,15,47,46,1,47
Raith,1444,6,11,9,16,34,45,-11,42
Dunfermline,1444,7,8,15,13,44,51,-7,39
Dumbarton,1444,8,8,13,15,46,64,-18,37
Ayr,1444,9,8,11,17,33,60,-27,35
St Mirren,1444,10,7,9,20,35,57,-22,30
Hibernian,1445,1,18,13,5,54,26,28,67
Morton,1445,2,16,12,8,51,38,13,60
Dundee Utd,1445,3,16,11,9,54,37,17,59
Falkirk,1445,4,14,12,10,56,45,11,54
Raith,1445,5,11,12,13,36,45,-9,45
Ayr,1445,6,10,12,14,34,49,-15,42
Dunfermline,1445,7,8,15,13,44,50,-6,39
Queen of S't,1445,8,9,12,15,39,49,-10,39
St Mirren,1445,9,9,11,16,40,54,-14,38
Dumbarton,1445,10,8,12,16,44,59,-15,36
Hibernian,1446,1,18,14,4,56,25,31,68
Morton,1446,2,17,13,6,50,33,17,64
Dundee Utd,1446,3,17,10,9,52,40,12,61
Falkirk,1446,4,16,10,10,58,43,15,58
Queen of S't,1446,5,12,9,15,44,52,-8,45
Dumbarton,1446,6,11,11,14,57,56,1,44
Dunfermline,1446,7,9,11,16,45,53,-8,38
St Mirren,1446,8,9,10,17,41,58,-17,37
Raith,1446,9,9,9,18,35,52,-17,36
Ayr,1446,10,8,11,17,37,63,-26,35
Hibernian,1447,1,18,13,5,56,29,27,67
Morton,1447,2,16,14,6,48,36,12,62
Falkirk,1447,3,17,9,10,59,44,15,60
Dundee Utd,1447,4,14,11,11,45,38,7,53
Dumbarton,1447,5,10,13,13,49,56,-7,43
Queen of S't,1447,6,11,9,16,40,48,-8,42
Ayr,1447,7,10,12,14,36,50,-14,42
Dunfermline,1447,8,9,13,14,44,47,-3,40
Raith,1447,9,9,10,17,37,52,-15,37
St Mirren,1447,10,8,12,16,43,57,-14,36
Hibernian,1448,1,19,13,4,52,26,26,70
Falkirk,1448,2,17,11,8,58,38,20,62
Morton,1448,3,17,11,8,56,39,17,62
Dundee Utd,1448,4,14,9,13,48,48,0,51
Queen of S't,1448,5,13,9,14,52,50,2,48
Dunfermline,1448,6,11,12,13,47,49,-2,45
St Mirren,1448,7,11,10,15,42,50,-8,43
Ayr,1448,8,9,11,16,32,54,-22,38
Dumbarton,1448,9,8,10,18,45,61,-16,34
Raith,1448,10,8,10,18,33,50,-17,34
Hibernian,1449,1,17,13,6,52,30,22,64
Falkirk,1449,2,17,10,9,61,39,22,61
Dundee Utd,1449,3,16,10,10,48,38,10,58
Morton,1449,4,15,11,10,46,39,7,56
Raith,1449,5,12,10,14,39,45,-6,46
Dunfermline,1449,6,10,14,12,48,48,0,44
Queen of S't,1449,7,11,11,14,41,49,-8,44
Ayr,1449,8,9,12,15,33,51,-18,39
Dumbarton,1449,9,8,12,16,48,62,-14,36
St Mirren,1449,10,8,11,17,41,56,-15,35
Hibernian,1450,1,17,14,5,51,27,24,65
Dundee Utd,1450,2,19,8,9,55,42,13,65
Morton,1450,3,16,13,7,54,37,17,61
Falkirk,1450,4,14,10,12,52,43,9,52
Dunfermline,1450,5,11,12,13,49,51,-2,45
Queen of S't,1450,6,11,11,14,43,48,-5,44
Raith,1450,7,11,9,16,38,49,-11,42
St Mirren,1450,8,10,11,15,42,53,-11,41
Ayr,1450,9,8,12,16,35,53,-18,36
Dumbarton,1450,10,7,12,17,46,62,-16,33
Hibernian,1451,1,19,12,5,53,27,26,69
Falkirk,1451,2,17,10,9,62,38,24,61
Dundee Utd,1451,3,17,10,9,55,39,16,61
Morton,1451,4,16,13,7,52,38,14,61
Queen of S't,1451,5,12,9,15,42,48,-6,45
Raith,1451,6,11,11,14,39,47,-8,44
Dunfermline,1451,7,10,12,14,45,50,-5,42
Dumbarton,1451,8,8,11,17,44,60,-16,35
St Mirren,1451,9,8,10,18,38,60,-22,34
Ayr,1451,10,7,12,17,31,54,-23,33
Hibernian,1452,1,17,14,5,55,28,27,65
Morton,1452,2,16,12,8,51,38,13,60
Dundee Utd,1452,3,16,11,9,50,37,13,59
Falkirk,1452,4,16,10,10,57,39,18,58
Dunfermline,1452,5,10,13,13,47,52,-5,43
Ayr,1452,6,10,12,14,46,57,-11,42
Queen of S't,1452,7,10,11,15,48,54,-6,41
Dumbarton,1452,8,10,11,15,47,60,-13,41
Raith,1452,9,10,9,17,33,51,-18,39
St Mirren,1452,10,8,11,17,40,58,-18,35
Morton,1453,1,20,11,5,54,31,23,71
Hibernian,1453,2,18,14,4,56,27,29,68
Falkirk,1453,3,19,9,8,60,36,24,66
Dundee Utd,1453,4,13,11,12,42,40,2,50
Queen of S't,1453,5,13,9,14,47,48,-1,48
Raith,1453,6,10,9,17,35,49,-14,39
Ayr,1453,7,9,12,15,34,52,-18,39
Dunfermline,1453,8,7,15,14,43,52,-9,36
Dumbarton,1453,9,8,12,16,44,60,-16,36
St Mirren,1453,10,7,10,19,35,55,-20,31
Hibernian,1454,1,19,14,3,53,24,29,71
Morton,1454,2,17,11,8,50,36,14,62
Falkirk,1454,3,16,11,9,59,38,21,59
Dundee Utd,1454,4,15,9,12,48,40,8,54
Dunfermline,1454,5,11,12,13,44,45,-1,45
Queen of S't,1454,6,11,9,16,41,50,-9,42
St Mirren,1454,7,10,10,16,38,53,-15,40
Raith,1454,8,10,9,17,37,49,-12,39
Dumbarton,1454,9,9,11,16,44,54,-10,38
Ayr,1454,10,7,14,15,32,57,-25,35
Hibernian,1455,1,16,16,4,48,22,26,64
Falkirk,1455,2,18,10,8,56,36,20,64
Dundee Utd,1455,3,15,10,11,50,42,8,55
Morton,1455,4,14,12,10,44,37,7,54
Raith,1455,5,12,10,14,35,43,-8,46
Queen of S't,1455,6,12,9,15,44,52,-8,45
Dunfermline,1455,7,10,13,13,48,48,0,43
St Mirren,1455,8,10,10,16,43,50,-7,40
Dumbarton,1455,9,10,10,16,46,62,-16,40
Ayr,1455,10,7,12,17,32,54,-22,33
Hibernian,1456,1,19,12,5,56,28,28,69
Morton,1456,2,16,12,8,46,34,12,60
Dundee Utd,1456,3,17,8,11,53,42,11,59
Falkirk,1456,4,16,10,10,57,42,15,58
Dunfermline,1456,5,11,13,12,44,45,-1,46
Raith,1456,6,12,10,14,41,47,-6,46
Dumbarton,1456,7,9,12,15,48,55,-7,39
Queen of S't,1456,8,10,9,17,43,56,-13,39
Ayr,1456,9,8,12,16,32,54,-22,36
St Mirren,1456,10,7,12,17,38,55,-17,33
Hibernian,1457,1,20,12,4,58,25,33,72
Morton,1457,2,18,9,9,53,34,19,63
Falkirk,1457,3,16,10,10,54,38,16,58
Dundee Utd,1457,4,15,9,12,45,41,4,54
Queen of S't,1457,5,12,9,15,45,51,-6,45
Dumbarton,1457,6,11,11,14,50,56,-6,44
Raith,1457,7,11,9,16,34,49,-15,42
Dunfermline,1457,8,9,14,13,41,45,-4,41
Ayr,1457,9,8,11,17,36,54,-18,35
St Mirren,1457,10,8,10,18,39,62,-23,34
Hibernian,1458,1,19,12,5,55,27,28,69
Morton,1458,2,19,10,7,53,38,15,67
Dundee Utd,1458,3,17,9,10,53,40,13,60
Falkirk,1458,4,15,12,9,60,40,20,57
Queen of S't,1458,5,12,9,15,44,53,-9,45
Raith,1458,6,12,8,16,42,52,-10,44
Dunfermline,1458,7,10,13,13,47,46,1,43
Dumbarton,1458,8,8,12,16,49,63,-14,36
Ayr,1458,9,8,12,16,35,55,-20,36
St Mirren,1458,10,6,11,19,40,64,-24,29
Hibernian,1459,1,21,12,3,63,28,35,75
Morton,1459,2,15,14,7,49,39,10,59
Falkirk,1459,3,16,10,10,58,44,14,58
Dundee Utd,1459,4,14,12,10,46,37,9,54
Raith,1459,5,11,10,15,36,49,-13,43
St Mirren,1459,6,11,9,16,44,55,-11,42
Dunfermline,1459,7,9,13,14,51,56,-5,40
Dumbarton,1459,8,9,12,15,51,59,-8,39
Queen of S't,1459,9,10,9,17,45,54,-9,39
Ayr,1459,10,8,11,17,33,55,-22,35
Hibernian,1460,1,19,11,6,53,28,25,68
Dundee Utd,1460,2,18,9,9,57,34,23,63
Morton,1460,3,17,11,8,50,38,12,62
Falkirk,1460,4,15,9,12,54,42,12,54
Queen of S't,1460,5,13,10,13,50,50,0,49
Raith,1460,6,10,10,16,36,47,-11,40
St Mirren,1460,7,10,9,17,45,54,-9,39
Dunfermline,1460,8,9,12,15,42,56,-14,39
Dumbarton,1460,9,9,10,17,46,62,-16,37
Ayr,1460,10,8,13,15,32,54,-22,37
Hibernian,1461,1,22,10,4,58,23,35,76
Morton,1461,2,17,11,8,53,37,16,62
Falkirk,1461,3,15,13,8,57,39,18,58
Dundee Utd,1461,4,16,10,10,57,44,13,58
Queen of S't,1461,5,11,10,15,48,53,-5,43
Dunfermline,1461,6,9,15,12,46,46,0,42
Ayr,1461,7,10,11,15,39,59,-20,41
Raith,1461,8,9,9,18,33,52,-19,36
Dumbarton,1461,9,8,11,17,44,60,-16,35
St Mirren,1461,10,8,10,18,37,59,-22,34
Hibernian,1462,1,21,12,3,56,23,33,75
Morton,1462,2,17,12,7,51,32,19,63
Falkirk,1462,3,16,11,9,62,44,18,59
Dundee Utd,1462,4,15,10,11,49,45,4,55
Queen of S't,1462,5,13,8,15,44,49,-5,47
Dunfermline,1462,6,9,14,13,48,48,0,41
Raith,1462,7,10,8,18,36,59,-23,38
Dumbarton,1462,8,8,13,15,48,58,-10,37
St Mirren,1462,9,9,10,17,39,53,-14,37
Ayr,1462,10,7,12,17,32,54,-22,33
Hibernian,1463,1,19,13,4,55,26,29,70
Morton,1463,2,18,10,8,53,36,17,64
Dundee Utd,1463,3,17,10,9,57,39,18,61
Falkirk,1463,4,17,9,10,55,39,16,60
Queen of S't,1463,5,11,11,14,46,50,-4,44
Raith,1463,6,10,12,14,38,48,-10,42
Dumbarton,1463,7,10,11,15,45,54,-9,41
Dunfermline,1463,8,9,11,16,41,54,-13,38
St Mirren,1463,9,7,12,17,37,56,-19,33
Ayr,1463,10,7,11,18,30,55,-25,32
Hibernian,1464,1,18,13,5,53,24,29,67
Falkirk,1464,2,19,10,7,63,35,28,67
Morton,1464,3,16,13,7,53,41,12,61
Dundee Utd,1464,4,16,9,11,51,45,6,57
Queen of S't,1464,5,11,10,15,43,48,-5,43
Dunfermline,1464,6,10,12,14,45,49,-4,42
Raith,1464,7,11,9,16,36,49,-13,42
Dumbarton,1464,8,9,10,17,48,62,-14,37
Ayr,1464,9,8,11,17,30,55,-25,35
St Mirren,1464,10,7,13,16,45,59,-14,34
Hibernian,1465,1,19,12,5,52,27,25,69
Morton,1465,2,16,13,7,52,35,17,61
Dundee Utd,1465,3,15,12,9,51,41,10,57
Falkirk,1465,4,15,11,10,56,37,19,56
Queen of S't,1465,5,13,10,13,49,48,1,49
Dunfermline,1465,6,10,14,12,49,51,-2,44
Dumbarton,1465,7,9,13,14,48,55,-7,40
Raith,1465,8,10,8,18,32,54,-22,38
Ayr,1465,9,8,12,16,32,55,-23,36
St Mirren,1465,10,7,11,18,39,57,-18,32
Morton,1466,1,20,10,6,53,34,19,70
Hibernian,1466,2,19,11,6,62,27,35,68
Falkirk,1466,3,18,10,8,59,36,23,64
Dundee Utd,1466,4,17,8,11,50,41,9,59
Queen of S't,1466,5,11,9,16,47,63,-16,42
Dumbarton,1466,6,10,11,15,48,55,-7,41
St Mirren,1466,7,9,10,17,39,52,-13,37
Raith,1466,8,9,10,17,32,55,-23,37
Dunfermline,1466,9,8,12,16,46,53,-7,36
Ayr,1466,10,8,11,17,39,59,-20,35
Morton,1467,1,19,10,7,52,36,16,67
Hibernian,1467,2,18,12,6,52,25,27,66
Dundee Utd,1467,3,16,10,10,57,42,15,58
Falkirk,1467,4,15,10,11,58,43,15,55
Dunfermline,1467,5,11,13,12,48,46,2,46
Queen of S't,1467,6,11,10,15,45,52,-7,43
Dumbarton,1467,7,10,11,15,50,63,-13,41
Ayr,1467,8,10,10,16,33,57,-24,40
Raith,1467,9,10,9,17,34,48,-14,39
St Mirren,1467,10,8,9,19,42,59,-17,33
Hibernian,1468,1,19,13,4,53,24,29,70
Morton,1468,2,18,11,7,52,36,16,65
Falkirk,1468,3,18,10,8,62,39,23,64
Dundee Utd,1468,4,16,9,11,52,42,10,57
Queen of S't,1468,5,12,9,15,47,50,-3,45
Raith,1468,6,11,9,16,34,48,-14,42
Dumbarton,1468,7,9,12,15,48,62,-14,39
Dunfermline,1468,8,8,14,14,48,52,-4,38
St Mirren,1468,9,8,11,17,40,54,-14,35
Ayr,1468,10,7,10,19,29,58,-29,31
Hibernian,1469,1,20,12,4,56,24,32,72
Dundee Utd,1469,2,18,9,9,52,39,13,63
Falkirk,1469,3,17,10,9,62,39,23,61
Morton,1469,4,16,11,9,48,37,11,59
Queen of S't,1469,5,13,8,15,46,50,-4,47
Raith,1469,6,11,11,14,37,48,-11,44
Dumbarton,1469,7,10,10,16,56,62,-6,40
Dunfermline,1469,8,9,13,14,42,50,-8,40
Ayr,1469,9,7,11,18,35,60,-25,32
St Mirren,1469,10,7,9,20,38,63,-25,30
Hibernian,1470,1,21,11,4,62,24,38,74
Falkirk,1470,2,17,10,9,57,39,18,61
Morton,1470,3,15,12,9,48,40,8,57
Dundee Utd,1470,4,14,13,9,53,42,11,55
Dunfermline,1470,5,11,12,13,50,50,0,45
Queen of S't,1470,6,11,10,15,45,51,-6,43
Raith,1470,7,11,10,15,36,47,-11,43
Dumbarton,1470,8,8,13,15,46,59,-13,37
Ayr,1470,9,8,13,15,33,55,-22,37
St Mirren,1470,10,6,12,18,42,65,-23,30
Hibernian,1471,1,21,11,4,59,22,37,74
Morton,1471,2,17,11,8,53,42,11,62
Falkirk,1471,3,17,9,10,59,38,21,60
Dundee Utd,1471,4,15,10,11,55,46,9,55
Raith,1471,5,12,9,15,36,43,-7,45
Dumbarton,1471,6,11,10,15,49,60,-11,43
Dunfermline,1471,7,9,15,12,46,48,-2,42
Queen of S't,1471,8,11,9,16,45,54,-9,42
St Mirren,1471,9,8,10,18,42,60,-18,34
Ayr,1471,10,6,12,18,32,63,-31,30
Hibernian,1472,1,18,12,6,55,28,27,66
Falkirk,1472,2,16,11,9,58,40,18,59
Morton,1472,3,16,10,10,54,46,8,58
Dundee Utd,1472,4,15,9,12,48,44,4,54
Dunfermline,1472,5,11,14,11,49,45,4,47
Queen of S't,1472,6,11,12,13,45,47,-2,45
Raith,1472,7,10,10,16,37,51,-14,40
Ayr,1472,8,9,13,14,37,53,-16,40
Dumbarton,1472,9,9,12,15,50,56,-6,39
St Mirren,1472,10,8,11,17,39,62,-23,35
Hibernian,1473,1,20,12,4,55,26,29,72
Falkirk,1473,2,15,11,10,55,39,16,56
Dundee Utd,1473,3,14,13,9,49,40,9,55
Morton,1473,4,14,13,9,50,42,8,55
Queen of S't,1473,5,12,10,14,45,50,-5,46
Dunfermline,1473,6,10,13,13,48,51,-3,43
Raith,1473,7,11,9,16,33,45,-12,42
Ayr,1473,8,9,13,14,36,52,-16,40
Dumbarton,1473,9,9,11,16,47,59,-12,38
St Mirren,1473,10,8,11,17,38,52,-14,35
Hibernian,1474,1,19,12,5,61,26,35,69
Morton,1474,2,16,13,7,53,36,17,61
Falkirk,1474,3,16,10,10,61,47,14,58
Dundee Utd,1474,4,15,11,10,51,39,12,56
Queen of S't,1474,5,12,9,15,46,52,-6,45
Dunfermline,1474,6,10,14,12,46,47,-1,44
Raith,1474,7,11,9,16,41,52,-11,42
Dumbarton,1474,8,9,11,16,46,59,-13,38
St Mirren,1474,9,8,12,16,38,59,-21,36
Ayr,1474,10,8,11,17,33,59,-26,35
Hibernian,1475,1,19,11,6,54,26,28,68
Falkirk,1475,2,16,12,8,61,40,21,60
Morton,1475,3,16,12,8,49,40,9,60
Dundee Utd,1475,4,14,11,11,49,42,7,53
Dumbarton,1475,5,12,11,13,53,55,-2,47
Dunfermline,1475,6,11,13,12,46,46,0,46
Queen of S't,1475,7,11,9,16,47,52,-5,42
Ayr,1475,8,8,14,14,34,53,-19,38
Raith,1475,9,9,9,18,33,53,-20,36
St Mirren,1475,10,8,10,18,40,59,-19,34
Hibernian,1476,1,22,11,3,64,25,39,77
Falkirk,1476,2,16,10,10,61,47,14,58
Morton,1476,3,14,14,8,45,37,8,56
Dundee Utd,1476,4,14,11,11,50,43,7,53
Raith,1476,5,11,10,15,35,49,-14,43
Dunfermline,1476,6,10,12,14,46,47,-1,42
Dumbarton,1476,7,10,12,14,47,55,-8,42
Queen of S't,1476,8,10,10,16,43,56,-13,40
Ayr,1476,9,9,12,15,42,56,-14,39
St Mirren,1476,10,7,12,17,37,55,-18,33
Hibernian,1477,1,22,11,3,60,21,39,77
Falkirk,1477,2,17,11,8,61,43,18,62
Dundee Utd,1477,3,17,9,10,55,40,15,60
Morton,1477,4,13,10,13,40,43,-3,49
Dunfermline,1477,5,12,11,13,52,47,5,47
Dumbarton,1477,6,10,12,14,49,55,-6,42
Queen of S't,1477,7,10,10,16,47,59,-12,40
St Mirren,1477,8,10,9,17,39,54,-15,39
Raith,1477,9,10,9,17,34,50,-16,39
Ayr,1477,10,8,10,18,32,57,-25,34
Hibernian,1478,1,20,11,5,59,27,32,71
Falkirk,1478,2,18,10,8,61,38,23,64
Morton,1478,3,16,11,9,49,41,8,59
Dundee Utd,1478,4,16,8,12,57,44,13,56
Queen of S't,1478,5,12,9,15,45,50,-5,45
Dunfermline,1478,6,10,13,13,49,52,-3,43
Dumbarton,1478,7,10,11,15,50,59,-9,41
Raith,1478,8,11,8,17,36,52,-16,41
Ayr,1478,9,8,11,17,33,55,-22,35
St Mirren,1478,10,8,10,18,40,61,-21,34
Hibernian,1479,1,20,12,4,56,25,31,72
Morton,1479,2,19,10,7,58,38,20,67
Falkirk,1479,3,16,10,10,61,43,18,58
Dundee Utd,1479,4,15,8,13,46,39,7,53
Queen of S't,1479,5,12,11,13,50,52,-2,47
Ayr,1479,6,9,13,14,37,54,-17,40
Raith,1479,7,10,9,17,35,51,-16,39
Dunfermline,1479,8,8,14,14,46,53,-7,38
St Mirren,1479,9,8,12,16,39,57,-18,36
Dumbarton,1479,10,8,11,17,46,62,-16,35
Hibernian,1480,1,18,11,7,50,27,23,65
Dundee Utd,1480,2,19,8,9,57,39,18,65
Morton,1480,3,17,13,6,50,32,18,64
Falkirk,1480,4,16,9,11,57,41,16,57
Dunfermline,1480,5,11,12,13,47,46,1,45
Queen of S't,1480,6,12,8,16,45,54,-9,44
Raith,1480,7,11,8,17,38,54,-16,41
St Mirren,1480,8,10,10,16,43,57,-14,40
Dumbarton,1480,9,9,11,16,50,60,-10,38
Ayr,1480,10,6,12,18,35,62,-27,30
Hibernian,1481,1,20,10,6,58,27,31,70
Morton,1481,2,17,12,7,52,38,14,63
Falkirk,1481,3,16,13,7,57,38,19,61
Dundee Utd,1481,4,15,11,10,47,39,8,56
Queen of S't,1481,5,13,8,15,46,50,-4,47
Dunfermline,1481,6,8,14,14,41,45,-4,38
St Mirren,1481,7,9,11,16,44,56,-12,38
Raith,1481,8,9,11,16,32,50,-18,38
Dumbarton,1481,9,8,12,16,45,57,-12,36
Ayr,1481,10,7,14,15,32,54,-22,35
Hibernian,1482,1,18,11,7,54,30,24,65
Morton,1482,2,16,12,8,52,40,12,60
Falkirk,1482,3,16,10,10,58,41,17,58
Dundee Utd,1482,4,15,12,9,46,38,8,57
Queen of S't,1482,5,11,11,14,41,46,-5,44
Ayr,1482,6,10,12,14,35,49,-14,42
Dumbarton,1482,7,9,14,13,50,55,-5,41
Raith,1482,8,10,10,16,33,50,-17,40
St Mirren,1482,9,9,11,16,45,58,-13,38
Dunfermline,1482,10,8,13,15,45,52,-7,37
Hibernian,1483,1,21,10,5,59,27,32,73
Morton,1483,2,17,11,8,52,35,17,62
Falkirk,1483,3,17,9,10,59,40,19,60
Dundee Utd,1483,4,16,10,10,53,44,9,58
Dunfermline,1483,5,10,13,13,47,51,-4,43
Queen of S't,1483,6,11,9,16,43,46,-3,42
St Mirren,1483,7,10,10,16,40,53,-13,40
Dumbarton,1483,8,8,13,15,43,56,-13,37
Raith,1483,9,9,9,18,33,54,-21,36
Ayr,1483,10,7,14,15,36,59,-23,35
Hibernian,1484,1,20,10,6,60,31,29,70
Morton,1484,2,18,10,8,52,37,15,64
Dundee Utd,1484,3,17,8,11,53,40,13,59
Falkirk,1484,4,13,11,12,55,48,7,50
Queen of S't,1484,5,12,10,14,45,50,-5,46
Dunfermline,1484,6,9,15,12,45,45,0,42
Raith,1484,7,11,9,16,39,51,-12,42
Ayr,1484,8,10,11,15,39,60,-21,41
Dumbarton,1484,9,9,10,17,50,61,-11,37
St Mirren,1484,10,9,10,17,41,56,-15,37
Hibernian,1485,1,21,11,4,56,24,32,74
Morton,1485,2,20,9,7,56,36,20,69
Dundee Utd,1485,3,16,10,10,49,39,10,58
Falkirk,1485,4,14,12,10,54,40,14,54
Queen of S't,1485,5,11,9,16,43,51,-8,42
Dumbarton,1485,6,10,11,15,49,56,-7,41
Ayr,1485,7,9,11,16,35,57,-22,38
Dunfermline,1485,8,7,16,13,45,51,-6,37
Raith,1485,9,9,10,17,33,50,-17,37
St Mirren,1485,10,8,11,17,41,57,-16,35
Morton,1486,1,18,11,7,51,33,18,65
Hibernian,1486,2,17,13,6,55,31,24,64
Falkirk,1486,3,18,9,9,58,40,18,63
Dundee Utd,1486,4,14,10,12,49,44,5,52
Queen of S't,1486,5,13,10,13,46,45,1,49
Ayr,1486,6,10,13,13,38,51,-13,43
St Mirren,1486,7,10,10,16,41,53,-12,40
Dunfermline,1486,8,8,13,15,44,54,-10,37
Dumbarton,1486,9,9,10,17,46,59,-13,37
Raith,1486,10,9,9,18,35,53,-18,36
Hibernian,1487,1,21,12,3,62,24,38,75
Morton,1487,2,18,12,6,52,33,19,66
Dundee Utd,1487,3,17,9,10,54,39,15,60
Falkirk,1487,4,15,11,10,57,45,12,56
Queen of S't,1487,5,11,10,15,42,47,-5,43
Dunfermline,1487,6,9,13,14,47,53,-6,40
Ayr,1487,7,9,11,16,31,53,-22,38
Dumbarton,1487,8,8,13,15,46,57,-11,37
Raith,1487,9,9,10,17,34,50,-16,37
St Mirren,1487,10,7,11,18,37,61,-24,32
Hibernian,1488,1,19,12,5,59,27,32,69
Morton,1488,2,16,10,10,50,37,13,58
Falkirk,1488,3,15,11,10,59,48,11,56
Dundee Utd,1488,4,14,13,9,47,39,8,55
Dunfermline,1488,5,12,13,11,50,46,4,49
Queen of S't,1488,6,10,12,14,49,55,-6,42
Dumbarton,1488,7,9,14,13,48,54,-6,41
Raith,1488,8,9,13,14,37,48,-11,40
Ayr,1488,9,9,13,14,35,54,-19,40
St Mirren,1488,10,6,11,19,37,63,-26,29
Hibernian,1489,1,22,10,4,59,20,39,76
Dundee Utd,1489,2,20,8,8,54,39,15,68
Falkirk,1489,3,15,9,12,56,41,15,54
Morton,1489,4,13,11,12,43,43,0,50
Dumbarton,1489,5,11,11,14,55,60,-5,44
Queen of S't,1489,6,11,10,15,45,52,-7,43
Raith,1489,7,11,9,16,37,52,-15,42
Dunfermline,1489,8,9,13,14,44,49,-5,40
St Mirren,1489,9,9,9,18,43,60,-17,36
Ayr,1489,10,7,14,15,31,51,-20,35
Hibernian,1490,1,18,12,6,55,27,28,66
Morton,1490,2,17,12,7,50,35,15,63
Falkirk,1490,3,15,11,10,56,47,9,56
Dundee Utd,1490,4,15,10,11,47,39,8,55
Queen of S't,1490,5,13,9,14,47,49,-2,48
Dunfermline,1490,6,10,13,13,44,46,-2,43
Dumbarton,1490,7,10,12,14,51,57,-6,42
St Mirren,1490,8,10,10,16,43,53,-10,40
Raith,1490,9,10,8,18,35,53,-18,38
Ayr,1490,10,8,11,17,35,57,-22,35
Hibernian,1491,1,18,14,4,53,25,28,68
Morton,1491,2,16,12,8,56,41,15,60
Falkirk,1491,3,15,11,10,58,44,14,56
Dundee Utd,1491,4,15,9,12,51,41,10,54
Ayr,1491,5,12,10,14,37,51,-14,46
Queen of S't,1491,6,12,9,15,49,53,-4,45
St Mirren,1491,7,11,10,15,42,53,-11,43
Dunfermline,1491,8,9,13,14,43,49,-6,40
Raith,1491,9,9,10,17,31,48,-17,37
Dumbarton,1491,10,8,12,16,50,65,-15,36
Hibernian,1492,1,19,12,5,57,26,31,69
Morton,1492,2,17,14,5,55,32,23,65
Falkirk,1492,3,17,10,9,56,43,13,61
Dundee Utd,1492,4,13,12,11,47,43,4,51
Dunfermline,1492,5,11,12,13,51,53,-2,45
Queen of S't,1492,6,12,8,16,44,49,-5,44
Ayr,1492,7,9,14,13,45,56,-11,41
Dumbarton,1492,8,8,12,16,48,63,-15,36
Raith,1492,9,8,12,16,32,51,-19,36
St Mirren,1492,10,7,12,17,41,60,-19,33
Hibernian,1493,1,17,14,5,50,28,22,65
Falkirk,1493,2,16,11,9,59,37,22,59
Morton,1493,3,15,12,9,49,38,11,57
Dundee Utd,1493,4,14,11,11,46,39,7,53
Dunfermline,1493,5,13,13,10,50,43,7,52
Raith,1493,6,12,10,14,34,43,-9,46
Queen of S't,1493,7,10,11,15,43,50,-7,41
Ayr,1493,8,8,14,14,36,51,-15,38
Dumbarton,1493,9,8,11,17,45,64,-19,35
St Mirren,1493,10,8,11,17,35,54,-19,35
Hibernian,1494,1,20,12,4,55,22,33,72
Dundee Utd,1494,2,18,10,8,49,34,15,64
Falkirk,1494,3,16,11,9,57,42,15,59
Morton,1494,4,15,12,9,46,36,10,57
Dumbarton,1494,5,10,13,13,47,55,-8,43
Raith,1494,6,11,9,16,35,45,-10,42
Dunfermline,1494,7,9,14,13,44,46,-2,41
Queen of S't,1494,8,9,9,18,39,53,-14,36
Ayr,1494,9,7,14,15,33,55,-22,35
St Mirren,1494,10,7,12,17,39,56,-17,33
Hibernian,1495,1,18,13,5,54,27,27,67
Falkirk,1495,2,17,10,9,59,39,20,61
Morton,1495,3,16,13,7,51,37,14,61
Dundee Utd,1495,4,13,13,10,48,42,6,52
Dumbarton,1495,5,11,13,12,53,53,0,46
Queen of S't,1495,6,11,9,16,41,53,-12,42
Dunfermline,1495,7,9,13,14,43,49,-6,40
Raith,1495,8,10,9,17,37,53,-16,39
St Mirren,1495,9,9,10,17,47,62,-15,37
Ayr,1495,10,8,13,15,37,55,-18,37
Hibernian,1496,1,22,11,3,61,23,38,77
Morton,1496,2,17,11,8,55,38,17,62
Falkirk,1496,3,17,10,9,57,40,17,61
Dundee Utd,1496,4,13,11,12,46,42,4,50
Dunfermline,1496,5,9,14,13,48,49,-1,41
Ayr,1496,6,10,11,15,31,53,-22,41
Queen of S't,1496,7,10,10,16,41,50,-9,40
Raith,1496,8,10,10,16,37,53,-16,40
St Mirren,1496,9,9,12,15,40,49,-9,39
Dumbarton,1496,10,8,10,18,45,64,-19,34
Hibernian,1497,1,20,13,3,57,25,32,73
Falkirk,1497,2,17,9,10,63,41,22,60
Morton,1497,3,16,12,8,51,37,14,60
Dundee Utd,1497,4,13,8,15,42,45,-3,47
Queen of S't,1497,5,12,9,15,49,52,-3,45
Dunfermline,1497,6,10,14,12,46,46,0,44
Dumbarton,1497,7,9,12,15,47,59,-12,39
St Mirren,1497,8,9,12,15,42,55,-13,39
Raith,1497,9,9,12,15,32,45,-13,39
Ayr,1497,10,9,11,16,33,57,-24,38
Hibernian,1498,1,20,12,4,57,24,33,72
Morton,1498,2,18,10,8,55,35,20,64
Falkirk,1498,3,17,9,10,58,40,18,60
Dundee Utd,1498,4,16,8,12,51,41,10,56
Ayr,1498,5,10,12,14,34,54,-20,42
Queen of S't,1498,6,10,11,15,43,49,-6,41
Dunfermline,1498,7,8,14,14,40,49,-9,38
Raith,1498,8,9,11,16,34,49,-15,38
St Mirren,1498,9,9,11,16,40,56,-16,38
Dumbarton,1498,10,8,12,16,41,56,-15,36
Hibernian,1499,1,19,13,4,58,26,32,70
Morton,1499,2,18,11,7,55,41,14,65
Falkirk,1499,3,16,12,8,58,39,19,60
Dundee Utd,1499,4,17,9,10,49,38,11,60
Queen of S't,1499,5,12,9,15,46,54,-8,45
Raith,1499,6,11,11,14,36,45,-9,44
Dumbarton,1499,7,9,11,16,46,59,-13,38
Dunfermline,1499,8,8,13,15,49,55,-6,37
Ayr,1499,9,7,12,17,34,55,-21,33
St Mirren,1499,10,7,11,18,36,55,-19,32
Hibernian,1500,1,18,13,5,57,30,27,67
Falkirk,1500,2,15,11,10,55,43,12,56
Morton,1500,3,14,13,9,49,41,8,55
Dundee Utd,1500,4,15,10,11,46,40,6,55
Queen of S't,1500,5,13,11,12,53,47,6,50
Raith,1500,6,11,11,14,39,49,-10,44
Dumbarton,1500,7,10,11,15,46,56,-10,41
Dunfermline,1500,8,9,13,14,47,51,-4,40
Ayr,1500,9,9,13,14,40,56,-16,40
St Mirren,1500,10,8,10,18,38,57,-19,34
Hibernian,1501,1,18,13,5,54,25,29,67
Falkirk,1501,2,18,10,8,61,38,23,64
Dundee Utd,1501,3,16,10,10,49,39,10,58
Morton,1501,4,15,12,9,43,34,9,57
Queen of S't,1501,5,12,9,15,44,51,-7,45
Raith,1501,6,12,8,16,36,46,-10,44
Dunfermline,1501,7,10,13,13,48,53,-5,43
Dumbarton,1501,8,9,13,14,47,57,-10,40
St Mirren,1501,9,8,11,17,41,55,-14,35
Ayr,1501,10,7,11,18,34,59,-25,32
Hibernian,1502,1,18,12,6,56,30,26,66
Morton,1502,2,18,10,8,50,34,16,64
Dundee Utd,1502,3,17,9,10,53,42,11,60
Falkirk,1502,4,16,11,9,63,42,21,59
Dunfermline,1502,5,12,12,12,49,44,5,48
Queen of S't,1502,6,12,8,16,48,54,-6,44
Ayr,1502,7,10,11,15,34,55,-21,41
Dumbarton,1502,8,10,10,16,48,57,-9,40
Raith,1502,9,9,9,18,35,55,-20,36
St Mirren,1502,10,7,10,19,37,60,-23,31
Hibernian,1503,1,20,10,6,57,27,30,70
Morton,1503,2,18,12,6,51,36,15,66
Falkirk,1503,3,16,11,9,63,42,21,59
Dundee Utd,1503,4,15,12,9,57,50,7,57
Queen of S't,1503,5,12,10,14,51,51,0,46
Raith,1503,6,12,8,16,40,50,-10,44
Dumbarton,1503,7,11,10,15,53,66,-13,43
Dunfermline,1503,8,8,15,13,47,51,-4,39
St Mirren,1503,9,7,10,19,41,62,-21,31
Ayr,1503,10,6,12,18,32,57,-25,30
Hibernian,1504,1,19,11,6,57,30,27,68
Morton,1504,2,19,10,7,51,31,20,67
Falkirk,1504,3,17,10,9,57,35,22,61
Dundee Utd,1504,4,16,10,10,50,40,10,58
Dunfermline,1504,5,11,11,14,44,46,-2,44
Raith,1504,6,11,9,16,36,47,-11,42
Queen of S't,1504,7,10,10,16,42,53,-11,40
Dumbarton,1504,8,9,10,17,47,61,-14,37
St Mirren,1504,9,9,9,18,40,60,-20,36
Ayr,1504,10,8,12,16,36,57,-21,36
Hibernian,1505,1,19,13,4,58,23,35,70
Falkirk,1505,2,17,9,10,66,41,25,60
Dundee Utd,1505,3,16,11,9,60,44,16,59
Morton,1505,4,15,11,10,45,42,3,56
Queen of S't,1505,5,13,10,13,44,45,-1,49
Dunfermline,1505,6,11,12,13,47,51,-4,45
Raith,1505,7,12,8,16,37,51,-14,44
St Mirren,1505,8,9,11,16,40,55,-15,38
Dumbarton,1505,9,7,13,16,42,60,-18,34
Ayr,1505,10,6,12,18,33,60,-27,30
Hibernian,1506,1,19,11,6,58,27,31,68
Falkirk,1506,2,17,11,8,61,41,20,62
Morton,1506,3,17,10,9,53,35,18,61
Dundee Utd,1506,4,15,9,12,49,39,10,54
Queen of S't,1506,5,11,11,14,42,48,-6,44
Dunfermline,1506,6,10,12,14,45,50,-5,42
Dumbarton,1506,7,10,12,14,52,59,-7,42
Raith,1506,8,11,8,17,37,49,-12,41
Ayr,1506,9,9,12,15,35,58,-23,39
St Mirren,1506,10,8,10,18,38,64,-26,34
Hibernian,1507,1,19,12,5,54,23,31,69
Morton,1507,2,17,11,8,54,38,16,62
Falkirk,1507,3,17,10,9,60,40,20,61
Dundee Utd,1507,4,16,10,10,50,42,8,58
Queen of S't,1507,5,12,9,15,42,49,-7,45
Dumbarton,1507,6,10,13,13,50,55,-5,43
Dunfermline,1507,7,9,14,13,42,47,-5,41
Ayr,1507,8,8,12,16,29,50,-21,36
St Mirren,1507,9,8,11,17,40,57,-17,35
Raith,1507,10,8,10,18,32,52,-20,34
Morton,1508,1,18,11,7,55,36,19,65
Hibernian,1508,2,17,13,6,54,28,26,64
Falkirk,1508,3,17,11,8,59,41,18,62
Dundee Utd,1508,4,13,8,15,43,46,-3,47
Dunfermline,1508,5,11,13,12,51,46,5,46
Queen of S't,1508,6,11,11,14,44,50,-6,44
Ayr,1508,7,11,10,15,37,56,-19,43
Raith,1508,8,10,11,15,37,48,-11,41
Dumbarton,1508,9,9,12,15,44,54,-10,39
St Mirren,1508,10,7,12,17,36,55,-19,33
Morton,1509,1,18,11,7,54,35,19,65
Hibernian,1509,2,17,13,6,55,29,26,64
Dundee Utd,1509,3,17,10,9,55,38,17,61
Falkirk,1509,4,15,10,11,61,47,14,55
Ayr,1509,5,11,11,14,40,56,-16,44
Queen of S't,1509,6,11,9,16,46,57,-11,42
Dunfermline,1509,7,9,13,14,42,49,-7,40
Raith,1509,8,10,10,16,33,51,-18,40
Dumbarton,1509,9,9,11,16,49,63,-14,38
St Mirren,1509,10,8,12,16,43,53,-10,36
Hibernian,1510,1,18,13,5,51,26,25,67
Dundee Utd,1510,2,17,10,9,55,38,17,61
Morton,1510,3,16,10,10,49,38,11,58
Falkirk,1510,4,14,11,11,58,44,14,53
Queen of S't,1510,5,13,11,12,44,45,-1,50
Dumbarton,1510,6,10,12,14,50,54,-4,42
Dunfermline,1510,7,10,12,14,46,50,-4,42
Raith,1510,8,10,11,15,31,43,-12,41
St Mirren,1510,9,9,10,17,42,58,-16,37
Ayr,1510,10,8,10,18,29,59,-30,34
Hibernian,1511,1,19,13,4,56,27,29,70
Dundee Utd,1511,2,16,11,9,60,44,16,59
Falkirk,1511,3,16,11,9,58,42,16,59
Morton,1511,4,16,11,9,48,36,12,59
Queen of S't,1511,5,12,9,15,44,54,-10,45
Dumbarton,1511,6,10,14,12,53,56,-3,44
Dunfermline,1511,7,9,14,13,49,51,-2,41
Raith,1511,8,10,10,16,37,50,-13,40
Ayr,1511,9,8,11,17,36,59,-23,35
St Mirren,1511,10,7,10,19,38,60,-22,31
Hibernian,1512,1,19,12,5,58,26,32,69
Morton,1512,2,18,12,6,53,36,17,66
Falkirk,1512,3,17,9,10,57,41,16,60
Dundee Utd,1512,4,16,10,10,51,38,13,58
Dunfermline,1512,5,10,13,13,50,52,-2,43
Queen of S't,1512,6,10,10,16,42,52,-10,40
Raith,1512,7,10,10,16,36,51,-15,40
Ayr,1512,8,9,11,16,32,54,-22,38
Dumbarton,1512,9,9,10,17,49,63,-14,37
St Mirren,1512,10,8,11,17,43,58,-15,35
Hibernian,1513,1,21,11,4,63,27,36,74
Morton,1513,2,18,13,5,57,35,22,67
Falkirk,1513,3,18,9,9,63,41,22,63
Dundee Utd,1513,4,17,9,10,49,36,13,60
Queen of S't,1513,5,11,10,15,50,58,-8,43
Dunfermline,1513,6,8,14,14,46,50,-4,38
Raith,1513,7,9,9,18,35,53,-18,36
St Mirren,1513,8,9,9,18,37,61,-24,36
Dumbarton,1513,9,8,11,17,50,65,-15,35
Ayr,1513,10,8,11,17,36,60,-24,35
Hibernian,1514,1,18,12,6,54,28,26,66
Morton,1514,2,17,11,8,56,40,16,62
Falkirk,1514,3,16,11,9,53,37,16,59
Dundee Utd,1514,4,16,9,11,48,41,7,57
Dunfermline,1514,5,12,14,10,50,45,5,50
Queen of S't,1514,6,13,9,14,48,49,-1,48
Ayr,1514,7,10,11,15,35,51,-16,41
Raith,1514,8,9,10,17,35,51,-16,37
Dumbarton,1514,9,7,12,17,42,59,-17,33
St Mirren,1514,10,8,9,19,40,60,-20,33
Hibernian,1515,1,21,12,3,58,21,37,75
Morton,1515,2,17,13,6,49,35,14,64
Falkirk,1515,3,14,11,11,51,41,10,53
Dundee Utd,1515,4,14,9,13,50,42,8,51
Queen of S't,1515,5,13,9,14,48,48,0,48
Dunfermline,1515,6,11,13,12,49,50,-1,46
Raith,1515,7,11,9,16,37,48,-11,42
St Mirren,1515,8,10,9,17,43,55,-12,39
Dumbarton,1515,9,8,11,17,45,68,-23,35
Ayr,1515,10,7,12,17,29,51,-22,33
Hibernian,1516,1,20,11,5,56,25,31,71
Dundee Utd,1516,2,15,12,9,50,37,13,57
Morton,1516,3,16,9,11,48,41,7,57
Falkirk,1516,4,15,11,10,56,41,15,56
Dunfermline,1516,5,11,14,11,51,50,1,47
Raith,1516,6,12,10,14,40,47,-7,46
Dumbarton,1516,7,9,14,13,51,59,-8,41
Queen of S't,1516,8,10,10,16,41,50,-9,40
Ayr,1516,9,8,12,16,34,56,-22,36
St Mirren,1516,10,7,11,18,38,59,-21,32
Hibernian,1517,1,20,10,6,57,27,30,70
Morton,1517,2,17,13,6,50,32,18,64
Falkirk,1517,3,15,11,10,57,41,16,56
Dundee Utd,1517,4,15,11,10,50,46,4,56
Queen of S't,1517,5,12,9,15,45,51,-6,45
Raith,1517,6,11,11,14,38,47,-9,44
Dunfermline,1517,7,9,14,13,46,49,-3,41
St Mirren,1517,8,9,12,15,42,51,-9,39
Dumbarton,1517,9,7,14,15,45,59,-14,35
Ayr,1517,10,6,13,17,28,55,-27,31
Hibernian,1518,1,18,13,5,56,28,28,67
Falkirk,1518,2,16,12,8,62,40,22,60
Morton,1518,3,16,12,8,51,38,13,60
Dundee Utd,1518,4,15,10,11,50,43,7,55
Dunfermline,1518,5,11,13,12,51,48,3,46
Raith,1518,6,12,10,14,36,44,-8,46
Ayr,1518,7,9,12,15,38,54,-16,39
Dumbarton,1518,8,9,11,16,47,59,-12,38
Queen of S't,1518,9,9,11,16,42,55,-13,38
St Mirren,1518,10,7,12,17,35,59,-24,33
Hibernian,1519,1,19,13,4,55,23,32,70
Falkirk,1519,2,16,10,10,60,45,15,58
Dundee Utd,1519,3,16,10,10,58,45,13,58
Morton,1519,4,16,10,10,46,37,9,58
Queen of S't,1519,5,12,10,14,47,52,-5,46
Raith,1519,6,10,11,15,35,47,-12,41
St Mirren,1519,7,9,13,14,47,56,-9,40
Dumbarton,1519,8,10,10,16,51,61,-10,40
Dunfermline,1519,9,8,13,15,40,51,-11,37
Ayr,1519,10,7,14,15,34,56,-22,35
Hibernian,1520,1,22,10,4,62,23,39,76
Morton,1520,2,18,11,7,49,34,15,65
Falkirk,1520,3,17,10,9,57,40,17,61
Dundee Utd,1520,4,17,10,9,56,39,17,61
Queen of S't,1520,5,12,8,16,42,49,-7,44
Dunfermline,1520,6,10,11,15,43,46,-3,41
Dumbarton,1520,7,9,11,16,46,60,-14,38
Raith,1520,8,9,10,17,29,45,-16,37
St Mirren,1520,9,7,11,18,37,60,-23,32
Ayr,1520,10,6,14,16,30,55,-25,32
Morton,1521,1,18,10,8,52,40,12,64
Hibernian,1521,2,17,12,7,51,30,21,63
Dundee Utd,1521,3,17,9,10,52,39,13,60
Falkirk,1521,4,16,11,9,55,39,16,59
Queen of S't,1521,5,13,9,14,49,52,-3,48
Dunfermline,1521,6,9,13,14,51,55,-4,40
Raith,1521,7,10,9,17,35,52,-17,39
Ayr,1521,8,9,12,15,34,53,-19,39
St Mirren,1521,9,9,10,17,45,52,-7,37
Dumbarton,1521,10,8,13,15,45,57,-12,37
Hibernian,1522,1,21,11,4,58,23,35,74
Falkirk,1522,2,18,9,9,61,38,23,63
Morton,1522,3,16,11,9,50,42,8,59
Dundee Utd,1522,4,16,10,10,54,40,14,58
Queen of S't,1522,5,12,10,14,51,51,0,46
Dunfermline,1522,6,9,12,15,52,51,1,39
Raith,1522,7,10,9,17,34,50,-16,39
St Mirren,1522,8,9,11,16,43,58,-15,38
Dumbarton,1522,9,8,12,16,42,63,-21,36
Ayr,1522,10,8,11,17,30,59,-29,35
Hibernian,1523,1,19,13,4,55,28,27,70
Morton,1523,2,17,10,9,51,37,14,61
Dundee Utd,1523,3,16,10,10,49,37,12,58
Falkirk,1523,4,14,11,11,54,46,8,53
Dunfermline,1523,5,10,14,12,45,47,-2,44
Raith,1523,6,11,9,16,38,51,-13,42
Ayr,1523,7,10,11,15,35,53,-18,41
Dumbarton,1523,8,9,13,14,49,54,-5,40
St Mirren,1523,9,9,11,16,44,54,-10,38
Queen of S't,1523,10,9,10,17,42,55,-13,37
Hibernian,1524,1,18,13,5,54,27,27,67
Falkirk,1524,2,18,9,9,59,36,23,63
Dundee Utd,1524,3,17,10,9,47,36,11,61
Morton,1524,4,14,13,9,44,35,9,55
Dunfermline,1524,5,10,13,13,47,49,-2,43
St Mirren,1524,6,9,13,14,42,53,-11,40
Queen of S't,1524,7,10,9,17,46,57,-11,39
Raith,1524,8,9,12,15,35,49,-14,39
Dumbarton,1524,9,9,11,16,45,58,-13,38
Ayr,1524,10,9,11,16,33,52,-19,38
Hibernian,1525,1,21,10,5,58,24,34,73
Morton,1525,2,17,11,8,51,38,13,62
Falkirk,1525,3,16,9,11,55,39,16,57
Dundee Utd,1525,4,15,10,11,46,38,8,55
Raith,1525,5,13,9,14,36,41,-5,48
Dumbarton,1525,6,11,13,12,52,54,-2,46
Dunfermline,1525,7,9,13,14,45,54,-9,40
Queen of S't,1525,8,9,10,17,42,56,-14,37
Ayr,1525,9,8,12,16,35,57,-22,36
St Mirren,1525,10,8,9,19,39,58,-19,33
Hibernian,1526,1,19,14,3,51,22,29,71
Morton,1526,2,17,12,7,52,36,16,63
Falkirk,1526,3,17,9,10,58,39,19,60
Dundee Utd,1526,4,14,8,14,48,47,1,50
Queen of S't,1526,5,11,10,15,44,52,-8,43
Dunfermline,1526,6,10,11,15,45,50,-5,41
Dumbarton,1526,7,9,13,14,53,61,-8,40
Raith,1526,8,10,10,16,33,46,-13,40
Ayr,1526,9,9,13,14,39,54,-15,40
St Mirren,1526,10,9,10,17,40,56,-16,37
Hibernian,1527,1,19,12,5,55,30,25,69
Falkirk,1527,2,16,10,10,57,44,13,58
Dundee Utd,1527,3,15,12,9,50,38,12,57
Morton,1527,4,15,12,9,47,39,8,57
Queen of S't,1527,5,13,9,14,49,48,1,48
Raith,1527,6,11,10,15,34,46,-12,43
Dunfermline,1527,7,9,15,12,50,50,0,42
Dumbarton,1527,8,10,11,15,53,55,-2,41
St Mirren,1527,9,8,12,16,38,52,-14,36
Ayr,1527,10,6,13,17,33,64,-31,31
Hibernian,1528,1,17,14,5,51,26,25,65
Morton,1528,2,17,11,8,51,33,18,62
Falkirk,1528,3,16,12,8,62,40,22,60
Dundee Utd,1528,4,14,11,11,48,45,3,53
Queen of S't,1528,5,12,12,12,47,48,-1,48
Dunfermline,1528,6,10,15,11,49,48,1,45
Ayr,1528,7,9,13,14,36,54,-18,40
Raith,1528,8,8,13,15,31,49,-18,37
St Mirren,1528,9,8,11,17,41,60,-19,35
Dumbarton,1528,10,8,10,18,52,65,-13,34
Hibernian,1529,1,19,11,6,56,28,28,68
Dundee Utd,1529,2,18,9,9,55,43,12,63
Morton,1529,3,16,12,8,53,44,9,60
Falkirk,1529,4,15,10,11,60,45,15,55
Queen of S't,1529,5,14,8,14,49,51,-2,50
Dunfermline,1529,6,11,11,14,54,54,0,44
Raith,1529,7,11,10,15,38,50,-12,43
Dumbarton,1529,8,10,10,16,47,56,-9,40
St Mirren,1529,9,9,9,18,40,55,-15,36
Ayr,1529,10,6,12,18,31,57,-26,30
Morton,1530,1,18,13,5,58,32,26,67
Hibernian,1530,2,17,13,6,53,28,25,64
Falkirk,1530,3,16,9,11,57,43,14,57
Dundee Utd,1530,4,14,11,11,44,39,5,53
Queen of S't,1530,5,12,9,15,44,50,-6,45
Raith,1530,6,11,10,15,33,47,-14,43
Dunfermline,1530,7,10,12,14,47,48,-1,42
St Mirren,1530,8,10,11,15,43,58,-15,41
Dumbarton,1530,9,9,11,16,49,61,-12,38
Ayr,1530,10,7,13,16,34,56,-22,34
Hibernian,1531,1,21,11,4,64,26,38,74
Morton,1531,2,16,10,10,47,36,11,58
Dundee Utd,1531,3,16,9,11,49,40,9,57
Falkirk,1531,4,15,10,11,57,44,13,55
Queen of S't,1531,5,12,10,14,50,51,-1,46
Raith,1531,6,12,8,16,37,52,-15,44
Dunfermline,1531,7,9,13,14,51,55,-4,40
Dumbarton,1531,8,9,12,15,47,60,-13,39
Ayr,1531,9,9,11,16,33,56,-23,38
St Mirren,1531,10,9,10,17,41,56,-15,37
Hibernian,1532,1,22,10,4,58,22,36,76
Morton,1532,2,18,10,8,50,35,15,64
Dundee Utd,1532,3,15,10,11,54,43,11,55
Falkirk,1532,4,14,11,11,57,45,12,53
Queen of S't,1532,5,14,9,13,51,52,-1,51
Dunfermline,1532,6,11,11,14,44,48,-4,44
Raith,1532,7,10,9,17,38,51,-13,39
St Mirren,1532,8,9,11,16,41,55,-14,38
Dumbarton,1532,9,8,11,17,44,59,-15,35
Ayr,1532,10,8,10,18,33,60,-27,34
Hibernian,1533,1,20,13,3,60,27,33,73
Dundee Utd,1533,2,18,10,8,56,38,18,64
Morton,1533,3,18,10,8,56,41,15,64
Falkirk,1533,4,17,10,9,59,37,22,61
Queen of S't,1533,5,10,10,16,43,55,-12,40
Raith,1533,6,10,9,17,38,57,-19,39
Dumbarton,1533,7,8,14,14,43,53,-10,38
Dunfermline,1533,8,7,15,14,42,49,-7,36
St Mirren,1533,9,8,10,18,38,56,-18,34
Ayr,1533,10,7,13,16,35,57,-22,34
Hibernian,1534,1,18,15,3,53,23,30,69
Dundee Utd,1534,2,17,11,8,53,34,19,62
Morton,1534,3,16,13,7,49,32,17,61
Falkirk,1534,4,17,9,10,60,40,20,60
Queen of S't,1534,5,10,12,14,44,52,-8,42
St Mirren,1534,6,10,10,16,42,53,-11,40
Dunfermline,1534,7,9,12,15,46,54,-8,39
Dumbarton,1534,8,9,11,16,48,59,-11,38
Ayr,1534,9,8,12,16,36,65,-29,36
Raith,1534,10,8,11,17,33,52,-19,35
Morton,1535,1,19,11,6,57,31,26,68
Hibernian,1535,2,19,11,6,52,27,25,68
Dundee Utd,1535,3,17,9,10,51,41,10,60
Falkirk,1535,4,16,10,10,58,42,16,58
Raith,1535,5,13,9,14,40,44,-4,48
Queen of S't,1535,6,12,9,15,49,53,-4,45
Dumbarton,1535,7,10,11,15,53,62,-9,41
Dunfermline,1535,8,8,11,17,40,58,-18,35
Ayr,1535,9,8,11,17,33,55,-22,35
St Mirren,1535,10,7,10,19,38,58,-20,31
Hibernian,1536,1,17,13,6,49,24,25,64
Falkirk,1536,2,18,10,8,63,42,21,64
Morton,1536,3,17,13,6,50,35,15,64
Dundee Utd,1536,4,16,12,8,56,36,20,60
Queen of S't,1536,5,12,11,13,52,49,3,47
Dunfermline,1536,6,9,13,14,46,54,-8,40
St Mirren,1536,7,9,10,17,39,58,-19,37
Dumbarton,1536,8,8,11,17,49,66,-17,35
Raith,1536,9,8,11,17,35,54,-19,35
Ayr,1536,10,7,14,15,32,53,-21,35
Hibernian,1537,1,20,13,3,57,25,32,73
Morton,1537,2,17,12,7,51,35,16,63
Dundee Utd,1537,3,16,9,11,53,43,10,57
Falkirk,1537,4,15,10,11,58,47,11,55
Queen of S't,1537,5,12,11,13,49,54,-5,47
Dunfermline,1537,6,10,11,15,48,51,-3,41
Ayr,1537,7,9,13,14,38,52,-14,40
Dumbarton,1537,8,9,12,15,43,60,-17,39
Raith,1537,9,9,11,16,37,52,-15,38
St Mirren,1537,10,7,10,19,42,57,-15,31
Hibernian,1538,1,19,14,3,54,23,31,71
Morton,1538,2,17,13,6,48,31,17,64
Falkirk,1538,3,17,10,9,59,39,20,61
Dundee Utd,1538,4,14,12,10,47,39,8,54
Queen of S't,1538,5,12,10,14,43,47,-4,46
Dunfermline,1538,6,9,14,13,46,49,-3,41
St Mirren,1538,7,9,10,17,40,55,-15,37
Ayr,1538,8,8,13,15,35,53,-18,37
Dumbarton,1538,9,8,12,16,45,61,-16,36
Raith,1538,10,8,10,18,32,52,-20,34
Hibernian,1539,1,17,13,6,58,31,27,64
Morton,1539,2,17,11,8,50,37,13,62
Dundee Utd,1539,3,17,8,11,55,41,14,59
Falkirk,1539,4,16,10,10,59,43,16,58
Queen of S't,1539,5,14,9,13,48,48,0,51
Dumbarton,1539,6,10,11,15,53,59,-6,41
St Mirren,1539,7,10,10,16,42,53,-11,40
Ayr,1539,8,9,11,16,38,61,-23,38
Dunfermline,1539,9,8,13,15,44,55,-11,37
Raith,1539,10,9,10,17,35,54,-19,37
Hibernian,1540,1,18,13,5,53,25,28,67
Dundee Utd,1540,2,19,8,9,57,42,15,65
Falkirk,1540,3,17,11,8,61,38,23,62
Morton,1540,4,16,12,8,49,38,11,60
Queen of S't,1540,5,12,8,16,43,53,-10,44
Ayr,1540,6,9,14,13,44,56,-12,41
Dumbarton,1540,7,9,11,16,46,59,-13,38
Raith,1540,8,9,11,16,32,47,-15,38
Dunfermline,1540,9,7,14,15,45,53,-8,35
St Mirren,1540,10,8,10,18,41,60,-19,34
Hibernian,1541,1,18,13,5,56,28,28,67
Dundee Utd,1541,2,17,10,9,51,36,15,61
Falkirk,1541,3,15,13,8,59,41,18,58
Morton,1541,4,15,12,9,51,41,10,57
Dunfermline,1541,5,12,11,13,49,50,-1,47
Queen of S't,1541,6,12,10,14,47,52,-5,46
Raith,1541,7,12,10,14,40,49,-9,46
Dumbarton,1541,8,10,10,16,47,58,-11,40
St Mirren,1541,9,8,10,18,36,53,-17,34
Ayr,1541,10,6,11,19,30,58,-28,29
Morton,1542,1,19,11,6,52,34,18,68
Hibernian,1542,2,19,10,7,57,26,31,67
Falkirk,1542,3,16,9,11,56,44,12,57
Dundee Utd,1542,4,15,11,10,52,42,10,56
Ayr,1542,5,11,12,13,41,55,-14,45
Queen of S't,1542,6,12,8,16,51,51,0,44
Raith,1542,7,12,8,16,39,51,-12,44
Dumbarton,1542,8,9,11,16,51,60,-9,38
Dunfermline,1542,9,8,13,15,44,58,-14,37
St Mirren,1542,10,7,11,18,38,60,-22,32
Hibernian,1543,1,20,12,4,58,23,35,72
Morton,1543,2,18,10,8,51,38,13,64
Dundee Utd,1543,3,16,11,9,52,39,13,59
Falkirk,1543,4,16,10,10,56,39,17,58
Dumbarton,1543,5,11,11,14,53,56,-3,44
Dunfermline,1543,6,9,13,14,45,49,-4,40
Raith,1543,7,10,10,16,32,48,-16,40
Ayr,1543,8,9,11,16,33,55,-22,38
Queen of S't,1543,9,9,10,17,41,55,-14,37
St Mirren,1543,10,8,10,18,38,57,-19,34
Hibernian,1544,1,19,13,4,56,24,32,70
Morton,1544,2,20,10,6,54,33,21,70
Falkirk,1544,3,16,9,11,57,41,16,57
Dundee Utd,1544,4,15,9,12,48,46,2,54
Raith,1544,5,11,11,14,37,46,-9,44
Dunfermline,1544,6,10,13,13,49,50,-1,43
St Mirren,1544,7,10,9,17,41,55,-14,39
Ayr,1544,8,9,12,15,37,53,-16,39
Queen of S't,1544,9,10,8,18,40,57,-17,38
Dumbarton,1544,10,8,10,18,46,60,-14,34
Hibernian,1545,1,20,12,4,60,28,32,72
Falkirk,1545,2,19,9,8,61,38,23,66
Dundee Utd,1545,3,15,11,10,48,40,8,56
Morton,1545,4,13,14,9,49,43,6,53
Dumbarton,1545,5,10,13,13,56,59,-3,43
Queen of S't,1545,6,11,9,16,42,51,-9,42
Raith,1545,7,10,11,15,39,51,-12,41
Dunfermline,1545,8,8,13,15,47,57,-10,37
St Mirren,1545,9,9,10,17,41,56,-15,37
Ayr,1545,10,8,12,16,36,56,-20,36
Hibernian,1546,1,18,11,7,52,31,21,65
Morton,1546,2,15,12,9,51,38,13,57
Falkirk,1546,3,14,12,10,54,40,14,54
Dundee Utd,1546,4,13,12,11,48,43,5,51
Ayr,1546,5,12,12,12,38,49,-11,48
Queen of S't,1546,6,12,11,13,46,47,-1,47
Dunfermline,1546,7,11,13,12,52,52,0,46
St Mirren,1546,8,10,11,15,41,51,-10,41
Dumbarton,1546,9,9,11,16,47,58,-11,38
Raith,1546,10,9,9,18,36,56,-20,36
Hibernian,1547,1,18,13,5,54,26,28,67
Morton,1547,2,19,10,7,57,38,19,67
Falkirk,1547,3,16,10,10,60,45,15,58
Dundee Utd,1547,4,14,11,11,51,45,6,53
Queen of S't,1547,5,11,12,13,46,51,-5,45
Ayr,1547,6,10,12,14,36,52,-16,42
Dunfermline,1547,7,9,14,13,42,45,-3,41
Dumbarton,1547,8,9,12,15,49,62,-13,39
Raith,1547,9,10,8,18,36,49,-13,38
St Mirren,1547,10,8,10,18,43,61,-18,34
Hibernian,1548,1,19,14,3,55,24,31,71
Dundee Utd,1548,2,15,13,8,50,36,14,58
Morton,1548,3,14,16,6,46,32,14,58
Falkirk,1548,4,15,12,9,58,42,16,57
Dunfermline,1548,5,10,13,13,45,49,-4,43
Ayr,1548,6,9,13,14,33,51,-18,40
St Mirren,1548,7,9,12,15,41,52,-11,39
Dumbarton,1548,8,9,11,16,47,58,-11,38
Raith,1548,9,9,10,17,36,51,-15,37
Queen of S't,1548,10,9,10,17,41,57,-16,37
Hibernian,1549,1,19,10,7,59,33,26,67
Falkirk,1549,2,18,10,8,67,39,28,64
Morton,1549,3,17,11,8,56,41,15,62
Dundee Utd,1549,4,15,12,9,48,38,10,57
Dumbarton,1549,5,12,12,12,53,55,-2,48
Queen of S't,1549,6,11,11,14,47,53,-6,44
Dunfermline,1549,7,10,12,14,46,52,-6,42
Raith,1549,8,9,11,16,33,49,-16,38
Ayr,1549,9,6,14,16,32,57,-25,32
St Mirren,1549,10,6,11,19,39,63,-24,29
Hibernian,1550,1,17,14,5,49,23,26,65
Falkirk,1550,2,17,10,9,61,39,22,61
Morton,1550,3,16,13,7,49,32,17,61
Dundee Utd,1550,4,17,8,11,50,39,11,59
Queen of S't,1550,5,12,11,13,45,49,-4,47
Dunfermline,1550,6,8,15,13,43,51,-8,39
Raith,1550,7,9,11,16,34,50,-16,38
Ayr,1550,8,8,14,14,32,50,-18,38
Dumbarton,1550,9,8,13,15,43,55,-12,37
St Mirren,1550,10,8,11,17,38,56,-18,35
Hibernian,1551,1,20,12,4,57,26,31,72
Morton,1551,2,17,11,8,49,37,12,62
Falkirk,1551,3,16,11,9,61,43,18,59
Dundee Utd,1551,4,15,9,12,49,44,5,54
Queen of S't,1551,5,12,10,14,50,50,0,46
Raith,1551,6,12,8,16,39,51,-12,44
Dunfermline,1551,7,9,13,14,44,48,-4,40
St Mirren,1551,8,9,11,16,44,56,-12,38
Dumbarton,1551,9,8,12,16,45,59,-14,36
Ayr,1551,10,7,13,16,34,58,-24,34
Hibernian,1552,1,17,12,7,53,28,25,63
Morton,1552,2,16,14,6,47,32,15,62
Falkirk,1552,3,16,11,9,54,39,15,59
Dundee Utd,1552,4,15,8,13,47,40,7,53
Queen of S't,1552,5,13,9,14,51,50,1,48
Dunfermline,1552,6,10,14,12,46,45,1,44
Raith,1552,7,11,10,15,38,47,-9,43
St Mirren,1552,8,11,9,16,47,56,-9,42
Ayr,1552,9,8,12,16,31,55,-24,36
Dumbarton,1552,10,7,13,16,47,69,-22,34
Hibernian,1553,1,21,12,3,63,25,38,75
Dundee Utd,1553,2,19,8,9,56,35,21,65
Morton,1553,3,17,12,7,53,37,16,63
Falkirk,1553,4,16,10,10,59,43,16,58
Queen of S't,1553,5,10,12,14,45,50,-5,42
Dunfermline,1553,6,9,13,14,43,50,-7,40
Raith,1553,7,10,10,16,32,49,-17,40
Dumbarton,1553,8,9,11,16,52,62,-10,38
St Mirren,1553,9,8,9,19,39,63,-24,33
Ayr,1553,10,7,11,18,29,57,-28,32
Hibernian,1554,1,21,11,4,60,23,37,74
Falkirk,1554,2,15,12,9,55,42,13,57
Dundee Utd,1554,3,14,11,11,48,41,7,53
Morton,1554,4,14,11,11,47,43,4,53
Dumbarton,1554,5,11,13,12,53,56,-3,46
Dunfermline,1554,6,10,14,12,45,44,1,44
Ayr,1554,7,10,12,14,39,52,-13,42
Queen of S't,1554,8,10,10,16,40,53,-13,40
St Mirren,1554,9,8,13,15,42,55,-13,37
Raith,1554,10,8,11,17,34,54,-20,35
Hibernian,1555,1,19,13,4,54,26,28,70
Morton,1555,2,18,11,7,55,35,20,65
Dundee Utd,1555,3,18,9,9,59,40,19,63
Falkirk,1555,4,15,11,10,57,41,16,56
Queen of S't,1555,5,12,12,12,48,47,1,48
Raith,1555,6,11,10,15,42,49,-7,43
Dunfermline,1555,7,8,13,15,48,54,-6,37
St Mirren,1555,8,9,9,18,36,58,-22,36
Dumbarton,1555,9,8,10,18,43,63,-20,34
Ayr,1555,10,7,12,17,31,60,-29,33
Hibernian,1556,1,21,11,4,57,21,36,74
Morton,1556,2,17,10,9,48,38,10,61
Dundee Utd,1556,3,16,11,9,49,36,13,59
Falkirk,1556,4,16,9,11,54,41,13,57
Dunfermline,1556,5,10,14,12,48,45,3,44
Raith,1556,6,11,11,14,41,47,-6,44
Dumbarton,1556,7,9,11,16,44,57,-13,38
Queen of S't,1556,8,9,10,17,41,57,-16,37
Ayr,1556,9,8,12,16,32,56,-24,36
St Mirren,1556,10,8,11,17,38,54,-16,35
Hibernian,1557,1,18,13,5,57,26,31,67
Morton,1557,2,18,12,6,53,35,18,66
Falkirk,1557,3,17,11,8,65,45,20,62
Dundee Utd,1557,4,15,12,9,50,39,11,57
Queen of S't,1557,5,11,9,16,47,54,-7,42
Dumbarton,1557,6,10,12,14,50,58,-8,42
Raith,1557,7,10,11,15,31,46,-15,41
St Mirren,1557,8,7,14,15,42,56,-14,35
Dunfermline,1557,9,7,13,16,44,54,-10,34
Ayr,1557,10,7,13,16,29,55,-26,34
Hibernian,1558,1,17,14,5,53,24,29,65
Morton,1558,2,17,12,7,49,35,14,63
Dundee Utd,1558,3,17,10,9,52,41,11,61
Falkirk,1558,4,15,11,10,57,39,18,56
Queen of S't,1558,5,11,9,16,41,51,-10,42
Dunfermline,1558,6,9,14,13,46,50,-4,41
St Mirren,1558,7,10,11,15,43,52,-9,41
Raith,1558,8,10,9,17,33,50,-17,39
Dumbarton,1558,9,9,11,16,47,59,-12,38
Ayr,1558,10,9,11,16,35,55,-20,38
Hibernian,1559,1,18,13,5,51,25,26,67
Morton,1559,2,17,10,9,49,35,14,61
Dundee Utd,1559,3,17,10,9,52,39,13,61
Falkirk,1559,4,16,11,9,59,40,19,59
Queen of S't,1559,5,12,9,15,44,47,-3,45
Dunfermline,1559,6,10,13,13,48,48,0,43
Ayr,1559,7,9,13,14,40,56,-16,40
Raith,1559,8,10,8,18,31,54,-23,38
Dumbarton,1559,9,8,13,15,45,57,-12,37
St Mirren,1559,10,8,10,18,40,58,-18,34
Hibernian,1560,1,18,14,4,53,25,28,68
Morton,1560,2,16,13,7,47,33,14,61
Dundee Utd,1560,3,15,11,10,54,41,13,56
Falkirk,1560,4,13,12,11,53,42,11,51
Dumbarton,1560,5,12,10,14,51,59,-8,46
Dunfermline,1560,6,11,12,13,49,51,-2,45
Queen of S't,1560,7,12,9,15,45,52,-7,45
Raith,1560,8,10,9,17,37,49,-12,39
Ayr,1560,9,8,14,14,35,53,-18,38
St Mirren,1560,10,7,12,17,38,57,-19,33
Hibernian,1561,1,18,11,7,55,30,25,65
Morton,1561,2,18,11,7,51,36,15,65
Falkirk,1561,3,17,11,8,62,40,22,62
Dundee Utd,1561,4,14,12,10,50,40,10,54
Dunfermline,1561,5,13,13,10,54,44,10,52
Raith,1561,6,11,8,17,37,50,-13,41
Queen of S't,1561,7,10,10,16,42,52,-10,40
Ayr,1561,8,9,12,15,34,55,-21,39
St Mirren,1561,9,8,11,17,38,56,-18,35
Dumbarton,1561,10,7,11,18,44,64,-20,32
Hibernian,1562,1,19,13,4,55,25,30,70
Dundee Utd,1562,2,17,10,9,49,35,14,61
Falkirk,1562,3,16,11,9,62,40,22,59
Morton,1562,4,14,11,11,47,42,5,53
Dunfermline,1562,5,11,11,14,46,52,-6,44
Queen of S't,1562,6,12,8,16,46,55,-9,44
Dumbarton,1562,7,10,11,15,49,54,-5,41
Raith,1562,8,10,10,16,38,51,-13,40
St Mirren,1562,9,10,9,17,41,58,-17,39
Ayr,1562,10,8,12,16,33,54,-21,36
Hibernian,1563,1,21,11,4,62,23,39,74
Morton,1563,2,15,11,10,49,40,9,56
Dundee Utd,1563,3,15,11,10,49,42,7,56
Falkirk,1563,4,15,10,11,56,41,15,55
Dunfermline,1563,5,10,14,12,47,48,-1,44
Queen of S't,1563,6,11,11,14,42,50,-8,44
St Mirren,1563,7,10,11,15,40,55,-15,41
Raith,1563,8,10,9,17,36,53,-17,39
Dumbarton,1563,9,9,11,16,46,56,-10,38
Ayr,1563,10,8,13,15,37,56,-19,37
Hibernian,1564,1,17,12,7,54,27,27,63
Falkirk,1564,2,16,13,7,60,36,24,61
Dundee Utd,1564,3,15,10,11,44,38,6,55
Morton,1564,4,14,12,10,46,40,6,54
Queen of S't,1564,5,13,10,13,49,48,1,49
Ayr,1564,6,10,12,14,37,54,-17,42
Dunfermline,1564,7,9,13,14,42,50,-8,40
St Mirren,1564,8,10,10,16,42,53,-11,40
Raith,1564,9,10,10,16,32,49,-17,40
Dumbarton,1564,10,9,12,15,47,58,-11,39
Hibernian,1565,1,20,11,5,61,27,34,71
Morton,1565,2,19,10,7,55,33,22,67
Dundee Utd,1565,3,17,10,9,52,43,9,61
Falkirk,1565,4,16,10,10,59,41,18,58
Queen of S't,1565,5,13,9,14,48,50,-2,48
Dunfermline,1565,6,9,12,15,45,52,-7,39
Raith,1565,7,9,12,15,33,47,-14,39
Dumbarton,1565,8,8,11,17,46,59,-13,35
Ayr,1565,9,7,14,15,30,53,-23,35
St Mirren,1565,10,7,11,18,37,61,-24,32
Hibernian,1566,1,19,12,5,53,22,31,69
Dundee Utd,1566,2,17,10,9,56,41,15,61
Morton,1566,3,16,12,8,52,38,14,60
Falkirk,1566,4,15,11,10,60,43,17,56
Dunfermline,1566,5,11,13,12,45,46,-1,46
Raith,1566,6,10,12,14,34,47,-13,42
Queen of S't,1566,7,10,11,15,43,54,-11,41
St Mirren,1566,8,8,12,16,44,58,-14,36
Ayr,1566,9,8,12,16,34,53,-19,36
Dumbarton,1566,10,8,11,17,46,65,-19,35
Hibernian,1567,1,21,11,4,63,27,36,74
Dundee Utd,1567,2,19,8,9,51,33,18,65
Falkirk,1567,3,15,10,11,55,45,10,55
Morton,1567,4,14,11,11,47,43,4,53
Queen of S't,1567,5,13,9,14,48,50,-2,48
Dunfermline,1567,6,11,12,13,48,48,0,45
Raith,1567,7,10,9,17,35,52,-17,39
Dumbarton,1567,8,8,13,15,45,57,-12,37
St Mirren,1567,9,8,12,16,41,54,-13,36
Ayr,1567,10,8,11,17,32,56,-24,35
Hibernian,1568,1,18,13,5,57,28,29,67
Morton,1568,2,17,12,7,51,37,14,63
Falkirk,1568,3,16,12,8,64,44,20,60
Dundee Utd,1568,4,16,10,10,52,42,10,58
Dunfermline,1568,5,11,12,13,51,51,0,45
Dumbarton,1568,6,10,11,15,56,58,-2,41
Queen of S't,1568,7,11,8,17,42,59,-17,41
Raith,1568,8,10,9,17,38,55,-17,39
St Mirren,1568,9,7,14,15,44,59,-15,35
Ayr,1568,10,8,11,17,33,55,-22,35
Hibernian,1569,1,20,12,4,58,29,29,72
Morton,1569,2,20,9,7,55,34,21,69
Falkirk,1569,3,16,11,9,65,46,19,59
Queen of S't,1569,4,13,9,14,48,49,-1,48
Dundee Utd,1569,5,12,9,15,42,48,-6,45
Raith,1569,6,11,9,16,37,51,-14,42
Dumbarton,1569,7,10,10,16,50,64,-14,40
Dunfermline,1569,8,9,12,15,44,50,-6,39
Ayr,1569,9,9,12,15,38,55,-17,39
St Mirren,1569,10,9,9,18,42,53,-11,36
Morton,1570,1,19,11,6,55,35,20,68
Hibernian,1570,2,17,11,8,51,33,18,62
Dundee Utd,1570,3,16,11,9,54,42,12,59
Falkirk,1570,4,16,10,10,56,39,17,58
Dunfermline,1570,5,11,14,11,52,48,4,47
Queen of S't,1570,6,11,11,14,45,52,-7,44
Raith,1570,7,10,10,16,35,51,-16,40
St Mirren,1570,8,10,9,17,45,53,-8,39
Dumbarton,1570,9,8,11,17,45,61,-16,35
Ayr,1570,10,6,14,16,34,58,-24,32
Hibernian,1571,1,20,11,5,60,26,34,71
Falkirk,1571,2,17,11,8,57,39,18,62
Dundee Utd,1571,3,17,9,10,55,40,15,60
Morton,1571,4,16,11,9,50,44,6,59
Dunfermline,1571,5,12,13,11,52,43,9,49
Queen of S't,1571,6,10,9,17,41,54,-13,39
Dumbarton,1571,7,9,11,16,47,58,-11,38
Raith,1571,8,9,11,16,36,55,-19,38
Ayr,1571,9,8,12,16,32,54,-22,36
St Mirren,1571,10,8,10,18,38,55,-17,34
Hibernian,1572,1,18,12,6,54,28,26,66
Falkirk,1572,2,18,9,9,62,43,19,63
Morton,1572,3,15,14,7,47,37,10,59
Dundee Utd,1572,4,14,11,11,50,41,9,53
Queen of S't,1572,5,13,8,15,50,55,-5,47
Dunfermline,1572,6,10,13,13,48,51,-3,43
Dumbarton,1572,7,10,11,15,49,57,-8,41
Raith,1572,8,11,8,17,37,49,-12,41
St Mirren,1572,9,8,12,16,40,54,-14,36
Ayr,1572,10,8,12,16,34,56,-22,36
Hibernian,1573,1,20,12,4,55,25,30,72
Falkirk,1573,2,18,9,9,61,41,20,63
Dundee Utd,1573,3,16,10,10,54,44,10,58
Morton,1573,4,15,12,9,48,37,11,57
Dunfermline,1573,5,10,14,12,48,49,-1,44
Queen of S't,1573,6,11,9,16,40,48,-8,42
Ayr,1573,7,10,12,14,36,53,-17,42
Raith,1573,8,10,10,16,37,49,-12,40
Dumbarton,1573,9,8,11,17,45,62,-17,35
St Mirren,1573,10,7,11,18,40,56,-16,32
Hibernian,1574,1,21,11,4,64,25,39,74
Falkirk,1574,2,17,9,10,61,40,21,60
Dundee Utd,1574,3,17,8,11,52,40,12,59
Morton,1574,4,15,12,9,49,41,8,57
Dunfermline,1574,5,11,12,13,48,48,0,45
Raith,1574,6,12,8,16,38,52,-14,44
Queen of S't,1574,7,11,10,15,50,59,-9,43
Dumbarton,1574,8,8,12,16,46,59,-13,36
Ayr,1574,9,8,12,16,38,60,-22,36
St Mirren,1574,10,8,10,18,39,61,-22,34
Falkirk,1575,1,19,9,8,71,44,27,66
Hibernian,1575,2,18,12,6,53,28,25,66
Morton,1575,3,18,11,7,55,37,18,65
Dundee Utd,1575,4,15,11,10,53,44,9,56
Dunfermline,1575,5,11,12,13,49,51,-2,45
Raith,1575,6,12,9,15,40,49,-9,45
Ayr,1575,7,10,10,16,40,57,-17,40
Dumbarton,1575,8,9,10,17,48,62,-14,37
Queen of S't,1575,9,9,9,18,43,60,-17,36
St Mirren,1575,10,8,9,19,38,58,-20,33
Hibernian,1576,1,20,11,5,59,27,32,71
Morton,1576,2,17,10,9,57,42,15,61
Falkirk,1576,3,14,11,11,51,38,13,53
Dundee Utd,1576,4,13,12,11,52,48,4,51
Queen of S't,1576,5,13,10,13,50,49,1,49
Dunfermline,1576,6,11,13,12,48,49,-1,46
Raith,1576,7,10,11,15,35,46,-11,41
St Mirren,1576,8,10,11,15,42,54,-12,41
Dumbarton,1576,9,9,12,15,46,56,-10,39
Ayr,1576,10,7,11,18,31,62,-31,32
Hibernian,1577,1,18,14,4,51,24,27,68
Dundee Utd,1577,2,17,10,9,50,37,13,61
Falkirk,1577,3,16,10,10,58,42,16,58
Morton,1577,4,15,13,8,48,37,11,58
Queen of S't,1577,5,11,11,14,47,51,-4,44
Raith,1577,6,11,8,17,37,47,-10,41
Dunfermline,1577,7,9,13,14,43,52,-9,40
St Mirren,1577,8,9,12,15,42,55,-13,39
Ayr,1577,9,9,11,16,33,53,-20,38
Dumbarton,1577,10,8,12,16,48,59,-11,36
Hibernian,1578,1,20,11,5,57,24,33,71
Morton,1578,2,17,11,8,53,42,11,62
Falkirk,1578,3,16,11,9,61,41,20,59
Dundee Utd,1578,4,16,9,11,51,44,7,57
Dunfermline,1578,5,11,13,12,47,48,-1,46
Queen of S't,1578,6,12,9,15,48,51,-3,45
Raith,1578,7,11,10,15,38,50,-12,43
Ayr,1578,8,9,11,16,36,54,-18,38
Dumbarton,1578,9,7,13,16,44,60,-16,34
St Mirren,1578,10,7,10,19,37,58,-21,31
Hibernian,1579,1,19,12,5,60,32,28,69
Falkirk,1579,2,17,11,8,61,41,20,62
Dundee Utd,1579,3,16,9,11,50,43,7,57
Morton,1579,4,13,16,7,48,40,8,55
Queen of S't,1579,5,14,8,14,57,50,7,50
Dumbarton,1579,6,11,11,14,52,58,-6,44
Raith,1579,7,11,9,16,38,48,-10,42
Dunfermline,1579,8,8,14,14,49,59,-10,38
Ayr,1579,9,8,11,17,36,60,-24,35
St Mirren,1579,10,7,11,18,37,57,-20,32
Hibernian,1580,1,18,12,6,52,27,25,66
Falkirk,1580,2,17,12,7,58,38,20,63
Morton,1580,3,16,14,6,45,31,14,62
Dundee Utd,1580,4,12,11,13,42,40,2,47
Dunfermline,1580,5,11,13,12,47,47,0,46
Queen of S't,1580,6,11,11,14,51,52,-1,44
Ayr,1580,7,10,13,13,39,54,-15,43
Dumbarton,1580,8,9,12,15,48,61,-13,39
Raith,1580,9,9,9,18,35,50,-15,36
St Mirren,1580,10,8,11,17,38,55,-17,35
Hibernian,1581,1,18,12,6,51,29,22,66
Falkirk,1581,2,17,12,7,59,35,24,63
Morton,1581,3,16,11,9,49,38,11,59
Dundee Utd,1581,4,14,11,11,46,38,8,53
Queen of S't,1581,5,13,11,12,47,44,3,50
Dunfermline,1581,6,12,12,12,49,45,4,48
St Mirren,1581,7,8,13,15,40,53,-13,37
Raith,1581,8,9,9,18,33,52,-19,36
Dumbarton,1581,9,7,14,15,47,60,-13,35
Ayr,1581,10,7,13,16,30,57,-27,34
Hibernian,1582,1,20,10,6,57,27,30,70
Morton,1582,2,18,12,6,54,32,22,66
Falkirk,1582,3,17,10,9,55,38,17,61
Dundee Utd,1582,4,15,11,10,47,37,10,56
Queen of S't,1582,5,13,8,15,48,50,-2,47
Dunfermline,1582,6,9,13,14,45,50,-5,40
St Mirren,1582,7,10,10,16,44,54,-10,40
Dumbarton,1582,8,9,11,16,46,62,-16,38
Raith,1582,9,9,8,19,36,55,-19,35
Ayr,1582,10,8,11,17,32,59,-27,35
Hibernian,1583,1,19,11,6,57,29,28,68
Dundee Utd,1583,2,18,8,10,53,42,11,62
Morton,1583,3,16,12,8,52,38,14,60
Falkirk,1583,4,15,11,10,59,46,13,56
Dunfermline,1583,5,11,13,12,45,43,2,46
Raith,1583,6,12,9,15,40,48,-8,45
Queen of S't,1583,7,11,9,16,44,53,-9,42
Ayr,1583,8,9,11,16,34,54,-20,38
Dumbarton,1583,9,8,12,16,49,61,-12,36
St Mirren,1583,10,8,10,18,40,59,-19,34
Hibernian,1584,1,18,12,6,51,26,25,66
Morton,1584,2,17,12,7,51,38,13,63
Falkirk,1584,3,16,10,10,59,42,17,58
Dundee Utd,1584,4,15,11,10,53,42,11,56
Dunfermline,1584,5,11,12,13,46,45,1,45
Queen of S't,1584,6,12,8,16,51,56,-5,44
Ayr,1584,7,11,11,14,39,55,-16,44
Dumbarton,1584,8,10,11,15,53,60,-7,41
Raith,1584,9,8,11,17,31,54,-23,35
St Mirren,1584,10,8,10,18,43,59,-16,34
Hibernian,1585,1,20,10,6,57,27,30,70
Falkirk,1585,2,16,12,8,57,37,20,60
Morton,1585,3,16,10,10,46,37,9,58
Dundee Utd,1585,4,15,10,11,50,41,9,55
Queen of S't,1585,5,11,12,13,46,48,-2,45
Dunfermline,1585,6,10,12,14,42,47,-5,42
Dumbarton,1585,7,10,10,16,49,59,-10,40
Raith,1585,8,9,12,15,31,45,-14,39
Ayr,1585,9,9,12,15,33,56,-23,39
St Mirren,1585,10,9,10,17,44,58,-14,37
Hibernian,1586,1,20,11,5,62,26,36,71
Falkirk,1586,2,17,10,9,58,38,20,61
Dundee Utd,1586,3,17,10,9,50,38,12,61
Morton,1586,4,15,11,10,45,40,5,56
Dunfermline,1586,5,10,14,12,46,46,0,44
Queen of S't,1586,6,11,10,15,41,47,-6,43
Ayr,1586,7,9,13,14,37,54,-17,40
Raith,1586,8,10,10,16,32,50,-18,40
Dumbarton,1586,9,8,11,17,46,60,-14,35
St Mirren,1586,10,8,10,18,41,59,-18,34
Hibernian,1587,1,20,12,4,59,29,30,72
Morton,1587,2,17,10,9,50,38,12,61
Falkirk,1587,3,14,14,8,57,41,16,56
Dundee Utd,1587,4,14,12,10,49,43,6,54
Queen of S't,1587,5,12,10,14,46,48,-2,46
Dunfermline,1587,6,11,12,13,52,50,2,45
St Mirren,1587,7,8,14,14,43,55,-12,38
Raith,1587,8,9,11,16,37,53,-16,38
Ayr,1587,9,8,12,16,35,58,-23,36
Dumbarton,1587,10,8,11,17,48,61,-13,35
Hibernian,1588,1,20,12,4,61,28,33,72
Morton,1588,2,17,11,8,54,40,14,62
Falkirk,1588,3,16,10,10,64,46,18,58
Dundee Utd,1588,4,16,10,10,50,40,10,58
Dunfermline,1588,5,11,11,14,53,54,-1,44
Queen of S't,1588,6,11,10,15,44,53,-9,43
Dumbarton,1588,7,10,10,16,54,64,-10,40
Raith,1588,8,10,9,17,33,53,-20,39
St Mirren,1588,9,9,10,17,43,54,-11,37
Ayr,1588,10,7,13,16,34,58,-24,34
Hibernian,1589,1,18,13,5,55,25,30,67
Morton,1589,2,17,11,8,49,36,13,62
Falkirk,1589,3,15,11,10,58,43,15,56
Dundee Utd,1589,4,14,10,12,51,48,3,52
Queen of S't,1589,5,12,12,12,51,50,1,48
Dunfermline,1589,6,9,14,13,47,57,-10,41
Dumbarton,1589,7,10,10,16,50,58,-8,40
Ayr,1589,8,9,13,14,34,52,-18,40
St Mirren,1589,9,9,12,15,42,52,-10,39
Raith,1589,10,9,10,17,31,47,-16,37
Morton,1590,1,19,11,6,58,34,24,68
Hibernian,1590,2,18,13,5,56,30,26,67
Falkirk,1590,3,16,11,9,56,39,17,59
Dundee Utd,1590,4,15,8,13,46,42,4,53
Queen of S't,1590,5,13,9,14,51,49,2,48
Dunfermline,1590,6,10,13,13,44,47,-3,43
Raith,1590,7,11,9,16,37,48,-11,42
Dumbarton,1590,8,10,10,16,53,66,-13,40
St Mirren,1590,9,9,10,17,44,59,-15,37
Ayr,1590,10,7,10,19,30,61,-31,31
Hibernian,1591,1,21,10,5,61,30,31,73
Morton,1591,2,19,10,7,60,37,23,67
Dundee Utd,1591,3,16,10,10,52,39,13,58
Falkirk,1591,4,14,13,9,58,45,13,55
Queen of S't,1591,5,13,8,15,47,50,-3,47
Raith,1591,6,11,10,15,38,49,-11,43
Dumbarton,1591,7,8,13,15,48,58,-10,37
Dunfermline,1591,8,7,15,14,45,56,-11,36
Ayr,1591,9,8,11,17,32,59,-27,35
St Mirren,1591,10,8,10,18,38,56,-18,34
Hibernian,1592,1,18,13,5,56,25,31,67
Falkirk,1592,2,16,12,8,59,41,18,60
Morton,1592,3,16,11,9,48,36,12,59
Dundee Utd,1592,4,13,11,12,47,42,5,50
Dumbarton,1592,5,12,11,13,48,51,-3,47
Queen of S't,1592,6,11,11,14,45,53,-8,44
Dunfermline,1592,7,10,13,13,44,44,0,43
St Mirren,1592,8,10,11,15,41,52,-11,41
Raith,1592,9,10,11,15,37,50,-13,41
Ayr,1592,10,7,10,19,28,59,-31,31
Hibernian,1593,1,19,11,6,58,30,28,68
Falkirk,1593,2,17,10,9,63,42,21,61
Morton,1593,3,16,12,8,50,37,13,60
Dundee Utd,1593,4,14,9,13,51,46,5,51
Dunfermline,1593,5,11,13,12,45,44,1,46
Raith,1593,6,12,9,15,36,46,-10,45
Queen of S't,1593,7,12,8,16,43,52,-9,44
Dumbarton,1593,8,10,11,15,47,57,-10,41
St Mirren,1593,9,9,11,16,41,53,-12,38
Ayr,1593,10,7,12,17,31,58,-27,33
Hibernian,1594,1,17,11,8,54,28,26,62
Morton,1594,2,16,11,9,47,40,7,59
Falkirk,1594,3,15,11,10,59,43,16,56
Dundee Utd,1594,4,16,8,12,52,42,10,56
Dunfermline,1594,5,11,12,13,46,47,-1,45
Queen of S't,1594,6,11,10,15,45,53,-8,43
Dumbarton,1594,7,11,10,15,50,60,-10,43
St Mirren,1594,8,11,10,15,44,54,-10,43
Raith,1594,9,10,11,15,38,50,-12,41
Ayr,1594,10,10,10,16,35,53,-18,40
Hibernian,1595,1,20,10,6,58,32,26,70
Falkirk,1595,2,19,9,8,69,40,29,66
Morton,1595,3,17,10,9,53,35,18,61
Dundee Utd,1595,4,15,10,11,49,39,10,55
Dunfermline,1595,5,10,13,13,49,53,-4,43
Queen of S't,1595,6,11,9,16,48,59,-11,42
Dumbarton,1595,7,10,10,16,46,55,-9,40
Ayr,1595,8,9,12,15,32,55,-23,39
Raith,1595,9,9,10,17,34,51,-17,37
St Mirren,1595,10,8,11,17,38,57,-19,35
Hibernian,1596,1,19,12,5,60,27,33,69
Morton,1596,2,19,10,7,53,34,19,67
Falkirk,1596,3,17,10,9,60,39,21,61
Dundee Utd,1596,4,14,10,12,45,41,4,52
Raith,1596,5,11,9,16,36,49,-13,42
Dunfermline,1596,6,10,11,15,46,50,-4,41
Ayr,1596,7,10,11,15,38,58,-20,41
Queen of S't,1596,8,10,9,17,42,58,-16,39
Dumbarton,1596,9,9,11,16,48,57,-9,38
St Mirren,1596,10,9,11,16,39,54,-15,38
Falkirk,1597,1,19,9,8,63,36,27,66
Hibernian,1597,2,18,12,6,53,26,27,66
Morton,1597,3,17,12,7,48,32,16,63
Dundee Utd,1597,4,17,8,11,55,41,14,59
Queen of S't,1597,5,11,11,14,46,51,-5,44
Raith,1597,6,10,10,16,31,49,-18,40
Dunfermline,1597,7,8,15,13,44,49,-5,39
Dumbarton,1597,8,8,13,15,46,61,-15,37
St Mirren,1597,9,8,11,17,38,55,-17,35
Ayr,1597,10,8,11,17,36,60,-24,35
Hibernian,1598,1,19,14,3,55,24,31,71
Morton,1598,2,18,12,6,55,32,23,66
Dundee Utd,1598,3,17,10,9,61,41,20,61
Falkirk,1598,4,15,10,11,57,43,14,55
Queen of S't,1598,5,14,9,13,52,48,4,51
Dunfermline,1598,6,11,13,12,50,50,0,46
St Mirren,1598,7,9,9,18,39,59,-20,36
Raith,1598,8,9,8,19,32,56,-24,35
Dumbarton,1598,9,8,10,18,45,63,-18,34
Ayr,1598,10,7,11,18,33,63,-30,32
Hibernian,1599,1,18,14,4,54,25,29,68
Falkirk,1599,2,17,11,8,62,42,20,62
Morton,1599,3,17,11,8,56,38,18,62
Dundee Utd,1599,4,16,10,10,51,40,11,58
Raith,1599,5,12,8,16,39,51,-12,44
Ayr,1599,6,9,13,14,33,48,-15,40
St Mirren,1599,7,9,12,15,41,54,-13,39
Queen of S't,1599,8,10,8,18,38,51,-13,38
Dumbarton,1599,9,9,10,17,46,57,-11,37
Dunfermline,1599,10,8,13,15,42,56,-14,37
Hibernian,1600,1,17,13,6,55,29,26,64
Dundee Utd,1600,2,18,9,9,54,36,18,63
Falkirk,1600,3,15,13,8,56,39,17,58
Morton,1600,4,16,10,10,48,41,7,58
Raith,1600,5,12,10,14,38,46,-8,46
Queen of S't,1600,6,11,10,15,47,50,-3,43
Dunfermline,1600,7,10,12,14,47,52,-5,42
Dumbarton,1600,8,10,11,15,51,58,-7,41
Ayr,1600,9,9,10,17,33,57,-24,37
St Mirren,1600,10,7,12,17,39,60,-21,33
Hibernian,1601,1,20,11,5,60,28,32,71
Falkirk,1601,2,17,11,8,61,38,23,62
Dundee Utd,1601,3,15,11,10,55,48,7,56
Morton,1601,4,14,11,11,45,42,3,53
Dumbarton,1601,5,11,12,13,53,56,-3,45
Queen of S't,1601,6,12,8,16,46,51,-5,44
Dunfermline,1601,7,11,11,14,49,55,-6,44
Raith,1601,8,11,9,16,34,49,-15,42
Ayr,1601,9,8,11,17,36,55,-19,35
St Mirren,1601,10,7,13,16,39,56,-17,34
Hibernian,1602,1,20,11,5,59,28,31,71
Morton,1602,2,17,12,7,57,40,17,63
Falkirk,1602,3,17,11,8,58,36,22,62
Dundee Utd,1602,4,13,9,14,47,47,0,48
Ayr,1602,5,11,10,15,36,57,-21,43
Dumbarton,1602,6,10,12,14,51,57,-6,42
Queen of S't,1602,7,10,12,14,44,50,-6,42
Dunfermline,1602,8,9,12,15,45,54,-9,39
Raith,1602,9,10,9,17,35,47,-12,39
St Mirren,1602,10,9,10,17,38,54,-16,37
Hibernian,1603,1,19,11,6,53,29,24,68
Morton,1603,2,17,12,7,55,37,18,63
Falkirk,1603,3,15,12,9,55,40,15,57
Dundee Utd,1603,4,15,9,12,48,40,8,54
Queen of S't,1603,5,14,8,14,50,48,2,50
Dunfermline,1603,6,10,13,13,46,49,-3,43
Ayr,1603,7,10,12,14,35,53,-18,42
Raith,1603,8,10,10,16,36,49,-13,40
St Mirren,1603,9,7,13,16,37,54,-17,34
Dumbarton,1603,10,7,12,17,44,60,-16,33
Hibernian,1604,1,17,14,5,49,24,25,65
Falkirk,1604,2,18,9,9,64,42,22,63
Dundee Utd,1604,3,18,8,10,58,42,16,62
Morton,1604,4,15,12,9,51,40,11,57
Queen of S't,1604,5,11,11,14,49,55,-6,44
Raith,1604,6,11,10,15,33,46,-13,43
Ayr,1604,7,9,12,15,33,49,-16,39
Dumbarton,1604,8,9,11,16,49,62,-13,38
Dunfermline,1604,9,8,13,15,44,51,-7,37
St Mirren,1604,10,9,10,17,40,59,-19,37
Hibernian,1605,1,20,12,4,60,22,38,72
Morton,1605,2,18,10,8,54,33,21,64
Dundee Utd,1605,3,15,12,9,48,37,11,57
Falkirk,1605,4,13,12,11,56,47,9,51
Queen of S't,1605,5,11,11,14,43,53,-10,44
Ayr,1605,6,10,12,14,35,54,-19,42
Dunfermline,1605,7,9,14,13,46,50,-4,41
Raith,1605,8,11,8,17,37,51,-14,41
St Mirren,1605,9,9,11,16,46,54,-8,38
Dumbarton,1605,10,7,12,17,47,71,-24,33
Hibernian,1606,1,17,13,6,54,28,26,64
Morton,1606,2,16,12,8,51,41,10,60
Dundee Utd,1606,3,16,9,11,51,43,8,57
Falkirk,1606,4,15,9,12,57,47,10,54
Queen of S't,1606,5,14,9,13,51,46,5,51
Dunfermline,1606,6,13,11,12,50,48,2,50
Raith,1606,7,10,10,16,37,51,-14,40
Ayr,1606,8,9,13,14,36,52,-16,40
St Mirren,1606,9,9,9,18,43,58,-15,36
Dumbarton,1606,10,8,11,17,48,64,-16,35
Hibernian,1607,1,21,11,4,56,24,32,74
Morton,1607,2,17,13,6,54,36,18,64
Dundee Utd,1607,3,16,9,11,52,42,10,57
Falkirk,1607,4,13,11,12,55,48,7,50
Queen of S't,1607,5,13,9,14,49,53,-4,48
Dumbarton,1607,6,11,10,15,57,64,-7,43
Raith,1607,7,10,11,15,36,47,-11,41
Ayr,1607,8,9,11,16,41,59,-18,38
Dunfermline,1607,9,8,13,15,48,57,-9,37
St Mirren,1607,10,7,12,17,38,56,-18,33
Hibernian,1608,1,20,11,5,53,24,29,71
Morton,1608,2,19,11,6,52,33,19,68
Falkirk,1608,3,16,11,9,61,42,19,59
Dundee Utd,1608,4,15,10,11,51,41,10,55
Queen of S't,1608,5,12,9,15,46,50,-4,45
Dunfermline,1608,6,10,13,13,44,46,-2,43
Dumbarton,1608,7,10,10,16,48,60,-12,40
Ayr,1608,8,8,13,15,32,51,-19,37
Raith,1608,9,9,9,18,34,51,-17,36
St Mirren,1608,10,8,9,19,38,61,-23,33
Hibernian,1609,1,18,13,5,53,24,29,67
Falkirk,1609,2,16,11,9,63,43,20,59
Morton,1609,3,15,14,7,44,34,10,59
Dundee Utd,1609,4,13,11,12,47,42,5,50
Dunfermline,1609,5,11,14,11,47,46,1,47
Queen of S't,1609,6,12,10,14,47,51,-4,46
Raith,1609,7,11,9,16,38,51,-13,42
Dumbarton,1609,8,10,10,16,50,62,-12,40
Ayr,1609,9,8,15,13,35,51,-16,39
St Mirren,1609,10,6,13,17,36,56,-20,31
Hibernian,1610,1,19,12,5,55,27,28,69
Morton,1610,2,16,13,7,53,37,16,61
Dundee Utd,1610,3,16,11,9,57,46,11,59
Falkirk,1610,4,14,13,9,57,41,16,55
Dunfermline,1610,5,10,12,14,46,50,-4,42
Queen of S't,1610,6,10,12,14,43,49,-6,42
Dumbarton,1610,7,9,12,15,53,62,-9,39
St Mirren,1610,8,9,11,16,44,58,-14,38
Raith,1610,9,9,11,16,33,49,-16,38
Ayr,1610,10,8,13,15,41,63,-22,37
Hibernian,1611,1,21,10,5,63,29,34,73
Falkirk,1611,2,18,10,8,67,40,27,64
Morton,1611,3,17,11,8,51,36,15,62
Dundee Utd,1611,4,17,9,10,52,43,9,60
Queen of S't,1611,5,14,9,13,44,45,-1,51
Dunfermline,1611,6,10,11,15,45,52,-7,41
Raith,1611,7,9,9,18,31,51,-20,36
Dumbarton,1611,8,7,13,16,45,58,-13,34
St Mirren,1611,9,7,13,16,38,55,-17,34
Ayr,1611,10,7,11,18,31,58,-27,32
Hibernian,1612,1,17,15,4,51,26,25,66
Morton,1612,2,17,13,6,47,31,16,64
Dundee Utd,1612,3,17,9,10,55,38,17,60
Falkirk,1612,4,15,11,10,55,40,15,56
Queen of S't,1612,5,13,9,14,50,49,1,48
Dunfermline,1612,6,11,13,12,48,50,-2,46
Raith,1612,7,9,11,16,31,48,-17,38
Dumbarton,1612,8,8,12,16,44,57,-13,36
St Mirren,1612,9,8,11,17,37,53,-16,35
Ayr,1612,10,7,12,17,32,58,-26,33
Morton,1613,1,19,12,5,61,34,27,69
Hibernian,1613,2,17,13,6,51,28,23,64
Dundee Utd,1613,3,18,8,10,56,40,16,62
Falkirk,1613,4,15,11,10,55,45,10,56
Queen of S't,1613,5,12,10,14,44,49,-5,46
Dumbarton,1613,6,11,10,15,51,61,-10,43
Dunfermline,1613,7,9,12,15,40,47,-7,39
Raith,1613,8,10,9,17,34,46,-12,39
St Mirren,1613,9,9,10,17,39,55,-16,37
Ayr,1613,10,7,11,18,35,61,-26,32
Hibernian,1614,1,22,10,4,60,25,35,76
Morton,1614,2,19,10,7,50,34,16,67
Falkirk,1614,3,17,11,8,58,38,20,62
Dundee Utd,1614,4,16,10,10,49,39,10,58
Dumbarton,1614,5,9,12,15,48,58,-10,39
Ayr,1614,6,9,12,15,36,56,-20,39
Queen of S't,1614,7,9,11,16,39,51,-12,38
Dunfermline,1614,8,8,13,15,42,48,-6,37
Raith,1614,9,9,10,17,34,50,-16,37
St Mirren,1614,10,8,9,19,38,55,-17,33
Hibernian,1615,1,19,13,4,57,27,30,70
Morton,1615,2,18,9,9,50,36,14,63
Dundee Utd,1615,3,16,8,12,45,38,7,56
Falkirk,1615,4,15,9,12,57,43,14,54
Ayr,1615,5,11,11,14,39,52,-13,44
Dunfermline,1615,6,10,13,13,46,51,-5,43
Queen of S't,1615,7,11,9,16,45,52,-7,42
Raith,1615,8,11,9,16,36,48,-12,42
Dumbarton,1615,9,10,11,15,47,58,-11,41
St Mirren,1615,10,8,10,18,38,55,-17,34
Hibernian,1616,1,21,12,3,57,23,34,75
Dundee Utd,1616,2,18,9,9,55,36,19,63
Falkirk,1616,3,15,12,9,57,38,19,57
Morton,1616,4,15,12,9,51,44,7,57
Dunfermline,1616,5,10,14,12,49,53,-4,44
Queen of S't,1616,6,11,9,16,42,49,-7,42
Ayr,1616,7,10,11,15,33,53,-20,41
Raith,1616,8,10,9,17,33,46,-13,39
Dumbarton,1616,9,8,10,18,48,60,-12,34
St Mirren,1616,10,8,10,18,35,58,-23,34
Hibernian,1617,1,20,12,4,58,27,31,72
Morton,1617,2,16,11,9,49,38,11,59
Falkirk,1617,3,16,10,10,55,40,15,58
Dundee Utd,1617,4,16,9,11,51,40,11,57
Queen of S't,1617,5,14,8,14,49,48,1,50
Dunfermline,1617,6,11,11,14,47,51,-4,44
Raith,1617,7,11,9,16,37,51,-14,42
Dumbarton,1617,8,8,12,16,45,58,-13,36
St Mirren,1617,9,8,12,16,43,57,-14,36
Ayr,1617,10,6,14,16,32,56,-24,32
Hibernian,1618,1,20,11,5,55,26,29,71
Dundee Utd,1618,2,16,10,10,53,39,14,58
Falkirk,1618,3,15,12,9,59,43,16,57
Morton,1618,4,15,9,12,46,46,0,54
Dunfermline,1618,5,13,11,12,50,48,2,50
Queen of S't,1618,6,13,8,15,49,54,-5,47
Raith,1618,7,11,9,16,37,46,-9,42
St Mirren,1618,8,9,10,17,40,57,-17,37
Ayr,1618,9,8,13,15,36,55,-19,37
Dumbarton,1618,10,8,11,17,47,58,-11,35
Hibernian,1619,1,19,11,6,51,26,25,68
Morton,1619,2,18,9,9,52,40,12,63
Dundee Utd,1619,3,17,9,10,51,39,12,60
Falkirk,1619,4,15,11,10,61,45,16,56
Dunfermline,1619,5,11,14,11,51,47,4,47
Queen of S't,1619,6,11,11,14,44,50,-6,44
St Mirren,1619,7,10,9,17,40,54,-14,39
Raith,1619,8,10,9,17,31,47,-16,39
Dumbarton,1619,9,8,12,16,47,59,-12,36
Ayr,1619,10,8,11,17,32,53,-21,35
Hibernian,1620,1,21,11,4,58,24,34,74
Dundee Utd,1620,2,17,10,9,55,38,17,61
Falkirk,1620,3,17,9,10,56,38,18,60
Morton,1620,4,15,11,10,45,41,4,56
Queen of S't,1620,5,12,9,15,44,46,-2,45
Raith,1620,6,11,9,16,36,51,-15,42
Dunfermline,1620,7,9,12,15,41,47,-6,39
St Mirren,1620,8,10,9,17,43,51,-8,39
Ayr,1620,9,7,15,14,32,53,-21,36
Dumbarton,1620,10,8,11,17,40,61,-21,35
Hibernian,1621,1,18,13,5,53,26,27,67
Morton,1621,2,17,12,7,50,37,13,63
Falkirk,1621,3,16,12,8,59,38,21,60
Dundee Utd,1621,4,15,10,11,50,42,8,55
Queen of S't,1621,5,11,10,15,44,54,-10,43
Raith,1621,6,11,10,15,36,46,-10,43
St Mirren,1621,7,10,10,16,45,56,-11,40
Dunfermline,1621,8,8,14,14,42,50,-8,38
Ayr,1621,9,9,11,16,35,52,-17,38
Dumbarton,1621,10,7,14,15,50,63,-13,35
Hibernian,1622,1,20,11,5,54,26,28,71
Falkirk,1622,2,17,9,10,60,46,14,60
Morton,1622,3,16,12,8,49,36,13,60
Dundee Utd,1622,4,16,10,10,55,39,16,58
Queen of S't,1622,5,13,10,13,45,45,0,49
Dumbarton,1622,6,10,12,14,49,56,-7,42
Dunfermline,1622,7,10,11,15,44,50,-6,41
Raith,1622,8,9,10,17,37,52,-15,37
Ayr,1622,9,8,12,16,33,55,-22,36
St Mirren,1622,10,7,11,18,38,59,-21,32
Hibernian,1623,1,19,13,4,53,25,28,70
Falkirk,1623,2,16,12,8,61,40,21,60
Morton,1623,3,15,14,7,52,40,12,59
Dundee Utd,1623,4,15,12,9,49,39,10,57
Dumbarton,1623,5,11,12,13,50,52,-2,45
Queen of S't,1623,6,11,10,15,45,52,-7,43
Raith,1623,7,11,10,15,39,48,-9,43
Dunfermline,1623,8,9,13,14,48,52,-4,40
St Mirren,1623,9,8,9,19,38,62,-24,33
Ayr,1623,10,7,11,18,31,56,-25,32
Hibernian,1624,1,21,11,4,61,26,35,74
Dundee Utd,1624,2,19,8,9,54,36,18,65
Falkirk,1624,3,17,10,9,62,45,17,61
Morton,1624,4,15,13,8,47,38,9,58
Raith,1624,5,11,10,15,36,44,-8,43
Dunfermline,1624,6,9,14,13,46,48,-2,41
St Mirren,1624,7,8,13,15,41,54,-13,37
Queen of S't,1624,8,9,9,18,39,57,-18,36
Ayr,1624,9,8,12,16,34,54,-20,36
Dumbarton,1624,10,8,10,18,46,64,-18,34
Hibernian,1625,1,20,12,4,55,25,30,72
Morton,1625,2,16,12,8,50,39,11,60
Falkirk,1625,3,15,11,10,58,45,13,56
Dundee Utd,1625,4,15,10,11,50,42,8,55
Dunfermline,1625,5,11,12,13,51,48,3,45
Queen of S't,1625,6,11,11,14,46,51,-5,44
Dumbarton,1625,7,10,11,15,48,57,-9,41
Raith,1625,8,10,11,15,36,49,-13,41
St Mirren,1625,9,9,11,16,44,54,-10,38
Ayr,1625,10,6,13,17,31,59,-28,31
Hibernian,1626,1,19,12,5,57,25,32,69
Falkirk,1626,2,16,10,10,62,42,20,58
Morton,1626,3,15,13,8,47,38,9,58
Dundee Utd,1626,4,13,10,13,44,45,-1,49
Dunfermline,1626,5,11,13,12,50,49,1,46
Raith,1626,6,11,9,16,36,47,-11,42
St Mirren,1626,7,10,11,15,44,53,-9,41
Ayr,1626,8,9,14,13,37,53,-16,41
Dumbarton,1626,9,9,13,14,44,55,-11,40
Queen of S't,1626,10,9,11,16,42,56,-14,38
Hibernian,1627,1,18,13,5,51,25,26,67
Morton,1627,2,19,9,8,56,33,23,66
Falkirk,1627,3,16,11,9,56,40,16,59
Dundee Utd,1627,4,14,12,10,46,40,6,54
Dunfermline,1627,5,10,14,12,46,49,-3,44
Queen of S't,1627,6,11,10,15,45,48,-3,43
Ayr,1627,7,8,15,13,34,51,-17,39
Raith,1627,8,9,11,16,34,48,-14,38
St Mirren,1627,9,8,13,15,41,54,-13,37
Dumbarton,1627,10,8,10,18,45,66,-21,34
Hibernian,1628,1,23,10,3,70,24,46,79
Dundee Utd,1628,2,17,9,10,47,39,8,60
Morton,1628,3,16,11,9,49,42,7,59
Falkirk,1628,4,14,12,10,57,43,14,54
Ayr,1628,5,10,11,15,39,54,-15,41
Dunfermline,1628,6,9,13,14,47,50,-3,40
Queen of S't,1628,7,10,9,17,41,59,-18,39
Dumbarton,1628,8,9,11,16,45,55,-10,38
St Mirren,1628,9,9,11,16,36,50,-14,38
Raith,1628,10,9,11,16,36,51,-15,38
Hibernian,1629,1,18,13,5,53,28,25,67
Morton,1629,2,17,12,7,50,35,15,63
Dundee Utd,1629,3,16,10,10,51,40,11,58
Falkirk,1629,4,15,11,10,53,39,14,56
Dunfermline,1629,5,12,11,13,49,51,-2,47
Queen of S't,1629,6,11,8,17,51,57,-6,41
Raith,1629,7,10,11,15,34,44,-10,41
Ayr,1629,8,9,12,15,38,56,-18,39
St Mirren,1629,9,9,11,16,40,54,-14,38
Dumbarton,1629,10,8,11,17,52,67,-15,35
Morton,1630,1,21,9,6,56,33,23,72
Hibernian,1630,2,19,13,4,56,23,33,70
Falkirk,1630,3,15,11,10,58,41,17,56
Dundee Utd,1630,4,15,10,11,44,37,7,55
Dumbarton,1630,5,10,12,14,60,60,0,42
Queen of S't,1630,6,10,11,15,47,57,-10,41
Dunfermline,1630,7,9,13,14,43,51,-8,40
Raith,1630,8,10,10,16,38,52,-14,40
Ayr,1630,9,8,11,17,31,59,-28,35
St Mirren,1630,10,8,10,18,42,62,-20,34
Hibernian,1631,1,19,11,6,58,29,29,68
Falkirk,1631,2,18,10,8,61,38,23,64
Dundee Utd,1631,3,18,8,10,55,41,14,62
Morton,1631,4,15,13,8,52,39,13,58
Raith,1631,5,11,9,16,40,50,-10,42
Queen of S't,1631,6,11,9,16,45,56,-11,42
Ayr,1631,7,10,12,14,37,54,-17,42
Dunfermline,1631,8,8,14,14,44,53,-9,38
Dumbarton,1631,9,8,12,16,45,58,-13,36
St Mirren,1631,10,8,10,18,45,64,-19,34
Hibernian,1632,1,18,13,5,53,26,27,67
Morton,1632,2,18,12,6,55,36,19,66
Falkirk,1632,3,17,11,8,62,40,22,62
Dundee Utd,1632,4,15,8,13,47,41,6,53
Queen of S't,1632,5,13,10,13,46,45,1,49
Dunfermline,1632,6,8,16,12,43,48,-5,40
St Mirren,1632,7,9,11,16,44,59,-15,38
Ayr,1632,8,9,11,16,33,52,-19,38
Raith,1632,9,9,10,17,33,49,-16,37
Dumbarton,1632,10,7,12,17,44,64,-20,33
Hibernian,1633,1,19,12,5,55,29,26,69
Morton,1633,2,19,10,7,54,34,20,67
Dundee Utd,1633,3,16,11,9,53,39,14,59
Falkirk,1633,4,16,9,11,60,46,14,57
Queen of S't,1633,5,12,10,14,50,53,-3,46
Raith,1633,6,11,9,16,38,52,-14,42
Dunfermline,1633,7,9,12,15,45,52,-7,39
Dumbarton,1633,8,9,12,15,51,59,-8,39
St Mirren,1633,9,8,10,18,40,58,-18,34
Ayr,1633,10,7,13,16,33,57,-24,34
Hibernian,1634,1,18,13,5,52,24,28,67
Morton,1634,2,17,11,8,50,37,13,62
Falkirk,1634,3,15,12,9,52,36,16,57
Dundee Utd,1634,4,14,11,11,46,40,6,53
Queen of S't,1634,5,13,9,14,48,49,-1,48
Dunfermline,1634,6,10,13,13,48,47,1,43
St Mirren,1634,7,10,12,14,42,49,-7,42
Raith,1634,8,10,9,17,36,54,-18,39
Ayr,1634,9,8,13,15,37,59,-22,37
Dumbarton,1634,10,8,11,17,45,61,-16,35
Hibernian,1635,1,20,11,5,59,24,35,71
Morton,1635,2,15,13,8,46,36,10,58
Dundee Utd,1635,3,15,12,9,49,39,10,57
Falkirk,1635,4,15,10,11,57,42,15,55
Dunfermline,1635,5,10,15,11,46,46,0,45
St Mirren,1635,6,11,9,16,39,53,-14,42
Dumbarton,1635,7,9,12,15,47,56,-9,39
Queen of S't,1635,8,9,12,15,41,55,-14,39
Ayr,1635,9,8,14,14,32,49,-17,38
Raith,1635,10,9,10,17,38,54,-16,37
Hibernian,1636,1,18,12,6,54,26,28,66
Falkirk,1636,2,17,10,9,54,35,19,61
Morton,1636,3,16,11,9,49,38,11,59
Dundee Utd,1636,4,15,12,9,51,39,12,57
Dunfermline,1636,5,12,12,12,47,46,1,48
Dumbarton,1636,6,11,10,15,51,58,-7,43
Queen of S't,1636,7,11,9,16,42,58,-16,42
Ayr,1636,8,9,11,16,38,54,-16,38
Raith,1636,9,9,10,17,35,51,-16,37
St Mirren,1636,10,7,13,16,41,57,-16,34
Hibernian,1637,1,20,12,4,56,24,32,72
Morton,1637,2,20,10,6,55,33,22,70
Falkirk,1637,3,16,11,9,59,40,19,59
Dundee Utd,1637,4,16,10,10,50,39,11,58
Queen of S't,1637,5,12,9,15,42,50,-8,45
Dunfermline,1637,6,10,12,14,49,50,-1,42
Ayr,1637,7,10,11,15,36,51,-15,41
Dumbarton,1637,8,8,12,16,47,63,-16,36
Raith,1637,9,8,10,18,31,53,-22,34
St Mirren,1637,10,6,11,19,34,56,-22,29
Hibernian,1638,1,19,11,6,54,26,28,68
Morton,1638,2,18,11,7,53,33,20,65
Falkirk,1638,3,15,12,9,61,44,17,57
Dundee Utd,1638,4,13,12,11,48,45,3,51
Dumbarton,1638,5,12,12,12,61,61,0,48
Raith,1638,6,11,9,16,35,50,-15,42
Queen of S't,1638,7,10,11,15,48,57,-9,41
Ayr,1638,8,9,14,13,41,57,-16,41
Dunfermline,1638,9,9,12,15,45,51,-6,39
St Mirren,1638,10,6,12,18,38,60,-22,30
Hibernian,1639,1,20,12,4,58,27,31,72
Morton,1639,2,16,10,10,53,40,13,58
Dundee Utd,1639,3,16,10,10,51,41,10,58
Falkirk,1639,4,16,9,11,60,41,19,57
Dunfermline,1639,5,13,13,10,54,47,7,52
Queen of S't,1639,6,12,9,15,47,52,-5,45
Raith,1639,7,11,8,17,41,55,-14,41
Ayr,1639,8,9,11,16,40,61,-21,38
Dumbarton,1639,9,8,11,17,49,65,-16,35
St Mirren,1639,10,7,11,18,39,63,-24,32
Hibernian,1640,1,18,13,5,55,28,27,67
Dundee Utd,1640,2,18,10,8,49,33,16,64
Morton,1640,3,16,11,9,48,39,9,59
Falkirk,1640,4,14,13,9,56,42,14,55
Dunfermline,1640,5,10,14,12,47,51,-4,44
Raith,1640,6,10,12,14,38,48,-10,42
Queen of S't,1640,7,10,10,16,43,49,-6,40
St Mirren,1640,8,9,11,16,45,56,-11,38
Dumbarton,1640,9,8,12,16,44,59,-15,36
Ayr,1640,10,6,16,14,32,52,-20,34
Hibernian,1641,1,20,11,5,60,24,36,71
Morton,1641,2,16,14,6,51,36,15,62
Falkirk,1641,3,17,10,9,58,40,18,61
Dundee Utd,1641,4,15,11,10,46,37,9,56
Queen of S't,1641,5,12,8,16,44,51,-7,44
Ayr,1641,6,9,13,14,35,55,-20,40
Raith,1641,7,10,9,17,33,50,-17,39
Dunfermline,1641,8,8,14,14,42,51,-9,38
St Mirren,1641,9,9,10,17,46,58,-12,37
Dumbarton,1641,10,8,12,16,45,58,-13,36
Hibernian,1642,1,18,13,5,50,25,25,67
Morton,1642,2,18,11,7,51,32,19,65
Falkirk,1642,3,15,11,10,55,41,14,56
Dundee Utd,1642,4,13,10,13,41,40,1,49
Queen of S't,1642,5,11,11,14,44,48,-4,44
Raith,1642,6,11,11,14,37,44,-7,44
Dunfermline,1642,7,10,12,14,43,48,-5,42
Dumbarton,1642,8,9,12,15,44,56,-12,39
Ayr,1642,9,9,12,15,35,52,-17,39
St Mirren,1642,10,8,13,15,36,50,-14,37
Hibernian,1643,1,20,12,4,56,25,31,72
Morton,1643,2,17,11,8,46,33,13,62
Dundee Utd,1643,3,17,10,9,54,38,16,61
Falkirk,1643,4,15,12,9,59,44,15,57
Queen of S't,1643,5,11,10,15,42,49,-7,43
Raith,1643,6,11,8,17,36,47,-11,41
Dumbarton,1643,7,10,10,16,47,60,-13,40
Ayr,1643,8,9,11,16,32,55,-23,38
Dunfermline,1643,9,8,12,16,41,48,-7,36
St Mirren,1643,10,8,12,16,38,52,-14,36
Hibernian,1644,1,21,11,4,58,22,36,74
Falkirk,1644,2,18,10,8,60,40,20,64
Morton,1644,3,18,10,8,50,36,14,64
Dundee Utd,1644,4,16,10,10,51,37,14,58
Queen of S't,1644,5,11,12,13,41,44,-3,45
Dunfermline,1644,6,10,12,14,43,46,-3,42
Raith,1644,7,9,11,16,36,48,-12,38
Dumbarton,1644,8,9,10,17,50,60,-10,37
Ayr,1644,9,8,11,17,31,61,-30,35
St Mirren,1644,10,7,9,20,38,64,-26,30
Hibernian,1645,1,23,10,3,63,25,38,79
Morton,1645,2,16,9,11,48,45,3,57
Falkirk,1645,3,15,11,10,55,41,14,56
Dundee Utd,1645,4,13,12,11,48,43,5,51
Dumbarton,1645,5,12,12,12,55,54,1,48
Dunfermline,1645,6,10,13,13,47,49,-2,43
Raith,1645,7,10,10,16,35,49,-14,40
Queen of S't,1645,8,10,9,17,42,54,-12,39
St Mirren,1645,9,9,11,16,43,56,-13,38
Ayr,1645,10,7,13,16,31,51,-20,34
Hibernian,1646,1,20,11,5,57,27,30,71
Morton,1646,2,17,11,8,52,36,16,62
Falkirk,1646,3,17,10,9,64,44,20,61
Dundee Utd,1646,4,14,11,11,45,42,3,53
Dumbarton,1646,5,10,13,13,52,54,-2,43
Raith,1646,6,10,11,15,35,48,-13,41
Dunfermline,1646,7,9,13,14,49,51,-2,40
Queen of S't,1646,8,10,10,16,41,56,-15,40
St Mirren,1646,9,8,12,16,43,55,-12,36
Ayr,1646,10,8,12,16,34,59,-25,36
Hibernian,1647,1,18,13,5,56,28,28,67
Morton,1647,2,16,11,9,52,40,12,59
Falkirk,1647,3,15,11,10,56,41,15,56
Dundee Utd,1647,4,14,12,10,48,40,8,54
Dunfermline,1647,5,12,13,11,47,45,2,49
Queen of S't,1647,6,12,11,13,44,45,-1,47
Raith,1647,7,10,10,16,33,50,-17,40
Ayr,1647,8,8,14,14,32,49,-17,38
Dumbarton,1647,9,8,12,16,47,61,-14,36
St Mirren,1647,10,8,11,17,39,55,-16,35
Hibernian,1648,1,21,11,4,59,26,33,74
Dundee Utd,1648,2,17,10,9,52,36,16,61
Falkirk,1648,3,16,10,10,56,38,18,58
Morton,1648,4,16,10,10,51,39,12,58
Raith,1648,5,12,9,15,36,49,-13,45
Queen of S't,1648,6,11,10,15,44,49,-5,43
Dunfermline,1648,7,9,15,12,43,46,-3,42
Dumbarton,1648,8,8,12,16,44,60,-16,36
Ayr,1648,9,8,11,17,31,55,-24,35
St Mirren,1648,10,7,12,17,37,55,-18,33
Hibernian,1649,1,21,10,5,63,26,37,73
Morton,1649,2,18,10,8,61,40,21,64
Falkirk,1649,3,18,10,8,58,37,21,64
Dundee Utd,1649,4,16,8,12,51,45,6,56
Queen of S't,1649,5,13,9,14,49,48,1,48
Dunfermline,1649,6,10,11,15,46,54,-8,41
Raith,1649,7,11,8,17,34,51,-17,41
St Mirren,1649,8,9,11,16,41,57,-16,38
Ayr,1649,9,7,13,16,36,58,-22,34
Dumbarton,1649,10,7,10,19,41,64,-23,31
Hibernian,1650,1,18,12,6,53,28,25,66
Dundee Utd,1650,2,18,9,9,55,35,20,63
Falkirk,1650,3,16,13,7,66,39,27,61
Morton,1650,4,17,10,9,51,40,11,61
Queen of S't,1650,5,12,10,14,45,52,-7,46
Dunfermline,1650,6,11,12,13,49,49,0,45
Ayr,1650,7,9,10,17,35,56,-21,37
St Mirren,1650,8,9,10,17,36,59,-23,37
Dumbarton,1650,9,8,12,16,47,59,-12,36
Raith,1650,10,9,8,19,35,55,-20,35
Hibernian,1651,1,20,11,5,56,24,32,71
Dundee Utd,1651,2,18,9,9,57,40,17,63
Falkirk,1651,3,17,11,8,64,42,22,62
Morton,1651,4,16,9,11,49,40,9,57
Queen of S't,1651,5,12,9,15,48,55,-7,45
Raith,1651,6,10,11,15,37,48,-11,41
Ayr,1651,7,10,10,16,32,52,-20,40
Dunfermline,1651,8,9,12,15,42,53,-11,39
Dumbarton,1651,9,9,10,17,50,63,-13,37
St Mirren,1651,10,8,10,18,40,58,-18,34
Hibernian,1652,1,17,15,4,53,28,25,66
Morton,1652,2,16,13,7,49,34,15,61
Falkirk,1652,3,16,12,8,60,37,23,60
Dundee Utd,1652,4,15,11,10,51,41,10,56
Dumbarton,1652,5,12,10,14,46,50,-4,46
Dunfermline,1652,6,10,11,15,44,48,-4,41
Queen of S't,1652,7,10,11,15,44,52,-8,41
Raith,1652,8,10,11,15,34,47,-13,41
Ayr,1652,9,8,13,15,36,58,-22,37
St Mirren,1652,10,7,11,18,38,60,-22,32
Morton,1653,1,18,11,7,50,34,16,65
Dundee Utd,1653,2,18,10,8,55,36,19,64
Falkirk,1653,3,18,9,9,62,41,21,63
Hibernian,1653,4,17,11,8,50,26,24,62
Queen of S't,1653,5,13,9,14,45,47,-2,48
Raith,1653,6,11,9,16,34,48,-14,42
St Mirren,1653,7,9,11,16,35,52,-17,38
Dunfermline,1653,8,8,13,15,43,54,-11,37
Ayr,1653,9,7,14,15,31,51,-20,35
Dumbarton,1653,10,7,11,18,45,61,-16,32
Hibernian,1654,1,18,13,5,54,30,24,67
Morton,1654,2,18,12,6,56,37,19,66
Falkirk,1654,3,16,11,9,55,38,17,59
Queen of S't,1654,4,13,10,13,52,48,4,49
Dundee Utd,1654,5,13,10,13,48,45,3,49
Dunfermline,1654,6,10,13,13,44,49,-5,43
St Mirren,1654,7,10,10,16,47,55,-8,40
Ayr,1654,8,9,11,16,38,60,-22,38
Raith,1654,9,9,10,17,36,55,-19,37
Dumbarton,1654,10,8,12,16,46,59,-13,36
Hibernian,1655,1,19,10,7,58,30,28,67
Morton,1655,2,18,11,7,51,34,17,65
Falkirk,1655,3,16,10,10,61,41,20,58
Dundee Utd,1655,4,15,12,9,47,36,11,57
Queen of S't,1655,5,12,9,15,46,54,-8,45
Dumbarton,1655,6,10,12,14,49,57,-8,42
Dunfermline,1655,7,9,12,15,49,56,-7,39
Ayr,1655,8,8,15,13,32,49,-17,39
Raith,1655,9,9,10,17,32,49,-17,37
St Mirren,1655,10,8,11,17,35,54,-19,35
Hibernian,1656,1,21,12,3,64,24,40,75
Morton,1656,2,15,15,6,53,40,13,60
Dundee Utd,1656,3,16,10,10,54,40,14,58
Falkirk,1656,4,16,9,11,56,42,14,57
Dumbarton,1656,5,10,12,14,53,63,-10,42
Dunfermline,1656,6,10,11,15,48,52,-4,41
Raith,1656,7,10,11,15,35,47,-12,41
Queen of S't,1656,8,10,10,16,43,58,-15,40
St Mirren,1656,9,8,11,17,39,56,-17,35
Ayr,1656,10,7,13,16,35,58,-23,34
Hibernian,1657,1,21,11,4,60,22,38,74
Morton,1657,2,17,12,7,51,41,10,63
Falkirk,1657,3,16,11,9,63,43,20,59
Dundee Utd,1657,4,14,12,10,52,43,9,54
Queen of S't,1657,5,11,10,15,46,54,-8,43
Ayr,1657,6,11,10,15,44,61,-17,43
St Mirren,1657,7,10,10,16,42,55,-13,40
Raith,1657,8,10,9,17,36,50,-14,39
Dumbarton,1657,9,8,12,16,47,59,-12,36
Dunfermline,1657,10,8,11,17,41,54,-13,35
Hibernian,1658,1,23,10,3,63,21,42,79
Morton,1658,2,17,10,9,54,43,11,61
Falkirk,1658,3,16,11,9,60,40,20,59
Dundee Utd,1658,4,16,10,10,54,40,14,58
Queen of S't,1658,5,12,9,15,46,52,-6,45
Dumbarton,1658,6,10,12,14,51,59,-8,42
Raith,1658,7,10,10,16,37,52,-15,40
St Mirren,1658,8,8,13,15,43,53,-10,37
Dunfermline,1658,9,8,12,16,46,59,-13,36
Ayr,1658,10,6,11,19,31,66,-35,29
Hibernian,1659,1,18,11,7,50,25,25,65
Falkirk,1659,2,16,11,9,54,36,18,59
Dundee Utd,1659,3,17,8,11,50,39,11,59
Morton,1659,4,14,12,10,47,44,3,54
Queen of S't,1659,5,13,10,13,49,50,-1,49
Dunfermline,1659,6,11,13,12,50,45,5,46
Raith,1659,7,10,10,16,33,48,-15,40
Ayr,1659,8,9,13,14,38,55,-17,40
Dumbarton,1659,9,9,12,15,49,58,-9,39
St Mirren,1659,10,7,12,17,36,56,-20,33
Hibernian,1660,1,19,13,4,57,25,32,70
Falkirk,1660,2,16,12,8,59,39,20,60
Dundee Utd,1660,3,17,9,10,51,40,11,60
Morton,1660,4,14,14,8,45,36,9,56
Raith,1660,5,10,12,14,36,48,-12,42
Queen of S't,1660,6,10,11,15,44,52,-8,41
Dumbarton,1660,7,9,12,15,50,60,-10,39
St Mirren,1660,8,9,12,15,42,53,-11,39
Dunfermline,1660,9,7,16,13,42,51,-9,37
Ayr,1660,10,7,13,16,36,58,-22,34
Hibernian,1661,1,20,12,4,60,25,35,72
Dundee Utd,1661,2,16,10,10,47,37,10,58
Morton,1661,3,13,15,8,47,38,9,54
Falkirk,1661,4,14,11,11,51,40,11,53
Queen of S't,1661,5,13,8,15,46,51,-5,47
Raith,1661,6,11,11,14,36,46,-10,44
Dunfermline,1661,7,9,14,13,44,50,-6,41
St Mirren,1661,8,10,10,16,41,53,-12,40
Dumbarton,1661,9,9,12,15,46,57,-11,39
Ayr,1661,10,7,13,16,32,53,-21,34
Hibernian,1662,1,19,13,4,55,22,33,70
Dundee Utd,1662,2,19,8,9,59,40,19,65
Morton,1662,3,17,12,7,49,36,13,63
Falkirk,1662,4,16,11,9,63,41,22,59
Queen of S't,1662,5,12,10,14,48,49,-1,46
Dunfermline,1662,6,10,12,14,45,48,-3,42
Dumbarton,1662,7,9,12,15,49,61,-12,39
Ayr,1662,8,8,12,16,33,57,-24,36
Raith,1662,9,8,10,18,33,54,-21,34
St Mirren,1662,10,7,10,19,39,65,-26,31
Morton,1663,1,19,11,6,49,30,19,68
Hibernian,1663,2,18,13,5,56,25,31,67
Falkirk,1663,3,17,9,10,63,46,17,60
Dundee Utd,1663,4,15,10,11,49,40,9,55
Dumbarton,1663,5,11,10,15,49,56,-7,43
Ayr,1663,6,11,10,15,32,51,-19,43
Queen of S't,1663,7,11,9,16,46,51,-5,42
Dunfermline,1663,8,10,12,14,46,53,-7,42
Raith,1663,9,9,9,18,30,48,-18,36
St Mirren,1663,10,8,9,19,37,57,-20,33
Hibernian,1664,1,19,11,6,53,28,25,68
Dundee Utd,1664,2,17,9,10,51,40,11,60
Morton,1664,3,16,12,8,46,35,11,60
Falkirk,1664,4,15,9,12,55,44,11,54
Dunfermline,1664,5,13,12,11,48,41,7,51
Queen of S't,1664,6,12,8,16,47,51,-4,44
Raith,1664,7,11,8,17,37,49,-12,41
St Mirren,1664,8,10,9,17,44,54,-10,39
Ayr,1664,9,9,11,16,32,57,-25,38
Dumbarton,1664,10,8,11,17,45,59,-14,35
Hibernian,1665,1,19,14,3,58,24,34,71
Morton,1665,2,17,12,7,51,37,14,63
Falkirk,1665,3,16,12,8,61,40,21,60
Dundee Utd,1665,4,14,9,13,45,45,0,51
Queen of S't,1665,5,13,8,15,46,51,-5,47
Raith,1665,6,11,9,16,34,45,-11,42
Dunfermline,1665,7,9,14,13,45,48,-3,41
Ayr,1665,8,9,11,16,34,52,-18,38
St Mirren,1665,9,9,10,17,41,55,-14,37
Dumbarton,1665,10,8,11,17,46,64,-18,35
Hibernian,1666,1,17,14,5,52,28,24,65
Morton,1666,2,16,11,9,52,41,11,59
Dundee Utd,1666,3,16,9,11,49,42,7,57
Falkirk,1666,4,14,12,10,56,41,15,54
Queen of S't,1666,5,13,8,15,44,48,-4,47
Dunfermline,1666,6,10,12,14,47,47,0,42
Dumbarton,1666,7,10,12,14,46,53,-7,42
St Mirren,1666,8,10,12,14,41,52,-11,42
Raith,1666,9,10,10,16,33,48,-15,40
Ayr,1666,10,7,14,15,31,51,-20,35
Hibernian,1667,1,19,12,5,56,28,28,69
Morton,1667,2,17,11,8,55,37,18,62
Falkirk,1667,3,15,12,9,57,39,18,57
Dundee Utd,1667,4,16,9,11,53,43,10,57
Dunfermline,1667,5,12,13,11,50,44,6,49
Queen of S't,1667,6,11,11,14,45,48,-3,44
Ayr,1667,7,9,13,14,35,54,-19,40
Raith,1667,8,9,9,18,32,55,-23,36
St Mirren,1667,9,7,13,16,44,58,-14,34
Dumbarton,1667,10,7,13,16,45,66,-21,34
Hibernian,1668,1,18,12,6,56,32,24,66
Morton,1668,2,17,9,10,50,42,8,60
Falkirk,1668,3,16,10,10,55,41,14,58
Dundee Utd,1668,4,15,11,10,47,37,10,56
Queen of S't,1668,5,13,11,12,44,44,0,50
Raith,1668,6,10,11,15,38,49,-11,41
Ayr,1668,7,9,13,14,35,51,-16,40
Dunfermline,1668,8,9,12,15,41,48,-7,39
Dumbarton,1668,9,9,11,16,49,57,-8,38
St Mirren,1668,10,9,10,17,44,58,-14,37
Hibernian,1669,1,17,14,5,50,23,27,65
Morton,1669,2,16,12,8,50,40,10,60
Dundee Utd,1669,3,16,11,9,54,43,11,59
Falkirk,1669,4,13,13,10,53,45,8,52
Queen of S't,1669,5,12,11,13,47,47,0,47
Raith,1669,6,12,8,16,40,49,-9,44
Ayr,1669,7,10,12,14,36,53,-17,42
Dunfermline,1669,8,8,13,15,46,50,-4,37
Dumbarton,1669,9,8,13,15,51,61,-10,37
St Mirren,1669,10,8,13,15,39,55,-16,37
Hibernian,1670,1,19,12,5,58,26,32,69
Morton,1670,2,16,12,8,54,42,12,60
Falkirk,1670,3,16,10,10,56,42,14,58
Dundee Utd,1670,4,15,12,9,54,43,11,57
Dunfermline,1670,5,12,12,12,49,47,2,48
Queen of S't,1670,6,11,11,14,42,48,-6,44
Raith,1670,7,11,9,16,33,46,-13,42
Dumbarton,1670,8,10,10,16,48,58,-10,40
St Mirren,1670,9,8,10,18,40,57,-17,34
Ayr,1670,10,7,12,17,34,59,-25,33
Morton,1671,1,20,10,6,59,38,21,70
Hibernian,1671,2,18,14,4,53,25,28,68
Falkirk,1671,3,17,9,10,56,42,14,60
Dundee Utd,1671,4,15,9,12,48,44,4,54
Dunfermline,1671,5,11,12,13,52,51,1,45
Queen of S't,1671,6,11,10,15,45,51,-6,43
St Mirren,1671,7,10,9,17,46,56,-10,39
Raith,1671,8,10,8,18,40,58,-18,38
Ayr,1671,9,8,13,15,38,57,-19,37
Dumbarton,1671,10,8,10,18,47,62,-15,34
Hibernian,1672,1,21,12,3,58,23,35,75
Falkirk,1672,2,15,12,9,58,42,16,57
Morton,1672,3,15,10,11,46,41,5,55
Dundee Utd,1672,4,15,9,12,49,44,5,54
Dunfermline,1672,5,11,14,11,53,46,7,47
Ayr,1672,6,11,12,13,37,53,-16,45
Dumbarton,1672,7,10,11,15,50,56,-6,41
Queen of S't,1672,8,10,11,15,46,56,-10,41
St Mirren,1672,9,8,11,17,39,55,-16,35
Raith,1672,10,8,10,18,31,51,-20,34
Hibernian,1673,1,21,11,4,58,25,33,74
Falkirk,1673,2,16,11,9,56,38,18,59
Dundee Utd,1673,3,16,10,10,46,38,8,58
Morton,1673,4,15,11,10,48,41,7,56
Dunfermline,1673,5,10,14,12,47,48,-1,44
Queen of S't,1673,6,11,9,16,43,50,-7,42
St Mirren,1673,7,10,11,15,41,50,-9,41
Raith,1673,8,10,10,16,36,47,-11,40
Dumbarton,1673,9,9,11,16,49,58,-9,38
Ayr,1673,10,7,12,17,30,59,-29,33
Hibernian,1674,1,21,12,3,59,26,33,75
Falkirk,1674,2,17,10,9,61,42,19,61
Morton,1674,3,17,10,9,53,39,14,61
Dundee Utd,1674,4,14,9,13,47,44,3,51
Raith,1674,5,12,10,14,42,48,-6,46
Ayr,1674,6,10,12,14,34,49,-15,42
Queen of S't,1674,7,10,11,15,46,53,-7,41
Dunfermline,1674,8,9,12,15,43,53,-10,39
Dumbarton,1674,9,9,10,17,43,56,-13,37
St Mirren,1674,10,7,12,17,41,59,-18,33
Morton,1675,1,18,11,7,49,33,16,65
Hibernian,1675,2,16,12,8,48,29,19,60
Dundee Utd,1675,3,17,9,10,52,38,14,60
Falkirk,1675,4,16,9,11,60,46,14,57
Raith,1675,5,13,9,14,40,47,-7,48
Queen of S't,1675,6,12,9,15,47,54,-7,45
Dunfermline,1675,7,11,11,14,48,49,-1,44
Ayr,1675,8,10,11,15,37,52,-15,41
Dumbarton,1675,9,9,11,16,46,59,-13,38
St Mirren,1675,10,7,10,19,40,60,-20,31
Hibernian,1676,1,17,13,6,54,33,21,64
Falkirk,1676,2,17,11,8,59,41,18,62
Morton,1676,3,16,11,9,54,40,14,59
Dundee Utd,1676,4,14,10,12,46,40,6,52
Dunfermline,1676,5,12,12,12,47,46,1,48
Raith,1676,6,11,11,14,37,45,-8,44
Queen of S't,1676,7,10,12,14,45,53,-8,42
Dumbarton,1676,8,9,11,16,47,57,-10,38
St Mirren,1676,9,8,13,15,39,52,-13,37
Ayr,1676,10,8,12,16,36,57,-21,36
Hibernian,1677,1,19,14,3,54,23,31,71
Dundee Utd,1677,2,18,10,8,59,42,17,64
Falkirk,1677,3,17,10,9,60,40,20,61
Morton,1677,4,15,11,10,47,38,9,56
Queen of S't,1677,5,12,10,14,49,49,0,46
Dunfermline,1677,6,9,14,13,45,49,-4,41
Raith,1677,7,10,10,16,37,52,-15,40
Ayr,1677,8,9,10,17,33,55,-22,37
Dumbarton,1677,9,8,11,17,48,66,-18,35
St Mirren,1677,10,8,10,18,44,62,-18,34
Hibernian,1678,1,21,12,3,59,23,36,75
Falkirk,1678,2,18,11,7,66,41,25,65
Morton,1678,3,18,10,8,53,39,14,64
Dundee Utd,1678,4,15,10,11,45,40,5,55
Dunfermline,1678,5,9,12,15,48,52,-4,39
Dumbarton,1678,6,9,12,15,49,58,-9,39
Raith,1678,7,10,9,17,41,55,-14,39
Ayr,1678,8,9,12,15,34,58,-24,39
Queen of S't,1678,9,10,8,18,42,55,-13,38
St Mirren,1678,10,7,12,17,44,60,-16,33
Hibernian,1679,1,21,12,3,58,22,36,75
Morton,1679,2,15,13,8,48,36,12,58
Dundee Utd,1679,3,15,11,10,49,38,11,56
Falkirk,1679,4,15,10,11,54,42,12,55
Dunfermline,1679,5,10,14,12,49,54,-5,44
Queen of S't,1679,6,11,10,15,42,49,-7,43
Dumbarton,1679,7,10,11,15,50,64,-14,41
Raith,1679,8,10,10,16,36,47,-11,40
Ayr,1679,9,7,15,14,31,54,-23,36
St Mirren,1679,10,8,10,18,43,54,-11,34
Hibernian,1680,1,21,10,5,62,27,35,73
Falkirk,1680,2,17,10,9,58,40,18,61
Morton,1680,3,17,10,9,57,44,13,61
Dundee Utd,1680,4,16,9,11,59,44,15,57
Dunfermline,1680,5,12,12,12,51,47,4,48
Queen of S't,1680,6,12,9,15,45,52,-7,45
Raith,1680,7,11,8,17,36,50,-14,41
Ayr,1680,8,9,10,17,35,58,-23,37
St Mirren,1680,9,8,10,18,41,66,-25,34
Dumbarton,1680,10,7,12,17,43,59,-16,33
Hibernian,1681,1,18,12,6,52,27,25,66
Dundee Utd,1681,2,17,10,9,54,37,17,61
Morton,1681,3,16,12,8,49,36,13,60
Falkirk,1681,4,16,10,10,58,40,18,58
Dunfermline,1681,5,12,12,12,48,47,1,48
Queen of S't,1681,6,10,12,14,42,49,-7,42
St Mirren,1681,7,10,10,16,42,54,-12,40
Dumbarton,1681,8,9,12,15,46,57,-11,39
Raith,1681,9,8,11,17,33,51,-18,35
Ayr,1681,10,8,11,17,32,58,-26,35
Hibernian,1682,1,18,15,3,55,25,30,69
Dundee Utd,1682,2,16,10,10,49,38,11,58
Falkirk,1682,3,14,13,9,58,43,15,55
Morton,1682,4,13,12,11,44,42,2,51
Dunfermline,1682,5,11,14,11,47,44,3,47
Queen of S't,1682,6,10,12,14,42,51,-9,42
Raith,1682,7,10,11,15,36,48,-12,41
Dumbarton,1682,8,9,13,14,48,54,-6,40
Ayr,1682,9,9,12,15,40,56,-16,39
St Mirren,1682,10,8,12,16,40,58,-18,36
Hibernian,1683,1,18,13,5,57,29,28,67
Morton,1683,2,17,11,8,49,39,10,62
Dundee Utd,1683,3,17,9,10,49,37,12,60
Falkirk,1683,4,15,11,10,55,41,14,56
Queen of S't,1683,5,12,9,15,45,49,-4,45
Dunfermline,1683,6,10,13,13,46,49,-3,43
Raith,1683,7,10,11,15,38,54,-16,41
St Mirren,1683,8,10,9,17,42,51,-9,39
Ayr,1683,9,8,13,15,34,51,-17,37
Dumbarton,1683,10,8,11,17,45,60,-15,35
Hibernian,1684,1,17,12,7,56,29,27,63
Morton,1684,2,17,11,8,53,38,15,62
Falkirk,1684,3,16,11,9,59,39,20,59
Dundee Utd,1684,4,14,12,10,49,44,5,54
Queen of S't,1684,5,14,9,13,49,51,-2,51
Dunfermline,1684,6,11,12,13,50,47,3,45
St Mirren,1684,7,11,10,15,45,54,-9,43
Raith,1684,8,11,8,17,38,55,-17,41
Dumbarton,1684,9,8,11,17,44,62,-18,35
Ayr,1684,10,7,12,17,34,58,-24,33
Hibernian,1685,1,19,11,6,53,27,26,68
Dundee Utd,1685,2,18,9,9,52,41,11,63
Morton,1685,3,16,11,9,47,37,10,59
Falkirk,1685,4,15,11,10,59,43,16,56
Dunfermline,1685,5,12,13,11,49,44,5,49
Queen of S't,1685,6,12,9,15,49,53,-4,45
Raith,1685,7,12,9,15,40,51,-11,45
Dumbarton,1685,8,7,13,16,47,61,-14,34
Ayr,1685,9,8,10,18,33,55,-22,34
St Mirren,1685,10,7,12,17,39,56,-17,33
Hibernian,1686,1,20,11,5,57,27,30,71
Morton,1686,2,17,10,9,53,42,11,61
Dundee Utd,1686,3,15,11,10,51,42,9,56
Falkirk,1686,4,15,10,11,56,44,12,55
Queen of S't,1686,5,11,11,14,43,49,-6,44
Dunfermline,1686,6,9,14,13,48,48,0,41
Dumbarton,1686,7,10,11,15,43,56,-13,41
Raith,1686,8,10,10,16,34,48,-14,40
Ayr,1686,9,9,12,15,39,55,-16,39
St Mirren,1686,10,8,12,16,45,58,-13,36
Hibernian,1687,1,20,11,5,56,27,29,71
Falkirk,1687,2,17,10,9,61,40,21,61
Morton,1687,3,16,12,8,52,39,13,60
Dundee Utd,1687,4,15,9,12,47,42,5,54
Queen of S't,1687,5,12,8,16,41,50,-9,44
Dunfermline,1687,6,10,13,13,46,48,-2,43
Dumbarton,1687,7,10,12,14,52,57,-5,42
Raith,1687,8,10,11,15,36,51,-15,41
Ayr,1687,9,9,10,17,35,57,-22,37
St Mirren,1687,10,8,10,18,41,56,-15,34
Hibernian,1688,1,21,12,3,60,25,35,75
Dundee Utd,1688,2,17,11,8,57,39,18,62
Morton,1688,3,16,12,8,50,39,11,60
Falkirk,1688,4,14,11,11,53,41,12,53
Dunfermline,1688,5,11,13,12,48,45,3,46
Queen of S't,1688,6,12,10,14,47,48,-1,46
Raith,1688,7,10,11,15,33,46,-13,41
St Mirren,1688,8,8,12,16,37,53,-16,36
Dumbarton,1688,9,8,10,18,42,64,-22,34
Ayr,1688,10,6,12,18,31,58,-27,30
Hibernian,1689,1,18,12,6,53,28,25,66
Morton,1689,2,17,10,9,51,37,14,61
Falkirk,1689,3,16,10,10,56,38,18,58
Dundee Utd,1689,4,14,11,11,48,42,6,53
Queen of S't,1689,5,14,9,13,46,48,-2,51
Dumbarton,1689,6,11,11,14,48,53,-5,44
Raith,1689,7,12,8,16,37,49,-12,44
Dunfermline,1689,8,8,15,13,41,45,-4,39
St Mirren,1689,9,9,11,16,41,55,-14,38
Ayr,1689,10,6,13,17,32,58,-26,31
Hibernian,1690,1,19,12,5,55,23,32,69
Morton,1690,2,17,12,7,51,40,11,63
Falkirk,1690,3,17,9,10,64,44,20,60
Dundee Utd,1690,4,16,12,8,56,42,14,60
Dunfermline,1690,5,14,12,10,54,42,12,54
Queen of S't,1690,6,10,9,17,43,56,-13,39
Raith,1690,7,9,10,17,36,53,-17,37
Ayr,1690,8,7,14,15,37,59,-22,35
Dumbarton,1690,9,7,13,16,49,62,-13,34
St Mirren,1690,10,7,11,18,40,64,-24,32
Hibernian,1691,1,20,12,4,57,24,33,72
Falkirk,1691,2,17,10,9,59,41,18,61
Morton,1691,3,16,13,7,53,37,16,61
Dundee Utd,1691,4,17,9,10,55,43,12,60
Queen of S't,1691,5,13,10,13,47,46,1,49
Raith,1691,6,9,12,15,32,44,-12,39
Dumbarton,1691,7,9,11,16,47,61,-14,38
St Mirren,1691,8,9,10,17,40,54,-14,37
Dunfermline,1691,9,7,13,16,42,53,-11,34
Ayr,1691,10,7,12,17,30,59,-29,33
Hibernian,1692,1,18,12,6,55,28,27,66
Morton,1692,2,18,11,7,54,37,17,65
Falkirk,1692,3,16,10,10,56,40,16,58
Dundee Utd,1692,4,14,13,9,54,41,13,55
Raith,1692,5,12,10,14,39,46,-7,46
Queen of S't,1692,6,11,9,16,44,54,-10,42
Ayr,1692,7,9,14,13,39,56,-17,41
Dunfermline,1692,8,8,14,14,42,48,-6,38
St Mirren,1692,9,9,11,16,43,57,-14,38
Dumbarton,1692,10,8,10,18,44,63,-19,34
Hibernian,1693,1,17,13,6,51,28,23,64
Morton,1693,2,17,13,6,48,32,16,64
Falkirk,1693,3,15,11,10,58,45,13,56
Dundee Utd,1693,4,15,10,11,50,43,7,55
Raith,1693,5,13,9,14,37,45,-8,48
Queen of S't,1693,6,12,10,14,45,47,-2,46
Dumbarton,1693,7,11,10,15,51,55,-4,43
Dunfermline,1693,8,10,12,14,45,48,-3,42
Ayr,1693,9,8,13,15,34,53,-19,37
St Mirren,1693,10,6,11,19,38,61,-23,29
Morton,1694,1,19,9,8,53,36,17,66
Hibernian,1694,2,18,11,7,55,28,27,65
Falkirk,1694,3,16,11,9,61,40,21,59
Dundee Utd,1694,4,15,9,12,48,41,7,54
Dunfermline,1694,5,12,11,13,46,45,1,47
Queen of S't,1694,6,12,10,14,49,53,-4,46
Ayr,1694,7,11,11,14,36,53,-17,44
Dumbarton,1694,8,9,10,17,48,62,-14,37
Raith,1694,9,9,9,18,34,50,-16,36
St Mirren,1694,10,9,9,18,39,61,-22,36
Hibernian,1695,1,20,13,3,56,23,33,73
Falkirk,1695,2,16,11,9,53,38,15,59
Morton,1695,3,15,13,8,49,37,12,58
Dundee Utd,1695,4,16,10,10,46,37,9,58
Queen of S't,1695,5,11,10,15,43,47,-4,43
Dunfermline,1695,6,10,12,14,50,51,-1,42
Ayr,1695,7,10,12,14,36,56,-20,42
St Mirren,1695,8,10,11,15,44,52,-8,41
Raith,1695,9,9,9,18,34,52,-18,36
Dumbarton,1695,10,7,11,18,42,60,-18,32
Hibernian,1696,1,17,13,6,56,33,23,64
Morton,1696,2,17,11,8,54,40,14,62
Falkirk,1696,3,16,11,9,61,45,16,59
Dundee Utd,1696,4,15,11,10,47,38,9,56
Dunfermline,1696,5,11,12,13,51,52,-1,45
Dumbarton,1696,6,10,14,12,53,57,-4,44
Queen of S't,1696,7,11,10,15,45,51,-6,43
Raith,1696,8,10,11,15,42,52,-10,41
Ayr,1696,9,7,15,14,38,56,-18,36
St Mirren,1696,10,6,12,18,39,62,-23,30
Falkirk,1697,1,18,10,8,63,38,25,64
Hibernian,1697,2,17,13,6,53,29,24,64
Morton,1697,3,17,11,8,50,36,14,62
Dundee Utd,1697,4,17,8,11,56,43,13,59
Queen of S't,1697,5,15,8,13,54,49,5,53
Dunfermline,1697,6,10,14,12,47,47,0,44
Raith,1697,7,9,9,18,37,56,-19,36
St Mirren,1697,8,8,11,17,44,60,-16,35
Dumbarton,1697,9,8,11,17,47,70,-23,35
Ayr,1697,10,8,11,17,35,58,-23,35
Hibernian,1698,1,21,10,5,62,26,36,73
Morton,1698,2,18,9,9,50,36,14,63
Falkirk,1698,3,15,11,10,60,44,16,56
Dundee Utd,1698,4,15,9,12,45,43,2,54
Dunfermline,1698,5,11,12,13,45,46,-1,45
Queen of S't,1698,6,11,10,15,43,51,-8,43
Dumbarton,1698,7,10,11,15,51,57,-6,41
Raith,1698,8,10,11,15,32,47,-15,41
St Mirren,1698,9,9,10,17,38,55,-17,37
Ayr,1698,10,8,11,17,34,55,-21,35
Hibernian,1699,1,17,16,3,57,29,28,67
Morton,1699,2,17,12,7,56,41,15,63
Falkirk,1699,3,17,11,8,58,38,20,62
Dundee Utd,1699,4,17,9,10,53,41,12,60
Queen of S't,1699,5,11,11,14,42,48,-6,44
Dunfermline,1699,6,8,14,14,41,46,-5,38
St Mirren,1699,7,9,11,16,41,53,-12,38
Ayr,1699,8,8,13,15,35,57,-22,37
Dumbarton,1699,9,7,14,15,47,59,-12,35
Raith,1699,10,8,11,17,33,51,-18,35
Dundee Utd,1700,1,20,8,8,62,36,26,68
Hibernian,1700,2,18,13,5,61,29,32,67
Falkirk,1700,3,17,9,10,60,46,14,60
Morton,1700,4,16,11,9,54,43,11,59
Raith,1700,5,13,9,14,42,48,-6,48
Queen of S't,1700,6,11,9,16,46,56,-10,42
Dunfermline,1700,7,9,13,14,47,52,-5,40
Dumbarton,1700,8,9,10,17,48,64,-16,37
St Mirren,1700,9,9,10,17,42,61,-19,37
Ayr,1700,10,7,10,19,33,60,-27,31
Hibernian,1701,1,18,13,5,52,25,27,67
Morton,1701,2,18,12,6,49,32,17,66
Falkirk,1701,3,16,11,9,58,43,15,59
Dundee Utd,1701,4,15,11,10,48,41,7,56
Dunfermline,1701,5,11,12,13,45,45,0,45
Queen of S't,1701,6,11,10,15,43,52,-9,43
Dumbarton,1701,7,10,12,14,49,52,-3,42
Raith,1701,8,9,10,17,32,48,-16,37
St Mirren,1701,9,8,11,17,38,54,-16,35
Ayr,1701,10,8,10,18,35,57,-22,34
Hibernian,1702,1,20,12,4,59,27,32,72
Dundee Utd,1702,2,17,9,10,52,36,16,60
Falkirk,1702,3,16,11,9,55,39,16,59
Morton,1702,4,15,9,12,46,43,3,54
Dunfermline,1702,5,11,12,13,50,48,2,45
Queen of S't,1702,6,12,9,15,46,51,-5,45
Dumbarton,1702,7,9,13,14,45,55,-10,40
Raith,1702,8,10,10,16,37,51,-14,40
Ayr,1702,9,9,10,17,36,59,-23,37
St Mirren,1702,10,8,11,17,39,56,-17,35
Hibernian,1703,1,20,12,4,58,27,31,72
Falkirk,1703,2,16,10,10,60,41,19,58
Dundee Utd,1703,3,15,11,10,53,41,12,56
Morton,1703,4,14,14,8,46,38,8,56
Dunfermline,1703,5,10,15,11,44,44,0,45
Queen of S't,1703,6,12,9,15,47,51,-4,45
Ayr,1703,7,9,14,13,35,50,-15,41
Raith,1703,8,10,10,16,38,54,-16,40
Dumbarton,1703,9,8,13,15,51,65,-14,37
St Mirren,1703,10,6,12,18,43,64,-21,30
Hibernian,1704,1,21,11,4,58,23,35,74
Dundee Utd,1704,2,16,11,9,52,37,15,59
Morton,1704,3,15,12,9,46,39,7,57
Falkirk,1704,4,15,10,11,57,45,12,55
Queen of S't,1704,5,12,8,16,49,47,2,44
Dunfermline,1704,6,9,15,12,43,51,-8,42
Ayr,1704,7,10,11,15,33,52,-19,41
Raith,1704,8,10,10,16,33,46,-13,40
Dumbarton,1704,9,8,13,15,51,66,-15,37
St Mirren,1704,10,8,11,17,42,58,-16,35
Hibernian,1705,1,21,11,4,62,25,37,74
Falkirk,1705,2,15,13,8,59,42,17,58
Dundee Utd,1705,3,16,10,10,51,42,9,58
Morton,1705,4,14,12,10,49,43,6,54
Dunfermline,1705,5,12,12,12,52,48,4,48
Queen of S't,1705,6,11,9,16,46,55,-9,42
Raith,1705,7,11,9,16,37,52,-15,42
Ayr,1705,8,9,12,15,38,55,-17,39
Dumbarton,1705,9,9,10,17,47,60,-13,37
St Mirren,1705,10,8,10,18,40,59,-19,34
Hibernian,1706,1,18,15,3,53,24,29,69
Dundee Utd,1706,2,18,10,8,56,38,18,64
Falkirk,1706,3,17,10,9,65,42,23,61
Morton,1706,4,15,12,9,45,39,6,57
Queen of S't,1706,5,10,12,14,46,52,-6,42
Dunfermline,1706,6,10,11,15,45,49,-4,41
Raith,1706,7,10,10,16,38,56,-18,40
Dumbarton,1706,8,9,11,16,46,57,-11,38
St Mirren,1706,9,9,11,16,43,55,-12,38
Ayr,1706,10,7,12,17,35,60,-25,33
Hibernian,1707,1,19,13,4,57,28,29,70
Morton,1707,2,17,11,8,47,33,14,62
Falkirk,1707,3,15,12,9,57,40,17,57
Dundee Utd,1707,4,14,12,10,51,43,8,54
Dunfermline,1707,5,11,13,12,51,49,2,46
Ayr,1707,6,11,11,14,43,53,-10,44
St Mirren,1707,7,9,12,15,44,54,-10,39
Dumbarton,1707,8,8,14,14,45,55,-10,38
Queen of S't,1707,9,9,10,17,41,58,-17,37
Raith,1707,10,9,8,19,33,56,-23,35
Hibernian,1708,1,20,12,4,57,24,33,72
Falkirk,1708,2,18,11,7,63,38,25,65
Morton,1708,3,16,12,8,53,41,12,60
Dundee Utd,1708,4,14,11,11,49,44,5,53
Dumbarton,1708,5,12,10,14,54,59,-5,46
Queen of S't,1708,6,12,9,15,47,53,-6,45
Raith,1708,7,10,9,17,37,53,-16,39
Ayr,1708,8,9,11,16,37,56,-19,38
Dunfermline,1708,9,8,13,15,41,50,-9,37
St Mirren,1708,10,7,10,19,36,56,-20,31
Hibernian,1709,1,20,12,4,64,33,31,72
Morton,1709,2,17,11,8,56,37,19,62
Falkirk,1709,3,16,11,9,60,42,18,59
Dundee Utd,1709,4,15,10,11,46,40,6,55
Queen of S't,1709,5,11,10,15,46,51,-5,43
St Mirren,1709,6,9,12,15,45,51,-6,39
Ayr,1709,7,9,12,15,30,49,-19,39
Raith,1709,8,10,9,17,33,58,-25,39
Dunfermline,1709,9,8,14,14,43,52,-9,38
Dumbarton,1709,10,9,11,16,47,57,-10,38
Hibernian,1710,1,20,12,4,61,24,37,72
Dundee Utd,1710,2,17,10,9,53,37,16,61
Morton,1710,3,14,14,8,47,41,6,56
Falkirk,1710,4,15,10,11,59,44,15,55
Queen of S't,1710,5,12,8,16,46,60,-14,44
Dunfermline,1710,6,10,12,14,46,46,0,42
Raith,1710,7,11,9,16,37,49,-12,42
Dumbarton,1710,8,9,14,13,50,58,-8,41
Ayr,1710,9,8,12,16,33,58,-25,36
St Mirren,1710,10,8,11,17,40,55,-15,35
Hibernian,1711,1,20,11,5,55,26,29,71
Morton,1711,2,18,11,7,51,33,18,65
Falkirk,1711,3,18,9,9,61,39,22,63
Dundee Utd,1711,4,15,9,12,48,41,7,54
Queen of S't,1711,5,12,9,15,47,53,-6,45
Dunfermline,1711,6,11,11,14,46,48,-2,44
St Mirren,1711,7,10,10,16,43,54,-11,40
Dumbarton,1711,8,9,10,17,47,61,-14,37
Raith,1711,9,8,13,15,37,52,-15,37
Ayr,1711,10,7,11,18,33,61,-28,32
Hibernian,1712,1,18,13,5,58,29,29,67
Morton,1712,2,18,10,8,52,40,12,64
Falkirk,1712,3,16,12,8,60,39,21,60
Dundee Utd,1712,4,17,9,10,55,38,17,60
Raith,1712,5,12,10,14,41,48,-7,46
Queen of S't,1712,6,11,10,15,41,52,-11,43
Ayr,1712,7,10,10,16,35,54,-19,40
Dunfermline,1712,8,9,11,16,44,51,-7,38
Dumbarton,1712,9,8,13,15,45,57,-12,37
St Mirren,1712,10,7,10,19,37,60,-23,31
Hibernian,1713,1,20,11,5,63,26,37,71
Morton,1713,2,18,11,7,50,33,17,65
Dundee Utd,1713,3,16,9,11,50,37,13,57
Falkirk,1713,4,15,11,10,58,48,10,56
Dunfermline,1713,5,11,13,12,46,44,2,46
Queen of S't,1713,6,12,9,15,47,52,-5,45
Raith,1713,7,10,9,17,33,53,-20,39
Ayr,1713,8,8,13,15,35,54,-19,37
Dumbarton,1713,9,8,12,16,44,59,-15,36
St Mirren,1713,10,8,10,18,37,57,-20,34
Hibernian,1714,1,19,13,4,56,22,34,70
Falkirk,1714,2,16,10,10,57,42,15,58
Morton,1714,3,15,12,9,46,36,10,57
Dundee Utd,1714,4,15,10,11,50,44,6,55
Dunfermline,1714,5,11,13,12,50,50,0,46
St Mirren,1714,6,11,9,16,42,56,-14,42
Raith,1714,7,11,9,16,33,49,-16,42
Dumbarton,1714,8,10,11,15,50,59,-9,41
Queen of S't,1714,9,10,10,16,48,53,-5,40
Ayr,1714,10,8,11,17,33,54,-21,35
Hibernian,1715,1,18,12,6,55,29,26,66
Falkirk,1715,2,17,10,9,63,40,23,61
Morton,1715,3,16,11,9,56,44,12,59
Dundee Utd,1715,4,16,10,10,52,43,9,58
Queen of S't,1715,5,12,10,14,48,51,-3,46
Dunfermline,1715,6,10,15,11,48,48,0,45
Raith,1715,7,10,11,15,36,48,-12,41
Dumbarton,1715,8,9,11,16,45,57,-12,38
St Mirren,1715,9,8,11,17,41,58,-17,35
Ayr,1715,10,8,11,17,30,56,-26,35
Hibernian,1716,1,19,11,6,54,30,24,68
Morton,1716,2,17,10,9,51,38,13,61
Falkirk,1716,3,16,10,10,64,46,18,58
Dundee Utd,1716,4,13,10,13,47,46,1,49
Queen of S't,1716,5,13,10,13,51,52,-1,49
Dunfermline,1716,6,11,11,14,48,51,-3,44
Dumbarton,1716,7,11,11,14,56,60,-4,44
Raith,1716,8,10,10,16,32,47,-15,40
Ayr,1716,9,8,13,15,35,53,-18,37
St Mirren,1716,10,7,14,15,43,58,-15,35
Hibernian,1717,1,18,11,7,54,31,23,65
Morton,1717,2,18,10,8,59,35,24,64
Dundee Utd,1717,3,17,11,8,53,36,17,62
Falkirk,1717,4,14,12,10,55,41,14,54
Queen of S't,1717,5,13,9,14,51,50,1,48
Dunfermline,1717,6,10,12,14,46,53,-7,42
Raith,1717,7,10,10,16,34,48,-14,40
Ayr,1717,8,9,12,15,33,53,-20,39
Dumbarton,1717,9,9,11,16,43,61,-18,38
St Mirren,1717,10,7,12,17,39,59,-20,33
Hibernian,1718,1,17,15,4,50,25,25,66
Morton,1718,2,17,13,6,53,35,18,64
Falkirk,1718,3,17,9,10,62,41,21,60
Dundee Utd,1718,4,16,9,11,52,38,14,57
Dunfermline,1718,5,11,12,13,43,46,-3,45
Queen of S't,1718,6,12,8,16,47,52,-5,44
Dumbarton,1718,7,9,12,15,45,53,-8,39
St Mirren,1718,8,8,12,16,36,54,-18,36
Raith,1718,9,9,9,18,34,55,-21,36
Ayr,1718,10,7,15,14,36,59,-23,36
Hibernian,1719,1,21,12,3,60,24,36,75
Falkirk,1719,2,17,10,9,62,39,23,61
Dundee Utd,1719,3,16,10,10,54,42,12,58
Morton,1719,4,15,12,9,48,40,8,57
Queen of S't,1719,5,12,8,16,48,56,-8,44
Dunfermline,1719,6,9,14,13,46,49,-3,41
Raith,1719,7,10,9,17,33,50,-17,39
St Mirren,1719,8,9,11,16,41,53,-12,38
Dumbarton,1719,9,9,10,17,47,62,-15,37
Ayr,1719,10,9,10,17,35,59,-24,37
Morton,1720,1,17,13,6,48,33,15,64
Hibernian,1720,2,16,15,5,52,29,23,63
Falkirk,1720,3,16,11,9,58,39,19,59
Dundee Utd,1720,4,15,10,11,47,41,6,55
Queen of S't,1720,5,14,8,14,50,48,2,50
Dunfermline,1720,6,9,15,12,44,48,-4,42
Raith,1720,7,10,11,15,37,48,-11,41
Dumbarton,1720,8,8,13,15,48,57,-9,37
Ayr,1720,9,8,12,16,34,56,-22,36
St Mirren,1720,10,7,12,17,38,57,-19,33
Hibernian,1721,1,19,14,3,53,22,31,71
Morton,1721,2,18,11,7,53,33,20,65
Falkirk,1721,3,15,11,10,59,41,18,56
Dundee Utd,1721,4,15,11,10,48,40,8,56
Queen of S't,1721,5,12,9,15,46,51,-5,45
Raith,1721,6,11,10,15,36,49,-13,43
Dumbarton,1721,7,10,10,16,49,62,-13,40
Dunfermline,1721,8,8,13,15,42,52,-10,37
Ayr,1721,9,8,13,15,34,52,-18,37
St Mirren,1721,10,8,10,18,43,61,-18,34
Hibernian,1722,1,19,13,4,55,27,28,70
Falkirk,1722,2,16,11,9,60,42,18,59
Morton,1722,3,15,11,10,51,41,10,56
Dundee Utd,1722,4,14,11,11,51,50,1,53
Ayr,1722,5,11,12,13,42,52,-10,45
Dunfermline,1722,6,11,11,14,51,53,-2,44
Queen of S't,1722,7,10,11,15,41,49,-8,41
Raith,1722,8,10,11,15,35,48,-13,41
Dumbarton,1722,9,8,13,15,52,61,-9,37
St Mirren,1722,10,9,10,17,43,58,-15,37
Hibernian,1723,1,20,13,3,55,23,32,73
Dundee Utd,1723,2,17,11,8,52,37,15,62
Falkirk,1723,3,16,10,10,57,40,17,58
Morton,1723,4,16,10,10,52,38,14,58
Raith,1723,5,11,11,14,38,49,-11,44
Queen of S't,1723,6,11,10,15,44,51,-7,43
Dumbarton,1723,7,10,11,15,51,60,-9,41
Ayr,1723,8,8,12,16,34,59,-25,36
Dunfermline,1723,9,8,11,17,41,52,-11,35
St Mirren,1723,10,8,11,17,45,60,-15,35
Falkirk,1724,1,19,9,8,61,37,24,66
Dundee Utd,1724,2,19,9,8,55,37,18,66
Hibernian,1724,3,17,14,5,56,27,29,65
Morton,1724,4,15,13,8,48,40,8,58
Queen of S't,1724,5,11,10,15,46,52,-6,43
Raith,1724,6,11,10,15,38,51,-13,43
Dumbarton,1724,7,10,10,16,47,56,-9,40
Dunfermline,1724,8,8,14,14,43,48,-5,38
St Mirren,1724,9,9,9,18,40,57,-17,36
Ayr,1724,10,7,10,19,34,63,-29,31
Hibernian,1725,1,20,11,5,59,26,33,71
Dundee Utd,1725,2,17,9,10,54,39,15,60
Falkirk,1725,3,15,10,11,55,43,12,55
Morton,1725,4,15,9,12,46,45,1,54
Dunfermline,1725,5,12,12,12,51,47,4,48
Queen of S't,1725,6,12,10,14,44,46,-2,46
Dumbarton,1725,7,10,11,15,48,56,-8,41
Raith,1725,8,9,11,16,34,52,-18,38
Ayr,1725,9,9,11,16,34,57,-23,38
St Mirren,1725,10,9,10,17,41,55,-14,37
Hibernian,1726,1,19,11,6,52,28,24,68
Falkirk,1726,2,17,11,8,64,39,25,62
Morton,1726,3,16,12,8,48,36,12,60
Dundee Utd,1726,4,17,8,11,55,45,10,59
Queen of S't,1726,5,15,8,13,48,46,2,53
St Mirren,1726,6,9,11,16,43,57,-14,38
Dumbarton,1726,7,9,11,16,45,60,-15,38
Raith,1726,8,8,13,15,32,46,-14,37
Dunfermline,1726,9,8,12,16,42,52,-10,36
Ayr,1726,10,7,13,16,39,59,-20,34
Hibernian,1727,1,18,12,6,57,28,29,66
Falkirk,1727,2,19,9,8,59,36,23,66
Dundee Utd,1727,3,16,11,9,56,39,17,59
Morton,1727,4,16,11,9,54,40,14,59
Dunfermline,1727,5,12,12,12,49,47,2,48
Queen of S't,1727,6,11,11,14,43,47,-4,44
Raith,1727,7,10,10,16,37,54,-17,40
St Mirren,1727,8,9,10,17,40,58,-18,37
Dumbarton,1727,9,8,10,18,43,64,-21,34
Ayr,1727,10,7,12,17,34,59,-25,33
Hibernian,1728,1,20,11,5,62,26,36,71
Morton,1728,2,17,11,8,48,36,12,62
Falkirk,1728,3,17,10,9,60,44,16,61
Dundee Utd,1728,4,16,9,11,50,41,9,57
Queen of S't,1728,5,12,10,14,48,50,-2,46
Dunfermline,1728,6,10,13,13,44,45,-1,43
Dumbarton,1728,7,10,10,16,50,60,-10,40
Raith,1728,8,8,13,15,32,47,-15,37
St Mirren,1728,9,8,11,17,37,56,-19,35
Ayr,1728,10,8,10,18,33,59,-26,34
Hibernian,1729,1,19,11,6,51,22,29,68
Morton,1729,2,17,12,7,47,34,13,63
Falkirk,1729,3,14,14,8,57,41,16,56
Dundee Utd,1729,4,14,11,11,51,46,5,53
Queen of S't,1729,5,13,10,13,48,49,-1,49
Dunfermline,1729,6,11,13,12,47,45,2,46
Dumbarton,1729,7,9,15,12,49,55,-6,42
Raith,1729,8,9,11,16,38,54,-16,38
Ayr,1729,9,7,12,17,35,59,-24,33
St Mirren,1729,10,6,13,17,39,57,-18,31
Hibernian,1730,1,20,10,6,57,28,29,70
Morton,1730,2,19,10,7,55,38,17,67
Falkirk,1730,3,18,9,9,63,42,21,63
Dundee Utd,1730,4,16,10,10,55,42,13,58
Dunfermline,1730,5,10,13,13,50,50,0,43
Queen of S't,1730,6,11,9,16,44,53,-9,42
Dumbarton,1730,7,9,11,16,50,60,-10,38
Ayr,1730,8,8,14,14,38,57,-19,38
Raith,1730,9,9,8,19,33,55,-22,35
St Mirren,1730,10,8,10,18,42,62,-20,34
Hibernian,1731,1,19,11,6,55,27,28,68
Morton,1731,2,18,12,6,51,34,17,66
Falkirk,1731,3,17,10,9,61,39,22,61
Dundee Utd,1731,4,14,9,13,47,44,3,51
Queen of S't,1731,5,12,11,13,50,49,1,47
Raith,1731,6,13,8,15,40,46,-6,47
Dumbarton,1731,7,10,11,15,47,52,-5,41
Dunfermline,1731,8,8,13,15,41,52,-11,37
Ayr,1731,9,7,13,16,33,64,-31,34
St Mirren,1731,10,7,12,17,38,56,-18,33
Hibernian,1732,1,21,12,3,58,24,34,75
Morton,1732,2,17,10,9,51,39,12,61
Dundee Utd,1732,3,16,10,10,55,43,12,58
Falkirk,1732,4,14,11,11,57,45,12,53
Dunfermline,1732,5,10,15,11,50,49,1,45
Raith,1732,6,12,9,15,36,46,-10,45
Queen of S't,1732,7,10,10,16,38,46,-8,40
Ayr,1732,8,9,11,16,36,58,-22,38
St Mirren,1732,9,9,9,18,42,60,-18,36
Dumbarton,1732,10,8,11,17,43,56,-13,35
Hibernian,1733,1,19,12,5,54,25,29,69
Falkirk,1733,2,17,10,9,58,40,18,61
Morton,1733,3,16,13,7,46,33,13,61
Dundee Utd,1733,4,16,10,10,52,39,13,58
Queen of S't,1733,5,12,10,14,52,52,0,46
Ayr,1733,6,11,11,14,39,51,-12,44
Dumbarton,1733,7,9,12,15,46,55,-9,39
Dunfermline,1733,8,9,12,15,40,51,-11,39
St Mirren,1733,9,8,10,18,39,55,-16,34
Raith,1733,10,8,10,18,34,59,-25,34
Morton,1734,1,18,12,6,52,34,18,66
Hibernian,1734,2,17,14,5,52,30,22,65
Falkirk,1734,3,15,11,10,54,40,14,56
Dundee Utd,1734,4,13,11,12,46,44,2,50
Queen of S't,1734,5,12,10,14,47,49,-2,46
Dunfermline,1734,6,10,13,13,48,46,2,43
Dumbarton,1734,7,9,12,15,47,57,-10,39
Raith,1734,8,9,12,15,33,46,-13,39
Ayr,1734,9,9,12,15,36,52,-16,39
St Mirren,1734,10,9,11,16,41,58,-17,38
Hibernian,1735,1,19,14,3,56,25,31,71
Dundee Utd,1735,2,17,11,8,53,36,17,62
Falkirk,1735,3,16,10,10,64,47,17,58
Morton,1735,4,14,15,7,43,32,11,57
Dunfermline,1735,5,10,14,12,44,46,-2,44
Raith,1735,6,10,10,16,37,53,-16,40
St Mirren,1735,7,9,11,16,39,52,-13,38
Dumbarton,1735,8,8,13,15,46,59,-13,37
Ayr,1735,9,8,13,15,30,50,-20,37
Queen of S't,1735,10,9,9,18,40,52,-12,36
Hibernian,1736,1,20,11,5,62,29,33,71
Morton,1736,2,18,10,8,52,40,12,64
Falkirk,1736,3,17,10,9,64,42,22,61
Dundee Utd,1736,4,15,10,11,53,43,10,55
Raith,1736,5,13,9,14,38,44,-6,48
Ayr,1736,6,12,10,14,41,52,-11,46
Queen of S't,1736,7,12,9,15,45,52,-7,45
Dunfermline,1736,8,7,13,16,43,59,-16,34
Dumbarton,1736,9,7,12,17,47,61,-14,33
St Mirren,1736,10,7,10,19,39,62,-23,31
Hibernian,1737,1,20,12,4,54,24,30,72
Dundee Utd,1737,2,18,8,10,52,39,13,62
Falkirk,1737,3,16,10,10,55,42,13,58
Morton,1737,4,14,11,11,42,37,5,53
Dunfermline,1737,5,12,12,12,57,48,9,48
Raith,1737,6,11,10,15,39,50,-11,43
Queen of S't,1737,7,11,9,16,45,55,-10,42
Ayr,1737,8,9,11,16,35,54,-19,38
St Mirren,1737,9,8,12,16,40,55,-15,36
Dumbarton,1737,10,7,13,16,45,60,-15,34
Hibernian,1738,1,17,13,6,52,30,22,64
Morton,1738,2,17,11,8,47,35,12,62
Falkirk,1738,3,17,10,9,58,38,20,61
Dundee Utd,1738,4,16,10,10,50,36,14,58
Queen of S't,1738,5,12,10,14,41,46,-5,46
Ayr,1738,6,10,12,14,34,50,-16,42
Raith,1738,7,9,12,15,32,46,-14,39
Dunfermline,1738,8,8,14,14,41,48,-7,38
Dumbarton,1738,9,8,13,15,45,55,-10,37
St Mirren,1738,10,7,13,16,38,54,-16,34
Hibernian,1739,1,21,10,5,64,27,37,73
Dundee Utd,1739,2,17,10,9,56,40,16,61
Morton,1739,3,15,12,9,50,44,6,57
Falkirk,1739,4,14,10,12,54,43,11,52
Queen of S't,1739,5,13,9,14,41,46,-5,48
Dunfermline,1739,6,11,12,13,49,49,0,45
Dumbarton,1739,7,9,12,15,47,58,-11,39
Raith,1739,8,10,9,17,36,51,-15,39
St Mirren,1739,9,9,10,17,43,60,-17,37
Ayr,1739,10,7,14,15,34,56,-22,35
Hibernian,1740,1,21,10,5,60,27,33,73
Morton,1740,2,16,10,10,51,41,10,58
Falkirk,1740,3,14,13,9,54,39,15,55
Dundee Utd,1740,4,13,12,11,49,45,4,51
Dunfermline,1740,5,11,13,12,49,51,-2,46
Dumbarton,1740,6,11,11,14,52,56,-4,44
Queen of S't,1740,7,11,9,16,44,52,-8,42
Ayr,1740,8,10,12,14,42,53,-11,42
Raith,1740,9,10,10,16,35,53,-18,40
St Mirren,1740,10,7,12,17,38,57,-19,33
Hibernian,1741,1,19,13,4,60,30,30,70
Falkirk,1741,2,17,10,9,61,40,21,61
Morton,1741,3,16,12,8,51,36,15,60
Dundee Utd,1741,4,15,11,10,49,38,11,56
Dunfermline,1741,5,11,12,13,43,45,-2,45
Queen of S't,1741,6,11,11,14,45,50,-5,44
Raith,1741,7,10,10,16,36,50,-14,40
Ayr,1741,8,9,12,15,35,56,-21,39
Dumbarton,1741,9,8,11,17,46,62,-16,35
St Mirren,1741,10,8,10,18,39,58,-19,34
Hibernian,1742,1,21,12,3,57,24,33,75
Falkirk,1742,2,17,10,9,60,37,23,61
Morton,1742,3,14,14,8,47,37,10,56
Dundee Utd,1742,4,15,9,12,48,43,5,54
Dunfermline,1742,5,12,13,11,47,43,4,49
Queen of S't,1742,6,12,8,16,44,51,-7,44
Dumbarton,1742,7,10,11,15,48,57,-9,41
Raith,1742,8,9,9,18,33,51,-18,36
Ayr,1742,9,8,12,16,36,56,-20,36
St Mirren,1742,10,8,10,18,36,57,-21,34
Hibernian,1743,1,19,13,4,57,26,31,70
Morton,1743,2,16,12,8,49,36,13,60
Falkirk,1743,3,15,13,8,55,39,16,58
Dundee Utd,1743,4,16,10,10,50,39,11,58
Raith,1743,5,11,10,15,37,47,-10,43
Dunfermline,1743,6,9,13,14,43,48,-5,40
St Mirren,1743,7,10,10,16,40,51,-11,40
Queen of S't,1743,8,10,10,16,44,60,-16,40
Dumbarton,1743,9,9,12,15,51,58,-7,39
Ayr,1743,10,7,13,16,30,52,-22,34
Hibernian,1744,1,22,11,3,62,25,37,77
Morton,1744,2,15,14,7,50,36,14,59
Falkirk,1744,3,15,11,10,58,41,17,56
Dundee Utd,1744,4,15,10,11,48,44,4,55
Dunfermline,1744,5,10,12,14,46,52,-6,42
Queen of S't,1744,6,11,9,16,42,51,-9,42
Raith,1744,7,10,11,15,37,49,-12,41
Dumbarton,1744,8,9,12,15,48,58,-10,39
St Mirren,1744,9,8,12,16,45,59,-14,36
Ayr,1744,10,7,14,15,35,56,-21,35
Hibernian,1745,1,19,13,4,53,26,27,70
Morton,1745,2,17,11,8,52,38,14,62
Falkirk,1745,3,17,9,10,61,41,20,60
Dundee Utd,1745,4,16,11,9,47,36,11,59
Queen of S't,1745,5,11,11,14,46,51,-5,44
Ayr,1745,6,11,11,14,41,55,-14,44
Dunfermline,1745,7,9,13,14,41,45,-4,40
St Mirren,1745,8,9,10,17,42,55,-13,37
Raith,1745,9,9,8,19,33,54,-21,35
Dumbarton,1745,10,7,13,16,49,64,-15,34
Hibernian,1746,1,23,10,3,58,21,37,79
Morton,1746,2,17,12,7,48,32,16,63
Dundee Utd,1746,3,15,10,11,48,39,9,55
Falkirk,1746,4,14,12,10,59,43,16,54
Queen of S't,1746,5,12,11,13,50,48,2,47
Dunfermline,1746,6,8,14,14,43,54,-11,38
Raith,1746,7,8,14,14,32,45,-13,38
St Mirren,1746,8,8,12,16,39,55,-16,36
Ayr,1746,9,8,12,16,34,56,-22,36
Dumbarton,1746,10,8,11,17,46,64,-18,35
Hibernian,1747,1,18,12,6,54,27,27,66
Morton,1747,2,18,12,6,50,35,15,66
Falkirk,1747,3,18,11,7,66,40,26,65
Dundee Utd,1747,4,15,12,9,52,42,10,57
Queen of S't,1747,5,12,8,16,45,51,-6,44
Dunfermline,1747,6,10,13,13,46,47,-1,43
Raith,1747,7,9,10,17,36,54,-18,37
Ayr,1747,8,8,13,15,31,50,-19,37
St Mirren,1747,9,8,11,17,38,56,-18,35
Dumbarton,1747,10,7,12,17,44,60,-16,33
Hibernian,1748,1,18,13,5,58,34,24,67
Morton,1748,2,17,10,9,56,38,18,61
Falkirk,1748,3,16,10,10,62,44,18,58
Dundee Utd,1748,4,14,10,12,45,44,1,52
Queen of S't,1748,5,13,9,14,48,48,0,48
Raith,1748,6,12,9,15,34,48,-14,45
Ayr,1748,7,10,13,13,36,48,-12,43
Dunfermline,1748,8,9,13,14,53,52,1,40
Dumbarton,1748,9,9,12,15,46,62,-16,39
St Mirren,1748,10,7,11,18,38,58,-20,32
Hibernian,1749,1,18,12,6,49,26,23,66
Falkirk,1749,2,18,10,8,63,38,25,64
Morton,1749,3,18,9,9,52,33,19,63
Dundee Utd,1749,4,14,12,10,50,43,7,54
Queen of S't,1749,5,12,10,14,44,48,-4,46
Raith,1749,6,12,8,16,34,46,-12,44
Dunfermline,1749,7,10,13,13,44,46,-2,43
Ayr,1749,8,8,13,15,34,53,-19,37
Dumbarton,1749,9,8,12,16,45,59,-14,36
St Mirren,1749,10,7,11,18,36,59,-23,32
Hibernian,1750,1,20,11,5,58,24,34,71
Morton,1750,2,17,14,5,49,30,19,65
Falkirk,1750,3,16,10,10,59,43,16,58
Dundee Utd,1750,4,15,12,9,47,37,10,57
Queen of S't,1750,5,13,9,14,48,51,-3,48
Dunfermline,1750,6,11,12,13,50,48,2,45
Dumbarton,1750,7,8,13,15,43,55,-12,37
Raith,1750,8,9,9,18,32,59,-27,36
St Mirren,1750,9,8,11,17,39,53,-14,35
Ayr,1750,10,7,11,18,34,59,-25,32
Morton,1751,1,19,9,8,51,37,14,66
Hibernian,1751,2,17,12,7,50,28,22,63
Falkirk,1751,3,14,14,8,55,38,17,56
Dundee Utd,1751,4,13,14,9,48,38,10,53
Queen of S't,1751,5,11,13,12,48,51,-3,46
Dunfermline,1751,6,9,16,11,46,47,-1,43
Raith,1751,7,10,10,16,32,46,-14,40
Dumbarton,1751,8,8,13,15,44,55,-11,37
St Mirren,1751,9,9,10,17,42,56,-14,37
Ayr,1751,10,8,13,15,33,53,-20,37
Hibernian,1752,1,21,12,3,64,25,39,75
Morton,1752,2,18,11,7,55,34,21,65
Dundee Utd,1752,3,15,11,10,48,40,8,56
Falkirk,1752,4,15,10,11,53,39,14,55
Queen of S't,1752,5,13,10,13,46,51,-5,49
Dumbarton,1752,6,11,10,15,51,58,-7,43
Dunfermline,1752,7,8,13,15,45,55,-10,37
Raith,1752,8,8,13,15,31,49,-18,37
St Mirren,1752,9,8,10,18,40,56,-16,34
Ayr,1752,10,7,12,17,32,58,-26,33
Morton,1753,1,19,11,6,54,36,18,68
Hibernian,1753,2,19,10,7,58,28,30,67
Falkirk,1753,3,16,12,8,62,41,21,60
Dundee Utd,1753,4,16,11,9,53,40,13,59
Dunfermline,1753,5,11,14,11,49,48,1,47
Queen of S't,1753,6,12,8,16,43,51,-8,44
Dumbarton,1753,7,9,10,17,46,61,-15,37
Raith,1753,8,9,10,17,35,52,-17,37
Ayr,1753,9,8,11,17,35,57,-22,35
St Mirren,1753,10,7,11,18,37,58,-21,32
Hibernian,1754,1,20,12,4,58,26,32,72
Morton,1754,2,18,9,9,51,37,14,63
Dundee Utd,1754,3,16,10,10,54,40,14,58
Falkirk,1754,4,13,13,10,56,46,10,52
Queen of S't,1754,5,11,12,13,45,50,-5,45
Dunfermline,1754,6,10,13,13,46,48,-2,43
Raith,1754,7,11,9,16,37,50,-13,42
Ayr,1754,8,9,12,15,32,52,-20,39
St Mirren,1754,9,9,10,17,43,55,-12,37
Dumbarton,1754,10,7,12,17,44,62,-18,33
Hibernian,1755,1,17,12,7,53,30,23,63
Falkirk,1755,2,17,10,9,58,42,16,61
Morton,1755,3,16,12,8,56,41,15,60
Dundee Utd,1755,4,14,11,11,48,43,5,53
Raith,1755,5,12,10,14,37,47,-10,46
Ayr,1755,6,10,13,13,35,49,-14,43
Queen of S't,1755,7,10,12,14,42,49,-7,42
Dunfermline,1755,8,9,14,13,45,48,-3,41
Dumbarton,1755,9,9,11,16,48,58,-10,38
St Mirren,1755,10,8,11,17,45,60,-15,35
Hibernian,1756,1,19,13,4,60,28,32,70
Dundee Utd,1756,2,15,11,10,50,44,6,56
Morton,1756,3,14,13,9,43,44,-1,55
Falkirk,1756,4,14,11,11,57,43,14,53
Dunfermline,1756,5,13,13,10,49,43,6,52
Raith,1756,6,13,8,15,42,47,-5,47
Dumbarton,1756,7,10,12,14,48,56,-8,42
St Mirren,1756,8,9,10,17,40,53,-13,37
Queen of S't,1756,9,9,10,17,42,56,-14,37
Ayr,1756,10,7,13,16,36,53,-17,34
Hibernian,1757,1,20,11,5,57,26,31,71
Dundee Utd,1757,2,19,9,8,57,34,23,66
Morton,1757,3,17,11,8,49,35,14,62
Falkirk,1757,4,15,9,12,53,42,11,54
Queen of S't,1757,5,14,9,13,46,46,0,51
Raith,1757,6,12,8,16,36,46,-10,44
Dunfermline,1757,7,8,14,14,44,50,-6,38
Dumbarton,1757,8,8,13,15,50,62,-12,37
St Mirren,1757,9,8,9,19,36,61,-25,33
Ayr,1757,10,6,13,17,31,57,-26,31
Hibernian,1758,1,19,11,6,57,29,28,68
Morton,1758,2,18,9,9,50,35,15,63
Falkirk,1758,3,15,13,8,60,41,19,58
Dundee Utd,1758,4,16,9,11,52,40,12,57
Queen of S't,1758,5,12,9,15,44,52,-8,45
Dunfermline,1758,6,10,14,12,43,44,-1,44
Dumbarton,1758,7,9,12,15,50,62,-12,39
Raith,1758,8,9,11,16,33,50,-17,38
St Mirren,1758,9,8,12,16,39,56,-17,36
Ayr,1758,10,7,14,15,38,57,-19,35
Hibernian,1759,1,19,12,5,57,27,30,69
Morton,1759,2,16,11,9,53,39,14,59
Falkirk,1759,3,15,12,9,54,41,13,57
Dundee Utd,1759,4,16,9,11,49,40,9,57
Queen of S't,1759,5,13,9,14,46,48,-2,48
Dunfermline,1759,6,10,14,12,49,49,0,44
Raith,1759,7,11,11,14,40,48,-8,44
St Mirren,1759,8,9,10,17,45,59,-14,37
Ayr,1759,9,8,12,16,33,58,-25,36
Dumbarton,1759,10,7,12,17,44,61,-17,33
Hibernian,1760,1,21,10,5,59,26,33,73
Morton,1760,2,16,13,7,47,36,11,61
Falkirk,1760,3,16,10,10,60,42,18,58
Dundee Utd,1760,4,15,10,11,51,45,6,55
Dunfermline,1760,5,10,14,12,49,52,-3,44
Raith,1760,6,11,11,14,39,48,-9,44
Queen of S't,1760,7,10,9,17,44,56,-12,39
Dumbarton,1760,8,9,11,16,51,61,-10,38
Ayr,1760,9,8,13,15,38,56,-18,37
St Mirren,1760,10,8,11,17,43,59,-16,35
Hibernian,1761,1,21,11,4,56,25,31,74
Morton,1761,2,17,10,9,48,35,13,61
Dundee Utd,1761,3,15,11,10,48,40,8,56
Falkirk,1761,4,13,11,12,53,42,11,50
Dunfermline,1761,5,11,14,11,44,43,1,47
Queen of S't,1761,6,12,10,14,44,47,-3,46
Ayr,1761,7,10,10,16,34,55,-21,40
Raith,1761,8,9,11,16,33,47,-14,38
Dumbarton,1761,9,8,12,16,49,62,-13,36
St Mirren,1761,10,8,12,16,42,55,-13,36
Hibernian,1762,1,19,12,5,57,31,26,69
Morton,1762,2,17,12,7,58,37,21,63
Falkirk,1762,3,17,10,9,58,39,19,61
Dundee Utd,1762,4,13,11,12,44,42,2,50
Queen of S't,1762,5,12,10,14,50,52,-2,46
Dumbarton,1762,6,11,12,13,48,54,-6,45
Dunfermline,1762,7,10,12,14,48,54,-6,42
Ayr,1762,8,8,13,15,36,53,-17,37
Raith,1762,9,8,11,17,37,53,-16,35
St Mirren,1762,10,8,11,17,37,58,-21,35
Hibernian,1763,1,21,10,5,60,30,30,73
Falkirk,1763,2,15,12,9,59,42,17,57
Dundee Utd,1763,3,15,12,9,51,39,12,57
Morton,1763,4,14,13,9,45,39,6,55
Dunfermline,1763,5,10,14,12,44,44,0,44
Queen of S't,1763,6,12,8,16,53,55,-2,44
St Mirren,1763,7,10,9,17,45,57,-12,39
Ayr,1763,8,9,12,15,37,57,-20,39
Raith,1763,9,9,11,16,34,53,-19,38
Dumbarton,1763,10,8,13,15,49,61,-12,37
Hibernian,1764,1,21,10,5,59,26,33,73
Morton,1764,2,17,10,9,53,39,14,61
Falkirk,1764,3,17,9,10,61,41,20,60
Dundee Utd,1764,4,16,8,12,52,43,9,56
Queen of S't,1764,5,13,9,14,49,51,-2,48
Dunfermline,1764,6,12,11,13,46,45,1,47
Raith,1764,7,10,9,17,37,51,-14,39
Dumbarton,1764,8,9,11,16,47,59,-12,38
St Mirren,1764,9,8,10,18,39,58,-19,34
Ayr,1764,10,7,13,16,34,64,-30,34
Hibernian,1765,1,17,12,7,51,27,24,63
Dundee Utd,1765,2,18,8,10,53,37,16,62
Falkirk,1765,3,15,12,9,57,39,18,57
Morton,1765,4,16,9,11,46,40,6,57
Dunfermline,1765,5,12,12,12,47,46,1,48
Queen of S't,1765,6,11,11,14,46,48,-2,44
St Mirren,1765,7,11,9,16,42,52,-10,42
Ayr,1765,8,10,10,16,37,57,-20,40
Dumbarton,1765,9,9,12,15,47,62,-15,39
Raith,1765,10,9,9,18,34,52,-18,36
Hibernian,1766,1,20,11,5,55,26,29,71
Falkirk,1766,2,18,11,7,65,37,28,65
Morton,1766,3,16,13,7,51,37,14,61
Dundee Utd,1766,4,14,9,13,46,46,0,51
Queen of S't,1766,5,12,8,16,46,50,-4,44
St Mirren,1766,6,11,10,15,43,53,-10,43
Dunfermline,1766,7,9,15,12,45,47,-2,42
Dumbarton,1766,8,9,13,14,48,56,-8,40
Raith,1766,9,9,9,18,32,53,-21,36
Ayr,1766,10,7,11,18,31,57,-26,32
Hibernian,1767,1,20,11,5,54,24,30,71
Dundee Utd,1767,2,17,9,10,56,42,14,60
Morton,1767,3,17,9,10,46,39,7,60
Falkirk,1767,4,16,11,9,58,41,17,59
Ayr,1767,5,11,10,15,37,51,-14,43
Queen of S't,1767,6,10,11,15,43,51,-8,41
Dunfermline,1767,7,9,13,14,47,52,-5,40
St Mirren,1767,8,10,10,16,42,56,-14,40
Raith,1767,9,10,9,17,34,49,-15,39
Dumbarton,1767,10,8,11,17,48,60,-12,35
Hibernian,1768,1,19,12,5,55,27,28,69
Morton,1768,2,17,12,7,51,36,15,63
Falkirk,1768,3,16,13,7,58,38,20,61
Dundee Utd,1768,4,15,12,9,51,39,12,57
Queen of S't,1768,5,11,11,14,44,48,-4,44
Dunfermline,1768,6,8,15,13,44,49,-5,39
St Mirren,1768,7,9,11,16,42,56,-14,38
Raith,1768,8,10,8,18,33,51,-18,38
Dumbarton,1768,9,8,12,16,47,61,-14,36
Ayr,1768,10,8,12,16,37,57,-20,36
Morton,1769,1,18,13,5,54,33,21,67
Falkirk,1769,2,17,11,8,55,36,19,62
Hibernian,1769,3,16,12,8,49,31,18,60
Dundee Utd,1769,4,13,11,12,54,45,9,50
Queen of S't,1769,5,12,10,14,49,49,0,46
Raith,1769,6,11,11,14,38,46,-8,44
Dunfermline,1769,7,10,12,14,46,52,-6,42
Ayr,1769,8,9,12,15,35,62,-27,39
St Mirren,1769,9,9,10,17,39,52,-13,37
Dumbarton,1769,10,8,12,16,42,55,-13,36
Hibernian,1770,1,19,14,3,55,23,32,71
Morton,1770,2,17,12,7,51,34,17,63
Falkirk,1770,3,16,12,8,62,41,21,60
Dundee Utd,1770,4,15,10,11,49,44,5,55
Queen of S't,1770,5,10,11,15,42,52,-10,41
Dunfermline,1770,6,8,15,13,42,49,-7,39
Raith,1770,7,9,12,15,37,51,-14,39
Dumbarton,1770,8,8,14,14,45,56,-11,38
Ayr,1770,9,8,13,15,35,53,-18,37
St Mirren,1770,10,8,11,17,43,58,-15,35
Hibernian,1771,1,18,11,7,56,29,27,65
Morton,1771,2,17,13,6,53,33,20,64
Falkirk,1771,3,16,10,10,52,37,15,58
Dundee Utd,1771,4,16,9,11,47,39,8,57
Raith,1771,5,12,10,14,40,43,-3,46
Queen of S't,1771,6,12,10,14,47,52,-5,46
Dunfermline,1771,7,9,13,14,44,51,-7,40
Dumbarton,1771,8,9,13,14,46,55,-9,40
St Mirren,1771,9,8,11,17,38,57,-19,35
Ayr,1771,10,7,12,17,35,62,-27,33
Hibernian,1772,1,20,11,5,63,28,35,71
Dundee Utd,1772,2,16,12,8,50,38,12,60
Falkirk,1772,3,16,10,10,58,44,14,58
Morton,1772,4,14,15,7,48,39,9,57
Dunfermline,1772,5,11,14,11,53,43,10,47
Queen of S't,1772,6,11,11,14,44,49,-5,44
Dumbarton,1772,7,9,11,16,49,58,-9,38
Raith,1772,8,9,10,17,31,54,-23,37
St Mirren,1772,9,8,11,17,39,56,-17,35
Ayr,1772,10,8,11,17,32,58,-26,35
Hibernian,1773,1,21,11,4,54,24,30,74
Morton,1773,2,17,13,6,50,33,17,64
Falkirk,1773,3,16,10,10,60,43,17,58
Dundee Utd,1773,4,14,11,11,51,44,7,53
Dunfermline,1773,5,11,12,13,51,51,0,45
Raith,1773,6,10,10,16,34,50,-16,40
St Mirren,1773,7,9,12,15,44,55,-11,39
Queen of S't,1773,8,10,8,18,42,52,-10,38
Dumbarton,1773,9,8,13,15,48,60,-12,37
Ayr,1773,10,7,14,15,31,53,-22,35
Hibernian,1774,1,20,11,5,57,24,33,71
Morton,1774,2,17,11,8,51,38,13,62
Falkirk,1774,3,15,10,11,56,46,10,55
Dundee Utd,1774,4,14,11,11,51,44,7,53
Dunfermline,1774,5,12,12,12,52,47,5,48
Queen of S't,1774,6,11,10,15,44,54,-10,43
Ayr,1774,7,9,13,14,37,54,-17,40
Raith,1774,8,10,9,17,34,51,-17,39
St Mirren,1774,9,9,11,16,45,55,-10,38
Dumbarton,1774,10,8,12,16,47,61,-14,36
Hibernian,1775,1,18,13,5,52,22,30,67
Morton,1775,2,18,11,7,52,35,17,65
Dundee Utd,1775,3,17,10,9,55,38,17,61
Falkirk,1775,4,15,10,11,58,45,13,55
Queen of S't,1775,5,11,11,14,46,52,-6,44
Dumbarton,1775,6,10,13,13,52,57,-5,43
Dunfermline,1775,7,10,13,13,49,56,-7,43
Raith,1775,8,9,12,15,35,50,-15,39
Ayr,1775,9,7,14,15,35,55,-20,35
St Mirren,1775,10,6,11,19,37,61,-24,29
Morton,1776,1,18,13,5,56,35,21,67
Hibernian,1776,2,15,15,6,53,33,20,60
Falkirk,1776,3,15,13,8,58,42,16,58
Dundee Utd,1776,4,15,12,9,51,42,9,57
Queen of S't,1776,5,12,9,15,48,53,-5,45
Dumbarton,1776,6,11,11,14,56,55,1,44
Raith,1776,7,11,10,15,38,47,-9,43
Dunfermline,1776,8,8,12,16,43,53,-10,36
Ayr,1776,9,7,14,15,33,60,-27,35
St Mirren,1776,10,7,13,16,37,53,-16,34
Hibernian,1777,1,18,13,5,53,26,27,67
Morton,1777,2,16,11,9,45,37,8,59
Falkirk,1777,3,15,11,10,58,43,15,56
Dundee Utd,1777,4,15,10,11,46,41,5,55
Dunfermline,1777,5,11,13,12,49,49,0,46
Queen of S't,1777,6,12,10,14,48,49,-1,46
Dumbarton,1777,7,10,11,15,49,56,-7,41
Ayr,1777,8,9,14,13,38,52,-14,41
Raith,1777,9,9,10,17,37,54,-17,37
St Mirren,1777,10,8,11,17,38,54,-16,35
Hibernian,1778,1,19,13,4,59,27,32,70
Morton,1778,2,18,10,8,49,36,13,64
Falkirk,1778,3,16,9,11,57,42,15,57
Dundee Utd,1778,4,16,9,11,52,38,14,57
Queen of S't,1778,5,12,9,15,42,48,-6,45
Ayr,1778,6,10,12,14,36,51,-15,42
Dunfermline,1778,7,8,16,12,44,45,-1,40
Raith,1778,8,10,8,18,32,50,-18,38
St Mirren,1778,9,9,10,17,42,60,-18,37
Dumbarton,1778,10,8,12,16,45,61,-16,36
Hibernian,1779,1,20,13,3,60,28,32,73
Dundee Utd,1779,2,16,12,8,51,37,14,60
Falkirk,1779,3,14,14,8,52,35,17,56
Morton,1779,4,14,13,9,47,42,5,55
Queen of S't,1779,5,11,11,14,46,52,-6,44
Dumbarton,1779,6,10,11,15,46,57,-11,41
Dunfermline,1779,7,8,16,12,39,42,-3,40
St Mirren,1779,8,9,10,17,43,56,-13,37
Raith,1779,9,8,13,15,33,47,-14,37
Ayr,1779,10,8,11,17,32,53,-21,35
Hibernian,1780,1,19,13,4,55,24,31,70
Falkirk,1780,2,17,10,9,61,41,20,61
Dundee Utd,1780,3,17,10,9,54,39,15,61
Morton,1780,4,13,14,9,43,38,5,53
Queen of S't,1780,5,12,8,16,45,57,-12,44
Dunfermline,1780,6,10,13,13,47,44,3,43
Raith,1780,7,10,11,15,37,48,-11,41
St Mirren,1780,8,9,11,16,43,60,-17,38
Ayr,1780,9,8,13,15,35,55,-20,37
Dumbarton,1780,10,8,11,17,46,60,-14,35
Hibernian,1781,1,18,14,4,52,25,27,68
Falkirk,1781,2,16,11,9,59,41,18,59
Morton,1781,3,16,11,9,46,35,11,59
Dundee Utd,1781,4,15,11,10,48,37,11,56
Raith,1781,5,13,8,15,38,45,-7,47
Queen of S't,1781,6,11,11,14,48,53,-5,44
Dunfermline,1781,7,9,13,14,42,48,-6,40
Dumbarton,1781,8,8,13,15,49,62,-13,37
Ayr,1781,9,8,13,15,38,58,-20,37
St Mirren,1781,10,7,13,16,40,56,-16,34
Hibernian,1782,1,18,14,4,53,24,29,68
Morton,1782,2,17,10,9,52,41,11,61
Falkirk,1782,3,16,11,9,60,39,21,59
Dundee Utd,1782,4,16,11,9,51,37,14,59
Queen of S't,1782,5,12,11,13,46,50,-4,47
Raith,1782,6,10,10,16,35,49,-14,40
Dumbarton,1782,7,8,15,13,49,58,-9,39
Ayr,1782,8,9,12,15,38,56,-18,39
Dunfermline,1782,9,7,14,15,42,53,-11,35
St Mirren,1782,10,8,10,18,41,60,-19,34
Hibernian,1783,1,21,11,4,58,26,32,74
Falkirk,1783,2,17,10,9,65,43,22,61
Morton,1783,3,16,11,9,50,39,11,59
Dundee Utd,1783,4,16,9,11,51,42,9,57
Queen of S't,1783,5,15,8,13,47,44,3,53
Ayr,1783,6,9,12,15,36,53,-17,39
Raith,1783,7,10,8,18,32,50,-18,38
Dumbarton,1783,8,9,10,17,46,63,-17,37
Dunfermline,1783,9,8,12,16,42,53,-11,36
St Mirren,1783,10,9,9,18,44,58,-14,36
Hibernian,1784,1,21,11,4,60,23,37,74
Morton,1784,2,16,12,8,54,43,11,60
Falkirk,1784,3,16,11,9,57,40,17,59
Dundee Utd,1784,4,15,11,10,50,40,10,56
Dunfermline,1784,5,12,13,11,49,45,4,49
Queen of S't,1784,6,10,11,15,45,54,-9,41
Ayr,1784,7,10,10,16,40,58,-18,40
Raith,1784,8,9,11,16,37,51,-14,38
Dumbarton,1784,9,8,10,18,48,64,-16,34
St Mirren,1784,10,8,10,18,37,59,-22,34
Hibernian,1785,1,21,11,4,59,25,34,74
Morton,1785,2,17,12,7,51,36,15,63
Falkirk,1785,3,16,11,9,56,38,18,59
Dundee Utd,1785,4,16,8,12,50,42,8,56
Ayr,1785,5,11,10,15,37,52,-15,43
Queen of S't,1785,6,11,9,16,44,53,-9,42
Raith,1785,7,11,9,16,40,53,-13,42
Dumbarton,1785,8,9,12,15,45,56,-11,39
Dunfermline,1785,9,8,11,17,43,53,-10,35
St Mirren,1785,10,8,11,17,41,58,-17,35
Hibernian,1786,1,19,14,3,60,25,35,71
Morton,1786,2,16,12,8,51,42,9,60
Dundee Utd,1786,3,16,11,9,52,38,14,59
Falkirk,1786,4,16,10,10,59,44,15,58
Queen of S't,1786,5,12,10,14,49,49,0,46
Dunfermline,1786,6,8,16,12,44,48,-4,40
Dumbarton,1786,7,10,10,16,45,59,-14,40
Raith,1786,8,9,11,16,36,51,-15,38
Ayr,1786,9,7,15,14,35,54,-19,36
St Mirren,1786,10,7,11,18,40,61,-21,32
Hibernian,1787,1,20,11,5,56,24,32,71
Morton,1787,2,16,12,8,49,36,13,60
Falkirk,1787,3,14,10,12,56,47,9,52
Dundee Utd,1787,4,14,10,12,45,43,2,52
Ayr,1787,5,12,11,13,40,53,-13,47
Queen of S't,1787,6,12,9,15,44,48,-4,45
Dunfermline,1787,7,10,14,12,46,44,2,44
Dumbarton,1787,8,9,13,14,49,58,-9,40
Raith,1787,9,10,9,17,33,49,-16,39
St Mirren,1787,10,8,11,17,40,56,-16,35
Hibernian,1788,1,19,13,4,55,25,30,70
Falkirk,1788,2,18,10,8,60,37,23,64
Morton,1788,3,16,10,10,46,40,6,58
Dundee Utd,1788,4,16,9,11,49,40,9,57
Dunfermline,1788,5,10,14,12,47,45,2,44
Raith,1788,6,11,8,17,36,52,-16,41
St Mirren,1788,7,10,10,16,40,51,-11,40
Queen of S't,1788,8,10,9,17,41,52,-11,39
Dumbarton,1788,9,9,11,16,44,54,-10,38
Ayr,1788,10,9,10,17,35,57,-22,37
Hibernian,1789,1,19,10,7,54,28,26,67
Morton,1789,2,17,10,9,46,37,9,61
Dundee Utd,1789,3,17,8,11,51,40,11,59
Falkirk,1789,4,15,11,10,59,43,16,56
Queen of S't,1789,5,12,10,14,47,49,-2,46
Dunfermline,1789,6,10,13,13,47,49,-2,43
Raith,1789,7,11,10,15,36,47,-11,43
St Mirren,1789,8,10,10,16,47,53,-6,40
Dumbarton,1789,9,10,10,16,45,59,-14,40
Ayr,1789,10,8,10,18,33,60,-27,34
Hibernian,1790,1,19,12,5,56,29,27,69
Morton,1790,2,18,13,5,52,34,18,67
Falkirk,1790,3,18,9,9,59,37,22,63
Dundee Utd,1790,4,16,10,10,50,41,9,58
Queen of S't,1790,5,12,8,16,49,52,-3,44
Dunfermline,1790,6,9,14,13,47,50,-3,41
Raith,1790,7,9,12,15,40,52,-12,39
Dumbarton,1790,8,8,12,16,50,64,-14,36
St Mirren,1790,9,8,11,17,41,57,-16,35
Ayr,1790,10,6,13,17,32,60,-28,31
Hibernian,1791,1,22,11,3,60,22,38,77
Falkirk,1791,2,17,10,9,56,41,15,61
Morton,1791,3,14,13,9,49,42,7,55
Dundee Utd,1791,4,13,11,12,51,45,6,50
Queen of S't,1791,5,13,9,14,48,50,-2,48
Dunfermline,1791,6,12,11,13,47,47,0,47
Dumbarton,1791,7,9,11,16,49,58,-9,38
Raith,1791,8,9,11,16,34,46,-12,38
St Mirren,1791,9,8,13,15,37,53,-16,37
Ayr,1791,10,7,12,17,32,59,-27,33
Hibernian,1792,1,18,13,5,55,26,29,67
Morton,1792,2,18,12,6,48,32,16,66
Falkirk,1792,3,16,10,10,58,38,20,58
Dundee Utd,1792,4,15,8,13,47,43,4,53
Queen of S't,1792,5,12,11,13,44,45,-1,47
Ayr,1792,6,12,10,14,38,48,-10,46
Dumbarton,1792,7,10,11,15,47,58,-11,41
Dunfermline,1792,8,9,12,15,45,51,-6,39
Raith,1792,9,9,9,18,33,56,-23,36
St Mirren,1792,10,8,10,18,39,57,-18,34
Hibernian,1793,1,18,13,5,53,27,26,67
Morton,1793,2,18,10,8,53,36,17,64
Falkirk,1793,3,15,14,7,55,37,18,59
Dundee Utd,1793,4,14,11,11,46,39,7,53
Queen of S't,1793,5,14,9,13,53,50,3,51
Raith,1793,6,11,9,16,35,49,-14,42
Dunfermline,1793,7,9,13,14,42,49,-7,40
St Mirren,1793,8,9,11,16,42,53,-11,38
Ayr,1793,9,8,13,15,37,60,-23,37
Dumbarton,1793,10,7,11,18,45,61,-16,32
Hibernian,1794,1,18,14,4,55,26,29,68
Falkirk,1794,2,15,14,7,59,40,19,59
Dundee Utd,1794,3,16,11,9,52,40,12,59
Morton,1794,4,15,11,10,48,37,11,56
Queen of S't,1794,5,12,10,14,49,52,-3,46
Raith,1794,6,11,10,15,38,47,-9,43
Dumbarton,1794,7,10,11,15,54,58,-4,41
Ayr,1794,8,9,12,15,35,56,-21,39
St Mirren,1794,9,9,9,18,41,60,-19,36
Dunfermline,1794,10,7,14,15,39,54,-15,35
Hibernian,1795,1,20,12,4,55,23,32,72
Falkirk,1795,2,17,12,7,60,36,24,63
Dundee Utd,1795,3,16,11,9,53,38,15,59
Morton,1795,4,15,11,10,46,42,4,56
Dunfermline,1795,5,11,12,13,52,50,2,45
Queen of S't,1795,6,11,8,17,42,52,-10,41
St Mirren,1795,7,10,10,16,42,56,-14,40
Dumbarton,1795,8,9,11,16,47,61,-14,38
Ayr,1795,9,9,11,16,35,53,-18,38
Raith,1795,10,9,8,19,33,54,-21,35
Hibernian,1796,1,21,11,4,57,24,33,74
Dundee Utd,1796,2,16,11,9,50,41,9,59
Falkirk,1796,3,15,10,11,57,41,16,55
Morton,1796,4,14,12,10,44,38,6,54
Raith,1796,5,12,8,16,40,51,-11,44
Dunfermline,1796,6,10,13,13,46,45,1,43
Dumbarton,1796,7,9,14,13,51,58,-7,41
Queen of S't,1796,8,11,8,17,46,57,-11,41
St Mirren,1796,9,10,9,17,46,56,-10,39
Ayr,1796,10,8,12,16,33,59,-26,36
Hibernian,1797,1,19,13,4,57,25,32,70
Falkirk,1797,2,15,12,9,56,41,15,57
Morton,1797,3,15,12,9,44,36,8,57
Dundee Utd,1797,4,14,13,9,48,40,8,55
Queen of S't,1797,5,12,10,14,46,48,-2,46
Raith,1797,6,11,10,15,39,50,-11,43
Dunfermline,1797,7,9,14,13,44,46,-2,41
Dumbarton,1797,8,9,12,15,44,57,-13,39
St Mirren,1797,9,10,9,17,43,57,-14,39
Ayr,1797,10,7,13,16,30,51,-21,34
Hibernian,1798,1,19,14,3,57,24,33,71
Dundee Utd,1798,2,18,10,8,50,35,15,64
Morton,1798,3,17,12,7,51,37,14,63
Falkirk,1798,4,15,12,9,61,44,17,57
Queen of S't,1798,5,11,10,15,44,53,-9,43
Dumbarton,1798,6,9,14,13,56,61,-5,41
Raith,1798,7,10,9,17,35,49,-14,39
Dunfermline,1798,8,9,11,16,45,53,-8,38
Ayr,1798,9,8,12,16,36,55,-19,36
St Mirren,1798,10,7,10,19,38,62,-24,31
Falkirk,1799,1,18,11,7,64,37,27,65
Hibernian,1799,2,17,13,6,50,27,23,64
Morton,1799,3,17,13,6,50,32,18,64
Dundee Utd,1799,4,17,9,10,52,37,15,60
Queen of S't,1799,5,12,11,13,45,46,-1,47
Dunfermline,1799,6,9,12,15,43,53,-10,39
St Mirren,1799,7,9,11,16,38,52,-14,38
Dumbarton,1799,8,9,10,17,43,56,-13,37
Raith,1799,9,9,9,18,33,56,-23,36
Ayr,1799,10,7,13,16,34,56,-22,34
Hibernian,1800,1,20,13,3,56,23,33,73
Dundee Utd,1800,2,16,11,9,53,39,14,59
Morton,1800,3,15,12,9,48,39,9,57
Falkirk,1800,4,15,10,11,60,44,16,55
Dunfermline,1800,5,10,14,12,48,48,0,44
Queen of S't,1800,6,11,9,16,46,55,-9,42
St Mirren,1800,7,9,13,14,43,54,-11,40
Raith,1800,8,10,9,17,34,50,-16,39
Dumbarton,1800,9,8,14,14,47,59,-12,38
Ayr,1800,10,7,13,16,31,55,-24,34
Hibernian,1801,1,20,12,4,57,25,32,72
Morton,1801,2,19,10,7,51,35,16,67
Falkirk,1801,3,16,9,11,59,45,14,57
Queen of S't,1801,4,14,9,13,53,49,4,51
Dundee Utd,1801,5,13,11,12,44,41,3,50
Dunfermline,1801,6,10,12,14,48,52,-4,42
Ayr,1801,7,9,13,14,36,53,-17,40
Dumbarton,1801,8,8,13,15,48,59,-11,37
Raith,1801,9,9,9,18,34,52,-18,36
St Mirren,1801,10,7,12,17,36,55,-19,33
Hibernian,1802,1,21,11,4,57,24,33,74
Dundee Utd,1802,2,17,8,11,55,43,12,59
Morton,1802,3,15,12,9,50,40,10,57
Falkirk,1802,4,15,10,11,53,43,10,55
Queen of S't,1802,5,12,9,15,45,49,-4,45
Raith,1802,6,11,10,15,42,50,-8,43
Ayr,1802,7,11,10,15,40,54,-14,43
Dunfermline,1802,8,9,14,13,47,48,-1,41
St Mirren,1802,9,8,11,17,38,58,-20,35
Dumbarton,1802,10,7,13,16,42,60,-18,34
Hibernian,1803,1,20,12,4,61,26,35,72
Morton,1803,2,17,12,7,51,33,18,63
Dundee Utd,1803,3,15,11,10,51,44,7,56
Falkirk,1803,4,14,12,10,58,44,14,54
Dunfermline,1803,5,12,14,10,50,41,9,50
Raith,1803,6,10,11,15,38,49,-11,41
Queen of S't,1803,7,10,10,16,42,55,-13,40
Dumbarton,1803,8,7,16,13,49,59,-10,37
St Mirren,1803,9,8,10,18,40,62,-22,34
Ayr,1803,10,7,12,17,32,59,-27,33
Hibernian,1804,1,20,12,4,59,24,35,72
Morton,1804,2,19,10,7,50,34,16,67
Dundee Utd,1804,3,17,10,9,54,37,17,61
Falkirk,1804,4,15,11,10,55,42,13,56
Queen of S't,1804,5,12,10,14,42,46,-4,46
Dumbarton,1804,6,10,11,15,50,57,-7,41
Raith,1804,7,10,10,16,36,52,-16,40
Ayr,1804,8,8,13,15,38,59,-21,37
Dunfermline,1804,9,8,11,17,44,55,-11,35
St Mirren,1804,10,7,10,19,37,59,-22,31
Hibernian,1805,1,20,11,5,59,30,29,71
Dundee Utd,1805,2,18,9,9,54,39,15,63
Morton,1805,3,17,11,8,55,41,14,62
Falkirk,1805,4,17,10,9,62,43,19,61
Dunfermline,1805,5,9,15,12,49,49,0,42
Queen of S't,1805,6,11,9,16,44,53,-9,42
Raith,1805,7,11,9,16,37,51,-14,42
Dumbarton,1805,8,8,12,16,48,59,-11,36
Ayr,1805,9,8,12,16,38,57,-19,36
St Mirren,1805,10,7,10,19,41,65,-24,31
Hibernian,1806,1,20,11,5,58,24,34,71
Morton,1806,2,19,9,8,54,37,17,66
Falkirk,1806,3,15,11,10,56,41,15,56
Dundee Utd,1806,4,12,13,11,43,39,4,49
Queen of S't,1806,5,11,10,15,42,50,-8,43
Dumbarton,1806,6,10,12,14,49,57,-8,42
Raith,1806,7,11,9,16,35,50,-15,42
Dunfermline,1806,8,9,13,14,48,52,-4,40
St Mirren,1806,9,9,11,16,43,61,-18,38
Ayr,1806,10,8,13,15,35,52,-17,37
Hibernian,1807,1,19,11,6,52,26,26,68
Dundee Utd,1807,2,19,9,8,55,37,18,66
Falkirk,1807,3,18,9,9,64,42,22,63
Morton,1807,4,16,13,7,50,34,16,61
Dunfermline,1807,5,12,12,12,52,47,5,48
Ayr,1807,6,10,10,16,34,55,-21,40
Dumbarton,1807,7,9,11,16,48,60,-12,38
Queen of S't,1807,8,10,8,18,40,52,-12,38
Raith,1807,9,8,11,17,35,55,-20,35
St Mirren,1807,10,7,10,19,37,59,-22,31
Hibernian,1808,1,22,10,4,67,23,44,76
Dundee Utd,1808,2,16,12,8,48,36,12,60
Morton,1808,3,16,10,10,50,40,10,58
Falkirk,1808,4,15,11,10,53,46,7,56
Dunfermline,1808,5,11,13,12,45,40,5,46
Queen of S't,1808,6,11,10,15,43,53,-10,43
Raith,1808,7,10,9,17,33,51,-18,39
St Mirren,1808,8,9,11,16,40,54,-14,38
Ayr,1808,9,8,11,17,41,58,-17,35
Dumbarton,1808,10,8,11,17,46,65,-19,35
Hibernian,1809,1,19,11,6,58,31,27,68
Morton,1809,2,19,11,6,63,38,25,68
Falkirk,1809,3,17,10,9,57,38,19,61
Dundee Utd,1809,4,15,9,12,50,43,7,54
Queen of S't,1809,5,11,11,14,43,49,-6,44
Ayr,1809,6,10,12,14,42,60,-18,42
Dumbarton,1809,7,10,11,15,53,60,-7,41
Raith,1809,8,9,11,16,36,50,-14,38
St Mirren,1809,9,9,10,17,40,56,-16,37
Dunfermline,1809,10,7,12,17,41,58,-17,33
Hibernian,1810,1,19,12,5,52,25,27,69
Falkirk,1810,2,17,9,10,55,37,18,60
Morton,1810,3,16,12,8,48,37,11,60
Dundee Utd,1810,4,15,11,10,53,43,10,56
Dunfermline,1810,5,12,13,11,53,49,4,49
Queen of S't,1810,6,12,8,16,48,53,-5,44
Raith,1810,7,11,10,15,36,44,-8,43
Dumbarton,1810,8,8,12,16,48,63,-15,36
Ayr,1810,9,8,11,17,36,60,-24,35
St Mirren,1810,10,8,10,18,38,56,-18,34
Hibernian,1811,1,19,11,6,53,27,26,68
Dundee Utd,1811,2,17,11,8,49,34,15,62
Morton,1811,3,16,13,7,55,40,15,61
Falkirk,1811,4,16,9,11,61,43,18,57
Dumbarton,1811,5,10,13,13,52,57,-5,43
Queen of S't,1811,6,11,9,16,43,54,-11,42
Dunfermline,1811,7,8,16,12,44,47,-3,40
Ayr,1811,8,8,13,15,39,56,-17,37
Raith,1811,9,8,13,15,35,52,-17,37
St Mirren,1811,10,7,12,17,41,62,-21,33
Hibernian,1812,1,20,11,5,60,28,32,71
Morton,1812,2,18,11,7,51,33,18,65
Falkirk,1812,3,17,11,8,60,39,21,62
Dundee Utd,1812,4,12,11,13,44,48,-4,47
Dunfermline,1812,5,11,12,13,51,50,1,45
Ayr,1812,6,11,12,13,41,50,-9,45
Dumbarton,1812,7,11,11,14,52,59,-7,44
Queen of S't,1812,8,11,9,16,49,58,-9,42
Raith,1812,9,8,9,19,35,59,-24,33
St Mirren,1812,10,7,11,18,40,59,-19,32
Morton,1813,1,20,11,5,59,32,27,71
Hibernian,1813,2,18,12,6,56,26,30,66
Dundee Utd,1813,3,16,10,10,52,41,11,58
Falkirk,1813,4,16,9,11,54,41,13,57
Queen of S't,1813,5,15,9,12,50,46,4,54
Dumbarton,1813,6,9,12,15,49,60,-11,39
Ayr,1813,7,8,13,15,33,56,-23,37
St Mirren,1813,8,8,12,16,42,59,-17,36
Dunfermline,1813,9,7,13,16,43,54,-11,34
Raith,1813,10,8,9,19,32,55,-23,33
Hibernian,1814,1,18,12,6,53,27,26,66
Morton,1814,2,16,13,7,49,34,15,61
Falkirk,1814,3,15,12,9,57,42,15,57
Dundee Utd,1814,4,14,11,11,48,45,3,53
Queen of S't,1814,5,14,10,12,51,45,6,52
Dunfermline,1814,6,10,13,13,47,49,-2,43
Ayr,1814,7,9,12,15,37,54,-17,39
Dumbarton,1814,8,8,14,14,46,58,-12,38
St Mirren,1814,9,8,12,16,39,53,-14,36
Raith,1814,10,9,9,18,33,53,-20,36
Morton,1815,1,18,12,6,53,34,19,66
Hibernian,1815,2,17,14,5,50,26,24,65
Dundee Utd,1815,3,17,10,9,50,37,13,61
Falkirk,1815,4,16,10,10,58,40,18,58
Queen of S't,1815,5,12,8,16,48,55,-7,44
Dumbarton,1815,6,11,10,15,46,53,-7,43
Dunfermline,1815,7,10,12,14,49,49,0,42
Raith,1815,8,9,11,16,31,48,-17,38
Ayr,1815,9,8,12,16,33,58,-25,36
St Mirren,1815,10,7,11,18,39,57,-18,32
Hibernian,1816,1,19,12,5,56,24,32,69
Morton,1816,2,17,10,9,53,37,16,61
Falkirk,1816,3,17,9,10,61,41,20,60
Dundee Utd,1816,4,17,8,11,51,41,10,59
Queen of S't,1816,5,13,9,14,54,54,0,48
Dunfermline,1816,6,11,12,13,50,50,0,45
Ayr,1816,7,9,12,15,33,53,-20,39
Dumbarton,1816,8,9,10,17,51,66,-15,37
Raith,1816,9,8,11,17,29,50,-21,35
St Mirren,1816,10,8,11,17,39,61,-22,35
Hibernian,1817,1,20,11,5,61,28,33,71
Morton,1817,2,18,10,8,51,40,11,64
Falkirk,1817,3,18,9,9,59,44,15,63
Dundee Utd,1817,4,18,9,9,55,40,15,63
Dunfermline,1817,5,11,13,12,53,46,7,46
Ayr,1817,6,10,10,16,34,54,-20,40
Queen of S't,1817,7,10,9,17,41,53,-12,39
Dumbarton,1817,8,8,13,15,44,56,-12,37
Raith,1817,9,9,8,19,36,52,-16,35
St Mirren,1817,10,7,10,19,36,57,-21,31
Morton,1818,1,21,10,5,63,34,29,73
Hibernian,1818,2,19,12,5,60,28,32,69
Falkirk,1818,3,17,10,9,57,40,17,61
Dundee Utd,1818,4,17,9,10,55,41,14,60
Queen of S't,1818,5,11,11,14,44,50,-6,44
Ayr,1818,6,10,12,14,39,53,-14,42
Raith,1818,7,8,12,16,34,50,-16,36
Dunfermline,1818,8,7,14,15,43,52,-9,35
Dumbarton,1818,9,8,10,18,46,60,-14,34
St Mirren,1818,10,7,10,19,37,70,-33,31
Hibernian,1819,1,18,11,7,54,32,22,65
Falkirk,1819,2,18,10,8,59,37,22,64
Morton,1819,3,16,9,11,50,40,10,57
Dundee Utd,1819,4,15,11,10,53,46,7,56
Dunfermline,1819,5,13,12,11,49,46,3,51
Dumbarton,1819,6,10,12,14,52,57,-5,42
Queen of S't,1819,7,11,9,16,45,52,-7,42
Raith,1819,8,11,8,17,34,48,-14,41
Ayr,1819,9,9,14,13,38,53,-15,41
St Mirren,1819,10,6,10,20,40,63,-23,28
Hibernian,1820,1,20,12,4,56,25,31,72
Morton,1820,2,17,13,6,54,37,17,64
Dundee Utd,1820,3,16,9,11,61,45,16,57
Falkirk,1820,4,14,12,10,55,39,16,54
Queen of S't,1820,5,12,10,14,48,50,-2,46
St Mirren,1820,6,10,12,14,43,51,-8,42
Dunfermline,1820,7,8,15,13,44,52,-8,39
Dumbarton,1820,8,9,12,15,45,59,-14,39
Raith,1820,9,8,12,16,32,52,-20,36
Ayr,1820,10,7,11,18,32,60,-28,32
Hibernian,1821,1,21,11,4,62,24,38,74
Morton,1821,2,16,11,9,47,40,7,59
Falkirk,1821,3,14,13,9,56,43,13,55
Dundee Utd,1821,4,14,12,10,49,38,11,54
Queen of S't,1821,5,12,11,13,44,47,-3,47
Dumbarton,1821,6,11,11,14,48,52,-4,44
Dunfermline,1821,7,9,16,11,43,42,1,43
Raith,1821,8,11,8,17,34,49,-15,41
Ayr,1821,9,8,11,17,32,57,-25,35
St Mirren,1821,10,7,10,19,33,56,-23,31
Hibernian,1822,1,18,13,5,53,26,27,67
Morton,1822,2,18,10,8,50,34,16,64
Dundee Utd,1822,3,17,9,10,55,40,15,60
Falkirk,1822,4,15,10,11,56,43,13,55
Dunfermline,1822,5,12,13,11,52,45,7,49
Queen of S't,1822,6,11,11,14,46,51,-5,44
Dumbarton,1822,7,9,12,15,49,61,-12,39
St Mirren,1822,8,10,9,17,39,53,-14,39
Raith,1822,9,10,8,18,34,53,-19,38
Ayr,1822,10,6,13,17,31,59,-28,31
Falkirk,1823,1,18,11,7,57,34,23,65
Hibernian,1823,2,17,13,6,53,30,23,64
Morton,1823,3,16,13,7,45,31,14,61
Dundee Utd,1823,4,17,9,10,57,38,19,60
Dunfermline,1823,5,11,15,10,51,46,5,48
Queen of S't,1823,6,12,9,15,45,55,-10,45
Ayr,1823,7,9,12,15,39,55,-16,39
Raith,1823,8,10,8,18,32,50,-18,38
Dumbarton,1823,9,8,11,17,44,61,-17,35
St Mirren,1823,10,7,9,20,35,58,-23,30
Morton,1824,1,18,12,6,54,33,21,66
Hibernian,1824,2,16,15,5,49,24,25,63
Dundee Utd,1824,3,16,11,9,50,39,11,59
Falkirk,1824,4,15,12,9,57,42,15,57
Queen of S't,1824,5,13,10,13,45,44,1,49
Ayr,1824,6,8,15,13,36,52,-16,39
Dunfermline,1824,7,8,14,14,45,52,-7,38
Raith,1824,8,9,11,16,35,52,-17,38
Dumbarton,1824,9,7,14,15,46,59,-13,35
St Mirren,1824,10,7,12,17,37,57,-20,33
Hibernian,1825,1,17,15,4,56,28,28,66
Morton,1825,2,17,10,9,49,33,16,61
Falkirk,1825,3,16,11,9,56,40,16,59
Dundee Utd,1825,4,15,10,11,47,41,6,55
Queen of S't,1825,5,11,10,15,46,50,-4,43
Dunfermline,1825,6,10,13,13,46,53,-7,43
Dumbarton,1825,7,10,11,15,52,58,-6,41
Raith,1825,8,10,11,15,33,46,-13,41
Ayr,1825,9,9,14,13,33,50,-17,41
St Mirren,1825,10,7,11,18,38,57,-19,32
Hibernian,1826,1,18,12,6,54,25,29,66
Dundee Utd,1826,2,15,12,9,50,37,13,57
Morton,1826,3,15,10,11,48,46,2,55
Falkirk,1826,4,14,12,10,56,42,14,54
Queen of S't,1826,5,12,9,15,43,48,-5,45
Dunfermline,1826,6,10,14,12,48,50,-2,44
St Mirren,1826,7,11,11,14,45,52,-7,44
Raith,1826,8,11,10,15,38,48,-10,43
Dumbarton,1826,9,9,11,16,53,66,-13,38
Ayr,1826,10,8,13,15,35,56,-21,37
Hibernian,1827,1,19,11,6,62,30,32,68
Morton,1827,2,18,11,7,51,34,17,65
Falkirk,1827,3,16,9,11,58,45,13,57
Dundee Utd,1827,4,15,11,10,49,39,10,56
Dunfermline,1827,5,11,13,12,52,50,2,46
Queen of S't,1827,6,11,10,15,44,53,-9,43
Raith,1827,7,11,8,17,41,54,-13,41
Dumbarton,1827,8,9,12,15,45,56,-11,39
St Mirren,1827,9,8,13,15,45,60,-15,37
Ayr,1827,10,6,14,16,32,58,-26,32
Hibernian,1828,1,22,10,4,62,21,41,76
Morton,1828,2,17,10,9,53,41,12,61
Dundee Utd,1828,3,16,10,10,49,40,9,58
Falkirk,1828,4,14,11,11,50,39,11,53
Queen of S't,1828,5,13,11,12,46,46,0,50
Dunfermline,1828,6,11,12,13,47,49,-2,45
Dumbarton,1828,7,10,13,13,46,51,-5,43
Raith,1828,8,8,10,18,32,52,-20,34
St Mirren,1828,9,7,12,17,35,53,-18,33
Ayr,1828,10,7,11,18,28,56,-28,32
Hibernian,1829,1,21,12,3,60,24,36,75
Morton,1829,2,17,11,8,50,36,14,62
Falkirk,1829,3,15,10,11,55,45,10,55
Dundee Utd,1829,4,13,11,12,43,40,3,50
Queen of S't,1829,5,13,9,14,46,46,0,48
Raith,1829,6,11,11,14,41,52,-11,44
Dunfermline,1829,7,9,14,13,42,46,-4,41
Dumbarton,1829,8,9,11,16,47,57,-10,38
Ayr,1829,9,8,12,16,39,58,-19,36
St Mirren,1829,10,7,13,16,36,55,-19,34
Hibernian,1830,1,20,10,6,52,24,28,70
Falkirk,1830,2,16,9,11,60,49,11,57
Morton,1830,3,15,12,9,48,39,9,57
Dundee Utd,1830,4,15,9,12,48,45,3,54
Dunfermline,1830,5,11,13,12,56,54,2,46
Queen of S't,1830,6,11,10,15,47,52,-5,43
Raith,1830,7,11,10,15,38,49,-11,43
St Mirren,1830,8,11,9,16,46,53,-7,42
Dumbarton,1830,9,10,11,15,45,53,-8,41
Ayr,1830,10,8,11,17,36,58,-22,35
Hibernian,1831,1,21,12,3,55,23,32,75
Falkirk,1831,2,16,11,9,58,38,20,59
Morton,1831,3,15,12,9,50,38,12,57
Dundee Utd,1831,4,13,13,10,49,47,2,52
Dunfermline,1831,5,10,13,13,43,53,-10,43
Dumbarton,1831,6,10,12,14,48,54,-6,42
Queen of S't,1831,7,11,8,17,45,48,-3,41
Raith,1831,8,10,10,16,33,46,-13,40
St Mirren,1831,9,10,9,17,40,55,-15,39
Ayr,1831,10,8,12,16,34,53,-19,36
Hibernian,1832,1,18,12,6,54,29,25,66
Falkirk,1832,2,16,12,8,58,40,18,60
Morton,1832,3,16,12,8,52,34,18,60
Dundee Utd,1832,4,14,10,12,47,41,6,52
Queen of S't,1832,5,14,8,14,47,49,-2,50
Dunfermline,1832,6,10,13,13,49,50,-1,43
St Mirren,1832,7,11,9,16,43,53,-10,42
Raith,1832,8,10,10,16,32,51,-19,40
Dumbarton,1832,9,9,12,15,50,61,-11,39
Ayr,1832,10,7,12,17,35,59,-24,33
Hibernian,1833,1,18,13,5,54,26,28,67
Morton,1833,2,18,11,7,54,34,20,65
Falkirk,1833,3,18,10,8,59,35,24,64
Dundee Utd,1833,4,17,9,10,57,40,17,60
Dumbarton,1833,5,10,12,14,44,56,-12,42
Dunfermline,1833,6,8,15,13,42,48,-6,39
Queen of S't,1833,7,9,10,17,39,51,-12,37
Raith,1833,8,9,10,17,33,53,-20,37
Ayr,1833,9,8,13,15,34,55,-21,37
St Mirren,1833,10,9,9,18,43,61,-18,36
Hibernian,1834,1,20,12,4,58,23,35,72
Morton,1834,2,18,9,9,52,39,13,63
Falkirk,1834,3,16,11,9,59,39,20,59
Dundee Utd,1834,4,14,11,11,47,42,5,53
Dunfermline,1834,5,12,11,13,49,47,2,47
Raith,1834,6,11,9,16,37,46,-9,42
Queen of S't,1834,7,9,11,16,42,53,-11,38
Dumbarton,1834,8,9,11,16,49,63,-14,38
Ayr,1834,9,9,11,16,33,54,-21,38
St Mirren,1834,10,9,10,17,40,60,-20,37
Hibernian,1835,1,19,11,6,56,25,31,68
Morton,1835,2,17,11,8,51,40,11,62
Falkirk,1835,3,16,11,9,60,39,21,59
Dundee Utd,1835,4,16,10,10,54,41,13,58
Dunfermline,1835,5,11,13,12,44,41,3,46
Queen of S't,1835,6,12,10,14,44,49,-5,46
Dumbarton,1835,7,11,10,15,49,58,-9,43
Raith,1835,8,10,9,17,34,51,-17,39
St Mirren,1835,9,8,10,18,39,60,-21,34
Ayr,1835,10,7,11,18,32,59,-27,32
Hibernian,1836,1,19,13,4,53,24,29,70
Morton,1836,2,17,12,7,51,36,15,63
Falkirk,1836,3,16,10,10,61,44,17,58
Dundee Utd,1836,4,15,10,11,49,41,8,55
Queen of S't,1836,5,13,10,13,47,46,1,49
Dunfermline,1836,6,10,14,12,48,46,2,44
St Mirren,1836,7,8,12,16,40,55,-15,36
Raith,1836,8,9,9,18,34,50,-16,36
Ayr,1836,9,7,15,14,35,57,-22,36
Dumbarton,1836,10,7,13,16,44,63,-19,34
Hibernian,1837,1,19,11,6,59,32,27,68
Morton,1837,2,18,9,9,53,44,9,63
Falkirk,1837,3,13,14,9,54,41,13,53
Dunfermline,1837,4,13,13,10,52,43,9,52
Queen of S't,1837,5,13,9,14,53,51,2,48
Dundee Utd,1837,6,13,9,14,45,47,-2,48
Dumbarton,1837,7,11,12,13,52,57,-5,45
Raith,1837,8,10,11,15,34,47,-13,41
St Mirren,1837,9,8,10,18,40,55,-15,34
Ayr,1837,10,7,12,17,35,60,-25,33
Hibernian,1838,1,21,10,5,58,25,33,73
Falkirk,1838,2,18,10,8,64,42,22,64
Morton,1838,3,15,12,9,48,36,12,57
Dundee Utd,1838,4,16,9,11,49,39,10,57
Ayr,1838,5,9,14,13,33,49,-16,41
Dunfermline,1838,6,9,13,14,47,52,-5,40
Dumbarton,1838,7,9,12,15,46,58,-12,39
Raith,1838,8,10,9,17,37,52,-15,39
St Mirren,1838,9,9,11,16,38,52,-14,38
Queen of S't,1838,10,10,8,18,44,59,-15,38
Hibernian,1839,1,18,13,5,55,26,29,67
Falkirk,1839,2,18,9,9,62,40,22,63
Morton,1839,3,16,12,8,47,38,9,60
Dundee Utd,1839,4,15,10,11,50,45,5,55
Dunfermline,1839,5,10,13,13,45,49,-4,43
Queen of S't,1839,6,11,10,15,44,50,-6,43
Ayr,1839,7,10,13,13,36,50,-14,43
Dumbarton,1839,8,9,12,15,49,57,-8,39
Raith,1839,9,9,11,16,38,52,-14,38
St Mirren,1839,10,7,11,18,39,58,-19,32
Hibernian,1840,1,20,10,6,57,30,27,70
Morton,1840,2,18,10,8,54,37,17,64
Falkirk,1840,3,18,9,9,60,41,19,63
Dundee Utd,1840,4,16,10,10,49,37,12,58
Dunfermline,1840,5,11,13,12,49,46,3,46
Queen of S't,1840,6,10,9,17,43,53,-10,39
Dumbarton,1840,7,9,11,16,45,59,-14,38
Ayr,1840,8,9,11,16,35,56,-21,38
Raith,1840,9,9,10,17,35,50,-15,37
St Mirren,1840,10,8,11,17,39,57,-18,35
Hibernian,1841,1,19,13,4,56,26,30,70
Dundee Utd,1841,2,17,9,10,49,39,10,60
Morton,1841,3,14,12,10,50,46,4,54
Falkirk,1841,4,13,11,12,54,45,9,50
Queen of S't,1841,5,12,10,14,44,47,-3,46
Dumbarton,1841,6,11,11,14,49,54,-5,44
Ayr,1841,7,10,13,13,36,53,-17,43
Dunfermline,1841,8,9,14,13,46,48,-2,41
Raith,1841,9,10,11,15,39,49,-10,41
St Mirren,1841,10,8,10,18,37,53,-16,34
Hibernian,1842,1,21,10,5,60,28,32,73
Morton,1842,2,18,12,6,53,36,17,66
Dundee Utd,1842,3,18,9,9,54,37,17,63
Falkirk,1842,4,15,9,12,56,43,13,54
Dunfermline,1842,5,10,13,13,44,47,-3,43
Raith,1842,6,11,10,15,37,47,-10,43
Queen of S't,1842,7,10,11,15,46,54,-8,41
Dumbarton,1842,8,8,12,16,44,61,-17,36
Ayr,1842,9,8,11,17,34,54,-20,35
St Mirren,1842,10,8,9,19,40,61,-21,33
Hibernian,1843,1,18,12,6,53,24,29,66
Morton,1843,2,17,10,9,47,37,10,61
Falkirk,1843,3,16,10,10,58,41,17,58
Dundee Utd,1843,4,15,11,10,47,36,11,56
Queen of S't,1843,5,14,10,12,51,49,2,52
Dunfermline,1843,6,12,11,13,45,45,0,47
Dumbarton,1843,7,9,12,15,49,60,-11,39
Ayr,1843,8,8,13,15,34,54,-20,37
Raith,1843,9,8,11,17,32,51,-19,35
St Mirren,1843,10,8,10,18,40,59,-19,34
Hibernian,1844,1,20,13,3,59,24,35,73
Dundee Utd,1844,2,18,9,9,51,36,15,63
Falkirk,1844,3,17,9,10,58,40,18,60
Morton,1844,4,16,11,9,44,37,7,59
Queen of S't,1844,5,11,10,15,44,49,-5,43
Dunfermline,1844,6,9,14,13,46,51,-5,41
Raith,1844,7,10,9,17,35,53,-18,39
Dumbarton,1844,8,8,12,16,45,58,-13,36
Ayr,1844,9,8,12,16,33,52,-19,36
St Mirren,1844,10,8,11,17,37,52,-15,35
Hibernian,1845,1,18,12,6,52,27,25,66
Falkirk,1845,2,18,9,9,64,37,27,63
Dundee Utd,1845,3,17,10,9,50,37,13,61
Morton,1845,4,16,12,8,51,37,14,60
Queen of S't,1845,5,12,9,15,48,54,-6,45
Raith,1845,6,12,8,16,36,50,-14,44
Ayr,1845,7,9,13,14,36,53,-17,40
Dunfermline,1845,8,8,13,15,43,47,-4,37
St Mirren,1845,9,9,9,18,38,60,-22,36
Dumbarton,1845,10,8,11,17,48,64,-16,35
Hibernian,1846,1,20,11,5,57,25,32,71
Morton,1846,2,18,9,9,51,37,14,63
Falkirk,1846,3,16,11,9,60,44,16,59
Dundee Utd,1846,4,16,9,11,49,42,7,57
Dunfermline,1846,5,11,13,12,48,46,2,46
Queen of S't,1846,6,10,12,14,41,49,-8,42
Raith,1846,7,10,10,16,40,53,-13,40
Dumbarton,1846,8,8,13,15,47,58,-11,37
Ayr,1846,9,8,13,15,39,60,-21,37
St Mirren,1846,10,8,9,19,41,59,-18,33
Morton,1847,1,20,11,5,56,28,28,71
Hibernian,1847,2,19,11,6,57,30,27,68
Falkirk,1847,3,14,10,12,57,45,12,52
Queen of S't,1847,4,14,8,14,49,51,-2,50
Dundee Utd,1847,5,13,10,13,47,44,3,49
Dunfermline,1847,6,10,14,12,46,47,-1,44
Dumbarton,1847,7,11,11,14,46,55,-9,44
Ayr,1847,8,9,12,15,36,53,-17,39
St Mirren,1847,9,9,10,17,37,56,-19,37
Raith,1847,10,8,9,19,30,52,-22,33
Hibernian,1848,1,20,12,4,54,27,27,72
Falkirk,1848,2,18,10,8,62,41,21,64
Morton,1848,3,16,11,9,47,37,10,59
Dundee Utd,1848,4,15,11,10,52,40,12,56
Queen of S't,1848,5,12,11,13,51,52,-1,47
Dunfermline,1848,6,9,11,16,52,53,-1,38
Dumbarton,1848,7,9,11,16,53,63,-10,38
St Mirren,1848,8,8,13,15,44,57,-13,37
Ayr,1848,9,8,13,15,36,57,-21,37
Raith,1848,10,9,9,18,34,58,-24,36
Hibernian,1849,1,19,13,4,56,23,33,70
Morton,1849,2,16,13,7,48,35,13,61
Falkirk,1849,3,17,9,10,60,42,18,60
Dundee Utd,1849,4,13,13,10,48,42,6,52
Queen of S't,1849,5,12,11,13,45,46,-1,47
Raith,1849,6,10,12,14,37,48,-11,42
Dunfermline,1849,7,9,14,13,42,48,-6,41
Dumbarton,1849,8,9,13,14,48,56,-8,40
Ayr,1849,9,8,12,16,34,54,-20,36
St Mirren,1849,10,6,12,18,40,64,-24,30
Hibernian,1850,1,19,12,5,50,23,27,69
Falkirk,1850,2,16,11,9,55,39,16,59
Dundee Utd,1850,3,14,12,10,46,35,11,54
Morton,1850,4,14,12,10,42,37,5,54
Queen of S't,1850,5,12,11,13,45,48,-3,47
Raith,1850,6,13,8,15,41,44,-3,47
Dumbarton,1850,7,10,12,14,48,52,-4,42
Dunfermline,1850,8,9,13,14,41,46,-5,40
Ayr,1850,9,8,12,16,30,56,-26,36
St Mirren,1850,10,8,11,17,38,56,-18,35
Hibernian,1851,1,17,14,5,62,31,31,65
Morton,1851,2,16,13,7,60,41,19,61
Dundee Utd,1851,3,16,10,10,48,39,9,58
Falkirk,1851,4,14,13,9,59,42,17,55
Queen of S't,1851,5,13,10,13,48,49,-1,49
Ayr,1851,6,10,14,12,40,50,-10,44
Raith,1851,7,11,11,14,38,49,-11,44
Dunfermline,1851,8,8,15,13,47,51,-4,39
Dumbarton,1851,9,7,11,18,43,67,-24,32
St Mirren,1851,10,7,11,18,36,62,-26,32
Morton,1852,1,19,10,7,52,34,18,67
Hibernian,1852,2,17,12,7,56,34,22,63
Dundee Utd,1852,3,16,10,10,46,38,8,58
Falkirk,1852,4,15,11,10,56,40,16,56
Dunfermline,1852,5,12,13,11,53,47,6,49
Queen of S't,1852,6,12,8,16,44,50,-6,44
Raith,1852,7,11,9,16,38,48,-10,42
Dumbarton,1852,8,10,11,15,47,54,-7,41
Ayr,1852,9,8,11,17,34,58,-24,35
St Mirren,1852,10,7,11,18,36,59,-23,32
Hibernian,1853,1,20,12,4,57,27,30,72
Morton,1853,2,18,12,6,53,33,20,66
Falkirk,1853,3,16,10,10,56,44,12,58
Dundee Utd,1853,4,16,9,11,49,42,7,57
Queen of S't,1853,5,12,8,16,47,49,-2,44
Raith,1853,6,11,9,16,38,51,-13,42
Dumbarton,1853,7,10,11,15,49,57,-8,41
Dunfermline,1853,8,8,13,15,44,50,-6,37
St Mirren,1853,9,8,11,17,40,55,-15,35
Ayr,1853,10,8,11,17,33,58,-25,35
Hibernian,1854,1,19,12,5,58,29,29,69
Morton,1854,2,16,14,6,52,37,15,62
Dundee Utd,1854,3,14,12,10,47,40,7,54
Falkirk,1854,4,14,10,12,56,47,9,52
Dunfermline,1854,5,12,14,10,51,42,9,50
Queen of S't,1854,6,13,10,13,46,51,-5,49
Dumbarton,1854,7,9,13,14,49,56,-7,40
St Mirren,1854,8,9,10,17,41,54,-13,37
Ayr,1854,9,7,14,15,34,55,-21,35
Raith,1854,10,8,9,19,32,55,-23,33
Hibernian,1855,1,19,11,6,52,26,26,68
Dundee Utd,1855,2,19,9,8,59,36,23,66
Falkirk,1855,3,16,10,10,58,38,20,58
Morton,1855,4,15,10,11,44,41,3,55
Dunfermline,1855,5,11,11,14,53,51,2,44
Dumbarton,1855,6,10,12,14,46,53,-7,42
Raith,1855,7,11,9,16,36,52,-16,42
Ayr,1855,8,10,12,14,36,54,-18,42
Queen of S't,1855,9,10,10,16,41,52,-11,40
St Mirren,1855,10,7,10,19,36,58,-22,31
Hibernian,1856,1,18,12,6,52,28,24,66
Falkirk,1856,2,17,10,9,57,37,20,61
Morton,1856,3,15,14,7,49,36,13,59
Dundee Utd,1856,4,15,11,10,51,42,9,56
Queen of S't,1856,5,13,9,14,45,51,-6,48
Dunfermline,1856,6,10,15,11,47,44,3,45
St Mirren,1856,7,9,11,16,41,57,-16,38
Dumbarton,1856,8,9,10,17,47,59,-12,37
Raith,1856,9,8,12,16,30,46,-16,36
Ayr,1856,10,7,14,15,33,52,-19,35
Hibernian,1857,1,18,11,7,55,31,24,65
Morton,1857,2,17,10,9,50,40,10,61
Falkirk,1857,3,17,9,10,64,44,20,60
Dundee Utd,1857,4,17,9,10,53,38,15,60
Queen of S't,1857,5,12,8,16,46,52,-6,44
Dumbarton,1857,6,11,10,15,48,55,-7,43
Raith,1857,7,11,10,15,40,53,-13,43
Ayr,1857,8,10,11,15,37,54,-17,41
St Mirren,1857,9,9,10,17,40,59,-19,37
Dunfermline,1857,10,8,12,16,49,56,-7,36
Hibernian,1858,1,20,11,5,55,26,29,71
Morton,1858,2,18,9,9,55,38,17,63
Dundee Utd,1858,3,18,9,9,53,39,14,63
Falkirk,1858,4,15,11,10,54,39,15,56
Raith,1858,5,12,10,14,37,45,-8,46
Queen of S't,1858,6,11,10,15,44,51,-7,43
Dunfermline,1858,7,10,12,14,43,46,-3,42
Dumbarton,1858,8,9,12,15,45,55,-10,39
Ayr,1858,9,8,11,17,33,56,-23,35
St Mirren,1858,10,7,9,20,34,58,-24,30
Hibernian,1859,1,18,11,7,52,28,24,65
Morton,1859,2,18,9,9,51,36,15,63
Falkirk,1859,3,17,10,9,62,41,21,61
Dundee Utd,1859,4,16,10,10,52,42,10,58
Dunfermline,1859,5,12,12,12,49,47,2,48
Queen of S't,1859,6,13,9,14,51,53,-2,48
Raith,1859,7,11,10,15,40,49,-9,43
Dumbarton,1859,8,9,10,17,46,64,-18,37
St Mirren,1859,9,8,11,17,37,54,-17,35
Ayr,1859,10,7,10,19,30,56,-26,31
Hibernian,1860,1,20,12,4,58,26,32,72
Dundee Utd,1860,2,18,8,10,58,37,21,62
Morton,1860,3,17,10,9,57,42,15,61
Falkirk,1860,4,14,14,8,57,39,18,56
Queen of S't,1860,5,12,10,14,48,54,-6,46
St Mirren,1860,6,10,10,16,44,57,-13,40
Dumbarton,1860,7,9,12,15,46,59,-13,39
Dunfermline,1860,8,7,16,13,42,50,-8,37
Raith,1860,9,9,10,17,36,54,-18,37
Ayr,1860,10,8,10,18,33,61,-28,34
Hibernian,1861,1,19,12,5,56,29,27,69
Morton,1861,2,19,10,7,57,38,19,67
Falkirk,1861,3,18,9,9,58,36,22,63
Dundee Utd,1861,4,16,11,9,58,40,18,59
Raith,1861,5,12,8,16,35,49,-14,44
Dunfermline,1861,6,10,12,14,48,48,0,42
Queen of S't,1861,7,9,10,17,42,55,-13,37
Ayr,1861,8,8,13,15,36,57,-21,37
Dumbarton,1861,9,8,11,17,46,59,-13,35
St Mirren,1861,10,8,10,18,41,66,-25,34
Hibernian,1862,1,21,12,3,61,23,38,75
Morton,1862,2,17,11,8,54,38,16,62
Dundee Utd,1862,3,17,10,9,57,40,17,61
Falkirk,1862,4,14,13,9,58,42,16,55
Queen of S't,1862,5,12,9,15,45,56,-11,45
Dumbarton,1862,6,10,12,14,52,61,-9,42
Dunfermline,1862,7,7,16,13,42,51,-9,37
St Mirren,1862,8,9,9,18,43,61,-18,36
Raith,1862,9,8,11,17,32,51,-19,35
Ayr,1862,10,8,11,17,33,54,-21,35
Hibernian,1863,1,19,12,5,55,25,30,69
Dundee Utd,1863,2,20,8,8,58,33,25,68
Morton,1863,3,17,11,8,49,39,10,62
Falkirk,1863,4,16,11,9,54,39,15,59
Queen of S't,1863,5,12,8,16,50,51,-1,44
Dunfermline,1863,6,10,11,15,48,52,-4,41
Dumbarton,1863,7,10,10,16,45,57,-12,40
Raith,1863,8,10,9,17,34,51,-17,39
St Mirren,1863,9,8,11,17,36,54,-18,35
Ayr,1863,10,7,11,18,32,60,-28,32
Hibernian,1864,1,18,14,4,54,24,30,68
Falkirk,1864,2,16,11,9,57,41,16,59
Morton,1864,3,15,12,9,49,38,11,57
Dundee Utd,1864,4,15,12,9,49,39,10,57
Dumbarton,1864,5,11,12,13,54,55,-1,45
Queen of S't,1864,6,11,12,13,44,49,-5,45
Raith,1864,7,10,10,16,37,51,-14,40
Dunfermline,1864,8,8,14,14,48,57,-9,38
St Mirren,1864,9,8,13,15,41,55,-14,37
Ayr,1864,10,6,14,16,30,54,-24,32
Hibernian,1865,1,20,13,3,55,22,33,73
Falkirk,1865,2,18,11,7,60,35,25,65
Dundee Utd,1865,3,18,9,9,59,41,18,63
Morton,1865,4,14,14,8,47,35,12,56
Dunfermline,1865,5,10,12,14,42,49,-7,42
Queen of S't,1865,6,11,8,17,43,54,-11,41
Raith,1865,7,10,9,17,33,47,-14,39
Dumbarton,1865,8,8,14,14,47,58,-11,38
Ayr,1865,9,9,11,16,35,57,-22,38
St Mirren,1865,10,6,11,19,40,63,-23,29
Hibernian,1866,1,19,13,4,55,24,31,70
Morton,1866,2,19,11,6,54,36,18,68
Dundee Utd,1866,3,17,9,10,54,36,18,60
Falkirk,1866,4,15,12,9,60,43,17,57
Dunfermline,1866,5,12,12,12,47,49,-2,48
Queen of S't,1866,6,11,10,15,43,48,-5,43
Raith,1866,7,9,9,18,32,49,-17,36
Ayr,1866,8,8,12,16,32,52,-20,36
St Mirren,1866,9,8,11,17,35,54,-19,35
Dumbarton,1866,10,7,11,18,44,65,-21,32
Hibernian,1867,1,21,11,4,62,24,38,74
Morton,1867,2,16,12,8,50,37,13,60
Falkirk,1867,3,15,12,9,56,40,16,57
Dundee Utd,1867,4,14,14,8,45,34,11,56
Dunfermline,1867,5,10,16,10,48,43,5,46
Raith,1867,6,11,10,15,39,46,-7,43
Queen of S't,1867,7,11,10,15,43,56,-13,43
St Mirren,1867,8,8,12,16,43,63,-20,36
Ayr,1867,9,7,12,17,30,56,-26,33
Dumbarton,1867,10,7,11,18,44,61,-17,32
Hibernian,1868,1,18,12,6,56,33,23,66
Falkirk,1868,2,18,11,7,62,39,23,65
Dundee Utd,1868,3,18,10,8,47,34,13,64
Morton,1868,4,17,12,7,53,35,18,63
Queen of S't,1868,5,13,9,14,49,51,-2,48
Dunfermline,1868,6,10,13,13,45,47,-2,43
Raith,1868,7,9,9,18,36,53,-17,36
St Mirren,1868,8,8,11,17,42,57,-15,35
Ayr,1868,9,7,12,17,33,54,-21,33
Dumbarton,1868,10,7,11,18,42,62,-20,32
Hibernian,1869,1,18,11,7,54,27,27,65
Morton,1869,2,18,10,8,48,32,16,64
Dundee Utd,1869,3,16,9,11,49,42,7,57
Falkirk,1869,4,15,11,10,60,48,12,56
Dunfermline,1869,5,10,15,11,45,41,4,45
Queen of S't,1869,6,12,8,16,46,48,-2,44
Raith,1869,7,11,10,15,34,48,-14,43
Ayr,1869,8,9,13,14,38,55,-17,40
Dumbarton,1869,9,8,13,15,48,62,-14,37
St Mirren,1869,10,8,10,18,40,59,-19,34
Hibernian,1870,1,19,12,5,56,25,31,69
Dundee Utd,1870,2,17,10,9,58,42,16,61
Morton,1870,3,16,12,8,48,37,11,60
Falkirk,1870,4,16,11,9,59,42,17,59
Dunfermline,1870,5,11,12,13,49,50,-1,45
Queen of S't,1870,6,11,9,16,42,53,-11,42
Dumbarton,1870,7,9,12,15,45,57,-12,39
Ayr,1870,8,9,12,15,38,54,-16,39
Raith,1870,9,9,9,18,35,56,-21,36
St Mirren,1870,10,8,11,17,39,53,-14,35
Hibernian,1871,1,17,12,7,54,32,22,63
Dundee Utd,1871,2,18,9,9,55,39,16,63
Falkirk,1871,3,17,10,9,61,40,21,61
Morton,1871,4,16,11,9,55,40,15,59
Queen of S't,1871,5,14,8,14,53,52,1,50
Dunfermline,1871,6,10,12,14,46,54,-8,42
Dumbarton,1871,7,10,11,15,50,57,-7,41
Raith,1871,8,10,8,18,34,52,-18,38
St Mirren,1871,9,9,9,18,38,57,-19,36
Ayr,1871,10,8,12,16,34,57,-23,36
Hibernian,1872,1,19,14,3,56,26,30,71
Falkirk,1872,2,16,10,10,57,40,17,58
Morton,1872,3,15,12,9,45,37,8,57
Dunfermline,1872,4,12,12,12,52,48,4,48
Dundee Utd,1872,5,13,8,15,45,48,-3,47
Queen of S't,1872,6,13,8,15,50,55,-5,47
Dumbarton,1872,7,11,12,13,50,48,2,45
Raith,1872,8,11,10,15,40,48,-8,43
Ayr,1872,9,8,12,16,34,58,-24,36
St Mirren,1872,10,7,12,17,35,56,-21,33
Hibernian,1873,1,19,14,3,53,23,30,71
Morton,1873,2,16,13,7,52,35,17,61
Falkirk,1873,3,16,10,10,58,41,17,58
Dundee Utd,1873,4,16,8,12,48,48,0,56
Dumbarton,1873,5,11,12,13,60,63,-3,45
Queen of S't,1873,6,11,11,14,45,48,-3,44
Raith,1873,7,11,9,16,32,45,-13,42
Dunfermline,1873,8,8,13,15,45,48,-3,37
St Mirren,1873,9,8,12,16,45,58,-13,36
Ayr,1873,10,6,14,16,35,64,-29,32
Hibernian,1874,1,21,12,3,59,20,39,75
Morton,1874,2,16,12,8,52,40,12,60
Falkirk,1874,3,16,11,9,56,42,14,59
Dundee Utd,1874,4,16,9,11,62,48,14,57
Queen of S't,1874,5,12,10,14,45,47,-2,46
Dumbarton,1874,6,10,12,14,52,58,-6,42
Raith,1874,7,10,11,15,35,47,-12,41
Dunfermline,1874,8,8,12,16,44,60,-16,36
Ayr,1874,9,8,12,16,38,59,-21,36
St Mirren,1874,10,8,9,19,40,62,-22,33
Hibernian,1875,1,21,10,5,53,22,31,73
Dundee Utd,1875,2,19,8,9,54,36,18,65
Morton,1875,3,17,9,10,46,37,9,60
Falkirk,1875,4,16,9,11,56,42,14,57
Raith,1875,5,12,9,15,37,45,-8,45
Dunfermline,1875,6,10,11,15,41,46,-5,41
Queen of S't,1875,7,11,8,17,43,50,-7,41
Ayr,1875,8,9,11,16,35,57,-22,38
Dumbarton,1875,9,8,12,16,44,56,-12,36
St Mirren,1875,10,8,11,17,40,58,-18,35
Hibernian,1876,1,19,13,4,54,24,30,70
Falkirk,1876,2,17,11,8,62,41,21,62
Morton,1876,3,17,11,8,50,36,14,62
Dundee Utd,1876,4,17,9,10,51,38,13,60
Dunfermline,1876,5,11,12,13,45,48,-3,45
Queen of S't,1876,6,11,10,15,46,50,-4,43
Dumbarton,1876,7,9,12,15,50,59,-9,39
Raith,1876,8,9,10,17,33,51,-18,37
St Mirren,1876,9,9,9,18,39,55,-16,36
Ayr,1876,10,6,13,17,29,57,-28,31
Hibernian,1877,1,18,15,3,55,22,33,69
Dundee Utd,1877,2,17,10,9,51,35,16,61
Falkirk,1877,3,16,9,11,56,45,11,57
Morton,1877,4,14,15,7,43,32,11,57
Queen of S't,1877,5,12,9,15,44,49,-5,45
Raith,1877,6,10,12,14,35,47,-12,42
Dunfermline,1877,7,9,14,13,44,49,-5,41
Dumbarton,1877,8,8,12,16,44,55,-11,36
St Mirren,1877,9,8,12,16,38,53,-15,36
Ayr,1877,10,8,12,16,32,55,-23,36
Hibernian,1878,1,18,13,5,52,27,25,67
Morton,1878,2,19,9,8,52,37,15,66
Falkirk,1878,3,18,9,9,61,39,22,63
Dundee Utd,1878,4,15,10,11,53,43,10,55
Queen of S't,1878,5,13,8,15,49,50,-1,47
Dunfermline,1878,6,9,14,13,45,48,-3,41
St Mirren,1878,7,10,10,16,44,59,-15,40
Raith,1878,8,9,10,17,33,49,-16,37
Ayr,1878,9,8,13,15,36,57,-21,37
Dumbarton,1878,10,8,10,18,44,60,-16,34
Hibernian,1879,1,21,11,4,60,26,34,74
Dundee Utd,1879,2,17,9,10,55,38,17,60
Falkirk,1879,3,16,11,9,58,43,15,59
Morton,1879,4,16,10,10,48,40,8,58
Queen of S't,1879,5,12,9,15,42,49,-7,45
Dumbarton,1879,6,9,13,14,50,61,-11,40
Dunfermline,1879,7,9,12,15,46,53,-7,39
Ayr,1879,8,9,12,15,34,53,-19,39
St Mirren,1879,9,9,10,17,41,54,-13,37
Raith,1879,10,9,9,18,32,49,-17,36
Morton,1880,1,18,11,7,50,34,16,65
Hibernian,1880,2,18,10,8,54,30,24,64
Falkirk,1880,3,17,11,8,61,40,21,62
Dundee Utd,1880,4,15,11,10,50,36,14,56
Queen of S't,1880,5,12,8,16,44,50,-6,44
Dunfermline,1880,6,10,12,14,47,50,-3,42
Dumbarton,1880,7,10,12,14,47,53,-6,42
Raith,1880,8,11,8,17,35,52,-17,41
St Mirren,1880,9,10,9,17,43,54,-11,39
Ayr,1880,10,8,10,18,30,62,-32,34
Hibernian,1881,1,17,14,5,52,28,24,65
Morton,1881,2,17,11,8,53,37,16,62
Dundee Utd,1881,3,15,11,10,52,39,13,56
Falkirk,1881,4,14,13,9,52,39,13,55
Queen of S't,1881,5,13,9,14,48,46,2,48
Dunfermline,1881,6,11,12,13,49,50,-1,45
St Mirren,1881,7,9,13,14,42,51,-9,40
Ayr,1881,8,9,12,15,36,54,-18,39
Raith,1881,9,9,11,16,33,53,-20,38
Dumbarton,1881,10,7,12,17,45,65,-20,33
Hibernian,1882,1,19,12,5,57,29,28,69
Morton,1882,2,19,9,8,52,38,14,66
Falkirk,1882,3,18,10,8,67,44,23,64
Dundee Utd,1882,4,16,8,12,46,39,7,56
Dunfermline,1882,5,11,11,14,45,47,-2,44
Queen of S't,1882,6,11,9,16,45,54,-9,42
Raith,1882,7,11,9,16,40,50,-10,42
Dumbarton,1882,8,9,11,16,51,60,-9,38
Ayr,1882,9,9,11,16,35,57,-22,38
St Mirren,1882,10,7,10,19,40,60,-20,31
Hibernian,1883,1,17,12,7,54,33,21,63
Morton,1883,2,17,12,7,52,36,16,63
Falkirk,1883,3,17,11,8,61,42,19,62
Dundee Utd,1883,4,16,9,11,51,42,9,57
Dunfermline,1883,5,11,12,13,51,46,5,45
Queen of S't,1883,6,11,9,16,49,55,-6,42
Ayr,1883,7,9,13,14,37,52,-15,40
St Mirren,1883,8,9,12,15,40,52,-12,39
Raith,1883,9,8,13,15,33,50,-17,37
Dumbarton,1883,10,8,11,17,45,65,-20,35
Hibernian,1884,1,20,11,5,57,23,34,71
Morton,1884,2,17,11,8,49,34,15,62
Dundee Utd,1884,3,16,11,9,50,38,12,59
Falkirk,1884,4,16,10,10,62,42,20,58
Dunfermline,1884,5,11,12,13,47,47,0,45
Raith,1884,6,12,8,16,38,56,-18,44
Queen of S't,1884,7,11,10,15,45,52,-7,43
Dumbarton,1884,8,10,12,14,47,56,-9,42
Ayr,1884,9,6,14,16,31,56,-25,32
St Mirren,1884,10,6,11,19,38,60,-22,29
Hibernian,1885,1,18,11,7,56,31,25,65
Falkirk,1885,2,17,10,9,61,40,21,61
Morton,1885,3,15,15,6,46,31,15,60
Dundee Utd,1885,4,16,9,11,47,39,8,57
Dunfermline,1885,5,10,15,11,49,46,3,45
Queen of S't,1885,6,12,9,15,43,50,-7,45
Ayr,1885,7,9,13,14,33,49,-16,40
Dumbarton,1885,8,9,11,16,44,57,-13,38
Raith,1885,9,9,10,17,34,52,-18,37
St Mirren,1885,10,9,9,18,39,57,-18,36
Hibernian,1886,1,19,13,4,54,25,29,70
Falkirk,1886,2,17,9,10,59,43,16,60
Dundee Utd,1886,3,17,9,10,54,38,16,60
Morton,1886,4,14,13,9,45,37,8,55
Queen of S't,1886,5,11,11,14,45,45,0,44
St Mirren,1886,6,11,11,14,44,49,-5,44
Dumbarton,1886,7,9,12,15,45,58,-13,39
Dunfermline,1886,8,8,14,14,44,51,-7,38
Raith,1886,9,9,11,16,34,50,-16,38
Ayr,1886,10,8,11,17,34,62,-28,35
Hibernian,1887,1,18,12,6,53,26,27,66
Morton,1887,2,18,10,8,50,35,15,64
Falkirk,1887,3,18,9,9,61,39,22,63
Dundee Utd,1887,4,16,10,10,49,38,11,58
Dumbarton,1887,5,11,11,14,51,59,-8,44
Queen of S't,1887,6,11,10,15,44,56,-12,43
Dunfermline,1887,7,9,13,14,45,50,-5,40
Ayr,1887,8,9,11,16,34,54,-20,38
St Mirren,1887,9,9,10,17,45,56,-11,37
Raith,1887,10,9,8,19,32,51,-19,35
Hibernian,1888,1,20,11,5,60,29,31,71
Falkirk,1888,2,17,11,8,62,39,23,62
Morton,1888,3,15,12,9,52,43,9,57
Dundee Utd,1888,4,15,12,9,48,39,9,57
Raith,1888,5,11,10,15,36,49,-13,43
Dunfermline,1888,6,9,15,12,47,50,-3,42
Queen of S't,1888,7,10,9,17,47,55,-8,39
St Mirren,1888,8,9,11,16,46,56,-10,38
Ayr,1888,9,9,11,16,33,54,-21,38
Dumbarton,1888,10,9,10,17,47,64,-17,37
Hibernian,1889,1,21,10,5,63,26,37,73
Falkirk,1889,2,18,9,9,58,42,16,63
Morton,1889,3,17,12,7,50,36,14,63
Dundee Utd,1889,4,14,12,10,53,43,10,54
Queen of S't,1889,5,11,11,14,43,49,-6,44
Dunfermline,1889,6,9,15,12,46,48,-2,42
Dumbarton,1889,7,9,12,15,49,57,-8,39
Raith,1889,8,9,10,17,36,52,-16,37
St Mirren,1889,9,8,10,18,42,60,-18,34
Ayr,1889,10,7,13,16,35,62,-27,34
Hibernian,1890,1,18,13,5,55,25,30,67
Morton,1890,2,18,11,7,50,35,15,65
Falkirk,1890,3,16,10,10,61,44,17,58
Dundee Utd,1890,4,15,11,10,52,42,10,56
Queen of S't,1890,5,14,8,14,48,53,-5,50
Dunfermline,1890,6,11,12,13,45,47,-2,45
Dumbarton,1890,7,10,11,15,52,57,-5,41
Raith,1890,8,11,8,17,34,45,-11,41
St Mirren,1890,9,8,9,19,41,63,-22,33
Ayr,1890,10,7,11,18,28,55,-27,32
Hibernian,1891,1,18,12,6,58,29,29,66
Morton,1891,2,16,12,8,49,34,15,60
Falkirk,1891,3,16,10,10,61,43,18,58
Dundee Utd,1891,4,16,9,11,47,38,9,57
Queen of S't,1891,5,12,11,13,44,47,-3,47
Ayr,1891,6,11,12,13,36,51,-15,45
Dunfermline,1891,7,11,11,14,48,51,-3,44
Raith,1891,8,9,10,17,35,56,-21,37
St Mirren,1891,9,8,12,16,38,55,-17,36
Dumbarton,1891,10,8,11,17,46,58,-12,35
Hibernian,1892,1,17,15,4,55,28,27,66
Morton,1892,2,16,13,7,51,38,13,61
Dundee Utd,1892,3,16,9,11,49,40,9,57
Falkirk,1892,4,13,14,9,54,41,13,53
Dunfermline,1892,5,11,12,13,50,49,1,45
Queen of S't,1892,6,11,10,15,42,52,-10,43
St Mirren,1892,7,10,11,15,45,52,-7,41
Ayr,1892,8,9,13,14,35,51,-16,40
Raith,1892,9,9,12,15,33,45,-12,39
Dumbarton,1892,10,8,11,17,46,64,-18,35
Hibernian,1893,1,19,11,6,55,30,25,68
Morton,1893,2,16,12,8,48,37,11,60
Falkirk,1893,3,16,10,10,58,50,8,58
Dundee Utd,1893,4,15,12,9,55,42,13,57
Dumbarton,1893,5,11,11,14,48,54,-6,44
Dunfermline,1893,6,9,14,13,54,51,3,41
Queen of S't,1893,7,9,12,15,44,53,-9,39
Raith,1893,8,9,12,15,37,49,-12,39
St Mirren,1893,9,8,14,14,41,53,-12,38
Ayr,1893,10,8,12,16,32,53,-21,36
Hibernian,1894,1,23,10,3,63,21,42,79
Dundee Utd,1894,2,17,9,10,55,43,12,60
Morton,1894,3,16,10,10,51,39,12,58
Falkirk,1894,4,15,12,9,56,42,14,57
Dumbarton,1894,5,11,10,15,47,59,-12,43
Dunfermline,1894,6,10,12,14,45,47,-2,42
Queen of S't,1894,7,10,11,15,46,52,-6,41
Ayr,1894,8,9,11,16,32,51,-19,38
Raith,1894,9,9,10,17,31,52,-21,37
St Mirren,1894,10,7,11,18,36,56,-20,32
Hibernian,1895,1,21,11,4,59,24,35,74
Dundee Utd,1895,2,17,9,10,52,38,14,60
Falkirk,1895,3,16,11,9,61,39,22,59
Morton,1895,4,15,11,10,47,41,6,56
Queen of S't,1895,5,13,9,14,49,55,-6,48
Dunfermline,1895,6,11,11,14,51,50,1,44
Ayr,1895,7,10,11,15,34,51,-17,41
Raith,1895,8,9,11,16,34,50,-16,38
Dumbarton,1895,9,9,10,17,48,62,-14,37
St Mirren,1895,10,7,10,19,37,62,-25,31
Hibernian,1896,1,18,12,6,55,27,28,66
Morton,1896,2,17,13,6,53,38,15,64
Falkirk,1896,3,16,11,9,57,39,18,59
Dundee Utd,1896,4,15,10,11,48,42,6,55
Queen of S't,1896,5,15,9,12,50,44,6,54
St Mirren,1896,6,10,9,17,41,55,-14,39
Raith,1896,7,10,9,17,33,52,-19,39
Ayr,1896,8,9,11,16,34,52,-18,38
Dunfermline,1896,9,8,13,15,43,48,-5,37
Dumbarton,1896,10,8,11,17,43,60,-17,35
Hibernian,1897,1,19,12,5,55,26,29,69
Falkirk,1897,2,17,10,9,61,41,20,61
Dundee Utd,1897,3,15,11,10,50,38,12,56
Morton,1897,4,14,12,10,45,39,6,54
Queen of S't,1897,5,13,8,15,48,49,-1,47
Dunfermline,1897,6,10,14,12,51,50,1,44
Ayr,1897,7,9,13,14,36,55,-19,40
St Mirren,1897,8,9,11,16,46,60,-14,38
Raith,1897,9,9,11,16,33,50,-17,38
Dumbarton,1897,10,8,12,16,44,61,-17,36
Hibernian,1898,1,18,12,6,51,25,26,66
Morton,1898,2,18,9,9,51,40,11,63
Falkirk,1898,3,16,10,10,56,40,16,58
Dundee Utd,1898,4,15,9,12,51,44,7,54
Queen of S't,1898,5,13,10,13,48,49,-1,49
Dunfermline,1898,6,10,13,13,45,46,-1,43
Raith,1898,7,11,10,15,36,48,-12,43
Ayr,1898,8,8,14,14,34,52,-18,38
Dumbarton,1898,9,8,13,15,46,57,-11,37
St Mirren,1898,10,7,12,17,37,54,-17,33
Hibernian,1899,1,20,12,4,54,26,28,72
Morton,1899,2,18,11,7,57,36,21,65
Falkirk,1899,3,17,10,9,59,37,22,61
Dundee Utd,1899,4,15,10,11,52,42,10,55
Ayr,1899,5,11,12,13,38,51,-13,45
Queen of S't,1899,6,12,8,16,48,51,-3,44
Dumbarton,1899,7,9,13,14,48,58,-10,40
Dunfermline,1899,8,8,13,15,42,57,-15,37
Raith,1899,9,9,9,18,34,50,-16,36
St Mirren,1899,10,7,10,19,37,61,-24,31
Hibernian,1900,1,19,14,3,61,28,33,71
Falkirk,1900,2,18,10,8,62,42,20,64
Morton,1900,3,17,12,7,55,37,18,63
Dundee Utd,1900,4,18,8,10,51,39,12,62
Dunfermline,1900,5,11,12,13,52,50,2,45
Raith,1900,6,10,10,16,37,49,-12,40
Ayr,1900,7,9,11,16,35,58,-23,38
Dumbarton,1900,8,8,12,16,46,60,-14,36
Queen of S't,1900,9,9,8,19,41,57,-16,35
St Mirren,1900,10,6,13,17,39,59,-20,31
Hibernian,1901,1,20,10,6,54,26,28,70
Morton,1901,2,17,9,10,48,36,12,60
Falkirk,1901,3,15,12,9,58,41,17,57
Dundee Utd,1901,4,16,9,11,54,42,12,57
Dunfermline,1901,5,10,14,12,50,51,-1,44
Queen of S't,1901,6,11,10,15,46,51,-5,43
St Mirren,1901,7,11,9,16,42,52,-10,42
Raith,1901,8,10,10,16,35,52,-17,40
Dumbarton,1901,9,8,13,15,50,61,-11,37
Ayr,1901,10,9,10,17,35,60,-25,37
Hibernian,1902,1,18,12,6,53,27,26,66
Morton,1902,2,19,9,8,54,35,19,66
Falkirk,1902,3,17,9,10,57,43,14,60
Dundee Utd,1902,4,16,9,11,53,40,13,57
Queen of S't,1902,5,16,8,12,48,45,3,56
Dumbarton,1902,6,9,12,15,50,56,-6,39
Dunfermline,1902,7,9,12,15,46,53,-7,39
St Mirren,1902,8,9,10,17,44,60,-16,37
Raith,1902,9,9,9,18,33,53,-20,36
Ayr,1902,10,8,10,18,34,60,-26,34
Hibernian,1903,1,22,10,4,63,27,36,76
Dundee Utd,1903,2,17,10,9,53,35,18,61
Morton,1903,3,14,14,8,45,38,7,56
Falkirk,1903,4,15,10,11,57,43,14,55
Queen of S't,1903,5,11,13,12,45,46,-1,46
Raith,1903,6,10,11,15,35,50,-15,41
Dunfermline,1903,7,9,13,14,46,48,-2,40
Dumbarton,1903,8,9,11,16,47,60,-13,38
Ayr,1903,9,8,12,16,37,58,-21,36
St Mirren,1903,10,8,10,18,37,60,-23,34
Hibernian,1904,1,18,14,4,53,25,28,68
Morton,1904,2,17,12,7,50,37,13,63
Falkirk,1904,3,16,10,10,58,40,18,58
Dundee Utd,1904,4,15,12,9,49,40,9,57
Dunfermline,1904,5,10,15,11,46,45,1,45
Queen of S't,1904,6,10,13,13,45,50,-5,43
Ayr,1904,7,9,13,14,33,52,-19,40
Dumbarton,1904,8,9,11,16,48,57,-9,38
Raith,1904,9,9,9,18,36,53,-17,36
St Mirren,1904,10,7,11,18,37,56,-19,32
Hibernian,1905,1,19,13,4,55,23,32,70
Morton,1905,2,17,12,7,51,37,14,63
Falkirk,1905,3,16,10,10,58,38,20,58
Dundee Utd,1905,4,13,12,11,45,41,4,51
Queen of S't,1905,5,12,9,15,48,53,-5,45
St Mirren,1905,6,11,10,15,37,48,-11,43
Dunfermline,1905,7,9,14,13,46,50,-4,41
Raith,1905,8,10,11,15,35,48,-13,41
Dumbarton,1905,9,9,11,16,48,60,-12,38
Ayr,1905,10,6,14,16,30,55,-25,32
Hibernian,1906,1,20,12,4,56,23,33,72
Morton,1906,2,19,9,8,48,33,15,66
Dundee Utd,1906,3,17,10,9,49,37,12,61
Falkirk,1906,4,16,10,10,57,43,14,58
Dunfermline,1906,5,11,12,13,50,46,4,45
Dumbarton,1906,6,11,10,15,52,54,-2,43
Queen of S't,1906,7,10,10,16,39,52,-13,40
Raith,1906,8,8,12,16,32,50,-18,36
St Mirren,1906,9,8,11,17,40,60,-20,35
Ayr,1906,10,6,12,18,31,56,-25,30
Hibernian,1907,1,19,13,4,55,26,29,70
Morton,1907,2,19,10,7,53,37,16,67
Falkirk,1907,3,16,11,9,61,41,20,59
Dundee Utd,1907,4,16,9,11,50,42,8,57
Queen of S't,1907,5,14,9,13,49,50,-1,51
Dunfermline,1907,6,10,13,13,48,45,3,43
Dumbarton,1907,7,9,12,15,50,62,-12,39
Raith,1907,8,8,11,17,36,54,-18,35
Ayr,1907,9,7,13,16,36,58,-22,34
St Mirren,1907,10,6,11,19,36,59,-23,29
Hibernian,1908,1,18,13,5,57,25,32,67
Falkirk,1908,2,17,10,9,56,41,15,61
Morton,1908,3,16,12,8,51,37,14,60
Dundee Utd,1908,4,16,10,10,53,37,16,58
Dunfermline,1908,5,10,13,13,47,50,-3,43
Queen of S't,1908,6,11,10,15,42,46,-4,43
Ayr,1908,7,10,11,15,36,55,-19,41
Raith,1908,8,9,12,15,34,47,-13,39
Dumbarton,1908,9,9,11,16,45,61,-16,38
St Mirren,1908,10,8,10,18,41,63,-22,34
Morton,1909,1,19,12,5,56,36,20,69
Hibernian,1909,2,18,13,5,57,26,31,67
Falkirk,1909,3,15,13,8,63,45,18,58
Dundee Utd,1909,4,15,10,11,48,43,5,55
Queen of S't,1909,5,12,10,14,46,50,-4,46
Dunfermline,1909,6,10,15,11,49,48,1,45
Dumbarton,1909,7,9,12,15,48,57,-9,39
Raith,1909,8,8,11,17,31,49,-18,35
St Mirren,1909,9,8,10,18,40,57,-17,34
Ayr,1909,10,6,14,16,32,59,-27,32
Hibernian,1910,1,21,11,4,59,24,35,74
Morton,1910,2,19,10,7,55,38,17,67
Falkirk,1910,3,16,10,10,60,40,20,58
Dundee Utd,1910,4,15,11,10,54,42,12,56
Queen of S't,1910,5,12,9,15,48,55,-7,45
Raith,1910,6,10,11,15,40,51,-11,41
Dunfermline,1910,7,8,14,14,47,53,-6,38
Ayr,1910,8,7,17,12,37,53,-16,38
Dumbarton,1910,9,8,11,17,46,63,-17,35
St Mirren,1910,10,7,10,19,41,68,-27,31
Hibernian,1911,1,20,11,5,58,23,35,71
Dundee Utd,1911,2,18,10,8,55,38,17,64
Falkirk,1911,3,18,9,9,59,43,16,63
Morton,1911,4,17,11,8,54,41,13,62
Dumbarton,1911,5,11,10,15,55,62,-7,43
Dunfermline,1911,6,9,13,14,47,52,-5,40
Raith,1911,7,9,11,16,36,52,-16,38
Queen of S't,1911,8,9,9,18,40,52,-12,36
St Mirren,1911,9,9,9,18,41,60,-19,36
Ayr,1911,10,7,13,16,35,57,-22,34
Morton,1912,1,20,11,5,54,31,23,71
Hibernian,1912,2,18,13,5,52,24,28,67
Dundee Utd,1912,3,17,8,11,52,40,12,59
Falkirk,1912,4,16,10,10,59,39,20,58
Dunfermline,1912,5,9,15,12,45,48,-3,42
Dumbarton,1912,6,10,11,15,49,55,-6,41
Queen of S't,1912,7,10,9,17,40,51,-11,39
Raith,1912,8,9,11,16,33,50,-17,38
Ayr,1912,9,9,10,17,34,58,-24,37
St Mirren,1912,10,8,10,18,38,60,-22,34
Hibernian,1913,1,20,11,5,53,24,29,71
Falkirk,1913,2,15,11,10,57,46,11,56
Dundee Utd,1913,3,15,11,10,52,41,11,56
Morton,1913,4,15,11,10,48,39,9,56
Queen of S't,1913,5,13,9,14,53,52,1,48
St Mirren,1913,6,11,11,14,51,56,-5,44
Ayr,1913,7,9,13,14,38,53,-15,40
Raith,1913,8,10,9,17,39,53,-14,39
Dumbarton,1913,9,9,11,16,46,60,-14,38
Dunfermline,1913,10,8,13,15,38,51,-13,37
Hibernian,1914,1,17,14,5,52,26,26,65
Falkirk,1914,2,18,11,7,59,34,25,65
Morton,1914,3,15,12,9,47,41,6,57
Dundee Utd,1914,4,15,10,11,47,41,6,55
Dunfermline,1914,5,12,11,13,52,46,6,47
Queen of S't,1914,6,11,10,15,46,50,-4,43
Ayr,1914,7,10,12,14,37,50,-13,42
Dumbarton,1914,8,9,11,16,46,59,-13,38
Raith,1914,9,10,8,18,36,56,-20,38
St Mirren,1914,10,8,11,17,36,55,-19,35
Hibernian,1915,1,18,11,7,53,31,22,65
Morton,1915,2,17,11,8,52,37,15,62
Falkirk,1915,3,16,12,8,60,40,20,60
Dundee Utd,1915,4,15,9,12,47,43,4,54
Queen of S't,1915,5,13,9,14,50,49,1,48
Raith,1915,6,11,11,14,35,44,-9,44
Dumbarton,1915,7,10,11,15,49,56,-7,41
Ayr,1915,8,9,11,16,34,55,-21,38
Dunfermline,1915,9,8,13,15,42,54,-12,37
St Mirren,1915,10,8,12,16,42,55,-13,36
Falkirk,1916,1,18,10,8,61,38,23,64
Hibernian,1916,2,18,10,8,53,30,23,64
Morton,1916,3,17,10,9,47,35,12,61
Dundee Utd,1916,4,17,9,10,51,40,11,60
St Mirren,1916,5,12,9,15,42,50,-8,45
Dunfermline,1916,6,10,13,13,47,49,-2,43
Queen of S't,1916,7,10,10,16,43,54,-11,40
Raith,1916,8,10,10,16,33,49,-16,40
Dumbarton,1916,9,8,12,16,49,61,-12,36
Ayr,1916,10,8,11,17,32,52,-20,35
Hibernian,1917,1,19,10,7,55,28,27,67
Morton,1917,2,18,10,8,53,37,16,64
Dundee Utd,1917,3,17,8,11,53,39,14,59
Falkirk,1917,4,15,11,10,55,43,12,56
Dunfermline,1917,5,11,11,14,51,51,0,44
Raith,1917,6,11,10,15,34,45,-11,43
Queen of S't,1917,7,11,9,16,44,51,-7,42
Dumbarton,1917,8,10,11,15,46,55,-9,41
Ayr,1917,9,9,12,15,31,51,-20,39
St Mirren,1917,10,8,10,18,38,60,-22,34
Hibernian,1918,1,20,12,4,57,24,33,72
Falkirk,1918,2,18,10,8,63,36,27,64
Morton,1918,3,18,10,8,56,36,20,64
Dundee Utd,1918,4,16,9,11,57,45,12,57
Queen of S't,1918,5,11,9,16,43,52,-9,42
Dunfermline,1918,6,9,13,14,43,51,-8,40
St Mirren,1918,7,9,12,15,36,50,-14,39
Raith,1918,8,10,9,17,37,55,-18,39
Dumbarton,1918,9,7,15,14,42,54,-12,36
Ayr,1918,10,6,13,17,30,61,-31,31
Dundee Utd,1919,1,18,9,9,56,41,15,63
Hibernian,1919,2,16,13,7,50,28,22,61
Morton,1919,3,16,13,7,54,39,15,61
Falkirk,1919,4,16,12,8,61,36,25,60
Queen of S't,1919,5,12,10,14,45,48,-3,46
Raith,1919,6,10,12,14,35,44,-9,42
Dunfermline,1919,7,9,12,15,45,56,-11,39
Dumbarton,1919,8,9,11,16,49,65,-16,38
Ayr,1919,9,8,13,15,35,56,-21,37
St Mirren,1919,10,8,11,17,44,61,-17,35
Hibernian,1920,1,17,12,7,53,31,22,63
Morton,1920,2,16,11,9,49,35,14,59
Dundee Utd,1920,3,16,9,11,50,40,10,57
Falkirk,1920,4,15,11,10,56,41,15,56
Queen of S't,1920,5,12,11,13,48,51,-3,47
Raith,1920,6,12,9,15,39,48,-9,45
Dunfermline,1920,7,10,12,14,47,53,-6,42
Dumbarton,1920,8,10,11,15,50,59,-9,41
Ayr,1920,9,10,10,16,34,55,-21,40
St Mirren,1920,10,9,10,17,42,55,-13,37
Hibernian,1921,1,20,12,4,56,23,33,72
Falkirk,1921,2,16,12,8,62,43,19,60
Dundee Utd,1921,3,15,11,10,50,39,11,56
Morton,1921,4,14,13,9,45,37,8,55
Queen of S't,1921,5,11,10,15,43,53,-10,43
Raith,1921,6,10,12,14,41,47,-6,42
Dunfermline,1921,7,9,13,14,43,51,-8,40
Ayr,1921,8,8,14,14,34,55,-21,38
Dumbarton,1921,9,8,13,15,48,59,-11,37
St Mirren,1921,10,8,12,16,39,54,-15,36
Hibernian,1922,1,18,13,5,57,27,30,67
Dundee Utd,1922,2,17,10,9,53,36,17,61
Morton,1922,3,16,12,8,51,41,10,60
Falkirk,1922,4,16,11,9,55,40,15,59
Dunfermline,1922,5,12,14,10,49,41,8,50
Queen of S't,1922,6,11,10,15,44,55,-11,43
St Mirren,1922,7,9,12,15,42,53,-11,39
Raith,1922,8,9,10,17,34,52,-18,37
Dumbarton,1922,9,7,13,16,43,56,-13,34
Ayr,1922,10,7,11,18,33,60,-27,32
Hibernian,1923,1,20,12,4,56,27,29,72
Morton,1923,2,17,11,8,55,37,18,62
Dundee Utd,1923,3,16,10,10,50,41,9,58
Falkirk,1923,4,15,11,10,58,40,18,56
Queen of S't,1923,5,12,10,14,50,50,0,46
Raith,1923,6,12,9,15,41,48,-7,45
Dunfermline,1923,7,10,12,14,44,50,-6,42
Ayr,1923,8,9,11,16,37,58,-21,38
Dumbarton,1923,9,8,13,15,48,66,-18,37
St Mirren,1923,10,6,11,19,38,60,-22,29
Hibernian,1924,1,20,10,6,60,28,32,70
Falkirk,1924,2,17,10,9,63,43,20,61
Dundee Utd,1924,3,16,10,10,53,41,12,58
Morton,1924,4,15,13,8,44,36,8,58
Dunfermline,1924,5,11,13,12,52,51,1,46
Dumbarton,1924,6,10,13,13,51,56,-5,43
Queen of S't,1924,7,11,8,17,47,55,-8,41
Raith,1924,8,11,8,17,37,57,-20,41
St Mirren,1924,9,8,11,17,40,54,-14,35
Ayr,1924,10,8,10,18,34,60,-26,34
Hibernian,1925,1,18,12,6,53,27,26,66
Morton,1925,2,18,12,6,51,33,18,66
Falkirk,1925,3,16,11,9,57,42,15,59
Dundee Utd,1925,4,13,10,13,49,44,5,49
Dunfermline,1925,5,11,14,11,51,45,6,47
Dumbarton,1925,6,11,10,15,49,57,-8,43
Queen of S't,1925,7,10,10,16,43,53,-10,40
Raith,1925,8,10,10,16,35,51,-16,40
Ayr,1925,9,9,13,14,34,50,-16,40
St Mirren,1925,10,8,10,18,40,60,-20,34
Hibernian,1926,1,20,13,3,58,23,35,73
Falkirk,1926,2,16,10,10,55,41,14,58
Dundee Utd,1926,3,14,10,12,45,38,7,52
Morton,1926,4,13,13,10,45,39,6,52
Queen of S't,1926,5,13,10,13,45,45,0,49
Raith,1926,6,12,10,14,38,47,-9,46
Ayr,1926,7,10,12,14,34,51,-17,42
Dunfermline,1926,8,8,15,13,45,48,-3,39
Dumbarton,1926,9,9,11,16,48,61,-13,38
St Mirren,1926,10,8,10,18,36,56,-20,34
Hibernian,1927,1,20,11,5,58,27,31,71
Falkirk,1927,2,16,13,7,59,40,19,61
Dundee Utd,1927,3,17,9,10,54,42,12,60
Morton,1927,4,16,10,10,52,42,10,58
Queen of S't,1927,5,13,10,13,45,46,-1,49
Dunfermline,1927,6,10,13,13,52,52,0,43
Dumbarton,1927,7,9,11,16,47,57,-10,38
Ayr,1927,8,9,10,17,33,57,-24,37
St Mirren,1927,9,9,9,18,41,55,-14,36
Raith,1927,10,9,8,19,36,59,-23,35
Hibernian,1928,1,20,12,4,65,25,40,72
Falkirk,1928,2,19,9,8,67,40,27,66
Morton,1928,3,17,12,7,49,36,13,63
Dundee Utd,1928,4,14,11,11,51,42,9,53
Queen of S't,1928,5,12,10,14,49,51,-2,46
Raith,1928,6,10,10,16,35,50,-15,40
Dumbarton,1928,7,9,11,16,48,65,-17,38
Ayr,1928,8,8,13,15,36,56,-20,37
Dunfermline,1928,9,8,12,16,43,55,-12,36
St Mirren,1928,10,8,10,18,38,61,-23,34
Hibernian,1929,1,19,11,6,51,25,26,68
Morton,1929,2,18,10,8,53,38,15,64
Dundee Utd,1929,3,16,10,10,55,40,15,58
Falkirk,1929,4,15,11,10,53,40,13,56
Queen of S't,1929,5,12,9,15,46,51,-5,45
Dunfermline,1929,6,10,12,14,51,53,-2,42
Raith,1929,7,11,9,16,39,48,-9,42
Dumbarton,1929,8,10,10,16,50,61,-11,40
St Mirren,1929,9,10,10,16,41,54,-13,40
Ayr,1929,10,8,10,18,35,64,-29,34
Hibernian,1930,1,18,13,5,54,27,27,67
Falkirk,1930,2,16,12,8,62,40,22,60
Morton,1930,3,15,13,8,48,37,11,58
Dundee Utd,1930,4,13,10,13,49,45,4,49
Dunfermline,1930,5,11,14,11,47,48,-1,47
Raith,1930,6,13,8,15,39,49,-10,47
Queen of S't,1930,7,11,9,16,46,56,-10,42
Ayr,1930,8,9,12,15,35,54,-19,39
St Mirren,1930,9,9,11,16,44,54,-10,38
Dumbarton,1930,10,9,10,17,44,58,-14,37
Falkirk,1931,1,19,9,8,66,37,29,66
Morton,1931,2,18,11,7,50,34,16,65
Hibernian,1931,3,17,12,7,54,32,22,63
Dundee Utd,1931,4,16,10,10,52,39,13,58
Dunfermline,1931,5,10,12,14,44,47,-3,42
Dumbarton,1931,6,10,12,14,47,53,-6,42
Queen of S't,1931,7,10,11,15,39,50,-11,41
St Mirren,1931,8,9,10,17,40,56,-16,37
Raith,1931,9,9,10,17,33,54,-21,37
Ayr,1931,10,7,13,16,33,56,-23,34
Hibernian,1932,1,18,13,5,58,27,31,67
Dundee Utd,1932,2,18,9,9,55,39,16,63
Morton,1932,3,16,14,6,50,38,12,62
Falkirk,1932,4,16,11,9,58,44,14,59
Dunfermline,1932,5,11,13,12,51,50,1,46
Queen of S't,1932,6,11,9,16,44,57,-13,42
Ayr,1932,7,9,13,14,36,52,-16,40
St Mirren,1932,8,8,13,15,44,56,-12,37
Dumbarton,1932,9,7,12,17,52,65,-13,33
Raith,1932,10,8,9,19,35,55,-20,33
Hibernian,1933,1,19,14,3,55,23,32,71
Morton,1933,2,18,12,6,56,35,21,66
Falkirk,1933,3,16,11,9,62,40,22,59
Dundee Utd,1933,4,16,10,10,53,39,14,58
Queen of S't,1933,5,12,9,15,46,53,-7,45
Dunfermline,1933,6,9,14,13,45,51,-6,41
Dumbarton,1933,7,8,13,15,46,60,-14,37
Ayr,1933,8,8,13,15,34,54,-20,37
St Mirren,1933,9,9,9,18,40,60,-20,36
Raith,1933,10,8,9,19,32,54,-22,33
Hibernian,1934,1,18,13,5,52,26,26,67
Dundee Utd,1934,2,18,10,8,53,37,16,64
Morton,1934,3,14,15,7,50,41,9,57
Falkirk,1934,4,14,12,10,56,43,13,54
Dunfermline,1934,5,10,14,12,48,49,-1,44
Raith,1934,6,10,12,14,37,47,-10,42
Ayr,1934,7,10,12,14,38,51,-13,42
Queen of S't,1934,8,10,10,16,42,52,-10,40
Dumbarton,1934,9,9,12,15,49,58,-9,39
St Mirren,1934,10,7,10,19,36,57,-21,31
Hibernian,1935,1,19,13,4,56,23,33,70
Falkirk,1935,2,16,11,9,60,43,17,59
Morton,1935,3,15,11,10,44,34,10,56
Dundee Utd,1935,4,15,11,10,51,42,9,56
Dunfermline,1935,5,13,12,11,50,46,4,51
Raith,1935,6,12,8,16,33,45,-12,44
St Mirren,1935,7,9,12,15,42,52,-10,39
Dumbarton,1935,8,9,11,16,45,59,-14,38
Queen of S't,1935,9,10,8,18,41,56,-15,38
Ayr,1935,10,8,11,17,35,57,-22,35
Hibernian,1936,1,19,12,5,54,25,29,69
Morton,1936,2,17,12,7,49,36,13,63
Dundee Utd,1936,3,17,9,10,56,39,17,60
Falkirk,1936,4,16,10,10,60,42,18,58
Queen of S't,1936,5,12,9,15,43,51,-8,45
Raith,1936,6,11,9,16,35,46,-11,42
Dunfermline,1936,7,8,15,13,44,53,-9,39
St Mirren,1936,8,10,9,17,42,54,-12,39
Ayr,1936,9,9,11,16,38,58,-20,38
Dumbarton,1936,10,8,10,18,46,63,-17,34
Hibernian,1937,1,19,13,4,52,21,31,70
Falkirk,1937,2,16,13,7,62,39,23,61
Morton,1937,3,15,13,8,44,35,9,58
Dundee Utd,1937,4,13,11,12,49,46,3,50
Dumbarton,1937,5,12,10,14,56,58,-2,46
Queen of S't,1937,6,10,12,14,43,48,-5,42
Ayr,1937,7,10,11,15,36,51,-15,41
Raith,1937,8,10,10,16,35,50,-15,40
Dunfermline,1937,9,8,15,13,43,50,-7,39
St Mirren,1937,10,8,10,18,38,60,-22,34
Hibernian,1938,1,18,14,4,57,29,28,68
Morton,1938,2,16,12,8,52,40,12,60
Falkirk,1938,3,13,14,9,55,41,14,53
Dundee Utd,1938,4,15,8,13,46,43,3,53
Queen of S't,1938,5,12,10,14,43,46,-3,46
Dumbarton,1938,6,12,10,14,45,52,-7,46
Dunfermline,1938,7,9,14,13,43,47,-4,41
Raith,1938,8,9,13,14,34,46,-12,40
St Mirren,1938,9,9,11,16,46,57,-11,38
Ayr,1938,10,8,12,16,37,57,-20,36
Hibernian,1939,1,20,13,3,57,22,35,73
Falkirk,1939,2,18,10,8,63,42,21,64
Dundee Utd,1939,3,16,10,10,51,42,9,58
Morton,1939,4,14,15,7,50,38,12,57
Dunfermline,1939,5,10,15,11,50,47,3,45
Raith,1939,6,11,9,16,35,47,-12,42
St Mirren,1939,7,9,11,16,42,54,-12,38
Queen of S't,1939,8,9,10,17,44,57,-13,37
Dumbarton,1939,9,8,11,17,45,61,-16,35
Ayr,1939,10,8,10,18,33,60,-27,34
Hibernian,1940,1,18,14,4,51,24,27,68
Dundee Utd,1940,2,17,8,11,55,44,11,59
Falkirk,1940,3,15,11,10,61,41,20,56
Morton,1940,4,13,12,11,41,40,1,51
Queen of S't,1940,5,13,9,14,48,55,-7,48
Dunfermline,1940,6,11,13,12,46,41,5,46
Ayr,1940,7,10,13,13,37,51,-14,43
St Mirren,1940,8,10,11,15,42,54,-12,41
Raith,1940,9,9,10,17,32,48,-16,37
Dumbarton,1940,10,8,11,17,50,65,-15,35
Hibernian,1941,1,19,13,4,53,24,29,70
Morton,1941,2,15,15,6,46,31,15,60
Falkirk,1941,3,15,13,8,56,40,16,58
Dundee Utd,1941,4,16,10,10,48,37,11,58
Raith,1941,5,12,9,15,40,51,-11,45
Dunfermline,1941,6,9,15,12,46,46,0,42
Queen of S't,1941,7,10,11,15,40,49,-9,41
Dumbarton,1941,8,8,14,14,47,56,-9,38
Ayr,1941,9,8,11,17,34,58,-24,35
St Mirren,1941,10,7,11,18,44,62,-18,32
Hibernian,1942,1,19,12,5,58,26,32,69
Morton,1942,2,16,12,8,51,39,12,60
Falkirk,1942,3,15,12,9,58,41,17,57
Dundee Utd,1942,4,15,11,10,57,44,13,56
Dunfermline,1942,5,10,14,12,48,48,0,44
Dumbarton,1942,6,10,12,14,52,64,-12,42
St Mirren,1942,7,10,11,15,40,51,-11,41
Queen of S't,1942,8,10,10,16,44,52,-8,40
Raith,1942,9,10,9,17,34,52,-18,39
Ayr,1942,10,7,13,16,37,62,-25,34
Hibernian,1943,1,19,11,6,54,26,28,68
Dundee Utd,1943,2,16,11,9,51,38,13,59
Morton,1943,3,16,10,10,49,39,10,58
Falkirk,1943,4,14,11,11,57,48,9,53
Dunfermline,1943,5,12,13,11,48,44,4,49
Queen of S't,1943,6,10,11,15,45,52,-7,41
Dumbarton,1943,7,10,11,15,45,57,-12,41
Raith,1943,8,10,10,16,36,47,-11,40
Ayr,1943,9,8,14,14,35,50,-15,38
St Mirren,1943,10,9,10,17,39,58,-19,37
Hibernian,1944,1,20,10,6,59,25,34,70
Falkirk,1944,2,19,10,7,64,39,25,67
Morton,1944,3,15,11,10,48,41,7,56
Dundee Utd,1944,4,15,10,11,48,46,2,55
Raith,1944,5,11,9,16,40,54,-14,42
Dumbarton,1944,6,10,11,15,50,57,-7,41
Dunfermline,1944,7,9,13,14,44,52,-8,40
Queen of S't,1944,8,10,10,16,45,55,-10,40
Ayr,1944,9,9,12,15,34,52,-18,39
St Mirren,1944,10,9,10,17,46,57,-11,37
Falkirk,1945,1,19,10,7,64,35,29,67
Hibernian,1945,2,17,15,4,54,28,26,66
Morton,1945,3,18,11,7,57,37,20,65
Dundee Utd,1945,4,16,9,11,50,39,11,57
Dunfermline,1945,5,10,13,13,44,48,-4,43
Raith,1945,6,10,10,16,33,47,-14,40
Queen of S't,1945,7,9,11,16,38,50,-12,38
Ayr,1945,8,8,13,15,34,54,-20,37
St Mirren,1945,9,8,12,16,43,57,-14,36
Dumbarton,1945,10,8,10,18,44,66,-22,34
Hibernian,1946,1,18,12,6,55,28,27,66
Morton,1946,2,16,12,8,50,37,13,60
Falkirk,1946,3,15,11,10,58,47,11,56
Dundee Utd,1946,4,15,9,12,43,38,5,54
Queen of S't,1946,5,12,10,14,45,48,-3,46
Dunfermline,1946,6,11,12,13,47,47,0,45
Raith,1946,7,10,11,15,34,47,-13,41
Ayr,1946,8,9,13,14,34,50,-16,40
St Mirren,1946,9,9,12,15,45,54,-9,39
Dumbarton,1946,10,9,10,17,45,60,-15,37
Hibernian,1947,1,17,14,5,52,26,26,65
Falkirk,1947,2,17,10,9,58,39,19,61
Morton,1947,3,15,16,5,47,32,15,61
Dundee Utd,1947,4,15,9,12,48,44,4,54
Queen of S't,1947,5,12,10,14,46,49,-3,46
Dunfermline,1947,6,10,14,12,50,47,3,44
Raith,1947,7,11,10,15,37,51,-14,43
Ayr,1947,8,7,15,14,33,56,-23,36
St Mirren,1947,9,8,11,17,41,54,-13,35
Dumbarton,1947,10,7,13,16,43,57,-14,34
Hibernian,1948,1,19,12,5,53,27,26,69
Morton,1948,2,17,11,8,50,39,11,62
Falkirk,1948,3,17,10,9,62,44,18,61
Dundee Utd,1948,4,17,8,11,61,41,20,59
Dunfermline,1948,5,10,15,11,48,45,3,45
Queen of S't,1948,6,12,9,15,46,52,-6,45
Dumbarton,1948,7,8,13,15,47,57,-10,37
St Mirren,1948,8,9,10,17,44,59,-15,37
Raith,1948,9,9,9,18,33,52,-19,36
Ayr,1948,10,8,11,17,36,64,-28,35
Hibernian,1949,1,20,11,5,59,30,29,71
Falkirk,1949,2,17,10,9,59,40,19,61
Morton,1949,3,16,11,9,51,41,10,59
Dundee Utd,1949,4,14,12,10,45,37,8,54
Dunfermline,1949,5,11,12,13,47,49,-2,45
Queen of S't,1949,6,11,11,14,46,51,-5,44
Dumbarton,1949,7,10,12,14,51,58,-7,42
Raith,1949,8,9,13,14,40,52,-12,40
Ayr,1949,9,7,13,16,37,58,-21,34
St Mirren,1949,10,7,11,18,40,59,-19,32
Hibernian,1950,1,20,11,5,56,24,32,71
Morton,1950,2,16,12,8,47,36,11,60
Falkirk,1950,3,16,10,10,63,44,19,58
Dundee Utd,1950,4,15,10,11,47,41,6,55
Queen of S't,1950,5,12,11,13,46,49,-3,47
Raith,1950,6,12,9,15,38,47,-9,45
Dunfermline,1950,7,9,14,13,45,47,-2,41
Dumbarton,1950,8,9,12,15,48,59,-11,39
Ayr,1950,9,8,11,17,32,55,-23,35
St Mirren,1950,10,8,10,18,36,56,-20,34
Hibernian,1951,1,20,13,3,63,25,38,73
Dundee Utd,1951,2,18,9,9,56,38,18,63
Falkirk,1951,3,16,9,11,58,45,13,57
Morton,1951,4,14,15,7,46,33,13,57
Queen of S't,1951,5,11,10,15,47,50,-3,43
Dunfermline,1951,6,9,15,12,44,49,-5,42
Raith,1951,7,10,9,17,34,54,-20,39
Dumbarton,1951,8,8,12,16,46,59,-13,36
St Mirren,1951,9,8,12,16,39,54,-15,36
Ayr,1951,10,8,12,16,32,58,-26,36
Hibernian,1952,1,20,10,6,58,27,31,70
Falkirk,1952,2,17,10,9,65,45,20,61
Morton,1952,3,16,12,8,49,35,14,60
Dundee Utd,1952,4,16,11,9,52,41,11,59
Dunfermline,1952,5,11,13,12,49,48,1,46
Queen of S't,1952,6,10,11,15,43,50,-7,41
Dumbarton,1952,7,8,14,14,44,53,-9,38
Ayr,1952,8,8,13,15,37,59,-22,37
Raith,1952,9,9,9,18,34,55,-21,36
St Mirren,1952,10,8,11,17,38,56,-18,35
Hibernian,1953,1,19,12,5,57,28,29,69
Morton,1953,2,18,10,8,58,34,24,64
Falkirk,1953,3,17,11,8,60,38,22,62
Dundee Utd,1953,4,16,9,11,48,41,7,57
Queen of S't,1953,5,12,9,15,41,48,-7,45
Dunfermline,1953,6,10,12,14,48,53,-5,42
St Mirren,1953,7,10,9,17,41,62,-21,39
Raith,1953,8,10,8,18,35,50,-15,38
Ayr,1953,9,9,11,16,38,57,-19,38
Dumbarton,1953,10,8,11,17,45,60,-15,35
Hibernian,1954,1,19,12,5,55,25,30,69
Falkirk,1954,2,19,9,8,61,40,21,66
Morton,1954,3,17,10,9,52,39,13,61
Dundee Utd,1954,4,16,9,11,53,43,10,57
Dumbarton,1954,5,11,10,15,54,60,-6,43
Queen of S't,1954,6,11,10,15,43,50,-7,43
Raith,1954,7,10,10,16,35,52,-17,40
Dunfermline,1954,8,9,12,15,45,51,-6,39
St Mirren,1954,9,8,11,17,46,59,-13,35
Ayr,1954,10,8,11,17,33,58,-25,35
Hibernian,1955,1,19,13,4,54,23,31,70
Morton,1955,2,17,11,8,47,34,13,62
Dundee Utd,1955,3,15,10,11,51,40,11,55
Falkirk,1955,4,14,12,10,58,47,11,54
Queen of S't,1955,5,14,10,12,47,44,3,52
Dunfermline,1955,6,10,13,13,46,51,-5,43
Dumbarton,1955,7,9,11,16,47,58,-11,38
St Mirren,1955,8,9,10,17,42,58,-16,37
Raith,1955,9,9,10,17,32,50,-18,37
Ayr,1955,10,7,14,15,34,53,-19,35
Hibernian,1956,1,20,11,5,59,29,30,71
Morton,1956,2,19,9,8,53,37,16,66
Dundee Utd,1956,3,17,9,10,53,37,16,60
Falkirk,1956,4,16,10,10,59,43,16,58
Queen of S't,1956,5,12,12,12,44,44,0,48
Dunfermline,1956,6,10,12,14,45,48,-3,42
Dumbarton,1956,7,10,10,16,45,61,-16,40
Raith,1956,8,9,11,16,37,51,-14,38
St Mirren,1956,9,7,11,18,36,54,-18,32
Ayr,1956,10,7,11,18,33,60,-27,32
Hibernian,1957,1,21,12,3,62,28,34,75
Dundee Utd,1957,2,18,10,8,65,39,26,64
Morton,1957,3,15,12,9,49,42,7,57
Falkirk,1957,4,14,12,10,58,44,14,54
Queen of S't,1957,5,13,8,15,50,54,-4,47
Dunfermline,1957,6,9,12,15,49,55,-6,39
Raith,1957,7,10,9,17,35,51,-16,39
St Mirren,1957,8,9,11,16,42,57,-15,38
Dumbarton,1957,9,8,13,15,49,66,-17,37
Ayr,1957,10,7,13,16,37,60,-23,34
Hibernian,1958,1,22,11,3,60,24,36,77
Falkirk,1958,2,16,9,11,59,41,18,57
Morton,1958,3,15,11,10,47,42,5,56
Dundee Utd,1958,4,15,10,11,48,44,4,55
Dunfermline,1958,5,11,13,12,55,51,4,46
Queen of S't,1958,6,11,10,15,47,54,-7,43
Raith,1958,7,11,10,15,42,53,-11,43
Dumbarton,1958,8,9,11,16,49,60,-11,38
Ayr,1958,9,9,10,17,34,54,-20,37
St Mirren,1958,10,8,11,17,41,59,-18,35
Hibernian,1959,1,18,11,7,54,26,28,65
Falkirk,1959,2,17,12,7,54,33,21,63
Morton,1959,3,17,12,7,49,34,15,63
Dundee Utd,1959,4,16,11,9,52,40,12,59
Queen of S't,1959,5,11,10,15,40,47,-7,43
Raith,1959,6,10,11,15,33,43,-10,41
Dunfermline,1959,7,8,15,13,41,48,-7,39
Ayr,1959,8,8,13,15,34,54,-20,37
St Mirren,1959,9,8,12,16,41,59,-18,36
Dumbarton,1959,10,8,11,17,45,59,-14,35
Hibernian,1960,1,20,12,4,58,23,35,72
Morton,1960,2,19,10,7,56,37,19,67
Dundee Utd,1960,3,17,9,10,53,43,10,60
Falkirk,1960,4,14,12,10,53,38,15,54
Ayr,1960,5,11,10,15,39,53,-14,43
Queen of S't,1960,6,10,11,15,48,51,-3,41
Dunfermline,1960,7,9,13,14,43,53,-10,40
Raith,1960,8,9,12,15,32,49,-17,39
St Mirren,1960,9,8,12,16,37,54,-17,36
Dumbarton,1960,10,7,11,18,40,58,-18,32
Hibernian,1961,1,18,13,5,56,25,31,67
Morton,1961,2,17,13,6,57,40,17,64
Falkirk,1961,3,17,12,7,61,37,24,63
Dundee Utd,1961,4,14,13,9,48,38,10,55
Queen of S't,1961,5,11,10,15,43,49,-6,43
St Mirren,1961,6,10,11,15,46,56,-10,41
Dunfermline,1961,7,9,13,14,46,49,-3,40
Dumbarton,1961,8,9,12,15,48,60,-12,39
Raith,1961,9,9,8,19,38,61,-23,35
Ayr,1961,10,7,13,16,33,61,-28,34
Hibernian,1962,1,18,14,4,57,26,31,68
Morton,1962,2,17,12,7,55,39,16,63
Falkirk,1962,3,17,10,9,57,38,19,61
Dundee Utd,1962,4,14,10,12,44,39,5,52
Dunfermline,1962,5,11,14,11,52,50,2,47
Queen of S't,1962,6,12,9,15,45,49,-4,45
Raith,1962,7,11,9,16,39,50,-11,42
Ayr,1962,8,8,14,14,33,54,-21,38
St Mirren,1962,9,9,10,17,41,55,-14,37
Dumbarton,1962,10,7,10,19,46,69,-23,31
Hibernian,1963,1,20,11,5,55,25,30,71
Morton,1963,2,18,12,6,53,34,19,66
Dundee Utd,1963,3,16,11,9,49,40,9,59
Falkirk,1963,4,15,10,11,59,43,16,55
Queen of S't,1963,5,11,10,15,43,52,-9,43
Dunfermline,1963,6,10,12,14,43,48,-5,42
Dumbarton,1963,7,9,12,15,50,57,-7,39
St Mirren,1963,8,9,11,16,42,57,-15,38
Ayr,1963,9,8,13,15,35,54,-19,37
Raith,1963,10,9,8,19,34,53,-19,35
Morton,1964,1,19,10,7,57,34,23,67
Hibernian,1964,2,18,11,7,58,34,24,65
Falkirk,1964,3,17,10,9,62,45,17,61
Dundee Utd,1964,4,16,10,10,49,41,8,58
Queen of S't,1964,5,12,10,14,45,47,-2,46
Dunfermline,1964,6,11,12,13,45,49,-4,45
Dumbarton,1964,7,8,14,14,44,53,-9,38
Ayr,1964,8,8,12,16,35,55,-20,36
St Mirren,1964,9,8,11,17,42,60,-18,35
Raith,1964,10,9,8,19,34,53,-19,35
Hibernian,1965,1,21,11,4,53,22,31,74
Morton,1965,2,17,12,7,47,32,15,63
Dundee Utd,1965,3,16,11,9,52,35,17,59
Falkirk,1965,4,14,11,11,54,44,10,53
Dunfermline,1965,5,11,12,13,43,45,-2,45
Queen of S't,1965,6,10,10,16,43,53,-10,40
Raith,1965,7,10,9,17,31,47,-16,39
St Mirren,1965,8,9,11,16,43,55,-12,38
Ayr,1965,9,7,15,14,34,56,-22,36
Dumbarton,1965,10,7,14,15,44,55,-11,35
Hibernian,1966,1,17,14,5,48,23,25,65
Dundee Utd,1966,2,17,11,8,56,35,21,62
Morton,1966,3,16,13,7,51,38,13,61
Falkirk,1966,4,16,10,10,58,43,15,58
Queen of S't,1966,5,10,11,15,42,49,-7,41
St Mirren,1966,6,10,11,15,44,55,-11,41
Raith,1966,7,10,11,15,36,49,-13,41
Dumbarton,1966,8,9,12,15,46,58,-12,39
Ayr,1966,9,8,14,14,34,51,-17,38
Dunfermline,1966,10,7,13,16,42,56,-14,34
Hibernian,1967,1,21,11,4,59,28,31,74
Morton,1967,2,19,11,6,55,32,23,68
Falkirk,1967,3,15,11,10,58,44,14,56
Dundee Utd,1967,4,14,11,11,51,43,8,53
St Mirren,1967,5,12,9,15,47,54,-7,45
Queen of S't,1967,6,10,11,15,42,49,-7,41
Dunfermline,1967,7,9,13,14,43,50,-7,40
Dumbarton,1967,8,8,12,16,43,58,-15,36
Raith,1967,9,9,9,18,34,53,-19,36
Ayr,1967,10,7,14,15,33,54,-21,35
Morton,1968,1,18,11,7,52,33,19,65
Hibernian,1968,2,17,13,6,54,30,24,64
Dundee Utd,1968,3,16,11,9,53,43,10,59
Falkirk,1968,4,16,9,11,59,43,16,57
Queen of S't,1968,5,13,10,13,45,47,-2,49
Ayr,1968,6,10,12,14,38,49,-11,42
Dunfermline,1968,7,8,16,12,42,47,-5,40
Dumbarton,1968,8,9,11,16,48,61,-13,38
Raith,1968,9,9,9,18,32,55,-23,36
St Mirren,1968,10,8,10,18,41,56,-15,34
Hibernian,1969,1,21,12,3,54,22,32,75
Morton,1969,2,17,10,9,52,37,15,61
Falkirk,1969,3,15,13,8,62,41,21,58
Dundee Utd,1969,4,15,10,11,46,40,6,55
Dunfermline,1969,5,11,13,12,52,49,3,46
Queen of S't,1969,6,11,8,17,46,60,-14,41
Dumbarton,1969,7,9,13,14,48,58,-10,40
Ayr,1969,8,9,13,14,34,51,-17,40
Raith,1969,9,10,9,17,35,51,-16,39
St Mirren,1969,10,7,9,20,38,58,-20,30
Hibernian,1970,1,18,13,5,57,30,27,67
Falkirk,1970,2,19,9,8,69,38,31,66
Dundee Utd,1970,3,17,10,9,53,38,15,61
Morton,1970,4,15,12,9,49,40,9,57
Dumbarton,1970,5,12,11,13,49,52,-3,47
Dunfermline,1970,6,9,13,14,47,54,-7,40
Queen of S't,1970,7,9,11,16,43,59,-16,38
Raith,1970,8,9,11,16,34,50,-16,38
St Mirren,1970,9,8,12,16,38,53,-15,36
Ayr,1970,10,6,14,16,31,56,-25,32
Hibernian,1971,1,20,11,5,56,27,29,71
Morton,1971,2,19,10,7,54,35,19,67
Dundee Utd,1971,3,18,9,9,51,37,14,63
Falkirk,1971,4,16,9,11,58,47,11,57
Queen of S't,1971,5,11,10,15,45,50,-5,43
Raith,1971,6,11,10,15,38,50,-12,43
Dumbarton,1971,7,9,11,16,53,60,-7,38
Dunfermline,1971,8,8,13,15,43,55,-12,37
St Mirren,1971,9,9,10,17,41,53,-12,37
Ayr,1971,10,7,11,18,35,60,-25,32
Hibernian,1972,1,19,13,4,62,33,29,70
Dundee Utd,1972,2,16,11,9,46,35,11,59
Falkirk,1972,3,16,10,10,62,41,21,58
Morton,1972,4,15,13,8,51,38,13,58
Queen of S't,1972,5,13,9,14,46,49,-3,48
Dunfermline,1972,6,9,14,13,43,48,-5,41
Dumbarton,1972,7,9,12,15,45,53,-8,39
St Mirren,1972,8,9,10,17,38,57,-19,37
Raith,1972,9,9,10,17,35,55,-20,37
Ayr,1972,10,8,12,16,36,55,-19,36
Hibernian,1973,1,18,14,4,55,27,28,68
Falkirk,1973,2,17,10,9,61,43,18,61
Dundee Utd,1973,3,17,9,10,54,43,11,60
Morton,1973,4,16,9,11,49,39,10,57
Queen of S't,1973,5,14,10,12,52,47,5,52
Dunfermline,1973,6,10,12,14,43,50,-7,42
Ayr,1973,7,10,12,14,36,53,-17,42
Dumbarton,1973,8,10,10,16,49,57,-8,40
Raith,1973,9,9,8,19,36,56,-20,35
St Mirren,1973,10,7,10,19,36,56,-20,31
Hibernian,1974,1,20,12,4,56,24,32,72
Dundee Utd,1974,2,16,10,10,56,42,14,58
Falkirk,1974,3,15,9,12,56,42,14,54
Morton,1974,4,13,12,11,46,46,0,51
Queen of S't,1974,5,13,9,14,48,52,-4,48
Raith,1974,6,12,9,15,43,53,-10,45
Dunfermline,1974,7,9,16,11,48,45,3,43
Dumbarton,1974,8,9,12,15,44,54,-10,39
Ayr,1974,9,9,12,15,35,55,-20,39
St Mirren,1974,10,8,11,17,42,61,-19,35
Hibernian,1975,1,16,15,5,50,27,23,63
Dundee Utd,1975,2,18,8,10,51,36,15,62
Morton,1975,3,16,12,8,51,41,10,60
Falkirk,1975,4,16,11,9,58,40,18,59
Dunfermline,1975,5,12,13,11,50,48,2,49
Queen of S't,1975,6,11,12,13,45,47,-2,45
Dumbarton,1975,7,9,13,14,52,60,-8,40
Raith,1975,8,9,11,16,36,52,-16,38
St Mirren,1975,9,8,10,18,41,55,-14,34
Ayr,1975,10,6,13,17,32,60,-28,31
Morton,1976,1,19,11,6,60,36,24,68
Hibernian,1976,2,19,10,7,54,26,28,67
Dundee Utd,1976,3,18,8,10,56,40,16,62
Falkirk,1976,4,16,10,10,57,40,17,58
Queen of S't,1976,5,12,10,14,46,48,-2,46
Raith,1976,6,11,9,16,36,48,-12,42
Dunfermline,1976,7,9,14,13,47,55,-8,41
St Mirren,1976,8,10,9,17,43,59,-16,39
Ayr,1976,9,7,12,17,32,60,-28,33
Dumbarton,1976,10,7,11,18,46,65,-19,32
Hibernian,1977,1,20,11,5,55,25,30,71
Dundee Utd,1977,2,16,11,9,50,39,11,59
Morton,1977,3,14,14,8,46,36,10,56
Falkirk,1977,4,15,10,11,55,41,14,55
Dunfermline,1977,5,10,14,12,50,49,1,44
Raith,1977,6,10,12,14,32,43,-11,42
Ayr,1977,7,9,14,13,34,50,-16,41
Dumbarton,1977,8,9,13,14,46,54,-8,40
St Mirren,1977,9,9,10,17,38,53,-15,37
Queen of S't,1977,10,9,9,18,41,57,-16,36
Hibernian,1978,1,20,11,5,58,30,28,71
Morton,1978,2,17,12,7,54,37,17,63
Dundee Utd,1978,3,15,10,11,50,42,8,55
Falkirk,1978,4,15,9,12,56,46,10,54
Queen of S't,1978,5,14,8,14,47,47,0,50
Dumbarton,1978,6,11,10,15,47,54,-7,43
Raith,1978,7,11,9,16,36,50,-14,42
Dunfermline,1978,8,9,11,16,42,53,-11,38
St Mirren,1978,9,8,12,16,40,52,-12,36
Ayr,1978,10,8,12,16,37,56,-19,36
Hibernian,1979,1,20,10,6,58,28,30,70
Dundee Utd,1979,2,17,10,9,57,42,15,61
Falkirk,1979,3,16,10,10,58,40,18,58
Morton,1979,4,16,10,10,49,39,10,58
Queen of S't,1979,5,13,10,13,48,50,-2,49
Dumbarton,1979,6,9,12,15,52,61,-9,39
Dunfermline,1979,7,8,15,13,44,53,-9,39
St Mirren,1979,8,10,9,17,45,59,-14,39
Raith,1979,9,10,9,17,34,51,-17,39
Ayr,1979,10,8,11,17,37,59,-22,35
Morton,1980,1,18,12,6,52,32,20,66
Hibernian,1980,2,17,14,5,49,23,26,65
Dundee Utd,1980,3,16,10,10,48,37,11,58
Falkirk,1980,4,15,11,10,55,41,14,56
Dunfermline,1980,5,10,13,13,46,48,-2,43
Raith,1980,6,10,11,15,34,47,-13,41
Queen of S't,1980,7,9,13,14,43,53,-10,40
Dumbarton,1980,8,9,12,15,46,55,-9,39
St Mirren,1980,9,8,12,16,42,57,-15,36
Ayr,1980,10,7,14,15,35,57,-22,35
Hibernian,1981,1,20,11,5,59,24,35,71
Morton,1981,2,19,10,7,53,34,19,67
Dundee Utd,1981,3,17,10,9,51,34,17,61
Falkirk,1981,4,16,11,9,56,41,15,59
Raith,1981,5,11,9,16,35,50,-15,42
Queen of S't,1981,6,11,8,17,43,54,-11,41
Dunfermline,1981,7,9,11,16,46,53,-7,38
Dumbarton,1981,8,9,10,17,45,60,-15,37
St Mirren,1981,9,9,10,17,41,58,-17,37
Ayr,1981,10,9,10,17,32,53,-21,37
Hibernian,1982,1,19,10,7,58,30,28,67
Falkirk,1982,2,16,10,10,53,41,12,58
Morton,1982,3,15,12,9,47,36,11,57
Dundee Utd,1982,4,15,12,9,46,36,10,57
Dunfermline,1982,5,11,14,11,49,46,3,47
Queen of S't,1982,6,12,9,15,44,47,-3,45
Raith,1982,7,11,10,15,38,47,-9,43
Ayr,1982,8,8,16,12,35,49,-14,40
Dumbarton,1982,9,8,12,16,44,58,-14,36
St Mirren,1982,10,7,11,18,33,57,-24,32
Hibernian,1983,1,19,14,3,59,22,37,71
Dundee Utd,1983,2,18,10,8,54,35,19,64
Morton,1983,3,16,12,8,49,34,15,60
Falkirk,1983,4,15,10,11,55,49,6,55
Queen of S't,1983,5,12,10,14,45,49,-4,46
Raith,1983,6,11,9,16,36,48,-12,42
Dunfermline,1983,7,9,12,15,42,48,-6,39
St Mirren,1983,8,8,12,16,37,52,-15,36
Dumbarton,1983,9,8,12,16,43,59,-16,36
Ayr,1983,10,6,15,15,29,53,-24,33
Hibernian,1984,1,21,12,3,56,22,34,75
Morton,1984,2,17,10,9,51,42,9,61
Falkirk,1984,3,15,13,8,58,40,18,58
Dundee Utd,1984,4,14,11,11,52,47,5,53
Queen of S't,1984,5,13,9,14,49,48,1,48
Dunfermline,1984,6,9,14,13,51,54,-3,41
Raith,1984,7,11,8,17,35,49,-14,41
St Mirren,1984,8,10,10,16,43,54,-11,40
Dumbarton,1984,9,8,12,16,47,61,-14,36
Ayr,1984,10,7,11,18,37,62,-25,32
Falkirk,1985,1,18,10,8,63,37,26,64
Hibernian,1985,2,16,14,6,51,30,21,62
Morton,1985,3,16,13,7,52,36,16,61
Dundee Utd,1985,4,17,10,9,54,40,14,61
Raith,1985,5,12,9,15,42,46,-4,45
Queen of S't,1985,6,12,8,16,45,55,-10,44
Ayr,1985,7,10,11,15,35,58,-23,41
Dumbarton,1985,8,9,12,15,46,57,-11,39
Dunfermline,1985,9,9,11,16,46,53,-7,38
St Mirren,1985,10,7,10,19,35,57,-22,31
Hibernian,1986,1,19,12,5,54,28,26,69
Morton,1986,2,17,10,9,46,34,12,61
Falkirk,1986,3,16,10,10,54,38,16,58
Dundee Utd,1986,4,15,10,11,46,40,6,55
Raith,1986,5,12,9,15,38,50,-12,45
Queen of S't,1986,6,11,10,15,43,49,-6,43
St Mirren,1986,7,10,10,16,42,53,-11,40
Dumbarton,1986,8,9,12,15,46,55,-9,39
Dunfermline,1986,9,8,14,14,46,49,-3,38
Ayr,1986,10,9,11,16,35,54,-19,38
Hibernian,1987,1,20,12,4,59,27,32,72
Morton,1987,2,17,10,9,53,38,15,61
Falkirk,1987,3,14,12,10,54,41,13,54
Dundee Utd,1987,4,13,12,11,44,45,-1,51
Raith,1987,5,11,11,14,38,46,-8,44
Dumbarton,1987,6,10,12,14,54,60,-6,42
Ayr,1987,7,10,12,14,39,51,-12,42
Queen of S't,1987,8,10,10,16,44,56,-12,40
Dunfermline,1987,9,9,12,15,45,51,-6,39
St Mirren,1987,10,9,11,16,45,60,-15,38
Hibernian,1988,1,20,12,4,58,24,34,72
Dundee Utd,1988,2,17,10,9,58,39,19,61
Morton,1988,3,16,11,9,44,34,10,59
Falkirk,1988,4,16,10,10,59,46,13,58
Dunfermline,1988,5,11,13,12,46,42,4,46
Raith,1988,6,11,10,15,34,48,-14,43
Queen of S't,1988,7,11,9,16,47,56,-9,42
Dumbarton,1988,8,9,12,15,51,64,-13,39
Ayr,1988,9,7,12,17,37,59,-22,33
St Mirren,1988,10,6,13,17,36,58,-22,31
Hibernian,1989,1,18,13,5,55,29,26,67
Dundee Utd,1989,2,18,9,9,53,35,18,63
Morton,1989,3,16,12,8,49,34,15,60
Falkirk,1989,4,16,10,10,55,43,12,58
Dunfermline,1989,5,12,12,12,49,46,3,48
Ayr,1989,6,10,13,13,39,53,-14,43
Raith,1989,7,10,10,16,32,46,-14,40
Dumbarton,1989,8,9,11,16,49,62,-13,38
Queen of S't,1989,9,9,9,18,41,53,-12,36
St Mirren,1989,10,7,11,18,37,58,-21,32
Hibernian,1990,1,20,12,4,57,26,31,72
Dundee Utd,1990,2,17,9,10,52,36,16,60
Morton,1990,3,16,11,9,51,37,14,59
Falkirk,1990,4,14,11,11,52,40,12,53
Queen of S't,1990,5,15,8,13,50,46,4,53
Raith,1990,6,11,11,14,35,45,-10,44
Dunfermline,1990,7,9,13,14,43,53,-10,40
Ayr,1990,8,9,11,16,33,58,-25,38
Dumbarton,1990,9,8,10,18,43,58,-15,34
St Mirren,1990,10,8,10,18,38,55,-17,34
Falkirk,1991,1,18,11,7,59,36,23,65
Hibernian,1991,2,18,11,7,50,27,23,65
Morton,1991,3,16,11,9,47,35,12,59
Dundee Utd,1991,4,15,9,12,46,40,6,54
Dunfermline,1991,5,10,14,12,48,47,1,44
Queen of S't,1991,6,11,11,14,49,52,-3,44
Raith,1991,7,10,10,16,36,52,-16,40
St Mirren,1991,8,10,9,17,43,54,-11,39
Dumbarton,1991,9,8,13,15,45,61,-16,37
Ayr,1991,10,8,13,15,33,52,-19,37
Hibernian,1992,1,21,11,4,66,28,38,74
Dundee Utd,1992,2,17,9,10,50,42,8,60
Morton,1992,3,16,11,9,49,37,12,59
Falkirk,1992,4,13,12,11,53,43,10,51
Dunfermline,1992,5,11,13,12,47,48,-1,46
Queen of S't,1992,6,11,11,14,44,50,-6,44
Dumbarton,1992,7,11,10,15,49,55,-6,43
Raith,1992,8,10,10,16,35,50,-15,40
Ayr,1992,9,8,11,17,37,57,-20,35
St Mirren,1992,10,8,10,18,38,58,-20,34
Hibernian,1993,1,20,11,5,58,30,28,71
Dundee Utd,1993,2,17,10,9,58,40,18,61
Morton,1993,3,16,11,9,52,40,12,59
Falkirk,1993,4,15,11,10,54,38,16,56
Raith,1993,5,12,8,16,39,51,-12,44
Dunfermline,1993,6,10,13,13,49,49,0,43
Queen of S't,1993,7,10,11,15,43,54,-11,41
Dumbarton,1993,8,10,10,16,48,61,-13,40
St Mirren,1993,9,9,11,16,42,57,-15,38
Ayr,1993,10,7,12,17,34,57,-23,33
Hibernian,1994,1,20,12,4,62,29,33,72
Falkirk,1994,2,17,10,9,59,36,23,61
Morton,1994,3,16,13,7,46,35,11,61
Dundee Utd,1994,4,17,9,10,54,37,17,60
Queen of S't,1994,5,12,10,14,47,52,-5,46
Dunfermline,1994,6,9,14,13,43,47,-4,41
Ayr,1994,7,9,12,15,35,57,-22,39
Raith,1994,8,9,10,17,33,50,-17,37
Dumbarton,1994,9,7,15,14,44,58,-14,36
St Mirren,1994,10,6,11,19,36,58,-22,29
Hibernian,1995,1,18,15,3,58,28,30,69
Morton,1995,2,18,12,6,48,30,18,66
Dundee Utd,1995,3,17,9,10,49,36,13,60
Falkirk,1995,4,14,12,10,54,45,9,54
Dunfermline,1995,5,10,13,13,48,46,2,43
Queen of S't,1995,6,10,12,14,45,52,-7,42
St Mirren,1995,7,10,10,16,39,52,-13,40
Ayr,1995,8,7,15,14,36,55,-19,36
Dumbarton,1995,9,8,11,17,46,62,-16,35
Raith,1995,10,8,11,17,30,47,-17,35
Hibernian,1996,1,19,14,3,55,22,33,71
Dundee Utd,1996,2,17,10,9,49,38,11,61
Falkirk,1996,3,15,11,10,57,41,16,56
Morton,1996,4,15,11,10,48,40,8,56
Raith,1996,5,12,10,14,40,48,-8,46
Dunfermline,1996,6,11,12,13,46,45,1,45
Queen of S't,1996,7,10,12,14,44,49,-5,42
Dumbarton,1996,8,9,13,14,49,57,-8,40
Ayr,1996,9,8,11,17,33,59,-26,35
St Mirren,1996,10,7,10,19,38,60,-22,31
Hibernian,1997,1,17,12,7,50,30,20,63
Falkirk,1997,2,16,11,9,56,39,17,59
Morton,1997,3,15,12,9,45,40,5,57
Dundee Utd,1997,4,15,10,11,50,44,6,55
Queen of S't,1997,5,14,9,13,51,50,1,51
Dunfermline,1997,6,9,16,11,49,48,1,43
Dumbarton,1997,7,10,12,14,51,57,-6,42
Raith,1997,8,11,9,16,38,46,-8,42
St Mirren,1997,9,8,12,16,41,54,-13,36
Ayr,1997,10,7,13,16,33,56,-23,34
Hibernian,1998,1,19,13,4,54,24,30,70
Morton,1998,2,19,11,6,56,34,22,68
Falkirk,1998,3,17,11,8,60,41,19,62
Dundee Utd,1998,4,15,9,12,48,42,6,54
Queen of S't,1998,5,12,9,15,45,49,-4,45
Ayr,1998,6,10,11,15,40,55,-15,41
Dunfermline,1998,7,9,13,14,44,51,-7,40
Dumbarton,1998,8,9,10,17,51,58,-7,37
St Mirren,1998,9,9,9,18,43,65,-22,36
Raith,1998,10,8,10,18,32,54,-22,34
Hibernian,1999,1,20,12,4,55,23,32,72
Morton,1999,2,18,10,8,53,38,15,64
Falkirk,1999,3,17,11,8,61,41,20,62
Dundee Utd,1999,4,13,12,11,49,44,5,51
Dunfermline,1999,5,11,12,13,46,51,-5,45
Ayr,1999,6,9,14,13,36,51,-15,41
Dumbarton,1999,7,9,13,14,52,61,-9,40
Queen of S't,1999,8,10,10,16,45,54,-9,40
Raith,1999,9,10,10,16,36,48,-12,40
St Mirren,1999,10,6,10,20,39,61,-22,28
Hibernian,2000,1,21,11,4,61,27,34,74
Morton,2000,2,17,12,7,48,34,14,63
Dundee Utd,2000,3,17,11,8,60,41,19,62
Falkirk,2000,4,15,12,9,57,43,14,57
Queen of S't,2000,5,12,8,16,50,54,-4,44
Dunfermline,2000,6,10,12,14,46,52,-6,42
Raith,2000,7,9,10,17,38,57,-19,37
St Mirren,2000,8,8,12,16,40,54,-14,36
Dumbarton,2000,9,8,11,17,45,60,-15,35
Ayr,2000,10,8,11,17,34,57,-23,35
Hibernian,2001,1,21,10,5,58,28,30,73
Morton,2001,2,18,11,7,53,36,17,65
Dundee Utd,2001,3,16,12,8,49,35,14,60
Falkirk,2001,4,15,10,11,58,45,13,55
Dunfermline,2001,5,10,13,13,50,47,3,43
Dumbarton,2001,6,10,12,14,47,59,-12,42
Raith,2001,7,9,12,15,37,50,-13,39
Queen of S't,2001,8,9,11,16,45,56,-11,38
Ayr,2001,9,7,13,16,32,56,-24,34
St Mirren,2001,10,7,12,17,37,54,-17,33
Hibernian,2002,1,18,14,4,53,25,28,68
Morton,2002,2,17,12,7,55,37,18,63
Falkirk,2002,3,16,11,9,59,40,19,59
Dundee Utd,2002,4,15,9,12,48,42,6,54
Raith,2002,5,13,9,14,45,49,-4,48
Queen of S't,2002,6,12,10,14,43,49,-6,46
Dumbarton,2002,7,10,11,15,48,57,-9,41
Dunfermline,2002,8,9,13,14,45,51,-6,40
Ayr,2002,9,8,10,18,32,55,-23,34
St Mirren,2002,10,8,9,19,39,62,-23,33
Hibernian,2003,1,18,14,4,52,25,27,68
Dundee Utd,2003,2,18,9,9,58,34,24,63
Morton,2003,3,17,10,9,47,34,13,61
Falkirk,2003,4,16,11,9,62,43,19,59
Raith,2003,5,12,9,15,37,45,-8,45
Dunfermline,2003,6,10,13,13,46,53,-7,43
Queen of S't,2003,7,10,9,17,41,55,-14,39
Ayr,2003,8,9,12,15,37,57,-20,39
Dumbarton,2003,9,8,11,17,45,60,-15,35
St Mirren,2003,10,8,10,18,35,54,-19,34
Hibernian,2004,1,19,12,5,56,27,29,69
Morton,2004,2,19,11,6,55,35,20,68
Falkirk,2004,3,15,12,9,55,38,17,57
Dundee Utd,2004,4,15,10,11,53,46,7,55
Queen of S't,2004,5,11,10,15,46,50,-4,43
St Mirren,2004,6,11,9,16,47,57,-10,42
Ayr,2004,7,9,12,15,39,55,-16,39
Dumbarton,2004,8,9,11,16,47,58,-11,38
Dunfermline,2004,9,8,14,14,41,52,-11,38
Raith,2004,10,9,9,18,35,56,-21,36
Hibernian,2005,1,19,12,5,55,25,30,69
Dundee Utd,2005,2,18,8,10,51,35,16,62
Morton,2005,3,17,11,8,51,36,15,62
Falkirk,2005,4,15,11,10,60,46,14,56
Queen of S't,2005,5,14,8,14,51,50,1,50
Raith,2005,6,10,12,14,36,45,-9,42
Dumbarton,2005,7,9,11,16,52,64,-12,38
Dunfermline,2005,8,8,13,15,43,54,-11,37
St Mirren,2005,9,8,11,17,38,54,-16,35
Ayr,2005,10,8,11,17,31,59,-28,35
Hibernian,2006,1,20,13,3,60,27,33,73
Morton,2006,2,17,12,7,54,39,15,63
Dundee Utd,2006,3,14,12,10,50,40,10,54
Falkirk,2006,4,13,14,9,53,39,14,53
Queen of S't,2006,5,13,10,13,47,50,-3,49
Raith,2006,6,10,11,15,35,46,-11,41
Dunfermline,2006,7,8,15,13,42,48,-6,39
Ayr,2006,8,8,13,15,34,54,-20,37
St Mirren,2006,9,8,11,17,40,57,-17,35
Dumbarton,2006,10,7,13,16,44,59,-15,34
Hibernian,2007,1,20,13,3,60,24,36,73
Falkirk,2007,2,18,9,9,63,43,20,63
Morton,2007,3,17,12,7,51,34,17,63
Dundee Utd,2007,4,16,10,10,53,39,14,58
Dunfermline,2007,5,12,11,13,45,44,1,47
Queen of S't,2007,6,10,9,17,42,52,-10,39
Raith,2007,7,9,11,16,31,45,-14,38
Ayr,2007,8,8,12,16,32,57,-25,36
Dumbarton,2007,9,8,11,17,48,62,-14,35
St Mirren,2007,10,8,10,18,36,61,-25,34
Hibernian,2008,1,18,13,5,53,24,29,67
Morton,2008,2,18,12,6,58,35,23,66
Falkirk,2008,3,17,10,9,65,40,25,61
Dundee Utd,2008,4,17,9,10,50,41,9,60
Queen of S't,2008,5,12,9,15,44,54,-10,45
Dumbarton,2008,6,11,11,14,55,58,-3,44
Dunfermline,2008,7,9,12,15,43,53,-10,39
Raith,2008,8,9,9,18,33,55,-22,36
Ayr,2008,9,8,11,17,34,56,-22,35
St Mirren,2008,10,8,10,18,39,58,-19,34
Hibernian,2009,1,19,13,4,56,23,33,70
Falkirk,2009,2,16,11,9,57,37,20,59
Morton,2009,3,15,13,8,51,38,13,58
Dundee Utd,2009,4,16,9,11,53,42,11,57
Queen of S't,2009,5,12,9,15,42,49,-7,45
Dumbarton,2009,6,10,12,14,50,57,-7,42
Dunfermline,2009,7,9,13,14,42,51,-9,40
Ayr,2009,8,9,12,15,36,57,-21,39
St Mirren,2009,9,9,10,17,38,54,-16,37
Raith,2009,10,9,10,17,32,49,-17,37
Hibernian,2010,1,18,11,7,53,28,25,65
Falkirk,2010,2,16,11,9,58,40,18,59
Morton,2010,3,16,10,10,45,36,9,58
Dundee Utd,2010,4,16,9,11,51,42,9,57
Queen of S't,2010,5,13,11,12,50,49,1,50
St Mirren,2010,6,11,10,15,43,49,-6,43
Raith,2010,7,11,9,16,35,48,-13,42
Dunfermline,2010,8,9,12,15,41,49,-8,39
Ayr,2010,9,9,11,16,35,54,-19,38
Dumbarton,2010,10,9,10,17,47,63,-16,37
Hibernian,2011,1,16,14,6,51,27,24,62
Dundee Utd,2011,2,17,9,10,50,38,12,60
Morton,2011,3,15,11,10,46,35,11,56
Falkirk,2011,4,14,13,9,54,40,14,55
Dunfermline,2011,5,13,12,11,52,47,5,51
Queen of S't,2011,6,12,10,14,47,49,-2,46
St Mirren,2011,7,10,10,16,39,54,-15,40
Raith,2011,8,9,12,15,36,48,-12,39
Ayr,2011,9,9,11,16,30,52,-22,38
Dumbarton,2011,10,9,10,17,48,63,-15,37
Hibernian,2012,1,19,11,6,54,32,22,68
Morton,2012,2,16,10,10,55,40,15,58
Falkirk,2012,3,15,11,10,57,40,17,56
Dundee Utd,2012,4,15,11,10,51,46,5,56
Dunfermline,2012,5,13,12,11,56,46,10,51
Raith,2012,6,13,10,13,41,46,-5,49
Queen of S't,2012,7,9,11,16,39,50,-11,38
Ayr,2012,8,8,14,14,38,56,-18,38
Dumbarton,2012,9,7,15,14,50,63,-13,36
St Mirren,2012,10,6,13,17,37,59,-22,31
Hibernian,2013,1,19,12,5,54,25,29,69
Dundee Utd,2013,2,19,9,8,53,35,18,66
Falkirk,2013,3,16,11,9,61,44,17,59
Morton,2013,4,16,10,10,50,40,10,58
Queen of S't,2013,5,12,11,13,45,48,-3,47
Dunfermline,2013,6,10,13,13,43,46,-3,43
Raith,2013,7,9,14,13,37,46,-9,41
Dumbarton,2013,8,9,10,17,45,58,-13,37
St Mirren,2013,9,7,11,18,40,61,-21,32
Ayr,2013,10,7,11,18,34,59,-25,32
Hibernian,2014,1,18,13,5,50,25,25,67
Morton,2014,2,17,12,7,50,35,15,63
Falkirk,2014,3,16,11,9,61,40,21,59
Dundee Utd,2014,4,15,12,9,46,34,12,57
Raith,2014,5,12,11,13,40,45,-5,47
Queen of S't,2014,6,11,9,16,43,54,-11,42
Dunfermline,2014,7,9,14,13,43,46,-3,41
St Mirren,2014,8,8,12,16,40,57,-17,36
Dumbarton,2014,9,7,14,15,43,56,-13,35
Ayr,2014,10,7,12,17,30,54,-24,33
Hibernian,2015,1,19,12,5,55,29,26,69
Morton,2015,2,15,14,7,50,40,10,59
Dundee Utd,2015,3,15,12,9,51,38,13,57
Falkirk,2015,4,15,10,11,53,40,13,55
Dunfermline,2015,5,12,14,10,49,44,5,50
Dumbarton,2015,6,9,13,14,48,55,-7,40
Queen of S't,2015,7,10,9,17,42,53,-11,39
Raith,2015,8,9,11,16,31,49,-18,38
Ayr,2015,9,7,16,13,40,56,-16,37
St Mirren,2015,10,8,11,17,37,52,-15,35
Hibernian,2016,1,19,11,6,55,27,28,68
Morton,2016,2,16,14,6,54,39,15,62
Falkirk,2016,3,17,10,9,57,36,21,61
Dundee Utd,2016,4,16,11,9,51,37,14,59
Ayr,2016,5,11,12,13,39,48,-9,45
Dunfermline,2016,6,10,13,13,49,50,-1,43
Raith,2016,7,10,9,17,36,55,-19,39
Queen of S't,2016,8,9,10,17,42,58,-16,37
St Mirren,2016,9,9,9,18,40,56,-16,36
Dumbarton,2016,10,7,13,16,41,58,-17,34
Hibernian,2017,1,19,12,5,54,25,29,69
Morton,2017,2,18,12,6,52,32,20,66
Falkirk,2017,3,16,12,8,59,41,18,60
Dundee Utd,2017,4,14,11,11,49,43,6,53
Dunfermline,2017,5,10,12,14,48,51,-3,42
Queen of S't,2017,6,11,9,16,44,52,-8,42
Raith,2017,7,10,10,16,34,50,-16,40
Dumbarton,2017,8,8,14,14,46,56,-10,38
Ayr,2017,9,9,11,16,34,53,-19,38
St Mirren,2017,10,7,13,16,37,54,-17,34
Hibernian,2018,1,21,11,4,57,24,33,74
Falkirk,2018,2,18,9,9,62,37,25,63
Morton,2018,3,16,12,8,47,34,13,60
Dundee Utd,2018,4,16,8,12,55,41,14,56
Queen of S't,2018,5,12,9,15,51,55,-4,45
Dumbarton,2018,6,11,10,15,51,58,-7,43
Dunfermline,2018,7,10,11,15,44,52,-8,41
Ayr,2018,8,10,11,15,38,62,-24,41
Raith,2018,9,8,11,17,36,56,-20,35
St Mirren,2018,10,7,10,19,35,57,-22,31
Hibernian,2019,1,19,12,5,55,28,27,69
Morton,2019,2,18,12,6,51,33,18,66
Falkirk,2019,3,16,10,10,56,39,17,58
Dundee Utd,2019,4,15,10,11,50,42,8,55
Dunfermline,2019,5,11,12,13,48,47,1,45
Queen of S't,2019,6,12,9,15,48,50,-2,45
Raith,2019,7,11,9,16,33,45,-12,42
Dumbarton,2019,8,9,11,16,47,60,-13,38
St Mirren,2019,9,8,11,17,43,62,-19,35
Ayr,2019,10,7,12,17,31,56,-25,33
Hibernian,2020,1,19,13,4,55,24,31,70
Dundee Utd,2020,2,18,9,9,46,32,14,63
Morton,2020,3,16,11,9,50,39,11,59
Falkirk,2020,4,15,11,10,54,41,13,56
Dunfermline,2020,5,10,13,13,48,48,0,43
Raith,2020,6,11,10,15,37,47,-10,43
Queen of S't,2020,7,11,9,16,43,55,-12,42
St Mirren,2020,8,10,11,15,40,52,-12,41
Ayr,2020,9,7,13,16,32,53,-21,34
Dumbarton,2020,10,7,12,17,44,58,-14,33
Morton,2021,1,19,10,7,53,34,19,67
Hibernian,2021,2,17,11,8,50,29,21,62
Falkirk,2021,3,17,10,9,59,44,15,61
Dundee Utd,2021,4,17,10,9,55,40,15,61
Raith,2021,5,12,9,15,39,49,-10,45
Dunfermline,2021,6,10,13,13,49,48,1,43
Queen of S't,2021,7,10,9,17,43,56,-13,39
Ayr,2021,8,9,12,15,33,50,-17,39
St Mirren,2021,9,9,10,17,42,57,-15,37
Dumbarton,2021,10,8,10,18,45,61,-16,34
Morton,2022,1,19,11,6,55,34,21,68
Hibernian,2022,2,18,12,6,53,27,26,66
Falkirk,2022,3,15,12,9,57,40,17,57
Dundee Utd,2022,4,15,12,9,46,36,10,57
Queen of S't,2022,5,12,10,14,46,50,-4,46
Ayr,2022,6,9,13,14,38,53,-15,40
Dunfermline,2022,7,9,12,15,44,52,-8,39
Dumbarton,2022,8,9,11,16,49,60,-11,38
St Mirren,2022,9,8,12,16,37,53,-16,36
Raith,2022,10,9,9,18,34,54,-20,36
Hibernian,2023,1,20,12,4,56,21,35,72
Morton,2023,2,18,9,9,50,40,10,63
Falkirk,2023,3,15,11,10,58,40,18,56
Dundee Utd,2023,4,14,11,11,49,43,6,53
Queen of S't,2023,5,12,10,14,43,48,-5,46
Dunfermline,2023,6,11,12,13,48,49,-1,45
Raith,2023,7,11,9,16,34,49,-15,42
Dumbarton,2023,8,9,13,14,50,59,-9,40
Ayr,2023,9,7,13,16,35,58,-23,34
St Mirren,2023,10,7,12,17,41,57,-16,33
Hibernian,2024,1,18,13,5,57,29,28,67
Morton,2024,2,16,11,9,45,34,11,59
Dundee Utd,2024,3,14,13,9,48,41,7,55
Falkirk,2024,4,14,12,10,55,43,12,54
Dunfermline,2024,5,12,12,12,52,46,6,48
Dumbarton,2024,6,10,13,13,51,56,-5,43
Raith,2024,7,11,10,15,35,47,-12,43
Queen of S't,2024,8,10,10,16,47,56,-9,40
Ayr,2024,9,7,15,14,33,53,-20,36
St Mirren,2024,10,8,11,17,39,57,-18,35
Hibernian,2025,1,18,14,4,56,26,30,68
Morton,2025,2,16,13,7,52,38,14,61
Dundee Utd,2025,3,15,11,10,48,39,9,56
Falkirk,2025,4,14,13,9,57,42,15,55
Queen of S't,2025,5,12,10,14,50,53,-3,46
Raith,2025,6,12,9,15,37,44,-7,45
Dunfermline,2025,7,9,13,14,48,54,-6,40
Dumbarton,2025,8,10,10,16,47,64,-17,40
St Mirren,2025,9,8,12,16,38,53,-15,36
Ayr,2025,10,7,13,16,36,56,-20,34
Hibernian,2026,1,20,13,3,55,20,35,73
Falkirk,2026,2,19,10,7,63,36,27,67
Morton,2026,3,16,10,10,47,43,4,58
Dundee Utd,2026,4,16,9,11,52,40,12,57
Raith,2026,5,12,8,16,36,45,-9,44
Queen of S't,2026,6,11,9,16,44,53,-9,42
St Mirren,2026,7,10,9,17,40,52,-12,39
Dunfermline,2026,8,8,13,15,42,52,-10,37
Dumbarton,2026,9,9,10,17,46,60,-14,37
Ayr,2026,10,8,11,17,32,56,-24,35
Hibernian,2027,1,19,11,6,59,27,32,68
Morton,2027,2,17,10,9,49,36,13,61
Falkirk,2027,3,15,11,10,56,44,12,56
Dundee Utd,2027,4,16,8,12,51,40,11,56
Dumbarton,2027,5,12,11,13,46,51,-5,47
Dunfermline,2027,6,10,12,14,44,49,-5,42
Raith,2027,7,10,12,14,38,49,-11,42
Ayr,2027,8,10,12,14,40,55,-15,42
Queen of S't,2027,9,9,10,17,40,54,-14,37
St Mirren,2027,10,8,11,17,37,55,-18,35
Hibernian,2028,1,18,14,4,56,24,32,68
Falkirk,2028,2,17,10,9,59,43,16,61
Morton,2028,3,15,14,7,46,35,11,59
Dundee Utd,2028,4,15,10,11,53,45,8,55
Queen of S't,2028,5,11,10,15,42,52,-10,43
Raith,2028,6,11,10,15,35,48,-13,43
Dumbarton,2028,7,10,11,15,53,61,-8,41
Ayr,2028,8,10,10,16,37,57,-20,40
Dunfermline,2028,9,8,15,13,46,49,-3,39
St Mirren,2028,10,8,10,18,42,55,-13,34
Hibernian,2029,1,17,13,6,49,27,22,64
Falkirk,2029,2,16,12,8,57,40,17,60
Morton,2029,3,15,12,9,47,36,11,57
Dundee Utd,2029,4,15,11,10,49,41,8,56
Dunfermline,2029,5,13,12,11,52,44,8,51
Queen of S't,2029,6,12,9,15,47,49,-2,45
Raith,2029,7,12,9,15,36,45,-9,45
Ayr,2029,8,9,12,15,33,54,-21,39
Dumbarton,2029,9,8,12,16,49,61,-12,36
St Mirren,2029,10,6,12,18,36,58,-22,30
Hibernian,2030,1,20,11,5,57,26,31,71
Dundee Utd,2030,2,19,9,8,55,40,15,66
Falkirk,2030,3,15,13,8,58,38,20,58
Morton,2030,4,15,12,9,50,40,10,57
Dunfermline,2030,5,11,12,13,46,50,-4,45
Queen of S't,2030,6,11,10,15,47,51,-4,43
St Mirren,2030,7,10,11,15,51,56,-5,41
Dumbarton,2030,8,8,12,16,53,68,-15,36
Ayr,2030,9,8,12,16,35,59,-24,36
Raith,2030,10,8,8,20,30,54,-24,32
Hibernian,2031,1,18,12,6,53,29,24,66
Falkirk,2031,2,17,10,9,62,43,19,61
Morton,2031,3,16,11,9,51,41,10,59
Dundee Utd,2031,4,16,10,10,51,40,11,58
Queen of S't,2031,5,15,8,13,44,44,0,53
Ayr,2031,6,11,11,14,43,50,-7,44
Dunfermline,2031,7,9,14,13,49,50,-1,41
Dumbarton,2031,8,8,12,16,46,56,-10,36
Raith,2031,9,9,9,18,33,54,-21,36
St Mirren,2031,10,8,9,19,36,61,-25,33
Hibernian,2032,1,20,12,4,62,24,38,72
Dundee Utd,2032,2,18,8,10,52,37,15,62
Morton,2032,3,16,11,9,50,41,9,59
Falkirk,2032,4,15,12,9,56,44,12,57
Queen of S't,2032,5,12,10,14,45,49,-4,46
Dunfermline,2032,6,10,11,15,51,51,0,41
St Mirren,2032,7,9,11,16,40,54,-14,38
Raith,2032,8,9,11,16,34,54,-20,38
Dumbarton,2032,9,8,12,16,47,62,-15,36
Ayr,2032,10,8,12,16,31,52,-21,36
Hibernian,2033,1,19,11,6,53,24,29,68
Morton,2033,2,18,9,9,53,34,19,63
Falkirk,2033,3,16,13,7,60,37,23,61
Dundee Utd,2033,4,14,10,12,49,44,5,52
Dunfermline,2033,5,11,14,11,49,44,5,47
Ayr,2033,6,11,11,14,36,51,-15,44
Queen of S't,2033,7,10,11,15,45,54,-9,41
Raith,2033,8,10,9,17,35,54,-19,39
Dumbarton,2033,9,8,13,15,47,62,-15,37
St Mirren,2033,10,8,9,19,35,58,-23,33
Hibernian,2034,1,18,15,3,55,25,30,69
Morton,2034,2,16,11,9,52,42,10,59
Falkirk,2034,3,16,10,10,55,42,13,58
Dundee Utd,2034,4,16,10,10,50,37,13,58
Dunfermline,2034,5,11,11,14,47,51,-4,44
Queen of S't,2034,6,10,12,14,44,51,-7,42
Ayr,2034,7,9,13,14,37,52,-15,40
Raith,2034,8,10,9,17,37,47,-10,39
Dumbarton,2034,9,9,12,15,47,60,-13,39
St Mirren,2034,10,8,11,17,39,56,-17,35
Hibernian,2035,1,20,12,4,61,27,34,72
Morton,2035,2,18,10,8,49,35,14,64
Falkirk,2035,3,16,9,11,62,46,16,57
Dundee Utd,2035,4,16,8,12,51,46,5,56
Queen of S't,2035,5,14,8,14,52,53,-1,50
Dunfermline,2035,6,10,12,14,47,52,-5,42
Ayr,2035,7,10,10,16,40,57,-17,40
St Mirren,2035,8,9,11,16,40,53,-13,38
Raith,2035,9,9,10,17,35,51,-16,37
Dumbarton,2035,10,8,10,18,43,60,-17,34
Hibernian,2036,1,19,12,5,55,30,25,69
Morton,2036,2,17,12,7,52,38,14,63
Falkirk,2036,3,16,12,8,60,40,20,60
Dundee Utd,2036,4,14,14,8,54,42,12,56
Queen of S't,2036,5,12,9,15,51,55,-4,45
Dunfermline,2036,6,9,15,12,47,50,-3,42
Dumbarton,2036,7,9,13,14,47,58,-11,40
Ayr,2036,8,8,13,15,38,56,-18,37
Raith,2036,9,9,8,19,39,57,-18,35
St Mirren,2036,10,7,12,17,40,57,-17,33
Hibernian,2037,1,21,11,4,59,26,33,74
Falkirk,2037,2,17,10,9,61,42,19,61
Morton,2037,3,15,12,9,42,34,8,57
Dundee Utd,2037,4,15,11,10,48,41,7,56
Dumbarton,2037,5,11,11,14,51,55,-4,44
Queen of S't,2037,6,11,10,15,48,52,-4,43
Raith,2037,7,11,10,15,35,48,-13,43
Dunfermline,2037,8,8,13,15,45,52,-7,37
Ayr,2037,9,8,12,16,34,54,-20,36
St Mirren,2037,10,7,12,17,36,55,-19,33
Hibernian,2038,1,17,14,5,50,25,25,65
Morton,2038,2,15,13,8,49,37,12,58
Dundee Utd,2038,3,15,10,11,49,44,5,55
Falkirk,2038,4,14,12,10,56,42,14,54
Queen of S't,2038,5,14,10,12,52,49,3,52
Dunfermline,2038,6,12,12,12,48,48,0,48
Raith,2038,7,10,10,16,34,49,-15,40
St Mirren,2038,8,9,10,17,43,57,-14,37
Dumbarton,2038,9,8,12,16,50,60,-10,36
Ayr,2038,10,7,15,14,33,53,-20,36
Hibernian,2039,1,21,10,5,58,24,34,73
Morton,2039,2,17,10,9,50,37,13,61
Falkirk,2039,3,16,11,9,57,39,18,59
Dundee Utd,2039,4,16,10,10,47,36,11,58
Queen of S't,2039,5,12,9,15,43,47,-4,45
Dumbarton,2039,6,10,12,14,50,54,-4,42
Dunfermline,2039,7,9,14,13,44,52,-8,41
Raith,2039,8,9,11,16,30,46,-16,38
Ayr,2039,9,9,11,16,32,54,-22,38
St Mirren,2039,10,7,10,19,34,56,-22,31
Hibernian,2040,1,19,11,6,57,26,31,68
Falkirk,2040,2,17,10,9,64,42,22,61
Morton,2040,3,17,10,9,48,38,10,61
Dundee Utd,2040,4,16,11,9,60,41,19,59
St Mirren,2040,5,12,10,14,47,52,-5,46
Dunfermline,2040,6,11,12,13,47,50,-3,45
Queen of S't,2040,7,11,9,16,47,60,-13,42
Ayr,2040,8,9,12,15,35,52,-17,39
Raith,2040,9,9,8,19,37,57,-20,35
Dumbarton,2040,10,7,11,18,42,66,-24,32
Hibernian,2041,1,20,10,6,58,29,29,70
Morton,2041,2,19,10,7,55,35,20,67
Falkirk,2041,3,17,11,8,58,38,20,62
Dundee Utd,2041,4,17,10,9,54,41,13,61
Dunfermline,2041,5,10,13,13,50,53,-3,43
Queen of S't,2041,6,10,11,15,43,51,-8,41
Ayr,2041,7,9,13,14,34,49,-15,40
Raith,2041,8,9,10,17,37,51,-14,37
St Mirren,2041,9,7,12,17,40,59,-19,33
Dumbarton,2041,10,7,10,19,42,65,-23,31
Hibernian,2042,1,21,12,3,58,22,36,75
Morton,2042,2,18,10,8,56,41,15,64
Dundee Utd,2042,3,15,12,9,53,41,12,57
Falkirk,2042,4,14,12,10,57,43,14,54
Queen of S't,2042,5,11,10,15,46,52,-6,43
Dumbarton,2042,6,10,12,14,49,57,-8,42
Raith,2042,7,10,10,16,34,49,-15,40
Dunfermline,2042,8,8,14,14,46,53,-7,38
St Mirren,2042,9,9,9,18,40,58,-18,36
Ayr,2042,10,7,13,16,34,57,-23,34
Hibernian,2043,1,22,11,3,61,26,35,77
Morton,2043,2,18,9,9,54,40,14,63
Falkirk,2043,3,16,12,8,61,39,22,60
Dundee Utd,2043,4,13,10,13,47,46,1,49
Queen of S't,2043,5,12,9,15,47,47,0,45
Ayr,2043,6,10,12,14,38,52,-14,42
Dumbarton,2043,7,10,11,15,52,58,-6,41
Dunfermline,2043,8,9,13,14,47,55,-8,40
Raith,2043,9,10,8,18,32,54,-22,38
St Mirren,2043,10,7,11,18,39,61,-22,32
Hibernian,2044,1,16,14,6,50,27,23,62
Morton,2044,2,17,11,8,49,36,13,62
Dundee Utd,2044,3,16,9,11,52,47,5,57
Falkirk,2044,4,15,10,11,56,41,15,55
Raith,2044,5,12,11,13,38,43,-5,47
Queen of S't,2044,6,12,10,14,46,51,-5,46
Dunfermline,2044,7,10,13,13,45,46,-1,43
Dumbarton,2044,8,9,12,15,46,54,-8,39
St Mirren,2044,9,9,10,17,38,53,-15,37
Ayr,2044,10,8,12,16,32,54,-22,36
Hibernian,2045,1,19,13,4,61,26,35,70
Falkirk,2045,2,16,13,7,60,37,23,61
Morton,2045,3,16,10,10,47,39,8,58
Dundee Utd,2045,4,16,9,11,49,41,8,57
Queen of S't,2045,5,13,9,14,50,46,4,48
Raith,2045,6,11,10,15,41,55,-14,43
Dumbarton,2045,7,10,11,15,45,58,-13,41
Dunfermline,2045,8,7,15,14,43,52,-9,36
Ayr,2045,9,8,12,16,35,56,-21,36
St Mirren,2045,10,7,12,17,39,60,-21,33
Hibernian,2046,1,19,13,4,53,25,28,70
Morton,2046,2,18,11,7,54,39,15,65
Falkirk,2046,3,17,9,10,59,41,18,60
Dundee Utd,2046,4,14,11,11,50,44,6,53
Dunfermline,2046,5,11,14,11,50,46,4,47
Raith,2046,6,11,9,16,36,47,-11,42
Dumbarton,2046,7,10,10,16,49,58,-9,40
Queen of S't,2046,8,9,11,16,42,52,-10,38
Ayr,2046,9,8,12,16,33,54,-21,36
St Mirren,2046,10,8,10,18,37,57,-20,34
Hibernian,2047,1,19,12,5,56,28,28,69
Morton,2047,2,16,11,9,47,37,10,59
Falkirk,2047,3,16,10,10,57,43,14,58
Dundee Utd,2047,4,14,12,10,50,41,9,54
Raith,2047,5,12,9,15,40,44,-4,45
Queen of S't,2047,6,12,9,15,48,53,-5,45
Dunfermline,2047,7,9,14,13,46,49,-3,41
Ayr,2047,8,9,12,15,33,54,-21,39
Dumbarton,2047,9,9,11,16,47,59,-12,38
St Mirren,2047,10,9,10,17,40,56,-16,37
Hibernian,2048,1,22,10,4,61,27,34,76
Morton,2048,2,17,11,8,51,34,17,62
Falkirk,2048,3,16,9,11,58,45,13,57
Dundee Utd,2048,4,14,10,12,45,39,6,52
St Mirren,2048,5,12,9,15,48,52,-4,45
Queen of S't,2048,6,12,9,15,49,54,-5,45
Dunfermline,2048,7,9,14,13,46,51,-5,41
Dumbarton,2048,8,9,10,17,47,66,-19,37
Raith,2048,9,8,12,16,35,50,-15,36
Ayr,2048,10,8,12,16,32,54,-22,36
Hibernian,2049,1,22,10,4,60,23,37,76
Dundee Utd,2049,2,17,9,10,57,44,13,60
Falkirk,2049,3,15,10,11,59,46,13,55
Morton,2049,4,14,12,10,52,45,7,54
Queen of S't,2049,5,14,9,13,48,46,2,51
Dunfermline,2049,6,10,14,12,51,53,-2,44
Raith,2049,7,11,8,17,36,51,-15,41
Dumbarton,2049,8,9,11,16,46,57,-11,38
St Mirren,2049,9,9,9,18,39,54,-15,36
Ayr,2049,10,8,10,18,32,61,-29,34
Hibernian,2050,1,20,12,4,62,26,36,72
Morton,2050,2,18,11,7,53,36,17,65
Dundee Utd,2050,3,17,8,11,51,43,8,59
Falkirk,2050,4,15,11,10,61,43,18,56
Raith,2050,5,11,12,13,40,48,-8,45
Queen of S't,2050,6,11,10,15,45,51,-6,43
Dunfermline,2050,7,9,12,15,47,53,-6,39
Ayr,2050,8,9,11,16,39,54,-15,38
Dumbarton,2050,9,8,11,17,45,69,-24,35
St Mirren,2050,10,7,12,17,35,55,-20,33
Hibernian,2051,1,20,12,4,54,22,32,72
Dundee Utd,2051,2,19,9,8,53,35,18,66
Falkirk,2051,3,15,11,10,55,44,11,56
Morton,2051,4,14,14,8,46,36,10,56
Dunfermline,2051,5,11,13,12,50,45,5,46
Dumbarton,2051,6,9,13,14,48,55,-7,40
Queen of S't,2051,7,9,11,16,36,49,-13,38
Raith,2051,8,9,10,17,37,51,-14,37
Ayr,2051,9,8,13,15,34,57,-23,37
St Mirren,2051,10,8,10,18,45,64,-19,34
Hibernian,2052,1,18,11,7,52,27,25,65
Morton,2052,2,17,12,7,53,39,14,63
Falkirk,2052,3,17,11,8,61,39,22,62
Dundee Utd,2052,4,15,9,12,62,51,11,54
Ayr,2052,5,12,10,14,38,54,-16,46
Dunfermline,2052,6,9,15,12,44,46,-2,42
Queen of S't,2052,7,11,8,17,40,54,-14,41
Dumbarton,2052,8,9,12,15,49,60,-11,39
St Mirren,2052,9,9,11,16,43,54,-11,38
Raith,2052,10,9,9,18,32,50,-18,36
Morton,2053,1,19,12,5,61,35,26,69
Hibernian,2053,2,17,12,7,50,30,20,63
Dundee Utd,2053,3,15,10,11,55,47,8,55
Falkirk,2053,4,15,9,12,56,45,11,54
Dunfermline,2053,5,11,14,11,46,45,1,47
Queen of S't,2053,6,12,10,14,54,55,-1,46
Raith,2053,7,10,11,15,40,51,-11,41
Ayr,2053,8,9,12,15,38,54,-16,39
Dumbarton,2053,9,9,11,16,45,59,-14,38
St Mirren,2053,10,8,9,19,36,60,-24,33
Hibernian,2054,1,18,13,5,50,22,28,67
Falkirk,2054,2,18,11,7,61,36,25,65
Dundee Utd,2054,3,18,9,9,53,37,16,63
Morton,2054,4,17,10,9,50,34,16,61
Queen of S't,2054,5,12,11,13,47,48,-1,47
Raith,2054,6,11,9,16,34,46,-12,42
Ayr,2054,7,9,11,16,37,60,-23,38
Dunfermline,2054,8,8,12,16,43,55,-12,36
Dumbarton,2054,9,8,11,17,46,63,-17,35
St Mirren,2054,10,8,9,19,42,62,-20,33
Hibernian,2055,1,21,11,4,61,26,35,74
Dundee Utd,2055,2,17,11,8,51,35,16,62
Morton,2055,3,17,10,9,51,39,12,61
Falkirk,2055,4,15,13,8,60,42,18,58
Ayr,2055,5,10,11,15,35,54,-19,41
Raith,2055,6,10,10,16,38,49,-11,40
Queen of S't,2055,7,10,10,16,41,53,-12,40
Dunfermline,2055,8,8,14,14,43,54,-11,38
St Mirren,2055,9,9,10,17,41,55,-14,37
Dumbarton,2055,10,8,10,18,42,56,-14,34
Hibernian,2056,1,21,11,4,56,23,33,74
Dundee Utd,2056,2,18,10,8,54,39,15,64
Falkirk,2056,3,16,10,10,60,39,21,58
Morton,2056,4,14,12,10,48,43,5,54
Dunfermline,2056,5,11,12,13,43,44,-1,45
Raith,2056,6,11,10,15,38,46,-8,43
Dumbarton,2056,7,10,10,16,47,58,-11,40
Queen of S't,2056,8,10,10,16,41,53,-12,40
Ayr,2056,9,8,12,16,33,52,-19,36
St Mirren,2056,10,7,11,18,36,59,-23,32
Hibernian,2057,1,18,15,3,53,24,29,69
Dundee Utd,2057,2,18,9,9,53,38,15,63
Falkirk,2057,3,17,11,8,66,42,24,62
Morton,2057,4,16,10,10,45,39,6,58
Raith,2057,5,14,9,13,47,46,1,51
Dumbarton,2057,6,11,11,14,51,58,-7,44
Queen of S't,2057,7,11,9,16,45,53,-8,42
Dunfermline,2057,8,7,14,15,40,50,-10,35
Ayr,2057,9,7,11,18,33,59,-26,32
St Mirren,2057,10,7,9,20,37,61,-24,30
Falkirk,2058,1,19,10,7,61,37,24,67
Hibernian,2058,2,18,10,8,57,32,25,64
Morton,2058,3,16,12,8,51,37,14,60
Dundee Utd,2058,4,13,10,13,49,49,0,49
Dunfermline,2058,5,12,12,12,47,48,-1,48
St Mirren,2058,6,10,11,15,41,51,-10,41
Raith,2058,7,11,8,17,36,47,-11,41
Ayr,2058,8,10,11,15,35,54,-19,41
Queen of S't,2058,9,10,10,16,43,53,-10,40
Dumbarton,2058,10,7,14,15,45,57,-12,35
Hibernian,2059,1,20,13,3,58,21,37,73
Morton,2059,2,18,12,6,49,32,17,66
Falkirk,2059,3,16,12,8,62,39,23,60
Dundee Utd,2059,4,16,10,10,51,41,10,58
Dunfermline,2059,5,10,14,12,46,47,-1,44
Queen of S't,2059,6,10,11,15,43,54,-11,41
Raith,2059,7,10,10,16,35,51,-16,40
Dumbarton,2059,8,8,11,17,45,57,-12,35
St Mirren,2059,9,8,10,18,37,56,-19,34
Ayr,2059,10,7,11,18,31,59,-28,32
Hibernian,2060,1,19,12,5,53,24,29,69
Morton,2060,2,16,14,6,49,35,14,62
Falkirk,2060,3,16,10,10,55,38,17,58
Dundee Utd,2060,4,15,9,12,51,44,7,54
Dunfermline,2060,5,11,14,11,48,47,1,47
Queen of S't,2060,6,10,11,15,41,52,-11,41
Dumbarton,2060,7,8,15,13,47,55,-8,39
St Mirren,2060,8,9,11,16,40,50,-10,38
Raith,2060,9,9,11,16,36,51,-15,38
Ayr,2060,10,8,11,17,35,59,-24,35
Hibernian,2061,1,22,11,3,64,22,42,77
Morton,2061,2,18,10,8,51,40,11,64
Dundee Utd,2061,3,17,8,11,50,39,11,59
Falkirk,2061,4,15,11,10,56,42,14,56
Queen of S't,2061,5,13,9,14,44,46,-2,48
Dunfermline,2061,6,9,12,15,44,52,-8,39
Dumbarton,2061,7,9,11,16,49,62,-13,38
Raith,2061,8,10,8,18,35,48,-13,38
St Mirren,2061,9,9,10,17,46,62,-16,37
Ayr,2061,10,8,10,18,30,56,-26,34
Hibernian,2062,1,18,13,5,57,30,27,67
Morton,2062,2,17,11,8,52,39,13,62
Falkirk,2062,3,15,10,11,58,50,8,55
Dundee Utd,2062,4,13,12,11,50,47,3,51
Dunfermline,2062,5,10,13,13,45,49,-4,43
Dumbarton,2062,6,10,12,14,56,57,-1,42
Queen of S't,2062,7,10,12,14,45,50,-5,42
Raith,2062,8,10,12,14,36,47,-11,42
Ayr,2062,9,9,12,15,36,55,-19,39
St Mirren,2062,10,8,13,15,44,55,-11,37
Hibernian,2063,1,18,13,5,57,28,29,67
Morton,2063,2,18,11,7,53,38,15,65
Falkirk,2063,3,14,11,11,56,45,11,53
Dundee Utd,2063,4,14,10,12,50,47,3,52
Queen of S't,2063,5,13,11,12,49,45,4,50
Raith,2063,6,12,11,13,42,47,-5,47
Dunfermline,2063,7,10,12,14,44,46,-2,42
Ayr,2063,8,9,11,16,41,60,-19,38
Dumbarton,2063,9,8,12,16,51,70,-19,36
St Mirren,2063,10,8,10,18,44,61,-17,34
Hibernian,2064,1,17,13,6,53,32,21,64
Morton,2064,2,16,12,8,53,38,15,60
Falkirk,2064,3,16,10,10,57,40,17,58
Dundee Utd,2064,4,15,12,9,47,37,10,57
Queen of S't,2064,5,12,10,14,43,47,-4,46
Raith,2064,6,12,10,14,39,43,-4,46
Ayr,2064,7,9,14,13,38,52,-14,41
Dunfermline,2064,8,9,13,14,40,45,-5,40
Dumbarton,2064,9,8,14,14,45,58,-13,38
St Mirren,2064,10,6,12,18,36,59,-23,30
Hibernian,2065,1,19,11,6,58,28,30,68
Falkirk,2065,2,18,11,7,61,37,24,65
Dundee Utd,2065,3,17,10,9,50,38,12,61
Morton,2065,4,15,13,8,50,38,12,58
Queen of S't,2065,5,12,9,15,45,49,-4,45
Raith,2065,6,10,12,14,36,47,-11,42
St Mirren,2065,7,9,12,15,46,55,-9,39
Dumbarton,2065,8,8,12,16,49,60,-11,36
Dunfermline,2065,9,7,14,15,40,52,-12,35
Ayr,2065,10,7,12,17,34,65,-31,33
Hibernian,2066,1,19,11,6,55,26,29,68
Morton,2066,2,18,10,8,54,38,16,64
Falkirk,2066,3,14,14,8,58,41,17,56
Dundee Utd,2066,4,13,14,9,48,41,7,53
Queen of S't,2066,5,11,11,14,48,52,-4,44
Dunfermline,2066,6,9,15,12,43,46,-3,42
Dumbarton,2066,7,10,11,15,53,62,-9,41
Ayr,2066,8,9,14,13,39,51,-12,41
St Mirren,2066,9,8,12,16,43,57,-14,36
Raith,2066,10,8,10,18,35,62,-27,34
Hibernian,2067,1,21,11,4,63,25,38,74
Falkirk,2067,2,17,10,9,58,42,16,61
Morton,2067,3,16,11,9,53,42,11,59
Dundee Utd,2067,4,15,11,10,50,41,9,56
Raith,2067,5,11,11,14,36,47,-11,44
Queen of S't,2067,6,10,12,14,42,48,-6,42
Dunfermline,2067,7,9,13,14,48,53,-5,40
Dumbarton,2067,8,9,12,15,50,60,-10,39
Ayr,2067,9,9,11,16,33,58,-25,38
St Mirren,2067,10,7,10,19,40,57,-17,31
Hibernian,2068,1,19,12,5,52,25,27,69
Falkirk,2068,2,16,12,8,59,40,19,60
Morton,2068,3,15,13,8,50,37,13,58
Dundee Utd,2068,4,14,11,11,46,40,6,53
Queen of S't,2068,5,12,12,12,50,50,0,48
Dumbarton,2068,6,10,12,14,46,52,-6,42
St Mirren,2068,7,10,10,16,42,57,-15,40
Raith,2068,8,10,9,17,35,47,-12,39
Dunfermline,2068,9,8,13,15,44,54,-10,37
Ayr,2068,10,8,12,16,35,57,-22,36
Hibernian,2069,1,18,15,3,54,25,29,69
Morton,2069,2,15,12,9,43,36,7,57
Falkirk,2069,3,15,11,10,64,48,16,56
Dundee Utd,2069,4,14,13,9,45,35,10,55
Dunfermline,2069,5,11,15,10,50,46,4,48
Raith,2069,6,11,11,14,37,45,-8,44
Queen of S't,2069,7,11,10,15,43,51,-8,43
St Mirren,2069,8,9,11,16,39,52,-13,38
Dumbarton,2069,9,8,11,17,47,61,-14,35
Ayr,2069,10,6,15,15,29,52,-23,33
Hibernian,2070,1,22,11,3,65,20,45,77
Dundee Utd,2070,2,17,11,8,57,39,18,62
Falkirk,2070,3,17,9,10,60,43,17,60
Morton,2070,4,16,12,8,51,40,11,60
Queen of S't,2070,5,12,9,15,46,51,-5,45
Dunfermline,2070,6,11,11,14,48,51,-3,44
Raith,2070,7,10,9,17,40,49,-9,39
St Mirren,2070,8,9,10,17,38,60,-22,37
Dumbarton,2070,9,7,11,18,47,65,-18,32
Ayr,2070,10,7,11,18,32,66,-34,32
Morton,2071,1,20,11,5,61,33,28,71
Hibernian,2071,2,18,12,6,58,27,31,66
Falkirk,2071,3,17,10,9,57,42,15,61
Dundee Utd,2071,4,15,10,11,46,38,8,55
Dunfermline,2071,5,12,13,11,48,45,3,49
Raith,2071,6,10,11,15,32,45,-13,41
Queen of S't,2071,7,10,10,16,38,46,-8,40
St Mirren,2071,8,9,11,16,42,55,-13,38
Dumbarton,2071,9,8,10,18,42,61,-19,34
Ayr,2071,10,6,12,18,29,61,-32,30
Hibernian,2072,1,17,13,6,52,29,23,64
Dundee Utd,2072,2,18,8,10,48,36,12,62
Falkirk,2072,3,17,9,10,59,43,16,60
Morton,2072,4,15,13,8,44,33,11,58
Queen of S't,2072,5,13,9,14,45,46,-1,48
Dunfermline,2072,6,11,12,13,49,45,4,45
Dumbarton,2072,7,9,12,15,47,56,-9,39
Raith,2072,8,9,11,16,31,47,-16,38
Ayr,2072,9,7,14,15,28,50,-22,35
St Mirren,2072,10,7,13,16,37,55,-18,34
Hibernian,2073,1,22,11,3,55,21,34,77
Morton,2073,2,18,10,8,50,34,16,64
Falkirk,2073,3,15,12,9,62,44,18,57
Dundee Utd,2073,4,15,9,12,48,43,5,54
Queen of S't,2073,5,12,9,15,41,44,-3,45
Dunfermline,2073,6,11,11,14,48,49,-1,44
Raith,2073,7,11,9,16,35,51,-16,42
St Mirren,2073,8,9,11,16,41,52,-11,38
Dumbarton,2073,9,8,12,16,48,63,-15,36
Ayr,2073,10,6,12,18,29,56,-27,30
Hibernian,2074,1,19,11,6,52,26,26,68
Morton,2074,2,17,9,10,52,42,10,60
Dundee Utd,2074,3,16,11,9,55,40,15,59
Falkirk,2074,4,15,10,11,55,44,11,55
Queen of S't,2074,5,13,10,13,49,50,-1,49
Dumbarton,2074,6,12,11,13,53,53,0,47
Dunfermline,2074,7,11,12,13,44,47,-3,45
Ayr,2074,8,9,11,16,37,58,-21,38
Raith,2074,9,9,9,18,32,49,-17,36
St Mirren,2074,10,7,10,19,36,56,-20,31
Hibernian,2075,1,19,13,4,61,27,34,70
Morton,2075,2,18,11,7,49,34,15,65
Falkirk,2075,3,17,11,8,59,39,20,62
Dundee Utd,2075,4,14,11,11,46,38,8,53
Queen of S't,2075,5,11,11,14,43,48,-5,44
Dunfermline,2075,6,9,14,13,44,47,-3,41
Ayr,2075,7,9,13,14,37,52,-15,40
Dumbarton,2075,8,8,13,15,43,56,-13,37
Raith,2075,9,9,10,17,31,48,-17,37
St Mirren,2075,10,7,11,18,34,58,-24,32
Hibernian,2076,1,20,11,5,56,26,30,71
Falkirk,2076,2,18,11,7,66,38,28,65
Morton,2076,3,17,10,9,47,36,11,61
Dundee Utd,2076,4,16,9,11,51,41,10,57
Queen of S't,2076,5,10,13,13,45,51,-6,43
Dumbarton,2076,6,9,12,15,47,55,-8,39
Raith,2076,7,8,14,14,30,43,-13,38
Dunfermline,2076,8,7,16,13,40,46,-6,37
Ayr,2076,9,8,12,16,33,62,-29,36
St Mirren,2076,10,8,10,18,41,58,-17,34
Hibernian,2077,1,19,12,5,57,25,32,69
Morton,2077,2,18,9,9,50,40,10,63
Dundee Utd,2077,3,16,9,11,53,47,6,57
Falkirk,2077,4,15,9,12,57,47,10,54
Queen of S't,2077,5,12,11,13,47,47,0,47
Dumbarton,2077,6,10,13,13,51,57,-6,43
Raith,2077,7,11,9,16,34,46,-12,42
Dunfermline,2077,8,8,13,15,46,52,-6,37
Ayr,2077,9,8,13,15,34,54,-20,37
St Mirren,2077,10,8,12,16,43,57,-14,36
Hibernian,2078,1,19,11,6,54,26,28,68
Falkirk,2078,2,17,12,7,61,35,26,63
Morton,2078,3,17,10,9,50,37,13,61
Dundee Utd,2078,4,17,9,10,50,40,10,60
Dunfermline,2078,5,12,13,11,48,44,4,49
Ayr,2078,6,10,12,14,39,56,-17,42
Queen of S't,2078,7,10,8,18,41,54,-13,38
Dumbarton,2078,8,8,12,16,45,61,-16,36
St Mirren,2078,9,8,11,17,38,55,-17,35
Raith,2078,10,9,8,19,33,51,-18,35
Hibernian,2079,1,17,14,5,53,26,27,65
Falkirk,2079,2,17,11,8,57,38,19,62
Dundee Utd,2079,3,17,10,9,52,38,14,61
Morton,2079,4,15,13,8,52,38,14,58
Raith,2079,5,12,10,14,38,50,-12,46
Queen of S't,2079,6,11,11,14,46,47,-1,44
Dunfermline,2079,7,10,12,14,43,51,-8,42
Dumbarton,2079,8,8,14,14,48,57,-9,38
Ayr,2079,9,8,11,17,39,61,-22,35
St Mirren,2079,10,7,10,19,38,60,-22,31
Morton,2080,1,19,11,6,57,35,22,68
Hibernian,2080,2,18,12,6,55,28,27,66
Falkirk,2080,3,17,10,9,59,36,23,61
Dundee Utd,2080,4,14,10,12,46,45,1,52
Queen of S't,2080,5,12,10,14,43,48,-5,46
Raith,2080,6,11,9,16,37,50,-13,42
Ayr,2080,7,10,12,14,39,58,-19,42
St Mirren,2080,8,10,9,17,43,53,-10,39
Dumbarton,2080,9,9,11,16,44,56,-12,38
Dunfermline,2080,10,7,12,17,45,59,-14,33
Hibernian,2081,1,21,11,4,66,27,39,74
Morton,2081,2,16,13,7,52,38,14,61
Falkirk,2081,3,16,10,10,57,45,12,58
Dundee Utd,2081,4,14,10,12,48,45,3,52
Dunfermline,2081,5,12,12,12,52,47,5,48
Raith,2081,6,12,8,16,37,49,-12,44
Dumbarton,2081,7,10,11,15,47,55,-8,41
Queen of S't,2081,8,10,9,17,40,52,-12,39
St Mirren,2081,9,8,11,17,39,59,-20,35
Ayr,2081,10,7,13,16,33,54,-21,34
Morton,2082,1,19,11,6,53,33,20,68
Hibernian,2082,2,17,13,6,57,35,22,64
Falkirk,2082,3,16,12,8,61,40,21,60
Dundee Utd,2082,4,16,10,10,45,38,7,58
Dunfermline,2082,5,12,11,13,52,49,3,47
Queen of S't,2082,6,11,11,14,49,53,-4,44
St Mirren,2082,7,9,11,16,43,55,-12,38
Raith,2082,8,9,11,16,38,52,-14,38
Dumbarton,2082,9,8,11,17,44,60,-16,35
Ayr,2082,10,6,13,17,29,56,-27,31
Hibernian,2083,1,19,13,4,53,24,29,70
Morton,2083,2,16,11,9,47,37,10,59
Dundee Utd,2083,3,16,10,10,52,37,15,58
Falkirk,2083,4,15,11,10,54,39,15,56
Queen of S't,2083,5,14,8,14,49,49,0,50
Raith,2083,6,11,9,16,37,51,-14,42
St Mirren,2083,7,10,11,15,41,55,-14,41
Dunfermline,2083,8,8,14,14,42,48,-6,38
Dumbarton,2083,9,8,12,16,44,57,-13,36
Ayr,2083,10,7,13,16,32,54,-22,34
Hibernian,2084,1,21,11,4,65,27,38,74
Morton,2084,2,16,11,9,46,39,7,59
Dundee Utd,2084,3,16,10,10,55,37,18,58
Falkirk,2084,4,13,11,12,51,47,4,50
Dunfermline,2084,5,11,14,11,45,43,2,47
Queen of S't,2084,6,12,10,14,45,48,-3,46
Raith,2084,7,10,11,15,35,49,-14,41
St Mirren,2084,8,10,10,16,44,57,-13,40
Dumbarton,2084,9,9,10,17,51,63,-12,37
Ayr,2084,10,7,12,17,35,62,-27,33
Hibernian,2085,1,20,10,6,56,27,29,70
Morton,2085,2,17,11,8,50,35,15,62
Falkirk,2085,3,15,11,10,59,43,16,56
Dundee Utd,2085,4,15,9,12,51,42,9,54
Queen of S't,2085,5,13,11,12,49,48,1,50
Dunfermline,2085,6,9,14,13,43,48,-5,41
Raith,2085,7,10,11,15,39,53,-14,41
Dumbarton,2085,8,9,12,15,51,60,-9,39
St Mirren,2085,9,10,9,17,43,61,-18,39
Ayr,2085,10,7,12,17,36,60,-24,33
Hibernian,2086,1,18,12,6,54,29,25,66
Morton,2086,2,17,12,7,53,37,16,63
Falkirk,2086,3,17,9,10,59,42,17,60
Dundee Utd,2086,4,15,10,11,53,43,10,55
Queen of S't,2086,5,13,9,14,47,48,-1,48
Dunfermline,2086,6,10,13,13,48,50,-2,43
Raith,2086,7,11,10,15,37,50,-13,43
Dumbarton,2086,8,9,10,17,46,61,-15,37
Ayr,2086,9,8,12,16,39,60,-21,36
St Mirren,2086,10,8,11,17,42,58,-16,35
Hibernian,2087,1,20,12,4,66,27,39,72
Morton,2087,2,17,11,8,54,39,15,62
Dundee Utd,2087,3,15,11,10,45,39,6,56
Falkirk,2087,4,14,12,10,52,41,11,54
Queen of S't,2087,5,13,8,15,46,49,-3,47
Dumbarton,2087,6,11,12,13,53,55,-2,45
Raith,2087,7,10,11,15,33,51,-18,41
Dunfermline,2087,8,8,13,15,39,46,-7,37
Ayr,2087,9,7,16,13,35,51,-16,37
St Mirren,2087,10,6,12,18,41,66,-25,30
Hibernian,2088,1,18,12,6,52,27,25,66
Falkirk,2088,2,16,12,8,59,38,21,60
Morton,2088,3,15,13,8,45,36,9,58
Dundee Utd,2088,4,15,10,11,50,42,8,55
Queen of S't,2088,5,11,12,13,45,48,-3,45
Dunfermline,2088,6,9,13,14,45,48,-3,40
St Mirren,2088,7,9,12,15,37,49,-12,39
Dumbarton,2088,8,9,12,15,49,62,-13,39
Raith,2088,9,9,12,15,31,46,-15,39
Ayr,2088,10,8,14,14,38,55,-17,38
Hibernian,2089,1,20,10,6,59,28,31,70
Falkirk,2089,2,17,9,10,58,40,18,60
Dundee Utd,2089,3,16,8,12,47,37,10,56
Morton,2089,4,15,11,10,47,41,6,56
Dunfermline,2089,5,12,12,12,46,45,1,48
Queen of S't,2089,6,13,8,15,51,50,1,47
Raith,2089,7,11,9,16,36,50,-14,42
Dumbarton,2089,8,10,10,16,46,59,-13,40
Ayr,2089,9,9,12,15,39,58,-19,39
St Mirren,2089,10,8,9,19,40,61,-21,33
Hibernian,2090,1,18,11,7,58,32,26,65
Falkirk,2090,2,17,10,9,57,43,14,61
Dundee Utd,2090,3,17,9,10,53,38,15,60
Morton,2090,4,15,13,8,50,39,11,58
Dunfermline,2090,5,11,14,11,47,47,0,47
Queen of S't,2090,6,12,8,16,49,54,-5,44
Dumbarton,2090,7,9,12,15,47,57,-10,39
Raith,2090,8,9,11,16,36,50,-14,38
Ayr,2090,9,9,10,17,33,57,-24,37
St Mirren,2090,10,8,12,16,37,50,-13,36
Hibernian,2091,1,19,13,4,56,25,31,70
Morton,2091,2,19,10,7,53,38,15,67
Dundee Utd,2091,3,16,10,10,51,39,12,58
Falkirk,2091,4,15,11,10,58,46,12,56
Queen of S't,2091,5,13,11,12,49,47,2,50
Dunfermline,2091,6,10,12,14,47,53,-6,42
St Mirren,2091,7,8,13,15,40,54,-14,37
Ayr,2091,8,8,12,16,35,52,-17,36
Dumbarton,2091,9,8,11,17,48,60,-12,35
Raith,2091,10,8,9,19,30,53,-23,33
Morton,2092,1,20,10,6,63,39,24,70
Hibernian,2092,2,19,11,6,54,24,30,68
Falkirk,2092,3,17,11,8,62,41,21,62
Dundee Utd,2092,4,14,12,10,47,42,5,54
Queen of S't,2092,5,12,11,13,48,49,-1,47
Dunfermline,2092,6,9,15,12,45,48,-3,42
Dumbarton,2092,7,9,11,16,47,58,-11,38
Raith,2092,8,9,11,16,33,49,-16,38
Ayr,2092,9,8,12,16,31,54,-23,36
St Mirren,2092,10,6,10,20,40,66,-26,28
Hibernian,2093,1,21,12,3,57,24,33,75
Morton,2093,2,17,10,9,53,39,14,61
Falkirk,2093,3,15,11,10,53,39,14,56
Dundee Utd,2093,4,15,8,13,49,44,5,53
Dunfermline,2093,5,10,14,12,47,45,2,44
Dumbarton,2093,6,10,13,13,49,54,-5,43
Queen of S't,2093,7,11,9,16,42,52,-10,42
Raith,2093,8,11,9,16,38,52,-14,42
Ayr,2093,9,8,11,17,35,57,-22,35
St Mirren,2093,10,7,13,16,40,57,-17,34
Hibernian,2094,1,21,10,5,55,23,32,73
Morton,2094,2,17,13,6,52,36,16,64
Dundee Utd,2094,3,16,10,10,54,42,12,58
Falkirk,2094,4,15,11,10,56,44,12,56
Queen of S't,2094,5,13,8,15,44,48,-4,47
Raith,2094,6,9,11,16,32,46,-14,38
St Mirren,2094,7,9,11,16,40,55,-15,38
Dunfermline,2094,8,7,16,13,43,50,-7,37
Dumbarton,2094,9,8,13,15,47,60,-13,37
Ayr,2094,10,8,11,17,37,56,-19,35
Hibernian,2095,1,19,12,5,51,24,27,69
Falkirk,2095,2,16,11,9,58,39,19,59
Morton,2095,3,15,12,9,49,39,10,57
Dundee Utd,2095,4,15,11,10,49,40,9,56
Queen of S't,2095,5,12,11,13,46,47,-1,47
Raith,2095,6,12,9,15,37,48,-11,45
Dumbarton,2095,7,10,11,15,44,57,-13,41
Dunfermline,2095,8,9,13,14,44,47,-3,40
Ayr,2095,9,8,12,16,31,55,-24,36
St Mirren,2095,10,7,12,17,42,55,-13,33
Hibernian,2096,1,19,13,4,59,29,30,70
Morton,2096,2,17,11,8,53,39,14,62
Falkirk,2096,3,16,10,10,59,43,16,58
Dundee Utd,2096,4,14,11,11,52,46,6,53
Queen of S't,2096,5,13,9,14,49,50,-1,48
Dunfermline,2096,6,11,13,12,47,45,2,46
Dumbarton,2096,7,10,11,15,54,63,-9,41
Ayr,2096,8,10,10,16,38,55,-17,40
Raith,2096,9,9,8,19,33,52,-19,35
St Mirren,2096,10,8,10,18,38,60,-22,34
Hibernian,2097,1,19,12,5,58,25,33,69
Dundee Utd,2097,2,17,10,9,60,41,19,61
Morton,2097,3,17,10,9,50,37,13,61
Falkirk,2097,4,14,10,12,53,51,2,52
Queen of S't,2097,5,13,10,13,49,51,-2,49
Raith,2097,6,11,9,16,35,47,-12,42
Dumbarton,2097,7,10,11,15,51,60,-9,41
St Mirren,2097,8,10,10,16,48,57,-9,40
Ayr,2097,9,8,12,16,35,57,-22,36
Dunfermline,2097,10,7,14,15,41,54,-13,35
Hibernian,2098,1,19,14,3,58,25,33,71
Morton,2098,2,16,13,7,46,33,13,61
Falkirk,2098,3,14,11,11,55,47,8,53
Dundee Utd,2098,4,15,8,13,49,42,7,53
Queen of S't,2098,5,13,8,15,49,55,-6,47
Dunfermline,2098,6,11,11,14,47,49,-2,44
Dumbarton,2098,7,10,11,15,49,57,-8,41
Raith,2098,8,10,10,16,36,48,-12,40
St Mirren,2098,9,9,11,16,42,56,-14,38
Ayr,2098,10,7,15,14,33,52,-19,36
Hibernian,2099,1,20,13,3,62,28,34,73
Falkirk,2099,2,17,11,8,60,38,22,62
Dundee Utd,2099,3,16,11,9,59,42,17,59
Morton,2099,4,16,11,9,52,41,11,59
Queen of S't,2099,5,13,9,14,47,49,-2,48
Dunfermline,2099,6,10,13,13,45,50,-5,43
Raith,2099,7,10,10,16,35,47,-12,40
Dumbarton,2099,8,9,10,17,46,61,-15,37
St Mirren,2099,9,7,11,18,39,62,-23,32
Ayr,2099,10,7,11,18,35,62,-27,32
Hibernian,2100,1,20,10,6,54,27,27,70
Falkirk,2100,2,17,9,10,56,40,16,60
Morton,2100,3,16,11,9,49,38,11,59
Dundee Utd,2100,4,16,9,11,50,38,12,57
Queen of S't,2100,5,14,8,14,47,46,1,50
Dunfermline,2100,6,11,12,13,45,46,-1,45
Dumbarton,2100,7,10,11,15,50,58,-8,41
Raith,2100,8,11,8,17,33,51,-18,41
Ayr,2100,9,9,10,17,39,61,-22,37
St Mirren,2100,10,7,10,19,42,60,-18,31
Hibernian,2101,1,22,11,3,67,27,40,77
Dundee Utd,2101,2,18,9,9,51,36,15,63
Falkirk,2101,3,17,11,8,58,39,19,62
Morton,2101,4,15,9,12,48,45,3,54
Queen of S't,2101,5,12,9,15,43,49,-6,45
Dumbarton,2101,6,9,12,15,50,58,-8,39
Dunfermline,2101,7,9,12,15,42,50,-8,39
Raith,2101,8,9,11,16,35,52,-17,38
Ayr,2101,9,9,11,16,35,54,-19,38
St Mirren,2101,10,7,11,18,39,58,-19,32
Morton,2102,1,20,11,5,58,35,23,71
Falkirk,2102,2,16,13,7,65,39,26,61
Hibernian,2102,3,15,14,7,49,30,19,59
Dundee Utd,2102,4,14,9,13,50,45,5,51
Queen of S't,2102,5,13,9,14,45,53,-8,48
Dunfermline,2102,6,9,15,12,47,51,-4,42
St Mirren,2102,7,9,12,15,42,54,-12,39
Ayr,2102,8,9,12,15,36,56,-20,39
Raith,2102,9,9,11,16,37,50,-13,38
Dumbarton,2102,10,7,12,17,48,64,-16,33
Morton,2103,1,18,11,7,57,37,20,65
Hibernian,2103,2,17,12,7,52,30,22,63
Falkirk,2103,3,17,10,9,65,43,22,61
Dundee Utd,2103,4,16,10,10,49,41,8,58
Dunfermline,2103,5,10,15,11,48,46,2,45
Queen of S't,2103,6,12,9,15,43,51,-8,45
Raith,2103,7,12,9,15,39,48,-9,45
Dumbarton,2103,8,8,12,16,49,62,-13,36
Ayr,2103,9,6,15,15,33,56,-23,33
St Mirren,2103,10,6,13,17,39,60,-21,31
Hibernian,2104,1,19,12,5,56,26,30,69
Morton,2104,2,17,12,7,47,32,15,63
Dundee Utd,2104,3,16,9,11,48,39,9,57
Falkirk,2104,4,15,11,10,61,47,14,56
Queen of S't,2104,5,13,9,14,48,48,0,48
Raith,2104,6,12,8,16,36,46,-10,44
Dunfermline,2104,7,10,12,14,46,50,-4,42
St Mirren,2104,8,9,10,17,44,59,-15,37
Ayr,2104,9,8,12,16,30,55,-25,36
Dumbarton,2104,10,8,11,17,46,60,-14,35
Hibernian,2105,1,18,13,5,57,29,28,67
Falkirk,2105,2,16,12,8,57,40,17,60
Dundee Utd,2105,3,16,10,10,52,37,15,58
Morton,2105,4,16,10,10,51,44,7,58
Dunfermline,2105,5,12,13,11,50,45,5,49
Queen of S't,2105,6,10,11,15,42,50,-8,41
Raith,2105,7,10,9,17,35,52,-17,39
Dumbarton,2105,8,9,11,16,48,59,-11,38
Ayr,2105,9,8,13,15,37,60,-23,37
St Mirren,2105,10,8,12,16,42,55,-13,36
Hibernian,2106,1,18,12,6,52,25,27,66
Dundee Utd,2106,2,16,9,11,51,44,7,57
Morton,2106,3,15,10,11,43,38,5,55
Falkirk,2106,4,14,12,10,59,45,14,54
Dunfermline,2106,5,12,12,12,51,47,4,48
Ayr,2106,6,11,12,13,40,51,-11,45
Queen of S't,2106,7,11,11,14,49,53,-4,44
Raith,2106,8,11,9,16,38,53,-15,42
Dumbarton,2106,9,9,12,15,44,57,-13,39
St Mirren,2106,10,8,11,17,39,53,-14,35
Hibernian,2107,1,19,10,7,57,29,28,67
Morton,2107,2,18,9,9,54,40,14,63
Falkirk,2107,3,17,10,9,63,44,19,61
Dundee Utd,2107,4,15,12,9,49,37,12,57
Queen of S't,2107,5,11,10,15,49,51,-2,43
Dunfermline,2107,6,10,12,14,46,53,-7,42
St Mirren,2107,7,10,10,16,41,55,-14,40
Ayr,2107,8,9,12,15,37,56,-19,39
Dumbarton,2107,9,8,14,14,46,58,-12,38
Raith,2107,10,9,9,18,35,54,-19,36
Hibernian,2108,1,19,14,3,57,22,35,71
Morton,2108,2,17,13,6,49,33,16,64
Falkirk,2108,3,17,11,8,63,39,24,62
Dundee Utd,2108,4,17,9,10,56,40,16,60
Dunfermline,2108,5,10,14,12,47,45,2,44
Queen of S't,2108,6,11,10,15,44,55,-11,43
Dumbarton,2108,7,8,14,14,49,58,-9,38
Raith,2108,8,8,13,15,33,51,-18,37
St Mirren,2108,9,7,10,19,34,61,-27,31
Ayr,2108,10,6,12,18,34,62,-28,30
Hibernian,2109,1,20,12,4,58,24,34,72
Dundee Utd,2109,2,18,8,10,60,39,21,62
Morton,2109,3,16,11,9,51,39,12,59
Falkirk,2109,4,14,11,11,51,42,9,53
Ayr,2109,5,11,10,15,43,55,-12,43
Queen of S't,2109,6,11,9,16,43,57,-14,42
Dumbarton,2109,7,10,10,16,46,58,-12,40
Raith,2109,8,10,10,16,37,52,-15,40
Dunfermline,2109,9,9,12,15,46,55,-9,39
St Mirren,2109,10,10,9,17,40,54,-14,39
Hibernian,2110,1,19,12,5,54,26,28,69
Dundee Utd,2110,2,17,10,9,51,38,13,61
Falkirk,2110,3,16,12,8,59,40,19,60
Morton,2110,4,15,13,8,51,37,14,58
Dunfermline,2110,5,11,13,12,49,47,2,46
Queen of S't,2110,6,11,11,14,41,47,-6,44
Raith,2110,7,9,11,16,35,54,-19,38
St Mirren,2110,8,8,12,16,42,56,-14,36
Dumbarton,2110,9,7,13,16,45,59,-14,34
Ayr,2110,10,6,15,15,33,56,-23,33
Morton,2111,1,19,10,7,56,33,23,67
Hibernian,2111,2,18,12,6,54,28,26,66
Dundee Utd,2111,3,16,10,10,52,41,11,58
Falkirk,2111,4,15,10,11,57,41,16,55
Queen of S't,2111,5,12,9,15,49,56,-7,45
Raith,2111,6,12,9,15,38,47,-9,45
Dunfermline,2111,7,10,13,13,49,50,-1,43
Dumbarton,2111,8,9,11,16,47,60,-13,38
St Mirren,2111,9,8,11,17,41,59,-18,35
Ayr,2111,10,8,11,17,36,64,-28,35
Hibernian,2112,1,19,12,5,55,25,30,69
Falkirk,2112,2,17,9,10,59,39,20,60
Morton,2112,3,15,12,9,50,41,9,57
Dundee Utd,2112,4,16,9,11,46,39,7,57
Dunfermline,2112,5,12,14,10,50,45,5,50
Queen of S't,2112,6,13,10,13,48,47,1,49
St Mirren,2112,7,10,9,17,40,54,-14,39
Raith,2112,8,9,11,16,31,48,-17,38
Dumbarton,2112,9,8,11,17,44,62,-18,35
Ayr,2112,10,7,11,18,31,54,-23,32
Hibernian,2113,1,19,13,4,58,26,32,70
Falkirk,2113,2,17,12,7,59,38,21,63
Morton,2113,3,15,10,11,52,41,11,55
Dundee Utd,2113,4,14,12,10,46,39,7,54
Dunfermline,2113,5,12,14,10,52,46,6,50
Queen of S't,2113,6,10,12,14,44,52,-8,42
Raith,2113,7,10,9,17,37,54,-17,39
Dumbarton,2113,8,9,11,16,47,56,-9,38
Ayr,2113,9,7,16,13,37,56,-19,37
St Mirren,2113,10,8,9,19,37,61,-24,33
Hibernian,2114,1,18,13,5,58,26,32,67
Falkirk,2114,2,18,10,8,61,41,20,64
Morton,2114,3,17,11,8,48,38,10,62
Dundee Utd,2114,4,15,11,10,50,39,11,56
Queen of S't,2114,5,11,11,14,44,52,-8,44
Dunfermline,2114,6,10,12,14,48,52,-4,42
St Mirren,2114,7,9,11,16,40,53,-13,38
Raith,2114,8,10,8,18,33,47,-14,38
Dumbarton,2114,9,8,13,15,48,60,-12,37
Ayr,2114,10,8,12,16,34,56,-22,36
Hibernian,2115,1,21,12,3,61,24,37,75
Falkirk,2115,2,17,9,10,58,39,19,60
Dundee Utd,2115,3,17,9,10,52,37,15,60
Morton,2115,4,15,10,11,47,50,-3,55
Dumbarton,2115,5,12,11,13,53,52,1,47
Dunfermline,2115,6,11,11,14,50,53,-3,44
Queen of S't,2115,7,11,10,15,45,51,-6,43
Raith,2115,8,10,8,18,37,52,-15,38
St Mirren,2115,9,9,9,18,44,60,-16,36
Ayr,2115,10,6,13,17,31,60,-29,31
Hibernian,2116,1,20,12,4,60,28,32,72
Falkirk,2116,2,16,13,7,59,37,22,61
Dundee Utd,2116,3,16,11,9,56,40,16,59
Morton,2116,4,15,12,9,48,40,8,57
Queen of S't,2116,5,12,8,16,45,50,-5,44
Dumbarton,2116,6,10,12,14,48,58,-10,42
Dunfermline,2116,7,8,15,13,49,54,-5,39
St Mirren,2116,8,9,11,16,40,55,-15,38
Raith,2116,9,9,9,18,35,52,-17,36
Ayr,2116,10,8,11,17,32,58,-26,35
Morton,2117,1,19,10,7,51,35,16,67
Hibernian,2117,2,17,13,6,51,29,22,64
Dundee Utd,2117,3,18,8,10,61,38,23,62
Falkirk,2117,4,17,10,9,58,37,21,61
Queen of S't,2117,5,10,10,16,45,52,-7,40
Dumbarton,2117,6,9,13,14,47,61,-14,40
Raith,2117,7,10,9,17,34,48,-14,39
Dunfermline,2117,8,9,11,16,41,47,-6,38
St Mirren,2117,9,9,11,16,37,52,-15,38
Ayr,2117,10,9,11,16,33,59,-26,38
Hibernian,2118,1,20,12,4,55,26,29,72
Dundee Utd,2118,2,18,8,10,55,42,13,62
Morton,2118,3,16,12,8,54,41,13,60
Falkirk,2118,4,16,11,9,56,40,16,59
Dunfermline,2118,5,11,12,13,49,51,-2,45
Raith,2118,6,11,9,16,39,51,-12,42
Dumbarton,2118,7,9,13,14,50,57,-7,40
Queen of S't,2118,8,9,12,15,42,50,-8,39
St Mirren,2118,9,7,12,17,40,57,-17,33
Ayr,2118,10,7,11,18,32,57,-25,32
Hibernian,2119,1,18,13,5,54,25,29,67
Falkirk,2119,2,17,10,9,58,38,20,61
Morton,2119,3,14,12,10,48,37,11,54
Dundee Utd,2119,4,14,11,11,53,47,6,53
Dunfermline,2119,5,12,11,13,48,47,1,47
Dumbarton,2119,6,12,10,14,54,56,-2,46
Queen of S't,2119,7,10,11,15,44,51,-7,41
Ayr,2119,8,10,11,15,38,55,-17,41
Raith,2119,9,10,10,16,35,54,-19,40
St Mirren,2119,10,8,11,17,38,60,-22,35
Hibernian,2120,1,18,13,5,52,27,25,67
Morton,2120,2,17,12,7,54,38,16,63
Falkirk,2120,3,16,10,10,56,40,16,58
Dundee Utd,2120,4,15,11,10,52,42,10,56
Queen of S't,2120,5,11,11,14,47,50,-3,44
Dunfermline,2120,6,10,13,13,45,50,-5,43
Raith,2120,7,11,10,15,37,50,-13,43
Dumbarton,2120,8,8,12,16,46,59,-13,36
St Mirren,2120,9,8,12,16,40,56,-16,36
Ayr,2120,10,8,12,16,37,54,-17,36
Morton,2121,1,20,10,6,59,34,25,70
Hibernian,2121,2,17,13,6,52,27,25,64
Dundee Utd,2121,3,18,8,10,57,45,12,62
Falkirk,2121,4,14,13,9,57,42,15,55
Raith,2121,5,12,9,15,38,46,-8,45
Queen of S't,2121,6,11,10,15,50,56,-6,43
Dunfermline,2121,7,10,12,14,46,50,-4,42
Dumbarton,2121,8,9,12,15,51,61,-10,39
St Mirren,2121,9,8,10,18,40,57,-17,34
Ayr,2121,10,7,11,18,34,66,-32,32
Morton,2122,1,17,13,6,50,34,16,64
Hibernian,2122,2,16,14,6,54,33,21,62
Falkirk,2122,3,17,9,10,64,42,22,60
Dundee Utd,2122,4,16,10,10,49,39,10,58
Queen of S't,2122,5,14,9,13,54,50,4,51
Dunfermline,2122,6,10,16,10,49,46,3,46
Raith,2122,7,9,10,17,36,56,-20,37
Dumbarton,2122,8,8,12,16,47,62,-15,36
St Mirren,2122,9,9,9,18,41,58,-17,36
Ayr,2122,10,7,12,17,35,59,-24,33
Hibernian,2123,1,21,12,3,63,26,37,75
Morton,2123,2,17,12,7,51,36,15,63
Falkirk,2123,3,14,9,13,54,50,4,51
Dundee Utd,2123,4,13,10,13,47,40,7,49
Queen of S't,2123,5,13,8,15,44,48,-4,47
Raith,2123,6,11,11,14,37,47,-10,44
Dunfermline,2123,7,10,13,13,45,47,-2,43
Dumbarton,2123,8,11,10,15,47,54,-7,43
St Mirren,2123,9,9,10,17,39,54,-15,37
Ayr,2123,10,7,13,16,30,55,-25,34
Hibernian,2124,1,19,13,4,55,26,29,70
Falkirk,2124,2,17,9,10,55,38,17,60
Morton,2124,3,15,15,6,45,32,13,60
Dundee Utd,2124,4,15,10,11,47,41,6,55
Raith,2124,5,11,11,14,35,45,-10,44
Queen of S't,2124,6,11,10,15,44,51,-7,43
Dunfermline,2124,7,8,15,13,39,44,-5,39
Dumbarton,2124,8,9,11,16,45,57,-12,38
St Mirren,2124,9,9,10,17,40,52,-12,37
Ayr,2124,10,8,12,16,36,55,-19,36
Hibernian,2125,1,18,10,8,51,32,19,64
Morton,2125,2,17,11,8,52,37,15,62
Falkirk,2125,3,17,10,9,59,37,22,61
Dundee Utd,2125,4,16,11,9,55,43,12,59
Dunfermline,2125,5,11,12,13,51,50,1,45
Queen of S't,2125,6,12,8,16,46,48,-2,44
Raith,2125,7,12,8,16,35,46,-11,44
Ayr,2125,8,9,11,16,35,56,-21,38
St Mirren,2125,9,9,10,17,40,59,-19,37
Dumbarton,2125,10,8,11,17,45,61,-16,35
Hibernian,2126,1,19,10,7,56,27,29,67
Morton,2126,2,18,9,9,53,41,12,63
Dundee Utd,2126,3,17,9,10,56,39,17,60
Falkirk,2126,4,16,10,10,58,40,18,58
Queen of S't,2126,5,15,8,13,50,46,4,53
Dunfermline,2126,6,10,11,15,46,54,-8,41
St Mirren,2126,7,10,11,15,44,58,-14,41
Raith,2126,8,9,10,17,34,51,-17,37
Dumbarton,2126,9,8,11,17,45,64,-19,35
Ayr,2126,10,7,13,16,32,54,-22,34
Hibernian,2127,1,21,10,5,62,27,35,73
Dundee Utd,2127,2,17,10,9,54,38,16,61
Falkirk,2127,3,16,12,8,57,38,19,60
Morton,2127,4,16,10,10,52,39,13,58
Queen of S't,2127,5,13,8,15,47,52,-5,47
Raith,2127,6,11,9,16,34,49,-15,42
Ayr,2127,7,10,11,15,34,52,-18,41
Dunfermline,2127,8,8,13,15,42,52,-10,37
St Mirren,2127,9,9,9,18,39,59,-20,36
Dumbarton,2127,10,7,12,17,45,60,-15,33
Hibernian,2128,1,18,14,4,53,27,26,68
Morton,2128,2,19,11,6,58,34,24,68
Falkirk,2128,3,16,9,11,61,41,20,57
Dundee Utd,2128,4,15,9,12,53,44,9,54
Dunfermline,2128,5,12,11,13,49,46,3,47
Queen of S't,2128,6,11,11,14,44,54,-10,44
Ayr,2128,7,10,11,15,37,54,-17,41
St Mirren,2128,8,9,11,16,42,59,-17,38
Raith,2128,9,9,10,17,33,49,-16,37
Dumbarton,2128,10,7,11,18,45,67,-22,32
Hibernian,2129,1,23,10,3,59,21,38,79
Morton,2129,2,18,11,7,50,33,17,65
Dundee Utd,2129,3,15,11,10,48,38,10,56
Falkirk,2129,4,15,10,11,58,45,13,55
Queen of S't,2129,5,13,9,14,47,49,-2,48
Dumbarton,2129,6,10,12,14,48,55,-7,42
Dunfermline,2129,7,9,12,15,42,48,-6,39
Raith,2129,8,9,10,17,33,48,-15,37
St Mirren,2129,9,8,10,18,39,59,-20,34
Ayr,2129,10,6,13,17,29,57,-28,31
Hibernian,2130,1,22,11,3,63,21,42,77
Dundee Utd,2130,2,17,9,10,53,44,9,60
Morton,2130,3,15,13,8,49,39,10,58
Falkirk,2130,4,13,13,10,54,43,11,52
Dunfermline,2130,5,12,12,12,51,46,5,48
Queen of S't,2130,6,13,8,15,43,52,-9,47
St Mirren,2130,7,9,11,16,42,55,-13,38
Raith,2130,8,9,10,17,33,51,-18,37
Dumbarton,2130,9,8,11,17,47,61,-14,35
Ayr,2130,10,7,12,17,35,58,-23,33
Hibernian,2131,1,20,10,6,62,28,34,70
Dundee Utd,2131,2,17,8,11,52,41,11,59
Morton,2131,3,15,11,10,50,42,8,56
Falkirk,2131,4,15,9,12,55,42,13,54
Dunfermline,2131,5,14,11,11,53,42,11,53
Queen of S't,2131,6,12,9,15,45,53,-8,45
St Mirren,2131,7,11,10,15,43,54,-11,43
Raith,2131,8,11,9,16,36,50,-14,42
Ayr,2131,9,7,13,16,31,55,-24,34
Dumbarton,2131,10,7,12,17,44,64,-20,33
Hibernian,2132,1,20,12,4,58,21,37,72
Morton,2132,2,17,12,7,50,31,19,63
Dundee Utd,2132,3,16,9,11,53,42,11,57
Falkirk,2132,4,15,10,11,57,42,15,55
Queen of S't,2132,5,12,9,15,47,50,-3,45
Raith,2132,6,11,8,17,34,51,-17,41
Dunfermline,2132,7,9,13,14,43,47,-4,40
Dumbarton,2132,8,9,13,14,48,58,-10,40
Ayr,2132,9,10,10,16,35,58,-23,40
St Mirren,2132,10,8,10,18,38,63,-25,34
Hibernian,2133,1,18,11,7,58,32,26,65
Morton,2133,2,18,10,8,55,41,14,64
Falkirk,2133,3,16,11,9,58,38,20,59
Dundee Utd,2133,4,15,11,10,52,42,10,56
Queen of S't,2133,5,13,8,15,51,56,-5,47
Dunfermline,2133,6,11,13,12,51,49,2,46
Ayr,2133,7,10,12,14,39,53,-14,42
Raith,2133,8,10,8,18,35,54,-19,38
Dumbarton,2133,9,8,11,17,48,64,-16,35
St Mirren,2133,10,8,11,17,41,59,-18,35
Hibernian,2134,1,18,15,3,56,25,31,69
Morton,2134,2,16,12,8,58,43,15,60
Dundee Utd,2134,3,15,12,9,46,37,9,57
Falkirk,2134,4,14,10,12,54,44,10,52
Dunfermline,2134,5,11,14,11,54,54,0,47
Queen of S't,2134,6,11,11,14,45,48,-3,44
St Mirren,2134,7,10,11,15,42,52,-10,41
Dumbarton,2134,8,8,13,15,47,60,-13,37
Raith,2134,9,9,10,17,34,52,-18,37
Ayr,2134,10,7,14,15,30,51,-21,35
Hibernian,2135,1,18,12,6,53,29,24,66
Morton,2135,2,17,10,9,50,36,14,61
Falkirk,2135,3,16,9,11,58,43,15,57
Dundee Utd,2135,4,16,9,11,53,47,6,57
Queen of S't,2135,5,13,9,14,52,48,4,48
St Mirren,2135,6,11,10,15,44,54,-10,43
Raith,2135,7,11,9,16,41,51,-10,42
Dunfermline,2135,8,9,12,15,45,52,-7,39
Dumbarton,2135,9,8,13,15,45,57,-12,37
Ayr,2135,10,8,13,15,35,59,-24,37
Hibernian,2136,1,19,10,7,55,26,29,67
Morton,2136,2,17,11,8,48,34,14,62
Falkirk,2136,3,16,11,9,58,38,20,59
Dundee Utd,2136,4,15,11,10,44,37,7,56
Queen of S't,2136,5,12,11,13,45,51,-6,47
Dunfermline,2136,6,9,13,14,43,48,-5,40
Dumbarton,2136,7,9,12,15,43,54,-11,39
St Mirren,2136,8,10,9,17,40,53,-13,39
Raith,2136,9,10,9,17,37,51,-14,39
Ayr,2136,10,9,11,16,32,53,-21,38
Hibernian,2137,1,20,12,4,57,25,32,72
Falkirk,2137,2,16,11,9,57,38,19,59
Morton,2137,3,15,13,8,47,37,10,58
Dundee Utd,2137,4,14,10,12,46,45,1,52
Dunfermline,2137,5,11,13,12,47,47,0,46
Queen of S't,2137,6,11,10,15,41,48,-7,43
Raith,2137,7,10,11,15,34,45,-11,41
Ayr,2137,8,9,13,14,35,51,-16,40
Dumbarton,2137,9,8,13,15,48,59,-11,37
St Mirren,2137,10,7,12,17,42,59,-17,33
Dundee Utd,2138,1,19,8,9,54,39,15,65
Hibernian,2138,2,17,13,6,51,30,21,64
Morton,2138,3,18,10,8,50,35,15,64
Falkirk,2138,4,17,11,8,64,40,24,62
Queen of S't,2138,5,12,9,15,44,50,-6,45
Ayr,2138,6,10,11,15,38,53,-15,41
Dunfermline,2138,7,8,14,14,45,50,-5,38
Dumbarton,2138,8,9,11,16,49,58,-9,38
Raith,2138,9,9,11,16,34,50,-16,38
St Mirren,2138,10,7,10,19,38,62,-24,31
Hibernian,2139,1,20,12,4,55,22,33,72
Dundee Utd,2139,2,17,9,10,52,39,13,60
Morton,2139,2,17,9,10,52,39,13,60
Falkirk,2139,4,16,11,9,58,41,17,59
Dunfermline,2139,5,10,13,13,47,49,-2,43
Queen of S't,2139,6,10,11,15,45,54,-9,41
Raith,2139,7,10,11,15,34,47,-13,41
St Mirren,2139,8,8,13,15,43,57,-14,37
Ayr,2139,9,9,10,17,33,56,-23,37
Dumbarton,2139,10,8,11,17,50,65,-15,35
Hibernian,2140,1,18,15,3,51,21,30,69
Dundee Utd,2140,2,16,10,10,52,41,11,58
Morton,2140,3,15,10,11,49,44,5,55
Falkirk,2140,4,13,11,12,52,45,7,50
Dumbarton,2140,5,11,12,13,50,52,-2,45
Raith,2140,6,10,13,13,37,46,-9,43
St Mirren,2140,7,10,12,14,44,53,-9,42
Dunfermline,2140,8,9,13,14,44,48,-4,40
Queen of S't,2140,9,10,10,16,42,54,-12,40
Ayr,2140,10,8,14,14,37,54,-17,38
Hibernian,2141,1,18,13,5,57,27,30,67
Dundee Utd,2141,2,17,9,10,53,41,12,60
Morton,2141,3,16,12,8,49,37,12,60
Falkirk,2141,4,16,10,10,57,39,18,58
Queen of S't,2141,5,13,9,14,49,50,-1,48
Dunfermline,2141,6,10,14,12,46,45,1,44
Dumbarton,2141,7,10,13,13,47,54,-7,43
Raith,2141,8,11,10,15,39,49,-10,43
St Mirren,2141,9,7,10,19,36,64,-28,31
Ayr,2141,10,6,12,18,30,57,-27,30
Hibernian,2142,1,21,12,3,59,23,36,75
Falkirk,2142,2,16,11,9,57,39,18,59
Morton,2142,3,15,13,8,48,35,13,58
Dundee Utd,2142,4,16,10,10,45,37,8,58
Dunfermline,2142,5,10,13,13,44,49,-5,43
Raith,2142,6,11,10,15,37,49,-12,43
Queen of S't,2142,7,9,12,15,39,47,-8,39
Dumbarton,2142,8,9,11,16,49,60,-11,38
Ayr,2142,9,7,14,15,32,54,-22,35
St Mirren,2142,10,8,10,18,42,59,-17,34
Hibernian,2143,1,20,11,5,55,26,29,71
Falkirk,2143,2,18,9,9,60,37,23,63
Morton,2143,3,18,9,9,50,35,15,63
Dundee Utd,2143,4,17,8,11,52,39,13,59
Queen of S't,2143,5,12,8,16,45,50,-5,44
Dunfermline,2143,6,9,13,14,46,52,-6,40
Raith,2143,7,10,10,16,34,49,-15,40
Ayr,2143,8,9,12,15,31,52,-21,39
Dumbarton,2143,9,8,12,16,47,61,-14,36
St Mirren,2143,10,8,10,18,40,59,-19,34
Morton,2144,1,19,11,6,53,32,21,68
Hibernian,2144,2,18,13,5,54,28,26,67
Falkirk,2144,3,16,11,9,61,41,20,59
Dundee Utd,2144,4,15,10,11,49,43,6,55
Queen of S't,2144,5,12,10,14,46,49,-3,46
Dumbarton,2144,6,11,10,15,48,57,-9,43
Raith,2144,7,9,12,15,37,52,-15,39
Ayr,2144,8,9,12,15,35,54,-19,39
Dunfermline,2144,9,8,11,17,42,52,-10,35
St Mirren,2144,10,7,12,17,38,55,-17,33
Hibernian,2145,1,19,11,6,61,28,33,68
Morton,2145,2,19,11,6,58,35,23,68
Falkirk,2145,3,17,10,9,60,41,19,61
Dundee Utd,2145,4,16,11,9,51,41,10,59
Dunfermline,2145,5,9,14,13,47,50,-3,41
Queen of S't,2145,6,10,11,15,42,49,-7,41
Dumbarton,2145,7,9,12,15,47,59,-12,39
Raith,2145,8,9,11,16,33,50,-17,38
Ayr,2145,9,8,13,15,33,55,-22,37
St Mirren,2145,10,6,12,18,33,57,-24,30
Hibernian,2146,1,19,12,5,54,24,30,69
Falkirk,2146,2,17,11,8,59,38,21,62
Dundee Utd,2146,3,15,10,11,54,48,6,55
Morton,2146,4,13,15,8,47,38,9,54
Queen of S't,2146,5,14,9,13,48,50,-2,51
Raith,2146,6,11,10,15,37,47,-10,43
Dunfermline,2146,7,9,13,14,44,50,-6,40
Dumbarton,2146,8,8,14,14,47,56,-9,38
Ayr,2146,9,8,13,15,34,54,-20,37
St Mirren,2146,10,7,11,18,37,56,-19,32
Hibernian,2147,1,18,14,4,53,27,26,68
Morton,2147,2,16,10,10,51,39,12,58
Falkirk,2147,3,13,13,10,55,43,12,52
Dundee Utd,2147,4,13,11,12,47,43,4,50
Dunfermline,2147,5,12,11,13,49,48,1,47
Queen of S't,2147,6,12,9,15,46,47,-1,45
Raith,2147,7,12,9,15,38,48,-10,45
Ayr,2147,8,10,13,13,33,47,-14,43
Dumbarton,2147,9,10,10,16,45,59,-14,40
St Mirren,2147,10,8,12,16,45,61,-16,36
Hibernian,2148,1,21,11,4,55,23,32,74
Dundee Utd,2148,2,17,10,9,54,38,16,61
Morton,2148,3,16,12,8,48,35,13,60
Falkirk,2148,4,15,10,11,52,40,12,55
Queen of S't,2148,5,13,9,14,47,48,-1,48
Raith,2148,6,10,10,16,33,46,-13,40
St Mirren,2148,7,10,9,17,41,53,-12,39
Dunfermline,2148,8,8,13,15,40,55,-15,37
Ayr,2148,9,7,15,14,34,53,-19,36
Dumbarton,2148,10,8,11,17,46,59,-13,35
Hibernian,2149,1,18,14,4,59,31,28,68
Morton,2149,2,16,14,6,56,34,22,62
Dundee Utd,2149,3,15,10,11,50,43,7,55
Falkirk,2149,4,14,12,10,60,47,13,54
Dunfermline,2149,5,10,14,12,47,48,-1,44
Queen of S't,2149,6,11,10,15,49,55,-6,43
Dumbarton,2149,7,9,12,15,48,57,-9,39
Raith,2149,8,9,12,15,33,48,-15,39
Ayr,2149,9,9,12,15,38,59,-21,39
St Mirren,2149,10,9,10,17,38,56,-18,37
Morton,2150,1,18,12,6,54,36,18,66
Hibernian,2150,2,17,13,6,52,29,23,64
Falkirk,2150,3,17,11,8,61,39,22,62
Dundee Utd,2150,4,13,10,13,47,47,0,49
Queen of S't,2150,5,12,10,14,47,49,-2,46
Dumbarton,2150,6,10,12,14,50,57,-7,42
Ayr,2150,7,9,14,13,36,52,-16,41
Dunfermline,2150,8,9,13,14,43,48,-5,40
Raith,2150,9,10,9,17,33,49,-16,39
St Mirren,2150,10,8,10,18,40,57,-17,34
Hibernian,2151,1,22,10,4,65,31,34,76
Morton,2151,2,17,12,7,55,39,16,63
Falkirk,2151,3,16,11,9,56,36,20,59
Dundee Utd,2151,4,15,10,11,49,38,11,55
Queen of S't,2151,5,11,10,15,45,55,-10,43
Raith,2151,6,10,11,15,36,52,-16,41
Dumbarton,2151,7,9,13,14,46,54,-8,40
Dunfermline,2151,8,8,14,14,46,51,-5,38
St Mirren,2151,9,8,11,17,42,60,-18,35
Ayr,2151,10,7,12,17,37,61,-24,33
Hibernian,2152,1,17,15,4,51,26,25,66
Morton,2152,2,17,13,6,55,33,22,64
Dundee Utd,2152,3,18,8,10,57,42,15,62
Falkirk,2152,4,16,9,11,66,49,17,57
Queen of S't,2152,5,13,10,13,50,46,4,49
Dunfermline,2152,6,10,13,13,45,48,-3,43
Raith,2152,7,10,11,15,34,45,-11,41
St Mirren,2152,8,9,9,18,38,61,-23,36
Dumbarton,2152,9,8,11,17,46,64,-18,35
Ayr,2152,10,7,11,18,33,61,-28,32
Hibernian,2153,1,20,11,5,57,26,31,71
Morton,2153,2,18,10,8,53,35,18,64
Falkirk,2153,3,17,11,8,59,37,22,62
Dundee Utd,2153,4,14,8,14,42,40,2,50
Queen of S't,2153,5,12,8,16,46,52,-6,44
Dunfermline,2153,6,10,13,13,45,47,-2,43
Ayr,2153,7,10,11,15,35,56,-21,41
Dumbarton,2153,8,9,12,15,43,56,-13,39
Raith,2153,9,10,8,18,36,52,-16,38
St Mirren,2153,10,9,10,17,40,55,-15,37
Hibernian,2154,1,19,13,4,55,25,30,70
Morton,2154,2,17,11,8,53,41,12,62
Falkirk,2154,3,15,12,9,55,40,15,57
Dundee Utd,2154,4,15,9,12,52,42,10,54
Ayr,2154,5,11,13,12,39,51,-12,46
Queen of S't,2154,6,11,12,13,46,47,-1,45
Dumbarton,2154,7,9,14,13,46,57,-11,41
Dunfermline,2154,8,9,12,15,43,48,-5,39
St Mirren,2154,9,7,13,16,38,56,-18,34
Raith,2154,10,8,9,19,34,54,-20,33
Hibernian,2155,1,20,11,5,57,24,33,71
Morton,2155,2,18,12,6,54,33,21,66
Falkirk,2155,3,15,11,10,58,44,14,56
Dundee Utd,2155,4,14,11,11,48,44,4,53
Queen of S't,2155,5,12,10,14,44,47,-3,46
Raith,2155,6,11,10,15,33,46,-13,43
Dumbarton,2155,7,9,14,13,51,58,-7,41
Ayr,2155,8,9,11,16,38,56,-18,38
St Mirren,2155,9,8,12,16,42,58,-16,36
Dunfermline,2155,10,7,12,17,43,58,-15,33
Hibernian,2156,1,18,13,5,52,26,26,67
Morton,2156,2,18,11,7,53,37,16,65
Falkirk,2156,3,17,12,7,60,38,22,63
Dundee Utd,2156,4,16,10,10,51,40,11,58
Dunfermline,2156,5,10,12,14,47,52,-5,42
Dumbarton,2156,6,9,13,14,52,59,-7,40
Queen of S't,2156,7,10,10,16,46,54,-8,40
Ayr,2156,8,9,12,15,34,52,-18,39
Raith,2156,9,9,11,16,32,47,-15,38
St Mirren,2156,10,7,10,19,39,61,-22,31
Hibernian,2157,1,21,10,5,58,28,30,73
Morton,2157,2,17,13,6,52,35,17,64
Dundee Utd,2157,3,17,9,10,51,40,11,60
Falkirk,2157,4,14,11,11,54,43,11,53
Dumbarton,2157,5,11,12,13,49,53,-4,45
Raith,2157,6,12,9,15,39,47,-8,45
Dunfermline,2157,7,10,13,13,45,46,-1,43
Queen of S't,2157,8,10,9,17,41,53,-12,39
St Mirren,2157,9,8,9,19,39,58,-19,33
Ayr,2157,10,6,13,17,34,59,-25,31
Hibernian,2158,1,20,11,5,59,31,28,71
Morton,2158,2,17,11,8,55,37,18,62
Falkirk,2158,3,15,11,10,55,39,16,56
Dundee Utd,2158,4,14,10,12,48,44,4,52
Queen of S't,2158,5,12,10,14,44,47,-3,46
Ayr,2158,6,10,12,14,38,54,-16,42
Dunfermline,2158,7,9,14,13,44,49,-5,41
Dumbarton,2158,8,10,11,15,48,57,-9,41
St Mirren,2158,9,8,13,15,44,58,-14,37
Raith,2158,10,8,11,17,35,54,-19,35
Hibernian,2159,1,21,11,4,62,24,38,74
Morton,2159,2,17,12,7,51,33,18,63
Falkirk,2159,3,16,11,9,57,42,15,59
Dundee Utd,2159,4,16,10,10,52,38,14,58
Dunfermline,2159,5,10,13,13,54,53,1,43
Dumbarton,2159,6,10,11,15,50,60,-10,41
Queen of S't,2159,7,10,10,16,45,58,-13,40
Raith,2159,8,9,10,17,31,50,-19,37
Ayr,2159,9,8,12,16,33,56,-23,36
St Mirren,2159,10,7,12,17,35,56,-21,33
Hibernian,2160,1,18,14,4,56,26,30,68
Falkirk,2160,2,16,11,9,58,41,17,59
Morton,2160,3,15,12,9,52,39,13,57
Dundee Utd,2160,4,14,11,11,48,43,5,53
Queen of S't,2160,5,13,9,14,47,49,-2,48
Dumbarton,2160,6,11,10,15,49,58,-9,43
Raith,2160,7,11,10,15,39,49,-10,43
Dunfermline,2160,8,8,15,13,46,51,-5,39
Ayr,2160,9,9,11,16,32,51,-19,38
St Mirren,2160,10,8,11,17,35,55,-20,35
Hibernian,2161,1,20,12,4,60,26,34,72
Falkirk,2161,2,16,11,9,54,40,14,59
Dundee Utd,2161,3,16,9,11,53,42,11,57
Morton,2161,4,15,12,9,49,42,7,57
Dumbarton,2161,5,11,12,13,51,55,-4,45
Queen of S't,2161,6,11,9,16,45,55,-10,42
Raith,2161,7,10,12,14,34,45,-11,42
Ayr,2161,8,10,11,15,37,53,-16,41
Dunfermline,2161,9,8,14,14,43,49,-6,38
St Mirren,2161,10,6,12,18,35,54,-19,30
Hibernian,2162,1,20,13,3,54,20,34,73
Morton,2162,2,16,13,7,52,36,16,61
Falkirk,2162,3,16,11,9,61,46,15,59
Dundee Utd,2162,4,15,9,12,48,44,4,54
Queen of S't,2162,5,12,9,15,44,53,-9,45
Dunfermline,2162,6,10,14,12,49,49,0,44
Raith,2162,7,9,12,15,32,45,-13,39
Ayr,2162,8,9,12,15,33,53,-20,39
Dumbarton,2162,9,8,12,16,48,58,-10,36
St Mirren,2162,10,7,11,18,38,55,-17,32
Hibernian,2163,1,19,12,5,52,24,28,69
Morton,2163,2,18,11,7,51,33,18,65
Falkirk,2163,3,16,11,9,59,42,17,59
Dundee Utd,2163,4,14,10,12,55,46,9,52
Queen of S't,2163,5,12,10,14,46,51,-5,46
Raith,2163,6,11,10,15,36,46,-10,43
Dumbarton,2163,7,10,11,15,50,63,-13,41
Dunfermline,2163,8,8,14,14,43,50,-7,38
Ayr,2163,9,9,10,17,36,58,-22,37
St Mirren,2163,10,9,9,18,43,58,-15,36
Hibernian,2164,1,21,10,5,62,27,35,73
Falkirk,2164,2,18,10,8,61,38,23,64
Dundee Utd,2164,3,14,12,10,47,41,6,54
Dunfermline,2164,4,14,11,11,50,42,8,53
Morton,2164,5,14,10,12,48,41,7,52
Queen of S't,2164,6,11,10,15,46,53,-7,43
St Mirren,2164,7,10,9,17,45,56,-11,39
Ayr,2164,8,9,12,15,38,55,-17,39
Dumbarton,2164,9,8,12,16,46,62,-16,36
Raith,2164,10,9,8,19,33,61,-28,35
Hibernian,2165,1,20,10,6,55,24,31,70
Falkirk,2165,2,17,10,9,62,41,21,61
Morton,2165,3,17,10,9,49,37,12,61
Dundee Utd,2165,4,16,9,11,47,39,8,57
Dunfermline,2165,5,12,12,12,50,46,4,48
Queen of S't,2165,6,11,11,14,44,49,-5,44
Dumbarton,2165,7,9,13,14,49,58,-9,40
Raith,2165,8,10,8,18,36,54,-18,38
St Mirren,2165,9,9,10,17,38,55,-17,37
Ayr,2165,10,6,13,17,32,59,-27,31
Hibernian,2166,1,19,12,5,57,25,32,69
Falkirk,2166,2,17,11,8,56,36,20,62
Morton,2166,3,16,11,9,49,37,12,59
Dundee Utd,2166,4,16,10,10,51,39,12,58
Raith,2166,5,12,9,15,36,45,-9,45
Queen of S't,2166,6,11,9,16,43,53,-10,42
Dumbarton,2166,7,10,12,14,45,57,-12,42
Dunfermline,2166,8,9,13,14,48,48,0,40
Ayr,2166,9,8,12,16,35,57,-22,36
St Mirren,2166,10,8,9,19,36,59,-23,33
Hibernian,2167,1,19,14,3,53,23,30,71
Morton,2167,2,17,12,7,51,34,17,63
Dundee Utd,2167,3,17,8,11,49,38,11,59
Falkirk,2167,4,13,9,14,53,49,4,48
Dunfermline,2167,5,11,14,11,52,48,4,47
Dumbarton,2167,6,10,12,14,49,56,-7,42
Raith,2167,7,11,8,17,33,46,-13,41
Queen of S't,2167,8,10,10,16,39,50,-11,40
Ayr,2167,9,9,12,15,33,52,-19,39
St Mirren,2167,10,8,11,17,39,55,-16,35
Hibernian,2168,1,18,14,4,55,27,28,68
Morton,2168,2,18,11,7,55,37,18,65
Falkirk,2168,3,16,12,8,62,39,23,60
Dundee Utd,2168,4,15,10,11,49,45,4,55
Queen of S't,2168,5,13,9,14,55,47,8,48
Dunfermline,2168,6,10,13,13,46,48,-2,43
Dumbarton,2168,7,10,11,15,48,59,-11,41
Ayr,2168,8,9,11,16,31,54,-23,38
Raith,2168,9,8,10,18,28,50,-22,34
St Mirren,2168,10,7,11,18,35,58,-23,32
Hibernian,2169,1,18,13,5,56,32,24,67
Morton,2169,2,17,11,8,52,37,15,62
Dundee Utd,2169,3,17,9,10,51,41,10,60
Falkirk,2169,4,15,12,9,55,38,17,57
Queen of S't,2169,5,12,10,14,42,45,-3,46
Raith,2169,6,11,11,14,36,45,-9,44
Dumbarton,2169,7,10,10,16,50,60,-10,40
Dunfermline,2169,8,9,12,15,41,48,-7,39
Ayr,2169,9,8,14,14,39,55,-16,38
St Mirren,2169,10,7,10,19,37,58,-21,31
Hibernian,2170,1,19,11,6,53,27,26,68
Morton,2170,2,18,10,8,49,34,15,64
Falkirk,2170,3,17,9,10,62,38,24,60
Dundee Utd,2170,4,14,11,11,49,38,11,53
Queen of S't,2170,5,12,11,13,42,47,-5,47
Dumbarton,2170,6,10,11,15,48,56,-8,41
Ayr,2170,7,9,13,14,31,49,-18,40
Dunfermline,2170,8,9,12,15,42,51,-9,39
Raith,2170,9,9,11,16,31,46,-15,38
St Mirren,2170,10,9,9,18,39,60,-21,36
Hibernian,2171,1,19,12,5,54,27,27,69
Dundee Utd,2171,2,18,9,9,54,38,16,63
Morton,2171,3,17,11,8,53,35,18,62
Falkirk,2171,4,16,11,9,60,41,19,59
Dunfermline,2171,5,11,13,12,49,48,1,46
Queen of S't,2171,6,12,10,14,51,55,-4,46
Raith,2171,7,10,9,17,34,50,-16,39
Ayr,2171,8,8,13,15,35,58,-23,37
Dumbarton,2171,9,7,11,18,47,66,-19,32
St Mirren,2171,10,6,13,17,38,57,-19,31
Hibernian,2172,1,20,10,6,56,27,29,70
Falkirk,2172,2,17,11,8,61,39,22,62
Dundee Utd,2172,3,15,11,10,51,39,12,56
Morton,2172,4,13,13,10,44,40,4,52
Dunfermline,2172,5,12,12,12,51,50,1,48
Queen of S't,2172,6,12,10,14,44,47,-3,46
Raith,2172,7,10,11,15,35,47,-12,41
Dumbarton,2172,8,10,10,16,47,57,-10,40
Ayr,2172,9,9,12,15,35,56,-21,39
St Mirren,2172,10,7,10,19,36,58,-22,31
Hibernian,2173,1,19,12,5,58,26,32,69
Falkirk,2173,2,18,9,9,59,40,19,63
Morton,2173,3,17,12,7,50,35,15,63
Dundee Utd,2173,4,14,12,10,47,40,7,54
Dunfermline,2173,5,11,13,12,50,49,1,46
Queen of S't,2173,6,11,8,17,41,52,-11,41
St Mirren,2173,7,10,10,16,44,55,-11,40
Ayr,2173,8,9,12,15,36,55,-19,39
Raith,2173,9,9,11,16,34,52,-18,38
Dumbarton,2173,10,7,11,18,42,57,-15,32
Hibernian,2174,1,20,12,4,63,28,35,72
Dundee Utd,2174,2,17,9,10,51,37,14,60
Morton,2174,3,15,11,10,45,40,5,56
Falkirk,2174,4,14,10,12,52,44,8,52
Dunfermline,2174,5,11,13,12,45,44,1,46
Dumbarton,2174,6,11,10,15,50,55,-5,43
Raith,2174,7,10,13,13,38,46,-8,43
Queen of S't,2174,8,10,11,15,45,57,-12,41
Ayr,2174,9,9,12,15,40,57,-17,39
St Mirren,2174,10,7,11,18,38,59,-21,32
Hibernian,2175,1,21,12,3,59,22,37,75
Falkirk,2175,2,17,10,9,61,40,21,61
Morton,2175,3,15,14,7,52,41,11,59
Dundee Utd,2175,4,13,14,9,48,39,9,53
Queen of S't,2175,5,11,11,14,45,52,-7,44
Dunfermline,2175,6,9,14,13,47,50,-3,41
Raith,2175,7,10,10,16,36,51,-15,40
Ayr,2175,8,8,15,13,37,53,-16,39
St Mirren,2175,9,8,11,17,43,58,-15,35
Dumbarton,2175,10,7,11,18,43,65,-22,32
Hibernian,2176,1,19,12,5,59,27,32,69
Dundee Utd,2176,2,18,8,10,55,38,17,62
Morton,2176,3,16,12,8,50,38,12,60
Falkirk,2176,4,15,10,11,55,43,12,55
Dunfermline,2176,5,12,12,12,46,43,3,48
Queen of S't,2176,6,11,9,16,44,51,-7,42
Raith,2176,7,10,11,15,39,52,-13,41
Ayr,2176,8,9,11,16,39,54,-15,38
Dumbarton,2176,9,9,11,16,46,63,-17,38
St Mirren,2176,10,8,10,18,40,64,-24,34
Hibernian,2177,1,18,12,6,56,32,24,66
Morton,2177,2,18,11,7,56,36,20,65
Dundee Utd,2177,3,16,9,11,47,38,9,57
Falkirk,2177,4,14,13,9,56,43,13,55
Dunfermline,2177,5,11,14,11,51,45,6,47
St Mirren,2177,6,11,10,15,42,53,-11,43
Queen of S't,2177,7,10,11,15,43,50,-7,41
Raith,2177,8,10,11,15,36,46,-10,41
Ayr,2177,9,9,11,16,34,62,-28,38
Dumbarton,2177,10,7,10,19,46,62,-16,31
Hibernian,2178,1,20,11,5,57,24,33,71
Falkirk,2178,2,18,9,9,60,42,18,63
Morton,2178,3,15,13,8,45,34,11,58
Dundee Utd,2178,4,13,12,11,45,39,6,51
Queen of S't,2178,5,11,10,15,42,51,-9,43
Raith,2178,6,11,10,15,36,47,-11,43
Dumbarton,2178,7,10,11,15,46,53,-7,41
Dunfermline,2178,8,9,13,14,46,50,-4,40
Ayr,2178,9,9,12,15,31,51,-20,39
St Mirren,2178,10,8,11,17,36,53,-17,35
Hibernian,2179,1,17,15,4,53,26,27,66
Morton,2179,2,17,13,6,48,32,16,64
Falkirk,2179,3,17,9,10,58,44,14,60
Queen of S't,2179,4,13,10,13,49,49,0,49
Dunfermline,2179,5,11,15,10,51,44,7,48
Dundee Utd,2179,6,12,9,15,45,46,-1,45
Dumbarton,2179,7,10,10,16,48,59,-11,40
Ayr,2179,8,9,11,16,37,58,-21,38
Raith,2179,9,9,10,17,34,50,-16,37
St Mirren,2179,10,8,12,16,39,54,-15,36
Hibernian,2180,1,21,10,5,57,23,34,73
Falkirk,2180,2,16,11,9,57,38,19,59
Morton,2180,3,16,11,9,51,44,7,59
Dundee Utd,2180,4,14,10,12,48,42,6,52
Dunfermline,2180,5,11,12,13,49,47,2,45
Raith,2180,6,12,9,15,43,49,-6,45
Dumbarton,2180,7,10,12,14,54,64,-10,42
Queen of S't,2180,8,10,10,16,43,58,-15,40
Ayr,2180,9,7,14,15,34,55,-21,35
St Mirren,2180,10,7,13,16,43,59,-16,34
Hibernian,2181,1,18,14,4,55,27,28,68
Morton,2181,2,16,11,9,48,38,10,59
Falkirk,2181,3,14,12,10,57,42,15,54
Dundee Utd,2181,4,13,12,11,46,41,5,51
Dumbarton,2181,5,11,12,13,50,54,-4,45
Dunfermline,2181,6,10,14,12,48,49,-1,44
Raith,2181,7,11,10,15,36,47,-11,43
St Mirren,2181,8,10,11,15,47,53,-6,41
Queen of S't,2181,9,10,9,17,45,56,-11,39
Ayr,2181,10,8,13,15,34,59,-25,37
Hibernian,2182,1,19,11,6,52,26,26,68
Dundee Utd,2182,2,17,9,10,50,38,12,60
Morton,2182,3,16,11,9,48,39,9,59
Falkirk,2182,4,15,11,10,53,38,15,56
Dumbarton,2182,5,11,13,12,51,53,-2,46
Queen of S't,2182,6,12,9,15,43,48,-5,45
St Mirren,2182,7,10,10,16,43,53,-10,40
Raith,2182,8,10,10,16,36,49,-13,40
Dunfermline,2182,9,9,12,15,42,47,-5,39
Ayr,2182,10,8,10,18,30,57,-27,34
Hibernian,2183,1,18,13,5,53,26,27,67
Falkirk,2183,2,18,9,9,62,42,20,63
Morton,2183,3,17,11,8,51,37,14,62
Dundee Utd,2183,4,16,10,10,52,40,12,58
Dunfermline,2183,5,12,13,11,54,47,7,49
Queen of S't,2183,6,12,10,14,45,46,-1,46
Raith,2183,7,9,11,16,33,49,-16,38
Ayr,2183,8,9,11,16,34,55,-21,38
Dumbarton,2183,9,7,11,18,43,60,-17,32
St Mirren,2183,10,7,11,18,33,58,-25,32
Hibernian,2184,1,19,12,5,56,24,32,69
Morton,2184,2,17,12,7,54,36,18,63
Dundee Utd,2184,3,16,10,10,55,43,12,58
Falkirk,2184,4,15,9,12,54,47,7,54
Dunfermline,2184,5,12,12,12,53,50,3,48
Queen of S't,2184,6,12,11,13,46,46,0,47
Dumbarton,2184,7,9,12,15,46,59,-13,39
Raith,2184,8,10,9,17,38,55,-17,39
Ayr,2184,9,8,11,17,35,60,-25,35
St Mirren,2184,10,8,10,18,42,59,-17,34
Falkirk,2185,1,19,10,7,64,35,29,67
Morton,2185,2,17,12,7,50,36,14,63
Hibernian,2185,3,16,13,7,50,27,23,61
Dundee Utd,2185,4,15,10,11,48,43,5,55
Queen of S't,2185,5,12,9,15,44,53,-9,45
Raith,2185,6,11,10,15,39,47,-8,43
Dunfermline,2185,7,10,12,14,47,48,-1,42
Dumbarton,2185,8,9,10,17,46,60,-14,37
St Mirren,2185,9,9,10,17,44,61,-17,37
Ayr,2185,10,9,10,17,38,60,-22,37
Hibernian,2186,1,20,11,5,54,23,31,71
Morton,2186,2,20,9,7,54,29,25,69
Falkirk,2186,3,16,9,11,57,42,15,57
Dundee Utd,2186,4,15,10,11,48,38,10,55
Queen of S't,2186,5,12,11,13,50,49,1,47
Raith,2186,6,11,9,16,37,51,-14,42
Dunfermline,2186,7,8,14,14,46,57,-11,38
Dumbarton,2186,8,8,13,15,45,58,-13,37
Ayr,2186,9,8,11,17,33,61,-28,35
St Mirren,2186,10,7,13,16,36,52,-16,34
Hibernian,2187,1,19,11,6,57,28,29,68
Dundee Utd,2187,2,18,9,9,54,38,16,63
Falkirk,2187,3,16,9,11,60,46,14,57
Morton,2187,4,14,12,10,44,40,4,54
Queen of S't,2187,5,12,10,14,42,49,-7,46
Dunfermline,2187,6,11,12,13,47,48,-1,45
Dumbarton,2187,7,11,12,13,49,51,-2,45
Raith,2187,8,10,9,17,35,49,-14,39
Ayr,2187,9,8,13,15,34,54,-20,37
St Mirren,2187,10,7,11,18,38,57,-19,32
Hibernian,2188,1,20,10,6,54,26,28,70
Morton,2188,2,20,9,7,55,33,22,69
Dundee Utd,2188,3,16,10,10,53,40,13,58
Falkirk,2188,4,15,12,9,54,40,14,57
Dunfermline,2188,5,10,12,14,43,49,-6,42
Ayr,2188,6,10,10,16,35,55,-20,40
Queen of S't,2188,7,10,9,17,41,51,-10,39
Dumbarton,2188,8,9,12,15,50,61,-11,39
Raith,2188,9,10,8,18,33,48,-15,38
St Mirren,2188,10,9,10,17,43,58,-15,37
Hibernian,2189,1,17,15,4,55,27,28,66
Morton,2189,2,17,13,6,52,38,14,64
Falkirk,2189,3,16,11,9,61,41,20,59
Dundee Utd,2189,4,16,10,10,53,43,10,58
Queen of S't,2189,5,12,11,13,48,52,-4,47
Dunfermline,2189,6,10,12,14,54,54,0,42
Raith,2189,7,10,10,16,32,46,-14,40
Ayr,2189,8,9,12,15,35,53,-18,39
St Mirren,2189,9,8,11,17,38,57,-19,35
Dumbarton,2189,10,7,11,18,41,58,-17,32
Hibernian,2190,1,19,12,5,51,25,26,69
Falkirk,2190,2,17,11,8,58,38,20,62
Dundee Utd,2190,3,17,8,11,52,37,15,59
Morton,2190,4,15,13,8,47,40,7,58
Dumbarton,2190,5,11,10,15,52,56,-4,43
Queen of S't,2190,6,11,9,16,44,53,-9,42
Dunfermline,2190,7,9,13,14,44,48,-4,40
Raith,2190,8,10,10,16,35,47,-12,40
St Mirren,2190,9,9,12,15,41,54,-13,39
Ayr,2190,10,8,10,18,34,60,-26,34
Hibernian,2191,1,20,13,3,58,26,32,73
Morton,2191,2,17,12,7,52,39,13,63
Falkirk,2191,3,16,11,9,56,39,17,59
Dundee Utd,2191,4,14,11,11,50,41,9,53
Queen of S't,2191,5,12,8,16,47,50,-3,44
Dunfermline,2191,6,9,16,11,46,44,2,43
Raith,2191,7,10,10,16,34,52,-18,40
Dumbarton,2191,8,9,12,15,48,59,-11,39
Ayr,2191,9,8,12,16,38,60,-22,36
St Mirren,2191,10,7,11,18,40,59,-19,32
Hibernian,2192,1,20,13,3,58,23,35,73
Morton,2192,2,17,11,8,57,40,17,62
Dundee Utd,2192,3,17,10,9,54,38,16,61
Falkirk,2192,4,15,10,11,53,39,14,55
Dunfermline,2192,5,10,14,12,46,46,0,44
Dumbarton,2192,6,10,13,13,47,53,-6,43
Queen of S't,2192,7,11,10,15,43,51,-8,43
Ayr,2192,8,9,11,16,33,55,-22,38
Raith,2192,9,9,9,18,33,54,-21,36
St Mirren,2192,10,7,9,20,36,61,-25,30
Hibernian,2193,1,20,11,5,59,28,31,71
Morton,2193,2,17,10,9,50,37,13,61
Falkirk,2193,3,16,11,9,59,43,16,59
Dundee Utd,2193,4,16,11,9,49,39,10,59
Raith,2193,5,12,10,14,42,47,-5,46
Dunfermline,2193,6,9,15,12,45,49,-4,42
Queen of S't,2193,7,10,10,16,40,51,-11,40
Ayr,2193,8,9,11,16,35,54,-19,38
Dumbarton,2193,9,8,13,15,48,57,-9,37
St Mirren,2193,10,6,12,18,39,61,-22,30
Hibernian,2194,1,18,13,5,61,30,31,67
Falkirk,2194,2,17,10,9,60,38,22,61
Morton,2194,3,16,11,9,53,42,11,59
Dundee Utd,2194,4,16,10,10,52,41,11,58
Dunfermline,2194,5,12,12,12,44,45,-1,48
Dumbarton,2194,6,10,12,14,53,56,-3,42
Queen of S't,2194,7,10,9,17,44,59,-15,39
Raith,2194,8,10,9,17,36,51,-15,39
Ayr,2194,9,8,15,13,37,53,-16,39
St Mirren,2194,10,7,11,18,37,62,-25,32
Hibernian,2195,1,17,13,6,50,28,22,64
Morton,2195,2,17,10,9,52,34,18,61
Falkirk,2195,3,15,12,9,52,35,17,57
Dundee Utd,2195,4,15,10,11,46,40,6,55
Dumbarton,2195,5,12,11,13,50,54,-4,47
Dunfermline,2195,6,10,14,12,44,46,-2,44
Queen of S't,2195,7,11,9,16,43,51,-8,42
Raith,2195,8,11,8,17,34,50,-16,41
St Mirren,2195,9,10,9,17,46,55,-9,39
Ayr,2195,10,8,12,16,36,60,-24,36
Hibernian,2196,1,19,13,4,52,23,29,70
Morton,2196,2,18,10,8,52,37,15,64
Falkirk,2196,3,18,9,9,65,46,19,63
Dundee Utd,2196,4,15,9,12,50,45,5,54
Queen of S't,2196,5,12,9,15,48,50,-2,45
Raith,2196,6,11,8,17,35,48,-13,41
Ayr,2196,7,10,11,15,37,55,-18,41
Dumbarton,2196,8,10,10,16,49,61,-12,40
Dunfermline,2196,9,9,11,16,44,50,-6,38
St Mirren,2196,10,8,10,18,44,61,-17,34
Hibernian,2197,1,18,12,6,56,29,27,66
Falkirk,2197,2,17,10,9,61,39,22,61
Dundee Utd,2197,3,15,10,11,50,44,6,55
Morton,2197,4,14,12,10,46,39,7,54
Dunfermline,2197,5,14,11,11,56,46,10,53
Queen of S't,2197,6,12,8,16,46,55,-9,44
Raith,2197,7,12,8,16,35,49,-14,44
Ayr,2197,8,9,11,16,38,57,-19,38
Dumbarton,2197,9,8,13,15,45,57,-12,37
St Mirren,2197,10,8,11,17,37,55,-18,35
Hibernian,2198,1,19,13,4,59,28,31,70
Morton,2198,2,18,12,6,56,34,22,66
Falkirk,2198,3,16,9,11,59,45,14,57
Dundee Utd,2198,4,14,10,12,48,41,7,52
Queen of S't,2198,5,13,10,13,48,48,0,49
Dunfermline,2198,6,10,13,13,49,52,-3,43
Raith,2198,7,9,11,16,31,47,-16,38
St Mirren,2198,8,8,13,15,44,55,-11,37
Ayr,2198,9,9,10,17,31,56,-25,37
Dumbarton,2198,10,8,11,17,43,62,-19,35
Hibernian,2199,1,19,12,5,59,28,31,69
Dundee Utd,2199,2,16,10,10,55,43,12,58
Falkirk,2199,3,16,9,11,61,45,16,57
Dunfermline,2199,4,13,13,10,60,49,11,52
Morton,2199,5,13,12,11,46,45,1,51
Raith,2199,6,11,11,14,36,48,-12,44
Queen of S't,2199,7,11,10,15,45,56,-11,43
Dumbarton,2199,8,8,13,15,50,61,-11,37
Ayr,2199,9,8,13,15,36,58,-22,37
St Mirren,2199,10,7,13,16,39,54,-15,34
Hibernian,2200,1,15,15,6,47,28,19,60
Morton,2200,2,16,12,8,47,34,13,60
Falkirk,2200,3,14,13,9,60,47,13,55
Dundee Utd,2200,4,15,10,11,50,43,7,55
Dunfermline,2200,5,11,14,11,55,49,6,47
Queen of S't,2200,6,12,11,13,45,47,-2,47
St Mirren,2200,7,10,12,14,44,53,-9,42
Raith,2200,8,10,10,16,36,49,-13,40
Ayr,2200,9,9,12,15,33,54,-21,39
Dumbarton,2200,10,7,13,16,50,63,-13,34
Hibernian,2201,1,18,12,6,52,28,24,66
Falkirk,2201,2,17,11,8,61,39,22,62
Dundee Utd,2201,3,17,10,9,54,37,17,61
Morton,2201,4,16,10,10,47,35,12,58
Raith,2201,5,12,9,15,38,49,-11,45
Dunfermline,2201,6,9,15,12,48,51,-3,42
Queen of S't,2201,7,11,9,16,45,54,-9,42
Ayr,2201,8,10,10,16,33,52,-19,40
St Mirren,2201,9,9,9,18,42,58,-16,36
Dumbarton,2201,10,8,11,17,45,62,-17,35
Hibernian,2202,1,20,10,6,58,27,31,70
Morton,2202,2,19,10,7,57,38,19,67
Falkirk,2202,3,18,10,8,60,36,24,64
Dundee Utd,2202,4,17,10,9,49,37,12,61
Queen of S't,2202,5,11,9,16,45,51,-6,42
Dumbarton,2202,6,10,11,15,52,60,-8,41
Raith,2202,7,9,10,17,35,51,-16,37
Ayr,2202,8,8,13,15,33,55,-22,37
Dunfermline,2202,9,7,14,15,42,54,-12,35
St Mirren,2202,10,7,11,18,38,60,-22,32
Hibernian,2203,1,19,13,4,57,25,32,70
Morton,2203,2,18,11,7,52,34,18,65
Dundee Utd,2203,3,15,12,9,42,35,7,57
Falkirk,2203,4,14,11,11,54,40,14,53
Dunfermline,2203,5,10,13,13,45,45,0,43
Queen of S't,2203,6,11,9,16,46,57,-11,42
Raith,2203,7,11,8,17,35,51,-16,41
Dumbarton,2203,8,9,11,16,45,58,-13,38
Ayr,2203,9,8,14,14,35,49,-14,38
St Mirren,2203,10,9,10,17,37,54,-17,37
Hibernian,2204,1,21,11,4,59,25,34,74
Morton,2204,2,17,12,7,53,38,15,63
Falkirk,2204,3,16,10,10,62,41,21,58
Dundee Utd,2204,4,16,10,10,53,45,8,58
Dunfermline,2204,5,10,14,12,48,50,-2,44
Queen of S't,2204,6,12,8,16,46,51,-5,44
Dumbarton,2204,7,10,10,16,46,62,-16,40
Raith,2204,8,10,9,17,35,50,-15,39
St Mirren,2204,9,9,9,18,44,57,-13,36
Ayr,2204,10,7,11,18,33,60,-27,32
Hibernian,2205,1,20,11,5,58,27,31,71
Morton,2205,2,17,12,7,50,35,15,63
Dundee Utd,2205,3,17,10,9,55,42,13,61
Falkirk,2205,4,15,10,11,65,45,20,55
Dumbarton,2205,5,10,13,13,52,57,-5,43
Dunfermline,2205,6,8,16,12,44,49,-5,40
Queen of S't,2205,7,10,10,16,43,52,-9,40
St Mirren,2205,8,9,11,16,40,52,-12,38
Raith,2205,9,9,10,17,33,57,-24,37
Ayr,2205,10,8,11,17,30,54,-24,35
Hibernian,2206,1,20,10,6,60,29,31,70
Falkirk,2206,2,16,12,8,57,40,17,60
Dundee Utd,2206,3,17,9,10,54,43,11,60
Morton,2206,4,15,13,8,48,40,8,58
Queen of S't,2206,5,11,10,15,51,56,-5,43
Dunfermline,2206,6,10,12,14,47,51,-4,42
Raith,2206,7,10,10,16,40,49,-9,40
Dumbarton,2206,8,8,14,14,46,55,-9,38
Ayr,2206,9,8,13,15,38,62,-24,37
St Mirren,2206,10,8,11,17,42,58,-16,35
Hibernian,2207,1,20,12,4,58,28,30,72
Morton,2207,2,18,9,9,53,36,17,63
Dundee Utd,2207,3,17,9,10,56,44,12,60
Falkirk,2207,4,16,11,9,59,44,15,59
Dunfermline,2207,5,11,12,13,46,46,0,45
Raith,2207,6,12,8,16,39,49,-10,44
Ayr,2207,7,9,12,15,37,57,-20,39
Queen of S't,2207,8,9,11,16,40,52,-12,38
Dumbarton,2207,9,7,13,16,42,55,-13,34
St Mirren,2207,10,8,9,19,37,56,-19,33
Hibernian,2208,1,19,12,5,53,24,29,69
Dundee Utd,2208,2,17,10,9,51,36,15,61
Morton,2208,3,16,12,8,48,35,13,60
Falkirk,2208,4,16,9,11,56,47,9,57
Raith,2208,5,13,10,13,41,44,-3,49
Queen of S't,2208,6,10,11,15,47,52,-5,41
Ayr,2208,7,10,10,16,34,52,-18,40
Dunfermline,2208,8,8,15,13,44,50,-6,39
Dumbarton,2208,9,8,11,17,48,65,-17,35
St Mirren,2208,10,8,10,18,38,55,-17,34
Hibernian,2209,1,19,14,3,58,24,34,71
Dundee Utd,2209,2,18,8,10,54,37,17,62
Morton,2209,3,16,11,9,49,36,13,59
Falkirk,2209,4,15,10,11,56,46,10,55
Dunfermline,2209,5,11,11,14,49,49,0,44
Queen of S't,2209,6,11,11,14,45,52,-7,44
Ayr,2209,7,9,13,14,36,50,-14,40
Raith,2209,8,10,8,18,36,51,-15,38
Dumbarton,2209,9,9,10,17,45,63,-18,37
St Mirren,2209,10,9,10,17,38,58,-20,37
Hibernian,2210,1,17,14,5,55,28,27,65
Morton,2210,2,17,11,8,51,35,16,62
Falkirk,2210,3,17,10,9,62,42,20,61
Dundee Utd,2210,4,15,10,11,49,42,7,55
Dumbarton,2210,5,10,14,12,54,57,-3,44
Queen of S't,2210,6,11,10,15,47,54,-7,43
St Mirren,2210,7,10,12,14,46,52,-6,42
Raith,2210,8,10,9,17,34,53,-19,39
Dunfermline,2210,9,8,12,16,42,52,-10,36
Ayr,2210,10,7,14,15,32,57,-25,35
Hibernian,2211,1,21,11,4,60,24,36,74
Dundee Utd,2211,2,16,10,10,49,39,10,58
Morton,2211,3,16,9,11,51,44,7,57
Falkirk,2211,4,15,10,11,54,45,9,55
Queen of S't,2211,5,11,11,14,43,49,-6,44
Dunfermline,2211,6,10,13,13,47,47,0,43
St Mirren,2211,7,11,10,15,43,51,-8,43
Raith,2211,8,10,9,17,33,48,-15,39
Dumbarton,2211,9,9,11,16,46,54,-8,38
Ayr,2211,10,8,12,16,33,58,-25,36
Hibernian,2212,1,20,13,3,54,23,31,73
Morton,2212,2,17,12,7,50,33,17,63
Dundee Utd,2212,3,15,12,9,53,40,13,57
Falkirk,2212,4,14,11,11,56,45,11,53
Queen of S't,2212,5,12,11,13,45,47,-2,47
Dunfermline,2212,6,9,15,12,47,50,-3,42
Raith,2212,7,11,9,16,35,48,-13,42
Dumbarton,2212,8,8,12,16,46,59,-13,36
St Mirren,2212,9,9,9,18,38,57,-19,36
Ayr,2212,10,7,12,17,31,53,-22,33
Hibernian,2213,1,19,12,5,57,26,31,69
Morton,2213,2,17,12,7,51,35,16,63
Dundee Utd,2213,3,16,10,10,49,37,12,58
Falkirk,2213,4,15,12,9,55,40,15,57
Queen of S't,2213,5,13,9,14,48,51,-3,48
Raith,2213,6,10,11,15,36,49,-13,41
Dumbarton,2213,7,9,11,16,47,60,-13,38
Dunfermline,2213,8,8,13,15,42,50,-8,37
Ayr,2213,9,8,13,15,34,55,-21,37
St Mirren,2213,10,8,11,17,36,52,-16,35
Hibernian,2214,1,17,12,7,52,33,19,63
Falkirk,2214,2,18,9,9,58,40,18,63
Dundee Utd,2214,3,17,10,9,54,41,13,61
Morton,2214,4,14,11,11,44,39,5,53
Dunfermline,2214,5,11,13,12,46,44,2,46
Ayr,2214,6,11,11,14,42,54,-12,44
Queen of S't,2214,7,11,10,15,45,50,-5,43
Raith,2214,8,10,11,15,34,45,-11,41
Dumbarton,2214,9,9,10,17,46,61,-15,37
St Mirren,2214,10,9,9,18,46,60,-14,36
Hibernian,2215,1,19,12,5,50,26,24,69
Morton,2215,2,17,12,7,52,38,14,63
Falkirk,2215,3,17,11,8,61,40,21,62
Dundee Utd,2215,4,17,10,9,50,37,13,61
Queen of S't,2215,5,11,10,15,53,52,1,43
Dunfermline,2215,6,9,14,13,43,45,-2,41
Dumbarton,2215,7,10,10,16,49,61,-12,40
Ayr,2215,8,8,12,16,33,52,-19,36
St Mirren,2215,9,8,11,17,40,55,-15,35
Raith,2215,10,9,8,19,34,59,-25,35
Hibernian,2216,1,19,13,4,51,22,29,70
Falkirk,2216,2,17,10,9,58,37,21,61
Morton,2216,3,16,11,9,45,35,10,59
Dundee Utd,2216,4,15,10,11,49,41,8,55
Dunfermline,2216,5,11,12,13,46,45,1,45
Queen of S't,2216,6,12,9,15,45,54,-9,45
Raith,2216,7,10,11,15,39,49,-10,41
Dumbarton,2216,8,8,13,15,49,61,-12,37
Ayr,2216,9,8,12,16,33,55,-22,36
St Mirren,2216,10,8,11,17,40,56,-16,35
Hibernian,2217,1,18,13,5,51,25,26,67
Morton,2217,2,17,11,8,48,33,15,62
Falkirk,2217,3,16,11,9,59,40,19,59
Dundee Utd,2217,4,14,13,9,47,37,10,55
Queen of S't,2217,5,13,10,13,45,47,-2,49
Raith,2217,6,10,10,16,35,50,-15,40
Dunfermline,2217,7,8,15,13,43,47,-4,39
St Mirren,2217,8,9,12,15,41,54,-13,39
Dumbarton,2217,9,9,11,16,46,59,-13,38
Ayr,2217,10,6,14,16,31,54,-23,32
Hibernian,2218,1,19,14,3,59,25,34,71
Falkirk,2218,2,16,11,9,56,38,18,59
Morton,2218,3,14,15,7,47,37,10,57
Dundee Utd,2218,4,15,11,10,47,39,8,56
Dunfermline,2218,5,13,13,10,54,43,11,52
Queen of S't,2218,6,11,9,16,42,50,-8,42
Ayr,2218,7,8,15,13,39,55,-16,39
Raith,2218,8,9,10,17,33,54,-21,37
Dumbarton,2218,9,8,12,16,45,60,-15,36
St Mirren,2218,10,7,10,19,41,62,-21,31
Hibernian,2219,1,20,11,5,55,26,29,71
Morton,2219,2,16,14,6,49,35,14,62
Falkirk,2219,3,15,11,10,56,40,16,56
Dundee Utd,2219,4,14,10,12,48,45,3,52
Dunfermline,2219,5,11,12,13,45,48,-3,45
Queen of S't,2219,6,12,8,16,49,53,-4,44
Raith,2219,7,11,10,15,40,48,-8,43
Ayr,2219,8,9,13,14,38,58,-20,40
Dumbarton,2219,9,8,12,16,46,59,-13,36
St Mirren,2219,10,8,11,17,39,53,-14,35
Hibernian,2220,1,19,12,5,52,26,26,69
Morton,2220,2,16,11,9,49,37,12,59
Falkirk,2220,3,15,11,10,55,43,12,56
Dundee Utd,2220,4,14,10,12,46,43,3,52
Dunfermline,2220,5,13,11,12,51,49,2,50
Queen of S't,2220,6,11,10,15,44,48,-4,43
Dumbarton,2220,7,10,11,15,48,54,-6,41
Raith,2220,8,10,10,16,34,47,-13,40
Ayr,2220,9,9,12,15,36,52,-16,39
St Mirren,2220,10,9,10,17,39,55,-16,37
Hibernian,2221,1,19,12,5,61,30,31,69
Dundee Utd,2221,2,15,11,10,46,40,6,56
Morton,2221,3,14,12,10,47,40,7,54
Falkirk,2221,4,14,10,12,53,41,12,52
Dumbarton,2221,5,11,13,12,49,51,-2,46
Queen of S't,2221,6,12,9,15,44,49,-5,45
Raith,2221,7,12,9,15,42,52,-10,45
Dunfermline,2221,8,11,11,14,48,50,-2,44
Ayr,2221,9,10,13,13,36,50,-14,43
St Mirren,2221,10,7,10,19,35,58,-23,31
Hibernian,2222,1,19,12,5,53,25,28,69
Dundee Utd,2222,2,16,11,9,57,43,14,59
Falkirk,2222,3,15,12,9,60,42,18,57
Morton,2222,4,15,12,9,48,38,10,57
Queen of S't,2222,5,13,9,14,46,49,-3,48
Raith,2222,6,10,12,14,34,47,-13,42
Dumbarton,2222,7,9,14,13,49,56,-7,41
Dunfermline,2222,8,8,14,14,42,48,-6,38
Ayr,2222,9,8,11,17,36,61,-25,35
St Mirren,2222,10,7,13,16,42,58,-16,34
Hibernian,2223,1,19,13,4,52,21,31,70
Morton,2223,2,18,9,9,54,36,18,63
Dundee Utd,2223,3,18,9,9,53,38,15,63
Falkirk,2223,4,14,12,10,57,43,14,54
Raith,2223,5,12,10,14,38,46,-8,46
Queen of S't,2223,6,11,9,16,39,47,-8,42
Dumbarton,2223,7,9,12,15,45,54,-9,39
Dunfermline,2223,8,8,14,14,43,51,-8,38
St Mirren,2223,9,9,10,17,36,55,-19,37
Ayr,2223,10,7,12,17,29,55,-26,33
Hibernian,2224,1,18,14,4,57,30,27,68
Dundee Utd,2224,2,17,10,9,56,41,15,61
Falkirk,2224,3,17,9,10,61,41,20,60
Morton,2224,4,16,11,9,46,38,8,59
Dunfermline,2224,5,11,14,11,46,44,2,47
Queen of S't,2224,6,11,11,14,48,53,-5,44
Raith,2224,7,10,11,15,41,49,-8,41
St Mirren,2224,8,10,9,17,43,60,-17,39
Ayr,2224,9,8,11,17,37,61,-24,35
Dumbarton,2224,10,7,10,19,46,64,-18,31
Hibernian,2225,1,18,13,5,55,30,25,67
Falkirk,2225,2,16,12,8,58,36,22,60
Morton,2225,3,15,13,8,46,36,10,58
Dundee Utd,2225,4,15,11,10,46,37,9,56
Queen of S't,2225,5,13,11,12,45,45,0,50
Raith,2225,6,11,10,15,36,44,-8,43
Dunfermline,2225,7,8,15,13,42,46,-4,39
Ayr,2225,8,9,11,16,34,51,-17,38
Dumbarton,2225,9,8,13,15,47,58,-11,37
St Mirren,2225,10,7,11,18,37,63,-26,32
Hibernian,2226,1,18,13,5,53,27,26,67
Morton,2226,2,15,14,7,49,36,13,59
Dundee Utd,2226,3,16,10,10,51,35,16,58
Falkirk,2226,4,14,13,9,61,48,13,55
Queen of S't,2226,5,12,10,14,45,49,-4,46
Dunfermline,2226,6,9,15,12,46,48,-2,42
St Mirren,2226,7,11,9,16,45,52,-7,42
Dumbarton,2226,8,9,11,16,46,61,-15,38
Raith,2226,9,10,8,18,36,56,-20,38
Ayr,2226,10,9,11,16,33,53,-20,38
Morton,2227,1,19,10,7,50,32,18,67
Hibernian,2227,2,18,12,6,56,30,26,66
Falkirk,2227,3,15,11,10,58,46,12,56
Dundee Utd,2227,4,15,11,10,52,42,10,56
Queen of S't,2227,5,14,8,14,51,46,5,50
Dunfermline,2227,6,10,14,12,47,45,2,44
Raith,2227,7,10,12,14,36,47,-11,42
St Mirren,2227,8,9,10,17,42,58,-16,37
Dumbarton,2227,9,8,11,17,44,64,-20,35
Ayr,2227,10,7,11,18,31,57,-26,32
Hibernian,2228,1,18,13,5,56,26,30,67
Morton,2228,2,17,11,8,55,40,15,62
Falkirk,2228,3,16,11,9,60,41,19,59
Dundee Utd,2228,4,16,9,11,54,43,11,57
Queen of S't,2228,5,13,8,15,44,47,-3,47
St Mirren,2228,6,11,9,16,43,54,-11,42
Dumbarton,2228,7,10,10,16,51,61,-10,40
Raith,2228,8,10,10,16,36,51,-15,40
Dunfermline,2228,9,9,12,15,47,58,-11,39
Ayr,2228,10,8,11,17,31,56,-25,35
Morton,2229,1,19,10,7,53,35,18,67
Hibernian,2229,2,18,12,6,54,28,26,66
Falkirk,2229,3,16,11,9,58,41,17,59
Dundee Utd,2229,4,15,11,10,47,39,8,56
Queen of S't,2229,5,11,12,13,45,48,-3,45
Dunfermline,2229,6,10,12,14,47,54,-7,42
Raith,2229,7,9,13,14,35,47,-12,40
Dumbarton,2229,8,9,12,15,47,52,-5,39
St Mirren,2229,9,7,13,16,39,55,-16,34
Ayr,2229,10,7,12,17,28,54,-26,33
Hibernian,2230,1,19,12,5,53,24,29,69
Falkirk,2230,2,17,12,7,60,39,21,63
Morton,2230,3,17,12,7,52,40,12,63
Dundee Utd,2230,4,18,8,10,53,38,15,62
Raith,2230,5,13,9,14,42,45,-3,48
Queen of S't,2230,6,11,11,14,44,48,-4,44
Dunfermline,2230,7,9,13,14,42,48,-6,40
Dumbarton,2230,8,7,12,17,41,57,-16,33
St Mirren,2230,9,7,10,19,39,61,-22,31
Ayr,2230,10,6,13,17,32,58,-26,31
Hibernian,2231,1,19,13,4,56,23,33,70
Morton,2231,2,17,12,7,49,34,15,63
Dundee Utd,2231,3,17,8,11,55,38,17,59
Falkirk,2231,4,16,11,9,57,42,15,59
Queen of S't,2231,5,10,11,15,43,49,-6,41
Raith,2231,6,10,11,15,34,47,-13,41
Dunfermline,2231,7,8,15,13,46,56,-10,39
Ayr,2231,8,9,11,16,34,52,-18,38
Dumbarton,2231,9,7,15,14,47,62,-15,36
St Mirren,2231,10,8,11,17,38,56,-18,35
Morton,2232,1,19,10,7,54,37,17,67
Hibernian,2232,2,18,12,6,54,28,26,66
Dundee Utd,2232,3,16,11,9,49,36,13,59
Falkirk,2232,4,15,11,10,60,43,17,56
Dunfermline,2232,5,11,13,12,49,47,2,46
Dumbarton,2232,6,10,13,13,51,54,-3,43
Raith,2232,7,10,9,17,36,52,-16,39
Queen of S't,2232,8,10,9,17,40,57,-17,39
St Mirren,2232,9,8,11,17,41,57,-16,35
Ayr,2232,10,7,13,16,31,54,-23,34
Hibernian,2233,1,20,11,5,53,26,27,71
Morton,2233,2,19,11,6,57,36,21,68
Falkirk,2233,3,16,10,10,55,41,14,58
Dundee Utd,2233,4,15,10,11,47,37,10,55
Dunfermline,2233,5,10,13,13,49,51,-2,43
St Mirren,2233,6,10,10,16,44,53,-9,40
Raith,2233,7,10,10,16,34,48,-14,40
Ayr,2233,8,9,12,15,35,53,-18,39
Queen of S't,2233,9,9,9,18,40,54,-14,36
Dumbarton,2233,10,8,12,16,47,62,-15,36
Hibernian,2234,1,17,14,5,51,25,26,65
Falkirk,2234,2,18,9,9,59,38,21,63
Morton,2234,3,16,14,6,49,34,15,62
Dundee Utd,2234,4,15,10,11,47,46,1,55
Dumbarton,2234,5,11,10,15,48,53,-5,43
Queen of S't,2234,6,10,12,14,45,53,-8,42
Raith,2234,7,9,13,14,34,45,-11,40
Ayr,2234,8,8,14,14,38,53,-15,38
Dunfermline,2234,9,7,15,14,41,50,-9,36
St Mirren,2234,10,8,11,17,42,57,-15,35
Hibernian,2235,1,20,10,6,55,23,32,70
Falkirk,2235,2,17,10,9,59,39,20,61
Dundee Utd,2235,3,17,9,10,59,42,17,60
Morton,2235,4,16,9,11,46,40,6,57
Queen of S't,2235,5,14,9,13,45,48,-3,51
Dunfermline,2235,6,10,13,13,43,49,-6,43
Dumbarton,2235,7,9,12,15,49,57,-8,39
Raith,2235,8,9,11,16,36,49,-13,38
St Mirren,2235,9,8,11,17,40,57,-17,35
Ayr,2235,10,7,12,17,33,61,-28,33
Hibernian,2236,1,18,14,4,52,25,27,68
Morton,2236,2,16,12,8,49,35,14,60
Dundee Utd,2236,3,16,10,10,55,38,17,58
Falkirk,2236,4,15,10,11,52,45,7,55
Queen of S't,2236,5,12,10,14,49,50,-1,46
Dunfermline,2236,6,10,13,13,46,50,-4,43
Raith,2236,7,11,10,15,37,47,-10,43
St Mirren,2236,8,10,10,16,43,54,-11,40
Dumbarton,2236,9,9,11,16,53,63,-10,38
Ayr,2236,10,6,14,16,34,63,-29,32
Hibernian,2237,1,18,12,6,55,29,26,66
Falkirk,2237,2,17,11,8,61,39,22,62
Morton,2237,3,16,14,6,48,36,12,62
Dundee Utd,2237,4,16,9,11,53,42,11,57
Dunfermline,2237,5,11,13,12,55,47,8,46
Queen of S't,2237,6,11,8,17,43,59,-16,41
St Mirren,2237,7,9,12,15,41,53,-12,39
Raith,2237,8,10,9,17,32,48,-16,39
Ayr,2237,9,9,11,16,33,52,-19,38
Dumbarton,2237,10,7,13,16,48,64,-16,34
Hibernian,2238,1,18,13,5,52,28,24,67
Morton,2238,2,18,9,9,51,34,17,63
Dundee Utd,2238,3,16,8,12,48,40,8,56
Falkirk,2238,4,15,9,12,55,45,10,54
Dunfermline,2238,5,13,11,12,44,43,1,50
Queen of S't,2238,6,12,10,14,46,46,0,46
Dumbarton,2238,7,10,12,14,50,58,-8,42
Raith,2238,8,11,9,16,32,44,-12,42
St Mirren,2238,9,9,11,16,43,58,-15,38
Ayr,2238,10,6,12,18,33,58,-25,30
Hibernian,2239,1,20,12,4,57,26,31,72
Morton,2239,2,18,12,6,49,31,18,66
Dundee Utd,2239,3,15,10,11,49,43,6,55
Falkirk,2239,4,13,12,11,54,46,8,51
Dunfermline,2239,5,12,12,12,52,49,3,48
Queen of S't,2239,6,13,9,14,55,53,2,48
Raith,2239,7,10,9,17,33,47,-14,39
Ayr,2239,8,8,13,15,38,58,-20,37
Dumbarton,2239,9,8,11,17,50,65,-15,35
St Mirren,2239,10,7,12,17,40,59,-19,33
Hibernian,2240,1,19,11,6,58,28,30,68
Falkirk,2240,2,18,10,8,65,42,23,64
Morton,2240,3,18,10,8,53,37,16,64
Dundee Utd,2240,4,16,10,10,49,39,10,58
Queen of S't,2240,5,11,11,14,41,46,-5,44
Raith,2240,6,11,10,15,41,50,-9,43
Dumbarton,2240,7,10,11,15,50,57,-7,41
Dunfermline,2240,8,9,13,14,43,48,-5,40
St Mirren,2240,9,8,9,19,37,63,-26,33
Ayr,2240,10,7,11,18,36,63,-27,32
Hibernian,2241,1,20,12,4,56,22,34,72
Morton,2241,2,18,11,7,49,34,15,65
Falkirk,2241,3,16,12,8,54,34,20,60
Dundee Utd,2241,4,14,11,11,47,43,4,53
Ayr,2241,5,11,11,14,35,51,-16,44
Dumbarton,2241,6,11,10,15,54,56,-2,43
Queen of S't,2241,7,10,9,17,44,58,-14,39
Raith,2241,8,10,9,17,36,50,-14,39
Dunfermline,2241,9,8,13,15,43,52,-9,37
St Mirren,2241,10,8,10,18,39,57,-18,34
Hibernian,2242,1,20,10,6,54,25,29,70
Falkirk,2242,2,18,10,8,62,39,23,64
Morton,2242,3,16,12,8,49,35,14,60
Dundee Utd,2242,4,14,11,11,45,42,3,53
Dunfermline,2242,5,9,14,13,43,47,-4,41
St Mirren,2242,6,10,11,15,50,58,-8,41
Raith,2242,7,10,11,15,34,47,-13,41
Queen of S't,2242,8,10,10,16,42,50,-8,40
Ayr,2242,9,9,12,15,36,57,-21,39
Dumbarton,2242,10,7,13,16,49,64,-15,34
Hibernian,2243,1,20,12,4,57,28,29,72
Dundee Utd,2243,2,17,11,8,51,38,13,62
Morton,2243,3,17,10,9,50,37,13,61
Falkirk,2243,4,13,12,11,56,45,11,51
Queen of S't,2243,5,11,10,15,44,49,-5,43
St Mirren,2243,6,11,9,16,46,53,-7,42
Dunfermline,2243,7,9,14,13,45,49,-4,41
Raith,2243,8,9,11,16,29,44,-15,38
Dumbarton,2243,9,8,13,15,50,63,-13,37
Ayr,2243,10,7,14,15,28,50,-22,35
Hibernian,2244,1,19,12,5,59,30,29,69
Morton,2244,2,16,13,7,49,36,13,61
Falkirk,2244,3,15,11,10,59,44,15,56
Dundee Utd,2244,4,14,11,11,48,43,5,53
Raith,2244,5,12,10,14,41,47,-6,46
Dumbarton,2244,6,10,13,13,50,54,-4,43
Queen of S't,2244,7,11,10,15,43,52,-9,43
St Mirren,2244,8,9,11,16,44,56,-12,38
Dunfermline,2244,9,7,16,13,43,50,-7,37
Ayr,2244,10,7,13,16,33,57,-24,34
Hibernian,2245,1,19,13,4,54,24,30,70
Morton,2245,2,16,12,8,45,33,12,60
Dundee Utd,2245,3,16,11,9,46,33,13,59
Falkirk,2245,4,15,13,8,59,40,19,58
Queen of S't,2245,5,12,10,14,46,48,-2,46
Raith,2245,6,10,10,16,33,48,-15,40
Dumbarton,2245,7,9,12,15,47,57,-10,39
Dunfermline,2245,8,8,13,15,42,52,-10,37
St Mirren,2245,9,8,13,15,39,52,-13,37
Ayr,2245,10,8,11,17,32,56,-24,35
Hibernian,2246,1,21,10,5,61,26,35,73
Morton,2246,2,20,9,7,57,34,23,69
Dundee Utd,2246,3,16,11,9,52,35,17,59
Falkirk,2246,4,14,13,9,54,42,12,55
Queen of S't,2246,5,12,10,14,45,49,-4,46
Ayr,2246,6,10,11,15,33,53,-20,41
Dunfermline,2246,7,9,12,15,47,56,-9,39
Raith,2246,8,10,9,17,37,52,-15,39
St Mirren,2246,9,8,10,18,42,61,-19,34
Dumbarton,2246,10,7,11,18,46,66,-20,32
Morton,2247,1,18,9,9,56,37,19,63
Falkirk,2247,2,17,10,9,62,40,22,61
Hibernian,2247,3,16,13,7,50,30,20,61
Dundee Utd,2247,4,16,10,10,49,37,12,58
Queen of S't,2247,5,12,8,16,42,49,-7,44
Raith,2247,6,11,10,15,35,49,-14,43
Dunfermline,2247,7,10,12,14,46,53,-7,42
St Mirren,2247,8,10,11,15,39,49,-10,41
Dumbarton,2247,9,9,11,16,48,60,-12,38
Ayr,2247,10,7,14,15,32,55,-23,35
Hibernian,2248,1,21,11,4,57,23,34,74
Dundee Utd,2248,2,17,9,10,55,42,13,60
Falkirk,2248,3,16,10,10,59,41,18,58
Morton,2248,4,14,10,12,47,39,8,52
Queen of S't,2248,5,14,8,14,46,50,-4,50
Dumbarton,2248,6,11,10,15,47,56,-9,43
St Mirren,2248,7,11,9,16,41,52,-11,42
Dunfermline,2248,8,9,12,15,44,52,-8,39
Raith,2248,9,9,10,17,36,54,-18,37
Ayr,2248,10,8,11,17,34,57,-23,35
Hibernian,2249,1,18,14,4,53,25,28,68
Morton,2249,2,16,12,8,51,38,13,60
Falkirk,2249,3,16,11,9,59,42,17,59
Dundee Utd,2249,4,15,10,11,49,44,5,55
Dumbarton,2249,5,11,11,14,53,60,-7,44
Queen of S't,2249,6,11,10,15,46,52,-6,43
St Mirren,2249,7,9,12,15,43,53,-10,39
Dunfermline,2249,8,8,14,14,43,49,-6,38
Raith,2249,9,9,11,16,34,49,-15,38
Ayr,2249,10,8,13,15,32,51,-19,37
Hibernian,2250,1,18,12,6,55,30,25,66
Morton,2250,2,17,11,8,51,35,16,62
Falkirk,2250,3,16,11,9,60,39,21,59
Dundee Utd,2250,4,16,11,9,52,39,13,59
Queen of S't,2250,5,12,10,14,52,55,-3,46
Dunfermline,2250,6,10,12,14,48,56,-8,42
Ayr,2250,7,9,13,14,33,51,-18,40
Raith,2250,8,10,8,18,39,55,-16,38
Dumbarton,2250,9,8,13,15,50,62,-12,37
St Mirren,2250,10,8,11,17,41,59,-18,35
Hibernian,2251,1,19,12,5,52,24,28,69
Falkirk,2251,2,19,10,7,65,39,26,67
Morton,2251,3,17,11,8,48,33,15,62
Dundee Utd,2251,4,17,9,10,53,38,15,60
Dunfermline,2251,5,9,15,12,44,47,-3,42
Queen of S't,2251,6,10,10,16,42,52,-10,40
Raith,2251,7,10,9,17,36,50,-14,39
Ayr,2251,8,9,11,16,33,57,-24,38
St Mirren,2251,9,9,10,17,43,58,-15,37
Dumbarton,2251,10,7,11,18,45,63,-18,32
Hibernian,2252,1,18,13,5,53,25,28,67
Falkirk,2252,2,17,10,9,57,38,19,61
Dundee Utd,2252,3,17,10,9,52,38,14,61
Morton,2252,4,15,12,9,48,36,12,57
Queen of S't,2252,5,11,11,14,44,49,-5,44
Ayr,2252,6,11,10,15,39,54,-15,43
Dunfermline,2252,7,9,14,13,43,50,-7,41
St Mirren,2252,8,10,9,17,40,57,-17,39
Raith,2252,9,10,8,18,32,49,-17,38
Dumbarton,2252,10,8,11,17,47,59,-12,35
Hibernian,2253,1,19,14,3,59,24,35,71
Falkirk,2253,2,18,10,8,64,38,26,64
Morton,2253,3,15,14,7,47,35,12,59
Dundee Utd,2253,4,16,10,10,47,39,8,58
Queen of S't,2253,5,12,10,14,49,52,-3,46
Dumbarton,2253,6,10,11,15,49,57,-8,41
Raith,2253,7,10,9,17,42,55,-13,39
Dunfermline,2253,8,8,14,14,47,53,-6,38
St Mirren,2253,9,7,13,16,36,57,-21,34
Ayr,2253,10,6,13,17,36,66,-30,31
Hibernian,2254,1,19,12,5,52,27,25,69
Morton,2254,2,17,10,9,53,40,13,61
Dundee Utd,2254,3,17,9,10,51,40,11,60
Falkirk,2254,4,15,11,10,58,42,16,56
Dunfermline,2254,5,11,12,13,53,53,0,45
Queen of S't,2254,6,11,11,14,44,49,-5,44
Raith,2254,7,10,9,17,36,50,-14,39
Ayr,2254,8,9,12,15,38,54,-16,39
Dumbarton,2254,9,9,11,16,47,59,-12,38
St Mirren,2254,10,8,11,17,38,56,-18,35
Hibernian,2255,1,22,11,3,61,22,39,77
Morton,2255,2,17,11,8,52,35,17,62
Falkirk,2255,3,16,10,10,58,40,18,58
Dundee Utd,2255,4,16,10,10,50,41,9,58
Queen of S't,2255,5,11,10,15,43,55,-12,43
Dumbarton,2255,6,9,12,15,48,56,-8,39
Raith,2255,7,10,9,17,35,52,-17,39
Dunfermline,2255,8,8,14,14,44,49,-5,38
St Mirren,2255,9,8,11,17,35,55,-20,35
Ayr,2255,10,7,14,15,34,55,-21,35
Morton,2256,1,19,10,7,57,34,23,67
Hibernian,2256,2,18,12,6,52,29,23,66
Dundee Utd,2256,3,16,10,10,57,44,13,58
Falkirk,2256,4,15,12,9,57,43,14,57
Queen of S't,2256,5,11,12,13,48,53,-5,45
Dumbarton,2256,6,10,13,13,48,53,-5,43
Dunfermline,2256,7,9,15,12,45,45,0,42
Raith,2256,8,10,9,17,38,55,-17,39
St Mirren,2256,9,8,10,18,44,60,-16,34
Ayr,2256,10,7,11,18,33,63,-30,32
Hibernian,2257,1,21,11,4,63,27,36,74
Falkirk,2257,2,18,11,7,63,37,26,65
Morton,2257,3,16,11,9,48,36,12,59
Dundee Utd,2257,4,15,11,10,52,46,6,56
Dunfermline,2257,5,10,13,13,47,52,-5,43
Queen of S't,2257,6,11,9,16,48,62,-14,42
Raith,2257,7,10,10,16,41,52,-11,40
Ayr,2257,8,8,13,15,40,59,-19,37
St Mirren,2257,9,9,9,18,43,55,-12,36
Dumbarton,2257,10,7,12,17,44,63,-19,33
Hibernian,2258,1,19,12,5,59,26,33,69
Morton,2258,2,17,11,8,51,35,16,62
Falkirk,2258,3,16,11,9,58,40,18,59
Dundee Utd,2258,4,16,10,10,52,40,12,58
Queen of S't,2258,5,14,9,13,47,44,3,51
St Mirren,2258,6,11,9,16,45,53,-8,42
Raith,2258,7,10,9,17,32,52,-20,39
Dumbarton,2258,8,9,10,17,46,63,-17,37
Dunfermline,2258,9,8,12,16,43,55,-12,36
Ayr,2258,10,8,11,17,31,56,-25,35
Hibernian,2259,1,20,10,6,58,28,30,70
Morton,2259,2,18,10,8,50,33,17,64
Falkirk,2259,3,17,9,10,64,47,17,60
Dundee Utd,2259,4,13,11,12,48,43,5,50
Queen of S't,2259,5,13,9,14,45,45,0,48
Dunfermline,2259,6,10,13,13,49,51,-2,43
St Mirren,2259,7,11,10,15,42,52,-10,43
Ayr,2259,8,10,10,16,34,55,-21,40
Raith,2259,9,10,9,17,32,49,-17,39
Dumbarton,2259,10,7,11,18,46,65,-19,32
Hibernian,2260,1,18,13,5,51,24,27,67
Falkirk,2260,2,16,10,10,57,44,13,58
Morton,2260,3,15,12,9,53,40,13,57
Dundee Utd,2260,4,16,9,11,54,46,8,57
Raith,2260,5,12,10,14,41,45,-4,46
Queen of S't,2260,6,12,8,16,47,52,-5,44
Dunfermline,2260,7,11,11,14,44,54,-10,44
St Mirren,2260,8,10,9,17,48,56,-8,39
Dumbarton,2260,9,9,11,16,51,67,-16,38
Ayr,2260,10,9,11,16,42,60,-18,38
Hibernian,2261,1,19,12,5,55,28,27,69
Morton,2261,2,17,10,9,57,43,14,61
Falkirk,2261,3,16,11,9,58,40,18,59
Dundee Utd,2261,4,16,9,11,49,42,7,57
Dunfermline,2261,5,13,11,12,50,48,2,50
Queen of S't,2261,6,13,9,14,50,49,1,48
Raith,2261,7,11,8,17,41,50,-9,41
Dumbarton,2261,8,8,13,15,47,63,-16,37
St Mirren,2261,9,7,13,16,41,57,-16,34
Ayr,2261,10,6,12,18,30,58,-28,30
Falkirk,2262,1,19,10,7,65,36,29,67
Hibernian,2262,2,18,13,5,55,26,29,67
Morton,2262,3,16,13,7,46,34,12,61
Dundee Utd,2262,4,16,9,11,55,41,14,57
Dunfermline,2262,5,10,13,13,44,50,-6,43
Queen of S't,2262,6,11,10,15,45,52,-7,43
Ayr,2262,7,11,10,15,37,56,-19,43
Raith,2262,8,10,10,16,34,49,-15,40
Dumbarton,2262,9,8,11,17,45,60,-15,35
St Mirren,2262,10,6,11,19,34,56,-22,29
Morton,2263,1,19,10,7,59,38,21,67
Falkirk,2263,2,18,11,7,62,36,26,65
Hibernian,2263,3,17,13,6,51,28,23,64
Dundee Utd,2263,4,15,11,10,52,44,8,56
Queen of S't,2263,5,13,9,14,44,46,-2,48
Raith,2263,6,10,11,15,37,47,-10,41
Dumbarton,2263,7,9,12,15,51,59,-8,39
St Mirren,2263,8,9,10,17,38,56,-18,37
Dunfermline,2263,9,7,13,16,40,52,-12,34
Ayr,2263,10,8,10,18,36,64,-28,34
Hibernian,2264,1,19,12,5,54,28,26,69
Morton,2264,2,18,10,8,49,32,17,64
Dundee Utd,2264,3,18,9,9,53,38,15,63
Falkirk,2264,4,15,11,10,57,41,16,56
Queen of S't,2264,5,12,9,15,45,52,-7,45
St Mirren,2264,6,10,10,16,43,53,-10,40
Ayr,2264,7,9,12,15,33,54,-21,39
Dunfermline,2264,8,8,13,15,43,53,-10,37
Raith,2264,9,9,10,17,34,47,-13,37
Dumbarton,2264,10,8,12,16,45,58,-13,36
Hibernian,2265,1,20,12,4,57,30,27,72
Morton,2265,2,16,12,8,56,39,17,60
Falkirk,2265,3,15,11,10,57,45,12,56
Dundee Utd,2265,4,14,10,12,52,48,4,52
Raith,2265,5,12,10,14,37,45,-8,46
Ayr,2265,6,11,12,13,42,51,-9,45
Dunfermline,2265,7,10,12,14,46,50,-4,42
Dumbarton,2265,8,9,13,14,52,57,-5,40
Queen of S't,2265,9,9,10,17,41,55,-14,37
St Mirren,2265,10,7,12,17,44,64,-20,33
Falkirk,2266,1,17,12,7,61,38,23,63
Hibernian,2266,2,17,12,7,52,30,22,63
Morton,2266,3,16,10,10,51,43,8,58
Dundee Utd,2266,4,15,11,10,50,41,9,56
Dunfermline,2266,5,10,13,13,46,47,-1,43
Queen of S't,2266,6,11,10,15,44,52,-8,43
St Mirren,2266,7,11,10,15,46,55,-9,43
Raith,2266,8,11,9,16,42,53,-11,42
Ayr,2266,9,8,13,15,31,53,-22,37
Dumbarton,2266,10,8,12,16,47,58,-11,36
Hibernian,2267,1,19,13,4,55,26,29,70
Falkirk,2267,2,19,9,8,62,40,22,66
Morton,2267,3,17,11,8,50,35,15,62
Dundee Utd,2267,4,15,11,10,49,38,11,56
Queen of S't,2267,5,13,9,14,44,46,-2,48
Raith,2267,6,10,10,16,42,54,-12,40
Dunfermline,2267,7,8,14,14,42,49,-7,38
Ayr,2267,8,8,13,15,32,54,-22,37
Dumbarton,2267,9,8,11,17,46,60,-14,35
St Mirren,2267,10,7,11,18,39,59,-20,32
Morton,2268,1,19,11,6,55,35,20,68
Hibernian,2268,2,18,11,7,50,30,20,65
Falkirk,2268,3,15,10,11,59,43,16,55
Dunfermline,2268,4,12,13,11,47,41,6,49
Queen of S't,2268,5,13,8,15,42,47,-5,47
Dundee Utd,2268,6,12,11,13,43,49,-6,47
St Mirren,2268,7,11,11,14,47,50,-3,44
Raith,2268,8,10,9,17,34,49,-15,39
Ayr,2268,9,9,12,15,32,51,-19,39
Dumbarton,2268,10,8,10,18,45,59,-14,34
Hibernian,2269,1,20,11,5,55,26,29,71
Falkirk,2269,2,19,9,8,60,34,26,66
Morton,2269,3,16,10,10,48,39,9,58
Dundee Utd,2269,4,16,8,12,47,41,6,56
Queen of S't,2269,5,12,10,14,48,52,-4,46
Dunfermline,2269,6,10,11,15,47,54,-7,41
St Mirren,2269,7,10,10,16,47,55,-8,40
Dumbarton,2269,8,9,12,15,45,53,-8,39
Raith,2269,9,9,10,17,37,56,-19,37
Ayr,2269,10,7,13,16,33,57,-24,34
Hibernian,2270,1,17,11,8,54,31,23,62
Morton,2270,2,16,13,7,48,34,14,61
Falkirk,2270,3,16,11,9,57,41,16,59
Dundee Utd,2270,4,14,12,10,47,40,7,54
Queen of S't,2270,5,12,10,14,45,49,-4,46
Dunfermline,2270,6,10,14,12,51,53,-2,44
Raith,2270,7,11,11,14,35,44,-9,44
Ayr,2270,8,9,13,14,37,54,-17,40
Dumbarton,2270,9,7,14,15,50,62,-12,35
St Mirren,2270,10,8,11,17,39,55,-16,35
Hibernian,2271,1,19,14,3,54,23,31,71
Morton,2271,2,17,12,7,54,35,19,63
Falkirk,2271,3,15,10,11,57,41,16,55
Dundee Utd,2271,4,14,11,11,44,40,4,53
Queen of S't,2271,5,11,10,15,47,50,-3,43
Dunfermline,2271,6,10,13,13,45,49,-4,43
St Mirren,2271,7,11,9,16,46,59,-13,42
Raith,2271,8,10,10,16,35,50,-15,40
Dumbarton,2271,9,8,13,15,43,56,-13,37
Ayr,2271,10,8,12,16,35,57,-22,36
Hibernian,2272,1,18,13,5,53,26,27,67
Morton,2272,2,19,10,7,51,36,15,67
Falkirk,2272,3,16,12,8,58,37,21,60
Dundee Utd,2272,4,14,11,11,47,40,7,53
Dunfermline,2272,5,11,14,11,50,46,4,47
Queen of S't,2272,6,10,11,15,45,54,-9,41
Ayr,2272,7,9,13,14,37,53,-16,40
Dumbarton,2272,8,9,12,15,52,63,-11,39
St Mirren,2272,9,8,10,18,41,60,-19,34
Raith,2272,10,8,10,18,33,52,-19,34
Hibernian,2273,1,18,14,4,54,24,30,68
Morton,2273,2,19,11,6,52,33,19,68
Falkirk,2273,3,18,9,9,61,44,17,63
Dundee Utd,2273,4,15,10,11,55,45,10,55
Queen of S't,2273,5,12,9,15,47,55,-8,45
Raith,2273,6,11,8,17,37,50,-13,41
Ayr,2273,7,9,12,15,38,50,-12,39
Dunfermline,2273,8,8,13,15,44,50,-6,37
Dumbarton,2273,9,8,13,15,46,64,-18,37
St Mirren,2273,10,7,11,18,40,59,-19,32
Hibernian,2274,1,19,12,5,55,29,26,69
Falkirk,2274,2,17,10,9,59,40,19,61
Morton,2274,3,16,11,9,53,41,12,59
Dundee Utd,2274,4,16,10,10,55,41,14,58
Queen of S't,2274,5,13,8,15,46,53,-7,47
Dunfermline,2274,6,10,14,12,53,48,5,44
Raith,2274,7,11,11,14,39,46,-7,44
Dumbarton,2274,8,9,12,15,46,58,-12,39
St Mirren,2274,9,7,11,18,40,61,-21,32
Ayr,2274,10,7,11,18,33,62,-29,32
Hibernian,2275,1,19,11,6,52,27,25,68
Morton,2275,2,19,9,8,56,40,16,66
Falkirk,2275,3,15,12,9,56,39,17,57
Dundee Utd,2275,4,15,11,10,53,42,11,56
Raith,2275,5,12,8,16,37,46,-9,44
Dunfermline,2275,6,10,13,13,49,49,0,43
Queen of S't,2275,7,10,11,15,43,50,-7,41
St Mirren,2275,8,10,10,16,44,54,-10,40
Dumbarton,2275,9,9,10,17,47,61,-14,37
Ayr,2275,10,8,11,17,31,60,-29,35
Morton,2276,1,18,13,5,52,32,20,67
Hibernian,2276,2,17,13,6,57,29,28,64
Falkirk,2276,3,17,11,8,58,39,19,62
Dundee Utd,2276,4,14,10,12,47,39,8,52
Queen of S't,2276,5,12,11,13,43,47,-4,47
Dunfermline,2276,6,9,14,13,41,45,-4,41
Raith,2276,7,9,12,15,33,46,-13,39
Dumbarton,2276,8,8,13,15,47,59,-12,37
St Mirren,2276,9,9,10,17,40,58,-18,37
Ayr,2276,10,7,13,16,33,57,-24,34
Hibernian,2277,1,19,13,4,55,27,28,70
Dundee Utd,2277,2,17,8,11,51,37,14,59
Falkirk,2277,3,16,10,10,54,38,16,58
Morton,2277,4,15,13,8,48,38,10,58
Queen of S't,2277,5,11,10,15,49,55,-6,43
Dumbarton,2277,6,11,10,15,52,59,-7,43
Dunfermline,2277,7,10,12,14,49,48,1,42
Raith,2277,8,11,9,16,39,54,-15,42
St Mirren,2277,9,10,9,17,40,54,-14,39
Ayr,2277,10,7,12,17,33,60,-27,33
Hibernian,2278,1,23,10,3,63,20,43,79
Morton,2278,2,16,11,9,47,37,10,59
Dundee Utd,2278,3,15,11,10,52,44,8,56
Falkirk,2278,4,14,9,13,55,45,10,51
Dunfermline,2278,5,11,12,13,45,45,0,45
Dumbarton,2278,6,10,12,14,48,55,-7,42
Queen of S't,2278,7,11,8,17,45,58,-13,41
Raith,2278,8,11,8,17,35,51,-16,41
Ayr,2278,9,9,11,16,32,52,-20,38
St Mirren,2278,10,9,10,17,40,55,-15,37
Hibernian,2279,1,19,11,6,58,26,32,68
Morton,2279,2,17,12,7,52,37,15,63
Dundee Utd,2279,3,17,10,9,53,40,13,61
Falkirk,2279,4,16,9,11,58,43,15,57
Queen of S't,2279,5,11,9,16,46,50,-4,42
Dumbarton,2279,6,10,12,14,46,53,-7,42
St Mirren,2279,7,11,9,16,40,55,-15,42
Raith,2279,8,11,8,17,37,46,-9,41
Dunfermline,2279,9,8,13,15,43,57,-14,37
Ayr,2279,10,7,13,16,33,59,-26,34
Hibernian,2280,1,19,13,4,54,29,25,70
Morton,2280,2,17,12,7,51,35,16,63
Falkirk,2280,3,16,10,10,59,42,17,58
Dundee Utd,2280,4,16,9,11,50,43,7,57
Dunfermline,2280,5,10,15,11,49,45,4,45
Queen of S't,2280,6,11,9,16,46,51,-5,42
Dumbarton,2280,7,10,10,16,49,63,-14,40
Ayr,2280,8,10,10,16,37,55,-18,40
Raith,2280,9,10,9,17,36,49,-13,39
St Mirren,2280,10,8,9,19,40,59,-19,33
Hibernian,2281,1,19,11,6,53,26,27,68
Morton,2281,2,18,10,8,48,34,14,64
Falkirk,2281,3,17,10,9,61,40,21,61
Dundee Utd,2281,4,15,9,12,52,43,9,54
Raith,2281,5,13,9,14,43,47,-4,48
Queen of S't,2281,6,13,8,15,46,55,-9,47
Dunfermline,2281,7,10,12,14,47,49,-2,42
Dumbarton,2281,8,10,10,16,49,61,-12,40
St Mirren,2281,9,8,9,19,44,61,-17,33
Ayr,2281,10,7,12,17,34,61,-27,33
Hibernian,2282,1,18,11,7,50,25,25,65
Morton,2282,2,18,11,7,52,35,17,65
Dundee Utd,2282,3,16,10,10,52,39,13,58
Falkirk,2282,4,14,10,12,53,48,5,52
Queen of S't,2282,5,14,9,13,47,46,1,51
Raith,2282,6,13,8,15,39,46,-7,47
Dunfermline,2282,7,9,14,13,49,51,-2,41
Dumbarton,2282,8,9,11,16,51,64,-13,38
St Mirren,2282,9,9,11,16,44,57,-13,38
Ayr,2282,10,7,11,18,34,60,-26,32
Hibernian,2283,1,21,11,4,65,26,39,74
Morton,2283,2,19,11,6,51,32,19,68
Falkirk,2283,3,16,11,9,58,43,15,59
Dundee Utd,2283,4,15,12,9,48,36,12,57
Queen of S't,2283,5,11,9,16,47,58,-11,42
Dunfermline,2283,6,8,15,13,47,52,-5,39
Dumbarton,2283,7,9,12,15,46,57,-11,39
Raith,2283,8,9,10,17,32,50,-18,37
Ayr,2283,9,8,12,16,36,55,-19,36
St Mirren,2283,10,7,11,18,36,57,-21,32
Hibernian,2284,1,20,11,5,56,25,31,71
Falkirk,2284,2,19,9,8,58,38,20,66
Morton,2284,3,17,11,8,54,40,14,62
Dundee Utd,2284,4,17,9,10,55,36,19,60
Queen of S't,2284,5,12,9,15,45,50,-5,45
Raith,2284,6,11,8,17,36,48,-12,41
Dunfermline,2284,7,9,13,14,45,48,-3,40
St Mirren,2284,8,9,10,17,36,52,-16,37
Ayr,2284,9,8,10,18,38,63,-25,34
Dumbarton,2284,10,7,12,17,43,66,-23,33
Hibernian,2285,1,19,12,5,59,25,34,69
Morton,2285,2,17,13,6,49,31,18,64
Falkirk,2285,3,18,9,9,62,40,22,63
Dundee Utd,2285,4,16,8,12,51,46,5,56
Dunfermline,2285,5,11,13,12,47,44,3,46
Queen of S't,2285,6,12,8,16,46,52,-6,44
Dumbarton,2285,7,10,10,16,45,56,-11,40
Ayr,2285,8,10,10,16,38,56,-18,40
Raith,2285,9,9,9,18,31,56,-25,36
St Mirren,2285,10,7,10,19,37,59,-22,31
Hibernian,2286,1,19,11,6,54,29,25,68
Morton,2286,2,18,11,7,57,38,19,65
Falkirk,2286,3,16,11,9,59,42,17,59
Dundee Utd,2286,4,16,8,12,52,39,13,56
Queen of S't,2286,5,14,9,13,48,49,-1,51
Dumbarton,2286,6,11,10,15,49,56,-7,43
Raith,2286,7,11,10,15,38,49,-11,43
Dunfermline,2286,8,8,13,15,45,57,-12,37
Ayr,2286,9,8,12,16,34,56,-22,36
St Mirren,2286,10,6,11,19,36,57,-21,29
Hibernian,2287,1,20,13,3,56,24,32,73
Dundee Utd,2287,2,16,11,9,51,39,12,59
Falkirk,2287,3,15,11,10,57,42,15,56
Morton,2287,4,14,13,9,44,38,6,55
Dunfermline,2287,5,9,16,11,42,44,-2,43
Dumbarton,2287,6,9,13,14,56,60,-4,40
Queen of S't,2287,7,10,10,16,42,51,-9,40
St Mirren,2287,8,10,9,17,42,57,-15,39
Raith,2287,9,9,11,16,31,44,-13,38
Ayr,2287,10,9,11,16,32,54,-22,38
Morton,2288,1,19,10,7,55,31,24,67
Falkirk,2288,2,18,11,7,64,37,27,65
Hibernian,2288,3,17,13,6,51,27,24,64
Dundee Utd,2288,4,17,8,11,54,42,12,59
Queen of S't,2288,5,11,10,15,45,52,-7,43
Dunfermline,2288,6,9,13,14,48,54,-6,40
Ayr,2288,7,10,10,16,35,62,-27,40
Dumbarton,2288,8,9,12,15,44,54,-10,39
Raith,2288,9,9,9,18,33,53,-20,36
St Mirren,2288,10,8,10,18,42,59,-17,34
Hibernian,2289,1,21,12,3,60,25,35,75
Dundee Utd,2289,2,18,9,9,52,39,13,63
Falkirk,2289,3,17,9,10,59,44,15,60
Morton,2289,4,15,13,8,47,36,11,58
Queen of S't,2289,5,11,10,15,45,47,-2,43
Dunfermline,2289,6,10,13,13,42,44,-2,43
St Mirren,2289,7,10,9,17,44,59,-15,39
Dumbarton,2289,8,9,11,16,55,65,-10,38
Raith,2289,9,9,10,17,34,49,-15,37
Ayr,2289,10,6,12,18,31,61,-30,30
Hibernian,2290,1,19,13,4,62,29,33,70
Dundee Utd,2290,2,18,9,9,57,40,17,63
Falkirk,2290,3,17,11,8,56,36,20,62
Morton,2290,4,16,10,10,54,41,13,58
Queen of S't,2290,5,13,10,13,51,51,0,49
Dunfermline,2290,6,9,13,14,45,55,-10,40
Dumbarton,2290,7,9,10,17,47,60,-13,37
St Mirren,2290,8,9,10,17,41,59,-18,37
Ayr,2290,9,7,14,15,36,56,-20,35
Raith,2290,10,8,10,18,35,57,-22,34
Hibernian,2291,1,18,12,6,52,29,23,66
Falkirk,2291,2,15,12,9,53,38,15,57
Morton,2291,3,15,12,9,49,40,9,57
Dundee Utd,2291,4,14,11,11,49,42,7,53
Dunfermline,2291,5,11,13,12,49,48,1,46
Queen of S't,2291,6,12,10,14,50,50,0,46
Dumbarton,2291,7,11,12,13,51,55,-4,45
Raith,2291,8,12,9,15,43,51,-8,45
St Mirren,2291,9,8,12,16,41,57,-16,36
Ayr,2291,10,7,11,18,32,59,-27,32
Hibernian,2292,1,20,12,4,55,25,30,72
Dundee Utd,2292,2,17,10,9,52,38,14,61
Morton,2292,3,16,11,9,46,36,10,59
Falkirk,2292,4,15,9,12,53,41,12,54
Dunfermline,2292,5,11,13,12,49,46,3,46
St Mirren,2292,6,10,11,15,44,52,-8,41
Dumbarton,2292,7,9,12,15,47,58,-11,39
Raith,2292,8,9,12,15,36,48,-12,39
Queen of S't,2292,9,10,9,17,38,51,-13,39
Ayr,2292,10,6,15,15,33,58,-25,33
Hibernian,2293,1,20,12,4,58,27,31,72
Morton,2293,2,18,11,7,54,37,17,65
Falkirk,2293,3,17,9,10,60,43,17,60
Dundee Utd,2293,4,13,10,13,44,46,-2,49
Dunfermline,2293,5,12,12,12,44,42,2,48
Dumbarton,2293,6,10,12,14,49,55,-6,42
Raith,2293,7,10,11,15,35,46,-11,41
Queen of S't,2293,8,10,10,16,41,50,-9,40
Ayr,2293,9,8,12,16,37,57,-20,36
St Mirren,2293,10,7,11,18,40,59,-19,32
Hibernian,2294,1,17,13,6,50,25,25,64
Morton,2294,2,17,12,7,51,35,16,63
Dundee Utd,2294,3,16,11,9,54,43,11,59
Falkirk,2294,4,16,9,11,57,46,11,57
Queen of S't,2294,5,13,10,13,46,45,1,49
Dumbarton,2294,6,11,11,14,52,54,-2,44
Raith,2294,7,10,12,14,35,45,-10,42
St Mirren,2294,8,9,10,17,39,58,-19,37
Dunfermline,2294,9,8,12,16,41,50,-9,36
Ayr,2294,10,8,10,18,32,56,-24,34
Hibernian,2295,1,22,10,4,56,23,33,76
Morton,2295,2,18,12,6,55,35,20,66
Dundee Utd,2295,3,16,10,10,52,44,8,58
Falkirk,2295,4,14,10,12,56,45,11,52
Queen of S't,2295,5,13,10,13,50,46,4,49
Dunfermline,2295,6,10,13,13,44,47,-3,43
Dumbarton,2295,7,9,13,14,45,55,-10,40
Raith,2295,8,10,9,17,39,52,-13,39
St Mirren,2295,9,7,11,18,39,58,-19,32
Ayr,2295,10,6,12,18,30,61,-31,30
Morton,2296,1,19,10,7,53,35,18,67
Hibernian,2296,2,17,14,5,53,28,25,65
Falkirk,2296,3,17,10,9,55,39,16,61
Dundee Utd,2296,4,15,11,10,47,35,12,56
Queen of S't,2296,5,13,10,13,47,46,1,49
Dunfermline,2296,6,11,12,13,46,45,1,45
Ayr,2296,7,9,12,15,38,58,-20,39
Dumbarton,2296,8,9,11,16,49,61,-12,38
Raith,2296,9,9,9,18,33,54,-21,36
St Mirren,2296,10,7,9,20,38,58,-20,30
Hibernian,2297,1,19,12,5,60,25,35,69
Falkirk,2297,2,14,12,10,53,43,10,54
Dundee Utd,2297,3,14,11,11,49,41,8,53
Morton,2297,4,13,14,9,45,38,7,53
Dumbarton,2297,5,10,13,13,51,57,-6,43
Raith,2297,6,11,10,15,39,48,-9,43
Ayr,2297,7,10,13,13,41,55,-14,43
Dunfermline,2297,8,9,14,13,44,53,-9,41
Queen of S't,2297,9,10,11,15,42,51,-9,41
St Mirren,2297,10,10,10,16,40,53,-13,40
Morton,2298,1,17,13,6,55,37,18,64
Hibernian,2298,2,17,12,7,51,32,19,63
Dundee Utd,2298,3,17,9,10,52,42,10,60
Falkirk,2298,4,16,11,9,60,41,19,59
Queen of S't,2298,5,13,8,15,46,50,-4,47
Raith,2298,6,12,8,16,45,55,-10,44
Dunfermline,2298,7,10,13,13,49,49,0,43
Ayr,2298,8,8,12,16,36,57,-21,36
Dumbarton,2298,9,8,11,17,49,63,-14,35
St Mirren,2298,10,8,11,17,43,60,-17,35
Hibernian,2299,1,20,12,4,57,24,33,72
Morton,2299,2,18,10,8,50,35,15,64
Falkirk,2299,3,15,10,11,56,41,15,55
Dundee Utd,2299,4,15,10,11,47,44,3,55
Dunfermline,2299,5,12,11,13,51,49,2,47
Dumbarton,2299,6,11,10,15,52,58,-6,43
Queen of S't,2299,7,11,8,17,46,55,-9,41
Ayr,2299,8,10,11,15,40,53,-13,41
Raith,2299,9,10,9,17,32,50,-18,39
St Mirren,2299,10,7,11,18,35,57,-22,32
Hibernian,2300,1,19,13,4,54,23,31,70
Dundee Utd,2300,2,16,10,10,53,43,10,58
Morton,2300,3,14,14,8,44,35,9,56
Falkirk,2300,4,15,9,12,57,45,12,54
Dunfermline,2300,5,10,14,12,52,52,0,44
Queen of S't,2300,6,12,8,16,45,51,-6,44
Ayr,2300,7,10,14,12,37,51,-14,44
Raith,2300,8,11,9,16,39,51,-12,42
Dumbarton,2300,9,9,12,15,46,56,-10,39
St Mirren,2300,10,7,11,18,42,62,-20,32
Hibernian,2301,1,19,12,5,54,24,30,69
Falkirk,2301,2,17,11,8,62,40,22,62
Morton,2301,3,16,10,10,48,37,11,58
Dundee Utd,2301,4,16,10,10,48,41,7,58
Queen of S't,2301,5,11,10,15,46,54,-8,43
Raith,2301,6,11,10,15,36,47,-11,43
Dunfermline,2301,7,9,12,15,44,52,-8,39
Dumbarton,2301,8,9,12,15,51,61,-10,39
Ayr,2301,9,9,12,15,35,50,-15,39
St Mirren,2301,10,8,11,17,40,58,-18,35
Hibernian,2302,1,20,12,4,54,23,31,72
Morton,2302,2,18,10,8,52,38,14,64
Falkirk,2302,3,16,11,9,58,40,18,59
Dundee Utd,2302,4,15,9,12,44,42,2,54
Queen of S't,2302,5,11,10,15,46,50,-4,43
Dunfermline,2302,6,9,13,14,48,49,-1,40
Raith,2302,7,10,10,16,32,49,-17,40
Ayr,2302,8,9,12,15,31,50,-19,39
St Mirren,2302,9,8,13,15,44,53,-9,37
Dumbarton,2302,10,8,12,16,48,63,-15,36
Hibernian,2303,1,20,11,5,59,27,32,71
Falkirk,2303,2,18,10,8,59,41,18,64
Morton,2303,3,16,12,8,48,38,10,60
Dundee Utd,2303,4,16,10,10,57,40,17,58
Queen of S't,2303,5,11,12,13,46,50,-4,45
Dunfermline,2303,6,10,13,13,47,51,-4,43
Raith,2303,7,10,10,16,37,49,-12,40
St Mirren,2303,8,8,12,16,39,55,-16,36
Dumbarton,2303,9,7,12,17,43,58,-15,33
Ayr,2303,10,7,12,17,33,59,-26,33
Hibernian,2304,1,18,13,5,57,26,31,67
Dundee Utd,2304,2,18,10,8,59,37,22,64
Morton,2304,3,16,11,9,53,42,11,59
Falkirk,2304,4,16,9,11,62,50,12,57
Queen of S't,2304,5,12,10,14,46,47,-1,46
Dunfermline,2304,6,10,13,13,45,49,-4,43
St Mirren,2304,7,9,11,16,43,56,-13,38
Raith,2304,8,10,8,18,39,60,-21,38
Dumbarton,2304,9,8,13,15,47,57,-10,37
Ayr,2304,10,8,12,16,33,60,-27,36
Hibernian,2305,1,18,13,5,55,25,30,67
Dundee Utd,2305,2,17,9,10,61,42,19,60
Falkirk,2305,3,16,10,10,59,41,18,58
Morton,2305,4,15,12,9,48,37,11,57
St Mirren,2305,5,12,9,15,45,54,-9,45
Raith,2305,6,12,9,15,35,46,-11,45
Queen of S't,2305,7,11,10,15,44,50,-6,43
Dunfermline,2305,8,9,12,15,42,54,-12,39
Dumbarton,2305,9,8,12,16,47,65,-18,36
Ayr,2305,10,8,12,16,34,56,-22,36
Morton,2306,1,18,12,6,51,30,21,66
Hibernian,2306,2,17,14,5,54,27,27,65
Dundee Utd,2306,3,17,9,10,49,37,12,60
Falkirk,2306,4,15,12,9,59,44,15,57
Dumbarton,2306,5,10,13,13,52,55,-3,43
Dunfermline,2306,6,9,14,13,41,48,-7,41
Queen of S't,2306,7,11,8,17,41,51,-10,41
Raith,2306,8,10,9,17,32,50,-18,39
St Mirren,2306,9,8,12,16,42,58,-16,36
Ayr,2306,10,7,13,16,31,52,-21,34
Hibernian,2307,1,20,12,4,55,25,30,72
Morton,2307,2,17,13,6,50,34,16,64
Dundee Utd,2307,3,16,10,10,49,40,9,58
Falkirk,2307,4,16,9,11,56,40,16,57
St Mirren,2307,5,11,10,15,46,51,-5,43
Raith,2307,6,11,10,15,35,45,-10,43
Dunfermline,2307,7,9,14,13,44,48,-4,41
Dumbarton,2307,8,10,10,16,48,59,-11,40
Queen of S't,2307,9,9,8,19,39,56,-17,35
Ayr,2307,10,7,12,17,31,55,-24,33
Hibernian,2308,1,18,13,5,60,30,30,67
Morton,2308,2,18,11,7,55,36,19,65
Falkirk,2308,3,17,12,7,61,37,24,63
Dundee Utd,2308,4,16,10,10,47,36,11,58
Queen of S't,2308,5,12,10,14,41,49,-8,46
Dumbarton,2308,6,10,11,15,47,56,-9,41
Raith,2308,7,10,9,17,42,50,-8,39
Dunfermline,2308,8,9,11,16,42,54,-12,38
Ayr,2308,9,9,11,16,33,58,-25,38
St Mirren,2308,10,7,10,19,39,61,-22,31
Hibernian,2309,1,18,13,5,56,26,30,67
Morton,2309,2,16,12,8,49,36,13,60
Dundee Utd,2309,3,17,9,10,48,37,11,60
Falkirk,2309,4,13,11,12,58,51,7,50
Dunfermline,2309,5,10,15,11,44,44,0,45
Queen of S't,2309,6,11,10,15,44,50,-6,43
Dumbarton,2309,7,10,11,15,50,55,-5,41
Raith,2309,8,10,11,15,40,52,-12,41
St Mirren,2309,9,9,11,16,40,55,-15,38
Ayr,2309,10,9,11,16,31,54,-23,38
Hibernian,2310,1,22,10,4,62,21,41,76
Morton,2310,2,18,10,8,52,33,19,64
Falkirk,2310,3,15,12,9,55,39,16,57
Dundee Utd,2310,4,15,11,10,52,41,11,56
Queen of S't,2310,5,12,9,15,45,53,-8,45
Ayr,2310,6,10,12,14,38,55,-17,42
Dunfermline,2310,7,8,14,14,43,53,-10,38
Raith,2310,8,9,11,16,34,51,-17,38
St Mirren,2310,9,9,10,17,41,57,-16,37
Dumbarton,2310,10,7,11,18,45,64,-19,32
Hibernian,2311,1,18,14,4,55,26,29,68
Morton,2311,2,17,12,7,46,35,11,63
Falkirk,2311,3,15,11,10,57,42,15,56
Dundee Utd,2311,4,15,9,12,50,44,6,54
Queen of S't,2311,5,12,11,13,48,50,-2,47
Dumbarton,2311,6,9,13,14,43,53,-10,40
Raith,2311,7,10,10,16,38,48,-10,40
Ayr,2311,8,9,13,14,37,53,-16,40
Dunfermline,2311,9,8,14,14,43,48,-5,38
St Mirren,2311,10,7,13,16,39,57,-18,34
Hibernian,2312,1,18,12,6,50,24,26,66
Morton,2312,2,17,10,9,49,35,14,61
Falkirk,2312,3,16,11,9,61,42,19,59
Dundee Utd,2312,4,16,8,12,53,41,12,56
Queen of S't,2312,5,12,10,14,49,51,-2,46
Dunfermline,2312,6,10,14,12,46,48,-2,44
Raith,2312,7,10,11,15,33,49,-16,41
Dumbarton,2312,8,9,13,14,52,59,-7,40
St Mirren,2312,9,8,12,16,36,52,-16,36
Ayr,2312,10,8,11,17,33,61,-28,35
Hibernian,2313,1,18,12,6,57,31,26,66
Morton,2313,2,18,10,8,55,39,16,64
Falkirk,2313,3,17,10,9,58,42,16,61
Dundee Utd,2313,4,15,9,12,49,42,7,54
Dunfermline,2313,5,10,14,12,47,50,-3,44
Raith,2313,6,11,10,15,41,49,-8,43
Queen of S't,2313,7,11,9,16,45,53,-8,42
St Mirren,2313,8,9,12,15,41,52,-11,39
Dumbarton,2313,9,9,11,16,48,58,-10,38
Ayr,2313,10,7,13,16,30,55,-25,34
Hibernian,2314,1,20,13,3,56,22,34,73
Falkirk,2314,2,17,10,9,57,41,16,61
Morton,2314,3,16,12,8,50,37,13,60
Dundee Utd,2314,4,15,12,9,52,40,12,57
Dunfermline,2314,5,10,13,13,46,50,-4,43
Queen of S't,2314,6,11,9,16,48,56,-8,42
St Mirren,2314,7,10,11,15,44,54,-10,41
Dumbarton,2314,8,9,11,16,51,60,-9,38
Ayr,2314,9,7,14,15,41,64,-23,35
Raith,2314,10,8,9,19,38,59,-21,33
Hibernian,2315,1,18,14,4,58,29,29,68
Dundee Utd,2315,2,18,10,8,52,36,16,64
Morton,2315,3,16,13,7,50,36,14,61
Falkirk,2315,4,16,9,11,61,45,16,57
Dunfermline,2315,5,10,13,13,47,50,-3,43
Raith,2315,6,10,12,14,35,47,-12,42
Dumbarton,2315,7,10,11,15,46,54,-8,41
Queen of S't,2315,8,9,9,18,41,56,-15,36
St Mirren,2315,9,8,12,16,37,54,-17,36
Ayr,2315,10,8,11,17,35,55,-20,35
Hibernian,2316,1,19,12,5,58,24,34,69
Falkirk,2316,2,19,10,7,66,39,27,67
Morton,2316,3,15,11,10,51,45,6,56
Dundee Utd,2316,4,15,10,11,50,40,10,55
Dunfermline,2316,5,10,13,13,44,48,-4,43
Queen of S't,2316,6,10,11,15,42,52,-10,41
Raith,2316,7,10,11,15,34,51,-17,41
Ayr,2316,8,8,14,14,34,51,-17,38
Dumbarton,2316,9,8,12,16,45,59,-14,36
St Mirren,2316,10,7,14,15,39,54,-15,35
Hibernian,2317,1,22,10,4,64,24,40,76
Morton,2317,2,18,9,9,48,35,13,63
Falkirk,2317,3,16,11,9,60,42,18,59
Dundee Utd,2317,4,16,9,11,50,43,7,57
Dunfermline,2317,5,11,12,13,47,49,-2,45
Queen of S't,2317,6,12,9,15,45,50,-5,45
Raith,2317,7,10,10,16,34,46,-12,40
Ayr,2317,8,9,11,16,31,51,-20,38
Dumbarton,2317,9,7,12,17,43,63,-20,33
St Mirren,2317,10,7,11,18,35,54,-19,32
Hibernian,2318,1,19,12,5,60,28,32,69
Morton,2318,2,19,10,7,53,37,16,67
Falkirk,2318,3,15,14,7,64,40,24,59
Dundee Utd,2318,4,14,11,11,46,44,2,53
Queen of S't,2318,5,13,8,15,52,50,2,47
Dumbarton,2318,6,10,11,15,52,58,-6,41
Dunfermline,2318,7,9,14,13,49,56,-7,41
Raith,2318,8,9,10,17,32,53,-21,37
St Mirren,2318,9,8,11,17,41,58,-17,35
Ayr,2318,10,8,11,17,31,56,-25,35
Hibernian,2319,1,19,13,4,56,28,28,70
Morton,2319,2,17,12,7,49,32,17,63
Dundee Utd,2319,3,18,8,10,49,37,12,62
Falkirk,2319,4,13,11,12,54,44,10,50
Raith,2319,5,11,10,15,36,49,-13,43
Dunfermline,2319,6,9,15,12,46,48,-2,42
Ayr,2319,7,10,11,15,36,49,-13,41
Queen of S't,2319,8,10,10,16,42,53,-11,40
Dumbarton,2319,9,9,12,15,43,57,-14,39
St Mirren,2319,10,8,10,18,41,55,-14,34
Hibernian,2320,1,18,14,4,55,27,28,68
Falkirk,2320,2,16,11,9,52,38,14,59
Morton,2320,3,15,11,10,56,45,11,56
Dundee Utd,2320,4,15,9,12,52,44,8,54
Ayr,2320,5,12,11,13,41,50,-9,47
Dunfermline,2320,6,10,15,11,48,46,2,45
Queen of S't,2320,7,11,9,16,41,55,-14,42
Raith,2320,8,10,9,17,37,51,-14,39
Dumbarton,2320,9,8,13,15,47,56,-9,37
St Mirren,2320,10,8,12,16,41,58,-17,36
Hibernian,2321,1,18,13,5,53,25,28,67
Morton,2321,2,16,12,8,47,37,10,60
Falkirk,2321,3,16,10,10,54,39,15,58
Dundee Utd,2321,4,15,12,9,55,43,12,57
Dunfermline,2321,5,11,13,12,45,45,0,46
Ayr,2321,6,10,12,14,42,54,-12,42
Dumbarton,2321,7,10,11,15,49,58,-9,41
Raith,2321,8,10,10,16,33,47,-14,40
Queen of S't,2321,9,9,11,16,42,51,-9,38
St Mirren,2321,10,7,12,17,38,59,-21,33
Hibernian,2322,1,20,11,5,61,26,35,71
Dundee Utd,2322,2,19,9,8,55,33,22,66
Falkirk,2322,3,16,10,10,56,40,16,58
Morton,2322,4,16,10,10,51,42,9,58
Dunfermline,2322,5,10,12,14,42,47,-5,42
Queen of S't,2322,6,11,8,17,46,52,-6,41
Raith,2322,7,11,8,17,35,49,-14,41
Ayr,2322,8,10,11,15,36,55,-19,41
Dumbarton,2322,9,10,10,16,49,64,-15,40
St Mirren,2322,10,7,11,18,39,62,-23,32
Hibernian,2323,1,20,12,4,57,23,34,72
Dundee Utd,2323,2,18,10,8,54,36,18,64
Morton,2323,3,17,11,8,53,38,15,62
Falkirk,2323,4,13,14,9,53,39,14,53
Queen of S't,2323,5,11,12,13,44,50,-6,45
Dumbarton,2323,6,10,11,15,46,55,-9,41
Dunfermline,2323,7,8,14,14,43,50,-7,38
Raith,2323,8,8,13,15,36,54,-18,37
St Mirren,2323,9,8,12,16,42,56,-14,36
Ayr,2323,10,7,11,18,33,60,-27,32
Hibernian,2324,1,20,10,6,57,27,30,70
Falkirk,2324,2,17,9,10,62,46,16,60
Dundee Utd,2324,3,16,9,11,48,39,9,57
Morton,2324,4,16,9,11,42,35,7,57
Dumbarton,2324,5,11,13,12,52,51,1,46
Dunfermline,2324,6,11,13,12,48,47,1,46
Queen of S't,2324,7,12,9,15,48,51,-3,45
Ayr,2324,8,9,11,16,31,50,-19,38
Raith,2324,9,9,9,18,34,52,-18,36
St Mirren,2324,10,8,10,18,38,62,-24,34
Hibernian,2325,1,19,13,4,57,28,29,70
Falkirk,2325,2,19,10,7,58,35,23,67
Morton,2325,3,17,12,7,51,34,17,63
Dundee Utd,2325,4,15,10,11,48,42,6,55
Queen of S't,2325,5,12,9,15,48,49,-1,45
Dunfermline,2325,6,10,12,14,45,51,-6,42
Raith,2325,7,10,10,16,36,48,-12,40
Dumbarton,2325,8,9,11,16,44,57,-13,38
Ayr,2325,9,8,12,16,33,56,-23,36
St Mirren,2325,10,6,11,19,31,51,-20,29
Hibernian,2326,1,20,13,3,55,20,35,73
Dundee Utd,2326,2,17,9,10,55,39,16,60
Morton,2326,3,16,12,8,49,41,8,60
Falkirk,2326,4,14,11,11,58,45,13,53
Queen of S't,2326,5,13,8,15,43,50,-7,47
Dunfermline,2326,6,10,14,12,49,42,7,44
Dumbarton,2326,7,9,13,14,48,57,-9,40
Raith,2326,8,10,9,17,33,56,-23,39
St Mirren,2326,9,9,11,16,41,54,-13,38
Ayr,2326,10,7,10,19,28,55,-27,31
Morton,2327,1,18,12,6,53,34,19,66
Hibernian,2327,2,17,13,6,55,30,25,64
Falkirk,2327,3,15,11,10,57,43,14,56
Dundee Utd,2327,4,15,11,10,49,40,9,56
Queen of S't,2327,5,12,10,14,45,45,0,46
Dunfermline,2327,6,9,15,12,45,48,-3,42
Raith,2327,7,10,10,16,37,52,-15,40
Ayr,2327,8,9,12,15,33,54,-21,39
Dumbarton,2327,9,8,12,16,46,57,-11,36
St Mirren,2327,10,8,12,16,41,58,-17,36
Dundee Utd,2328,1,19,8,9,57,38,19,65
Morton,2328,2,18,11,7,54,37,17,65
Hibernian,2328,3,17,13,6,51,26,25,64
Falkirk,2328,4,16,10,10,57,45,12,58
Queen of S't,2328,5,12,10,14,46,48,-2,46
Dumbarton,2328,6,10,12,14,49,58,-9,42
Dunfermline,2328,7,9,12,15,44,50,-6,39
Raith,2328,8,9,10,17,31,49,-18,37
Ayr,2328,9,8,12,16,37,56,-19,36
St Mirren,2328,10,8,10,18,40,59,-19,34
Hibernian,2329,1,20,13,3,63,22,41,73
Falkirk,2329,2,17,10,9,65,40,25,61
Morton,2329,3,16,11,9,50,42,8,59
Dundee Utd,2329,4,14,13,9,51,41,10,55
Dunfermline,2329,5,11,13,12,47,47,0,46
Dumbarton,2329,6,10,12,14,48,55,-7,42
Queen of S't,2329,7,10,10,16,47,56,-9,40
Raith,2329,8,10,8,18,39,58,-19,38
Ayr,2329,9,8,12,16,32,55,-23,36
St Mirren,2329,10,8,10,18,37,63,-26,34
Hibernian,2330,1,20,11,5,62,25,37,71
Morton,2330,2,18,10,8,49,36,13,64
Dundee Utd,2330,3,17,10,9,56,36,20,61
Falkirk,2330,4,15,11,10,59,46,13,56
Queen of S't,2330,5,13,8,15,46,49,-3,47
Dunfermline,2330,6,9,15,12,44,49,-5,42
Raith,2330,7,9,11,16,33,50,-17,38
Dumbarton,2330,8,8,12,16,49,64,-15,36
St Mirren,2330,9,8,11,17,41,58,-17,35
Ayr,2330,10,7,13,16,35,61,-26,34
Dundee Utd,2331,1,18,10,8,57,35,22,64
Morton,2331,2,17,11,8,48,38,10,62
Falkirk,2331,3,17,10,9,59,41,18,61
Hibernian,2331,4,16,12,8,51,29,22,60
Dunfermline,2331,5,12,11,13,52,48,4,47
Queen of S't,2331,6,11,10,15,41,51,-10,43
Ayr,2331,7,9,14,13,37,53,-16,41
Dumbarton,2331,8,9,12,15,44,56,-12,39
Raith,2331,9,9,9,18,32,52,-20,36
St Mirren,2331,10,8,9,19,39,57,-18,33
Hibernian,2332,1,19,13,4,55,23,32,70
Morton,2332,2,19,10,7,52,35,17,67
Falkirk,2332,3,15,11,10,59,42,17,56
Dundee Utd,2332,4,15,11,10,49,36,13,56
Queen of S't,2332,5,12,10,14,47,50,-3,46
Dunfermline,2332,6,10,12,14,45,47,-2,42
Raith,2332,7,11,9,16,35,51,-16,42
Ayr,2332,8,9,11,16,32,56,-24,38
Dumbarton,2332,9,8,12,16,48,63,-15,36
St Mirren,2332,10,8,9,19,38,57,-19,33
Hibernian,2333,1,20,13,3,59,24,35,73
Dundee Utd,2333,2,17,11,8,57,39,18,62
Morton,2333,3,16,13,7,50,37,13,61
Falkirk,2333,4,15,9,12,57,49,8,54
Dunfermline,2333,5,12,11,13,51,51,0,47
Queen of S't,2333,6,11,9,16,44,55,-11,42
St Mirren,2333,7,10,11,15,49,56,-7,41
Raith,2333,8,9,10,17,39,53,-14,37
Ayr,2333,9,8,11,17,37,61,-24,35
Dumbarton,2333,10,8,10,18,47,65,-18,34
Hibernian,2334,1,17,13,6,49,27,22,64
Falkirk,2334,2,17,11,8,59,37,22,62
Morton,2334,3,16,12,8,49,36,13,60
Dundee Utd,2334,4,15,11,10,47,39,8,56
Queen of S't,2334,5,12,11,13,45,46,-1,47
Raith,2334,6,10,12,14,36,46,-10,42
Dunfermline,2334,7,9,14,13,49,52,-3,41
Ayr,2334,8,8,14,14,37,55,-18,38
Dumbarton,2334,9,8,11,17,47,62,-15,35
St Mirren,2334,10,8,11,17,44,62,-18,35
Hibernian,2335,1,19,12,5,55,25,30,69
Morton,2335,2,19,12,5,57,35,22,69
Falkirk,2335,3,18,11,7,63,36,27,65
Dundee Utd,2335,4,17,9,10,57,39,18,60
Queen of S't,2335,5,13,10,13,44,46,-2,49
Dunfermline,2335,6,8,14,14,45,57,-12,38
Dumbarton,2335,7,9,11,16,46,59,-13,38
Raith,2335,8,9,8,19,32,54,-22,35
St Mirren,2335,9,8,9,19,37,54,-17,33
Ayr,2335,10,7,10,19,29,60,-31,31
Hibernian,2336,1,19,12,5,58,26,32,69
Dundee Utd,2336,2,16,11,9,54,40,14,59
Morton,2336,3,16,11,9,50,39,11,59
Falkirk,2336,4,15,12,9,55,40,15,57
Queen of S't,2336,5,11,10,15,45,55,-10,43
Dumbarton,2336,6,10,11,15,47,58,-11,41
Dunfermline,2336,7,9,13,14,43,51,-8,40
Raith,2336,8,10,10,16,35,47,-12,40
St Mirren,2336,9,9,11,16,45,56,-11,38
Ayr,2336,10,7,15,14,33,53,-20,36
Hibernian,2337,1,18,12,6,57,28,29,66
Morton,2337,2,16,14,6,49,34,15,62
Dundee Utd,2337,3,17,9,10,47,37,10,60
Falkirk,2337,4,15,12,9,53,38,15,57
Raith,2337,5,14,8,14,36,42,-6,50
Dunfermline,2337,6,8,15,13,43,50,-7,39
Queen of S't,2337,7,10,9,17,47,56,-9,39
Dumbarton,2337,8,8,13,15,48,60,-12,37
St Mirren,2337,9,9,10,17,40,54,-14,37
Ayr,2337,10,8,12,16,35,56,-21,36
Hibernian,2338,1,19,13,4,53,24,29,70
Morton,2338,2,17,11,8,56,38,18,62
Falkirk,2338,3,16,10,10,57,45,12,58
Dundee Utd,2338,4,15,9,12,50,42,8,54
Queen of S't,2338,5,11,10,15,49,56,-7,43
Dumbarton,2338,6,10,12,14,53,58,-5,42
Ayr,2338,7,10,12,14,35,50,-15,42
Dunfermline,2338,8,9,13,14,45,51,-6,40
Raith,2338,9,9,11,16,34,50,-16,38
St Mirren,2338,10,8,11,17,40,58,-18,35
Hibernian,2339,1,19,13,4,55,26,29,70
Morton,2339,2,18,10,8,52,36,16,64
Falkirk,2339,3,17,11,8,61,41,20,62
Dundee Utd,2339,4,15,10,11,52,44,8,55
Queen of S't,2339,5,12,10,14,47,49,-2,46
Dunfermline,2339,6,8,15,13,43,49,-6,39
Dumbarton,2339,7,9,12,15,49,59,-10,39
St Mirren,2339,8,8,13,15,40,52,-12,37
Raith,2339,9,9,10,17,34,50,-16,37
Ayr,2339,10,7,12,17,31,58,-27,33
Hibernian,2340,1,18,12,6,60,37,23,66
Morton,2340,2,17,11,8,54,39,15,62
Falkirk,2340,3,16,12,8,57,39,18,60
Dundee Utd,2340,4,14,11,11,50,46,4,53
Dunfermline,2340,5,11,15,10,51,43,8,48
Queen of S't,2340,6,12,9,15,47,51,-4,45
Dumbarton,2340,7,9,13,14,51,59,-8,40
St Mirren,2340,8,10,10,16,44,57,-13,40
Ayr,2340,9,9,11,16,38,55,-17,38
Raith,2340,10,8,8,20,31,57,-26,32
Hibernian,2341,1,19,12,5,53,23,30,69
Morton,2341,2,16,13,7,52,35,17,61
Dundee Utd,2341,3,16,10,10,51,41,10,58
Falkirk,2341,4,15,12,9,60,43,17,57
Raith,2341,5,11,11,14,41,50,-9,44
Dumbarton,2341,6,10,11,15,48,53,-5,41
Dunfermline,2341,7,9,14,13,44,49,-5,41
Queen of S't,2341,8,10,9,17,40,55,-15,39
St Mirren,2341,9,9,10,17,41,58,-17,37
Ayr,2341,10,8,12,16,31,54,-23,36
Hibernian,2342,1,19,14,3,58,26,32,71
Morton,2342,2,17,12,7,48,35,13,63
Dundee Utd,2342,3,16,11,9,51,40,11,59
Falkirk,2342,4,15,12,9,57,39,18,57
Queen of S't,2342,5,11,10,15,47,53,-6,43
Dunfermline,2342,6,9,14,13,47,49,-2,41
Dumbarton,2342,7,10,11,15,51,60,-9,41
St Mirren,2342,8,9,9,18,43,56,-13,36
Raith,2342,9,8,11,17,34,52,-18,35
Ayr,2342,10,7,14,15,36,62,-26,35
Morton,2343,1,19,11,6,52,33,19,68
Hibernian,2343,2,17,13,6,56,31,25,64
Dundee Utd,2343,3,15,12,9,52,42,10,57
Falkirk,2343,4,15,9,12,57,45,12,54
Queen of S't,2343,5,12,9,15,48,53,-5,45
Raith,2343,6,12,9,15,37,46,-9,45
Dunfermline,2343,7,9,13,14,44,49,-5,40
Dumbarton,2343,8,9,13,14,51,59,-8,40
St Mirren,2343,9,9,11,16,42,55,-13,38
Ayr,2343,10,7,12,17,32,58,-26,33
Hibernian,2344,1,21,10,5,54,24,30,73
Morton,2344,2,19,10,7,51,33,18,67
Dundee Utd,2344,3,17,10,9,49,38,11,61
Falkirk,2344,4,16,10,10,58,40,18,58
Raith,2344,5,11,10,15,36,46,-10,43
Queen of S't,2344,6,11,9,16,42,52,-10,42
Dunfermline,2344,7,9,11,16,43,57,-14,38
St Mirren,2344,8,9,10,17,40,54,-14,37
Ayr,2344,9,9,10,17,35,52,-17,37
Dumbarton,2344,10,8,10,18,44,56,-12,34
Hibernian,2345,1,19,12,5,53,24,29,69
Falkirk,2345,2,16,10,10,58,39,19,58
Morton,2345,3,15,13,8,50,39,11,58
Dundee Utd,2345,4,16,10,10,47,38,9,58
Queen of S't,2345,5,14,9,13,49,47,2,51
Dunfermline,2345,6,11,12,13,49,52,-3,45
Ayr,2345,7,9,13,14,33,49,-16,40
Dumbarton,2345,8,9,10,17,48,62,-14,37
Raith,2345,9,8,11,17,40,57,-17,35
St Mirren,2345,10,7,12,17,39,59,-20,33
Hibernian,2346,1,20,12,4,58,23,35,72
Falkirk,2346,2,15,10,11,57,49,8,55
Dundee Utd,2346,3,15,8,13,51,44,7,53
Morton,2346,4,13,12,11,46,43,3,51
Dunfermline,2346,5,12,13,11,54,50,4,49
Raith,2346,6,12,11,13,42,46,-4,47
Ayr,2346,7,10,12,14,39,53,-14,42
Queen of S't,2346,8,10,11,15,45,51,-6,41
Dumbarton,2346,9,10,10,16,47,61,-14,40
St Mirren,2346,10,8,11,17,37,56,-19,35
Hibernian,2347,1,21,12,3,55,21,34,75
Falkirk,2347,2,16,11,9,55,37,18,59
Morton,2347,3,15,13,8,47,36,11,58
Dundee Utd,2347,4,16,10,10,51,41,10,58
Queen of S't,2347,5,11,8,17,48,55,-7,41
Raith,2347,6,10,11,15,36,49,-13,41
St Mirren,2347,7,10,10,16,45,54,-9,40
Dunfermline,2347,8,8,15,13,43,46,-3,39
Dumbarton,2347,9,8,12,16,44,63,-19,36
Ayr,2347,10,8,12,16,36,58,-22,36
Hibernian,2348,1,17,11,8,53,32,21,62
Falkirk,2348,2,17,9,10,58,40,18,60
Morton,2348,3,16,12,8,50,37,13,60
Dundee Utd,2348,4,16,10,10,51,43,8,58
Queen of S't,2348,5,12,10,14,45,47,-2,46
Dumbarton,2348,6,12,10,14,51,54,-3,46
St Mirren,2348,7,11,9,16,45,56,-11,42
Raith,2348,8,11,8,17,37,52,-15,41
Ayr,2348,9,9,11,16,35,54,-19,38
Dunfermline,2348,10,8,12,16,40,50,-10,36
Morton,2349,1,18,11,7,52,36,16,65
Hibernian,2349,2,16,13,7,48,27,21,61
Falkirk,2349,3,16,10,10,54,43,11,58
Dundee Utd,2349,4,15,10,11,51,43,8,55
Dunfermline,2349,5,11,13,12,53,47,6,46
Queen of S't,2349,6,12,9,15,49,52,-3,45
St Mirren,2349,7,11,11,14,46,53,-7,44
Raith,2349,8,10,10,16,36,49,-13,40
Ayr,2349,9,9,12,15,35,52,-17,39
Dumbarton,2349,10,7,11,18,44,66,-22,32
Hibernian,2350,1,19,13,4,58,24,34,70
Morton,2350,2,16,11,9,52,39,13,59
Falkirk,2350,3,16,10,10,60,44,16,58
Dundee Utd,2350,4,16,9,11,53,44,9,57
Dunfermline,2350,5,10,13,13,47,51,-4,43
Raith,2350,6,11,9,16,38,48,-10,42
Queen of S't,2350,7,11,9,16,43,57,-14,42
Dumbarton,2350,8,9,14,13,47,53,-6,41
St Mirren,2350,9,9,10,17,42,56,-14,37
Ayr,2350,10,8,12,16,33,57,-24,36
Hibernian,2351,1,23,10,3,68,27,41,79
Falkirk,2351,2,16,11,9,59,42,17,59
Dundee Utd,2351,3,16,10,10,52,42,10,58
Morton,2351,4,15,11,10,45,40,5,56
Dumbarton,2351,5,11,12,13,51,56,-5,45
Queen of S't,2351,6,12,8,16,44,52,-8,44
Dunfermline,2351,7,9,12,15,50,56,-6,39
Raith,2351,8,9,10,17,33,50,-17,37
St Mirren,2351,9,8,12,16,40,54,-14,36
Ayr,2351,10,7,12,17,30,53,-23,33
Hibernian,2352,1,20,10,6,59,27,32,70
Falkirk,2352,2,18,9,9,56,38,18,63
Morton,2352,3,15,12,9,49,40,9,57
Dundee Utd,2352,4,15,10,11,52,46,6,55
Dunfermline,2352,5,12,13,11,51,46,5,49
Queen of S't,2352,6,10,11,15,42,49,-7,41
Dumbarton,2352,7,9,13,14,49,54,-5,40
St Mirren,2352,8,9,10,17,37,52,-15,37
Ayr,2352,9,8,13,15,35,59,-24,37
Raith,2352,10,9,9,18,31,50,-19,36
Hibernian,2353,1,20,12,4,55,24,31,72
Morton,2353,2,16,11,9,53,41,12,59
Dundee Utd,2353,3,16,11,9,49,38,11,59
Falkirk,2353,4,15,11,10,57,43,14,56
Raith,2353,5,12,9,15,40,47,-7,45
Queen of S't,2353,6,11,10,15,42,54,-12,43
Dunfermline,2353,7,10,12,14,48,49,-1,42
Dumbarton,2353,8,9,12,15,45,55,-10,39
Ayr,2353,9,9,10,17,32,55,-23,37
St Mirren,2353,10,8,10,18,37,52,-15,34
Hibernian,2354,1,19,13,4,57,25,32,70
Morton,2354,2,17,12,7,49,33,16,63
Dundee Utd,2354,3,17,9,10,50,38,12,60
Falkirk,2354,4,15,10,11,54,42,12,55
Queen of S't,2354,5,11,11,14,46,53,-7,44
Dunfermline,2354,6,10,13,13,50,52,-2,43
Dumbarton,2354,7,10,12,14,52,57,-5,42
Raith,2354,8,10,11,15,37,50,-13,41
St Mirren,2354,9,7,13,16,37,54,-17,34
Ayr,2354,10,6,12,18,30,58,-28,30
Hibernian,2355,1,19,13,4,57,26,31,70
Dundee Utd,2355,2,17,9,10,53,41,12,60
Morton,2355,3,15,13,8,45,38,7,58
Falkirk,2355,4,15,9,12,56,45,11,54
Queen of S't,2355,5,12,9,15,48,51,-3,45
Dunfermline,2355,6,11,12,13,46,49,-3,45
Raith,2355,7,10,9,17,36,46,-10,39
Ayr,2355,8,9,12,15,37,57,-20,39
Dumbarton,2355,9,9,11,16,54,66,-12,38
St Mirren,2355,10,9,11,16,45,58,-13,38
Hibernian,2356,1,19,11,6,53,27,26,68
Morton,2356,2,19,9,8,54,37,17,66
Dundee Utd,2356,3,17,9,10,55,37,18,60
Falkirk,2356,4,16,9,11,60,43,17,57
Queen of S't,2356,5,14,8,14,44,47,-3,50
Dunfermline,2356,6,11,12,13,47,46,1,45
Raith,2356,7,11,10,15,40,49,-9,43
Ayr,2356,8,9,11,16,33,57,-24,38
Dumbarton,2356,9,8,10,18,44,61,-17,34
St Mirren,2356,10,7,9,20,37,63,-26,30
Morton,2357,1,19,11,6,62,39,23,68
Hibernian,2357,2,17,14,5,55,31,24,65
Falkirk,2357,3,16,11,9,58,41,17,59
Dundee Utd,2357,4,16,9,11,47,40,7,57
Queen of S't,2357,5,13,11,12,47,45,2,50
Raith,2357,6,10,10,16,36,55,-19,40
Dunfermline,2357,7,9,12,15,45,51,-6,39
Dumbarton,2357,8,8,12,16,46,57,-11,36
Ayr,2357,9,8,12,16,32,53,-21,36
St Mirren,2357,10,7,12,17,41,57,-16,33
Hibernian,2358,1,19,13,4,56,23,33,70
Morton,2358,2,17,12,7,49,33,16,63
Falkirk,2358,3,16,13,7,60,36,24,61
Dundee Utd,2358,4,14,11,11,44,40,4,53
Queen of S't,2358,5,12,9,15,43,48,-5,45
Dunfermline,2358,6,8,16,12,44,49,-5,40
Dumbarton,2358,7,9,13,14,47,55,-8,40
Ayr,2358,8,8,13,15,35,54,-19,37
Raith,2358,9,8,12,16,31,49,-18,36
St Mirren,2358,10,7,12,17,38,60,-22,33
Hibernian,2359,1,20,12,4,56,22,34,72
Falkirk,2359,2,16,11,9,59,42,17,59
Morton,2359,3,16,11,9,44,37,7,59
Dundee Utd,2359,4,15,10,11,49,40,9,55
Queen of S't,2359,5,11,11,14,43,48,-5,44
Ayr,2359,6,9,14,13,34,49,-15,41
St Mirren,2359,7,10,10,16,43,55,-12,40
Dumbarton,2359,8,9,12,15,50,59,-9,39
Raith,2359,9,9,11,16,37,54,-17,38
Dunfermline,2359,10,8,12,16,44,53,-9,36
Hibernian,2360,1,19,12,5,54,27,27,69
Falkirk,2360,2,15,12,9,61,42,19,57
Morton,2360,3,15,12,9,49,38,11,57
Dundee Utd,2360,4,14,11,11,45,40,5,53
Queen of S't,2360,5,13,10,13,50,49,1,49
Dunfermline,2360,6,9,15,12,44,45,-1,42
Raith,2360,7,11,8,17,34,52,-18,41
St Mirren,2360,8,10,9,17,41,52,-11,39
Dumbarton,2360,9,9,12,15,47,60,-13,39
Ayr,2360,10,8,13,15,37,57,-20,37
Hibernian,2361,1,19,12,5,56,25,31,69
Morton,2361,2,18,11,7,48,36,12,65
Falkirk,2361,3,18,9,9,60,36,24,63
Dundee Utd,2361,4,18,8,10,57,42,15,62
Queen of S't,2361,5,13,10,13,46,46,0,49
Dunfermline,2361,6,11,11,14,47,46,1,44
Dumbarton,2361,7,9,11,16,46,58,-12,38
St Mirren,2361,8,9,9,18,42,60,-18,36
Raith,2361,9,8,9,19,30,53,-23,33
Ayr,2361,10,6,12,18,30,60,-30,30
Morton,2362,1,17,13,6,48,32,16,64
Hibernian,2362,2,17,11,8,55,35,20,62
Falkirk,2362,3,17,9,10,56,41,15,60
Dundee Utd,2362,4,14,11,11,48,39,9,53
Dunfermline,2362,5,11,12,13,45,47,-2,45
Queen of S't,2362,6,11,10,15,44,50,-6,43
Dumbarton,2362,7,10,11,15,47,56,-9,41
St Mirren,2362,8,10,11,15,40,50,-10,41
Raith,2362,9,10,10,16,35,48,-13,40
Ayr,2362,10,8,12,16,34,54,-20,36
Hibernian,2363,1,20,12,4,55,24,31,72
Morton,2363,2,18,13,5,52,32,20,67
Dundee Utd,2363,3,17,10,9,54,38,16,61
Falkirk,2363,4,14,12,10,56,42,14,54
Queen of S't,2363,5,13,9,14,47,52,-5,48
St Mirren,2363,6,9,11,16,41,55,-14,38
Dunfermline,2363,7,8,13,15,46,54,-8,37
Raith,2363,8,9,10,17,35,50,-15,37
Dumbarton,2363,9,8,11,17,49,64,-15,35
Ayr,2363,10,8,11,17,35,59,-24,35
Hibernian,2364,1,21,11,4,58,24,34,74
Falkirk,2364,2,17,11,8,61,40,21,62
Morton,2364,3,16,9,11,49,38,11,57
Dundee Utd,2364,4,14,10,12,45,39,6,52
Dunfermline,2364,5,11,13,12,46,46,0,46
Queen of S't,2364,6,11,8,17,41,53,-12,41
Ayr,2364,7,10,11,15,37,58,-21,41
Dumbarton,2364,8,9,12,15,48,60,-12,39
Raith,2364,9,10,9,17,38,52,-14,39
St Mirren,2364,10,9,10,17,40,53,-13,37
Hibernian,2365,1,22,11,3,57,22,35,77
Morton,2365,2,16,13,7,53,38,15,61
Falkirk,2365,3,17,9,10,57,38,19,60
Dundee Utd,2365,4,17,9,10,50,40,10,60
Queen of S't,2365,5,10,12,14,41,47,-6,42
Dumbarton,2365,6,9,13,14,51,63,-12,40
Dunfermline,2365,7,8,14,14,45,49,-4,38
St Mirren,2365,8,9,10,17,47,57,-10,37
Raith,2365,9,9,9,18,33,55,-22,36
Ayr,2365,10,6,14,16,31,56,-25,32
Hibernian,2366,1,19,12,5,57,26,31,69
Dundee Utd,2366,2,17,9,10,57,41,16,60
Falkirk,2366,3,16,11,9,58,41,17,59
Morton,2366,4,14,14,8,49,42,7,56
Dunfermline,2366,5,12,13,11,55,48,7,49
Queen of S't,2366,6,11,11,14,54,55,-1,44
Raith,2366,7,10,11,15,41,55,-14,41
Dumbarton,2366,8,8,12,16,46,65,-19,36
Ayr,2366,9,7,14,15,36,60,-24,35
St Mirren,2366,10,7,11,18,37,57,-20,32
Hibernian,2367,1,18,14,4,52,25,27,68
Dundee Utd,2367,2,17,9,10,52,37,15,60
Morton,2367,3,17,9,10,51,38,13,60
Falkirk,2367,4,15,10,11,54,43,11,55
Dunfermline,2367,5,11,14,11,49,48,1,47
Raith,2367,6,11,12,13,37,44,-7,45
Queen of S't,2367,7,11,10,15,43,49,-6,43
Dumbarton,2367,8,7,13,16,44,59,-15,34
St Mirren,2367,9,7,13,16,39,56,-17,34
Ayr,2367,10,6,16,14,30,52,-22,34
Hibernian,2368,1,19,12,5,61,30,31,69
Dundee Utd,2368,2,18,9,9,56,37,19,63
Morton,2368,3,18,9,9,47,37,10,63
Falkirk,2368,4,14,9,13,52,43,9,51
Dunfermline,2368,5,10,14,12,49,52,-3,44
Queen of S't,2368,6,11,11,14,44,51,-7,44
Dumbarton,2368,7,9,13,14,47,56,-9,40
St Mirren,2368,8,10,10,16,43,55,-12,40
Raith,2368,9,10,8,18,37,53,-16,38
Ayr,2368,10,8,11,17,35,57,-22,35
Hibernian,2369,1,21,12,3,58,24,34,75
Falkirk,2369,2,15,10,11,54,44,10,55
Morton,2369,3,15,10,11,49,44,5,55
Dundee Utd,2369,4,14,11,11,47,42,5,53
Queen of S't,2369,5,12,10,14,42,45,-3,46
Dunfermline,2369,6,10,14,12,49,48,1,44
Dumbarton,2369,7,9,14,13,46,50,-4,41
St Mirren,2369,8,10,10,16,46,56,-10,40
Ayr,2369,9,9,12,15,37,54,-17,39
Raith,2369,10,8,11,17,35,56,-21,35
Hibernian,2370,1,22,11,3,57,25,32,77
Morton,2370,2,18,10,8,47,32,15,64
Dundee Utd,2370,3,16,9,11,52,36,16,57
Falkirk,2370,4,15,11,10,59,44,15,56
Queen of S't,2370,5,11,10,15,43,49,-6,43
Dumbarton,2370,6,10,12,14,51,56,-5,42
Dunfermline,2370,7,9,11,16,46,53,-7,38
St Mirren,2370,8,9,11,16,41,59,-18,38
Raith,2370,9,9,10,17,34,53,-19,37
Ayr,2370,10,8,11,17,32,55,-23,35
Hibernian,2371,1,19,10,7,58,29,29,67
Falkirk,2371,2,17,11,8,65,40,25,62
Morton,2371,3,16,12,8,55,44,11,60
Dundee Utd,2371,4,14,11,11,47,41,6,53
Queen of S't,2371,5,12,10,14,48,52,-4,46
Ayr,2371,6,11,10,15,40,53,-13,43
Dunfermline,2371,7,9,15,12,47,46,1,42
Dumbarton,2371,8,9,12,15,51,66,-15,39
Raith,2371,9,9,10,17,32,54,-22,37
St Mirren,2371,10,8,11,17,42,60,-18,35
Hibernian,2372,1,19,11,6,58,26,32,68
Morton,2372,2,16,12,8,47,33,14,60
Falkirk,2372,3,16,9,11,59,47,12,57
Dundee Utd,2372,4,16,8,12,47,44,3,56
Dunfermline,2372,5,13,12,11,52,46,6,51
Queen of S't,2372,6,11,8,17,47,59,-12,41
Raith,2372,7,10,10,16,35,47,-12,40
Ayr,2372,8,9,13,14,35,50,-15,40
Dumbarton,2372,9,9,11,16,50,63,-13,38
St Mirren,2372,10,9,10,17,40,55,-15,37
Hibernian,2373,1,19,14,3,55,24,31,71
Morton,2373,2,17,14,5,54,33,21,65
Falkirk,2373,3,16,11,9,62,40,22,59
Dundee Utd,2373,4,15,11,10,47,39,8,56
Raith,2373,5,11,12,13,36,44,-8,45
Queen of S't,2373,6,11,11,14,41,46,-5,44
Dumbarton,2373,7,9,11,16,44,60,-16,38
Ayr,2373,8,8,13,15,35,56,-21,37
Dunfermline,2373,9,7,12,17,40,53,-13,33
St Mirren,2373,10,7,11,18,36,55,-19,32
Hibernian,2374,1,19,10,7,53,26,27,67
Morton,2374,2,15,14,7,49,38,11,59
Dundee Utd,2374,3,16,9,11,50,39,11,57
Falkirk,2374,4,15,11,10,57,42,15,56
Raith,2374,5,12,11,13,37,44,-7,47
Dumbarton,2374,6,12,10,14,56,57,-1,46
Queen of S't,2374,7,11,10,15,44,53,-9,43
Dunfermline,2374,8,8,16,12,44,48,-4,40
Ayr,2374,9,9,12,15,34,55,-21,39
St Mirren,2374,10,7,9,20,38,60,-22,30
Hibernian,2375,1,20,11,5,56,25,31,71
Falkirk,2375,2,17,9,10,56,39,17,60
Morton,2375,3,16,12,8,49,36,13,60
Dundee Utd,2375,4,16,9,11,52,40,12,57
Dunfermline,2375,5,10,15,11,45,45,0,45
Queen of S't,2375,6,11,10,15,42,47,-5,43
Dumbarton,2375,7,9,13,14,51,62,-11,40
Raith,2375,8,10,9,17,34,51,-17,39
Ayr,2375,9,8,12,16,32,55,-23,36
St Mirren,2375,10,8,10,18,40,57,-17,34
Hibernian,2376,1,19,14,3,53,22,31,71
Dundee Utd,2376,2,17,9,10,54,41,13,60
Falkirk,2376,3,16,11,9,62,45,17,59
Morton,2376,4,16,10,10,43,34,9,58
Dunfermline,2376,5,11,12,13,45,48,-3,45
Queen of S't,2376,6,11,10,15,47,53,-6,43
Dumbarton,2376,7,9,13,14,47,56,-9,40
St Mirren,2376,8,10,9,17,41,53,-12,39
Ayr,2376,9,8,12,16,35,55,-20,36
Raith,2376,10,8,10,18,33,53,-20,34
Hibernian,2377,1,19,14,3,54,24,30,71
Falkirk,2377,2,18,9,9,62,41,21,63
Dundee Utd,2377,3,18,9,9,59,41,18,63
Morton,2377,4,16,12,8,48,39,9,60
Raith,2377,5,11,10,15,42,51,-9,43
Dumbarton,2377,6,10,11,15,54,61,-7,41
Dunfermline,2377,7,9,11,16,47,56,-9,38
St Mirren,2377,8,9,11,16,42,56,-14,38
Queen of S't,2377,9,9,10,17,41,55,-14,37
Ayr,2377,10,7,11,18,31,56,-25,32
Hibernian,2378,1,18,12,6,57,28,29,66
Dundee Utd,2378,2,19,8,9,59,40,19,65
Falkirk,2378,3,14,11,11,56,47,9,53
Morton,2378,4,13,12,11,49,48,1,51
Dumbarton,2378,5,12,11,13,54,55,-1,47
Queen of S't,2378,6,11,12,13,46,49,-3,45
Dunfermline,2378,7,10,14,12,50,51,-1,44
Raith,2378,8,10,11,15,44,57,-13,41
Ayr,2378,9,8,13,15,35,56,-21,37
St Mirren,2378,10,8,10,18,45,64,-19,34
Hibernian,2379,1,19,11,6,55,26,29,68
Morton,2379,2,16,13,7,46,33,13,61
Falkirk,2379,3,16,11,9,54,37,17,59
Dundee Utd,2379,4,14,13,9,50,38,12,55
Queen of S't,2379,5,12,11,13,44,49,-5,47
Dunfermline,2379,6,9,16,11,44,45,-1,43
Ayr,2379,7,9,14,13,36,52,-16,41
St Mirren,2379,8,10,10,16,46,58,-12,40
Raith,2379,9,8,10,18,30,49,-19,34
Dumbarton,2379,10,7,11,18,47,65,-18,32
Hibernian,2380,1,19,14,3,56,25,31,71
Morton,2380,2,18,12,6,57,35,22,66
Dundee Utd,2380,3,15,11,10,51,43,8,56
Falkirk,2380,4,14,12,10,53,41,12,54
Queen of S't,2380,5,11,11,14,46,48,-2,44
Dunfermline,2380,6,9,15,12,46,47,-1,42
Dumbarton,2380,7,9,13,14,48,59,-11,40
Ayr,2380,8,9,13,14,36,56,-20,40
Raith,2380,9,10,8,18,36,52,-16,38
St Mirren,2380,10,6,11,19,35,58,-23,29
Morton,2381,1,20,9,7,58,38,20,69
Hibernian,2381,2,18,13,5,51,25,26,67
Dundee Utd,2381,3,16,10,10,53,42,11,58
Falkirk,2381,4,13,12,11,55,46,9,51
Dunfermline,2381,5,11,12,13,50,48,2,45
Queen of S't,2381,6,10,11,15,43,48,-5,41
Dumbarton,2381,7,9,12,15,45,56,-11,39
Ayr,2381,8,9,12,15,34,54,-20,39
Raith,2381,9,9,11,16,35,50,-15,38
St Mirren,2381,10,8,12,16,36,53,-17,36
Hibernian,2382,1,17,13,6,47,24,23,64
Morton,2382,2,15,14,7,49,38,11,59
Falkirk,2382,3,16,10,10,60,40,20,58
Dundee Utd,2382,4,14,10,12,50,43,7,52
Queen of S't,2382,5,13,9,14,48,47,1,48
Dunfermline,2382,6,11,12,13,47,46,1,45
Dumbarton,2382,7,9,13,14,50,62,-12,40
St Mirren,2382,8,9,12,15,41,56,-15,39
Raith,2382,9,10,9,17,35,53,-18,39
Ayr,2382,10,8,14,14,38,56,-18,38
Hibernian,2383,1,17,15,4,53,26,27,66
Falkirk,2383,2,18,11,7,64,41,23,65
Morton,2383,3,16,13,7,48,32,16,61
Dundee Utd,2383,4,14,9,13,48,47,1,51
Dunfermline,2383,5,10,13,13,46,48,-2,43
Queen of S't,2383,6,11,10,15,48,53,-5,43
Raith,2383,7,9,13,14,32,45,-13,40
Ayr,2383,8,8,14,14,32,50,-18,38
St Mirren,2383,9,9,10,17,43,54,-11,37
Dumbarton,2383,10,8,12,16,48,66,-18,36
Hibernian,2384,1,20,10,6,57,28,29,70
Falkirk,2384,2,17,12,7,61,39,22,63
Morton,2384,3,16,11,9,51,38,13,59
Dundee Utd,2384,4,15,10,11,47,41,6,55
Queen of S't,2384,5,12,10,14,46,49,-3,46
Dunfermline,2384,6,10,13,13,42,44,-2,43
Raith,2384,7,10,12,14,35,45,-10,42
Dumbarton,2384,8,9,13,14,46,54,-8,40
Ayr,2384,9,8,12,16,34,54,-20,36
St Mirren,2384,10,6,11,19,34,61,-27,29
Hibernian,2385,1,20,12,4,57,25,32,72
Dundee Utd,2385,2,15,13,8,51,39,12,58
Falkirk,2385,3,14,11,11,56,43,13,53
Morton,2385,4,13,12,11,43,39,4,51
Dunfermline,2385,5,11,14,11,52,49,3,47
St Mirren,2385,6,11,10,15,46,54,-8,43
Queen of S't,2385,7,10,12,14,44,51,-7,42
Raith,2385,8,10,10,16,34,49,-15,40
Dumbarton,2385,9,9,11,16,50,61,-11,38
Ayr,2385,10,8,13,15,35,58,-23,37
Hibernian,2386,1,20,11,5,59,27,32,71
Morton,2386,2,17,11,8,50,38,12,62
Falkirk,2386,3,17,10,9,62,42,20,61
Dundee Utd,2386,4,15,9,12,51,46,5,54
Queen of S't,2386,5,12,9,15,50,51,-1,45
Dumbarton,2386,6,11,12,13,51,55,-4,45
Dunfermline,2386,7,10,12,14,49,52,-3,42
Raith,2386,8,11,8,17,37,55,-18,41
St Mirren,2386,9,9,11,16,43,57,-14,38
Ayr,2386,10,6,11,19,27,56,-29,29
Hibernian,2387,1,20,12,4,61,27,34,72
Morton,2387,2,16,12,8,50,41,9,60
Falkirk,2387,3,16,11,9,63,45,18,59
Dundee Utd,2387,4,17,8,11,54,41,13,59
Dunfermline,2387,5,10,13,13,45,47,-2,43
Queen of S't,2387,6,11,9,16,47,54,-7,42
Raith,2387,7,10,12,14,40,50,-10,42
Dumbarton,2387,8,9,12,15,52,64,-12,39
St Mirren,2387,9,9,10,17,46,60,-14,37
Ayr,2387,10,7,11,18,32,61,-29,32
Hibernian,2388,1,17,11,8,51,29,22,62
Morton,2388,2,16,14,6,48,32,16,62
Falkirk,2388,3,16,10,10,63,42,21,58
Dundee Utd,2388,4,16,10,10,59,43,16,58
Dunfermline,2388,5,11,13,12,47,48,-1,46
Queen of S't,2388,6,12,9,15,49,55,-6,45
St Mirren,2388,7,11,10,15,44,58,-14,43
Raith,2388,8,9,10,17,33,48,-15,37
Ayr,2388,9,8,13,15,36,58,-22,37
Dumbarton,2388,10,8,12,16,44,61,-17,36
Hibernian,2389,1,18,13,5,51,25,26,67
Morton,2389,2,18,10,8,52,38,14,64
Falkirk,2389,3,16,11,9,59,40,19,59
Dundee Utd,2389,4,15,10,11,48,39,9,55
Queen of S't,2389,5,12,9,15,41,47,-6,45
Dunfermline,2389,6,10,12,14,46,47,-1,42
Dumbarton,2389,7,10,12,14,50,58,-8,42
Raith,2389,8,11,8,17,36,52,-16,41
Ayr,2389,9,9,12,15,35,53,-18,39
St Mirren,2389,10,8,9,19,39,58,-19,33
Hibernian,2390,1,19,12,5,59,29,30,69
Morton,2390,2,19,12,5,58,37,21,69
Falkirk,2390,3,18,9,9,57,40,17,63
Dundee Utd,2390,4,17,9,10,51,39,12,60
Queen of S't,2390,5,11,9,16,44,54,-10,42
Raith,2390,6,10,11,15,36,48,-12,41
Dunfermline,2390,7,8,13,15,46,49,-3,37
St Mirren,2390,8,9,10,17,39,53,-14,37
Ayr,2390,9,8,11,17,33,54,-21,35
Dumbarton,2390,10,8,10,18,45,65,-20,34
Hibernian,2391,1,18,15,3,54,25,29,69
Morton,2391,2,16,13,7,48,36,12,61
Falkirk,2391,3,16,10,10,59,47,12,58
Dundee Utd,2391,4,14,11,11,52,43,9,53
Queen of S't,2391,5,12,10,14,45,50,-5,46
Ayr,2391,6,10,12,14,40,56,-16,42
Dunfermline,2391,7,9,13,14,49,54,-5,40
St Mirren,2391,8,10,9,17,45,55,-10,39
Dumbarton,2391,9,8,13,15,45,54,-9,37
Raith,2391,10,9,10,17,34,51,-17,37
Hibernian,2392,1,22,11,3,68,25,43,77
Morton,2392,2,15,11,10,47,45,2,56
Falkirk,2392,3,15,10,11,59,51,8,55
Dundee Utd,2392,4,14,12,10,49,37,12,54
Raith,2392,5,11,10,15,40,49,-9,43
Dunfermline,2392,6,9,15,12,48,48,0,42
Queen of S't,2392,7,10,11,15,40,49,-9,41
St Mirren,2392,8,10,10,16,41,52,-11,40
Ayr,2392,9,9,12,15,31,50,-19,39
Dumbarton,2392,10,9,10,17,47,64,-17,37
Morton,2393,1,18,12,6,53,34,19,66
Hibernian,2393,2,16,13,7,52,32,20,61
Dundee Utd,2393,3,16,11,9,48,35,13,59
Falkirk,2393,4,16,9,11,55,39,16,57
Raith,2393,5,11,10,15,35,46,-11,43
Queen of S't,2393,6,10,12,14,45,51,-6,42
Dunfermline,2393,7,9,14,13,48,53,-5,41
St Mirren,2393,8,9,11,16,43,56,-13,38
Dumbarton,2393,9,9,11,16,48,62,-14,38
Ayr,2393,10,7,15,14,34,53,-19,36
Hibernian,2394,1,18,11,7,52,27,25,65
Morton,2394,2,16,14,6,51,35,16,62
Dundee Utd,2394,3,16,10,10,50,42,8,58
Falkirk,2394,4,14,11,11,58,47,11,53
Queen of S't,2394,5,12,10,14,50,52,-2,46
Dunfermline,2394,6,9,16,11,51,50,1,43
Dumbarton,2394,7,10,12,14,48,56,-8,42
Raith,2394,8,11,8,17,35,48,-13,41
St Mirren,2394,9,8,13,15,40,53,-13,37
Ayr,2394,10,7,13,16,28,53,-25,34
Hibernian,2395,1,19,12,5,54,29,25,69
Morton,2395,2,17,10,9,53,40,13,61
Dundee Utd,2395,3,17,9,10,58,40,18,60
Falkirk,2395,4,16,9,11,57,47,10,57
Queen of S't,2395,5,11,9,16,44,50,-6,42
Dumbarton,2395,6,10,11,15,52,63,-11,41
Ayr,2395,7,10,11,15,37,53,-16,41
Raith,2395,8,10,10,16,37,49,-12,40
Dunfermline,2395,9,8,14,14,49,54,-5,38
St Mirren,2395,10,8,13,15,36,52,-16,37
Hibernian,2396,1,19,11,6,56,29,27,68
Falkirk,2396,2,18,10,8,57,34,23,64
Morton,2396,3,16,12,8,50,41,9,60
Dundee Utd,2396,4,15,10,11,48,39,9,55
Queen of S't,2396,5,12,9,15,43,49,-6,45
Dunfermline,2396,6,10,12,14,47,46,1,42
Raith,2396,7,11,9,16,35,46,-11,42
Ayr,2396,8,9,13,14,35,51,-16,40
Dumbarton,2396,9,9,12,15,48,59,-11,39
St Mirren,2396,10,7,10,19,36,61,-25,31
Hibernian,2397,1,18,10,8,48,26,22,64
Morton,2397,2,18,10,8,54,36,18,64
Falkirk,2397,3,17,11,8,61,39,22,62
Dundee Utd,2397,4,15,10,11,50,41,9,55
St Mirren,2397,5,12,9,15,45,51,-6,45
Queen of S't,2397,6,11,11,14,45,48,-3,44
Raith,2397,7,11,9,16,39,48,-9,42
Dunfermline,2397,8,9,13,14,45,50,-5,40
Ayr,2397,9,8,13,15,33,58,-25,37
Dumbarton,2397,10,7,12,17,46,69,-23,33
Hibernian,2398,1,18,13,5,52,26,26,67
Dundee Utd,2398,2,18,9,9,53,37,16,63
Falkirk,2398,3,15,12,9,62,45,17,57
Morton,2398,4,15,10,11,48,40,8,55
Raith,2398,5,11,11,14,41,48,-7,44
Dunfermline,2398,6,10,13,13,50,52,-2,43
Queen of S't,2398,7,11,10,15,43,50,-7,43
Ayr,2398,8,9,11,16,32,54,-22,38
St Mirren,2398,9,8,13,15,40,56,-16,37
Dumbarton,2398,10,8,12,16,43,56,-13,36
Hibernian,2399,1,22,10,4,57,24,33,76
Morton,2399,2,19,9,8,52,37,15,66
Falkirk,2399,3,15,10,11,55,41,14,55
Dundee Utd,2399,4,15,8,13,49,43,6,53
Queen of S't,2399,5,13,9,14,43,48,-5,48
Dunfermline,2399,6,10,12,14,48,48,0,42
Dumbarton,2399,7,10,10,16,47,57,-10,40
St Mirren,2399,8,9,11,16,43,56,-13,38
Ayr,2399,9,8,12,16,36,56,-20,36
Raith,2399,10,9,9,18,32,52,-20,36
Hibernian,2400,1,21,12,3,59,24,35,75
Falkirk,2400,2,17,10,9,62,42,20,61
Morton,2400,3,16,11,9,49,36,13,59
Dundee Utd,2400,4,14,13,9,55,42,13,55
Queen of S't,2400,5,10,11,15,41,51,-10,41
Dunfermline,2400,6,9,13,14,43,48,-5,40
Dumbarton,2400,7,9,13,14,49,56,-7,40
Raith,2400,8,10,10,16,36,50,-14,40
Ayr,2400,9,9,12,15,34,57,-23,39
St Mirren,2400,10,7,11,18,40,62,-22,32
Hibernian,2401,1,18,12,6,54,29,25,66
Morton,2401,2,18,10,8,49,34,15,64
Dundee Utd,2401,3,15,12,9,49,38,11,57
Falkirk,2401,4,14,13,9,55,41,14,55
Dunfermline,2401,5,12,13,11,52,45,7,49
Queen of S't,2401,6,13,10,13,43,44,-1,49
St Mirren,2401,7,10,10,16,47,55,-8,40
Raith,2401,8,9,9,18,30,56,-26,36
Ayr,2401,9,7,13,16,30,51,-21,34
Dumbarton,2401,10,7,12,17,44,60,-16,33
Hibernian,2402,1,18,14,4,55,27,28,68
Falkirk,2402,2,16,10,10,59,38,21,58
Dundee Utd,2402,3,16,10,10,51,41,10,58
Morton,2402,4,15,10,11,48,41,7,55
Dunfermline,2402,5,13,12,11,48,45,3,51
Queen of S't,2402,6,12,8,16,46,51,-5,44
Ayr,2402,7,9,14,13,35,51,-16,41
Dumbarton,2402,8,9,12,15,52,61,-9,39
Raith,2402,9,9,10,17,41,58,-17,37
St Mirren,2402,10,8,10,18,40,62,-22,34
Hibernian,2403,1,20,12,4,59,27,32,72
Dundee Utd,2403,2,19,8,9,59,35,24,65
Falkirk,2403,3,16,12,8,59,40,19,60
Morton,2403,4,16,11,9,51,41,10,59
Dumbarton,2403,5,10,11,15,51,60,-9,41
Queen of S't,2403,6,10,11,15,44,53,-9,41
Raith,2403,7,11,8,17,39,53,-14,41
St Mirren,2403,8,9,10,17,42,65,-23,37
Dunfermline,2403,9,8,12,16,44,54,-10,36
Ayr,2403,10,7,13,16,35,55,-20,34
Hibernian,2404,1,18,13,5,53,24,29,67
Morton,2404,2,16,14,6,52,34,18,62
Dundee Utd,2404,3,17,10,9,56,39,17,61
Falkirk,2404,4,16,10,10,58,44,14,58
Queen of S't,2404,5,12,9,15,46,54,-8,45
Dunfermline,2404,6,10,12,14,45,48,-3,42
Raith,2404,7,11,8,17,38,53,-15,41
St Mirren,2404,8,10,10,16,39,52,-13,40
Dumbarton,2404,9,9,11,16,44,55,-11,38
Ayr,2404,10,7,11,18,31,59,-28,32
Hibernian,2405,1,20,12,4,65,28,37,72
Dundee Utd,2405,2,18,9,9,58,41,17,63
Morton,2405,3,17,11,8,52,37,15,62
Falkirk,2405,4,15,11,10,60,45,15,56
Raith,2405,5,12,9,15,39,49,-10,45
Queen of S't,2405,6,10,11,15,44,53,-9,41
Dumbarton,2405,7,10,10,16,52,61,-9,40
Dunfermline,2405,8,7,15,14,41,53,-12,36
Ayr,2405,9,8,12,16,37,62,-25,36
St Mirren,2405,10,8,10,18,47,66,-19,34
Hibernian,2406,1,19,12,5,57,30,27,69
Dundee Utd,2406,2,16,9,11,50,41,9,57
Falkirk,2406,3,15,11,10,56,40,16,56
Morton,2406,4,14,11,11,48,42,6,53
Dunfermline,2406,5,11,14,11,47,45,2,47
Queen of S't,2406,6,11,12,13,47,51,-4,45
St Mirren,2406,7,9,13,14,44,55,-11,40
Raith,2406,8,10,10,16,35,48,-13,40
Dumbarton,2406,9,9,11,16,46,59,-13,38
Ayr,2406,10,8,13,15,33,52,-19,37
Hibernian,2407,1,20,12,4,61,27,34,72
Falkirk,2407,2,18,10,8,59,39,20,64
Morton,2407,3,17,10,9,54,39,15,61
Dundee Utd,2407,4,17,9,10,54,41,13,60
Queen of S't,2407,5,12,10,14,49,52,-3,46
Raith,2407,6,11,11,14,38,45,-7,44
Dumbarton,2407,7,9,11,16,44,55,-11,38
Dunfermline,2407,8,8,13,15,42,50,-8,37
St Mirren,2407,9,7,11,18,38,60,-22,32
Ayr,2407,10,6,13,17,30,61,-31,31
Hibernian,2408,1,21,10,5,60,27,33,73
Falkirk,2408,2,17,11,8,59,37,22,62
Morton,2408,3,17,11,8,55,38,17,62
Dundee Utd,2408,4,15,10,11,45,41,4,55
Dunfermline,2408,5,10,13,13,48,50,-2,43
Dumbarton,2408,6,11,10,15,51,59,-8,43
Queen of S't,2408,7,11,9,16,46,53,-7,42
Raith,2408,8,9,11,16,35,49,-14,38
Ayr,2408,9,9,11,16,35,60,-25,38
St Mirren,2408,10,7,10,19,40,60,-20,31
Hibernian,2409,1,19,12,5,57,27,30,69
Morton,2409,2,17,12,7,50,34,16,63
Dundee Utd,2409,3,15,12,9,50,38,12,57
Falkirk,2409,4,15,11,10,57,40,17,56
Raith,2409,5,12,10,14,38,46,-8,46
Dunfermline,2409,6,10,15,11,50,48,2,45
Queen of S't,2409,7,10,11,15,43,54,-11,41
Dumbarton,2409,8,10,10,16,50,63,-13,40
St Mirren,2409,9,8,11,17,40,57,-17,35
Ayr,2409,10,6,12,18,29,57,-28,30
Hibernian,2410,1,23,10,3,66,25,41,79
Dundee Utd,2410,2,18,8,10,57,41,16,62
Falkirk,2410,3,17,9,10,58,39,19,60
Morton,2410,4,16,10,10,47,38,9,58
Queen of S't,2410,5,12,9,15,47,51,-4,45
Dunfermline,2410,6,10,12,14,43,49,-6,42
Dumbarton,2410,7,10,11,15,54,59,-5,41
Raith,2410,8,10,9,17,35,55,-20,39
Ayr,2410,9,8,11,17,34,60,-26,35
St Mirren,2410,10,7,9,20,37,61,-24,30
Hibernian,2411,1,16,14,6,51,29,22,62
Falkirk,2411,2,16,10,10,57,41,16,58
Dundee Utd,2411,3,15,11,10,49,39,10,56
Morton,2411,4,14,13,9,44,35,9,55
Queen of S't,2411,5,13,9,14,51,50,1,48
Dunfermline,2411,6,11,13,12,48,48,0,46
Raith,2411,7,11,11,14,37,47,-10,44
Ayr,2411,8,8,15,13,34,54,-20,39
Dumbarton,2411,9,8,14,14,47,57,-10,38
St Mirren,2411,10,8,10,18,40,58,-18,34
Hibernian,2412,1,20,13,3,55,22,33,73
Morton,2412,2,17,11,8,51,35,16,62
Falkirk,2412,3,16,12,8,62,44,18,60
Dundee Utd,2412,4,16,9,11,53,42,11,57
Dunfermline,2412,5,12,12,12,52,47,5,48
Dumbarton,2412,6,10,12,14,47,57,-10,42
Raith,2412,7,10,9,17,36,51,-15,39
Queen of S't,2412,8,10,9,17,40,56,-16,39
Ayr,2412,9,7,12,17,35,55,-20,33
St Mirren,2412,10,8,9,19,44,66,-22,33
Hibernian,2413,1,19,12,5,58,28,30,69
Morton,2413,2,18,12,6,59,36,23,66
Dundee Utd,2413,3,19,8,9,54,38,16,65
Falkirk,2413,4,14,10,12,56,48,8,52
Dunfermline,2413,5,11,13,12,54,47,7,46
Raith,2413,6,12,8,16,38,51,-13,44
Dumbarton,2413,7,10,11,15,49,55,-6,41
Queen of S't,2413,8,11,8,17,45,60,-15,41
Ayr,2413,9,8,10,18,37,65,-28,34
St Mirren,2413,10,7,10,19,38,60,-22,31
Hibernian,2414,1,17,14,5,53,26,27,65
Morton,2414,2,15,13,8,48,37,11,58
Falkirk,2414,3,14,11,11,57,45,12,53
Dundee Utd,2414,4,14,10,12,48,40,8,52
Queen of S't,2414,5,14,10,12,48,45,3,52
Raith,2414,6,12,11,13,37,43,-6,47
Dumbarton,2414,7,11,11,14,49,56,-7,44
Dunfermline,2414,8,10,11,15,44,49,-5,41
Ayr,2414,9,9,12,15,37,60,-23,39
St Mirren,2414,10,7,11,18,39,59,-20,32
Hibernian,2415,1,20,10,6,55,26,29,70
Morton,2415,2,17,11,8,50,35,15,62
Falkirk,2415,3,15,9,12,56,46,10,54
Dundee Utd,2415,4,14,10,12,49,44,5,52
Raith,2415,5,13,9,14,37,45,-8,48
Queen of S't,2415,6,12,9,15,44,51,-7,45
Ayr,2415,7,11,11,14,38,52,-14,44
Dumbarton,2415,8,9,13,14,51,57,-6,40
Dunfermline,2415,9,9,13,14,45,53,-8,40
St Mirren,2415,10,8,9,19,39,55,-16,33
Hibernian,2416,1,18,13,5,53,25,28,67
Falkirk,2416,2,16,11,9,59,42,17,59
Dundee Utd,2416,3,16,10,10,55,44,11,58
Morton,2416,4,15,13,8,50,39,11,58
Queen of S't,2416,5,13,9,14,48,51,-3,48
Dumbarton,2416,6,10,12,14,52,59,-7,42
Raith,2416,7,11,8,17,35,49,-14,41
St Mirren,2416,8,9,12,15,43,54,-11,39
Dunfermline,2416,9,8,12,16,47,56,-9,36
Ayr,2416,10,8,12,16,35,58,-23,36
Hibernian,2417,1,19,13,4,54,23,31,70
Morton,2417,2,17,11,8,50,38,12,62
Falkirk,2417,3,15,10,11,56,44,12,55
Dundee Utd,2417,4,15,10,11,50,40,10,55
Dumbarton,2417,5,11,10,15,51,56,-5,43
Raith,2417,6,11,9,16,38,51,-13,42
Ayr,2417,7,10,11,15,35,50,-15,41
Dunfermline,2417,8,8,15,13,41,47,-6,39
Queen of S't,2417,9,9,12,15,40,56,-16,39
St Mirren,2417,10,9,11,16,44,54,-10,38
Hibernian,2418,1,20,12,4,56,22,34,72
Falkirk,2418,2,16,10,10,59,42,17,58
Morton,2418,3,15,11,10,46,38,8,56
Dundee Utd,2418,4,14,9,13,45,41,4,51
Dumbarton,2418,5,12,11,13,51,54,-3,47
Dunfermline,2418,6,11,12,13,48,46,2,45
Queen of S't,2418,7,12,9,15,43,52,-9,45
Ayr,2418,8,8,14,14,37,54,-17,38
Raith,2418,9,10,8,18,32,50,-18,38
St Mirren,2418,10,9,10,17,36,54,-18,37
Morton,2419,1,19,12,5,56,33,23,69
Hibernian,2419,2,18,12,6,52,26,26,66
Dundee Utd,2419,3,17,9,10,57,40,17,60
Falkirk,2419,4,15,12,9,53,40,13,57
Dunfermline,2419,5,10,15,11,44,41,3,45
Queen of S't,2419,6,11,10,15,41,48,-7,43
Dumbarton,2419,7,8,13,15,47,59,-12,37
Raith,2419,8,9,10,17,30,47,-17,37
St Mirren,2419,9,9,9,18,41,60,-19,36
Ayr,2419,10,7,12,17,33,60,-27,33
Morton,2420,1,19,11,6,51,34,17,68
Hibernian,2420,2,18,12,6,56,26,30,66
Falkirk,2420,3,18,9,9,58,40,18,63
Dundee Utd,2420,4,16,9,11,55,40,15,57
Dumbarton,2420,5,11,10,15,54,58,-4,43
Queen of S't,2420,6,11,9,16,48,59,-11,42
St Mirren,2420,7,10,10,16,41,55,-14,40
Dunfermline,2420,8,9,12,15,44,50,-6,39
Raith,2420,9,10,8,18,35,52,-17,38
Ayr,2420,10,8,10,18,35,63,-28,34
Hibernian,2421,1,21,11,4,62,26,36,74
Dundee Utd,2421,2,17,8,11,51,43,8,59
Morton,2421,3,16,10,10,52,41,11,58
Falkirk,2421,4,14,10,12,55,50,5,52
Queen of S't,2421,5,14,8,14,51,50,1,50
Raith,2421,6,11,11,14,35,42,-7,44
Dunfermline,2421,7,10,12,14,45,50,-5,42
Dumbarton,2421,8,10,12,14,50,56,-6,42
St Mirren,2421,9,8,12,16,43,57,-14,36
Ayr,2421,10,7,10,19,32,61,-29,31
Hibernian,2422,1,18,11,7,57,28,29,65
Dundee Utd,2422,2,19,8,9,56,34,22,65
Morton,2422,3,16,11,9,45,35,10,59
Falkirk,2422,4,14,11,11,56,49,7,53
Dunfermline,2422,5,11,14,11,43,41,2,47
Queen of S't,2422,6,12,9,15,47,53,-6,45
Ayr,2422,7,10,11,15,35,52,-17,41
Raith,2422,8,10,9,17,32,52,-20,39
St Mirren,2422,9,9,10,17,44,56,-12,37
Dumbarton,2422,10,7,14,15,43,58,-15,35
Hibernian,2423,1,18,12,6,54,28,26,66
Dundee Utd,2423,2,17,8,11,58,40,18,59
Morton,2423,3,16,11,9,47,39,8,59
Falkirk,2423,4,15,11,10,58,43,15,56
Queen of S't,2423,5,13,9,14,45,50,-5,48
Dunfermline,2423,6,12,11,13,50,46,4,47
Ayr,2423,7,11,10,15,37,56,-19,43
Dumbarton,2423,8,10,10,16,48,59,-11,40
Raith,2423,9,10,10,16,39,53,-14,40
St Mirren,2423,10,7,10,19,39,61,-22,31
Hibernian,2424,1,20,12,4,54,23,31,72
Morton,2424,2,19,10,7,46,31,15,67
Dundee Utd,2424,3,16,11,9,46,37,9,59
Falkirk,2424,4,14,11,11,52,42,10,53
Queen of S't,2424,5,13,8,15,46,47,-1,47
Ayr,2424,6,11,11,14,35,49,-14,44
Dunfermline,2424,7,10,11,15,45,46,-1,41
Raith,2424,8,10,10,16,35,50,-15,40
Dumbarton,2424,9,7,11,18,43,60,-17,32
St Mirren,2424,10,7,11,18,37,54,-17,32
Hibernian,2425,1,19,13,4,57,25,32,70
Morton,2425,2,18,9,9,51,40,11,63
Falkirk,2425,3,16,12,8,54,35,19,60
Dundee Utd,2425,4,16,10,10,52,39,13,58
Queen of S't,2425,5,12,9,15,47,47,0,45
Raith,2425,6,11,9,16,37,52,-15,42
Dunfermline,2425,7,9,12,15,46,50,-4,39
Dumbarton,2425,8,9,12,15,47,60,-13,39
St Mirren,2425,9,7,14,15,40,54,-14,35
Ayr,2425,10,8,10,18,30,59,-29,34
Hibernian,2426,1,20,11,5,58,24,34,71
Morton,2426,2,18,11,7,56,36,20,65
Falkirk,2426,3,17,10,9,60,36,24,61
Dundee Utd,2426,4,16,10,10,52,45,7,58
Dumbarton,2426,5,9,14,13,49,54,-5,41
Dunfermline,2426,6,10,11,15,47,52,-5,41
Queen of S't,2426,7,10,11,15,42,52,-10,41
Raith,2426,8,10,9,17,34,52,-18,39
Ayr,2426,9,7,14,15,30,56,-26,35
St Mirren,2426,10,8,9,19,41,62,-21,33
Hibernian,2427,1,19,12,5,56,25,31,69
Dundee Utd,2427,2,17,9,10,57,37,20,60
Morton,2427,3,15,15,6,55,40,15,60
Falkirk,2427,4,15,10,11,54,44,10,55
Queen of S't,2427,5,12,9,15,47,54,-7,45
Dunfermline,2427,6,10,13,13,43,47,-4,43
Ayr,2427,7,10,12,14,36,51,-15,42
Raith,2427,8,11,8,17,39,54,-15,41
Dumbarton,2427,9,8,11,17,48,64,-16,35
St Mirren,2427,10,8,11,17,39,58,-19,35
Hibernian,2428,1,21,11,4,54,23,31,74
Morton,2428,2,19,9,8,52,34,18,66
Falkirk,2428,3,16,11,9,58,39,19,59
Dundee Utd,2428,4,16,10,10,48,38,10,58
Dumbarton,2428,5,10,12,14,46,53,-7,42
Queen of S't,2428,6,11,8,17,43,51,-8,41
Dunfermline,2428,7,10,11,15,45,54,-9,41
Raith,2428,8,9,10,17,34,49,-15,37
St Mirren,2428,9,8,11,17,39,56,-17,35
Ayr,2428,10,7,13,16,32,54,-22,34
Hibernian,2429,1,22,10,4,59,25,34,76
Dundee Utd,2429,2,17,10,9,52,38,14,61
Morton,2429,3,16,13,7,51,38,13,61
Falkirk,2429,4,15,11,10,58,42,16,56
Dunfermline,2429,5,10,14,12,49,49,0,44
Queen of S't,2429,6,11,10,15,44,49,-5,43
Raith,2429,7,9,11,16,35,50,-15,38
Ayr,2429,8,8,12,16,35,59,-24,36
Dumbarton,2429,9,7,13,16,45,59,-14,34
St Mirren,2429,10,8,10,18,37,56,-19,34
Hibernian,2430,1,21,10,5,60,23,37,73
Dundee Utd,2430,2,19,8,9,56,39,17,65
Morton,2430,3,17,11,8,47,35,12,62
Falkirk,2430,4,13,11,12,54,45,9,50
Raith,2430,5,12,10,14,36,45,-9,46
Dunfermline,2430,6,9,14,13,46,51,-5,41
Dumbarton,2430,7,10,10,16,48,55,-7,40
Queen of S't,2430,8,10,10,16,40,56,-16,40
St Mirren,2430,9,9,10,17,40,55,-15,37
Ayr,2430,10,8,10,18,30,53,-23,34
Hibernian,2431,1,20,10,6,52,24,28,70
Morton,2431,2,18,10,8,54,36,18,64
Dundee Utd,2431,3,17,11,8,54,37,17,62
Falkirk,2431,4,16,13,7,59,38,21,61
Dunfermline,2431,5,10,14,12,44,48,-4,44
Queen of S't,2431,6,11,9,16,48,59,-11,42
Raith,2431,7,11,9,16,37,49,-12,42
Ayr,2431,8,8,11,17,36,61,-25,35
Dumbarton,2431,9,7,12,17,47,62,-15,33
St Mirren,2431,10,8,9,19,38,55,-17,33
Hibernian,2432,1,19,12,5,54,24,30,69
Dundee Utd,2432,2,17,10,9,54,40,14,61
Morton,2432,3,15,13,8,52,39,13,58
Falkirk,2432,4,16,10,10,56,44,12,58
Queen of S't,2432,5,12,10,14,45,48,-3,46
Dumbarton,2432,6,10,12,14,59,63,-4,42
Raith,2432,7,10,10,16,35,49,-14,40
Dunfermline,2432,8,9,12,15,41,52,-11,39
Ayr,2432,9,9,12,15,35,52,-17,39
St Mirren,2432,10,7,11,18,38,58,-20,32
Hibernian,2433,1,23,10,3,64,24,40,79
Morton,2433,2,17,10,9,50,37,13,61
Dundee Utd,2433,3,16,10,10,58,39,19,58
Falkirk,2433,4,14,12,10,57,44,13,54
Dunfermline,2433,5,12,12,12,47,49,-2,48
Queen of S't,2433,6,12,10,14,50,51,-1,46
Dumbarton,2433,7,9,10,17,50,67,-17,37
Raith,2433,8,9,10,17,35,55,-20,37
St Mirren,2433,9,7,14,15,40,55,-15,35
Ayr,2433,10,6,12,18,28,58,-30,30
Hibernian,2434,1,20,10,6,54,27,27,70
Morton,2434,2,19,10,7,53,31,22,67
Falkirk,2434,3,17,11,8,59,38,21,62
Dundee Utd,2434,4,14,10,12,48,45,3,52
Queen of S't,2434,5,12,9,15,44,48,-4,45
Dunfermline,2434,6,10,12,14,44,48,-4,42
Dumbarton,2434,7,9,13,14,44,54,-10,40
Raith,2434,8,10,10,16,36,47,-11,40
Ayr,2434,9,8,12,16,32,54,-22,36
St Mirren,2434,10,8,9,19,38,60,-22,33
Hibernian,2435,1,21,11,4,57,21,36,74
Falkirk,2435,2,17,12,7,63,43,20,63
Morton,2435,3,16,12,8,47,35,12,60
Dundee Utd,2435,4,14,13,9,50,41,9,55
Dunfermline,2435,5,9,15,12,43,48,-5,42
Queen of S't,2435,6,11,9,16,40,47,-7,42
Raith,2435,7,11,9,16,36,46,-10,42
Dumbarton,2435,8,10,10,16,45,55,-10,40
Ayr,2435,9,7,12,17,31,55,-24,33
St Mirren,2435,10,7,11,18,41,62,-21,32
Hibernian,2436,1,19,11,6,57,27,30,68
Morton,2436,2,18,12,6,53,36,17,66
Dundee Utd,2436,3,18,9,9,56,37,19,63
Falkirk,2436,4,16,11,9,57,42,15,59
Dunfermline,2436,5,11,12,13,46,49,-3,45
Queen of S't,2436,6,11,9,16,44,50,-6,42
Ayr,2436,7,9,10,17,33,57,-24,37
St Mirren,2436,8,8,12,16,37,53,-16,36
Raith,2436,9,8,12,16,36,54,-18,36
Dumbarton,2436,10,8,10,18,46,60,-14,34
Hibernian,2437,1,20,12,4,59,25,34,72
Dundee Utd,2437,2,17,9,10,52,39,13,60
Morton,2437,3,16,10,10,49,41,8,58
Falkirk,2437,4,14,12,10,58,44,14,54
Dunfermline,2437,5,10,15,11,45,45,0,45
St Mirren,2437,6,11,10,15,45,53,-8,43
Queen of S't,2437,7,11,10,15,45,54,-9,43
Raith,2437,8,11,8,17,37,50,-13,41
Ayr,2437,9,8,11,17,34,57,-23,35
Dumbarton,2437,10,7,13,16,47,63,-16,34
Hibernian,2438,1,19,11,6,56,27,29,68
Dundee Utd,2438,2,17,10,9,53,35,18,61
Falkirk,2438,3,17,10,9,59,43,16,61
Morton,2438,4,17,10,9,50,38,12,61
Queen of S't,2438,5,12,9,15,42,47,-5,45
Dunfermline,2438,6,9,14,13,45,49,-4,41
Dumbarton,2438,7,9,11,16,48,59,-11,38
St Mirren,2438,8,9,11,16,45,56,-11,38
Ayr,2438,9,9,11,16,36,61,-25,38
Raith,2438,10,9,9,18,34,53,-19,36
Hibernian,2439,1,19,13,4,56,24,32,70
Dundee Utd,2439,2,17,9,10,56,41,15,60
Falkirk,2439,3,16,11,9,56,40,16,59
Morton,2439,4,15,11,10,51,44,7,56
Raith,2439,5,12,10,14,39,48,-9,46
Dumbarton,2439,6,10,14,12,53,56,-3,44
Queen of S't,2439,7,10,12,14,45,53,-8,42
Dunfermline,2439,8,8,12,16,46,54,-8,36
St Mirren,2439,9,8,12,16,39,56,-17,36
Ayr,2439,10,7,12,17,34,59,-25,33
Hibernian,2440,1,20,12,4,58,26,32,72
Falkirk,2440,2,18,9,9,64,39,25,63
Morton,2440,3,17,10,9,51,42,9,61
Dundee Utd,2440,4,14,10,12,50,47,3,52
Queen of S't,2440,5,12,10,14,48,53,-5,46
Dunfermline,2440,6,11,12,13,46,47,-1,45
Raith,2440,7,9,11,16,36,51,-15,38
St Mirren,2440,8,9,10,17,45,58,-13,37
Dumbarton,2440,9,9,10,17,47,62,-15,37
Ayr,2440,10,8,12,16,39,59,-20,36
Hibernian,2441,1,20,13,3,60,24,36,73
Morton,2441,2,17,12,7,48,34,14,63
Dundee Utd,2441,3,18,8,10,52,37,15,62
Falkirk,2441,4,15,11,10,57,40,17,56
Queen of S't,2441,5,13,8,15,49,52,-3,47
Dumbarton,2441,6,9,12,15,49,61,-12,39
Raith,2441,7,10,9,17,34,51,-17,39
Dunfermline,2441,8,9,11,16,41,49,-8,38
Ayr,2441,9,8,11,17,35,60,-25,35
St Mirren,2441,10,7,13,16,38,55,-17,34
Hibernian,2442,1,18,13,5,54,26,28,67
Falkirk,2442,2,18,11,7,59,35,24,65
Morton,2442,3,18,11,7,56,36,20,65
Dundee Utd,2442,4,16,8,12,52,45,7,56
Dumbarton,2442,5,11,10,15,49,59,-10,43
Queen of S't,2442,6,10,10,16,43,53,-10,40
St Mirren,2442,7,10,10,16,39,53,-14,40
Ayr,2442,8,9,11,16,37,58,-21,38
Dunfermline,2442,9,8,13,15,45,53,-8,37
Raith,2442,10,9,9,18,35,51,-16,36
Hibernian,2443,1,20,11,5,61,26,35,71
Morton,2443,2,17,11,8,49,36,13,62
Dundee Utd,2443,3,16,10,10,52,37,15,58
Falkirk,2443,4,15,10,11,57,47,10,55
Dunfermline,2443,5,11,13,12,47,46,1,46
Dumbarton,2443,6,12,10,14,53,54,-1,46
Queen of S't,2443,7,12,9,15,48,54,-6,45
Ayr,2443,8,10,10,16,36,56,-20,40
Raith,2443,9,10,9,17,37,52,-15,39
St Mirren,2443,10,6,9,21,35,67,-32,27
Hibernian,2444,1,20,11,5,56,26,30,71
Morton,2444,2,18,10,8,50,37,13,64
Falkirk,2444,3,17,10,9,61,40,21,61
Dundee Utd,2444,4,13,10,13,42,40,2,49
Queen of S't,2444,5,12,10,14,45,47,-2,46
Dunfermline,2444,6,10,12,14,50,52,-2,42
Dumbarton,2444,7,10,10,16,51,66,-15,40
Ayr,2444,8,9,13,14,39,54,-15,40
St Mirren,2444,9,9,11,16,42,57,-15,38
Raith,2444,10,9,9,18,35,52,-17,36
Hibernian,2445,1,21,10,5,57,24,33,73
Morton,2445,2,17,10,9,48,37,11,61
Falkirk,2445,3,16,11,9,57,40,17,59
Dundee Utd,2445,4,16,11,9,50,37,13,59
Dunfermline,2445,5,10,14,12,49,49,0,44
Raith,2445,6,11,9,16,36,49,-13,42
Ayr,2445,7,10,12,14,34,50,-16,42
Queen of S't,2445,8,11,8,17,44,53,-9,41
Dumbarton,2445,9,7,12,17,45,62,-17,33
St Mirren,2445,10,8,9,19,39,58,-19,33
Hibernian,2446,1,20,12,4,58,23,35,72
Falkirk,2446,2,16,11,9,59,42,17,59
Morton,2446,3,15,12,9,47,38,9,57
Dundee Utd,2446,4,15,11,10,53,40,13,56
Queen of S't,2446,5,12,10,14,48,51,-3,46
Dunfermline,2446,6,11,11,14,43,46,-3,44
Raith,2446,7,10,9,17,36,53,-17,39
Dumbarton,2446,8,9,11,16,46,60,-14,38
Ayr,2446,9,9,11,16,37,61,-24,38
St Mirren,2446,10,9,10,17,42,55,-13,37
Hibernian,2447,1,20,10,6,56,25,31,70
Morton,2447,2,17,12,7,48,36,12,63
Falkirk,2447,3,16,12,8,57,38,19,60
Dundee Utd,2447,4,15,13,8,52,39,13,58
Queen of S't,2447,5,12,10,14,45,49,-4,46
Dumbarton,2447,6,9,12,15,44,54,-10,39
Raith,2447,7,10,9,17,32,46,-14,39
Ayr,2447,8,8,14,14,33,53,-20,38
Dunfermline,2447,9,8,12,16,41,48,-7,36
St Mirren,2447,10,8,10,18,36,56,-20,34
Morton,2448,1,19,11,6,58,32,26,68
Hibernian,2448,2,18,13,5,54,29,25,67
Dundee Utd,2448,3,17,8,11,48,39,9,59
Falkirk,2448,4,14,11,11,53,42,11,53
Queen of S't,2448,5,10,13,13,43,49,-6,43
Raith,2448,6,11,10,15,36,47,-11,43
Dunfermline,2448,7,10,12,14,44,48,-4,42
Dumbarton,2448,8,9,11,16,48,59,-11,38
St Mirren,2448,9,9,9,18,37,53,-16,36
Ayr,2448,10,8,12,16,31,54,-23,36
Hibernian,2449,1,20,12,4,55,24,31,72
Morton,2449,2,18,10,8,49,35,14,64
Falkirk,2449,3,16,12,8,58,39,19,60
Dundee Utd,2449,4,16,11,9,56,46,10,59
St Mirren,2449,5,10,11,15,49,58,-9,41
Ayr,2449,6,9,12,15,35,52,-17,39
Queen of S't,2449,7,9,11,16,40,52,-12,38
Dumbarton,2449,8,8,13,15,41,52,-11,37
Raith,2449,9,9,10,17,34,51,-17,37
Dunfermline,2449,10,8,12,16,45,53,-8,36
Hibernian,2450,1,20,10,6,57,25,32,70
Morton,2450,2,18,12,6,48,32,16,66
Dundee Utd,2450,3,16,10,10,53,39,14,58
Falkirk,2450,4,14,12,10,54,39,15,54
Dunfermline,2450,5,11,13,12,46,46,0,46
Raith,2450,6,12,9,15,41,47,-6,45
Dumbarton,2450,7,9,12,15,46,60,-14,39
Queen of S't,2450,8,10,8,18,42,61,-19,38
St Mirren,2450,9,9,10,17,43,55,-12,37
Ayr,2450,10,7,12,17,31,57,-26,33
Hibernian,2451,1,18,12,6,59,30,29,66
Falkirk,2451,2,19,9,8,59,38,21,66
Morton,2451,3,16,12,8,46,37,9,60
Dundee Utd,2451,4,14,11,11,47,40,7,53
Queen of S't,2451,5,11,11,14,44,49,-5,44
Dunfermline,2451,6,10,13,13,45,46,-1,43
Raith,2451,7,11,10,15,36,47,-11,43
St Mirren,2451,8,9,10,17,38,53,-15,37
Ayr,2451,9,8,13,15,33,55,-22,37
Dumbarton,2451,10,8,11,17,48,60,-12,35
Hibernian,2452,1,20,12,4,56,24,32,72
Morton,2452,2,17,11,8,47,34,13,62
Falkirk,2452,3,15,11,10,55,43,12,56
Dundee Utd,2452,4,16,8,12,48,40,8,56
Dumbarton,2452,5,11,11,14,54,56,-2,44
Dunfermline,2452,6,10,12,14,45,53,-8,42
Queen of S't,2452,7,11,9,16,44,52,-8,42
St Mirren,2452,8,10,10,16,40,52,-12,40
Ayr,2452,9,8,13,15,32,50,-18,37
Raith,2452,10,9,9,18,34,51,-17,36
Hibernian,2453,1,20,11,5,53,27,26,71
Morton,2453,2,20,10,6,58,34,24,70
Falkirk,2453,3,15,10,11,56,43,13,55
Dundee Utd,2453,4,13,13,10,49,44,5,52
Queen of S't,2453,5,13,8,15,46,47,-1,47
Raith,2453,6,11,8,17,36,51,-15,41
Ayr,2453,7,9,13,14,32,47,-15,40
Dumbarton,2453,8,8,13,15,46,60,-14,37
Dunfermline,2453,9,7,15,14,49,57,-8,36
St Mirren,2453,10,8,11,17,38,53,-15,35
Hibernian,2454,1,20,12,4,60,28,32,72
Morton,2454,2,18,9,9,54,38,16,63
Dundee Utd,2454,3,17,10,9,53,35,18,61
Falkirk,2454,4,16,12,8,57,35,22,60
Queen of S't,2454,5,12,10,14,47,51,-4,46
Dunfermline,2454,6,10,14,12,45,47,-2,44
Raith,2454,7,10,9,17,36,53,-17,39
Dumbarton,2454,8,8,11,17,42,58,-16,35
St Mirren,2454,9,7,12,17,39,56,-17,33
Ayr,2454,10,7,11,18,30,62,-32,32
Hibernian,2455,1,17,15,4,55,26,29,66
Morton,2455,2,18,12,6,50,29,21,66
Dundee Utd,2455,3,17,8,11,50,44,6,59
Falkirk,2455,4,15,12,9,59,43,16,57
Dumbarton,2455,5,12,10,14,50,53,-3,46
Queen of S't,2455,6,11,9,16,40,48,-8,42
Dunfermline,2455,7,9,14,13,44,46,-2,41
Raith,2455,8,9,12,15,34,49,-15,39
St Mirren,2455,9,8,11,17,41,58,-17,35
Ayr,2455,10,6,13,17,32,59,-27,31
Hibernian,2456,1,22,11,3,63,24,39,77
Falkirk,2456,2,16,10,10,59,40,19,58
Morton,2456,3,15,11,10,52,41,11,56
Dundee Utd,2456,4,15,10,11,46,42,4,55
Dunfermline,2456,5,11,14,11,51,51,0,47
Queen of S't,2456,6,11,12,13,45,48,-3,45
St Mirren,2456,7,10,9,17,41,57,-16,39
Dumbarton,2456,8,9,11,16,46,56,-10,38
Raith,2456,9,9,9,18,31,51,-20,36
Ayr,2456,10,8,11,17,32,56,-24,35
Hibernian,2457,1,18,10,8,51,31,20,64
Falkirk,2457,2,16,11,9,62,42,20,59
Morton,2457,3,16,11,9,49,36,13,59
Dundee Utd,2457,4,16,9,11,55,43,12,57
Dumbarton,2457,5,13,10,13,57,53,4,49
Queen of S't,2457,6,11,9,16,44,55,-11,42
Raith,2457,7,10,11,15,31,48,-17,41
St Mirren,2457,8,10,10,16,44,57,-13,40
Dunfermline,2457,9,9,12,15,49,54,-5,39
Ayr,2457,10,9,11,16,38,61,-23,38
Hibernian,2458,1,17,12,7,55,29,26,63
Dundee Utd,2458,2,18,9,9,53,40,13,63
Morton,2458,3,15,12,9,49,41,8,57
Falkirk,2458,4,14,12,10,56,41,15,54
Dunfermline,2458,5,11,13,12,45,44,1,46
Dumbarton,2458,6,11,10,15,48,55,-7,43
Queen of S't,2458,7,11,10,15,43,50,-7,43
Raith,2458,8,10,12,14,33,45,-12,42
Ayr,2458,9,9,12,15,35,53,-18,39
St Mirren,2458,10,6,14,16,40,59,-19,32
Hibernian,2459,1,18,12,6,55,29,26,66
Falkirk,2459,2,17,11,8,60,36,24,62
Morton,2459,3,17,10,9,50,35,15,61
Dundee Utd,2459,4,14,12,10,54,49,5,54
Dunfermline,2459,5,12,14,10,50,45,5,50
Raith,2459,6,12,8,16,39,48,-9,44
Queen of S't,2459,7,11,10,15,49,54,-5,43
Ayr,2459,8,9,12,15,37,56,-19,39
Dumbarton,2459,9,8,13,15,51,64,-13,37
St Mirren,2459,10,6,10,20,38,67,-29,28
Hibernian,2460,1,21,10,5,59,26,33,73
Morton,2460,2,16,12,8,54,42,12,60
Dundee Utd,2460,3,14,13,9,47,38,9,55
Falkirk,2460,4,13,11,12,52,45,7,50
Queen of S't,2460,5,13,10,13,47,47,0,49
Dunfermline,2460,6,10,14,12,46,46,0,44
Dumbarton,2460,7,8,14,14,43,52,-9,38
Raith,2460,8,9,11,16,35,50,-15,38
St Mirren,2460,9,9,10,17,37,54,-17,37
Ayr,2460,10,8,13,15,34,54,-20,37
Hibernian,2461,1,18,12,6,54,29,25,66
Morton,2461,2,16,11,9,46,37,9,59
Falkirk,2461,3,16,9,11,57,45,12,57
Dundee Utd,2461,4,16,9,11,49,40,9,57
Dunfermline,2461,5,13,11,12,53,45,8,50
St Mirren,2461,6,12,10,14,45,49,-4,46
Queen of S't,2461,7,11,10,15,43,49,-6,43
Raith,2461,8,10,9,17,34,50,-16,39
Ayr,2461,9,9,12,15,35,52,-17,39
Dumbarton,2461,10,7,11,18,42,62,-20,32
Hibernian,2462,1,20,11,5,56,24,32,71
Falkirk,2462,2,16,12,8,57,37,20,60
Dundee Utd,2462,3,16,10,10,50,38,12,58
Morton,2462,4,16,10,10,49,38,11,58
Dunfermline,2462,5,11,13,12,48,47,1,46
Queen of S't,2462,6,11,10,15,42,49,-7,43
Dumbarton,2462,7,11,10,15,50,58,-8,43
Raith,2462,8,10,10,16,35,47,-12,40
Ayr,2462,9,8,11,17,30,57,-27,35
St Mirren,2462,10,7,11,18,34,56,-22,32
Hibernian,2463,1,19,11,6,56,28,28,68
Falkirk,2463,2,16,12,8,60,44,16,60
Dundee Utd,2463,3,14,12,10,46,40,6,54
Morton,2463,4,14,11,11,47,40,7,53
Dunfermline,2463,5,12,12,12,46,46,0,48
Raith,2463,6,11,11,14,37,45,-8,44
Queen of S't,2463,7,10,10,16,43,53,-10,40
St Mirren,2463,8,10,9,17,41,55,-14,39
Ayr,2463,9,8,15,13,33,49,-16,39
Dumbarton,2463,10,9,11,16,51,60,-9,38
Morton,2464,1,19,12,5,57,32,25,69
Hibernian,2464,2,18,12,6,52,26,26,66
Falkirk,2464,3,17,11,8,56,35,21,62
Dundee Utd,2464,4,16,10,10,48,39,9,58
Queen of S't,2464,5,11,11,14,46,49,-3,44
Dunfermline,2464,6,9,13,14,48,53,-5,40
St Mirren,2464,7,9,11,16,40,54,-14,38
Raith,2464,8,9,11,16,31,48,-17,38
Dumbarton,2464,9,8,11,17,46,64,-18,35
Ayr,2464,10,7,12,17,35,59,-24,33
Hibernian,2465,1,19,13,4,58,24,34,70
Morton,2465,2,17,13,6,53,35,18,64
Dundee Utd,2465,3,17,10,9,50,35,15,61
Falkirk,2465,4,13,14,9,53,41,12,53
Raith,2465,5,12,10,14,36,44,-8,46
Dunfermline,2465,6,10,14,12,50,51,-1,44
Queen of S't,2465,7,10,11,15,42,53,-11,41
Ayr,2465,8,8,11,17,32,60,-28,35
Dumbarton,2465,9,7,12,17,48,62,-14,33
St Mirren,2465,10,7,12,17,38,55,-17,33
Hibernian,2466,1,17,16,3,51,23,28,67
Morton,2466,2,18,12,6,52,32,20,66
Falkirk,2466,3,17,11,8,63,39,24,62
Dundee Utd,2466,4,16,9,11,50,46,4,57
Dunfermline,2466,5,9,13,14,44,47,-3,40
Queen of S't,2466,6,9,13,14,40,49,-9,40
Ayr,2466,7,9,13,14,36,51,-15,40
Dumbarton,2466,8,8,13,15,47,57,-10,37
St Mirren,2466,9,8,11,17,40,57,-17,35
Raith,2466,10,8,11,17,32,54,-22,35
Hibernian,2467,1,19,12,5,59,24,35,69
Morton,2467,2,18,12,6,53,37,16,66
Dundee Utd,2467,3,17,10,9,59,38,21,61
Falkirk,2467,4,14,12,10,52,38,14,54
Queen of S't,2467,5,12,11,13,44,48,-4,47
Raith,2467,6,11,10,15,41,53,-12,43
Dunfermline,2467,7,10,11,15,47,55,-8,41
St Mirren,2467,8,9,10,17,39,52,-13,37
Dumbarton,2467,9,9,10,17,46,63,-17,37
Ayr,2467,10,6,12,18,30,62,-32,30
Hibernian,2468,1,18,14,4,53,26,27,68
Morton,2468,2,15,13,8,49,36,13,58
Dundee Utd,2468,3,14,12,10,47,40,7,54
Falkirk,2468,4,14,11,11,51,41,10,53
Queen of S't,2468,5,13,11,12,48,48,0,50
Dunfermline,2468,6,11,11,14,50,51,-1,44
Dumbarton,2468,7,10,12,14,48,54,-6,42
Ayr,2468,8,8,14,14,32,51,-19,38
Raith,2468,9,8,13,15,35,49,-14,37
St Mirren,2468,10,8,11,17,38,55,-17,35
Hibernian,2469,1,17,14,5,51,24,27,65
Morton,2469,2,17,11,8,54,36,18,62
Falkirk,2469,3,15,12,9,55,40,15,57
Dundee Utd,2469,4,15,11,10,52,41,11,56
Dunfermline,2469,5,11,14,11,48,44,4,47
Queen of S't,2469,6,12,9,15,48,52,-4,45
Raith,2469,7,11,11,14,40,48,-8,44
Dumbarton,2469,8,9,11,16,47,62,-15,38
St Mirren,2469,9,8,11,17,41,57,-16,35
Ayr,2469,10,7,12,17,32,64,-32,33
Falkirk,2470,1,18,11,7,60,38,22,65
Hibernian,2470,2,17,13,6,54,27,27,64
Morton,2470,3,16,13,7,51,36,15,61
Dundee Utd,2470,4,17,9,10,49,38,11,60
Raith,2470,5,12,10,14,38,45,-7,46
Dunfermline,2470,6,9,15,12,50,51,-1,42
Queen of S't,2470,7,9,10,17,40,58,-18,37
Ayr,2470,8,8,13,15,32,55,-23,37
St Mirren,2470,9,8,11,17,40,54,-14,35
Dumbarton,2470,10,7,13,16,46,58,-12,34
Hibernian,2471,1,21,10,5,57,24,33,73
Falkirk,2471,2,18,10,8,59,39,20,64
Morton,2471,3,16,11,9,50,39,11,59
Dunfermline,2471,4,11,15,10,49,46,3,48
Dundee Utd,2471,5,13,9,14,48,46,2,48
Queen of S't,2471,6,12,10,14,45,50,-5,46
Ayr,2471,7,9,12,15,32,50,-18,39
Dumbarton,2471,8,8,14,14,45,54,-9,38
Raith,2471,9,9,11,16,34,50,-16,38
St Mirren,2471,10,7,10,19,40,61,-21,31
Hibernian,2472,1,19,11,6,53,28,25,68
Morton,2472,2,17,10,9,51,38,13,61
Falkirk,2472,3,16,11,9,61,41,20,59
Dundee Utd,2472,4,16,11,9,52,42,10,59
Queen of S't,2472,5,12,10,14,48,47,1,46
Raith,2472,6,12,9,15,36,47,-11,45
Dunfermline,2472,7,10,13,13,49,50,-1,43
Dumbarton,2472,8,9,12,15,48,59,-11,39
Ayr,2472,9,7,12,17,35,63,-28,33
St Mirren,2472,10,7,11,18,39,57,-18,32
Morton,2473,1,18,11,7,57,35,22,65
Falkirk,2473,2,17,11,8,60,38,22,62
Hibernian,2473,3,16,14,6,51,31,20,62
Dundee Utd,2473,4,14,12,10,55,42,13,54
Queen of S't,2473,5,11,12,13,44,49,-5,45
Dunfermline,2473,6,10,13,13,47,53,-6,43
St Mirren,2473,7,10,10,16,44,55,-11,40
Dumbarton,2473,8,9,12,15,51,60,-9,39
Ayr,2473,9,9,12,15,38,62,-24,39
Raith,2473,10,8,9,19,33,55,-22,33
Hibernian,2474,1,18,12,6,54,28,26,66
Dundee Utd,2474,2,17,10,9,53,38,15,61
Falkirk,2474,3,16,9,11,56,41,15,57
Morton,2474,4,15,12,9,49,40,9,57
Dunfermline,2474,5,12,13,11,48,46,2,49
Queen of S't,2474,6,10,12,14,44,49,-5,42
St Mirren,2474,7,10,9,17,43,54,-11,39
Raith,2474,8,10,9,17,33,46,-13,39
Dumbarton,2474,9,9,11,16,47,63,-16,38
Ayr,2474,10,8,13,15,33,55,-22,37
Hibernian,2475,1,21,11,4,59,26,33,74
Morton,2475,2,19,10,7,55,36,19,67
Falkirk,2475,3,17,11,8,58,37,21,62
Dundee Utd,2475,4,14,12,10,49,41,8,54
Queen of S't,2475,5,12,9,15,41,48,-7,45
Dumbarton,2475,6,11,10,15,55,59,-4,43
Raith,2475,7,10,10,16,33,48,-15,40
Dunfermline,2475,8,7,13,16,45,56,-11,34
Ayr,2475,9,7,13,16,35,58,-23,34
St Mirren,2475,10,8,9,19,35,56,-21,33
Hibernian,2476,1,21,11,4,57,21,36,74
Morton,2476,2,17,11,8,51,36,15,62
Dundee Utd,2476,3,15,11,10,49,37,12,56
Falkirk,2476,4,15,10,11,56,41,15,55
Queen of S't,2476,5,15,9,12,49,45,4,54
Dunfermline,2476,6,9,13,14,41,52,-11,40
St Mirren,2476,7,10,10,16,43,56,-13,40
Raith,2476,8,10,9,17,37,50,-13,39
Ayr,2476,9,8,10,18,32,62,-30,34
Dumbarton,2476,10,7,12,17,43,58,-15,33
Hibernian,2477,1,20,12,4,54,22,32,72
Morton,2477,2,16,12,8,54,37,17,60
Dundee Utd,2477,3,17,9,10,51,40,11,60
Falkirk,2477,4,16,10,10,60,42,18,58
Dunfermline,2477,5,12,12,12,48,46,2,48
Ayr,2477,6,9,12,15,32,49,-17,39
Dumbarton,2477,7,9,11,16,45,55,-10,38
Queen of S't,2477,8,9,10,17,38,54,-16,37
Raith,2477,9,9,10,17,33,50,-17,37
St Mirren,2477,10,8,12,16,39,59,-20,36
Hibernian,2478,1,22,11,3,62,25,37,77
Morton,2478,2,17,10,9,50,39,11,61
Falkirk,2478,3,17,9,10,57,39,18,60
Dundee Utd,2478,4,16,9,11,49,39,10,57
Queen of S't,2478,5,13,9,14,47,48,-1,48
Dunfermline,2478,6,9,14,13,48,53,-5,41
Dumbarton,2478,7,9,12,15,48,57,-9,39
Ayr,2478,8,9,11,16,33,53,-20,38
Raith,2478,9,9,8,19,29,53,-24,35
St Mirren,2478,10,8,9,19,40,57,-17,33
Hibernian,2479,1,20,12,4,59,26,33,72
Dundee Utd,2479,2,16,11,9,48,38,10,59
Falkirk,2479,3,16,10,10,53,36,17,58
Morton,2479,4,15,10,11,49,41,8,55
Raith,2479,5,12,10,14,34,46,-12,46
Queen of S't,2479,6,10,11,15,44,52,-8,41
Dunfermline,2479,7,9,13,14,45,48,-3,40
St Mirren,2479,8,9,12,15,39,52,-13,39
Dumbarton,2479,9,8,13,15,46,56,-10,37
Ayr,2479,10,8,12,16,31,53,-22,36
Hibernian,2480,1,21,10,5,63,26,37,73
Dundee Utd,2480,2,17,9,10,51,39,12,60
Morton,2480,3,15,12,9,47,38,9,57
Falkirk,2480,4,14,11,11,53,45,8,53
Queen of S't,2480,5,12,11,13,46,49,-3,47
Dunfermline,2480,6,11,12,13,46,48,-2,45
Dumbarton,2480,7,9,13,14,52,60,-8,40
St Mirren,2480,8,9,10,17,45,61,-16,37
Raith,2480,9,9,10,17,31,50,-19,37
Ayr,2480,10,7,14,15,38,56,-18,35
Hibernian,2481,1,18,13,5,54,25,29,67
Dundee Utd,2481,2,18,10,8,52,37,15,64
Morton,2481,3,16,14,6,51,33,18,62
Falkirk,2481,4,16,10,10,57,42,15,58
Queen of S't,2481,5,13,8,15,46,52,-6,47
Raith,2481,6,10,10,16,33,46,-13,40
Dunfermline,2481,7,9,12,15,44,49,-5,39
St Mirren,2481,8,9,11,16,38,53,-15,38
Dumbarton,2481,9,8,11,17,45,60,-15,35
Ayr,2481,10,8,11,17,30,53,-23,35
Hibernian,2482,1,18,12,6,54,24,30,66
Morton,2482,2,17,13,6,56,35,21,64
Dundee Utd,2482,3,16,11,9,52,38,14,59
Falkirk,2482,4,16,10,10,58,40,18,58
Queen of S't,2482,5,13,9,14,46,46,0,48
Dunfermline,2482,6,11,11,14,44,56,-12,44
Dumbarton,2482,7,10,12,14,54,58,-4,42
Raith,2482,8,9,9,18,32,53,-21,36
Ayr,2482,9,8,11,17,32,57,-25,35
St Mirren,2482,10,7,12,17,39,60,-21,33
Hibernian,2483,1,20,12,4,57,26,31,72
Morton,2483,2,16,11,9,46,36,10,59
Falkirk,2483,3,16,10,10,58,42,16,58
Dundee Utd,2483,4,16,9,11,49,40,9,57
Dunfermline,2483,5,11,12,13,50,48,2,45
Raith,2483,6,11,9,16,35,50,-15,42
Ayr,2483,7,10,12,14,34,51,-17,42
Queen of S't,2483,8,10,9,17,43,52,-9,39
Dumbarton,2483,9,8,13,15,47,57,-10,37
St Mirren,2483,10,8,11,17,43,60,-17,35
Hibernian,2484,1,18,14,4,52,24,28,68
Falkirk,2484,2,16,10,10,59,42,17,58
Morton,2484,3,15,13,8,46,38,8,58
Dundee Utd,2484,4,15,9,12,48,44,4,54
Queen of S't,2484,5,13,9,14,45,44,1,48
Dumbarton,2484,6,12,11,13,53,54,-1,47
Raith,2484,7,12,8,16,34,45,-11,44
Dunfermline,2484,8,9,12,15,47,55,-8,39
Ayr,2484,9,8,11,17,31,52,-21,35
St Mirren,2484,10,7,13,16,37,54,-17,34
Hibernian,2485,1,19,12,5,56,26,30,69
Morton,2485,2,18,11,7,54,35,19,65
Falkirk,2485,3,18,9,9,63,41,22,63
Dundee Utd,2485,4,15,10,11,50,39,11,55
Dunfermline,2485,5,10,13,13,46,49,-3,43
Raith,2485,6,10,10,16,32,47,-15,40
Queen of S't,2485,7,10,9,17,40,54,-14,39
St Mirren,2485,8,9,11,16,39,58,-19,38
Ayr,2485,9,9,11,16,33,52,-19,38
Dumbarton,2485,10,9,10,17,52,64,-12,37
Hibernian,2486,1,20,10,6,55,26,29,70
Morton,2486,2,17,10,9,45,34,11,61
Falkirk,2486,3,17,9,10,59,42,17,60
Dundee Utd,2486,4,15,8,13,54,45,9,53
Dunfermline,2486,5,12,12,12,49,46,3,48
Queen of S't,2486,6,12,8,16,47,53,-6,44
St Mirren,2486,7,11,10,15,40,52,-12,43
Ayr,2486,8,9,12,15,37,53,-16,39
Raith,2486,9,9,10,17,33,52,-19,37
Dumbarton,2486,10,7,13,16,44,60,-16,34
Hibernian,2487,1,20,11,5,58,26,32,71
Dundee Utd,2487,2,19,8,9,52,36,16,65
Falkirk,2487,3,17,10,9,60,41,19,61
Morton,2487,4,16,11,9,48,38,10,59
Queen of S't,2487,5,11,10,15,44,51,-7,43
Dunfermline,2487,6,9,13,14,47,52,-5,40
Dumbarton,2487,7,9,12,15,50,59,-9,39
Ayr,2487,8,9,12,15,36,55,-19,39
Raith,2487,9,9,9,18,35,53,-18,36
St Mirren,2487,10,8,10,18,37,56,-19,34
Hibernian,2488,1,19,11,6,56,26,30,68
Dundee Utd,2488,2,17,9,10,49,39,10,60
Morton,2488,3,16,10,10,51,44,7,58
Falkirk,2488,4,15,10,11,57,44,13,55
Dunfermline,2488,5,11,12,13,49,49,0,45
Queen of S't,2488,6,12,9,15,44,50,-6,45
Raith,2488,7,12,8,16,37,45,-8,44
St Mirren,2488,8,9,11,16,40,56,-16,38
Ayr,2488,9,8,13,15,35,54,-19,37
Dumbarton,2488,10,7,15,14,43,54,-11,36
Hibernian,2489,1,18,11,7,54,28,26,65
Morton,2489,2,17,11,8,51,36,15,62
Dundee Utd,2489,3,17,10,9,58,39,19,61
Falkirk,2489,4,15,11,10,58,43,15,56
Dunfermline,2489,5,11,12,13,45,48,-3,45
Dumbarton,2489,6,11,11,14,49,59,-10,44
Queen of S't,2489,7,11,8,17,43,52,-9,41
St Mirren,2489,8,10,10,16,47,60,-13,40
Raith,2489,9,9,11,16,37,51,-14,38
Ayr,2489,10,8,11,17,35,61,-26,35
Hibernian,2490,1,18,11,7,56,31,25,65
Morton,2490,2,18,11,7,55,39,16,65
Falkirk,2490,3,15,13,8,58,38,20,58
Dundee Utd,2490,4,14,10,12,49,43,6,52
Dumbarton,2490,5,11,12,13,49,53,-4,45
Queen of S't,2490,6,11,11,14,44,49,-5,44
Dunfermline,2490,7,8,16,12,42,46,-4,40
Ayr,2490,8,9,13,14,36,53,-17,40
Raith,2490,9,9,12,15,33,48,-15,39
St Mirren,2490,10,8,9,19,38,60,-22,33
Morton,2491,1,18,12,6,50,33,17,66
Hibernian,2491,2,17,13,6,52,29,23,64
Dundee Utd,2491,3,14,13,9,46,38,8,55
Falkirk,2491,4,14,12,10,55,40,15,54
Dunfermline,2491,5,11,13,12,49,45,4,46
Queen of S't,2491,6,10,12,14,43,53,-10,42
Dumbarton,2491,7,10,11,15,50,58,-8,41
Raith,2491,8,10,11,15,36,48,-12,41
St Mirren,2491,9,10,9,17,42,54,-12,39
Ayr,2491,10,7,12,17,34,59,-25,33
Hibernian,2492,1,21,10,5,56,24,32,73
Morton,2492,2,17,13,6,55,37,18,64
Dundee Utd,2492,3,17,11,8,52,35,17,62
Falkirk,2492,4,16,9,11,61,46,15,57
Queen of S't,2492,5,12,10,14,47,47,0,46
Dunfermline,2492,6,9,14,13,47,49,-2,41
St Mirren,2492,7,9,11,16,41,55,-14,38
Dumbarton,2492,8,7,14,15,43,59,-16,35
Raith,2492,9,8,11,17,36,59,-23,35
Ayr,2492,10,6,13,17,27,54,-27,31
Morton,2493,1,19,11,6,58,35,23,68
Hibernian,2493,2,17,15,4,48,22,26,66
Falkirk,2493,3,15,11,10,56,40,16,56
Queen of S't,2493,4,14,10,12,49,45,4,52
Dundee Utd,2493,5,14,10,12,46,43,3,52
St Mirren,2493,6,10,11,15,42,55,-13,41
Dunfermline,2493,7,9,13,14,46,49,-3,40
Raith,2493,8,10,10,16,34,50,-16,40
Ayr,2493,9,8,11,17,32,53,-21,35
Dumbarton,2493,10,7,12,17,46,65,-19,33
Hibernian,2494,1,20,12,4,59,24,35,72
Morton,2494,2,17,12,7,52,36,16,63
Falkirk,2494,3,16,9,11,57,43,14,57
Dundee Utd,2494,4,14,13,9,49,44,5,55
Queen of S't,2494,5,13,9,14,47,48,-1,48
Dunfermline,2494,6,11,13,12,50,45,5,46
Raith,2494,7,10,9,17,40,55,-15,39
Ayr,2494,8,7,15,14,39,59,-20,36
St Mirren,2494,9,8,10,18,36,61,-25,34
Dumbarton,2494,10,7,12,17,44,58,-14,33
Hibernian,2495,1,19,11,6,56,28,28,68
Morton,2495,2,18,9,9,49,38,11,63
Falkirk,2495,3,15,12,9,58,41,17,57
Dundee Utd,2495,4,14,10,12,49,43,6,52
Queen of S't,2495,5,13,9,14,47,47,0,48
Dumbarton,2495,6,11,11,14,54,58,-4,44
Ayr,2495,7,10,10,16,34,53,-19,40
Dunfermline,2495,8,8,15,13,47,51,-4,39
St Mirren,2495,9,9,11,16,40,54,-14,38
Raith,2495,10,9,10,17,32,53,-21,37
Morton,2496,1,19,10,7,54,36,18,67
Hibernian,2496,2,17,14,5,54,30,24,65
Falkirk,2496,3,17,11,8,58,38,20,62
Dundee Utd,2496,4,16,9,11,48,39,9,57
Queen of S't,2496,5,13,10,13,44,43,1,49
Dunfermline,2496,6,9,14,13,45,49,-4,41
Raith,2496,7,10,10,16,37,50,-13,40
Ayr,2496,8,8,12,16,35,55,-20,36
Dumbarton,2496,9,8,10,18,46,63,-17,34
St Mirren,2496,10,7,12,17,36,54,-18,33
Hibernian,2497,1,18,13,5,53,27,26,67
Falkirk,2497,2,17,9,10,59,40,19,60
Dundee Utd,2497,3,17,8,11,51,39,12,59
Morton,2497,4,13,14,9,46,40,6,53
Dunfermline,2497,5,11,13,12,46,46,0,46
Queen of S't,2497,6,12,9,15,48,49,-1,45
Ayr,2497,7,10,10,16,38,54,-16,40
St Mirren,2497,8,9,12,15,40,54,-14,39
Dumbarton,2497,9,9,11,16,47,63,-16,38
Raith,2497,10,9,11,16,36,52,-16,38
Hibernian,2498,1,19,13,4,57,27,30,70
Morton,2498,2,17,13,6,54,36,18,64
Dundee Utd,2498,3,15,13,8,48,36,12,58
Falkirk,2498,4,14,11,11,57,44,13,53
Queen of S't,2498,5,14,10,12,46,45,1,52
Raith,2498,6,11,9,16,40,50,-10,42
Dunfermline,2498,7,9,13,14,43,49,-6,40
Dumbarton,2498,8,8,11,17,44,56,-12,35
Ayr,2498,9,7,13,16,30,57,-27,34
St Mirren,2498,10,7,12,17,37,56,-19,33
Hibernian,2499,1,20,11,5,58,24,34,71
Falkirk,2499,2,17,10,9,61,43,18,61
Morton,2499,3,17,10,9,51,43,8,61
Dundee Utd,2499,4,16,8,12,51,43,8,56
Queen of S't,2499,5,13,11,12,43,44,-1,50
Dunfermline,2499,6,12,11,13,52,51,1,47
Dumbarton,2499,7,9,10,17,46,55,-9,37
Raith,2499,8,9,10,17,35,56,-21,37
Ayr,2499,9,8,11,17,34,55,-21,35
St Mirren,2499,10,8,10,18,39,56,-17,34
Hibernian,2500,1,19,10,7,51,28,23,67
Morton,2500,2,18,12,6,51,31,20,66
Dundee Utd,2500,3,17,8,11,53,40,13,59
Falkirk,2500,4,16,10,10,54,39,15,58
Dunfermline,2500,5,11,12,13,44,47,-3,45
St Mirren,2500,6,11,9,16,40,50,-10,42
Queen of S't,2500,7,11,8,17,46,52,-6,41
Dumbarton,2500,8,10,11,15,46,54,-8,41
Raith,2500,9,10,10,16,34,50,-16,40
Ayr,2500,10,6,12,18,29,57,-28,30
Hibernian,2501,1,21,11,4,61,23,38,74
Falkirk,2501,2,16,11,9,59,39,20,59
Dundee Utd,2501,3,16,11,9,53,41,12,59
Morton,2501,4,14,11,11,44,39,5,53
Queen of S't,2501,5,12,11,13,46,47,-1,47
Raith,2501,6,11,9,16,34,50,-16,42
Dunfermline,2501,7,9,12,15,46,53,-7,39
Dumbarton,2501,8,9,12,15,49,60,-11,39
Ayr,2501,9,8,13,15,31,53,-22,37
St Mirren,2501,10,8,11,17,41,59,-18,35
Hibernian,2502,1,19,11,6,53,24,29,68
Falkirk,2502,2,17,10,9,59,41,18,61
Morton,2502,3,15,13,8,46,34,12,58
Dundee Utd,2502,4,14,11,11,48,42,6,53
St Mirren,2502,5,11,10,15,46,53,-7,43
Queen of S't,2502,6,10,11,15,42,54,-12,41
Raith,2502,7,10,11,15,32,45,-13,41
Dumbarton,2502,8,9,13,14,48,57,-9,40
Dunfermline,2502,9,8,15,13,41,47,-6,39
Ayr,2502,10,8,13,15,36,54,-18,37
Hibernian,2503,1,20,13,3,53,23,30,73
Falkirk,2503,2,17,10,9,57,38,19,61
Morton,2503,3,16,11,9,51,38,13,59
Dundee Utd,2503,4,14,11,11,48,42,6,53
Queen of S't,2503,5,11,10,15,44,50,-6,43
Raith,2503,6,11,9,16,38,49,-11,42
St Mirren,2503,7,10,11,15,41,52,-11,41
Dumbarton,2503,8,9,11,16,43,57,-14,38
Dunfermline,2503,9,8,13,15,41,50,-9,37
Ayr,2503,10,8,13,15,36,53,-17,37
Hibernian,2504,1,20,12,4,55,23,32,72
Morton,2504,2,16,12,8,51,34,17,60
Falkirk,2504,3,17,9,10,58,42,16,60
Dundee Utd,2504,4,16,10,10,55,46,9,58
Queen of S't,2504,5,13,9,14,50,49,1,48
Dumbarton,2504,6,11,12,13,53,56,-3,45
Dunfermline,2504,7,8,14,14,43,51,-8,38
Raith,2504,8,10,8,18,30,52,-22,38
St Mirren,2504,9,7,12,17,37,55,-18,33
Ayr,2504,10,7,12,17,35,59,-24,33
Morton,2505,1,19,10,7,51,31,20,67
Hibernian,2505,2,18,12,6,54,27,27,66
Dundee Utd,2505,3,15,10,11,49,41,8,55
Falkirk,2505,4,13,10,13,53,48,5,49
Raith,2505,5,13,9,14,40,47,-7,48
Dunfermline,2505,6,9,16,11,41,42,-1,43
Dumbarton,2505,7,9,13,14,54,62,-8,40
Queen of S't,2505,8,10,10,16,46,57,-11,40
Ayr,2505,9,10,10,16,40,57,-17,40
St Mirren,2505,10,8,12,16,40,56,-16,36
Hibernian,2506,1,19,13,4,56,24,32,70
Falkirk,2506,2,18,9,9,62,40,22,63
Morton,2506,3,16,13,7,49,35,14,61
Dundee Utd,2506,4,16,9,11,47,40,7,57
Queen of S't,2506,5,13,9,14,43,48,-5,48
St Mirren,2506,6,10,10,16,43,53,-10,40
Raith,2506,7,10,10,16,34,50,-16,40
Dumbarton,2506,8,9,11,16,48,56,-8,38
Ayr,2506,9,7,14,15,31,53,-22,35
Dunfermline,2506,10,7,12,17,38,52,-14,33
Hibernian,2507,1,21,12,3,57,23,34,75
Dundee Utd,2507,2,17,9,10,51,38,13,60
Morton,2507,3,16,12,8,49,39,10,60
Falkirk,2507,4,14,11,11,58,47,11,53
Queen of S't,2507,5,14,8,14,49,49,0,50
Dunfermline,2507,6,11,12,13,48,49,-1,45
Dumbarton,2507,7,10,11,15,50,59,-9,41
Raith,2507,8,10,9,17,36,49,-13,39
St Mirren,2507,9,8,9,19,40,57,-17,33
Ayr,2507,10,7,11,18,30,58,-28,32
Hibernian,2508,1,19,13,4,56,26,30,70
Falkirk,2508,2,16,12,8,57,40,17,60
Morton,2508,3,16,11,9,50,39,11,59
Dundee Utd,2508,4,15,10,11,52,44,8,55
Dumbarton,2508,5,11,12,13,58,57,1,45
Queen of S't,2508,6,11,10,15,47,53,-6,43
Dunfermline,2508,7,10,11,15,45,52,-7,41
St Mirren,2508,8,10,10,16,42,55,-13,40
Raith,2508,9,9,10,17,31,49,-18,37
Ayr,2508,10,7,13,16,35,58,-23,34
Hibernian,2509,1,19,11,6,58,30,28,68
Morton,2509,2,18,10,8,51,39,12,64
Dundee Utd,2509,3,18,9,9,56,41,15,63
Falkirk,2509,4,16,9,11,56,42,14,57
Dunfermline,2509,5,10,13,13,51,51,0,43
Queen of S't,2509,6,11,10,15,52,61,-9,43
Raith,2509,7,11,10,15,39,51,-12,43
Dumbarton,2509,8,9,10,17,44,55,-11,37
Ayr,2509,9,7,14,15,35,55,-20,35
St Mirren,2509,10,7,12,17,37,54,-17,33
Hibernian,2510,1,18,12,6,54,27,27,66
Falkirk,2510,2,16,12,8,60,40,20,60
Dundee Utd,2510,3,16,11,9,52,41,11,59
Morton,2510,4,16,10,10,45,37,8,58
Dunfermline,2510,5,10,16,10,46,45,1,46
Queen of S't,2510,6,11,10,15,45,52,-7,43
Raith,2510,7,9,12,15,32,44,-12,39
St Mirren,2510,8,10,9,17,37,52,-15,39
Ayr,2510,9,8,13,15,34,54,-20,37
Dumbarton,2510,10,8,11,17,47,60,-13,35
Hibernian,2511,1,18,12,6,50,25,25,66
Morton,2511,2,19,9,8,52,39,13,66
Falkirk,2511,3,15,10,11,57,45,12,55
Dundee Utd,2511,4,14,10,12,45,41,4,52
Raith,2511,5,13,8,15,41,51,-10,47
St Mirren,2511,6,12,9,15,47,52,-5,45
Dunfermline,2511,7,9,13,14,43,46,-3,40
Dumbarton,2511,8,10,10,16,51,57,-6,40
Queen of S't,2511,9,10,10,16,41,51,-10,40
Ayr,2511,10,9,11,16,34,54,-20,38
Hibernian,2512,1,21,12,3,58,23,35,75
Dundee Utd,2512,2,16,11,9,50,33,17,59
Falkirk,2512,3,16,11,9,56,40,16,59
Morton,2512,4,14,13,9,45,38,7,55
Dunfermline,2512,5,11,13,12,50,48,2,46
Raith,2512,6,11,8,17,38,48,-10,41
Dumbarton,2512,7,10,11,15,48,62,-14,41
Queen of S't,2512,8,10,8,18,39,50,-11,38
St Mirren,2512,9,9,10,17,44,59,-15,37
Ayr,2512,10,7,13,16,33,60,-27,34
Hibernian,2513,1,17,13,6,56,32,24,64
Morton,2513,2,15,15,6,53,38,15,60
Falkirk,2513,3,15,11,10,58,44,14,56
Dundee Utd,2513,4,15,11,10,53,42,11,56
Queen of S't,2513,5,13,8,15,47,48,-1,47
Raith,2513,6,11,12,13,39,47,-8,45
Dumbarton,2513,7,11,11,14,47,57,-10,44
Dunfermline,2513,8,9,13,14,48,54,-6,40
Ayr,2513,9,8,12,16,36,57,-21,36
St Mirren,2513,10,7,12,17,38,56,-18,33
Morton,2514,1,18,12,6,52,33,19,66
Hibernian,2514,2,17,14,5,52,27,25,65
Dundee Utd,2514,3,17,10,9,53,39,14,61
Falkirk,2514,4,14,10,12,57,46,11,52
Dunfermline,2514,5,11,14,11,50,46,4,47
Queen of S't,2514,6,11,11,14,44,51,-7,44
Raith,2514,7,10,12,14,39,48,-9,42
Dumbarton,2514,8,9,10,17,47,61,-14,37
Ayr,2514,9,9,10,17,34,58,-24,37
St Mirren,2514,10,7,11,18,41,60,-19,32
Hibernian,2515,1,19,13,4,51,20,31,70
Falkirk,2515,2,17,9,10,58,40,18,60
Dundee Utd,2515,3,17,9,10,50,37,13,60
Morton,2515,4,16,11,9,47,36,11,59
Ayr,2515,5,12,11,13,37,50,-13,47
Queen of S't,2515,6,12,8,16,52,54,-2,44
Raith,2515,7,11,10,15,33,45,-12,43
Dunfermline,2515,8,8,14,14,42,49,-7,38
Dumbarton,2515,9,7,12,17,49,69,-20,33
St Mirren,2515,10,7,11,18,37,56,-19,32
Hibernian,2516,1,18,11,7,60,32,28,65
Morton,2516,2,17,11,8,48,35,13,62
Falkirk,2516,3,17,10,9,60,40,20,61
Dundee Utd,2516,4,15,10,11,46,39,7,55
Dunfermline,2516,5,11,12,13,47,44,3,45
Queen of S't,2516,6,12,9,15,45,52,-7,45
Raith,2516,7,11,11,14,36,49,-13,44
Dumbarton,2516,8,10,11,15,49,61,-12,41
Ayr,2516,9,8,14,14,33,50,-17,38
St Mirren,2516,10,6,11,19,38,60,-22,29
Hibernian,2517,1,21,10,5,58,31,27,73
Falkirk,2517,2,19,9,8,63,38,25,66
Morton,2517,3,16,10,10,54,44,10,58
Dundee Utd,2517,4,15,9,12,54,45,9,54
Dunfermline,2517,5,11,12,13,51,50,1,45
Queen of S't,2517,6,11,10,15,45,50,-5,43
Raith,2517,7,10,10,16,35,51,-16,40
Ayr,2517,8,9,11,16,37,58,-21,38
Dumbarton,2517,9,9,10,17,46,59,-13,37
St Mirren,2517,10,9,9,18,42,59,-17,36
Hibernian,2518,1,20,13,3,58,23,35,73
Morton,2518,2,15,12,9,48,38,10,57
Falkirk,2518,3,15,11,10,55,42,13,56
Dundee Utd,2518,4,15,11,10,50,41,9,56
Queen of S't,2518,5,11,11,14,45,50,-5,44
Dunfermline,2518,6,10,12,14,48,55,-7,42
Dumbarton,2518,7,10,11,15,50,57,-7,41
Ayr,2518,8,9,13,14,33,50,-17,40
Raith,2518,9,9,11,16,33,51,-18,38
St Mirren,2518,10,8,11,17,43,56,-13,35
Hibernian,2519,1,18,12,6,55,31,24,66
Morton,2519,2,18,11,7,58,40,18,65
Falkirk,2519,3,16,12,8,63,44,19,60
Dundee Utd,2519,4,13,10,13,47,51,-4,49
Dunfermline,2519,5,12,12,12,54,48,6,48
Raith,2519,6,12,9,15,42,50,-8,45
Queen of S't,2519,7,10,11,15,44,57,-13,41
Dumbarton,2519,8,9,11,16,50,59,-9,38
St Mirren,2519,9,9,11,16,41,52,-11,38
Ayr,2519,10,8,11,17,36,58,-22,35
Hibernian,2520,1,18,13,5,53,28,25,67
Dundee Utd,2520,2,18,8,10,50,39,11,62
Falkirk,2520,3,16,10,10,56,40,16,58
Morton,2520,4,16,10,10,50,38,12,58
Queen of S't,2520,5,12,11,13,42,44,-2,47
Dunfermline,2520,6,11,11,14,47,50,-3,44
Raith,2520,7,10,11,15,31,44,-13,41
Dumbarton,2520,8,10,10,16,46,54,-8,40
Ayr,2520,9,9,10,17,34,51,-17,37
St Mirren,2520,10,8,10,18,38,59,-21,34
Hibernian,2521,1,18,12,6,54,26,28,66
Falkirk,2521,2,16,12,8,57,38,19,60
Morton,2521,3,16,10,10,46,37,9,58
Dundee Utd,2521,4,15,11,10,51,41,10,56
Dunfermline,2521,5,12,14,10,50,46,4,50
Queen of S't,2521,6,11,9,16,45,52,-7,42
Raith,2521,7,10,10,16,35,49,-14,40
Dumbarton,2521,8,9,12,15,47,58,-11,39
Ayr,2521,9,9,11,16,38,55,-17,38
St Mirren,2521,10,8,11,17,35,56,-21,35
Hibernian,2522,1,20,11,5,60,25,35,71
Morton,2522,2,16,12,8,51,35,16,60
Falkirk,2522,3,16,11,9,59,42,17,59
Dundee Utd,2522,4,16,11,9,54,40,14,59
Dunfermline,2522,5,12,12,12,44,44,0,48
Raith,2522,6,12,9,15,35,48,-13,45
Queen of S't,2522,7,10,10,16,46,57,-11,40
Dumbarton,2522,8,7,15,14,46,56,-10,36
St Mirren,2522,9,8,10,18,38,61,-23,34
Ayr,2522,10,6,13,17,30,55,-25,31
Hibernian,2523,1,19,11,6,53,26,27,68
Morton,2523,2,16,10,10,51,37,14,58
Dundee Utd,2523,3,16,10,10,53,41,12,58
Falkirk,2523,4,14,12,10,55,42,13,54
Dunfermline,2523,5,11,14,11,44,44,0,47
Raith,2523,6,12,10,14,39,47,-8,46
Queen of S't,2523,7,11,10,15,44,49,-5,43
St Mirren,2523,8,11,9,16,44,55,-11,42
Ayr,2523,9,8,11,17,32,59,-27,35
Dumbarton,2523,10,7,13,16,47,62,-15,34
Hibernian,2524,1,20,12,4,53,23,30,72
Falkirk,2524,2,18,10,8,60,41,19,64
Morton,2524,3,17,12,7,51,37,14,63
Dundee Utd,2524,4,15,10,11,50,44,6,55
Queen of S't,2524,5,14,8,14,47,46,1,50
St Mirren,2524,6,9,11,16,45,55,-10,38
Ayr,2524,7,8,13,15,38,55,-17,37
Raith,2524,8,9,10,17,32,49,-17,37
Dunfermline,2524,9,8,12,16,44,51,-7,36
Dumbarton,2524,10,7,12,17,45,64,-19,33
Hibernian,2525,1,19,12,5,53,25,28,69
Morton,2525,2,16,11,9,47,40,7,59
Falkirk,2525,3,15,12,9,58,43,15,57
Dundee Utd,2525,4,14,11,11,45,40,5,53
Dunfermline,2525,5,13,13,10,56,42,14,52
Ayr,2525,6,11,11,14,38,51,-13,44
Raith,2525,7,10,11,15,36,49,-13,41
Dumbarton,2525,8,9,12,15,46,56,-10,39
Queen of S't,2525,9,9,10,17,38,54,-16,37
St Mirren,2525,10,7,11,18,39,56,-17,32
Hibernian,2526,1,19,11,6,53,30,23,68
Morton,2526,2,18,12,6,50,32,18,66
Dundee Utd,2526,3,17,9,10,50,37,13,60
Falkirk,2526,4,14,11,11,57,45,12,53
Dunfermline,2526,5,11,12,13,50,49,1,45
Ayr,2526,6,10,11,15,37,53,-16,41
Queen of S't,2526,7,10,10,16,43,48,-5,40
Raith,2526,8,10,9,17,33,49,-16,39
St Mirren,2526,9,9,11,16,38,53,-15,38
Dumbarton,2526,10,8,12,16,44,59,-15,36
Hibernian,2527,1,20,12,4,56,22,34,72
Morton,2527,2,18,10,8,52,35,17,64
Falkirk,2527,3,16,11,9,56,40,16,59
Dundee Utd,2527,4,17,8,11,52,41,11,59
Queen of S't,2527,5,11,11,14,44,51,-7,44
Dunfermline,2527,6,10,12,14,45,50,-5,42
Raith,2527,7,10,9,17,36,49,-13,39
St Mirren,2527,8,9,10,17,39,55,-16,37
Ayr,2527,9,8,12,16,31,53,-22,36
Dumbarton,2527,10,8,11,17,45,60,-15,35
Hibernian,2528,1,16,15,5,55,29,26,63
Morton,2528,2,17,11,8,54,40,14,62
Falkirk,2528,3,16,12,8,59,39,20,60
Dundee Utd,2528,4,15,9,12,47,42,5,54
Dunfermline,2528,5,12,12,12,49,51,-2,48
Ayr,2528,6,10,13,13,35,50,-15,43
Dumbarton,2528,7,10,11,15,54,59,-5,41
St Mirren,2528,8,9,12,15,44,56,-12,39
Queen of S't,2528,9,10,9,17,42,54,-12,39
Raith,2528,10,8,10,18,33,52,-19,34
Hibernian,2529,1,20,13,3,59,24,35,73
Morton,2529,2,17,11,8,49,36,13,62
Falkirk,2529,3,16,11,9,59,40,19,59
Dundee Utd,2529,4,16,10,10,50,38,12,58
Dunfermline,2529,5,11,11,14,44,48,-4,44
Raith,2529,6,10,10,16,38,49,-11,40
Queen of S't,2529,7,10,9,17,40,53,-13,39
St Mirren,2529,8,9,10,17,38,53,-15,37
Ayr,2529,9,8,13,15,29,52,-23,37
Dumbarton,2529,10,8,12,16,44,57,-13,36
Hibernian,2530,1,20,12,4,57,26,31,72
Morton,2530,2,17,12,7,48,33,15,63
Falkirk,2530,3,16,10,10,61,48,13,58
Dundee Utd,2530,4,14,11,11,46,43,3,53
Queen of S't,2530,5,13,8,15,51,52,-1,47
Dunfermline,2530,6,10,13,13,48,51,-3,43
Raith,2530,7,11,10,15,38,47,-9,43
Dumbarton,2530,8,8,13,15,49,60,-11,37
St Mirren,2530,9,8,11,17,40,55,-15,35
Ayr,2530,10,7,12,17,33,56,-23,33
Hibernian,2531,1,19,12,5,55,27,28,69
Morton,2531,2,18,9,9,51,37,14,63
Dundee Utd,2531,3,17,9,10,56,40,16,60
Falkirk,2531,4,15,11,10,61,47,14,56
Dunfermline,2531,5,11,12,13,46,48,-2,45
Queen of S't,2531,6,12,9,15,47,51,-4,45
Raith,2531,7,12,9,15,33,44,-11,45
Dumbarton,2531,8,10,10,16,52,61,-9,40
Ayr,2531,9,7,12,17,34,59,-25,33
St Mirren,2531,10,7,11,18,36,57,-21,32
Hibernian,2532,1,20,12,4,58,27,31,72
Morton,2532,2,17,12,7,53,36,17,63
Falkirk,2532,3,16,10,10,56,40,16,58
Dundee Utd,2532,4,15,10,11,53,42,11,55
Queen of S't,2532,5,12,8,16,44,50,-6,44
Dunfermline,2532,6,9,16,11,47,46,1,43
Ayr,2532,7,10,11,15,38,55,-17,41
Dumbarton,2532,8,9,10,17,46,63,-17,37
Raith,2532,9,9,10,17,33,50,-17,37
St Mirren,2532,10,8,11,17,38,57,-19,35
Hibernian,2533,1,20,11,5,56,24,32,71
Morton,2533,2,16,12,8,51,39,12,60
Falkirk,2533,3,16,9,11,61,45,16,57
Dundee Utd,2533,4,16,8,12,49,41,8,56
Dumbarton,2533,5,11,12,13,55,60,-5,45
Dunfermline,2533,6,10,14,12,53,52,1,44
Raith,2533,7,11,10,15,36,48,-12,43
Queen of S't,2533,8,10,10,16,43,55,-12,40
St Mirren,2533,9,9,10,17,38,53,-15,37
Ayr,2533,10,7,12,17,31,56,-25,33
Hibernian,2534,1,21,12,3,65,23,42,75
Morton,2534,2,17,12,7,51,37,14,63
Falkirk,2534,3,16,11,9,61,45,16,59
Dundee Utd,2534,4,15,10,11,48,44,4,55
Dunfermline,2534,5,11,13,12,46,41,5,46
Queen of S't,2534,6,11,11,14,44,53,-9,44
St Mirren,2534,7,9,11,16,42,55,-13,38
Raith,2534,8,9,11,16,31,49,-18,38
Ayr,2534,9,7,12,17,33,57,-24,33
Dumbarton,2534,10,7,11,18,49,66,-17,32
Hibernian,2535,1,17,14,5,54,28,26,65
Falkirk,2535,2,16,10,10,58,41,17,58
Morton,2535,3,16,10,10,50,43,7,58
Dundee Utd,2535,4,14,10,12,49,43,6,52
Dunfermline,2535,5,12,14,10,53,46,7,50
St Mirren,2535,6,11,10,15,43,53,-10,43
Dumbarton,2535,7,10,12,14,52,59,-7,42
Queen of S't,2535,8,10,10,16,46,55,-9,40
Raith,2535,9,10,9,17,33,48,-15,39
Ayr,2535,10,9,11,16,37,59,-22,38
Hibernian,2536,1,19,11,6,55,26,29,68
Morton,2536,2,17,11,8,49,35,14,62
Falkirk,2536,3,17,9,10,58,42,16,60
Dundee Utd,2536,4,16,10,10,55,41,14,58
Dunfermline,2536,5,11,11,14,47,46,1,44
Raith,2536,6,11,9,16,37,50,-13,42
Ayr,2536,7,9,13,14,33,57,-24,40
Dumbarton,2536,8,9,12,15,44,54,-10,39
Queen of S't,2536,9,9,10,17,41,54,-13,37
St Mirren,2536,10,7,14,15,37,51,-14,35
Morton,2537,1,19,11,6,53,30,23,68
Hibernian,2537,2,17,12,7,53,34,19,63
Falkirk,2537,3,16,11,9,58,39,19,59
Dundee Utd,2537,4,15,8,13,47,42,5,53
Dunfermline,2537,5,10,15,11,47,45,2,45
Queen of S't,2537,6,12,9,15,46,52,-6,45
Dumbarton,2537,7,11,11,14,52,56,-4,44
Raith,2537,8,11,10,15,39,50,-11,43
Ayr,2537,9,9,10,17,32,56,-24,37
St Mirren,2537,10,7,9,20,38,61,-23,30
Hibernian,2538,1,18,11,7,51,28,23,65
Dundee Utd,2538,2,19,8,9,55,35,20,65
Morton,2538,3,17,14,5,51,35,16,65
Falkirk,2538,4,18,9,9,61,40,21,63
Queen of S't,2538,5,13,9,14,49,48,1,48
Dunfermline,2538,6,9,13,14,44,51,-7,40
Dumbarton,2538,7,9,12,15,46,59,-13,39
Raith,2538,8,9,10,17,33,46,-13,37
St Mirren,2538,9,8,10,18,38,57,-19,34
Ayr,2538,10,7,10,19,31,60,-29,31
Hibernian,2539,1,17,14,5,56,32,24,65
Falkirk,2539,2,17,10,9,57,37,20,61
Morton,2539,3,16,13,7,55,40,15,61
Dundee Utd,2539,4,16,9,11,51,41,10,57
Queen of S't,2539,5,13,8,15,44,49,-5,47
Dunfermline,2539,6,10,13,13,45,49,-4,43
St Mirren,2539,7,10,12,14,46,54,-8,42
Dumbarton,2539,8,9,10,17,48,58,-10,37
Ayr,2539,9,8,12,16,38,60,-22,36
Raith,2539,10,8,11,17,32,52,-20,35
Hibernian,2540,1,19,11,6,55,27,28,68
Morton,2540,2,18,10,8,52,43,9,64
Falkirk,2540,3,17,9,10,60,43,17,60
Dundee Utd,2540,4,17,8,11,55,41,14,59
Queen of S't,2540,5,12,9,15,47,53,-6,45
Dumbarton,2540,6,11,11,14,54,56,-2,44
Dunfermline,2540,7,9,14,13,48,50,-2,41
Raith,2540,8,10,8,18,38,54,-16,38
St Mirren,2540,9,8,11,17,41,57,-16,35
Ayr,2540,10,8,11,17,34,60,-26,35
Hibernian,2541,1,20,11,5,58,26,32,71
Morton,2541,2,18,10,8,54,36,18,64
Dundee Utd,2541,3,17,10,9,56,42,14,61
Falkirk,2541,4,14,12,10,55,42,13,54
Queen of S't,2541,5,12,9,15,51,56,-5,45
St Mirren,2541,6,11,9,16,43,56,-13,42
Dumbarton,2541,7,9,13,14,48,57,-9,40
Dunfermline,2541,8,9,12,15,45,52,-7,39
Raith,2541,9,9,11,16,32,47,-15,38
Ayr,2541,10,7,11,18,33,61,-28,32
Hibernian,2542,1,17,13,6,51,25,26,64
Morton,2542,2,16,13,7,50,39,11,61
Falkirk,2542,3,15,14,7,58,39,19,59
Dundee Utd,2542,4,15,9,12,51,47,4,54
Queen of S't,2542,5,12,11,13,48,48,0,47
Dunfermline,2542,6,8,17,11,47,49,-2,41
Ayr,2542,7,9,13,14,37,51,-14,40
Raith,2542,8,10,10,16,34,52,-18,40
Dumbarton,2542,9,8,13,15,47,59,-12,37
St Mirren,2542,10,8,11,17,41,55,-14,35
Morton,2543,1,19,11,6,52,35,17,68
Hibernian,2543,2,18,13,5,54,25,29,67
Falkirk,2543,3,18,9,9,61,39,22,63
Dundee Utd,2543,4,17,9,10,50,39,11,60
Dumbarton,2543,5,10,10,16,52,55,-3,40
Dunfermline,2543,6,8,16,12,43,48,-5,40
Raith,2543,7,10,10,16,34,46,-12,40
Queen of S't,2543,8,10,9,17,40,53,-13,39
Ayr,2543,9,8,12,16,30,52,-22,36
St Mirren,2543,10,8,9,19,36,60,-24,33
Hibernian,2544,1,21,11,4,55,22,33,74
Morton,2544,2,16,12,8,50,42,8,60
Falkirk,2544,3,15,10,11,54,42,12,55
Dundee Utd,2544,4,14,11,11,45,39,6,53
Dunfermline,2544,5,13,11,12,53,46,7,50
Queen of S't,2544,6,12,10,14,42,47,-5,46
St Mirren,2544,7,10,10,16,41,53,-12,40
Dumbarton,2544,8,9,10,17,47,58,-11,37
Raith,2544,9,9,9,18,34,51,-17,36
Ayr,2544,10,8,12,16,32,53,-21,36
Hibernian,2545,1,19,10,7,57,25,32,67
Dundee Utd,2545,2,16,10,10,51,38,13,58
Morton,2545,3,14,14,8,43,36,7,56
Falkirk,2545,4,14,12,10,54,47,7,54
Queen of S't,2545,5,12,11,13,45,46,-1,47
Dunfermline,2545,6,11,12,13,46,46,0,45
Raith,2545,7,11,10,15,39,48,-9,43
Dumbarton,2545,8,9,13,14,49,59,-10,40
St Mirren,2545,9,9,10,17,38,53,-15,37
Ayr,2545,10,7,14,15,34,58,-24,35
Hibernian,2546,1,18,12,6,54,30,24,66
Morton,2546,2,17,12,7,55,44,11,63
Dundee Utd,2546,3,16,9,11,53,41,12,57
Falkirk,2546,4,15,10,11,58,46,12,55
Dumbarton,2546,5,11,12,13,49,52,-3,45
Raith,2546,6,12,9,15,39,49,-10,45
Queen of S't,2546,7,11,10,15,47,49,-2,43
Dunfermline,2546,8,10,12,14,52,57,-5,42
Ayr,2546,9,8,12,16,35,55,-20,36
St Mirren,2546,10,7,12,17,40,59,-19,33
Hibernian,2547,1,19,12,5,51,24,27,69
Morton,2547,2,17,12,7,49,33,16,63
Falkirk,2547,3,15,13,8,56,42,14,58
Dundee Utd,2547,4,15,12,9,53,41,12,57
Queen of S't,2547,5,13,8,15,45,48,-3,47
St Mirren,2547,6,11,11,14,38,47,-9,44
Dumbarton,2547,7,9,11,16,46,58,-12,38
Dunfermline,2547,8,8,13,15,43,48,-5,37
Raith,2547,9,9,9,18,36,53,-17,36
Ayr,2547,10,7,13,16,33,56,-23,34
Hibernian,2548,1,16,15,5,51,27,24,63
Morton,2548,2,16,14,6,57,37,20,62
Falkirk,2548,3,15,11,10,57,44,13,56
Dundee Utd,2548,4,15,11,10,48,42,6,56
Queen of S't,2548,5,13,9,14,47,48,-1,48
Dunfermline,2548,6,11,12,13,47,51,-4,45
Raith,2548,7,11,10,15,38,46,-8,43
Dumbarton,2548,8,8,12,16,44,56,-12,36
St Mirren,2548,9,8,12,16,37,52,-15,36
Ayr,2548,10,7,14,15,34,57,-23,35
Hibernian,2549,1,18,12,6,57,29,28,66
Morton,2549,2,18,10,8,51,35,16,64
Falkirk,2549,3,16,11,9,60,39,21,59
Dundee Utd,2549,4,17,8,11,54,45,9,59
Queen of S't,2549,5,12,9,15,44,56,-12,45
St Mirren,2549,6,10,11,15,43,53,-10,41
Ayr,2549,7,10,10,16,38,58,-20,40
Dunfermline,2549,8,9,12,15,39,46,-7,39
Raith,2549,9,9,11,16,34,48,-14,38
Dumbarton,2549,10,9,10,17,47,58,-11,37
Hibernian,2550,1,16,14,6,52,27,25,62
Morton,2550,2,17,11,8,53,38,15,62
Falkirk,2550,3,15,12,9,60,42,18,57
Dundee Utd,2550,4,16,8,12,49,42,7,56
St Mirren,2550,5,12,10,14,46,48,-2,46
Dunfermline,2550,6,9,14,13,44,48,-4,41
Dumbarton,2550,7,10,11,15,47,58,-11,41
Queen of S't,2550,8,10,10,16,42,52,-10,40
Raith,2550,9,9,12,15,35,51,-16,39
Ayr,2550,10,9,12,15,34,56,-22,39
Hibernian,2551,1,19,11,6,51,25,26,68
Falkirk,2551,2,17,10,9,61,38,23,61
Morton,2551,3,16,11,9,48,37,11,59
Dundee Utd,2551,4,14,11,11,52,48,4,53
Queen of S't,2551,5,12,9,15,45,54,-9,45
Dunfermline,2551,6,10,13,13,44,45,-1,43
Dumbarton,2551,7,10,10,16,48,60,-12,40
St Mirren,2551,8,10,10,16,41,54,-13,40
Raith,2551,9,10,10,16,32,46,-14,40
Ayr,2551,10,9,11,16,37,52,-15,38
Hibernian,2552,1,20,12,4,59,30,29,72
Dundee Utd,2552,2,16,11,9,52,38,14,59
Morton,2552,3,15,11,10,51,44,7,56
Falkirk,2552,4,13,11,12,52,43,9,50
Raith,2552,5,12,10,14,35,44,-9,46
Dumbarton,2552,6,10,13,13,52,55,-3,43
Queen of S't,2552,7,11,10,15,41,48,-7,43
Dunfermline,2552,8,9,12,15,48,53,-5,39
St Mirren,2552,9,8,13,15,41,55,-14,37
Ayr,2552,10,7,15,14,35,56,-21,36
Hibernian,2553,1,19,13,4,52,21,31,70
Morton,2553,2,19,10,7,55,36,19,67
Falkirk,2553,3,15,13,8,58,41,17,58
Dundee Utd,2553,4,16,10,10,54,43,11,58
Queen of S't,2553,5,11,11,14,48,54,-6,44
Raith,2553,6,11,9,16,36,52,-16,42
Dumbarton,2553,7,10,10,16,47,63,-16,40
Dunfermline,2553,8,8,12,16,46,55,-9,36
Ayr,2553,9,7,14,15,36,54,-18,35
St Mirren,2553,10,8,10,18,45,58,-13,34
Hibernian,2554,1,20,11,5,60,28,32,71
Morton,2554,2,18,11,7,52,37,15,65
Falkirk,2554,3,16,10,10,60,43,17,58
Dundee Utd,2554,4,14,10,12,47,44,3,52
Dunfermline,2554,5,13,11,12,52,44,8,50
Queen of S't,2554,6,12,9,15,46,50,-4,45
Dumbarton,2554,7,10,10,16,46,58,-12,40
Raith,2554,8,10,9,17,34,51,-17,39
Ayr,2554,9,8,11,17,33,56,-23,35
St Mirren,2554,10,8,10,18,37,56,-19,34
Hibernian,2555,1,17,14,5,50,26,24,65
Dundee Utd,2555,2,19,8,9,60,37,23,65
Morton,2555,3,18,11,7,53,34,19,65
Falkirk,2555,4,16,10,10,55,39,16,58
Dunfermline,2555,5,10,13,13,46,49,-3,43
Queen of S't,2555,6,10,10,16,46,53,-7,40
Raith,2555,7,10,10,16,37,52,-15,40
Dumbarton,2555,8,8,13,15,46,58,-12,37
St Mirren,2555,9,9,10,17,37,53,-16,37
Ayr,2555,10,7,13,16,29,58,-29,34
Hibernian,2556,1,19,12,5,58,23,35,69
Morton,2556,2,18,12,6,51,32,19,66
Falkirk,2556,3,17,10,9,59,40,19,61
Dundee Utd,2556,4,16,10,10,58,42,16,58
Queen of S't,2556,5,11,11,14,44,50,-6,44
Dunfermline,2556,6,10,12,14,41,56,-15,42
Ayr,2556,7,8,14,14,32,51,-19,38
Raith,2556,8,9,9,18,32,49,-17,36
St Mirren,2556,9,9,9,18,39,62,-23,36
Dumbarton,2556,10,8,11,17,51,60,-9,35
Hibernian,2557,1,20,11,5,55,25,30,71
Falkirk,2557,2,18,10,8,56,37,19,64
Dundee Utd,2557,3,16,11,9,52,39,13,59
Morton,2557,4,14,11,11,45,43,2,53
Dunfermline,2557,5,10,14,12,46,47,-1,44
Ayr,2557,6,9,14,13,36,52,-16,41
Queen of S't,2557,7,10,10,16,44,53,-9,40
Raith,2557,8,9,12,15,36,48,-12,39
Dumbarton,2557,9,8,12,16,46,58,-12,36
St Mirren,2557,10,8,11,17,42,56,-14,35
Hibernian,2558,1,19,11,6,58,33,25,68
Morton,2558,2,15,15,6,53,37,16,60
Dundee Utd,2558,3,16,11,9,50,36,14,59
Falkirk,2558,4,15,10,11,55,44,11,55
Queen of S't,2558,5,12,9,15,44,54,-10,45
Dunfermline,2558,6,10,13,13,50,51,-1,43
Raith,2558,7,11,9,16,37,48,-11,42
Dumbarton,2558,8,10,11,15,56,65,-9,41
Ayr,2558,9,9,10,17,37,60,-23,37
St Mirren,2558,10,8,11,17,41,53,-12,35
Hibernian,2559,1,19,12,5,55,24,31,69
Morton,2559,2,17,13,6,48,30,18,64
Falkirk,2559,3,16,11,9,58,42,16,59
Dundee Utd,2559,4,16,9,11,53,45,8,57
Dumbarton,2559,5,11,11,14,54,60,-6,44
Queen of S't,2559,6,11,11,14,44,52,-8,44
Dunfermline,2559,7,10,13,13,47,49,-2,43
Raith,2559,8,9,10,17,31,50,-19,37
St Mirren,2559,9,8,11,17,38,53,-15,35
Ayr,2559,10,7,11,18,31,54,-23,32
Hibernian,2560,1,19,13,4,55,22,33,70
Dundee Utd,2560,2,17,10,9,53,40,13,61
Morton,2560,3,17,10,9,52,40,12,61
Falkirk,2560,4,17,9,10,59,42,17,60
Ayr,2560,5,11,12,13,36,50,-14,45
Dumbarton,2560,6,11,11,14,52,54,-2,44
Queen of S't,2560,7,11,10,15,40,47,-7,43
Dunfermline,2560,8,7,14,15,41,51,-10,35
Raith,2560,9,8,11,17,31,54,-23,35
St Mirren,2560,10,7,10,19,42,61,-19,31
Morton,2561,1,18,12,6,46,29,17,66
Hibernian,2561,2,17,13,6,51,26,25,64
Dundee Utd,2561,3,18,9,9,57,39,18,63
Falkirk,2561,4,14,13,9,54,39,15,55
Queen of S't,2561,5,11,9,16,44,54,-10,42
St Mirren,2561,6,10,11,15,39,50,-11,41
Dunfermline,2561,7,8,16,12,40,44,-4,40
Ayr,2561,8,10,10,16,36,55,-19,40
Dumbarton,2561,9,8,13,15,44,58,-14,37
Raith,2561,10,9,8,19,33,50,-17,35
Hibernian,2562,1,20,12,4,62,27,35,72
Morton,2562,2,17,12,7,51,31,20,63
Dundee Utd,2562,3,16,11,9,51,38,13,59
Falkirk,2562,4,16,10,10,56,38,18,58
Dunfermline,2562,5,11,12,13,49,48,1,45
Queen of S't,2562,6,12,8,16,47,56,-9,44
Raith,2562,7,10,10,16,39,57,-18,40
St Mirren,2562,8,9,10,17,43,56,-13,37
Dumbarton,2562,9,8,11,17,44,63,-19,35
Ayr,2562,10,6,14,16,33,61,-28,32
Hibernian,2563,1,16,15,5,53,29,24,63
Dundee Utd,2563,2,18,9,9,52,36,16,63
Morton,2563,3,16,13,7,46,34,12,61
Falkirk,2563,4,16,12,8,57,39,18,60
Dunfermline,2563,5,10,14,12,45,48,-3,44
Queen of S't,2563,6,10,13,13,44,49,-5,43
St Mirren,2563,7,9,11,16,36,50,-14,38
Dumbarton,2563,8,8,12,16,49,60,-11,36
Ayr,2563,9,8,12,16,37,57,-20,36
Raith,2563,10,8,11,17,35,52,-17,35
Hibernian,2564,1,18,12,6,55,28,27,66
Dundee Utd,2564,2,17,11,8,53,35,18,62
Morton,2564,3,16,12,8,49,37,12,60
Falkirk,2564,4,16,10,10,59,44,15,58
Dunfermline,2564,5,13,13,10,46,41,5,52
Queen of S't,2564,6,12,9,15,43,49,-6,45
St Mirren,2564,7,9,11,16,43,54,-11,38
Ayr,2564,8,8,12,16,35,59,-24,36
Raith,2564,9,9,8,19,37,56,-19,35
Dumbarton,2564,10,7,12,17,41,58,-17,33
Hibernian,2565,1,19,12,5,52,25,27,69
Falkirk,2565,2,19,10,7,60,36,24,67
Dundee Utd,2565,3,17,9,10,54,40,14,60
Morton,2565,4,16,11,9,50,36,14,59
Dunfermline,2565,5,9,14,13,43,45,-2,41
Queen of S't,2565,6,11,8,17,43,51,-8,41
Raith,2565,7,10,10,16,33,48,-15,40
St Mirren,2565,8,9,10,17,44,59,-15,37
Dumbarton,2565,9,8,12,16,44,62,-18,36
Ayr,2565,10,8,12,16,33,54,-21,36
Hibernian,2566,1,19,12,5,55,28,27,69
Morton,2566,2,19,11,6,55,36,19,68
Falkirk,2566,3,17,11,8,60,38,22,62
Dundee Utd,2566,4,14,11,11,45,42,3,53
Queen of S't,2566,5,12,8,16,49,57,-8,44
Dunfermline,2566,6,9,13,14,46,51,-5,40
Ayr,2566,7,9,12,15,38,56,-18,39
Dumbarton,2566,8,9,10,17,47,58,-11,37
Raith,2566,9,9,10,17,35,49,-14,37
St Mirren,2566,10,9,10,17,38,53,-15,37
Hibernian,2567,1,19,13,4,60,32,28,70
Falkirk,2567,2,17,10,9,64,40,24,61
Morton,2567,3,16,12,8,53,39,14,60
Dundee Utd,2567,4,15,10,11,48,39,9,55
Dunfermline,2567,5,11,12,13,46,47,-1,45
Raith,2567,6,11,11,14,38,46,-8,44
Queen of S't,2567,7,12,8,16,45,57,-12,44
Dumbarton,2567,8,9,10,17,45,59,-14,37
St Mirren,2567,9,8,11,17,41,58,-17,35
Ayr,2567,10,8,11,17,35,58,-23,35
Hibernian,2568,1,18,13,5,52,26,26,67
Dundee Utd,2568,2,18,9,9,59,36,23,63
Morton,2568,3,16,9,11,49,42,7,57
Falkirk,2568,4,15,10,11,57,46,11,55
Raith,2568,5,13,8,15,38,46,-8,47
Queen of S't,2568,6,11,11,14,45,51,-6,44
Dunfermline,2568,7,10,13,13,48,51,-3,43
St Mirren,2568,8,10,10,16,43,53,-10,40
Dumbarton,2568,9,9,12,15,50,63,-13,39
Ayr,2568,10,7,11,18,32,59,-27,32
Hibernian,2569,1,17,15,4,57,25,32,66
Morton,2569,2,17,10,9,50,37,13,61
Dundee Utd,2569,3,17,8,11,50,37,13,59
Falkirk,2569,4,16,10,10,52,41,11,58
Queen of S't,2569,5,11,10,15,40,51,-11,43
Dunfermline,2569,6,10,12,14,45,52,-7,42
Dumbarton,2569,7,10,11,15,49,55,-6,41
Raith,2569,8,10,10,16,36,48,-12,40
Ayr,2569,9,9,12,15,34,53,-19,39
St Mirren,2569,10,9,10,17,39,53,-14,37
Hibernian,2570,1,20,12,4,57,25,32,72
Dundee Utd,2570,2,17,10,9,52,36,16,61
Morton,2570,3,16,12,8,49,35,14,60
Falkirk,2570,4,15,11,10,60,48,12,56
Dumbarton,2570,5,11,11,14,49,54,-5,44
Queen of S't,2570,6,11,10,15,45,51,-6,43
Raith,2570,7,11,9,16,36,48,-12,42
Dunfermline,2570,8,8,15,13,46,49,-3,39
St Mirren,2570,9,9,9,18,43,63,-20,36
Ayr,2570,10,7,11,18,32,60,-28,32
Hibernian,2571,1,19,13,4,56,25,31,70
Falkirk,2571,2,16,12,8,55,39,16,60
Morton,2571,3,16,11,9,48,37,11,59
Dundee Utd,2571,4,16,10,10,53,41,12,58
Dunfermline,2571,5,11,12,13,51,50,1,45
Queen of S't,2571,6,12,9,15,47,51,-4,45
Dumbarton,2571,7,9,11,16,45,58,-13,38
Raith,2571,8,10,8,18,34,55,-21,38
St Mirren,2571,9,9,10,17,42,53,-11,37
Ayr,2571,10,8,12,16,35,57,-22,36
Hibernian,2572,1,21,11,4,65,28,37,74
Falkirk,2572,2,17,11,8,60,43,17,62
Dundee Utd,2572,3,17,9,10,56,44,12,60
Morton,2572,4,16,12,8,51,42,9,60
Queen of S't,2572,5,11,10,15,41,49,-8,43
Dunfermline,2572,6,10,12,14,46,46,0,42
Raith,2572,7,11,9,16,35,49,-14,42
Ayr,2572,8,8,12,16,39,59,-20,36
Dumbarton,2572,9,8,11,17,50,63,-13,35
St Mirren,2572,10,6,13,17,39,59,-20,31
Hibernian,2573,1,20,12,4,60,25,35,72
Falkirk,2573,2,17,10,9,62,41,21,61
Morton,2573,3,15,15,6,47,33,14,60
Dundee Utd,2573,4,13,13,10,47,43,4,52
Dunfermline,2573,5,11,13,12,46,47,-1,46
Dumbarton,2573,6,10,13,13,50,58,-8,43
Ayr,2573,7,10,11,15,42,54,-12,41
Queen of S't,2573,8,10,9,17,42,51,-9,39
Raith,2573,9,8,11,17,29,51,-22,35
St Mirren,2573,10,7,11,18,38,60,-22,32
Hibernian,2574,1,19,13,4,56,25,31,70
Morton,2574,2,17,12,7,54,34,20,63
Falkirk,2574,3,16,13,7,57,37,20,61
Dundee Utd,2574,4,16,11,9,48,37,11,59
Queen of S't,2574,5,11,11,14,46,49,-3,44
Ayr,2574,6,8,14,14,35,57,-22,38
Dunfermline,2574,7,8,13,15,44,54,-10,37
Raith,2574,8,9,10,17,34,53,-19,37
Dumbarton,2574,9,7,14,15,44,55,-11,35
St Mirren,2574,10,8,11,17,40,57,-17,35
Hibernian,2575,1,21,10,5,59,28,31,73
Falkirk,2575,2,17,11,8,60,40,20,62
Morton,2575,3,16,11,9,51,39,12,59
Dundee Utd,2575,4,16,10,10,52,36,16,58
Queen of S't,2575,5,12,9,15,52,49,3,45
Dunfermline,2575,6,9,15,12,47,50,-3,42
Dumbarton,2575,7,10,11,15,49,64,-15,41
Raith,2575,8,10,10,16,36,51,-15,40
Ayr,2575,9,8,11,17,34,57,-23,35
St Mirren,2575,10,7,10,19,40,66,-26,31
Hibernian,2576,1,22,10,4,54,24,30,76
Falkirk,2576,2,16,11,9,62,45,17,59
Dundee Utd,2576,3,15,11,10,53,43,10,56
Morton,2576,4,14,11,11,47,44,3,53
Queen of S't,2576,5,13,10,13,50,50,0,49
Dunfermline,2576,6,10,12,14,49,48,1,42
Raith,2576,7,11,9,16,38,47,-9,42
Ayr,2576,8,9,12,15,36,55,-19,39
Dumbarton,2576,9,8,12,16,50,63,-13,36
St Mirren,2576,10,8,10,18,39,59,-20,34
Hibernian,2577,1,21,11,4,53,21,32,74
Falkirk,2577,2,17,10,9,58,39,19,61
Morton,2577,3,16,12,8,46,32,14,60
Dundee Utd,2577,4,15,11,10,48,38,10,56
Dunfermline,2577,5,12,11,13,45,45,0,47
Raith,2577,6,10,12,14,36,46,-10,42
Queen of S't,2577,7,10,9,17,42,54,-12,39
Dumbarton,2577,8,9,10,17,45,62,-17,37
Ayr,2577,9,8,12,16,31,50,-19,36
St Mirren,2577,10,7,12,17,34,51,-17,33
Hibernian,2578,1,18,13,5,56,25,31,67
Morton,2578,2,18,10,8,51,37,14,64
Falkirk,2578,3,15,13,8,57,40,17,58
Dundee Utd,2578,4,13,9,14,42,43,-1,48
Queen of S't,2578,5,13,9,14,46,51,-5,48
Dunfermline,2578,6,10,15,11,49,46,3,45
Dumbarton,2578,7,10,12,14,51,59,-8,42
Ayr,2578,8,10,10,16,35,54,-19,40
Raith,2578,9,10,9,17,32,50,-18,39
St Mirren,2578,10,8,10,18,45,59,-14,34
Hibernian,2579,1,19,12,5,57,27,30,69
Dundee Utd,2579,2,16,12,8,53,39,14,60
Morton,2579,3,16,12,8,50,38,12,60
Falkirk,2579,4,15,13,8,56,39,17,58
Raith,2579,5,12,10,14,42,49,-7,46
Queen of S't,2579,6,10,11,15,44,53,-9,41
Dunfermline,2579,7,8,14,14,42,50,-8,38
Ayr,2579,8,8,13,15,38,58,-20,37
St Mirren,2579,9,8,12,16,41,56,-15,36
Dumbarton,2579,10,7,13,16,45,59,-14,34
Hibernian,2580,1,18,12,6,53,29,24,66
Falkirk,2580,2,17,11,8,63,40,23,62
Morton,2580,3,16,10,10,51,41,10,58
Dunfermline,2580,4,13,13,10,51,44,7,52
Dundee Utd,2580,5,13,11,12,45,41,4,50
Queen of S't,2580,6,10,11,15,39,51,-12,41
Raith,2580,7,10,10,16,39,49,-10,40
Ayr,2580,8,9,13,14,36,52,-16,40
Dumbarton,2580,9,8,14,14,49,58,-9,38
St Mirren,2580,10,7,13,16,38,59,-21,34
Hibernian,2581,1,18,12,6,58,32,26,66
Morton,2581,2,17,11,8,50,38,12,62
Falkirk,2581,3,16,11,9,62,44,18,59
Dundee Utd,2581,4,15,13,8,52,38,14,58
Queen of S't,2581,5,12,11,13,48,46,2,47
Raith,2581,6,12,9,15,37,47,-10,45
Dumbarton,2581,7,9,13,14,47,54,-7,40
Dunfermline,2581,8,8,13,15,42,55,-13,37
Ayr,2581,9,6,16,14,29,51,-22,34
St Mirren,2581,10,7,11,18,37,57,-20,32
Hibernian,2582,1,21,12,3,59,22,37,75
Morton,2582,2,17,11,8,48,34,14,62
Dundee Utd,2582,3,15,11,10,53,45,8,56
Falkirk,2582,4,14,11,11,55,43,12,53
Queen of S't,2582,5,12,10,14,48,50,-2,46
Dunfermline,2582,6,10,13,13,43,48,-5,43
Raith,2582,7,11,9,16,38,50,-12,42
Ayr,2582,8,9,12,15,37,56,-19,39
Dumbarton,2582,9,7,14,15,48,60,-12,35
St Mirren,2582,10,7,11,18,41,62,-21,32
Hibernian,2583,1,18,13,5,54,23,31,67
Falkirk,2583,2,19,9,8,59,37,22,66
Morton,2583,3,16,13,7,48,34,14,61
Dundee Utd,2583,4,16,8,12,52,39,13,56
Queen of S't,2583,5,13,8,15,49,50,-1,47
Dunfermline,2583,6,11,12,13,45,48,-3,45
Raith,2583,7,10,11,15,34,47,-13,41
Dumbarton,2583,8,9,11,16,46,60,-14,38
St Mirren,2583,9,8,10,18,35,56,-21,34
Ayr,2583,10,7,11,18,31,59,-28,32
Hibernian,2584,1,20,10,6,60,32,28,70
Morton,2584,2,17,10,9,53,41,12,61
Falkirk,2584,3,17,9,10,62,39,23,60
Dundee Utd,2584,4,16,11,9,53,43,10,59
Dunfermline,2584,5,10,14,12,43,46,-3,44
Dumbarton,2584,6,11,11,14,51,56,-5,44
Queen of S't,2584,7,11,9,16,48,54,-6,42
Raith,2584,8,10,10,16,32,47,-15,40
Ayr,2584,9,7,13,16,34,57,-23,34
St Mirren,2584,10,7,11,18,39,60,-21,32
Dundee Utd,2585,1,19,8,9,51,35,16,65
Hibernian,2585,2,17,11,8,52,30,22,62
Morton,2585,3,17,11,8,49,33,16,62
Falkirk,2585,4,16,12,8,53,36,17,60
Raith,2585,5,13,9,14,45,48,-3,48
Queen of S't,2585,6,12,9,15,49,54,-5,45
Dumbarton,2585,7,10,11,15,51,59,-8,41
Dunfermline,2585,8,9,12,15,43,51,-8,39
Ayr,2585,9,7,13,16,34,59,-25,34
St Mirren,2585,10,7,10,19,37,59,-22,31
Hibernian,2586,1,19,14,3,59,27,32,71
Morton,2586,2,16,11,9,54,40,14,59
Dundee Utd,2586,3,16,10,10,56,44,12,58
Falkirk,2586,4,16,9,11,58,41,17,57
Raith,2586,5,13,9,14,40,47,-7,48
Queen of S't,2586,6,12,9,15,50,55,-5,45
Dunfermline,2586,7,10,13,13,48,49,-1,43
Dumbarton,2586,8,10,11,15,46,62,-16,41
Ayr,2586,9,7,12,17,35,60,-25,33
St Mirren,2586,10,7,10,19,34,55,-21,31
Hibernian,2587,1,18,14,4,59,30,29,68
Morton,2587,2,18,10,8,51,37,14,64
Falkirk,2587,3,16,12,8,60,39,21,60
Dundee Utd,2587,4,14,10,12,42,38,4,52
Dumbarton,2587,5,10,13,13,49,53,-4,43
Dunfermline,2587,6,10,12,14,48,54,-6,42
St Mirren,2587,7,9,13,14,35,47,-12,40
Queen of S't,2587,8,10,9,17,42,54,-12,39
Raith,2587,9,9,10,17,35,49,-14,37
Ayr,2587,10,8,13,15,33,53,-20,37
Hibernian,2588,1,17,16,3,58,29,29,67
Falkirk,2588,2,17,11,8,60,40,20,62
Morton,2588,3,15,14,7,51,39,12,59
Dundee Utd,2588,4,16,10,10,44,35,9,58
Dunfermline,2588,5,10,12,14,44,48,-4,42
Queen of S't,2588,6,11,9,16,46,54,-8,42
Raith,2588,7,9,13,14,33,46,-13,40
Ayr,2588,8,9,12,15,35,51,-16,39
Dumbarton,2588,9,9,11,16,48,60,-12,38
St Mirren,2588,10,7,12,17,39,56,-17,33
Hibernian,2589,1,18,12,6,54,27,27,66
Dundee Utd,2589,2,17,10,9,57,40,17,61
Morton,2589,3,16,11,9,51,36,15,59
Falkirk,2589,4,13,14,9,56,45,11,53
Queen of S't,2589,5,12,11,13,46,50,-4,47
Raith,2589,6,10,11,15,36,48,-12,41
Dunfermline,2589,7,9,13,14,47,51,-4,40
Dumbarton,2589,8,9,13,14,49,57,-8,40
St Mirren,2589,9,10,10,16,39,56,-17,40
Ayr,2589,10,7,13,16,31,56,-25,34
Morton,2590,1,17,13,6,50,32,18,64
Hibernian,2590,2,16,15,5,52,27,25,63
Falkirk,2590,3,14,13,9,54,40,14,55
Dundee Utd,2590,4,15,10,11,49,39,10,55
Dunfermline,2590,5,14,12,10,52,44,8,54
Queen of S't,2590,6,12,10,14,45,51,-6,46
St Mirren,2590,7,8,13,15,42,54,-12,37
Ayr,2590,8,8,13,15,39,62,-23,37
Dumbarton,2590,9,7,14,15,48,60,-12,35
Raith,2590,10,8,9,19,32,54,-22,33
Hibernian,2591,1,20,11,5,56,25,31,71
Morton,2591,2,17,11,8,56,42,14,62
Falkirk,2591,3,16,10,10,53,38,15,58
Dundee Utd,2591,4,16,10,10,49,36,13,58
Dumbarton,2591,5,11,11,14,51,54,-3,44
Queen of S't,2591,6,10,11,15,44,52,-8,41
Dunfermline,2591,7,9,12,15,45,55,-10,39
St Mirren,2591,8,10,9,17,43,55,-12,39
Raith,2591,9,10,8,18,34,52,-18,38
Ayr,2591,10,9,11,16,34,56,-22,38
Hibernian,2592,1,17,14,5,52,26,26,65
Falkirk,2592,2,18,9,9,68,43,25,63
Morton,2592,3,15,11,10,45,35,10,56
Dundee Utd,2592,4,15,8,13,51,45,6,53
Queen of S't,2592,5,13,9,14,50,51,-1,48
Dunfermline,2592,6,11,12,13,49,52,-3,45
Ayr,2592,7,11,12,13,37,53,-16,45
Raith,2592,8,11,9,16,36,45,-9,42
Dumbarton,2592,9,8,11,17,46,64,-18,35
St Mirren,2592,10,8,11,17,37,57,-20,35
Hibernian,2593,1,18,15,3,54,23,31,69
Morton,2593,2,19,11,6,54,34,20,68
Dundee Utd,2593,3,17,10,9,54,42,12,61
Falkirk,2593,4,15,12,9,56,41,15,57
Dunfermline,2593,5,10,13,13,45,48,-3,43
Queen of S't,2593,6,10,10,16,45,55,-10,40
Raith,2593,7,10,9,17,38,56,-18,39
Dumbarton,2593,8,8,12,16,49,60,-11,36
St Mirren,2593,9,8,11,17,38,52,-14,35
Ayr,2593,10,7,13,16,35,57,-22,34
Hibernian,2594,1,20,12,4,58,23,35,72
Morton,2594,2,17,11,8,53,37,16,62
Dundee Utd,2594,3,17,9,10,54,38,16,60
Falkirk,2594,4,14,11,11,55,51,4,53
Raith,2594,5,12,9,15,41,48,-7,45
Queen of S't,2594,6,11,11,14,45,55,-10,44
Dumbarton,2594,7,10,11,15,47,57,-10,41
Dunfermline,2594,8,9,12,15,42,52,-10,39
Ayr,2594,9,8,12,16,34,51,-17,36
St Mirren,2594,10,8,10,18,41,58,-17,34
Hibernian,2595,1,21,10,5,59,24,35,73
Morton,2595,2,17,12,7,50,37,13,63
Falkirk,2595,3,16,11,9,59,42,17,59
Dundee Utd,2595,4,16,10,10,53,42,11,58
Dumbarton,2595,5,10,12,14,50,57,-7,42
Raith,2595,6,11,9,16,37,49,-12,42
Queen of S't,2595,7,10,11,15,41,48,-7,41
St Mirren,2595,8,10,9,17,42,53,-11,39
Dunfermline,2595,9,7,14,15,45,55,-10,35
Ayr,2595,10,7,12,17,30,59,-29,33
Hibernian,2596,1,19,13,4,60,27,33,70
Morton,2596,2,18,9,9,49,38,11,63
Falkirk,2596,3,15,13,8,59,41,18,58
Dundee Utd,2596,4,16,10,10,47,36,11,58
Queen of S't,2596,5,12,8,16,46,56,-10,44
Dumbarton,2596,6,9,13,14,49,58,-9,40
Dunfermline,2596,7,8,15,13,44,49,-5,39
St Mirren,2596,8,9,12,15,42,54,-12,39
Raith,2596,9,9,11,16,37,49,-12,38
Ayr,2596,10,7,12,17,32,57,-25,33
Morton,2597,1,19,11,6,56,33,23,68
Hibernian,2597,2,18,12,6,54,25,29,66
Falkirk,2597,3,15,13,8,60,41,19,58
Dundee Utd,2597,4,14,11,11,49,41,8,53
Ayr,2597,5,12,11,13,34,46,-12,47
Dumbarton,2597,6,10,13,13,51,56,-5,43
Dunfermline,2597,7,10,13,13,46,54,-8,43
Queen of S't,2597,8,10,11,15,46,53,-7,41
Raith,2597,9,9,8,19,34,55,-21,35
St Mirren,2597,10,7,9,20,38,64,-26,30
Hibernian,2598,1,21,10,5,62,30,32,73
Falkirk,2598,2,17,10,9,58,42,16,61
Morton,2598,3,17,9,10,50,39,11,60
Dundee Utd,2598,4,15,9,12,51,43,8,54
Queen of S't,2598,5,13,8,15,50,51,-1,47
Dunfermline,2598,6,10,13,13,44,45,-1,43
Dumbarton,2598,7,10,12,14,50,59,-9,42
St Mirren,2598,8,10,10,16,42,54,-12,40
Raith,2598,9,9,9,18,32,54,-22,36
Ayr,2598,10,7,12,17,32,54,-22,33
Hibernian,2599,1,19,11,6,53,28,25,68
Falkirk,2599,2,18,9,9,58,41,17,63
Dundee Utd,2599,3,16,8,12,53,43,10,56
Morton,2599,4,15,11,10,48,40,8,56
Dunfermline,2599,5,12,12,12,50,44,6,48
Ayr,2599,6,10,13,13,39,53,-14,43
Queen of S't,2599,7,10,11,15,43,49,-6,41
Dumbarton,2599,8,9,12,15,48,60,-12,39
St Mirren,2599,9,9,10,17,41,59,-18,37
Raith,2599,10,9,9,18,32,48,-16,36
Hibernian,2600,1,21,11,4,60,24,36,74
Morton,2600,2,17,10,9,49,36,13,61
Dundee Utd,2600,3,16,8,12,48,42,6,56
Falkirk,2600,4,14,12,10,53,43,10,54
Dunfermline,2600,5,13,12,11,55,46,9,51
Queen of S't,2600,6,11,9,16,45,55,-10,42
Raith,2600,7,10,10,16,35,50,-15,40
St Mirren,2600,8,8,13,15,38,50,-12,37
Ayr,2600,9,8,12,16,32,54,-22,36
Dumbarton,2600,10,8,11,17,46,61,-15,35
Hibernian,2601,1,19,12,5,53,25,28,69
Falkirk,2601,2,17,10,9,60,38,22,61
Morton,2601,3,16,10,10,47,38,9,58
Dundee Utd,2601,4,15,10,11,53,42,11,55
Dunfermline,2601,5,12,13,11,46,41,5,49
Dumbarton,2601,6,10,12,14,48,59,-11,42
Raith,2601,7,11,9,16,34,48,-14,42
Queen of S't,2601,8,10,9,17,42,53,-11,39
Ayr,2601,9,8,13,15,39,57,-18,37
St Mirren,2601,10,7,12,17,40,61,-21,33
Hibernian,2602,1,18,13,5,53,27,26,67
Morton,2602,2,18,11,7,50,35,15,65
Falkirk,2602,3,16,10,10,59,47,12,58
Dundee Utd,2602,4,14,9,13,51,45,6,51
Queen of S't,2602,5,12,10,14,46,52,-6,46
Dunfermline,2602,6,11,11,14,55,56,-1,44
Dumbarton,2602,7,11,11,14,49,53,-4,44
Raith,2602,8,11,10,15,43,48,-5,43
Ayr,2602,9,7,14,15,36,59,-23,35
St Mirren,2602,10,7,11,18,40,60,-20,32
Hibernian,2603,1,19,12,5,56,29,27,69
Morton,2603,2,17,13,6,54,36,18,64
Falkirk,2603,3,16,11,9,59,45,14,59
Dundee Utd,2603,4,16,10,10,54,41,13,58
Dunfermline,2603,5,10,15,11,48,44,4,45
Dumbarton,2603,6,10,12,14,53,60,-7,42
Queen of S't,2603,7,10,10,16,47,52,-5,40
Raith,2603,8,8,12,16,33,49,-16,36
Ayr,2603,9,8,12,16,36,62,-26,36
St Mirren,2603,10,8,9,19,38,60,-22,33
Hibernian,2604,1,19,13,4,58,25,33,70
Morton,2604,2,17,10,9,47,39,8,61
Dundee Utd,2604,3,16,11,9,52,38,14,59
Falkirk,2604,4,15,11,10,56,42,14,56
Dumbarton,2604,5,12,10,14,52,56,-4,46
Queen of S't,2604,6,12,9,15,50,50,0,45
Raith,2604,7,11,9,16,36,48,-12,42
Dunfermline,2604,8,9,12,15,43,53,-10,39
Ayr,2604,9,8,11,17,33,60,-27,35
St Mirren,2604,10,8,10,18,39,55,-16,34
Hibernian,2605,1,21,11,4,58,23,35,74
Morton,2605,2,17,10,9,46,34,12,61
Dundee Utd,2605,3,16,9,11,47,37,10,57
Falkirk,2605,4,14,12,10,55,42,13,54
Queen of S't,2605,5,12,11,13,44,47,-3,47
Dunfermline,2605,6,10,14,12,45,44,1,44
Dumbarton,2605,7,9,12,15,46,55,-9,39
Raith,2605,8,9,11,16,31,49,-18,38
St Mirren,2605,9,9,10,17,40,53,-13,37
Ayr,2605,10,7,12,17,29,57,-28,33
Hibernian,2606,1,19,12,5,53,25,28,69
Morton,2606,2,17,11,8,52,34,18,62
Dundee Utd,2606,3,17,9,10,52,42,10,60
Falkirk,2606,4,16,10,10,59,43,16,58
Queen of S't,2606,5,11,11,14,45,50,-5,44
Dunfermline,2606,6,10,11,15,42,52,-10,41
Ayr,2606,7,10,11,15,36,53,-17,41
Dumbarton,2606,8,9,13,14,50,57,-7,40
Raith,2606,9,10,9,17,37,52,-15,39
St Mirren,2606,10,8,9,19,40,58,-18,33
Hibernian,2607,1,20,12,4,53,25,28,72
Morton,2607,2,17,11,8,52,38,14,62
Dundee Utd,2607,3,17,9,10,54,39,15,60
Falkirk,2607,4,15,11,10,58,42,16,56
Dunfermline,2607,5,11,13,12,49,46,3,46
Queen of S't,2607,6,10,12,14,44,50,-6,42
Raith,2607,7,10,10,16,34,49,-15,40
Dumbarton,2607,8,8,14,14,49,59,-10,38
St Mirren,2607,9,9,9,18,44,63,-19,36
Ayr,2607,10,6,13,17,31,57,-26,31
Morton,2608,1,17,12,7,52,35,17,63
Hibernian,2608,2,17,10,9,51,31,20,61
Dundee Utd,2608,3,16,11,9,52,39,13,59
Falkirk,2608,4,14,11,11,54,41,13,53
Dunfermline,2608,5,11,13,12,48,49,-1,46
St Mirren,2608,6,11,10,15,47,53,-6,43
Dumbarton,2608,7,9,14,13,49,55,-6,41
Queen of S't,2608,8,10,11,15,43,54,-11,41
Raith,2608,9,10,9,17,35,51,-16,39
Ayr,2608,10,8,13,15,34,57,-23,37
Hibernian,2609,1,19,12,5,57,27,30,69
Dundee Utd,2609,2,15,11,10,50,38,12,56
Falkirk,2609,3,15,10,11,55,44,11,55
Morton,2609,4,14,10,12,44,43,1,52
Raith,2609,5,13,10,13,42,47,-5,49
Dunfermline,2609,6,11,12,13,44,50,-6,45
Queen of S't,2609,7,11,11,14,46,47,-1,44
Dumbarton,2609,8,10,13,13,52,56,-4,43
Ayr,2609,9,8,12,16,39,58,-19,36
St Mirren,2609,10,8,11,17,37,56,-19,35
Hibernian,2610,1,20,10,6,55,28,27,70
Dundee Utd,2610,2,18,10,8,55,36,19,64
Morton,2610,3,17,11,8,54,39,15,62
Falkirk,2610,4,15,10,11,54,42,12,55
Dunfermline,2610,5,12,11,13,51,47,4,47
Queen of S't,2610,6,11,8,17,44,56,-12,41
Dumbarton,2610,7,9,12,15,46,53,-7,39
St Mirren,2610,8,10,9,17,40,52,-12,39
Raith,2610,9,10,8,18,32,54,-22,38
Ayr,2610,10,8,11,17,35,59,-24,35
Hibernian,2611,1,18,14,4,57,27,30,68
Falkirk,2611,2,17,10,9,58,38,20,61
Dundee Utd,2611,3,16,11,9,53,40,13,59
Morton,2611,4,15,12,9,53,43,10,57
Queen of S't,2611,5,11,11,14,43,52,-9,44
Raith,2611,6,11,10,15,38,46,-8,43
Dunfermline,2611,7,8,16,12,44,47,-3,40
Dumbarton,2611,8,9,13,14,49,58,-9,40
St Mirren,2611,9,8,11,17,41,58,-17,35
Ayr,2611,10,7,12,17,33,60,-27,33
Falkirk,2612,1,18,10,8,64,42,22,64
Hibernian,2612,2,17,11,8,54,28,26,62
Morton,2612,3,15,15,6,47,36,11,60
Dundee Utd,2612,4,14,9,13,43,40,3,51
Dumbarton,2612,5,11,12,13,49,54,-5,45
Ayr,2612,6,11,12,13,37,50,-13,45
Dunfermline,2612,7,10,14,12,46,46,0,44
Raith,2612,8,11,9,16,39,52,-13,42
St Mirren,2612,9,9,10,17,41,56,-15,37
Queen of S't,2612,10,9,8,19,40,56,-16,35
Hibernian,2613,1,20,12,4,64,27,37,72
Morton,2613,2,17,11,8,56,37,19,62
Falkirk,2613,3,17,9,10,64,45,19,60
Dundee Utd,2613,4,14,10,12,47,45,2,52
Dunfermline,2613,5,13,12,11,52,47,5,51
Queen of S't,2613,6,10,10,16,40,54,-14,40
Dumbarton,2613,7,9,12,15,47,57,-10,39
Ayr,2613,8,9,11,16,34,54,-20,38
Raith,2613,9,10,8,18,33,54,-21,38
St Mirren,2613,10,8,11,17,38,55,-17,35
Hibernian,2614,1,20,13,3,63,30,33,73
Morton,2614,2,17,12,7,55,38,17,63
Dundee Utd,2614,3,16,10,10,54,43,11,58
Falkirk,2614,4,14,11,11,58,52,6,53
Queen of S't,2614,5,12,11,13,48,51,-3,47
Dunfermline,2614,6,9,14,13,51,51,0,41
Dumbarton,2614,7,9,12,15,49,60,-11,39
Raith,2614,8,9,11,16,36,49,-13,38
Ayr,2614,9,8,12,16,34,56,-22,36
St Mirren,2614,10,7,12,17,38,56,-18,33
Hibernian,2615,1,18,14,4,54,28,26,68
Morton,2615,2,17,12,7,51,34,17,63
Falkirk,2615,3,16,12,8,58,44,14,60
Dundee Utd,2615,4,15,11,10,47,40,7,56
Dumbarton,2615,5,12,10,14,54,54,0,46
Queen of S't,2615,6,11,11,14,44,50,-6,44
Dunfermline,2615,7,9,13,14,45,49,-4,40
Raith,2615,8,9,11,16,35,48,-13,38
St Mirren,2615,9,8,10,18,41,60,-19,34
Ayr,2615,10,7,12,17,36,58,-22,33
Morton,2616,1,19,11,6,54,36,18,68
Hibernian,2616,2,18,12,6,53,26,27,66
Falkirk,2616,3,18,9,9,58,38,20,63
Dundee Utd,2616,4,15,11,10,52,39,13,56
Queen of S't,2616,5,11,10,15,46,49,-3,43
Dunfermline,2616,6,10,12,14,46,52,-6,42
Raith,2616,7,10,9,17,35,53,-18,39
Dumbarton,2616,8,9,11,16,47,62,-15,38
St Mirren,2616,9,8,11,17,44,56,-12,35
Ayr,2616,10,7,14,15,37,61,-24,35
Hibernian,2617,1,21,12,3,62,25,37,75
Dundee Utd,2617,2,18,10,8,58,41,17,64
Falkirk,2617,3,15,12,9,56,39,17,57
Morton,2617,4,15,12,9,48,41,7,57
Queen of S't,2617,5,12,9,15,43,50,-7,45
Dunfermline,2617,6,9,14,13,44,46,-2,41
St Mirren,2617,7,10,9,17,40,58,-18,39
Ayr,2617,8,8,12,16,33,53,-20,36
Dumbarton,2617,9,8,11,17,47,59,-12,35
Raith,2617,10,8,11,17,34,53,-19,35
Hibernian,2618,1,23,10,3,61,21,40,79
Falkirk,2618,2,17,9,10,55,40,15,60
Dundee Utd,2618,3,15,10,11,50,38,12,55
Morton,2618,4,14,13,9,47,38,9,55
Dunfermline,2618,5,11,14,11,48,46,2,47
Ayr,2618,6,10,11,15,32,55,-23,41
Queen of S't,2618,7,10,10,16,41,49,-8,40
Raith,2618,8,9,12,15,33,45,-12,39
Dumbarton,2618,9,9,12,15,44,59,-15,39
St Mirren,2618,10,6,11,19,37,57,-20,29
Hibernian,2619,1,21,11,4,56,23,33,74
Falkirk,2619,2,16,11,9,57,39,18,59
Dundee Utd,2619,3,16,11,9,51,40,11,59
Morton,2619,4,14,13,9,45,36,9,55
Dunfermline,2619,5,11,13,12,51,49,2,46
Queen of S't,2619,6,12,10,14,48,51,-3,46
Raith,2619,7,11,9,16,37,51,-14,42
St Mirren,2619,8,9,10,17,41,59,-18,37
Dumbarton,2619,9,8,10,18,45,63,-18,34
Ayr,2619,10,7,12,17,36,56,-20,33
Hibernian,2620,1,21,12,3,58,23,35,75
Dundee Utd,2620,2,16,9,11,52,44,8,57
Falkirk,2620,3,14,12,10,57,42,15,54
Morton,2620,4,14,12,10,47,41,6,54
Queen of S't,2620,5,13,11,12,49,46,3,50
Dumbarton,2620,6,12,11,13,50,55,-5,47
Dunfermline,2620,7,9,14,13,43,48,-5,41
Raith,2620,8,8,13,15,33,49,-16,37
St Mirren,2620,9,8,11,17,38,56,-18,35
Ayr,2620,10,7,11,18,31,54,-23,32
Hibernian,2621,1,20,11,5,61,30,31,71
Dundee Utd,2621,2,17,9,10,49,37,12,60
Falkirk,2621,3,16,11,9,59,40,19,59
Morton,2621,4,15,11,10,55,45,10,56
Raith,2621,5,11,10,15,42,53,-11,43
Dunfermline,2621,6,10,12,14,49,51,-2,42
Queen of S't,2621,7,10,12,14,44,49,-5,42
Dumbarton,2621,8,9,12,15,49,65,-16,39
St Mirren,2621,9,8,12,16,44,58,-14,36
Ayr,2621,10,8,12,16,33,57,-24,36
Hibernian,2622,1,21,11,4,58,23,35,74
Morton,2622,2,19,10,7,56,39,17,67
Dundee Utd,2622,3,16,9,11,52,44,8,57
Falkirk,2622,4,15,9,12,53,44,9,54
Dunfermline,2622,5,11,12,13,48,49,-1,45
Queen of S't,2622,6,11,10,15,44,49,-5,43
Dumbarton,2622,7,9,12,15,48,60,-12,39
Ayr,2622,8,8,13,15,36,51,-15,37
Raith,2622,9,9,10,17,34,49,-15,37
St Mirren,2622,10,8,10,18,40,61,-21,34
Hibernian,2623,1,18,14,4,53,26,27,68
Morton,2623,2,17,13,6,56,32,24,64
Falkirk,2623,3,18,9,9,59,38,21,63
Dundee Utd,2623,4,17,9,10,57,43,14,60
Queen of S't,2623,5,12,8,16,47,55,-8,44
Dunfermline,2623,6,9,15,12,45,48,-3,42
Dumbarton,2623,7,10,11,15,54,64,-10,41
Ayr,2623,8,8,12,16,39,61,-22,36
Raith,2623,9,8,10,18,29,49,-20,34
St Mirren,2623,10,7,11,18,34,57,-23,32
Hibernian,2624,1,21,12,3,64,23,41,75
Morton,2624,2,17,12,7,54,38,16,63
Falkirk,2624,3,15,10,11,54,40,14,55
Dundee Utd,2624,4,13,11,12,46,44,2,50
Dunfermline,2624,5,10,14,12,49,51,-2,44
Queen of S't,2624,6,10,12,14,42,49,-7,42
St Mirren,2624,7,10,10,16,42,56,-14,40
Ayr,2624,8,9,13,14,39,57,-18,40
Raith,2624,9,10,8,18,33,53,-20,38
Dumbarton,2624,10,8,12,16,51,63,-12,36
Hibernian,2625,1,18,14,4,59,27,32,68
Morton,2625,2,16,15,5,55,36,19,63
Dundee Utd,2625,3,17,9,10,54,40,14,60
Falkirk,2625,4,15,9,12,54,43,11,54
Raith,2625,5,12,10,14,38,44,-6,46
Dunfermline,2625,6,10,14,12,45,49,-4,44
Queen of S't,2625,7,12,8,16,46,56,-10,44
Dumbarton,2625,8,9,13,14,52,55,-3,40
Ayr,2625,9,7,12,17,33,60,-27,33
St Mirren,2625,10,7,10,19,37,63,-26,31
Hibernian,2626,1,21,10,5,62,27,35,73
Morton,2626,2,18,10,8,53,36,17,64
Falkirk,2626,3,17,10,9,59,41,18,61
Dundee Utd,2626,4,17,9,10,56,36,20,60
Dunfermline,2626,5,10,13,13,44,49,-5,43
Queen of S't,2626,6,10,11,15,44,54,-10,41
St Mirren,2626,7,9,10,17,39,56,-17,37
Dumbarton,2626,8,8,12,16,42,56,-14,36
Raith,2626,9,8,12,16,32,51,-19,36
Ayr,2626,10,7,13,16,31,56,-25,34
Hibernian,2627,1,19,13,4,54,24,30,70
Falkirk,2627,2,15,12,9,55,41,14,57
Dundee Utd,2627,3,15,10,11,50,41,9,55
Morton,2627,4,14,13,9,49,41,8,55
Raith,2627,5,13,9,14,44,43,1,48
Queen of S't,2627,6,11,10,15,45,51,-6,43
Ayr,2627,7,10,12,14,36,54,-18,42
Dunfermline,2627,8,9,14,13,48,51,-3,41
Dumbarton,2627,9,8,12,16,44,60,-16,36
St Mirren,2627,10,8,11,17,36,55,-19,35
Hibernian,2628,1,19,12,5,57,26,31,69
Falkirk,2628,2,18,11,7,62,37,25,65
Morton,2628,3,18,11,7,54,34,20,65
Dundee Utd,2628,4,15,9,12,44,41,3,54
Raith,2628,5,12,9,15,38,48,-10,45
Queen of S't,2628,6,11,10,15,42,50,-8,43
Dunfermline,2628,7,10,12,14,45,47,-2,42
Ayr,2628,8,9,11,16,31,51,-20,38
Dumbarton,2628,9,8,12,16,44,57,-13,36
St Mirren,2628,10,6,11,19,40,66,-26,29
Hibernian,2629,1,19,12,5,53,26,27,69
Morton,2629,2,16,11,9,49,38,11,59
Falkirk,2629,3,15,12,9,61,43,18,57
Dundee Utd,2629,4,13,11,12,43,38,5,50
Queen of S't,2629,5,12,12,12,45,47,-2,48
Dunfermline,2629,6,11,14,11,50,48,2,47
Dumbarton,2629,7,9,12,15,52,63,-11,39
Raith,2629,8,9,12,15,35,48,-13,39
Ayr,2629,9,8,15,13,32,50,-18,39
St Mirren,2629,10,7,11,18,39,58,-19,32
Hibernian,2630,1,20,12,4,55,24,31,72
Morton,2630,2,18,9,9,50,35,15,63
Falkirk,2630,3,16,12,8,59,40,19,60
Dundee Utd,2630,4,14,10,12,47,43,4,52
Queen of S't,2630,5,13,9,14,50,49,1,48
Raith,2630,6,11,11,14,40,47,-7,44
Dumbarton,2630,7,11,10,15,48,58,-10,43
Dunfermline,2630,8,9,13,14,46,53,-7,40
Ayr,2630,9,8,10,18,31,55,-24,34
St Mirren,2630,10,7,10,19,38,60,-22,31
Hibernian,2631,1,19,13,4,66,31,35,70
Morton,2631,2,17,11,8,52,38,14,62
Falkirk,2631,3,16,11,9,58,42,16,59
Dundee Utd,2631,4,14,9,13,48,51,-3,51
Dunfermline,2631,5,10,15,11,51,46,5,45
Queen of S't,2631,6,11,10,15,48,51,-3,43
Raith,2631,7,11,8,17,35,51,-16,41
Dumbarton,2631,8,9,13,14,49,58,-9,40
Ayr,2631,9,9,12,15,36,59,-23,39
St Mirren,2631,10,8,10,18,45,61,-16,34
Hibernian,2632,1,19,12,5,54,27,27,69
Morton,2632,2,17,10,9,57,42,15,61
Falkirk,2632,3,14,14,8,59,42,17,56
Dundee Utd,2632,4,14,10,12,50,47,3,52
Dunfermline,2632,5,13,12,11,54,48,6,51
Queen of S't,2632,6,11,11,14,44,51,-7,44
Ayr,2632,7,11,11,14,41,54,-13,44
St Mirren,2632,8,9,11,16,44,55,-11,38
Dumbarton,2632,9,8,11,17,48,66,-18,35
Raith,2632,10,8,10,18,34,53,-19,34
Hibernian,2633,1,21,11,4,57,24,33,74
Morton,2633,2,16,13,7,48,35,13,61
Falkirk,2633,3,16,11,9,58,39,19,59
Dundee Utd,2633,4,14,12,10,51,40,11,54
Queen of S't,2633,5,11,10,15,45,51,-6,43
Dumbarton,2633,6,10,12,14,53,61,-8,42
Dunfermline,2633,7,9,14,13,46,53,-7,41
Raith,2633,8,10,10,16,38,52,-14,40
Ayr,2633,9,8,12,16,32,52,-20,36
St Mirren,2633,10,8,9,19,42,63,-21,33
Falkirk,2634,1,19,10,7,69,38,31,67
Hibernian,2634,2,18,13,5,55,27,28,67
Dundee Utd,2634,3,16,10,10,47,36,11,58
Morton,2634,4,14,13,9,45,39,6,55
Dunfermline,2634,5,10,14,12,52,51,1,44
Raith,2634,6,10,11,15,31,47,-16,41
Ayr,2634,7,9,13,14,36,52,-16,40
Dumbarton,2634,8,8,13,15,46,58,-12,37
Queen of S't,2634,9,9,9,18,40,55,-15,36
St Mirren,2634,10,8,12,16,40,58,-18,36
Hibernian,2635,1,21,11,4,57,23,34,74
Morton,2635,2,20,11,5,55,33,22,71
Dundee Utd,2635,3,18,9,9,50,35,15,63
Falkirk,2635,4,17,10,9,58,39,19,61
Raith,2635,5,11,9,16,38,52,-14,42
Dunfermline,2635,6,10,11,15,49,53,-4,41
Dumbarton,2635,7,10,10,16,52,60,-8,40
Queen of S't,2635,8,10,8,18,42,53,-11,38
St Mirren,2635,9,8,9,19,40,63,-23,33
Ayr,2635,10,6,10,20,29,59,-30,28
Hibernian,2636,1,17,14,5,59,29,30,65
Dundee Utd,2636,2,16,11,9,51,39,12,59
Morton,2636,3,16,11,9,50,38,12,59
Falkirk,2636,4,15,10,11,58,46,12,55
Dunfermline,2636,5,11,13,12,49,48,1,46
Raith,2636,6,10,13,13,35,44,-9,43
Queen of S't,2636,7,11,9,16,40,53,-13,42
St Mirren,2636,8,8,14,14,39,51,-12,38
Dumbarton,2636,9,8,12,16,46,60,-14,36
Ayr,2636,10,7,15,14,33,52,-19,36
Hibernian,2637,1,21,11,4,58,22,36,74
Falkirk,2637,2,16,10,10,59,42,17,58
Morton,2637,3,16,10,10,51,42,9,58
Dundee Utd,2637,4,14,13,9,49,40,9,55
Dumbarton,2637,5,11,11,14,52,56,-4,44
Dunfermline,2637,6,10,13,13,47,50,-3,43
Queen of S't,2637,7,11,8,17,44,52,-8,41
Raith,2637,8,11,8,17,39,56,-17,41
Ayr,2637,9,9,12,15,39,57,-18,39
St Mirren,2637,10,8,10,18,40,61,-21,34
Hibernian,2638,1,18,12,6,52,28,24,66
Morton,2638,2,19,9,8,53,35,18,66
Falkirk,2638,3,17,12,7,60,39,21,63
Dundee Utd,2638,4,14,9,13,48,44,4,51
Ayr,2638,5,13,11,12,44,50,-6,50
Queen of S't,2638,6,11,10,15,42,46,-4,43
St Mirren,2638,7,10,10,16,42,53,-11,40
Dunfermline,2638,8,8,13,15,42,54,-12,37
Raith,2638,9,9,9,18,30,51,-21,36
Dumbarton,2638,10,8,11,17,47,60,-13,35
Hibernian,2639,1,19,12,5,54,27,27,69
Morton,2639,2,17,12,7,52,33,19,63
Dundee Utd,2639,3,18,9,9,50,35,15,63
Falkirk,2639,4,17,10,9,59,40,19,61
Dumbarton,2639,5,11,10,15,48,58,-10,43
Queen of S't,2639,6,11,9,16,45,53,-8,42
Dunfermline,2639,7,9,12,15,46,49,-3,39
Ayr,2639,8,9,10,17,35,58,-23,37
St Mirren,2639,9,9,9,18,41,59,-18,36
Raith,2639,10,9,9,18,35,53,-18,36
Hibernian,2640,1,19,13,4,59,28,31,70
Morton,2640,2,20,10,6,56,36,20,70
Falkirk,2640,3,16,9,11,60,41,19,57
Dundee Utd,2640,4,15,9,12,49,41,8,54
Queen of S't,2640,5,13,10,13,45,46,-1,49
Ayr,2640,6,10,11,15,36,54,-18,41
Dumbarton,2640,7,10,10,16,48,59,-11,40
Raith,2640,8,9,10,17,33,55,-22,37
Dunfermline,2640,9,8,12,16,43,52,-9,36
St Mirren,2640,10,8,10,18,41,58,-17,34
Hibernian,2641,1,18,10,8,56,27,29,64
Falkirk,2641,2,17,10,9,61,40,21,61
Morton,2641,3,17,9,10,52,41,11,60
Dundee Utd,2641,4,16,9,11,49,42,7,57
Dunfermline,2641,5,13,12,11,52,49,3,51
Raith,2641,6,11,11,14,40,52,-12,44
Queen of S't,2641,7,11,9,16,45,50,-5,42
St Mirren,2641,8,10,10,16,43,53,-10,40
Dumbarton,2641,9,8,11,17,44,65,-21,35
Ayr,2641,10,8,11,17,32,55,-23,35
Hibernian,2642,1,20,11,5,60,29,31,71
Falkirk,2642,2,16,13,7,58,36,22,61
Morton,2642,3,15,11,10,55,46,9,56
Dundee Utd,2642,4,15,11,10,53,45,8,56
Queen of S't,2642,5,11,10,15,44,49,-5,43
Raith,2642,6,11,10,15,37,49,-12,43
Dumbarton,2642,7,9,13,14,51,60,-9,40
Dunfermline,2642,8,9,13,14,45,55,-10,40
St Mirren,2642,9,8,13,15,40,52,-12,37
Ayr,2642,10,7,13,16,33,55,-22,34
Hibernian,2643,1,19,13,4,59,26,33,70
Morton,2643,2,17,11,8,46,34,12,62
Falkirk,2643,3,14,11,11,56,48,8,53
Dundee Utd,2643,4,14,11,11,51,45,6,53
Queen of S't,2643,5,13,10,13,46,46,0,49
Dunfermline,2643,6,10,14,12,44,44,0,44
Raith,2643,7,10,12,14,37,46,-9,42
Dumbarton,2643,8,8,14,14,46,56,-10,38
St Mirren,2643,9,8,12,16,40,56,-16,36
Ayr,2643,10,7,12,17,31,55,-24,33
Hibernian,2644,1,18,13,5,56,30,26,67
Morton,2644,2,18,10,8,53,36,17,64
Falkirk,2644,3,16,11,9,61,43,18,59
Dundee Utd,2644,4,14,9,13,46,43,3,51
Queen of S't,2644,5,13,10,13,49,51,-2,49
Dunfermline,2644,6,11,14,11,48,44,4,47
St Mirren,2644,7,11,10,15,45,51,-6,43
Ayr,2644,8,9,11,16,37,55,-18,38
Raith,2644,9,8,11,17,37,56,-19,35
Dumbarton,2644,10,7,11,18,44,67,-23,32
Hibernian,2645,1,21,11,4,56,23,33,74
Morton,2645,2,18,9,9,54,40,14,63
Falkirk,2645,3,17,9,10,59,40,19,60
Dundee Utd,2645,4,14,12,10,47,39,8,54
Queen of S't,2645,5,14,9,13,49,47,2,51
Dunfermline,2645,6,10,12,14,49,51,-2,42
Raith,2645,7,10,9,17,36,51,-15,39
Dumbarton,2645,8,8,12,16,46,58,-12,36
St Mirren,2645,9,8,11,17,39,58,-19,35
Ayr,2645,10,7,12,17,30,58,-28,33
Hibernian,2646,1,21,12,3,59,25,34,75
Falkirk,2646,2,15,13,8,55,36,19,58
Morton,2646,3,16,10,10,51,46,5,58
Dundee Utd,2646,4,15,9,12,49,43,6,54
Queen of S't,2646,5,12,10,14,49,49,0,46
Dunfermline,2646,6,9,13,14,48,51,-3,40
Dumbarton,2646,7,9,12,15,49,62,-13,39
St Mirren,2646,8,9,11,16,38,52,-14,38
Raith,2646,9,9,11,16,33,48,-15,38
Ayr,2646,10,9,11,16,33,52,-19,38
Hibernian,2647,1,17,14,5,51,26,25,65
Dundee Utd,2647,2,17,10,9,55,36,19,61
Morton,2647,3,16,11,9,48,39,9,59
Falkirk,2647,4,16,10,10,59,43,16,58
Dunfermline,2647,5,9,15,12,41,46,-5,42
Ayr,2647,6,10,12,14,37,54,-17,42
Queen of S't,2647,7,10,11,15,44,51,-7,41
Dumbarton,2647,8,8,14,14,48,56,-8,38
St Mirren,2647,9,9,11,16,42,56,-14,38
Raith,2647,10,9,10,17,31,49,-18,37
Hibernian,2648,1,21,11,4,54,21,33,74
Morton,2648,2,18,10,8,51,35,16,64
Dundee Utd,2648,3,17,10,9,53,41,12,61
Falkirk,2648,4,14,11,11,58,45,13,53
Dunfermline,2648,5,11,12,13,46,47,-1,45
Queen of S't,2648,6,10,11,15,41,51,-10,41
Raith,2648,7,9,11,16,38,53,-15,38
Dumbarton,2648,8,8,13,15,46,56,-10,37
St Mirren,2648,9,9,10,17,40,55,-15,37
Ayr,2648,10,6,15,15,36,59,-23,33
Hibernian,2649,1,21,11,4,56,24,32,74
Dundee Utd,2649,2,17,9,10,52,40,12,60
Falkirk,2649,3,15,11,10,57,42,15,56
Morton,2649,4,14,11,11,47,45,2,53
Queen of S't,2649,5,13,10,13,49,47,2,49
Dunfermline,2649,6,9,13,14,42,48,-6,40
Dumbarton,2649,7,9,13,14,47,56,-9,40
Ayr,2649,8,9,13,14,36,53,-17,40
Raith,2649,9,10,8,18,35,54,-19,38
St Mirren,2649,10,9,9,18,46,58,-12,36
Hibernian,2650,1,18,12,6,52,28,24,66
Morton,2650,2,18,10,8,53,36,17,64
Dundee Utd,2650,3,17,9,10,54,37,17,60
Falkirk,2650,4,16,11,9,58,38,20,59
Queen of S't,2650,5,12,10,14,47,49,-2,46
Raith,2650,6,11,10,15,36,47,-11,43
Dunfermline,2650,7,8,14,14,45,53,-8,38
St Mirren,2650,8,9,11,16,39,53,-14,38
Dumbarton,2650,9,8,12,16,46,61,-15,36
Ayr,2650,10,8,11,17,32,60,-28,35
Hibernian,2651,1,22,10,4,59,25,34,76
Morton,2651,2,19,10,7,54,35,19,67
Dundee Utd,2651,3,17,9,10,57,42,15,60
Falkirk,2651,4,15,10,11,57,45,12,55
Queen of S't,2651,5,12,8,16,47,57,-10,44
Dunfermline,2651,6,9,13,14,47,52,-5,40
Raith,2651,7,10,10,16,39,51,-12,40
Dumbarton,2651,8,9,11,16,53,63,-10,38
St Mirren,2651,9,8,11,17,40,56,-16,35
Ayr,2651,10,6,14,16,33,60,-27,32
Hibernian,2652,1,19,12,5,55,25,30,69
Morton,2652,2,18,10,8,51,42,9,64
Falkirk,2652,3,15,11,10,56,44,12,56
Dundee Utd,2652,4,15,11,10,47,37,10,56
Dunfermline,2652,5,14,11,11,57,43,14,53
Queen of S't,2652,6,10,9,17,43,58,-15,39
St Mirren,2652,7,9,11,16,40,53,-13,38
Raith,2652,8,9,11,16,34,50,-16,38
Ayr,2652,9,9,11,16,34,52,-18,38
Dumbarton,2652,10,8,11,17,46,59,-13,35
Hibernian,2653,1,19,11,6,58,27,31,68
Morton,2653,2,18,12,6,49,33,16,66
Falkirk,2653,3,17,12,7,62,37,25,63
Dundee Utd,2653,4,16,10,10,50,36,14,58
Queen of S't,2653,5,13,9,14,48,53,-5,48
Ayr,2653,6,9,11,16,36,58,-22,38
Dumbarton,2653,7,9,10,17,45,58,-13,37
Raith,2653,8,9,10,17,34,54,-20,37
Dunfermline,2653,9,8,12,16,43,51,-8,36
St Mirren,2653,10,8,11,17,39,57,-18,35
Hibernian,2654,1,18,11,7,55,26,29,65
Falkirk,2654,2,17,11,8,60,37,23,62
Morton,2654,3,17,11,8,50,36,14,62
Dundee Utd,2654,4,16,8,12,48,40,8,56
Queen of S't,2654,5,12,10,14,43,53,-10,46
Dunfermline,2654,6,10,15,11,48,47,1,45
St Mirren,2654,7,10,10,16,41,53,-12,40
Raith,2654,8,10,9,17,35,49,-14,39
Dumbarton,2654,9,8,13,15,47,61,-14,37
Ayr,2654,10,7,12,17,31,56,-25,33
Morton,2655,1,18,10,8,54,36,18,64
Hibernian,2655,2,17,12,7,50,27,23,63
Falkirk,2655,3,15,13,8,56,37,19,58
Dundee Utd,2655,4,16,10,10,50,39,11,58
Raith,2655,5,11,11,14,34,43,-9,44
Dunfermline,2655,6,10,13,13,46,49,-3,43
Queen of S't,2655,7,10,12,14,43,50,-7,42
St Mirren,2655,8,10,9,17,42,59,-17,39
Dumbarton,2655,9,9,11,16,43,56,-13,38
Ayr,2655,10,7,13,16,32,54,-22,34
Hibernian,2656,1,20,12,4,55,25,30,72
Morton,2656,2,18,12,6,56,35,21,66
Dundee Utd,2656,3,18,9,9,53,38,15,63
Falkirk,2656,4,15,9,12,58,45,13,54
Dunfermline,2656,5,12,12,12,53,49,4,48
Queen of S't,2656,6,12,8,16,41,48,-7,44
Raith,2656,7,11,9,16,36,48,-12,42
Dumbarton,2656,8,8,11,17,47,63,-16,35
St Mirren,2656,9,8,10,18,37,57,-20,34
Ayr,2656,10,7,10,19,31,59,-28,31
Hibernian,2657,1,19,13,4,60,26,34,70
Morton,2657,2,17,13,6,48,33,15,64
Falkirk,2657,3,14,14,8,55,40,15,56
Dundee Utd,2657,4,14,12,10,44,37,7,54
Queen of S't,2657,5,12,11,13,44,44,0,47
Dunfermline,2657,6,9,14,13,45,47,-2,41
Dumbarton,2657,7,10,11,15,47,57,-10,41
St Mirren,2657,8,8,12,16,44,60,-16,36
Raith,2657,9,8,11,17,33,52,-19,35
Ayr,2657,10,7,13,16,32,56,-24,34
Hibernian,2658,1,17,13,6,51,30,21,64
Dundee Utd,2658,2,18,9,9,50,38,12,63
Falkirk,2658,3,17,11,8,64,41,23,62
Morton,2658,4,17,10,9,48,38,10,61
Raith,2658,5,12,8,16,42,52,-10,44
Dumbarton,2658,6,10,12,14,49,54,-5,42
Ayr,2658,7,10,12,14,35,49,-14,42
Queen of S't,2658,8,10,10,16,45,55,-10,40
Dunfermline,2658,9,8,14,14,45,51,-6,38
St Mirren,2658,10,7,9,20,38,59,-21,30
Hibernian,2659,1,22,11,3,59,21,38,77
Falkirk,2659,2,17,10,9,58,41,17,61
Morton,2659,3,17,9,10,50,36,14,60
Dundee Utd,2659,4,15,10,11,45,38,7,55
Queen of S't,2659,5,11,11,14,46,51,-5,44
Raith,2659,6,12,8,16,37,50,-13,44
St Mirren,2659,7,11,9,16,42,50,-8,42
Dunfermline,2659,8,9,13,14,40,43,-3,40
Ayr,2659,9,8,11,17,33,62,-29,35
Dumbarton,2659,10,7,10,19,40,58,-18,31
Hibernian,2660,1,17,15,4,53,28,25,66
Morton,2660,2,16,14,6,50,35,15,62
Dundee Utd,2660,3,17,10,9,52,39,13,61
Falkirk,2660,4,16,11,9,59,42,17,59
Queen of S't,2660,5,11,10,15,45,48,-3,43
Dumbarton,2660,6,8,14,14,47,57,-10,38
St Mirren,2660,7,9,11,16,41,56,-15,38
Ayr,2660,8,9,11,16,40,56,-16,38
Raith,2660,9,9,11,16,33,50,-17,38
Dunfermline,2660,10,8,13,15,44,53,-9,37
Hibernian,2661,1,18,13,5,51,26,25,67
Falkirk,2661,2,18,11,7,61,38,23,65
Morton,2661,3,18,10,8,52,33,19,64
Dundee Utd,2661,4,15,11,10,46,37,9,56
Dunfermline,2661,5,9,14,13,44,50,-6,41
Queen of S't,2661,6,10,11,15,43,49,-6,41
Dumbarton,2661,7,9,12,15,50,57,-7,39
Raith,2661,8,10,9,17,35,52,-17,39
St Mirren,2661,9,8,11,17,41,59,-18,35
Ayr,2661,10,7,14,15,32,54,-22,35
Hibernian,2662,1,19,13,4,61,29,32,70
Morton,2662,2,18,12,6,50,33,17,66
Falkirk,2662,3,17,10,9,59,39,20,61
Dundee Utd,2662,4,14,10,12,48,40,8,52
Queen of S't,2662,5,13,8,15,46,50,-4,47
Ayr,2662,6,10,12,14,37,56,-19,42
Dunfermline,2662,7,9,12,15,44,51,-7,39
Dumbarton,2662,8,9,10,17,47,62,-15,37
Raith,2662,9,9,10,17,35,50,-15,37
St Mirren,2662,10,8,11,17,43,60,-17,35
Hibernian,2663,1,21,11,4,56,21,35,74
Morton,2663,2,16,11,9,47,38,9,59
Dundee Utd,2663,3,16,9,11,49,37,12,57
Falkirk,2663,4,15,11,10,58,45,13,56
Dunfermline,2663,5,11,13,12,49,43,6,46
Queen of S't,2663,6,10,10,16,42,52,-10,40
Ayr,2663,7,8,15,13,35,52,-17,39
St Mirren,2663,8,9,11,16,43,59,-16,38
Raith,2663,9,9,11,16,34,53,-19,38
Dumbarton,2663,10,7,14,15,46,59,-13,35
Hibernian,2664,1,18,12,6,49,25,24,66
Falkirk,2664,2,18,10,8,62,37,25,64
Morton,2664,3,16,10,10,49,42,7,58
Dundee Utd,2664,4,14,10,12,46,45,1,52
Dumbarton,2664,5,13,10,13,51,50,1,49
Queen of S't,2664,6,11,12,13,40,45,-5,45
Dunfermline,2664,7,10,12,14,47,46,1,42
Raith,2664,8,10,9,17,34,49,-15,39
Ayr,2664,9,9,11,16,37,54,-17,38
St Mirren,2664,10,7,12,17,34,56,-22,33
Hibernian,2665,1,20,12,4,60,25,35,72
Dundee Utd,2665,2,17,9,10,58,43,15,60
Morton,2665,3,16,11,9,51,44,7,59
Falkirk,2665,4,15,11,10,57,39,18,56
Dunfermline,2665,5,11,12,13,45,47,-2,45
Queen of S't,2665,6,11,9,16,46,54,-8,42
Dumbarton,2665,7,10,11,15,47,56,-9,41
Raith,2665,8,9,11,16,33,50,-17,38
Ayr,2665,9,9,11,16,37,58,-21,38
St Mirren,2665,10,9,9,18,40,58,-18,36
Hibernian,2666,1,19,11,6,55,29,26,68
Morton,2666,2,16,11,9,53,38,15,59
Falkirk,2666,3,14,10,12,57,45,12,52
Dundee Utd,2666,4,14,10,12,48,47,1,52
Queen of S't,2666,5,13,10,13,51,50,1,49
Dunfermline,2666,6,11,12,13,50,49,1,45
Raith,2666,7,12,9,15,36,45,-9,45
St Mirren,2666,8,11,11,14,43,53,-10,44
Dumbarton,2666,9,10,10,16,49,59,-10,40
Ayr,2666,10,7,12,17,34,61,-27,33
Morton,2667,1,17,12,7,49,34,15,63
Hibernian,2667,2,16,13,7,49,28,21,61
Falkirk,2667,3,17,10,9,60,40,20,61
Queen of S't,2667,4,15,9,12,47,43,4,54
Dundee Utd,2667,5,14,10,12,46,42,4,52
Dunfermline,2667,6,10,14,12,44,46,-2,44
Ayr,2667,7,10,11,15,37,54,-17,41
Raith,2667,8,9,10,17,30,48,-18,37
Dumbarton,2667,9,7,14,15,42,54,-12,35
St Mirren,2667,10,8,11,17,40,55,-15,35
Hibernian,2668,1,18,12,6,54,29,25,66
Morton,2668,2,17,11,8,54,39,15,62
Dundee Utd,2668,3,17,10,9,54,38,16,61
Falkirk,2668,4,15,9,12,57,45,12,54
Queen of S't,2668,5,12,11,13,48,49,-1,47
Dunfermline,2668,6,10,13,13,44,46,-2,43
Raith,2668,7,11,10,15,42,54,-12,43
Ayr,2668,8,9,12,15,34,56,-22,39
Dumbarton,2668,9,9,10,17,48,61,-13,37
St Mirren,2668,10,7,12,17,39,57,-18,33
Hibernian,2669,1,22,10,4,61,26,35,76
Morton,2669,2,15,13,8,48,37,11,58
Falkirk,2669,3,14,11,11,54,41,13,53
Dundee Utd,2669,4,13,12,11,44,40,4,51
Queen of S't,2669,5,12,9,15,46,54,-8,45
Dunfermline,2669,6,10,14,12,45,43,2,44
Raith,2669,7,11,9,16,34,44,-10,42
St Mirren,2669,8,10,11,15,45,55,-10,41
Dumbarton,2669,9,9,11,16,44,56,-12,38
Ayr,2669,10,8,12,16,34,59,-25,36
Hibernian,2670,1,20,12,4,57,24,33,72
Falkirk,2670,2,15,12,9,59,40,19,57
Morton,2670,3,15,12,9,45,38,7,57
Dundee Utd,2670,4,15,11,10,49,39,10,56
Dunfermline,2670,5,10,14,12,45,47,-2,44
Queen of S't,2670,6,11,10,15,49,53,-4,43
St Mirren,2670,7,10,11,15,41,52,-11,41
Raith,2670,8,10,11,15,35,47,-12,41
Ayr,2670,9,8,12,16,35,59,-24,36
Dumbarton,2670,10,8,11,17,45,61,-16,35
Hibernian,2671,1,20,10,6,59,29,30,70
Dundee Utd,2671,2,18,10,8,51,34,17,64
Falkirk,2671,3,15,11,10,57,42,15,56
Morton,2671,4,14,13,9,45,37,8,55
Queen of S't,2671,5,11,9,16,42,51,-9,42
Dunfermline,2671,6,9,14,13,44,47,-3,41
Dumbarton,2671,7,9,14,13,48,53,-5,41
Raith,2671,8,10,11,15,37,52,-15,41
Ayr,2671,9,8,14,14,32,52,-20,38
St Mirren,2671,10,7,12,17,41,59,-18,33
Falkirk,2672,1,18,10,8,60,39,21,64
Hibernian,2672,2,16,13,7,51,29,22,61
Morton,2672,3,16,10,10,46,38,8,58
Dundee Utd,2672,4,15,12,9,48,38,10,57
Queen of S't,2672,5,13,9,14,54,51,3,48
St Mirren,2672,6,10,12,14,41,50,-9,42
Dunfermline,2672,7,9,14,13,43,49,-6,41
Raith,2672,8,10,9,17,38,50,-12,39
Ayr,2672,9,8,14,14,34,52,-18,38
Dumbarton,2672,10,7,13,16,44,63,-19,34
Hibernian,2673,1,19,12,5,57,27,30,69
Morton,2673,2,17,11,8,51,38,13,62
Falkirk,2673,3,16,10,10,59,44,15,58
Dundee Utd,2673,4,16,10,10,48,37,11,58
Queen of S't,2673,5,13,9,14,53,54,-1,48
Dunfermline,2673,6,11,12,13,48,47,1,45
Raith,2673,7,10,10,16,36,52,-16,40
Dumbarton,2673,8,9,11,16,46,61,-15,38
St Mirren,2673,9,8,12,16,42,57,-15,36
Ayr,2673,10,6,13,17,30,53,-23,31
Hibernian,2674,1,22,11,3,61,21,40,77
Morton,2674,2,16,12,8,54,42,12,60
Falkirk,2674,3,15,9,12,56,49,7,54
Dundee Utd,2674,4,14,10,12,50,44,6,52
Dunfermline,2674,5,11,12,13,46,44,2,45
Queen of S't,2674,6,12,9,15,47,51,-4,45
Ayr,2674,7,10,12,14,37,53,-16,42
Raith,2674,8,10,9,17,35,51,-16,39
Dumbarton,2674,9,9,11,16,44,58,-14,38
St Mirren,2674,10,8,11,17,42,59,-17,35
Hibernian,2675,1,20,11,5,58,30,28,71
Morton,2675,2,18,11,7,59,38,21,65
Falkirk,2675,3,17,11,8,61,38,23,62
Dundee Utd,2675,4,17,10,9,52,39,13,61
Dunfermline,2675,5,10,12,14,53,56,-3,42
Queen of S't,2675,6,10,10,16,44,55,-11,40
Dumbarton,2675,7,9,12,15,48,58,-10,39
Ayr,2675,8,9,12,15,35,54,-19,39
Raith,2675,9,9,8,19,34,59,-25,35
St Mirren,2675,10,7,11,18,39,56,-17,32
Hibernian,2676,1,20,10,6,56,25,31,70
Morton,2676,2,16,11,9,53,41,12,59
Falkirk,2676,3,15,10,11,54,44,10,55
Dundee Utd,2676,4,14,12,10,49,42,7,54
Dumbarton,2676,5,11,11,14,53,55,-2,44
Dunfermline,2676,6,9,15,12,49,51,-2,42
Raith,2676,7,10,12,14,35,45,-10,42
Queen of S't,2676,8,10,11,15,38,49,-11,41
St Mirren,2676,9,9,11,16,42,58,-16,38
Ayr,2676,10,8,13,15,35,54,-19,37
Hibernian,2677,1,19,12,5,55,24,31,69
Morton,2677,2,18,10,8,55,38,17,64
Falkirk,2677,3,16,9,11,57,42,15,57
Dundee Utd,2677,4,16,9,11,57,43,14,57
Dunfermline,2677,5,11,13,12,53,48,5,46
Ayr,2677,6,11,12,13,40,54,-14,45
St Mirren,2677,7,10,9,17,40,59,-19,39
Raith,2677,8,9,11,16,34,51,-17,38
Dumbarton,2677,9,9,10,17,46,62,-16,37
Queen of S't,2677,10,9,9,18,39,55,-16,36
Hibernian,2678,1,20,11,5,58,26,32,71
Morton,2678,2,20,10,6,54,31,23,70
Dundee Utd,2678,3,15,10,11,51,42,9,55
Falkirk,2678,4,14,12,10,54,41,13,54
Queen of S't,2678,5,12,10,14,46,51,-5,46
Dunfermline,2678,6,9,13,14,48,53,-5,40
Dumbarton,2678,7,9,12,15,45,55,-10,39
Raith,2678,8,10,9,17,37,55,-18,39
St Mirren,2678,9,8,12,16,38,56,-18,36
Ayr,2678,10,8,11,17,37,58,-21,35
Hibernian,2679,1,19,13,4,63,25,38,70
Falkirk,2679,2,15,13,8,61,44,17,58
Dundee Utd,2679,3,16,9,11,50,43,7,57
Morton,2679,4,14,14,8,49,39,10,56
Dunfermline,2679,5,12,12,12,49,47,2,48
Dumbarton,2679,6,11,11,14,51,55,-4,44
Raith,2679,7,10,10,16,37,53,-16,40
Queen of S't,2679,8,10,9,17,44,60,-16,39
Ayr,2679,9,8,12,16,32,50,-18,36
St Mirren,2679,10,8,11,17,43,63,-20,35
Hibernian,2680,1,21,11,4,58,27,31,74
Morton,2680,2,16,12,8,55,41,14,60
Falkirk,2680,3,15,11,10,59,43,16,56
Dundee Utd,2680,4,15,10,11,51,46,5,55
Ayr,2680,5,10,12,14,41,52,-11,42
Dumbarton,2680,6,9,14,13,51,58,-7,41
Queen of S't,2680,7,10,10,16,44,54,-10,40
Raith,2680,8,10,10,16,34,48,-14,40
St Mirren,2680,9,10,9,17,41,54,-13,39
Dunfermline,2680,10,8,13,15,47,58,-11,37
Hibernian,2681,1,20,10,6,62,27,35,70
Falkirk,2681,2,17,9,10,56,38,18,60
Morton,2681,3,15,12,9,45,39,6,57
Dundee Utd,2681,4,15,11,10,49,40,9,56
Dumbarton,2681,5,12,10,14,49,54,-5,46
Queen of S't,2681,6,11,10,15,45,54,-9,43
Dunfermline,2681,7,9,13,14,43,47,-4,40
Ayr,2681,8,9,12,15,35,57,-22,39
Raith,2681,9,9,11,16,33,50,-17,38
St Mirren,2681,10,9,10,17,44,55,-11,37
Hibernian,2682,1,18,13,5,52,25,27,67
Falkirk,2682,2,18,9,9,59,38,21,63
Morton,2682,3,17,10,9,47,36,11,61
Dundee Utd,2682,4,14,10,12,48,39,9,52
Dunfermline,2682,5,11,14,11,49,43,6,47
Ayr,2682,6,12,10,14,35,48,-13,46
Raith,2682,7,11,9,16,36,48,-12,42
Queen of S't,2682,8,10,9,17,40,54,-14,39
St Mirren,2682,9,9,10,17,40,55,-15,37
Dumbarton,2682,10,8,10,18,44,64,-20,34
Hibernian,2683,1,19,12,5,52,25,27,69
Falkirk,2683,2,17,11,8,59,39,20,62
Morton,2683,3,17,10,9,50,35,15,61
Dundee Utd,2683,4,14,10,12,46,41,5,52
Queen of S't,2683,5,13,9,14,46,45,1,48
Raith,2683,6,12,10,14,36,44,-8,46
Dunfermline,2683,7,10,13,13,41,44,-3,43
Dumbarton,2683,8,7,14,15,44,58,-14,35
St Mirren,2683,9,8,11,17,41,58,-17,35
Ayr,2683,10,7,12,17,31,57,-26,33
Hibernian,2684,1,18,11,7,55,28,27,65
Morton,2684,2,17,13,6,51,34,17,64
Falkirk,2684,3,17,11,8,61,39,22,62
Dundee Utd,2684,4,16,8,12,50,40,10,56
Queen of S't,2684,5,15,9,12,54,49,5,54
Dunfermline,2684,6,10,13,13,53,54,-1,43
Dumbarton,2684,7,8,12,16,46,62,-16,36
St Mirren,2684,8,9,9,18,42,60,-18,36
Ayr,2684,9,8,12,16,33,58,-25,36
Raith,2684,10,9,8,19,32,53,-21,35
Hibernian,2685,1,21,11,4,63,28,35,74
Dundee Utd,2685,2,17,9,10,56,43,13,60
Falkirk,2685,3,16,10,10,63,48,15,58
Morton,2685,4,15,12,9,53,46,7,57
Queen of S't,2685,5,12,10,14,52,55,-3,46
Dunfermline,2685,6,10,12,14,52,54,-2,42
Ayr,2685,7,10,10,16,33,53,-20,40
Dumbarton,2685,8,9,12,15,50,60,-10,39
Raith,2685,9,10,9,17,38,50,-12,39
St Mirren,2685,10,7,11,18,39,62,-23,32
Hibernian,2686,1,21,11,4,62,29,33,74
Morton,2686,2,18,11,7,53,36,17,65
Dundee Utd,2686,3,16,9,11,50,40,10,57
Falkirk,2686,4,15,9,12,55,42,13,54
Queen of S't,2686,5,11,10,15,44,52,-8,43
Dunfermline,2686,6,10,12,14,44,47,-3,42
Raith,2686,7,10,10,16,37,52,-15,40
Dumbarton,2686,8,8,13,15,50,60,-10,37
St Mirren,2686,9,9,10,17,39,57,-18,37
Ayr,2686,10,7,15,14,37,56,-19,36
Hibernian,2687,1,19,12,5,60,29,31,69
Morton,2687,2,17,10,9,51,39,12,61
Falkirk,2687,3,16,10,10,58,43,15,58
Dundee Utd,2687,4,16,10,10,56,46,10,58
Queen of S't,2687,5,11,11,14,48,52,-4,44
Dumbarton,2687,6,11,11,14,48,55,-7,44
Ayr,2687,7,8,15,13,33,50,-17,39
Dunfermline,2687,8,8,13,15,47,54,-7,37
St Mirren,2687,9,9,10,17,43,57,-14,37
Raith,2687,10,9,10,17,35,54,-19,37
Hibernian,2688,1,21,10,5,67,31,36,73
Morton,2688,2,20,10,6,58,36,22,70
Dundee Utd,2688,3,15,10,11,51,42,9,55
Falkirk,2688,4,14,12,10,55,41,14,54
Queen of S't,2688,5,12,10,14,43,49,-6,46
Dunfermline,2688,6,9,12,15,44,51,-7,39
St Mirren,2688,7,10,9,17,44,57,-13,39
Ayr,2688,8,9,11,16,39,63,-24,38
Dumbarton,2688,9,9,10,17,47,60,-13,37
Raith,2688,10,9,10,17,32,50,-18,37
Hibernian,2689,1,20,11,5,54,25,29,71
Morton,2689,2,17,11,8,49,31,18,62
Falkirk,2689,3,16,11,9,62,43,19,59
Dundee Utd,2689,4,14,10,12,45,42,3,52
Dunfermline,2689,5,11,12,13,42,43,-1,45
Queen of S't,2689,6,11,9,16,42,55,-13,42
Dumbarton,2689,7,10,10,16,47,58,-11,40
Raith,2689,8,9,12,15,37,51,-14,39
St Mirren,2689,9,9,11,16,42,52,-10,38
Ayr,2689,10,8,13,15,35,55,-20,37
Morton,2690,1,19,10,7,54,34,20,67
Hibernian,2690,2,17,13,6,52,27,25,64
Falkirk,2690,3,16,12,8,58,40,18,60
Dundee Utd,2690,4,15,9,12,46,42,4,54
Raith,2690,5,12,9,15,39,49,-10,45
Dunfermline,2690,6,10,13,13,56,53,3,43
Queen of S't,2690,7,10,11,15,48,58,-10,41
Ayr,2690,8,9,12,15,39,56,-17,39
Dumbarton,2690,9,8,12,16,51,65,-14,36
St Mirren,2690,10,8,11,17,40,59,-19,35
Hibernian,2691,1,19,13,4,54,23,31,70
Morton,2691,2,16,11,9,49,39,10,59
Falkirk,2691,3,16,10,10,56,40,16,58
Dundee Utd,2691,4,15,9,12,49,44,5,54
Queen of S't,2691,5,13,10,13,51,48,3,49
Raith,2691,6,13,9,14,42,47,-5,48
Ayr,2691,7,10,11,15,35,54,-19,41
Dunfermline,2691,8,9,13,14,48,57,-9,40
Dumbarton,2691,9,8,12,16,43,55,-12,36
St Mirren,2691,10,6,12,18,38,58,-20,30
Hibernian,2692,1,19,13,4,54,24,30,70
Morton,2692,2,16,10,10,44,42,2,58
Dundee Utd,2692,3,16,9,11,47,39,8,57
Falkirk,2692,4,15,9,12,55,43,12,54
St Mirren,2692,5,12,10,14,49,51,-2,46
Queen of S't,2692,6,12,9,15,47,47,0,45
Ayr,2692,7,10,12,14,35,51,-16,42
Raith,2692,8,10,11,15,36,46,-10,41
Dunfermline,2692,9,9,12,15,42,51,-9,39
Dumbarton,2692,10,8,11,17,46,61,-15,35
Hibernian,2693,1,20,12,4,61,27,34,72
Dundee Utd,2693,2,18,9,9,57,37,20,63
Morton,2693,3,15,13,8,50,38,12,58
Falkirk,2693,4,14,11,11,56,45,11,53
Raith,2693,5,13,9,14,36,44,-8,48
Queen of S't,2693,6,11,10,15,47,56,-9,43
Dunfermline,2693,7,10,12,14,46,52,-6,42
Dumbarton,2693,8,9,12,15,48,59,-11,39
St Mirren,2693,9,9,10,17,43,56,-13,37
Ayr,2693,10,7,10,19,35,65,-30,31
Hibernian,2694,1,17,13,6,52,31,21,64
Morton,2694,2,16,12,8,56,42,14,60
Falkirk,2694,3,15,11,10,59,41,18,56
Dundee Utd,2694,4,15,10,11,49,40,9,55
Dunfermline,2694,5,11,13,12,50,47,3,46
Raith,2694,6,12,9,15,38,48,-10,45
Dumbarton,2694,7,11,11,14,50,59,-9,44
Queen of S't,2694,8,10,10,16,45,54,-9,40
St Mirren,2694,9,10,10,16,40,54,-14,40
Ayr,2694,10,8,11,17,31,54,-23,35
Hibernian,2695,1,18,14,4,56,24,32,68
Morton,2695,2,17,12,7,49,34,15,63
Dundee Utd,2695,3,17,10,9,55,40,15,61
Falkirk,2695,4,16,10,10,58,42,16,58
Dunfermline,2695,5,11,11,14,47,53,-6,44
Queen of S't,2695,6,11,10,15,47,53,-6,43
Raith,2695,7,10,12,14,37,50,-13,42
Dumbarton,2695,8,10,10,16,51,60,-9,40
Ayr,2695,9,8,12,16,30,52,-22,36
St Mirren,2695,10,7,9,20,38,60,-22,30
Hibernian,2696,1,20,12,4,57,24,33,72
Falkirk,2696,2,17,11,8,62,38,24,62
Morton,2696,3,16,10,10,46,38,8,58
Dundee Utd,2696,4,14,10,12,47,45,2,52
Dunfermline,2696,5,13,12,11,52,46,6,51
Queen of S't,2696,6,10,12,14,43,49,-6,42
Raith,2696,7,11,8,17,36,51,-15,41
Dumbarton,2696,8,9,11,16,49,59,-10,38
Ayr,2696,9,8,13,15,34,56,-22,37
St Mirren,2696,10,8,9,19,38,58,-20,33
Hibernian,2697,1,18,13,5,51,25,26,67
Morton,2697,2,16,13,7,51,37,14,61
Dundee Utd,2697,3,15,11,10,50,38,12,56
Falkirk,2697,4,13,12,11,51,42,9,51
Dunfermline,2697,5,11,14,11,45,44,1,47
Raith,2697,6,11,10,15,35,45,-10,43
Queen of S't,2697,7,10,12,14,43,48,-5,42
Dumbarton,2697,8,9,13,14,48,58,-10,40
Ayr,2697,9,7,15,14,30,50,-20,36
St Mirren,2697,10,8,11,17,40,57,-17,35
Hibernian,2698,1,18,14,4,51,23,28,68
Morton,2698,2,17,13,6,49,34,15,64
Dundee Utd,2698,3,17,10,9,55,39,16,61
Falkirk,2698,4,16,11,9,61,44,17,59
Queen of S't,2698,5,13,9,14,47,49,-2,48
Raith,2698,6,10,11,15,37,51,-14,41
Dunfermline,2698,7,9,12,15,49,52,-3,39
Dumbarton,2698,8,7,14,15,45,61,-16,35
St Mirren,2698,9,8,10,18,39,57,-18,34
Ayr,2698,10,6,14,16,33,56,-23,32
Hibernian,2699,1,22,10,4,60,25,35,76
Falkirk,2699,2,17,10,9,59,36,23,61
Morton,2699,3,17,10,9,48,38,10,61
Dundee Utd,2699,4,15,10,11,50,44,6,55
Queen of S't,2699,5,12,9,15,46,49,-3,45
Dunfermline,2699,6,9,14,13,43,45,-2,41
Dumbarton,2699,7,10,11,15,49,58,-9,41
Ayr,2699,8,8,13,15,32,56,-24,37
Raith,2699,9,9,9,18,35,54,-19,36
St Mirren,2699,10,8,10,18,39,56,-17,34
Hibernian,2700,1,20,11,5,55,26,29,71
Falkirk,2700,2,19,10,7,63,36,27,67
Dundee Utd,2700,3,17,10,9,51,36,15,61
Morton,2700,4,16,11,9,53,39,14,59
Dunfermline,2700,5,9,14,13,44,48,-4,41
Raith,2700,6,11,8,17,38,51,-13,41
Queen of S't,2700,7,10,10,16,40,51,-11,40
Dumbarton,2700,8,9,10,17,45,61,-16,37
St Mirren,2700,9,9,9,18,40,56,-16,36
Ayr,2700,10,8,11,17,33,58,-25,35
Hibernian,2701,1,20,12,4,59,27,32,72
Morton,2701,2,18,11,7,53,39,14,65
Falkirk,2701,3,16,10,10,59,43,16,58
Dundee Utd,2701,4,15,9,12,46,38,8,54
Queen of S't,2701,5,12,9,15,44,51,-7,45
Ayr,2701,6,11,11,14,37,54,-17,44
Dunfermline,2701,7,10,12,14,47,47,0,42
St Mirren,2701,8,8,12,16,42,56,-14,36
Raith,2701,9,9,9,18,35,53,-18,36
Dumbarton,2701,10,8,11,17,43,57,-14,35
Morton,2702,1,21,9,6,57,35,22,72
Hibernian,2702,2,18,12,6,53,29,24,66
Dundee Utd,2702,3,16,11,9,51,38,13,59
Falkirk,2702,4,14,11,11,56,43,13,53
Dunfermline,2702,5,10,13,13,45,46,-1,43
Dumbarton,2702,6,10,12,14,48,56,-8,42
Raith,2702,7,10,9,17,35,51,-16,39
Queen of S't,2702,8,9,11,16,44,55,-11,38
Ayr,2702,9,8,14,14,34,53,-19,38
St Mirren,2702,10,7,12,17,39,56,-17,33
Hibernian,2703,1,20,11,5,58,28,30,71
Falkirk,2703,2,15,11,10,59,41,18,56
Morton,2703,3,15,11,10,47,40,7,56
Dundee Utd,2703,4,13,13,10,45,39,6,52
Dunfermline,2703,5,12,12,12,48,46,2,48
Dumbarton,2703,6,11,11,14,52,56,-4,44
Queen of S't,2703,7,11,11,14,44,49,-5,44
St Mirren,2703,8,9,11,16,41,54,-13,38
Ayr,2703,9,9,11,16,34,54,-20,38
Raith,2703,10,9,10,17,36,57,-21,37
Hibernian,2704,1,18,14,4,52,24,28,68
Morton,2704,2,18,9,9,50,38,12,63
Falkirk,2704,3,16,10,10,58,39,19,58
Dundee Utd,2704,4,14,13,9,48,38,10,55
Queen of S't,2704,5,10,12,14,42,48,-6,42
Dunfermline,2704,6,9,14,13,46,51,-5,41
Raith,2704,7,9,13,14,34,45,-11,40
Dumbarton,2704,8,9,11,16,47,56,-9,38
Ayr,2704,9,8,14,14,32,53,-21,38
St Mirren,2704,10,9,10,17,38,55,-17,37
Hibernian,2705,1,19,12,5,54,24,30,69
Morton,2705,2,18,12,6,52,33,19,66
Falkirk,2705,3,17,10,9,60,41,19,61
Dundee Utd,2705,4,16,9,11,50,40,10,57
Queen of S't,2705,5,11,10,15,46,51,-5,43
Dumbarton,2705,6,10,11,15,46,57,-11,41
Dunfermline,2705,7,8,14,14,43,50,-7,38
St Mirren,2705,8,9,11,16,40,57,-17,38
Raith,2705,9,9,10,17,36,52,-16,37
Ayr,2705,10,7,13,16,33,55,-22,34
Hibernian,2706,1,21,11,4,57,25,32,74
Morton,2706,2,17,12,7,56,40,16,63
Dundee Utd,2706,3,17,9,10,51,39,12,60
Falkirk,2706,4,16,10,10,56,37,19,58
Raith,2706,5,11,10,15,35,46,-11,43
Dunfermline,2706,6,9,14,13,47,51,-4,41
Dumbarton,2706,7,9,12,15,48,59,-11,39
Queen of S't,2706,8,10,8,18,41,56,-15,38
Ayr,2706,9,8,12,16,33,53,-20,36
St Mirren,2706,10,8,10,18,37,55,-18,34
Hibernian,2707,1,20,12,4,59,24,35,72
Dundee Utd,2707,2,17,9,10,54,38,16,60
Morton,2707,3,16,10,10,47,45,2,58
Falkirk,2707,4,14,13,9,55,44,11,55
Dunfermline,2707,5,11,13,12,47,51,-4,46
Queen of S't,2707,6,11,10,15,45,48,-3,43
Dumbarton,2707,7,10,11,15,50,61,-11,41
St Mirren,2707,8,9,11,16,48,55,-7,38
Raith,2707,9,9,11,16,35,50,-15,38
Ayr,2707,10,7,12,17,31,55,-24,33
Hibernian,2708,1,22,11,3,62,22,40,77
Morton,2708,2,16,10,10,48,40,8,58
Falkirk,2708,3,14,10,12,55,50,5,52
Dundee Utd,2708,4,14,9,13,48,43,5,51
Dunfermline,2708,5,9,15,12,49,49,0,42
Dumbarton,2708,6,10,12,14,53,58,-5,42
Queen of S't,2708,7,11,9,16,43,51,-8,42
St Mirren,2708,8,11,9,16,42,54,-12,42
Raith,2708,9,10,11,15,41,52,-11,41
Ayr,2708,10,10,10,16,36,58,-22,40
Hibernian,2709,1,17,14,5,54,26,28,65
Morton,2709,2,16,12,8,49,39,10,60
Dundee Utd,2709,3,16,10,10,53,41,12,58
Falkirk,2709,4,16,9,11,53,41,12,57
Queen of S't,2709,5,11,12,13,47,50,-3,45
Dunfermline,2709,6,10,14,12,47,46,1,44
Dumbarton,2709,7,10,11,15,50,58,-8,41
Raith,2709,8,10,11,15,34,47,-13,41
Ayr,2709,9,8,13,15,35,58,-23,37
St Mirren,2709,10,8,10,18,43,59,-16,34
Hibernian,2710,1,20,12,4,64,27,37,72
Morton,2710,2,19,10,7,52,38,14,67
Dundee Utd,2710,3,17,9,10,55,41,14,60
Falkirk,2710,4,14,11,11,54,45,9,53
Queen of S't,2710,5,11,10,15,46,52,-6,43
Dunfermline,2710,6,10,12,14,49,50,-1,42
Dumbarton,2710,7,10,10,16,46,57,-11,40
Ayr,2710,8,9,11,16,35,55,-20,38
St Mirren,2710,9,9,10,17,40,55,-15,37
Raith,2710,10,9,9,18,34,55,-21,36
Hibernian,2711,1,17,14,5,50,25,25,65
Falkirk,2711,2,17,11,8,60,36,24,62
Morton,2711,3,17,11,8,48,33,15,62
Dundee Utd,2711,4,15,10,11,48,42,6,55
Dunfermline,2711,5,12,11,13,45,45,0,47
Raith,2711,6,12,9,15,39,48,-9,45
Queen of S't,2711,7,11,9,16,44,52,-8,42
Dumbarton,2711,8,9,11,16,44,58,-14,38
Ayr,2711,9,7,14,15,32,54,-22,35
St Mirren,2711,10,7,12,17,38,55,-17,33
Hibernian,2712,1,20,12,4,53,23,30,72
Morton,2712,2,19,11,6,52,32,20,68
Falkirk,2712,3,18,10,8,56,36,20,64
Dundee Utd,2712,4,14,10,12,47,42,5,52
Queen of S't,2712,5,11,10,15,46,51,-5,43
St Mirren,2712,6,10,10,16,41,54,-13,40
Dumbarton,2712,7,9,12,15,47,57,-10,39
Ayr,2712,8,9,11,16,36,54,-18,38
Dunfermline,2712,9,8,12,16,41,51,-10,36
Raith,2712,10,8,10,18,33,52,-19,34
Hibernian,2713,1,20,12,4,56,24,32,72
Morton,2713,2,17,12,7,53,36,17,63
Falkirk,2713,3,17,10,9,58,39,19,61
Dundee Utd,2713,4,17,10,9,52,39,13,61
Queen of S't,2713,5,13,8,15,47,49,-2,47
Dunfermline,2713,6,9,13,14,43,48,-5,40
Ayr,2713,7,8,14,14,35,55,-20,38
Dumbarton,2713,8,8,12,16,49,61,-12,36
St Mirren,2713,9,8,10,18,42,61,-19,34
Raith,2713,10,8,9,19,30,53,-23,33
Hibernian,2714,1,19,13,4,55,24,31,70
Morton,2714,2,17,13,6,51,36,15,64
Dundee Utd,2714,3,16,9,11,51,40,11,57
Falkirk,2714,4,14,11,11,57,47,10,53
Dunfermline,2714,5,11,12,13,49,46,3,45
Queen of S't,2714,6,12,9,15,51,55,-4,45
Dumbarton,2714,7,11,12,13,55,61,-6,45
Raith,2714,8,10,11,15,34,46,-12,41
St Mirren,2714,9,8,9,19,43,65,-22,33
Ayr,2714,10,7,11,18,36,62,-26,32
Hibernian,2715,1,19,13,4,57,29,28,70
Morton,2715,2,16,13,7,50,33,17,61
Falkirk,2715,3,13,13,10,54,43,11,52
Dundee Utd,2715,4,14,10,12,46,43,3,52
Queen of S't,2715,5,11,12,13,45,48,-3,45
Dunfermline,2715,6,9,15,12,47,50,-3,42
Ayr,2715,7,10,12,14,38,54,-16,42
St Mirren,2715,8,10,11,15,39,52,-13,41
Raith,2715,9,10,10,16,36,49,-13,40
Dumbarton,2715,10,8,11,17,49,60,-11,35
Hibernian,2716,1,20,12,4,59,24,35,72
Morton,2716,2,18,11,7,56,39,17,65
Falkirk,2716,3,17,9,10,57,41,16,60
Dundee Utd,2716,4,13,10,13,46,44,2,49
Queen of S't,2716,5,12,10,14,44,47,-3,46
Dunfermline,2716,6,10,13,13,47,50,-3,43
Dumbarton,2716,7,11,10,15,46,54,-8,43
Ayr,2716,8,11,10,15,36,53,-17,43
St Mirren,2716,9,8,10,18,39,58,-19,34
Raith,2716,10,8,9,19,35,55,-20,33
Hibernian,2717,1,19,11,6,55,29,26,68
Dundee Utd,2717,2,18,9,9,53,40,13,63
Morton,2717,3,16,9,11,49,46,3,57
Falkirk,2717,4,15,11,10,58,43,15,56
Dunfermline,2717,5,11,12,13,51,49,2,45
Raith,2717,6,11,11,14,39,49,-10,44
Ayr,2717,7,10,11,15,38,53,-15,41
Queen of S't,2717,8,10,9,17,41,52,-11,39
Dumbarton,2717,9,9,11,16,52,60,-8,38
St Mirren,2717,10,8,12,16,44,59,-15,36
Morton,2718,1,19,11,6,56,35,21,68
Hibernian,2718,2,18,11,7,52,27,25,65
Falkirk,2718,3,17,10,9,56,40,16,61
Dundee Utd,2718,4,16,9,11,50,39,11,57
Dunfermline,2718,5,12,12,12,51,47,4,48
Queen of S't,2718,6,13,8,15,50,50,0,47
Dumbarton,2718,7,8,12,16,46,58,-12,36
Raith,2718,8,9,9,18,31,52,-21,36
Ayr,2718,9,8,11,17,33,61,-28,35
St Mirren,2718,10,7,13,16,40,56,-16,34
Hibernian,2719,1,21,11,4,57,24,33,74
Morton,2719,2,17,9,10,48,38,10,60
Dundee Utd,2719,3,15,11,10,48,35,13,56
Falkirk,2719,4,14,11,11,56,42,14,53
Queen of S't,2719,5,11,11,14,46,50,-4,44
Dumbarton,2719,6,11,11,14,49,55,-6,44
Dunfermline,2719,7,10,13,13,48,51,-3,43
St Mirren,2719,8,11,9,16,41,53,-12,42
Raith,2719,9,9,11,16,33,48,-15,38
Ayr,2719,10,6,13,17,31,61,-30,31
Hibernian,2720,1,20,12,4,55,24,31,72
Morton,2720,2,15,12,9,48,39,9,57
Dundee Utd,2720,3,15,12,9,48,40,8,57
Falkirk,2720,4,15,11,10,59,41,18,56
Queen of S't,2720,5,12,10,14,50,52,-2,46
Dunfermline,2720,6,10,12,14,45,52,-7,42
Raith,2720,7,11,9,16,38,55,-17,42
Dumbarton,2720,8,9,13,14,52,60,-8,40
St Mirren,2720,9,9,10,17,47,55,-8,37
Ayr,2720,10,7,13,16,31,55,-24,34
Hibernian,2721,1,19,11,6,56,28,28,68
Morton,2721,2,17,12,7,50,37,13,63
Dundee Utd,2721,3,18,8,10,50,38,12,62
Falkirk,2721,4,16,10,10,58,42,16,58
Dunfermline,2721,5,11,13,12,49,47,2,46
Queen of S't,2721,6,11,10,15,47,54,-7,43
Dumbarton,2721,7,9,12,15,47,55,-8,39
Raith,2721,8,9,11,16,34,48,-14,38
Ayr,2721,9,8,12,16,35,59,-24,36
St Mirren,2721,10,7,11,18,38,56,-18,32
Hibernian,2722,1,20,13,3,57,25,32,73
Dundee Utd,2722,2,16,10,10,49,37,12,58
Morton,2722,3,15,13,8,48,36,12,58
Falkirk,2722,4,15,11,10,58,43,15,56
Raith,2722,5,12,8,16,38,50,-12,44
Dunfermline,2722,6,10,12,14,47,50,-3,42
Dumbarton,2722,7,9,14,13,48,55,-7,41
Queen of S't,2722,8,10,9,17,40,51,-11,39
Ayr,2722,9,7,15,14,35,56,-21,36
St Mirren,2722,10,7,13,16,42,59,-17,34
Morton,2723,1,20,10,6,57,38,19,70
Hibernian,2723,2,17,14,5,51,27,24,65
Dundee Utd,2723,3,17,10,9,53,39,14,61
Falkirk,2723,4,16,10,10,61,41,20,58
Queen of S't,2723,5,11,10,15,43,52,-9,43
Dunfermline,2723,6,9,14,13,49,53,-4,41
Dumbarton,2723,7,10,11,15,53,63,-10,41
Raith,2723,8,10,9,17,36,49,-13,39
St Mirren,2723,9,8,10,18,36,55,-19,34
Ayr,2723,10,7,12,17,34,56,-22,33
Hibernian,2724,1,20,10,6,59,28,31,70
Morton,2724,2,18,11,7,49,34,15,65
Dundee Utd,2724,3,16,10,10,51,39,12,58
Falkirk,2724,4,14,10,12,52,48,4,52
Dunfermline,2724,5,12,12,12,50,44,6,48
Queen of S't,2724,6,12,10,14,43,45,-2,46
St Mirren,2724,7,11,10,15,44,51,-7,43
Raith,2724,8,9,9,18,30,48,-18,36
Ayr,2724,9,7,14,15,37,58,-21,35
Dumbarton,2724,10,8,10,18,43,63,-20,34
Hibernian,2725,1,20,11,5,56,26,30,71
Falkirk,2725,2,16,10,10,57,40,17,58
Dundee Utd,2725,3,15,10,11,50,44,6,55
Morton,2725,4,15,10,11,46,40,6,55
Dunfermline,2725,5,12,12,12,46,42,4,48
Queen of S't,2725,6,11,11,14,43,44,-1,44
Raith,2725,7,11,9,16,37,50,-13,42
Ayr,2725,8,9,12,15,33,52,-19,39
St Mirren,2725,9,9,11,16,39,56,-17,38
Dumbarton,2725,10,9,10,17,46,59,-13,37
Hibernian,2726,1,20,12,4,56,24,32,72
Morton,2726,2,17,11,8,61,38,23,62
Dundee Utd,2726,3,15,11,10,47,37,10,56
Falkirk,2726,4,14,11,11,57,44,13,53
Dunfermline,2726,5,11,14,11,49,50,-1,47
Dumbarton,2726,6,10,12,14,46,54,-8,42
Raith,2726,7,10,10,16,36,51,-15,40
Queen of S't,2726,8,9,12,15,42,51,-9,39
St Mirren,2726,9,9,10,17,40,58,-18,37
Ayr,2726,10,7,13,16,33,60,-27,34
Hibernian,2727,1,17,12,7,51,29,22,63
Morton,2727,2,16,12,8,53,39,14,60
Falkirk,2727,3,16,11,9,56,37,19,59
Dundee Utd,2727,4,15,10,11,46,42,4,55
Dunfermline,2727,5,11,13,12,49,49,0,46
Queen of S't,2727,6,12,10,14,45,45,0,46
St Mirren,2727,7,11,9,16,40,54,-14,42
Raith,2727,8,10,10,16,34,48,-14,40
Dumbarton,2727,9,9,10,17,45,58,-13,37
Ayr,2727,10,8,13,15,33,51,-18,37
Hibernian,2728,1,19,12,5,57,29,28,69
Morton,2728,2,16,11,9,47,35,12,59
Falkirk,2728,3,16,9,11,62,44,18,57
Dundee Utd,2728,4,15,11,10,52,42,10,56
Queen of S't,2728,5,11,10,15,43,50,-7,43
St Mirren,2728,6,10,11,15,41,52,-11,41
Raith,2728,7,10,11,15,32,45,-13,41
Dunfermline,2728,8,9,13,14,45,52,-7,40
Dumbarton,2728,9,10,10,16,48,57,-9,40
Ayr,2728,10,8,14,14,37,58,-21,38
Hibernian,2729,1,17,13,6,58,30,28,64
Falkirk,2729,2,17,10,9,63,42,21,61
Morton,2729,3,16,12,8,53,39,14,60
Dundee Utd,2729,4,17,8,11,51,40,11,59
Dumbarton,2729,5,11,12,13,51,55,-4,45
Raith,2729,6,11,10,15,39,49,-10,43
Ayr,2729,7,10,11,15,37,54,-17,41
Dunfermline,2729,8,8,16,12,44,49,-5,40
Queen of S't,2729,9,9,10,17,41,59,-18,37
St Mirren,2729,10,8,10,18,40,60,-20,34
Hibernian,2730,1,20,12,4,55,23,32,72
Falkirk,2730,2,17,10,9,60,38,22,61
Morton,2730,3,15,13,8,48,35,13,58
Dundee Utd,2730,4,14,12,10,51,43,8,54
Queen of S't,2730,5,13,9,14,48,52,-4,48
Dunfermline,2730,6,10,13,13,48,50,-2,43
Raith,2730,7,10,10,16,35,51,-16,40
Dumbarton,2730,8,9,12,15,49,60,-11,39
St Mirren,2730,9,7,12,17,37,57,-20,33
Ayr,2730,10,6,15,15,34,56,-22,33
Hibernian,2731,1,17,13,6,52,26,26,64
Morton,2731,2,17,11,8,47,36,11,62
Dundee Utd,2731,3,17,10,9,51,36,15,61
Falkirk,2731,4,14,11,11,55,47,8,53
Queen of S't,2731,5,12,11,13,46,47,-1,47
Raith,2731,6,11,11,14,36,46,-10,44
Dumbarton,2731,7,10,13,13,48,53,-5,43
Dunfermline,2731,8,9,12,15,43,48,-5,39
Ayr,2731,9,7,14,15,31,50,-19,35
St Mirren,2731,10,7,12,17,38,58,-20,33
Hibernian,2732,1,19,12,5,60,28,32,69
Falkirk,2732,2,19,9,8,58,38,20,66
Dundee Utd,2732,3,18,9,9,53,35,18,63
Morton,2732,4,15,13,8,53,42,11,58
Raith,2732,5,12,8,16,37,47,-10,44
Queen of S't,2732,6,11,9,16,43,53,-10,42
Dunfermline,2732,7,9,14,13,49,51,-2,41
Ayr,2732,8,10,10,16,39,60,-21,40
Dumbarton,2732,9,8,12,16,49,62,-13,36
St Mirren,2732,10,6,10,20,34,59,-25,28
Hibernian,2733,1,19,13,4,61,29,32,70
Morton,2733,2,18,10,8,53,36,17,64
Falkirk,2733,3,15,13,8,59,41,18,58
Dundee Utd,2733,4,14,12,10,50,40,10,54
Dunfermline,2733,5,11,15,10,53,50,3,48
Queen of S't,2733,6,12,10,14,49,50,-1,46
Raith,2733,7,9,12,15,34,50,-16,39
Dumbarton,2733,8,8,12,16,48,61,-13,36
Ayr,2733,9,7,13,16,35,58,-23,34
St Mirren,2733,10,7,10,19,35,62,-27,31
Hibernian,2734,1,21,11,4,60,27,33,74
Morton,2734,2,18,10,8,54,41,13,64
Falkirk,2734,3,16,11,9,62,41,21,59
Dundee Utd,2734,4,14,9,13,53,47,6,51
Dunfermline,2734,5,11,12,13,50,48,2,45
Dumbarton,2734,6,10,12,14,46,52,-6,42
Raith,2734,7,11,8,17,43,55,-12,41
Queen of S't,2734,8,10,10,16,42,53,-11,40
Ayr,2734,9,9,12,15,36,57,-21,39
St Mirren,2734,10,8,9,19,36,61,-25,33
Hibernian,2735,1,19,12,5,54,24,30,69
Morton,2735,2,17,12,7,54,34,20,63
Falkirk,2735,3,16,10,10,60,43,17,58
Dundee Utd,2735,4,16,8,12,56,49,7,56
Dunfermline,2735,5,11,12,13,47,49,-2,45
Ayr,2735,6,11,10,15,37,53,-16,43
Raith,2735,7,10,12,14,34,43,-9,42
Queen of S't,2735,8,10,9,17,49,58,-9,39
Dumbarton,2735,9,9,10,17,45,62,-17,37
St Mirren,2735,10,9,9,18,40,61,-21,36
Hibernian,2736,1,20,11,5,56,25,31,71
Morton,2736,2,19,9,8,49,36,13,66
Dundee Utd,2736,3,18,8,10,55,41,14,62
Falkirk,2736,4,16,10,10,61,42,19,58
Queen of S't,2736,5,11,10,15,47,50,-3,43
Raith,2736,6,10,10,16,35,51,-16,40
Dumbarton,2736,7,9,12,15,49,60,-11,39
Dunfermline,2736,8,8,14,14,44,51,-7,38
St Mirren,2736,9,9,10,17,45,58,-13,37
Ayr,2736,10,8,10,18,32,59,-27,34
Hibernian,2737,1,18,15,3,54,23,31,69
Dundee Utd,2737,2,17,11,8,54,37,17,62
Morton,2737,3,15,12,9,52,42,10,57
Falkirk,2737,4,15,11,10,57,44,13,56
Queen of S't,2737,5,12,8,16,43,50,-7,44
Dunfermline,2737,6,9,15,12,46,49,-3,42
Raith,2737,7,9,12,15,35,49,-14,39
Dumbarton,2737,8,8,14,14,45,55,-10,38
St Mirren,2737,9,9,11,16,43,55,-12,38
Ayr,2737,10,8,11,17,32,57,-25,35
Hibernian,2738,1,21,11,4,57,21,36,74
Falkirk,2738,2,17,10,9,58,39,19,61
Morton,2738,3,15,14,7,52,37,15,59
Dundee Utd,2738,4,16,11,9,48,37,11,59
Dunfermline,2738,5,10,13,13,45,50,-5,43
Queen of S't,2738,6,10,10,16,45,58,-13,40
Ayr,2738,7,9,11,16,36,58,-22,38
Raith,2738,8,9,10,17,34,48,-14,37
Dumbarton,2738,9,8,12,16,49,62,-13,36
St Mirren,2738,10,8,12,16,43,57,-14,36
Dundee Utd,2739,1,19,9,8,49,32,17,66
Hibernian,2739,2,16,14,6,50,28,22,62
Morton,2739,3,17,11,8,49,33,16,62
Falkirk,2739,4,14,13,9,56,40,16,55
Queen of S't,2739,5,13,10,13,50,51,-1,49
Dunfermline,2739,6,12,12,12,52,52,0,48
Ayr,2739,7,9,11,16,35,53,-18,38
St Mirren,2739,8,9,10,17,41,57,-16,37
Dumbarton,2739,9,7,13,16,43,60,-17,34
Raith,2739,10,8,9,19,34,53,-19,33
Hibernian,2740,1,19,12,5,57,25,32,69
Morton,2740,2,15,14,7,47,36,11,59
Falkirk,2740,3,15,11,10,54,42,12,56
Dundee Utd,2740,4,14,12,10,51,43,8,54
Queen of S't,2740,5,14,9,13,49,49,0,51
Dumbarton,2740,6,10,11,15,50,58,-8,41
Dunfermline,2740,7,8,16,12,43,49,-6,40
Raith,2740,8,9,12,15,36,49,-13,39
St Mirren,2740,9,8,11,17,39,54,-15,35
Ayr,2740,10,7,14,15,33,54,-21,35
Hibernian,2741,1,20,10,6,63,28,35,70
Dundee Utd,2741,2,18,8,10,52,37,15,62
Falkirk,2741,3,17,9,10,59,39,20,60
Morton,2741,4,16,10,10,51,42,9,58
Dunfermline,2741,5,13,11,12,51,53,-2,50
Dumbarton,2741,6,10,11,15,46,57,-11,41
Ayr,2741,7,10,11,15,36,53,-17,41
Raith,2741,8,9,12,15,35,50,-15,39
Queen of S't,2741,9,9,9,18,44,58,-14,36
St Mirren,2741,10,7,11,18,38,58,-20,32
Hibernian,2742,1,19,11,6,53,29,24,68
Morton,2742,2,17,12,7,48,35,13,63
Dundee Utd,2742,3,15,11,10,49,40,9,56
Falkirk,2742,4,14,13,9,57,42,15,55
Dunfermline,2742,5,11,13,12,48,45,3,46
Queen of S't,2742,6,11,11,14,46,52,-6,44
Raith,2742,7,10,11,15,35,46,-11,41
Ayr,2742,8,9,12,15,33,53,-20,39
Dumbarton,2742,9,7,15,14,42,53,-11,36
St Mirren,2742,10,7,11,18,38,54,-16,32
Hibernian,2743,1,19,13,4,56,22,34,70
Dundee Utd,2743,2,18,9,9,53,36,17,63
Morton,2743,3,17,11,8,46,34,12,62
Falkirk,2743,4,13,11,12,56,51,5,50
Dunfermline,2743,5,10,12,14,45,47,-2,42
Dumbarton,2743,6,10,12,14,48,57,-9,42
Queen of S't,2743,7,10,11,15,45,55,-10,41
St Mirren,2743,8,10,9,17,44,56,-12,39
Raith,2743,9,9,11,16,33,48,-15,38
Ayr,2743,10,8,13,15,33,53,-20,37
Hibernian,2744,1,19,13,4,55,25,30,70
Dundee Utd,2744,2,16,12,8,51,38,13,60
Falkirk,2744,3,16,11,9,57,36,21,59
Morton,2744,4,15,12,9,47,39,8,57
Dunfermline,2744,5,11,15,10,45,43,2,48
St Mirren,2744,6,10,10,16,42,53,-11,40
Queen of S't,2744,7,10,8,18,40,53,-13,38
Dumbarton,2744,8,8,13,15,46,56,-10,37
Raith,2744,9,9,10,17,34,53,-19,37
Ayr,2744,10,8,12,16,31,52,-21,36
Hibernian,2745,1,19,13,4,56,26,30,70
Dundee Utd,2745,2,17,11,8,49,35,14,62
Morton,2745,3,16,12,8,51,36,15,60
Falkirk,2745,4,16,9,11,55,41,14,57
Queen of S't,2745,5,11,10,15,45,51,-6,43
Raith,2745,6,11,9,16,39,54,-15,42
Dunfermline,2745,7,9,14,13,47,49,-2,41
St Mirren,2745,8,10,10,16,39,51,-12,40
Dumbarton,2745,9,9,11,16,45,58,-13,38
Ayr,2745,10,6,13,17,31,56,-25,31
Hibernian,2746,1,19,12,5,54,27,27,69
Morton,2746,2,17,12,7,51,35,16,63
Falkirk,2746,3,17,11,8,59,39,20,62
Dundee Utd,2746,4,16,12,8,54,34,20,60
Dumbarton,2746,5,11,10,15,47,58,-11,43
Queen of S't,2746,6,11,9,16,45,53,-8,42
Dunfermline,2746,7,9,13,14,42,53,-11,40
Raith,2746,8,9,10,17,34,48,-14,37
St Mirren,2746,9,8,10,18,43,58,-15,34
Ayr,2746,10,6,15,15,30,54,-24,33
Hibernian,2747,1,21,11,4,62,26,36,74
Morton,2747,2,18,10,8,52,40,12,64
Falkirk,2747,3,16,10,10,60,46,14,58
Dundee Utd,2747,4,16,9,11,55,41,14,57
Raith,2747,5,12,9,15,40,51,-11,45
Ayr,2747,6,10,10,16,44,56,-12,40
Queen of S't,2747,7,10,10,16,43,55,-12,40
Dunfermline,2747,8,9,12,15,46,55,-9,39
Dumbarton,2747,9,9,10,17,45,60,-15,37
St Mirren,2747,10,8,11,17,38,55,-17,35
Hibernian,2748,1,18,12,6,53,28,25,66
Falkirk,2748,2,17,10,9,62,41,21,61
Morton,2748,3,16,13,7,52,35,17,61
Dundee Utd,2748,4,15,11,10,50,40,10,56
Queen of S't,2748,5,12,10,14,44,49,-5,46
Dunfermline,2748,6,10,12,14,44,52,-8,42
Ayr,2748,7,10,11,15,35,52,-17,41
Dumbarton,2748,8,9,13,14,47,55,-8,40
Raith,2748,9,9,9,18,35,54,-19,36
St Mirren,2748,10,8,11,17,40,56,-16,35
Hibernian,2749,1,20,11,5,63,31,32,71
Morton,2749,2,16,11,9,53,42,11,59
Falkirk,2749,3,16,10,10,59,41,18,58
Dundee Utd,2749,4,15,12,9,53,40,13,57
Queen of S't,2749,5,13,10,13,48,47,1,49
Raith,2749,6,11,11,14,40,50,-10,44
Ayr,2749,7,8,15,13,38,52,-14,39
St Mirren,2749,8,9,10,17,40,58,-18,37
Dunfermline,2749,9,8,12,16,41,60,-19,36
Dumbarton,2749,10,7,12,17,45,59,-14,33
Hibernian,2750,1,16,14,6,48,26,22,62
Morton,2750,2,17,10,9,56,41,15,61
Falkirk,2750,3,16,12,8,58,38,20,60
Dundee Utd,2750,4,14,11,11,50,42,8,53
Dumbarton,2750,5,11,12,13,49,52,-3,45
Queen of S't,2750,6,11,11,14,39,46,-7,44
Raith,2750,7,11,11,14,35,45,-10,44
Dunfermline,2750,8,10,12,14,46,51,-5,42
Ayr,2750,9,8,12,16,33,55,-22,36
St Mirren,2750,10,7,13,16,39,57,-18,34
Morton,2751,1,20,9,7,59,38,21,69
Hibernian,2751,2,17,12,7,52,29,23,63
Falkirk,2751,3,18,9,9,58,37,21,63
Dundee Utd,2751,4,16,9,11,53,39,14,57
Queen of S't,2751,5,14,9,13,48,46,2,51
Dunfermline,2751,6,10,14,12,52,52,0,44
Ayr,2751,7,9,12,15,36,55,-19,39
Raith,2751,8,8,11,17,33,53,-20,35
Dumbarton,2751,9,8,10,18,42,64,-22,34
St Mirren,2751,10,7,11,18,38,58,-20,32
Hibernian,2752,1,19,12,5,57,26,31,69
Morton,2752,2,17,11,8,50,34,16,62
Dundee Utd,2752,3,17,9,10,55,38,17,60
Falkirk,2752,4,16,10,10,59,43,16,58
Ayr,2752,5,11,12,13,36,50,-14,45
Queen of S't,2752,6,12,8,16,44,54,-10,44
Dunfermline,2752,7,9,14,13,49,54,-5,41
St Mirren,2752,8,10,9,17,42,57,-15,39
Raith,2752,9,9,10,17,33,48,-15,37
Dumbarton,2752,10,7,11,18,42,63,-21,32
Hibernian,2753,1,20,12,4,56,24,32,72
Dundee Utd,2753,2,17,9,10,53,44,9,60
Morton,2753,3,17,9,10,48,41,7,60
Falkirk,2753,4,15,11,10,56,41,15,56
Queen of S't,2753,5,12,9,15,46,52,-6,45
Dunfermline,2753,6,9,14,13,48,49,-1,41
St Mirren,2753,7,10,11,15,44,51,-7,41
Raith,2753,8,10,9,17,37,51,-14,39
Dumbarton,2753,9,9,10,17,44,58,-14,37
Ayr,2753,10,8,12,16,35,56,-21,36
Hibernian,2754,1,19,13,4,53,24,29,70
Dundee Utd,2754,2,16,9,11,53,38,15,57
Morton,2754,3,15,11,10,47,40,7,56
Falkirk,2754,4,14,11,11,54,44,10,53
Dunfermline,2754,5,11,12,13,48,56,-8,45
Queen of S't,2754,6,11,11,14,51,49,2,44
Dumbarton,2754,7,11,10,15,48,57,-9,43
Raith,2754,8,10,12,14,38,49,-11,42
St Mirren,2754,9,9,11,16,42,57,-15,38
Ayr,2754,10,8,12,16,38,58,-20,36
Hibernian,2755,1,19,12,5,55,29,26,69
Falkirk,2755,2,18,10,8,60,35,25,64
Morton,2755,3,15,12,9,43,34,9,57
Dundee Utd,2755,4,15,11,10,46,38,8,56
Dunfermline,2755,5,12,12,12,50,44,6,48
Ayr,2755,6,10,12,14,35,52,-17,42
Raith,2755,7,11,8,17,35,51,-16,41
Queen of S't,2755,8,10,10,16,39,48,-9,40
Dumbarton,2755,9,8,11,17,46,61,-15,35
St Mirren,2755,10,8,10,18,42,59,-17,34
Hibernian,2756,1,18,13,5,55,30,25,67
Falkirk,2756,2,18,11,7,60,37,23,65
Morton,2756,3,16,12,8,51,37,14,60
Dundee Utd,2756,4,14,9,13,47,48,-1,51
Queen of S't,2756,5,13,9,14,46,48,-2,48
Ayr,2756,6,11,13,12,39,49,-10,46
Dunfermline,2756,7,9,13,14,44,50,-6,40
St Mirren,2756,8,10,9,17,50,59,-9,39
Raith,2756,9,9,9,18,36,50,-14,36
Dumbarton,2756,10,7,12,17,43,63,-20,33
Hibernian,2757,1,18,12,6,58,29,29,66
Morton,2757,2,18,11,7,51,33,18,65
Dundee Utd,2757,3,17,10,9,47,36,11,61
Falkirk,2757,4,15,10,11,62,42,20,55
Dunfermline,2757,5,11,12,13,47,48,-1,45
Raith,2757,6,11,10,15,37,50,-13,43
Dumbarton,2757,7,10,11,15,49,59,-10,41
Queen of S't,2757,8,9,10,17,37,54,-17,37
Ayr,2757,9,7,16,13,34,52,-18,37
St Mirren,2757,10,8,10,18,41,60,-19,34
Morton,2758,1,18,11,7,62,40,22,65
Falkirk,2758,2,18,10,8,62,36,26,64
Hibernian,2758,3,15,15,6,50,31,19,60
Dundee Utd,2758,4,17,9,10,60,43,17,60
Raith,2758,5,12,10,14,35,44,-9,46
Ayr,2758,6,10,13,13,41,56,-15,43
Queen of S't,2758,7,10,12,14,44,51,-7,42
Dunfermline,2758,8,8,13,15,48,56,-8,37
Dumbarton,2758,9,8,10,18,42,62,-20,34
St Mirren,2758,10,7,11,18,41,66,-25,32
Hibernian,2759,1,18,12,6,59,27,32,66
Morton,2759,2,18,12,6,54,34,20,66
Falkirk,2759,3,16,11,9,59,42,17,59
Dundee Utd,2759,4,14,10,12,47,42,5,52
Queen of S't,2759,5,13,8,15,49,53,-4,47
Dunfermline,2759,6,10,13,13,44,49,-5,43
Ayr,2759,7,10,13,13,36,48,-12,43
Raith,2759,8,10,8,18,34,55,-21,38
Dumbarton,2759,9,8,12,16,46,60,-14,36
St Mirren,2759,10,8,11,17,38,56,-18,35
Hibernian,2760,1,18,12,6,55,29,26,66
Falkirk,2760,2,17,11,8,62,35,27,62
Morton,2760,3,16,12,8,50,37,13,60
Dundee Utd,2760,4,13,13,10,48,42,6,52
Queen of S't,2760,5,12,11,13,47,50,-3,47
Dunfermline,2760,6,10,12,14,47,53,-6,42
Raith,2760,7,10,10,16,34,55,-21,40
Dumbarton,2760,8,9,12,15,46,57,-11,39
Ayr,2760,9,8,15,13,35,51,-16,39
St Mirren,2760,10,8,10,18,41,56,-15,34
Hibernian,2761,1,19,12,5,53,25,28,69
Morton,2761,2,16,11,9,47,36,11,59
Dundee Utd,2761,3,16,9,11,48,40,8,57
Falkirk,2761,4,14,14,8,58,45,13,56
Dumbarton,2761,5,12,11,13,59,57,2,47
Dunfermline,2761,6,11,13,12,46,45,1,46
Queen of S't,2761,7,12,10,14,49,49,0,46
Raith,2761,8,9,10,17,32,50,-18,37
St Mirren,2761,9,8,10,18,38,57,-19,34
Ayr,2761,10,8,10,18,32,58,-26,34
Hibernian,2762,1,18,11,7,54,30,24,65
Morton,2762,2,18,10,8,55,37,18,64
Falkirk,2762,3,18,9,9,62,40,22,63
Dundee Utd,2762,4,16,9,11,48,40,8,57
Dunfermline,2762,5,12,12,12,54,49,5,48
Raith,2762,6,10,12,14,45,57,-12,42
Queen of S't,2762,7,10,10,16,44,53,-9,40
Ayr,2762,8,10,10,16,34,58,-24,40
St Mirren,2762,9,9,10,17,39,52,-13,37
Dumbarton,2762,10,7,11,18,40,59,-19,32
Hibernian,2763,1,19,13,4,59,26,33,70
Dundee Utd,2763,2,17,9,10,52,40,12,60
Falkirk,2763,3,16,11,9,55,37,18,59
Morton,2763,4,15,14,7,51,39,12,59
Queen of S't,2763,5,12,8,16,44,54,-10,44
Dunfermline,2763,6,9,14,13,46,49,-3,41
Dumbarton,2763,7,9,13,14,52,57,-5,40
Raith,2763,8,10,10,16,32,49,-17,40
St Mirren,2763,9,8,12,16,39,52,-13,36
Ayr,2763,10,7,12,17,33,60,-27,33
Morton,2764,1,18,12,6,52,32,20,66
Hibernian,2764,2,17,13,6,46,24,22,64
Dundee Utd,2764,3,18,10,8,55,38,17,64
Falkirk,2764,4,15,11,10,54,41,13,56
Dumbarton,2764,5,12,10,14,57,55,2,46
St Mirren,2764,6,11,9,16,43,54,-11,42
Dunfermline,2764,7,9,13,14,43,48,-5,40
Queen of S't,2764,8,9,11,16,42,58,-16,38
Raith,2764,9,10,8,18,35,51,-16,38
Ayr,2764,10,7,11,18,30,56,-26,32
Hibernian,2765,1,20,12,4,56,23,33,72
Falkirk,2765,2,18,10,8,61,35,26,64
Dundee Utd,2765,3,17,10,9,51,39,12,61
Morton,2765,4,16,11,9,52,40,12,59
Dunfermline,2765,5,10,13,13,49,48,1,43
Raith,2765,6,11,9,16,35,48,-13,42
Dumbarton,2765,7,10,11,15,46,60,-14,41
Ayr,2765,8,9,12,15,38,55,-17,39
Queen of S't,2765,9,9,10,17,40,57,-17,37
St Mirren,2765,10,6,10,20,34,57,-23,28
Hibernian,2766,1,20,12,4,57,25,32,72
Dundee Utd,2766,2,17,9,10,55,39,16,60
Falkirk,2766,3,16,11,9,59,42,17,59
Morton,2766,4,13,13,10,43,37,6,52
Queen of S't,2766,5,12,10,14,47,56,-9,46
Dunfermline,2766,6,10,14,12,46,46,0,44
St Mirren,2766,7,11,10,15,42,50,-8,43
Ayr,2766,8,9,11,16,32,53,-21,38
Raith,2766,9,8,12,16,33,52,-19,36
Dumbarton,2766,10,7,12,17,47,61,-14,33
Hibernian,2767,1,21,11,4,59,28,31,74
Morton,2767,2,17,12,7,56,36,20,63
Dundee Utd,2767,3,17,10,9,57,39,18,61
Falkirk,2767,4,15,10,11,56,49,7,55
Dunfermline,2767,5,9,14,13,47,51,-4,41
Raith,2767,6,11,8,17,40,52,-12,41
Dumbarton,2767,7,10,10,16,49,62,-13,40
Queen of S't,2767,8,10,8,18,43,56,-13,38
Ayr,2767,9,9,11,16,34,56,-22,38
St Mirren,2767,10,9,10,17,46,58,-12,37
Hibernian,2768,1,20,12,4,57,24,33,72
Falkirk,2768,2,18,10,8,62,38,24,64
Dundee Utd,2768,3,17,10,9,55,39,16,61
Morton,2768,4,15,14,7,50,35,15,59
Queen of S't,2768,5,13,10,13,42,44,-2,49
Dunfermline,2768,6,8,14,14,40,46,-6,38
St Mirren,2768,7,9,9,18,41,63,-22,36
Dumbarton,2768,8,7,14,15,46,61,-15,35
Raith,2768,9,9,8,19,31,49,-18,35
Ayr,2768,10,8,11,17,30,55,-25,35
Hibernian,2769,1,20,12,4,57,27,30,72
Falkirk,2769,2,18,9,9,56,38,18,63
Dundee Utd,2769,3,17,9,10,53,40,13,60
Morton,2769,4,16,11,9,48,40,8,59
St Mirren,2769,5,10,10,16,44,54,-10,40
Ayr,2769,6,9,13,14,36,52,-16,40
Queen of S't,2769,7,10,9,17,44,56,-12,39
Dunfermline,2769,8,8,14,14,48,53,-5,38
Raith,2769,9,9,11,16,37,50,-13,38
Dumbarton,2769,10,7,14,15,48,61,-13,35
Hibernian,2770,1,21,10,5,58,23,35,73
Morton,2770,2,19,11,6,57,33,24,68
Dundee Utd,2770,3,17,10,9,57,41,16,61
Falkirk,2770,4,16,10,10,60,46,14,58
Raith,2770,5,11,9,16,42,52,-10,42
Queen of S't,2770,6,10,11,15,46,53,-7,41
Dunfermline,2770,7,8,15,13,43,55,-12,39
Dumbarton,2770,8,7,14,15,44,55,-11,35
St Mirren,2770,9,8,10,18,39,61,-22,34
Ayr,2770,10,7,12,17,32,59,-27,33
Hibernian,2771,1,22,11,3,56,20,36,77
Falkirk,2771,2,18,10,8,63,40,23,64
Morton,2771,3,16,12,8,48,36,12,60
Dundee Utd,2771,4,14,10,12,45,41,4,52
Dunfermline,2771,5,11,14,11,49,47,2,47
Queen of S't,2771,6,11,10,15,43,50,-7,43
Ayr,2771,7,9,13,14,33,47,-14,40
St Mirren,2771,8,9,10,17,41,57,-16,37
Dumbarton,2771,9,7,12,17,48,64,-16,33
Raith,2771,10,8,8,20,34,58,-24,32
Morton,2772,1,19,11,6,49,29,20,68
Hibernian,2772,2,18,12,6,50,27,23,66
Dundee Utd,2772,3,17,11,8,56,37,19,62
Falkirk,2772,4,17,9,10,66,47,19,60
Queen of S't,2772,5,12,9,15,47,52,-5,45
Dumbarton,2772,6,11,11,14,50,57,-7,44
Raith,2772,7,11,8,17,34,47,-13,41
Ayr,2772,8,8,12,16,32,52,-20,36
Dunfermline,2772,9,7,13,16,38,51,-13,34
St Mirren,2772,10,7,10,19,39,62,-23,31
Hibernian,2773,1,19,12,5,55,29,26,69
Morton,2773,2,18,10,8,56,39,17,64
Dundee Utd,2773,3,17,10,9,55,42,13,61
Falkirk,2773,4,16,12,8,59,39,20,60
Dunfermline,2773,5,10,13,13,48,50,-2,43
Raith,2773,6,11,9,16,39,48,-9,42
Queen of S't,2773,7,11,9,16,42,53,-11,42
Dumbarton,2773,8,8,13,15,44,57,-13,37
St Mirren,2773,9,9,10,17,41,55,-14,37
Ayr,2773,10,7,10,19,29,56,-27,31
Hibernian,2774,1,18,12,6,53,29,24,66
Falkirk,2774,2,17,9,10,62,42,20,60
Morton,2774,3,16,12,8,51,37,14,60
Dundee Utd,2774,4,16,10,10,52,43,9,58
Dunfermline,2774,5,12,12,12,48,45,3,48
Queen of S't,2774,6,13,9,14,44,49,-5,48
Dumbarton,2774,7,9,11,16,50,60,-10,38
Ayr,2774,8,8,14,14,38,55,-17,38
Raith,2774,9,8,11,17,31,51,-20,35
St Mirren,2774,10,7,12,17,35,53,-18,33
Hibernian,2775,1,20,11,5,61,28,33,71
Morton,2775,2,16,11,9,51,40,11,59
Falkirk,2775,3,16,10,10,60,44,16,58
Dundee Utd,2775,4,14,9,13,48,43,5,51
Queen of S't,2775,5,14,8,14,51,54,-3,50
Dumbarton,2775,6,11,12,13,52,55,-3,45
Dunfermline,2775,7,10,12,14,43,49,-6,42
Raith,2775,8,10,10,16,36,47,-11,40
St Mirren,2775,9,9,11,16,42,56,-14,38
Ayr,2775,10,7,12,17,34,62,-28,33
Hibernian,2776,1,19,12,5,62,25,37,69
Falkirk,2776,2,18,10,8,64,39,25,64
Morton,2776,3,17,13,6,49,35,14,64
Dundee Utd,2776,4,15,10,11,53,46,7,55
Queen of S't,2776,5,14,10,12,47,44,3,52
St Mirren,2776,6,10,9,17,46,59,-13,39
Dumbarton,2776,7,9,11,16,55,59,-4,38
Dunfermline,2776,8,7,14,15,40,58,-18,35
Raith,2776,9,8,11,17,33,57,-24,35
Ayr,2776,10,6,14,16,31,58,-27,32
Hibernian,2777,1,18,13,5,57,28,29,67
Morton,2777,2,18,10,8,53,37,16,64
Falkirk,2777,3,14,13,9,55,41,14,55
Dundee Utd,2777,4,14,12,10,50,43,7,54
Queen of S't,2777,5,12,9,15,45,51,-6,45
Ayr,2777,6,11,12,13,37,51,-14,45
Raith,2777,7,11,10,15,37,48,-11,43
St Mirren,2777,8,10,10,16,45,55,-10,40
Dunfermline,2777,9,7,14,15,42,52,-10,35
Dumbarton,2777,10,7,13,16,44,59,-15,34
Hibernian,2778,1,18,13,5,51,23,28,67
Falkirk,2778,2,15,12,9,57,39,18,57
Morton,2778,3,15,12,9,44,36,8,57
Dundee Utd,2778,4,15,9,12,54,45,9,54
Dunfermline,2778,5,12,11,13,50,45,5,47
Raith,2778,6,12,10,14,41,48,-7,46
Queen of S't,2778,7,11,11,14,42,50,-8,44
Ayr,2778,8,11,11,14,38,50,-12,44
Dumbarton,2778,9,8,13,15,47,63,-16,37
St Mirren,2778,10,7,10,19,36,61,-25,31
Hibernian,2779,1,18,13,5,52,24,28,67
Falkirk,2779,2,18,10,8,67,45,22,64
Morton,2779,3,18,10,8,51,36,15,64
Dundee Utd,2779,4,14,10,12,51,45,6,52
Dunfermline,2779,5,12,13,11,52,47,5,49
Ayr,2779,6,9,14,13,37,52,-15,41
Dumbarton,2779,7,9,12,15,54,62,-8,39
Queen of S't,2779,8,10,9,17,41,53,-12,39
Raith,2779,9,9,10,17,34,54,-20,37
St Mirren,2779,10,7,11,18,34,55,-21,32
Hibernian,2780,1,19,12,5,51,25,26,69
Falkirk,2780,2,17,10,9,60,38,22,61
Morton,2780,3,17,10,9,47,35,12,61
Dundee Utd,2780,4,17,9,10,57,38,19,60
Queen of S't,2780,5,12,10,14,47,48,-1,46
St Mirren,2780,6,10,11,15,38,49,-11,41
Dumbarton,2780,7,10,10,16,49,59,-10,40
Dunfermline,2780,8,9,13,14,42,52,-10,40
Raith,2780,9,8,11,17,33,50,-17,35
Ayr,2780,10,7,12,17,29,59,-30,33
Hibernian,2781,1,20,11,5,55,23,32,71
Morton,2781,2,20,10,6,51,31,20,70
Falkirk,2781,3,15,11,10,58,43,15,56
Dundee Utd,2781,4,13,13,10,48,42,6,52
Queen of S't,2781,5,12,9,15,44,50,-6,45
Dunfermline,2781,6,10,14,12,43,45,-2,44
Raith,2781,7,11,9,16,35,49,-14,42
Dumbarton,2781,8,9,11,16,49,63,-14,38
St Mirren,2781,9,8,12,16,41,52,-11,36
Ayr,2781,10,6,12,18,30,56,-26,30
Hibernian,2782,1,16,15,5,49,25,24,63
Falkirk,2782,2,16,12,8,62,44,18,60
Dundee Utd,2782,3,15,10,11,53,45,8,55
Morton,2782,4,14,12,10,45,38,7,54
Raith,2782,5,12,10,14,40,46,-6,46
Dunfermline,2782,6,10,14,12,47,49,-2,44
Dumbarton,2782,7,10,13,13,50,55,-5,43
Queen of S't,2782,8,11,10,15,47,53,-6,43
Ayr,2782,9,9,11,16,39,59,-20,38
St Mirren,2782,10,8,11,17,42,60,-18,35
Hibernian,2783,1,19,11,6,58,27,31,68
Morton,2783,2,18,12,6,51,34,17,66
Falkirk,2783,3,16,9,11,57,40,17,57
Dundee Utd,2783,4,15,9,12,48,43,5,54
Dunfermline,2783,5,11,15,10,54,49,5,48
Queen of S't,2783,6,13,8,15,43,49,-6,47
Ayr,2783,7,10,10,16,36,52,-16,40
Raith,2783,8,9,10,17,32,49,-17,37
Dumbarton,2783,9,8,11,17,46,62,-16,35
St Mirren,2783,10,8,11,17,39,59,-20,35
Hibernian,2784,1,21,12,3,57,23,34,75
Falkirk,2784,2,19,9,8,63,37,26,66
Morton,2784,3,16,11,9,50,37,13,59
Dundee Utd,2784,4,14,11,11,48,43,5,53
Queen of S't,2784,5,13,9,14,48,49,-1,48
Ayr,2784,6,8,14,14,34,54,-20,38
Dunfermline,2784,7,8,13,15,44,52,-8,37
Raith,2784,8,9,10,17,34,51,-17,37
Dumbarton,2784,9,8,12,16,45,57,-12,36
St Mirren,2784,10,8,11,17,42,62,-20,35
Hibernian,2785,1,22,11,3,58,19,39,77
Morton,2785,2,16,12,8,52,36,16,60
Dundee Utd,2785,3,16,10,10,50,41,9,58
Falkirk,2785,4,13,13,10,54,45,9,52
Dumbarton,2785,5,11,12,13,53,54,-1,45
Queen of S't,2785,6,11,10,15,45,52,-7,43
Dunfermline,2785,7,8,16,12,42,45,-3,40
Raith,2785,8,9,10,17,34,52,-18,37
Ayr,2785,9,8,12,16,35,58,-23,36
St Mirren,2785,10,6,14,16,41,62,-21,32
Hibernian,2786,1,20,11,5,62,26,36,71
Morton,2786,2,17,10,9,49,39,10,61
Falkirk,2786,3,15,11,10,59,44,15,56
Dundee Utd,2786,4,15,11,10,45,38,7,56
Dunfermline,2786,5,10,14,12,48,52,-4,44
Queen of S't,2786,6,11,11,14,43,48,-5,44
Raith,2786,7,10,12,14,37,49,-12,42
Dumbarton,2786,8,8,14,14,42,52,-10,38
St Mirren,2786,9,9,10,17,41,55,-14,37
Ayr,2786,10,7,12,17,29,52,-23,33
Hibernian,2787,1,17,14,5,53,28,25,65
Falkirk,2787,2,18,11,7,61,38,23,65
Morton,2787,3,18,9,9,55,39,16,63
Dundee Utd,2787,4,14,10,12,54,50,4,52
Queen of S't,2787,5,12,9,15,45,49,-4,45
Dunfermline,2787,6,10,12,14,46,48,-2,42
Raith,2787,7,11,8,17,33,47,-14,41
Dumbarton,2787,8,10,10,16,47,58,-11,40
St Mirren,2787,9,9,11,16,37,53,-16,38
Ayr,2787,10,7,14,15,32,53,-21,35
Hibernian,2788,1,22,11,3,58,20,38,77
Morton,2788,2,18,12,6,56,34,22,66
Falkirk,2788,3,18,10,8,63,36,27,64
Dundee Utd,2788,4,13,12,11,49,42,7,51
Dunfermline,2788,5,9,12,15,42,50,-8,39
St Mirren,2788,6,10,9,17,46,56,-10,39
Raith,2788,7,10,9,17,38,53,-15,39
Queen of S't,2788,8,10,9,17,46,62,-16,39
Ayr,2788,9,9,11,16,37,60,-23,38
Dumbarton,2788,10,8,11,17,46,68,-22,35
Hibernian,2789,1,19,13,4,58,27,31,70
Morton,2789,2,15,14,7,52,39,13,59
Dundee Utd,2789,3,16,11,9,47,37,10,59
Falkirk,2789,4,15,11,10,59,45,14,56
Queen of S't,2789,5,12,10,14,45,46,-1,46
Raith,2789,6,11,11,14,38,47,-9,44
Dunfermline,2789,7,8,16,12,46,48,-2,40
Dumbarton,2789,8,7,14,15,47,61,-14,35
St Mirren,2789,9,8,11,17,40,59,-19,35
Ayr,2789,10,7,13,16,33,56,-23,34
Hibernian,2790,1,19,10,7,55,29,26,67
Falkirk,2790,2,18,10,8,64,39,25,64
Morton,2790,3,17,11,8,49,36,13,62
Dundee Utd,2790,4,15,8,13,52,45,7,53
Queen of S't,2790,5,13,10,13,51,49,2,49
Dunfermline,2790,6,10,12,14,48,53,-5,42
Raith,2790,7,10,11,15,39,50,-11,41
Ayr,2790,8,9,13,14,35,55,-20,40
Dumbarton,2790,9,9,11,16,45,58,-13,38
St Mirren,2790,10,7,10,19,38,62,-24,31
Hibernian,2791,1,17,14,5,53,25,28,65
Falkirk,2791,2,18,10,8,61,39,22,64
Morton,2791,3,15,15,6,51,37,14,60
Dundee Utd,2791,4,15,11,10,51,39,12,56
Raith,2791,5,10,12,14,35,46,-11,42
Queen of S't,2791,6,11,9,16,42,54,-12,42
St Mirren,2791,7,10,11,15,43,53,-10,41
Dunfermline,2791,8,8,15,13,43,47,-4,39
Dumbarton,2791,9,8,13,15,44,56,-12,37
Ayr,2791,10,7,12,17,33,60,-27,33
Hibernian,2792,1,19,12,5,56,28,28,69
Morton,2792,2,18,10,8,50,34,16,64
Falkirk,2792,3,16,10,10,56,40,16,58
Dundee Utd,2792,4,14,9,13,45,40,5,51
Queen of S't,2792,5,12,9,15,47,48,-1,45
Dunfermline,2792,6,11,11,14,46,48,-2,44
Dumbarton,2792,7,11,11,14,54,60,-6,44
Raith,2792,8,11,9,16,36,48,-12,42
St Mirren,2792,9,9,10,17,41,58,-17,37
Ayr,2792,10,7,13,16,36,63,-27,34
Hibernian,2793,1,19,13,4,57,24,33,70
Falkirk,2793,2,18,11,7,61,35,26,65
Dundee Utd,2793,3,16,10,10,52,37,15,58
Morton,2793,4,14,13,9,45,37,8,55
Queen of S't,2793,5,11,10,15,43,52,-9,43
Dunfermline,2793,6,10,12,14,45,54,-9,42
St Mirren,2793,7,11,9,16,44,53,-9,42
Raith,2793,8,10,10,16,35,49,-14,40
Ayr,2793,9,8,13,15,36,56,-20,37
Dumbarton,2793,10,7,11,18,44,65,-21,32
Hibernian,2794,1,18,14,4,54,24,30,68
Dundee Utd,2794,2,17,10,9,50,37,13,61
Morton,2794,3,16,12,8,50,37,13,60
Falkirk,2794,4,16,9,11,59,45,14,57
Queen of S't,2794,5,12,9,15,44,50,-6,45
Raith,2794,6,11,11,14,43,51,-8,44
Dumbarton,2794,7,10,11,15,49,58,-9,41
Dunfermline,2794,8,9,13,14,44,49,-5,40
St Mirren,2794,9,9,9,18,44,58,-14,36
Ayr,2794,10,7,12,17,30,58,-28,33
Hibernian,2795,1,20,13,3,61,26,35,73
Dundee Utd,2795,2,17,9,10,54,42,12,60
Morton,2795,3,15,10,11,50,46,4,55
Falkirk,2795,4,14,11,11,55,45,10,53
Dunfermline,2795,5,12,13,11,54,45,9,49
Queen of S't,2795,6,11,11,14,47,51,-4,44
Dumbarton,2795,7,10,12,14,48,58,-10,42
St Mirren,2795,8,10,9,17,45,57,-12,39
Raith,2795,9,9,10,17,36,56,-20,37
Ayr,2795,10,8,10,18,35,59,-24,34
Hibernian,2796,1,17,14,5,52,28,24,65
Morton,2796,2,17,12,7,50,34,16,63
Falkirk,2796,3,15,13,8,59,38,21,58
Dundee Utd,2796,4,15,11,10,48,37,11,56
Queen of S't,2796,5,12,8,16,44,50,-6,44
Dunfermline,2796,6,10,13,13,45,46,-1,43
Dumbarton,2796,7,10,11,15,49,61,-12,41
Raith,2796,8,10,11,15,33,48,-15,41
Ayr,2796,9,7,14,15,31,52,-21,35
St Mirren,2796,10,7,13,16,40,57,-17,34
Hibernian,2797,1,19,11,6,56,29,27,68
Falkirk,2797,2,16,12,8,61,40,21,60
Dundee Utd,2797,3,16,11,9,51,38,13,59
Morton,2797,4,14,11,11,46,41,5,53
Dunfermline,2797,5,13,11,12,51,49,2,50
Queen of S't,2797,6,10,11,15,46,53,-7,41
Ayr,2797,7,9,14,13,36,51,-15,41
Dumbarton,2797,8,9,12,15,49,58,-9,39
Raith,2797,9,9,11,16,33,51,-18,38
St Mirren,2797,10,8,10,18,38,57,-19,34
Hibernian,2798,1,18,13,5,54,26,28,67
Falkirk,2798,2,18,9,9,60,40,20,63
Dundee Utd,2798,3,17,9,10,53,40,13,60
Morton,2798,4,15,14,7,52,36,16,59
Raith,2798,5,11,9,16,35,52,-17,42
St Mirren,2798,6,10,11,15,51,54,-3,41
Dunfermline,2798,7,9,13,14,45,50,-5,40
Queen of S't,2798,8,10,9,17,43,56,-13,39
Ayr,2798,9,9,12,15,35,58,-23,39
Dumbarton,2798,10,7,13,16,44,60,-16,34
Hibernian,2799,1,18,15,3,56,24,32,69
Morton,2799,2,19,11,6,51,34,17,68
Falkirk,2799,3,17,10,9,63,39,24,61
Dundee Utd,2799,4,15,10,11,46,41,5,55
Queen of S't,2799,5,11,9,16,41,52,-11,42
Dunfermline,2799,6,9,13,14,45,52,-7,40
Dumbarton,2799,7,9,12,15,46,56,-10,39
Ayr,2799,8,8,14,14,35,53,-18,38
Raith,2799,9,8,12,16,33,48,-15,36
St Mirren,2799,10,7,12,17,40,57,-17,33
Hibernian,2800,1,18,14,4,56,28,28,68
Dundee Utd,2800,2,19,9,8,61,37,24,66
Falkirk,2800,3,17,12,7,58,37,21,63
Morton,2800,4,16,11,9,49,40,9,59
Queen of S't,2800,5,10,11,15,41,52,-11,41
Dunfermline,2800,6,8,15,13,44,48,-4,39
Raith,2800,7,9,11,16,34,47,-13,38
Dumbarton,2800,8,8,13,15,46,58,-12,37
St Mirren,2800,9,8,11,17,41,58,-17,35
Ayr,2800,10,7,13,16,30,55,-25,34
Hibernian,2801,1,18,12,6,56,32,24,66
Morton,2801,2,18,12,6,53,33,20,66
Falkirk,2801,3,16,11,9,55,38,17,59
Dundee Utd,2801,4,16,8,12,48,44,4,56
Raith,2801,5,12,9,15,37,46,-9,45
Queen of S't,2801,6,11,9,16,47,53,-6,42
Dunfermline,2801,7,9,13,14,44,48,-4,40
Dumbarton,2801,8,9,12,15,52,61,-9,39
St Mirren,2801,9,9,11,16,48,59,-11,38
Ayr,2801,10,8,11,17,33,59,-26,35
Hibernian,2802,1,21,11,4,61,28,33,74
Morton,2802,2,16,11,9,49,40,9,59
Dundee Utd,2802,3,15,12,9,51,36,15,57
Falkirk,2802,4,14,13,9,53,40,13,55
Queen of S't,2802,5,13,10,13,50,48,2,49
Dunfermline,2802,6,9,13,14,44,50,-6,40
Raith,2802,7,9,11,16,33,47,-14,38
Dumbarton,2802,8,8,13,15,47,63,-16,37
Ayr,2802,9,8,13,15,33,52,-19,37
St Mirren,2802,10,7,13,16,38,55,-17,34
Hibernian,2803,1,19,12,5,54,25,29,69
Morton,2803,2,16,11,9,49,35,14,59
Falkirk,2803,3,16,10,10,57,41,16,58
Dundee Utd,2803,4,16,8,12,50,40,10,56
Ayr,2803,5,13,11,12,43,48,-5,50
Queen of S't,2803,6,12,8,16,47,53,-6,44
Dunfermline,2803,7,10,12,14,44,49,-5,42
Raith,2803,8,10,10,16,35,50,-15,40
St Mirren,2803,9,9,9,18,46,64,-18,36
Dumbarton,2803,10,8,11,17,47,67,-20,35
Hibernian,2804,1,21,11,4,61,26,35,74
Morton,2804,2,18,10,8,56,36,20,64
Falkirk,2804,3,16,9,11,56,41,15,57
Dundee Utd,2804,4,14,11,11,48,45,3,53
Dunfermline,2804,5,10,14,12,49,48,1,44
Queen of S't,2804,6,11,10,15,45,50,-5,43
Ayr,2804,7,9,12,15,37,52,-15,39
Dumbarton,2804,8,9,11,16,47,61,-14,38
St Mirren,2804,9,9,10,17,44,60,-16,37
Raith,2804,10,9,10,17,32,56,-24,37
Hibernian,2805,1,18,13,5,53,24,29,67
Morton,2805,2,15,12,9,50,38,12,57
Dundee Utd,2805,3,15,12,9,48,38,10,57
Falkirk,2805,4,15,10,11,53,40,13,55
Dunfermline,2805,5,11,12,13,46,48,-2,45
Raith,2805,6,11,12,13,37,46,-9,45
Queen of S't,2805,7,11,10,15,42,47,-5,43
Dumbarton,2805,8,9,11,16,52,62,-10,38
St Mirren,2805,9,9,11,16,42,56,-14,38
Ayr,2805,10,8,13,15,31,55,-24,37
Hibernian,2806,1,20,12,4,58,24,34,72
Falkirk,2806,2,17,10,9,56,39,17,61
Dundee Utd,2806,3,17,9,10,47,38,9,60
Morton,2806,4,14,12,10,45,38,7,54
Dunfermline,2806,5,11,11,14,48,48,0,44
Dumbarton,2806,6,11,10,15,51,58,-7,43
Queen of S't,2806,7,10,9,17,41,51,-10,39
Ayr,2806,8,9,12,15,36,52,-16,39
Raith,2806,9,10,9,17,36,55,-19,39
St Mirren,2806,10,8,12,16,41,56,-15,36
Hibernian,2807,1,20,11,5,55,23,32,71
Morton,2807,2,18,11,7,53,34,19,65
Falkirk,2807,3,16,11,9,55,38,17,59
Dundee Utd,2807,4,15,9,12,51,40,11,54
Queen of S't,2807,5,14,9,13,51,50,1,51
Dunfermline,2807,6,10,12,14,46,52,-6,42
St Mirren,2807,7,8,13,15,44,55,-11,37
Ayr,2807,8,9,10,17,37,55,-18,37
Raith,2807,9,9,10,17,33,51,-18,37
Dumbarton,2807,10,8,10,18,46,73,-27,34
Hibernian,2808,1,19,13,4,62,32,30,70
Morton,2808,2,18,11,7,49,33,16,65
Falkirk,2808,3,16,9,11,63,45,18,57
Dundee Utd,2808,4,14,13,9,46,37,9,55
Dunfermline,2808,5,10,13,13,51,49,2,43
Raith,2808,6,11,10,15,37,48,-11,43
Ayr,2808,7,10,12,14,40,53,-13,42
Queen of S't,2808,8,10,9,17,38,51,-13,39
Dumbarton,2808,9,9,12,15,44,58,-14,39
St Mirren,2808,10,6,12,18,36,60,-24,30
Hibernian,2809,1,19,13,4,54,23,31,70
Morton,2809,2,18,11,7,56,34,22,65
Falkirk,2809,3,16,12,8,60,36,24,60
Dundee Utd,2809,4,14,10,12,54,49,5,52
Raith,2809,5,12,9,15,37,48,-11,45
Dunfermline,2809,6,10,14,12,47,48,-1,44
Queen of S't,2809,7,11,9,16,41,53,-12,42
Dumbarton,2809,8,10,11,15,48,61,-13,41
Ayr,2809,9,8,12,16,37,60,-23,36
St Mirren,2809,10,7,9,20,39,61,-22,30
Hibernian,2810,1,20,11,5,56,28,28,71
Dundee Utd,2810,2,18,10,8,56,39,17,64
Falkirk,2810,3,16,11,9,58,38,20,59
Morton,2810,4,16,9,11,52,46,6,57
Dunfermline,2810,5,11,12,13,51,50,1,45
Ayr,2810,6,10,13,13,36,50,-14,43
Queen of S't,2810,7,11,9,16,46,52,-6,42
Raith,2810,8,11,8,17,34,49,-15,41
Dumbarton,2810,9,7,12,17,46,64,-18,33
St Mirren,2810,10,7,11,18,37,56,-19,32
Hibernian,2811,1,18,13,5,54,27,27,67
Morton,2811,2,18,12,6,53,37,16,66
Falkirk,2811,3,15,9,12,55,39,16,54
Dundee Utd,2811,4,15,9,12,49,43,6,54
Queen of S't,2811,5,13,9,14,47,46,1,48
Dumbarton,2811,6,11,11,14,50,55,-5,44
Dunfermline,2811,7,8,16,12,42,47,-5,40
Raith,2811,8,10,10,16,34,49,-15,40
St Mirren,2811,9,9,10,17,44,61,-17,37
Ayr,2811,10,8,11,17,34,58,-24,35
Hibernian,2812,1,20,12,4,53,21,32,72
Morton,2812,2,17,11,8,50,37,13,62
Falkirk,2812,3,15,12,9,56,43,13,57
Dundee Utd,2812,4,15,8,13,49,43,6,53
Queen of S't,2812,5,12,10,14,41,46,-5,46
Dunfermline,2812,6,11,12,13,48,46,2,45
Raith,2812,7,10,10,16,34,48,-14,40
Dumbarton,2812,8,9,12,15,48,57,-9,39
Ayr,2812,9,8,13,15,33,52,-19,37
St Mirren,2812,10,8,10,18,35,54,-19,34
Hibernian,2813,1,21,11,4,60,28,32,74
Dundee Utd,2813,2,16,11,9,51,39,12,59
Morton,2813,3,15,12,9,46,36,10,57
Falkirk,2813,4,14,13,9,57,40,17,55
Queen of S't,2813,5,10,12,14,44,48,-4,42
Ayr,2813,6,9,14,13,38,53,-15,41
Raith,2813,7,9,13,14,37,49,-12,40
Dumbarton,2813,8,9,12,15,47,61,-14,39
Dunfermline,2813,9,8,14,14,41,48,-7,38
St Mirren,2813,10,7,12,17,38,57,-19,33
Hibernian,2814,1,19,12,5,60,28,32,69
Dundee Utd,2814,2,16,11,9,51,39,12,59
Morton,2814,3,16,11,9,50,41,9,59
Falkirk,2814,4,15,11,10,55,40,15,56
Queen of S't,2814,5,12,11,13,47,47,0,47
Raith,2814,6,10,11,15,39,53,-14,41
Ayr,2814,7,10,11,15,38,56,-18,41
Dunfermline,2814,8,8,16,12,42,46,-4,40
Dumbarton,2814,9,9,11,16,44,57,-13,38
St Mirren,2814,10,8,9,19,37,56,-19,33
Hibernian,2815,1,19,12,5,54,24,30,69
Falkirk,2815,2,17,12,7,63,41,22,63
Morton,2815,3,16,13,7,49,36,13,61
Dundee Utd,2815,4,15,11,10,48,39,9,56
Queen of S't,2815,5,12,9,15,46,53,-7,45
Dunfermline,2815,6,9,14,13,48,47,1,41
Ayr,2815,7,9,12,15,35,54,-19,39
St Mirren,2815,8,9,10,17,41,55,-14,37
Dumbarton,2815,9,8,12,16,44,61,-17,36
Raith,2815,10,8,11,17,30,48,-18,35
Hibernian,2816,1,18,13,5,51,23,28,67
Morton,2816,2,17,13,6,48,30,18,64
Dundee Utd,2816,3,16,11,9,49,36,13,59
Falkirk,2816,4,15,10,11,56,44,12,55
Dunfermline,2816,5,10,16,10,45,42,3,46
Queen of S't,2816,6,11,10,15,45,52,-7,43
Raith,2816,7,11,9,16,35,48,-13,42
Ayr,2816,8,8,12,16,33,55,-22,36
Dumbarton,2816,9,7,14,15,44,55,-11,35
St Mirren,2816,10,8,10,18,39,60,-21,34
Hibernian,2817,1,19,12,5,51,25,26,69
Morton,2817,2,18,11,7,54,33,21,65
Falkirk,2817,3,18,9,9,61,42,19,63
Dundee Utd,2817,4,14,11,11,53,45,8,53
Queen of S't,2817,5,11,12,13,45,48,-3,45
Raith,2817,6,11,9,16,36,54,-18,42
Dunfermline,2817,7,10,11,15,47,54,-7,41
Ayr,2817,8,9,14,13,41,55,-14,41
Dumbarton,2817,9,8,12,16,45,56,-11,36
St Mirren,2817,10,7,9,20,36,57,-21,30
Hibernian,2818,1,22,11,3,64,23,41,77
Morton,2818,2,18,11,7,56,37,19,65
Falkirk,2818,3,17,9,10,57,42,15,60
Dundee Utd,2818,4,15,10,11,45,39,6,55
Queen of S't,2818,5,12,10,14,43,47,-4,46
Dunfermline,2818,6,9,13,14,47,52,-5,40
Dumbarton,2818,7,9,11,16,46,55,-9,38
St Mirren,2818,8,9,9,18,43,64,-21,36
Ayr,2818,9,8,12,16,32,53,-21,36
Raith,2818,10,8,10,18,34,55,-21,34
Hibernian,2819,1,19,12,5,58,26,32,69
Morton,2819,2,15,12,9,49,38,11,57
Falkirk,2819,3,14,12,10,53,40,13,54
Dundee Utd,2819,4,15,9,12,49,41,8,54
Ayr,2819,5,11,13,12,37,50,-13,46
Dunfermline,2819,6,9,15,12,44,47,-3,42
Raith,2819,7,11,9,16,35,46,-11,42
Queen of S't,2819,8,10,11,15,39,50,-11,41
Dumbarton,2819,9,10,10,16,49,62,-13,40
St Mirren,2819,10,9,11,16,42,55,-13,38
Hibernian,2820,1,20,11,5,60,23,37,71
Morton,2820,2,17,10,9,55,40,15,61
Falkirk,2820,3,16,12,8,61,38,23,60
Dundee Utd,2820,4,15,11,10,54,44,10,56
Dunfermline,2820,5,11,13,12,46,46,0,46
Raith,2820,6,11,11,14,36,48,-12,44
Queen of S't,2820,7,10,9,17,42,57,-15,39
Dumbarton,2820,8,9,11,16,50,66,-16,38
Ayr,2820,9,8,14,14,39,55,-16,38
St Mirren,2820,10,7,10,19,38,64,-26,31
Hibernian,2821,1,19,12,5,58,27,31,69
Morton,2821,2,17,10,9,53,38,15,61
Falkirk,2821,3,17,9,10,57,39,18,60
Dundee Utd,2821,4,16,9,11,51,44,7,57
Queen of S't,2821,5,12,9,15,48,53,-5,45
Raith,2821,6,11,9,16,35,50,-15,42
Ayr,2821,7,10,11,15,38,54,-16,41
Dunfermline,2821,8,9,13,14,50,50,0,40
Dumbarton,2821,9,9,11,16,48,65,-17,38
St Mirren,2821,10,8,11,17,43,61,-18,35
Hibernian,2822,1,20,12,4,61,25,36,72
Morton,2822,2,17,11,8,56,39,17,62
Falkirk,2822,3,16,10,10,61,44,17,58
Dundee Utd,2822,4,13,10,13,45,49,-4,49
Queen of S't,2822,5,12,9,15,43,49,-6,45
Dunfermline,2822,6,10,12,14,47,50,-3,42
St Mirren,2822,7,11,9,16,50,56,-6,42
Raith,2822,8,11,9,16,34,48,-14,42
Dumbarton,2822,9,10,11,15,49,58,-9,41
Ayr,2822,10,8,11,17,35,63,-28,35
Hibernian,2823,1,21,12,3,56,21,35,75
Dundee Utd,2823,2,18,10,8,57,37,20,64
Falkirk,2823,3,16,11,9,61,41,20,59
Morton,2823,4,15,13,8,51,37,14,58
Dunfermline,2823,5,10,14,12,47,46,1,44
Queen of S't,2823,6,10,11,15,42,50,-8,41
Dumbarton,2823,7,9,11,16,45,59,-14,38
Raith,2823,8,9,9,18,34,56,-22,36
Ayr,2823,9,8,11,17,31,58,-27,35
St Mirren,2823,10,8,10,18,39,58,-19,34
Hibernian,2824,1,21,10,5,54,24,30,73
Falkirk,2824,2,16,10,10,58,41,17,58
Morton,2824,3,15,13,8,46,35,11,58
Dundee Utd,2824,4,14,13,9,45,35,10,55
Dunfermline,2824,5,10,14,12,45,45,0,44
Dumbarton,2824,6,10,13,13,52,58,-6,43
Queen of S't,2824,7,10,12,14,43,52,-9,42
Raith,2824,8,9,12,15,33,46,-13,39
St Mirren,2824,9,8,12,16,39,52,-13,36
Ayr,2824,10,6,13,17,31,58,-27,31
Hibernian,2825,1,18,14,4,53,24,29,68
Dundee Utd,2825,2,18,9,9,49,35,14,63
Falkirk,2825,3,16,11,9,55,39,16,59
Morton,2825,4,15,13,8,48,37,11,58
Queen of S't,2825,5,13,9,14,45,48,-3,48
Raith,2825,6,11,9,16,34,45,-11,42
Dumbarton,2825,7,10,11,15,45,54,-9,41
Dunfermline,2825,8,7,15,14,45,52,-7,36
St Mirren,2825,9,8,10,18,38,56,-18,34
Ayr,2825,10,7,13,16,34,56,-22,34
Hibernian,2826,1,19,13,4,52,21,31,70
Morton,2826,2,17,11,8,51,36,15,62
Dundee Utd,2826,3,14,13,9,50,38,12,55
Falkirk,2826,4,13,11,12,52,48,4,50
Raith,2826,5,12,10,14,42,44,-2,46
Queen of S't,2826,6,12,9,15,44,56,-12,45
Dunfermline,2826,7,10,13,13,47,46,1,43
Dumbarton,2826,8,9,12,15,52,59,-7,39
Ayr,2826,9,8,14,14,36,54,-18,38
St Mirren,2826,10,8,10,18,40,64,-24,34
Hibernian,2827,1,18,14,4,59,31,28,68
Morton,2827,2,17,14,5,55,35,20,65
Falkirk,2827,3,18,10,8,67,41,26,64
Dundee Utd,2827,4,14,11,11,50,43,7,53
Dunfermline,2827,5,10,15,11,47,47,0,45
Queen of S't,2827,6,10,11,15,44,56,-12,41
Dumbarton,2827,7,9,11,16,46,59,-13,38
Ayr,2827,8,9,11,16,37,56,-19,38
Raith,2827,9,9,10,17,34,49,-15,37
St Mirren,2827,10,8,9,19,35,57,-22,33
Hibernian,2828,1,19,12,5,58,26,32,69
Dundee Utd,2828,2,17,9,10,49,36,13,60
Morton,2828,3,16,10,10,46,37,9,58
Falkirk,2828,4,15,10,11,56,43,13,55
Dunfermline,2828,5,11,14,11,46,45,1,47
Raith,2828,6,12,10,14,41,46,-5,46
Queen of S't,2828,7,12,9,15,47,52,-5,45
St Mirren,2828,8,9,10,17,42,58,-16,37
Ayr,2828,9,8,12,16,36,57,-21,36
Dumbarton,2828,10,8,10,18,45,66,-21,34
Hibernian,2829,1,19,12,5,55,29,26,69
Dundee Utd,2829,2,20,8,8,55,36,19,68
Falkirk,2829,3,16,10,10,57,39,18,58
Morton,2829,4,15,12,9,50,42,8,57
Raith,2829,5,11,10,15,39,45,-6,43
Dunfermline,2829,6,9,14,13,46,45,1,41
Dumbarton,2829,7,10,10,16,49,59,-10,40
Queen of S't,2829,8,10,9,17,44,58,-14,39
St Mirren,2829,9,8,12,16,42,57,-15,36
Ayr,2829,10,8,11,17,31,58,-27,35
Hibernian,2830,1,20,12,4,56,24,32,72
Dundee Utd,2830,2,17,10,9,52,37,15,61
Morton,2830,3,15,12,9,51,40,11,57
Falkirk,2830,4,14,12,10,55,42,13,54
Raith,2830,5,12,9,15,35,48,-13,45
Dunfermline,2830,6,10,13,13,47,48,-1,43
Queen of S't,2830,7,11,10,15,46,51,-5,43
Dumbarton,2830,8,9,11,16,48,60,-12,38
St Mirren,2830,9,9,11,16,42,57,-15,38
Ayr,2830,10,8,10,18,31,56,-25,34
Hibernian,2831,1,19,11,6,58,24,34,68
Morton,2831,2,18,10,8,54,35,19,64
Falkirk,2831,3,15,9,12,56,45,11,54
Dundee Utd,2831,4,15,9,12,46,43,3,54
Dunfermline,2831,5,13,13,10,48,42,6,52
Queen of S't,2831,6,13,8,15,49,52,-3,47
Raith,2831,7,10,10,16,38,56,-18,40
Dumbarton,2831,8,9,11,16,50,59,-9,38
Ayr,2831,9,8,13,15,31,55,-24,37
St Mirren,2831,10,8,10,18,39,58,-19,34
Hibernian,2832,1,22,11,3,60,22,38,77
Dundee Utd,2832,2,17,10,9,57,42,15,61
Morton,2832,3,16,10,10,52,44,8,58
Falkirk,2832,4,16,9,11,57,46,11,57
Dumbarton,2832,5,10,12,14,51,57,-6,42
Dunfermline,2832,6,10,12,14,47,53,-6,42
Queen of S't,2832,7,10,10,16,42,51,-9,40
St Mirren,2832,8,9,10,17,42,57,-15,37
Raith,2832,9,9,10,17,34,49,-15,37
Ayr,2832,10,8,12,16,35,56,-21,36
Hibernian,2833,1,18,12,6,55,28,27,66
Morton,2833,2,18,12,6,56,34,22,66
Falkirk,2833,3,16,9,11,59,42,17,57
Dundee Utd,2833,4,14,10,12,50,42,8,52
Dunfermline,2833,5,11,12,13,44,45,-1,45
Queen of S't,2833,6,12,8,16,45,56,-11,44
Raith,2833,7,11,10,15,38,48,-10,43
Dumbarton,2833,8,10,10,16,48,61,-13,40
Ayr,2833,9,9,11,16,37,60,-23,38
St Mirren,2833,10,9,10,17,41,57,-16,37
Hibernian,2834,1,20,11,5,56,25,31,71
Morton,2834,2,19,10,7,53,33,20,67
Falkirk,2834,3,16,11,9,58,38,20,59
Dundee Utd,2834,4,16,10,10,52,42,10,58
Raith,2834,5,11,9,16,38,52,-14,42
Queen of S't,2834,6,10,10,16,44,51,-7,40
Dunfermline,2834,7,9,12,15,45,54,-9,39
Ayr,2834,8,8,14,14,36,54,-18,38
St Mirren,2834,9,9,10,17,39,55,-16,37
Dumbarton,2834,10,7,13,16,45,62,-17,34
Hibernian,2835,1,20,12,4,61,29,32,72
Morton,2835,2,16,11,9,48,41,7,59
Dundee Utd,2835,3,15,13,8,53,36,17,58
Falkirk,2835,4,15,11,10,57,45,12,56
Queen of S't,2835,5,12,11,13,49,51,-2,47
Dunfermline,2835,6,11,12,13,48,48,0,45
Ayr,2835,7,9,13,14,36,55,-19,40
Raith,2835,8,10,9,17,35,49,-14,39
St Mirren,2835,9,8,11,17,37,54,-17,35
Dumbarton,2835,10,7,11,18,42,58,-16,32
Hibernian,2836,1,17,13,6,55,26,29,64
Morton,2836,2,18,10,8,48,33,15,64
Falkirk,2836,3,18,9,9,62,41,21,63
Dundee Utd,2836,4,16,10,10,54,41,13,58
Queen of S't,2836,5,13,8,15,47,50,-3,47
Dunfermline,2836,6,10,13,13,49,51,-2,43
Dumbarton,2836,7,10,12,14,50,58,-8,42
Raith,2836,8,10,10,16,35,47,-12,40
St Mirren,2836,9,8,10,18,39,61,-22,34
Ayr,2836,10,7,11,18,29,60,-31,32
Hibernian,2837,1,19,10,7,52,27,25,67
Morton,2837,2,18,10,8,54,42,12,64
Falkirk,2837,3,17,10,9,56,39,17,61
Dundee Utd,2837,4,16,11,9,51,36,15,59
Dunfermline,2837,5,12,11,13,49,46,3,47
Dumbarton,2837,6,10,12,14,47,55,-8,42
Raith,2837,7,11,9,16,33,45,-12,42
Queen of S't,2837,8,9,10,17,40,52,-12,37
St Mirren,2837,9,8,10,18,44,57,-13,34
Ayr,2837,10,7,13,16,32,59,-27,34
Hibernian,2838,1,22,10,4,59,26,33,76
Dundee Utd,2838,2,17,10,9,51,41,10,61
Morton,2838,3,14,12,10,43,40,3,54
Falkirk,2838,4,14,11,11,51,42,9,53
Queen of S't,2838,5,12,10,14,47,49,-2,46
Ayr,2838,6,11,10,15,41,53,-12,43
Dunfermline,2838,7,8,15,13,44,47,-3,39
Dumbarton,2838,8,9,12,15,50,56,-6,39
Raith,2838,9,9,11,16,33,48,-15,38
St Mirren,2838,10,8,11,17,38,55,-17,35
Hibernian,2839,1,19,12,5,52,26,26,69
Falkirk,2839,2,17,10,9,64,41,23,61
Morton,2839,3,15,13,8,51,43,8,58
Dundee Utd,2839,4,15,10,11,53,50,3,55
Dunfermline,2839,5,10,12,14,47,51,-4,42
St Mirren,2839,6,11,9,16,46,53,-7,42
Dumbarton,2839,7,10,12,14,51,60,-9,42
Queen of S't,2839,8,11,9,16,49,59,-10,42
Raith,2839,9,9,10,17,32,46,-14,37
Ayr,2839,10,8,13,15,36,52,-16,37
Hibernian,2840,1,20,12,4,59,28,31,72
Morton,2840,2,17,11,8,49,36,13,62
Falkirk,2840,3,15,11,10,58,42,16,56
Dundee Utd,2840,4,15,8,13,47,39,8,53
Queen of S't,2840,5,12,11,13,47,50,-3,47
Dunfermline,2840,6,10,13,13,44,48,-4,43
Ayr,2840,7,9,12,15,33,53,-20,39
Dumbarton,2840,8,9,11,16,46,58,-12,38
St Mirren,2840,9,9,11,16,43,56,-13,38
Raith,2840,10,9,10,17,38,54,-16,37
Hibernian,2841,1,20,11,5,58,23,35,71
Falkirk,2841,2,16,12,8,57,39,18,60
Dundee Utd,2841,3,15,11,10,52,39,13,56
Morton,2841,4,13,14,9,43,38,5,53
Queen of S't,2841,5,13,9,14,47,49,-2,48
Dunfermline,2841,6,10,13,13,44,50,-6,43
Raith,2841,7,11,8,17,36,49,-13,41
St Mirren,2841,8,9,11,16,38,53,-15,38
Ayr,2841,9,9,11,16,34,57,-23,38
Dumbarton,2841,10,7,14,15,48,60,-12,35
Hibernian,2842,1,19,12,5,56,26,30,69
Morton,2842,2,18,13,5,52,35,17,67
Falkirk,2842,3,15,14,7,61,40,21,59
Dundee Utd,2842,4,16,9,11,53,43,10,57
Ayr,2842,5,9,13,14,33,51,-18,40
Dumbarton,2842,6,9,12,15,43,53,-10,39
Queen of S't,2842,7,9,12,15,42,52,-10,39
Dunfermline,2842,8,8,13,15,44,54,-10,37
Raith,2842,9,9,10,17,37,52,-15,37
St Mirren,2842,10,8,12,16,40,55,-15,36
Hibernian,2843,1,20,10,6,56,26,30,70
Dundee Utd,2843,2,17,10,9,51,36,15,61
Falkirk,2843,3,15,12,9,56,41,15,57
Morton,2843,4,15,11,10,45,37,8,56
Queen of S't,2843,5,12,9,15,50,53,-3,45
Dunfermline,2843,6,10,14,12,45,47,-2,44
Raith,2843,7,11,9,16,32,47,-15,42
St Mirren,2843,8,9,11,16,42,52,-10,38
Dumbarton,2843,9,8,13,15,48,60,-12,37
Ayr,2843,10,8,11,17,33,59,-26,35
Hibernian,2844,1,20,11,5,57,26,31,71
Morton,2844,2,17,11,8,48,34,14,62
Falkirk,2844,3,17,10,9,59,41,18,61
Dundee Utd,2844,4,16,10,10,53,39,14,58
Queen of S't,2844,5,12,9,15,45,50,-5,45
Dunfermline,2844,6,9,14,13,47,52,-5,41
Dumbarton,2844,7,10,10,16,49,63,-14,40
St Mirren,2844,8,9,11,16,39,51,-12,38
Raith,2844,9,9,9,18,33,51,-18,36
Ayr,2844,10,8,11,17,33,56,-23,35
Morton,2845,1,18,12,6,53,36,17,66
Hibernian,2845,2,15,14,7,49,29,20,59
Dundee Utd,2845,3,16,11,9,56,38,18,59
Falkirk,2845,4,15,13,8,57,44,13,58
Queen of S't,2845,5,13,9,14,45,50,-5,48
Dumbarton,2845,6,11,10,15,54,58,-4,43
Dunfermline,2845,7,9,13,14,44,48,-4,40
Raith,2845,8,9,12,15,33,48,-15,39
St Mirren,2845,9,8,12,16,45,57,-12,36
Ayr,2845,10,7,12,17,32,60,-28,33
Hibernian,2846,1,23,10,3,58,22,36,79
Morton,2846,2,18,10,8,52,38,14,64
Dundee Utd,2846,3,16,9,11,48,39,9,57
Falkirk,2846,4,14,11,11,52,41,11,53
Queen of S't,2846,5,13,9,14,49,51,-2,48
Dumbarton,2846,6,10,12,14,52,58,-6,42
Dunfermline,2846,7,10,11,15,45,49,-4,41
Raith,2846,8,10,8,18,37,53,-16,38
St Mirren,2846,9,8,10,18,40,58,-18,34
Ayr,2846,10,8,10,18,35,59,-24,34
Hibernian,2847,1,19,11,6,55,29,26,68
Morton,2847,2,19,11,6,52,33,19,68
Falkirk,2847,3,16,10,10,55,39,16,58
Dundee Utd,2847,4,16,9,11,49,40,9,57
Queen of S't,2847,5,12,10,14,48,51,-3,46
Dunfermline,2847,6,10,13,13,44,44,0,43
St Mirren,2847,7,11,10,15,44,52,-8,43
Dumbarton,2847,8,8,11,17,43,58,-15,35
Raith,2847,9,9,8,19,34,56,-22,35
Ayr,2847,10,8,11,17,33,55,-22,35
Morton,2848,1,20,11,5,55,31,24,71
Hibernian,2848,2,18,10,8,51,29,22,64
Falkirk,2848,3,15,11,10,55,45,10,56
Dundee Utd,2848,4,14,13,9,48,41,7,55
Queen of S't,2848,5,13,9,14,48,46,2,48
Ayr,2848,6,11,11,14,40,51,-11,44
Dumbarton,2848,7,10,12,14,48,55,-7,42
Dunfermline,2848,8,9,14,13,44,47,-3,41
Raith,2848,9,9,10,17,33,49,-16,37
St Mirren,2848,10,6,9,21,39,67,-28,27
Hibernian,2849,1,21,11,4,64,22,42,74
Morton,2849,2,17,9,10,51,40,11,60
Dundee Utd,2849,3,15,12,9,50,39,11,57
Falkirk,2849,4,15,10,11,59,49,10,55
Queen of S't,2849,5,11,11,14,43,51,-8,44
Dunfermline,2849,6,10,13,13,48,49,-1,43
St Mirren,2849,7,10,12,14,46,51,-5,42
Dumbarton,2849,8,9,11,16,46,64,-18,38
Raith,2849,9,9,10,17,32,50,-18,37
Ayr,2849,10,8,11,17,35,59,-24,35
Hibernian,2850,1,18,12,6,55,29,26,66
Falkirk,2850,2,18,9,9,62,41,21,63
Morton,2850,3,17,11,8,49,34,15,62
Dundee Utd,2850,4,17,9,10,51,40,11,60
Queen of S't,2850,5,11,12,13,42,47,-5,45
Dunfermline,2850,6,9,14,13,42,47,-5,41
Dumbarton,2850,7,10,10,16,47,57,-10,40
Ayr,2850,8,10,10,16,34,51,-17,40
St Mirren,2850,9,9,9,18,39,56,-17,36
Raith,2850,10,8,10,18,33,52,-19,34
Hibernian,2851,1,17,15,4,53,26,27,66
Morton,2851,2,17,11,8,49,35,14,62
Falkirk,2851,3,17,10,9,65,41,24,61
Dundee Utd,2851,4,15,11,10,50,38,12,56
Queen of S't,2851,5,12,10,14,49,52,-3,46
Dunfermline,2851,6,10,13,13,46,49,-3,43
Raith,2851,7,10,9,17,35,50,-15,39
Dumbarton,2851,8,9,11,16,48,62,-14,38
St Mirren,2851,9,9,10,17,37,55,-18,37
Ayr,2851,10,8,12,16,33,57,-24,36
Dundee Utd,2852,1,19,9,8,56,36,20,66
Falkirk,2852,2,16,11,9,56,38,18,59
Hibernian,2852,3,15,14,7,49,35,14,59
Morton,2852,4,15,11,10,49,42,7,56
Dunfermline,2852,5,12,12,12,49,46,3,48
Raith,2852,6,12,11,13,41,44,-3,47
Queen of S't,2852,7,12,9,15,44,52,-8,45
Dumbarton,2852,8,9,11,16,50,62,-12,38
Ayr,2852,9,8,10,18,40,60,-20,34
St Mirren,2852,10,7,12,17,39,58,-19,33
Hibernian,2853,1,19,10,7,56,30,26,67
Falkirk,2853,2,18,9,9,58,39,19,63
Morton,2853,3,17,11,8,49,38,11,62
Dundee Utd,2853,4,17,9,10,51,41,10,60
Queen of S't,2853,5,13,10,13,48,47,1,49
Raith,2853,6,10,10,16,36,49,-13,40
St Mirren,2853,7,9,12,15,41,53,-12,39
Dumbarton,2853,8,8,12,16,44,56,-12,36
Ayr,2853,9,8,12,16,38,58,-20,36
Dunfermline,2853,10,8,11,17,41,51,-10,35
Hibernian,2854,1,20,10,6,55,28,27,70
Morton,2854,2,16,12,8,49,35,14,60
Falkirk,2854,3,16,10,10,56,40,16,58
Dundee Utd,2854,4,14,10,12,50,45,5,52
Queen of S't,2854,5,13,9,14,47,45,2,48
Dunfermline,2854,6,11,12,13,46,45,1,45
Raith,2854,7,11,9,16,36,48,-12,42
St Mirren,2854,8,10,10,16,42,53,-11,40
Ayr,2854,9,8,13,15,32,55,-23,37
Dumbarton,2854,10,8,11,17,44,63,-19,35
Morton,2855,1,20,9,7,53,31,22,69
Hibernian,2855,2,19,11,6,56,26,30,68
Falkirk,2855,3,17,11,8,58,39,19,62
Dundee Utd,2855,4,15,11,10,47,40,7,56
Queen of S't,2855,5,12,9,15,45,45,0,45
Dunfermline,2855,6,9,13,14,46,49,-3,40
St Mirren,2855,7,9,11,16,42,61,-19,38
Dumbarton,2855,8,8,13,15,44,60,-16,37
Raith,2855,9,9,10,17,34,51,-17,37
Ayr,2855,10,8,10,18,34,57,-23,34
Hibernian,2856,1,19,11,6,55,26,29,68
Morton,2856,2,18,11,7,53,35,18,65
Dundee Utd,2856,3,16,11,9,50,35,15,59
Falkirk,2856,4,14,10,12,58,46,12,52
Queen of S't,2856,5,11,12,13,44,47,-3,45
Dumbarton,2856,6,10,13,13,49,53,-4,43
Dunfermline,2856,7,9,12,15,45,54,-9,39
Raith,2856,8,9,12,15,33,48,-15,39
St Mirren,2856,9,8,12,16,38,58,-20,36
Ayr,2856,10,7,14,15,35,58,-23,35
Hibernian,2857,1,19,13,4,55,25,30,70
Dundee Utd,2857,2,19,9,8,55,37,18,66
Morton,2857,3,17,9,10,48,38,10,60
Falkirk,2857,4,15,13,8,58,39,19,58
Queen of S't,2857,5,12,8,16,44,53,-9,44
Dunfermline,2857,6,9,14,13,46,48,-2,41
Ayr,2857,7,8,13,15,38,56,-18,37
Raith,2857,8,9,10,17,34,53,-19,37
St Mirren,2857,9,8,12,16,40,55,-15,36
Dumbarton,2857,10,8,11,17,48,62,-14,35
Hibernian,2858,1,21,11,4,58,23,35,74
Dundee Utd,2858,2,18,10,8,54,38,16,64
Falkirk,2858,3,16,11,9,61,41,20,59
Morton,2858,4,15,10,11,48,40,8,55
Queen of S't,2858,5,13,8,15,51,53,-2,47
Dunfermline,2858,6,11,12,13,52,50,2,45
Ayr,2858,7,9,12,15,34,52,-18,39
Raith,2858,8,10,8,18,33,57,-24,38
Dumbarton,2858,9,8,12,16,43,54,-11,36
St Mirren,2858,10,7,10,19,36,62,-26,31
Hibernian,2859,1,19,13,4,57,27,30,70
Dundee Utd,2859,2,17,9,10,52,40,12,60
Morton,2859,3,14,14,8,44,35,9,56
Falkirk,2859,4,13,12,11,51,45,6,51
Dunfermline,2859,5,11,14,11,47,46,1,47
Queen of S't,2859,6,11,11,14,45,50,-5,44
Raith,2859,7,10,10,16,36,46,-10,40
Ayr,2859,8,9,12,15,41,57,-16,39
Dumbarton,2859,9,8,14,14,46,57,-11,38
St Mirren,2859,10,8,11,17,38,54,-16,35
Hibernian,2860,1,18,11,7,54,29,25,65
Morton,2860,2,17,10,9,54,41,13,61
Falkirk,2860,3,16,12,8,64,44,20,60
Dundee Utd,2860,4,15,11,10,51,40,11,56
Queen of S't,2860,5,13,9,14,46,50,-4,48
Dumbarton,2860,6,11,12,13,51,54,-3,45
Dunfermline,2860,7,9,13,14,50,56,-6,40
Raith,2860,8,10,10,16,36,50,-14,40
St Mirren,2860,9,9,11,16,40,55,-15,38
Ayr,2860,10,7,11,18,29,56,-27,32
Hibernian,2861,1,18,12,6,53,27,26,66
Morton,2861,2,17,11,8,50,38,12,62
Falkirk,2861,3,16,12,8,53,37,16,60
Dundee Utd,2861,4,15,10,11,47,38,9,55
Queen of S't,2861,5,13,9,14,43,47,-4,48
Dunfermline,2861,6,10,13,13,43,45,-2,43
St Mirren,2861,7,9,11,16,40,52,-12,38
Ayr,2861,8,9,11,16,36,56,-20,38
Dumbarton,2861,9,8,13,15,49,57,-8,37
Raith,2861,10,9,10,17,31,48,-17,37
Hibernian,2862,1,17,13,6,51,26,25,64
Morton,2862,2,18,10,8,49,33,16,64
Falkirk,2862,3,17,10,9,59,40,19,61
Queen of S't,2862,4,14,9,13,49,49,0,51
Dundee Utd,2862,5,14,8,14,50,45,5,50
Dunfermline,2862,6,10,13,13,44,48,-4,43
Dumbarton,2862,7,10,12,14,49,59,-10,42
Raith,2862,8,10,9,17,37,51,-14,39
St Mirren,2862,9,9,11,16,38,50,-12,38
Ayr,2862,10,7,13,16,32,57,-25,34
Hibernian,2863,1,18,12,6,58,32,26,66
Morton,2863,2,19,9,8,58,37,21,66
Dundee Utd,2863,3,17,8,11,50,39,11,59
Falkirk,2863,4,16,9,11,57,43,14,57
Queen of S't,2863,5,12,9,15,47,52,-5,45
Dunfermline,2863,6,11,11,14,51,54,-3,44
Raith,2863,7,10,10,16,37,55,-18,40
Dumbarton,2863,8,9,11,16,49,59,-10,38
St Mirren,2863,9,9,11,16,41,54,-13,38
Ayr,2863,10,9,10,17,34,57,-23,37
Hibernian,2864,1,18,13,5,50,22,28,67
Falkirk,2864,2,17,11,8,61,41,20,62
Dundee Utd,2864,3,17,10,9,53,38,15,61
Morton,2864,4,15,9,12,47,42,5,54
Dunfermline,2864,5,11,11,14,47,47,0,44
Queen of S't,2864,6,11,11,14,45,50,-5,44
Raith,2864,7,11,10,15,33,44,-11,43
Dumbarton,2864,8,9,12,15,52,60,-8,39
Ayr,2864,9,8,13,15,35,57,-22,37
St Mirren,2864,10,8,10,18,37,59,-22,34
Falkirk,2865,1,18,11,7,58,34,24,65
Hibernian,2865,2,16,14,6,51,29,22,62
Morton,2865,3,16,12,8,50,38,12,60
Dundee Utd,2865,4,16,8,12,50,44,6,56
Dunfermline,2865,5,11,13,12,45,44,1,46
Ayr,2865,6,10,12,14,38,55,-17,42
Raith,2865,7,9,13,14,36,48,-12,40
Dumbarton,2865,8,9,11,16,46,59,-13,38
Queen of S't,2865,9,9,10,17,38,48,-10,37
St Mirren,2865,10,9,10,17,42,55,-13,37
Hibernian,2866,1,19,11,6,59,28,31,68
Falkirk,2866,2,17,12,7,59,36,23,63
Morton,2866,3,17,10,9,50,42,8,61
Dundee Utd,2866,4,14,12,10,47,38,9,54
Queen of S't,2866,5,12,9,15,41,49,-8,45
Dunfermline,2866,6,9,14,13,43,45,-2,41
Raith,2866,7,10,11,15,36,50,-14,41
Ayr,2866,8,10,11,15,40,57,-17,41
Dumbarton,2866,9,9,11,16,49,59,-10,38
St Mirren,2866,10,7,11,18,36,56,-20,32
Hibernian,2867,1,18,14,4,53,24,29,68
Morton,2867,2,19,10,7,50,33,17,67
Falkirk,2867,3,17,9,10,61,39,22,60
Dundee Utd,2867,4,16,8,12,51,44,7,56
Queen of S't,2867,5,12,9,15,42,49,-7,45
Raith,2867,6,12,8,16,35,48,-13,44
Dunfermline,2867,7,10,12,14,44,48,-4,42
Ayr,2867,8,10,11,15,39,53,-14,41
Dumbarton,2867,9,8,10,18,43,60,-17,34
St Mirren,2867,10,7,11,18,34,54,-20,32
Hibernian,2868,1,20,11,5,58,25,33,71
Dundee Utd,2868,2,18,9,9,52,35,17,63
Morton,2868,3,17,12,7,49,34,15,63
Falkirk,2868,4,15,10,11,58,43,15,55
Queen of S't,2868,5,12,9,15,45,54,-9,45
Dunfermline,2868,6,10,12,14,47,49,-2,42
Raith,2868,7,10,11,15,36,51,-15,41
Dumbarton,2868,8,9,12,15,47,57,-10,39
St Mirren,2868,9,8,10,18,39,57,-18,34
Ayr,2868,10,8,10,18,34,60,-26,34
Hibernian,2869,1,19,12,5,57,28,29,69
Morton,2869,2,17,12,7,52,36,16,63
Falkirk,2869,3,15,10,11,54,41,13,55
Dundee Utd,2869,4,14,11,11,44,38,6,53
Dunfermline,2869,5,12,11,13,46,50,-4,47
Queen of S't,2869,6,12,10,14,51,48,3,46
Ayr,2869,7,9,14,13,34,51,-17,41
St Mirren,2869,8,10,9,17,40,56,-16,39
Dumbarton,2869,9,8,13,15,44,56,-12,37
Raith,2869,10,8,10,18,36,54,-18,34
Hibernian,2870,1,18,13,5,50,24,26,67
Morton,2870,2,17,13,6,47,33,14,64
Falkirk,2870,3,17,10,9,60,38,22,61
Dundee Utd,2870,4,12,11,13,45,46,-1,47
Queen of S't,2870,5,12,10,14,49,49,0,46
Dunfermline,2870,6,9,13,14,45,50,-5,40
Dumbarton,2870,7,9,13,14,43,55,-12,40
Ayr,2870,8,9,13,14,34,50,-16,40
St Mirren,2870,9,10,9,17,42,55,-13,39
Raith,2870,10,9,11,16,36,51,-15,38
Falkirk,2871,1,18,11,7,60,37,23,65
Hibernian,2871,2,17,13,6,52,27,25,64
Morton,2871,3,16,11,9,48,38,10,59
Dundee Utd,2871,4,16,9,11,58,43,15,57
Queen of S't,2871,5,12,8,16,45,51,-6,44
Dunfermline,2871,6,10,12,14,46,50,-4,42
Dumbarton,2871,7,10,12,14,48,57,-9,42
Ayr,2871,8,9,13,14,34,51,-17,40
Raith,2871,9,10,9,17,35,54,-19,39
St Mirren,2871,10,8,10,18,39,57,-18,34
Hibernian,2872,1,20,10,6,58,29,29,70
Morton,2872,2,19,11,6,53,32,21,68
Dundee Utd,2872,3,15,9,12,47,39,8,54
Falkirk,2872,4,14,11,11,58,48,10,53
Queen of S't,2872,5,13,9,14,45,49,-4,48
Dunfermline,2872,6,10,12,14,48,52,-4,42
Raith,2872,7,9,12,15,33,45,-12,39
Dumbarton,2872,8,9,11,16,51,62,-11,38
Ayr,2872,9,9,11,16,34,52,-18,38
St Mirren,2872,10,9,10,17,38,57,-19,37
Hibernian,2873,1,19,12,5,56,29,27,69
Morton,2873,2,17,13,6,54,34,20,64
Falkirk,2873,3,17,11,8,64,42,22,62
Dundee Utd,2873,4,14,12,10,49,40,9,54
Queen of S't,2873,5,13,8,15,48,50,-2,47
Dunfermline,2873,6,8,16,12,44,48,-4,40
Dumbarton,2873,7,9,13,14,50,60,-10,40
St Mirren,2873,8,9,11,16,40,55,-15,38
Raith,2873,9,9,9,18,33,53,-20,36
Ayr,2873,10,7,11,18,33,60,-27,32
Hibernian,2874,1,21,11,4,60,25,35,74
Falkirk,2874,2,15,12,9,55,39,16,57
Morton,2874,3,15,12,9,51,42,9,57
Dundee Utd,2874,4,14,10,12,44,39,5,52
Dunfermline,2874,5,10,16,10,50,48,2,46
Queen of S't,2874,6,12,9,15,45,50,-5,45
Dumbarton,2874,7,10,12,14,52,57,-5,42
St Mirren,2874,8,10,11,15,45,53,-8,41
Raith,2874,9,8,10,18,31,54,-23,34
Ayr,2874,10,7,13,16,32,58,-26,34
Hibernian,2875,1,19,12,5,52,27,25,69
Dundee Utd,2875,2,18,9,9,55,37,18,63
Morton,2875,3,17,12,7,53,35,18,63
Falkirk,2875,4,14,9,13,57,46,11,51
Raith,2875,5,12,9,15,40,52,-12,45
Queen of S't,2875,6,12,8,16,41,49,-8,44
Dunfermline,2875,7,9,15,12,46,49,-3,42
Dumbarton,2875,8,10,11,15,47,56,-9,41
Ayr,2875,9,8,12,16,32,56,-24,36
St Mirren,2875,10,7,11,18,39,55,-16,32
Hibernian,2876,1,21,11,4,59,22,37,74
Morton,2876,2,20,9,7,57,35,22,69
Dundee Utd,2876,3,17,9,10,54,41,13,60
Falkirk,2876,4,16,10,10,59,43,16,58
Dunfermline,2876,5,10,11,15,47,54,-7,41
Queen of S't,2876,6,11,8,17,42,54,-12,41
Raith,2876,7,10,9,17,34,51,-17,39
Dumbarton,2876,8,9,11,16,49,59,-10,38
St Mirren,2876,9,8,11,17,38,55,-17,35
Ayr,2876,10,8,11,17,31,56,-25,35
Hibernian,2877,1,17,14,5,52,24,28,65
Morton,2877,2,16,13,7,49,35,14,61
Falkirk,2877,3,16,11,9,56,40,16,59
Dundee Utd,2877,4,14,11,11,47,41,6,53
Queen of S't,2877,5,12,12,12,45,45,0,48
Ayr,2877,6,10,13,13,38,52,-14,43
Dunfermline,2877,7,9,15,12,43,45,-2,42
Dumbarton,2877,8,9,10,17,47,60,-13,37
St Mirren,2877,9,9,10,17,39,55,-16,37
Raith,2877,10,8,11,17,32,51,-19,35
Hibernian,2878,1,21,10,5,59,26,33,73
Dundee Utd,2878,2,17,10,9,53,35,18,61
Falkirk,2878,3,16,11,9,59,41,18,59
Morton,2878,4,14,12,10,45,41,4,54
Queen of S't,2878,5,11,10,15,43,49,-6,43
Ayr,2878,6,10,12,14,37,50,-13,42
Dunfermline,2878,7,9,14,13,44,50,-6,41
Dumbarton,2878,8,8,13,15,47,63,-16,37
Raith,2878,9,8,12,16,34,50,-16,36
St Mirren,2878,10,7,14,15,37,53,-16,35
Hibernian,2879,1,19,12,5,53,23,30,69
Falkirk,2879,2,17,9,10,62,38,24,60
Dundee Utd,2879,3,17,9,10,52,39,13,60
Morton,2879,4,16,11,9,49,38,11,59
Queen of S't,2879,5,12,10,14,47,50,-3,46
Dunfermline,2879,6,9,14,13,43,50,-7,41
Raith,2879,7,10,11,15,35,47,-12,41
Dumbarton,2879,8,9,11,16,44,55,-11,38
St Mirren,2879,9,9,9,18,35,57,-22,36
Ayr,2879,10,7,14,15,31,54,-23,35
Hibernian,2880,1,20,11,5,58,24,34,71
Falkirk,2880,2,17,12,7,59,35,24,63
Dundee Utd,2880,3,17,10,9,54,40,14,61
Morton,2880,4,16,12,8,51,38,13,60
Queen of S't,2880,5,11,9,16,47,51,-4,42
Raith,2880,6,9,12,15,35,48,-13,39
Ayr,2880,7,9,12,15,36,55,-19,39
Dunfermline,2880,8,8,13,15,44,57,-13,37
St Mirren,2880,9,9,10,17,40,54,-14,37
Dumbarton,2880,10,8,11,17,48,70,-22,35
Hibernian,2881,1,18,13,5,54,29,25,67
Falkirk,2881,2,16,12,8,62,41,21,60
Morton,2881,3,15,12,9,49,38,11,57
Queen of S't,2881,4,13,9,14,50,49,1,48
Dundee Utd,2881,5,13,9,14,42,46,-4,48
Ayr,2881,6,11,13,12,39,47,-8,46
Dunfermline,2881,7,11,12,13,48,48,0,45
St Mirren,2881,8,9,12,15,39,55,-16,39
Dumbarton,2881,9,8,12,16,46,57,-11,36
Raith,2881,10,8,12,16,34,53,-19,36
Hibernian,2882,1,19,12,5,58,25,33,69
Morton,2882,2,18,11,7,49,34,15,65
Falkirk,2882,3,17,10,9,65,46,19,61
Dundee Utd,2882,4,16,10,10,49,38,11,58
Ayr,2882,5,13,10,13,41,49,-8,49
Queen of S't,2882,6,11,10,15,46,56,-10,43
Raith,2882,7,10,9,17,38,49,-11,39
Dunfermline,2882,8,8,14,14,42,53,-11,38
Dumbarton,2882,9,8,10,18,44,61,-17,34
St Mirren,2882,10,7,10,19,39,60,-21,31
Hibernian,2883,1,20,11,5,63,31,32,71
Morton,2883,2,18,12,6,57,37,20,66
Falkirk,2883,3,14,12,10,55,44,11,54
Dundee Utd,2883,4,14,10,12,49,43,6,52
Queen of S't,2883,5,14,8,14,48,52,-4,50
Dunfermline,2883,6,10,14,12,51,48,3,44
Dumbarton,2883,7,11,11,14,51,56,-5,44
Raith,2883,8,9,10,17,37,55,-18,37
Ayr,2883,9,8,11,17,37,63,-26,35
St Mirren,2883,10,7,11,18,39,58,-19,32
Hibernian,2884,1,20,13,3,55,23,32,73
Dundee Utd,2884,2,16,11,9,48,36,12,59
Morton,2884,3,15,13,8,46,36,10,58
Falkirk,2884,4,14,13,9,58,41,17,55
Dumbarton,2884,5,11,12,13,53,56,-3,45
Raith,2884,6,12,9,15,37,44,-7,45
Queen of S't,2884,7,11,10,15,42,48,-6,43
Dunfermline,2884,8,7,14,15,42,52,-10,35
St Mirren,2884,9,8,10,18,36,58,-22,34
Ayr,2884,10,7,13,16,31,54,-23,34
Hibernian,2885,1,19,13,4,62,31,31,70
Dundee Utd,2885,2,18,9,9,60,42,18,63
Morton,2885,3,17,12,7,54,37,17,63
Falkirk,2885,4,15,10,11,62,48,14,55
Queen of S't,2885,5,12,9,15,48,61,-13,45
Dumbarton,2885,6,11,11,14,55,62,-7,44
Raith,2885,7,10,10,16,37,51,-14,40
Dunfermline,2885,8,8,14,14,45,53,-8,38
Ayr,2885,9,7,13,16,35,56,-21,34
St Mirren,2885,10,8,9,19,41,58,-17,33
Hibernian,2886,1,20,13,3,56,21,35,73
Dundee Utd,2886,2,17,10,9,50,37,13,61
Falkirk,2886,3,16,11,9,59,41,18,59
Morton,2886,4,15,13,8,48,36,12,58
Dunfermline,2886,5,11,13,12,48,49,-1,46
Queen of S't,2886,6,12,9,15,41,50,-9,45
Dumbarton,2886,7,9,11,16,46,57,-11,38
Raith,2886,8,10,8,18,35,49,-14,38
Ayr,2886,9,8,12,16,34,57,-23,36
St Mirren,2886,10,6,12,18,36,56,-20,30
Hibernian,2887,1,18,11,7,55,28,27,65
Morton,2887,2,17,12,7,49,33,16,63
Falkirk,2887,3,15,11,10,58,45,13,56
Dundee Utd,2887,4,15,11,10,49,36,13,56
Queen of S't,2887,5,12,10,14,45,50,-5,46
Dunfermline,2887,6,9,16,11,48,49,-1,43
Raith,2887,7,10,9,17,35,51,-16,39
Ayr,2887,8,9,12,15,34,50,-16,39
Dumbarton,2887,9,9,11,16,47,60,-13,38
St Mirren,2887,10,9,11,16,41,59,-18,38
Hibernian,2888,1,19,10,7,56,29,27,67
Falkirk,2888,2,17,10,9,62,44,18,61
Dundee Utd,2888,3,15,11,10,53,40,13,56
Morton,2888,4,15,10,11,51,43,8,55
Queen of S't,2888,5,14,10,12,52,48,4,52
Dunfermline,2888,6,12,12,12,50,48,2,48
Ayr,2888,7,11,10,15,40,55,-15,43
Raith,2888,8,11,9,16,40,49,-9,42
St Mirren,2888,9,7,11,18,39,62,-23,32
Dumbarton,2888,10,7,11,18,42,67,-25,32
Hibernian,2889,1,18,13,5,57,27,30,67
Morton,2889,2,17,12,7,55,34,21,63
Falkirk,2889,3,17,10,9,62,42,20,61
Dundee Utd,2889,4,17,8,11,52,38,14,59
Queen of S't,2889,5,13,9,14,44,47,-3,48
Dumbarton,2889,6,10,12,14,49,54,-5,42
St Mirren,2889,7,10,10,16,42,51,-9,40
Dunfermline,2889,8,9,13,14,44,57,-13,40
Raith,2889,9,8,11,17,34,56,-22,35
Ayr,2889,10,6,12,18,28,61,-33,30
Morton,2890,1,18,12,6,53,32,21,66
Hibernian,2890,2,16,14,6,50,28,22,62
Dundee Utd,2890,3,16,10,10,50,40,10,58
Falkirk,2890,4,15,12,9,57,38,19,57
Queen of S't,2890,5,11,13,12,43,45,-2,46
Dunfermline,2890,6,9,15,12,43,47,-4,42
Raith,2890,7,10,10,16,32,46,-14,40
Dumbarton,2890,8,9,12,15,45,55,-10,39
St Mirren,2890,9,9,10,17,38,56,-18,37
Ayr,2890,10,7,12,17,32,56,-24,33
Hibernian,2891,1,18,13,5,51,24,27,67
Morton,2891,2,17,11,8,49,39,10,62
Falkirk,2891,3,16,10,10,57,41,16,58
Dundee Utd,2891,4,15,9,12,48,41,7,54
Dunfermline,2891,5,12,12,12,50,46,4,48
Queen of S't,2891,6,13,8,15,44,48,-4,47
Raith,2891,7,12,9,15,41,45,-4,45
Ayr,2891,8,10,11,15,32,54,-22,41
Dumbarton,2891,9,9,11,16,49,60,-11,38
St Mirren,2891,10,6,10,20,39,62,-23,28
Hibernian,2892,1,19,13,4,53,23,30,70
Falkirk,2892,2,16,10,10,61,42,19,58
Morton,2892,3,16,10,10,50,40,10,58
Dundee Utd,2892,4,16,10,10,50,41,9,58
Dunfermline,2892,5,11,13,12,53,50,3,46
Ayr,2892,6,11,10,15,35,52,-17,43
Queen of S't,2892,7,10,11,15,47,58,-11,41
Dumbarton,2892,8,9,13,14,49,57,-8,40
Raith,2892,9,10,9,17,40,56,-16,39
St Mirren,2892,10,7,11,18,38,57,-19,32
Hibernian,2893,1,19,13,4,57,27,30,70
Falkirk,2893,2,18,9,9,61,41,20,63
Morton,2893,3,17,12,7,51,37,14,63
Dundee Utd,2893,4,16,8,12,53,38,15,56
Queen of S't,2893,5,12,9,15,43,49,-6,45
Dumbarton,2893,6,11,10,15,50,57,-7,43
Raith,2893,7,10,12,14,38,48,-10,42
St Mirren,2893,8,10,10,16,41,54,-13,40
Dunfermline,2893,9,8,12,16,44,56,-12,36
Ayr,2893,10,6,11,19,31,62,-31,29
Hibernian,2894,1,22,11,3,63,25,38,77
Dundee Utd,2894,2,19,9,8,52,34,18,66
Morton,2894,3,15,11,10,44,38,6,56
Falkirk,2894,4,15,10,11,57,44,13,55
Dumbarton,2894,5,11,11,14,51,56,-5,44
Dunfermline,2894,6,10,12,14,44,50,-6,42
Queen of S't,2894,7,10,10,16,44,53,-9,40
St Mirren,2894,8,9,10,17,43,54,-11,37
Raith,2894,9,9,10,17,36,53,-17,37
Ayr,2894,10,8,10,18,31,58,-27,34
Hibernian,2895,1,20,12,4,59,24,35,72
Morton,2895,2,17,10,9,53,43,10,61
Falkirk,2895,3,14,12,10,57,43,14,54
Dundee Utd,2895,4,15,9,12,54,45,9,54
Dunfermline,2895,5,12,11,13,52,52,0,47
Queen of S't,2895,6,12,9,15,43,54,-11,45
Raith,2895,7,12,8,16,40,48,-8,44
Dumbarton,2895,8,9,12,15,50,61,-11,39
Ayr,2895,9,9,11,16,36,53,-17,38
St Mirren,2895,10,8,10,18,38,59,-21,34
Hibernian,2896,1,18,13,5,53,26,27,67
Falkirk,2896,2,17,12,7,62,37,25,63
Morton,2896,3,16,12,8,48,39,9,60
Dundee Utd,2896,4,15,11,10,46,39,7,56
Dunfermline,2896,5,10,14,12,52,50,2,44
Queen of S't,2896,6,11,11,14,46,51,-5,44
Dumbarton,2896,7,9,12,15,51,60,-9,39
Raith,2896,8,10,9,17,35,51,-16,39
St Mirren,2896,9,7,13,16,37,55,-18,34
Ayr,2896,10,7,13,16,33,55,-22,34
Hibernian,2897,1,19,13,4,66,28,38,70
Morton,2897,2,16,12,8,52,40,12,60
Falkirk,2897,3,15,11,10,53,42,11,56
Dundee Utd,2897,4,15,10,11,46,38,8,55
Dumbarton,2897,5,11,10,15,47,60,-13,43
Dunfermline,2897,6,9,15,12,47,46,1,42
Queen of S't,2897,7,11,9,16,45,50,-5,42
Raith,2897,8,9,12,15,32,46,-14,39
St Mirren,2897,9,10,9,17,44,59,-15,39
Ayr,2897,10,9,11,16,33,56,-23,38
Hibernian,2898,1,18,11,7,53,29,24,65
Morton,2898,2,17,12,7,47,33,14,63
Falkirk,2898,3,14,12,10,54,41,13,54
Dundee Utd,2898,4,14,11,11,47,40,7,53
Queen of S't,2898,5,13,10,13,53,51,2,49
Dunfermline,2898,6,10,14,12,45,46,-1,44
Dumbarton,2898,7,10,13,13,49,55,-6,43
Raith,2898,8,9,10,17,32,50,-18,37
Ayr,2898,9,8,13,15,35,55,-20,37
St Mirren,2898,10,8,12,16,36,51,-15,36
Hibernian,2899,1,21,10,5,61,28,33,73
Morton,2899,2,18,10,8,53,37,16,64
Dundee Utd,2899,3,17,8,11,49,38,11,59
Falkirk,2899,4,16,10,10,59,41,18,58
Raith,2899,5,12,8,16,37,47,-10,44
Dunfermline,2899,6,10,12,14,47,52,-5,42
Queen of S't,2899,7,11,8,17,44,52,-8,41
St Mirren,2899,8,10,9,17,42,55,-13,39
Dumbarton,2899,9,9,10,17,44,59,-15,37
Ayr,2899,10,8,11,17,31,58,-27,35
Hibernian,2900,1,17,14,5,55,29,26,65
Morton,2900,2,16,15,5,49,32,17,63
Dundee Utd,2900,3,16,10,10,51,39,12,58
Falkirk,2900,4,15,11,10,60,46,14,56
Dunfermline,2900,5,11,14,11,52,48,4,47
Queen of S't,2900,6,9,13,14,43,51,-8,40
Dumbarton,2900,7,8,14,14,52,64,-12,38
Raith,2900,8,9,11,16,34,53,-19,38
Ayr,2900,9,7,16,13,34,52,-18,37
St Mirren,2900,10,8,10,18,43,59,-16,34
Falkirk,2901,1,18,11,7,64,35,29,65
Hibernian,2901,2,17,11,8,49,28,21,62
Dundee Utd,2901,3,16,11,9,52,40,12,59
Morton,2901,4,14,12,10,46,40,6,54
Dunfermline,2901,5,11,13,12,46,45,1,46
Queen of S't,2901,6,11,13,12,45,48,-3,46
Raith,2901,7,11,10,15,37,50,-13,43
St Mirren,2901,8,10,9,17,43,57,-14,39
Dumbarton,2901,9,8,11,17,44,60,-16,35
Ayr,2901,10,7,13,16,32,55,-23,34
Morton,2902,1,19,11,6,59,34,25,68
Hibernian,2902,2,17,13,6,53,30,23,64
Falkirk,2902,3,16,12,8,57,39,18,60
Dundee Utd,2902,4,16,10,10,56,44,12,58
Queen of S't,2902,5,12,10,14,50,51,-1,46
Dunfermline,2902,6,11,11,14,48,53,-5,44
Raith,2902,7,9,10,17,33,50,-17,37
Dumbarton,2902,8,8,12,16,46,58,-12,36
Ayr,2902,9,7,15,14,36,56,-20,36
St Mirren,2902,10,8,10,18,38,61,-23,34
Hibernian,2903,1,18,14,4,56,25,31,68
Morton,2903,2,16,13,7,55,38,17,61
Falkirk,2903,3,14,11,11,56,46,10,53
Dundee Utd,2903,4,14,10,12,50,46,4,52
Queen of S't,2903,5,13,10,13,51,49,2,49
Dunfermline,2903,6,9,15,12,45,50,-5,42
Ayr,2903,7,10,12,14,39,55,-16,42
Raith,2903,8,10,9,17,39,51,-12,39
St Mirren,2903,9,8,13,15,38,51,-13,37
Dumbarton,2903,10,8,13,15,49,67,-18,37
Hibernian,2904,1,20,13,3,57,20,37,73
Dundee Utd,2904,2,17,9,10,54,38,16,60
Falkirk,2904,3,15,12,9,52,36,16,57
Morton,2904,4,14,12,10,47,41,6,54
Dunfermline,2904,5,11,13,12,51,52,-1,46
Ayr,2904,6,10,12,14,31,48,-17,42
Raith,2904,7,10,11,15,40,52,-12,41
Queen of S't,2904,8,10,9,17,39,54,-15,39
Dumbarton,2904,9,8,13,15,44,56,-12,37
St Mirren,2904,10,8,10,18,38,56,-18,34
Hibernian,2905,1,17,15,4,54,26,28,66
Falkirk,2905,2,16,10,10,57,39,18,58
Morton,2905,3,15,13,8,48,39,9,58
Dundee Utd,2905,4,14,10,12,43,38,5,52
Raith,2905,5,12,10,14,37,46,-9,46
Dunfermline,2905,6,10,15,11,46,46,0,45
Dumbarton,2905,7,10,12,14,46,53,-7,42
Queen of S't,2905,8,11,9,16,43,53,-10,42
St Mirren,2905,9,9,11,16,40,51,-11,38
Ayr,2905,10,8,11,17,32,55,-23,35
Hibernian,2906,1,22,10,4,59,22,37,76
Falkirk,2906,2,17,11,8,57,36,21,62
Morton,2906,3,16,11,9,52,41,11,59
Dundee Utd,2906,4,15,11,10,55,41,14,56
Queen of S't,2906,5,12,9,15,46,52,-6,45
Dunfermline,2906,6,9,13,14,50,59,-9,40
Raith,2906,7,10,9,17,34,52,-18,39
St Mirren,2906,8,9,10,17,43,58,-15,37
Dumbarton,2906,9,8,12,16,46,63,-17,36
Ayr,2906,10,8,12,16,39,57,-18,36
Hibernian,2907,1,19,12,5,55,25,30,69
Morton,2907,2,17,11,8,53,44,9,62
Falkirk,2907,3,16,9,11,55,41,14,57
Dundee Utd,2907,4,15,11,10,49,40,9,56
Dunfermline,2907,5,11,13,12,51,47,4,46
Queen of S't,2907,6,11,10,15,46,51,-5,43
Raith,2907,7,11,10,15,34,48,-14,43
St Mirren,2907,8,10,10,16,44,52,-8,40
Ayr,2907,9,8,12,16,34,54,-20,36
Dumbarton,2907,10,7,12,17,42,61,-19,33
Hibernian,2908,1,19,13,4,57,25,32,70
Morton,2908,2,19,10,7,52,36,16,67
Falkirk,2908,3,15,12,9,61,46,15,57
Dundee Utd,2908,4,16,9,11,49,39,10,57
Dunfermline,2908,5,10,13,13,43,44,-1,43
Dumbarton,2908,6,10,10,16,49,58,-9,40
Queen of S't,2908,7,10,10,16,45,54,-9,40
Raith,2908,8,10,10,16,35,53,-18,40
St Mirren,2908,9,8,11,17,40,53,-13,35
Ayr,2908,10,7,14,15,31,54,-23,35
Dundee Utd,2909,1,18,9,9,55,44,11,63
Hibernian,2909,2,17,11,8,52,32,20,62
Morton,2909,3,17,10,9,47,38,9,61
Falkirk,2909,4,16,11,9,55,38,17,59
Dunfermline,2909,5,10,13,13,47,46,1,43
Ayr,2909,6,11,10,15,38,51,-13,43
Raith,2909,7,11,9,16,34,49,-15,42
Queen of S't,2909,8,11,8,17,44,52,-8,41
Dumbarton,2909,9,10,10,16,46,56,-10,40
St Mirren,2909,10,9,9,18,45,57,-12,36
Hibernian,2910,1,17,15,4,50,22,28,66
Dundee Utd,2910,2,18,9,9,51,37,14,63
Morton,2910,3,17,10,9,54,35,19,61
Falkirk,2910,4,14,11,11,55,41,14,53
Queen of S't,2910,5,12,9,15,44,51,-7,45
Raith,2910,6,12,9,15,38,47,-9,45
Dunfermline,2910,7,11,11,14,48,51,-3,44
Dumbarton,2910,8,9,13,14,47,54,-7,40
St Mirren,2910,9,8,10,18,37,57,-20,34
Ayr,2910,10,7,13,16,32,61,-29,34
Hibernian,2911,1,19,12,5,56,29,27,69
Falkirk,2911,2,16,11,9,59,41,18,59
Dundee Utd,2911,3,16,10,10,50,39,11,58
Morton,2911,4,15,13,8,47,40,7,58
Ayr,2911,5,10,13,13,36,51,-15,43
Queen of S't,2911,6,10,11,15,46,54,-8,41
Dunfermline,2911,7,9,13,14,50,53,-3,40
Dumbarton,2911,8,9,11,16,48,60,-12,38
Raith,2911,9,9,11,16,35,47,-12,38
St Mirren,2911,10,9,11,16,41,54,-13,38
Hibernian,2912,1,22,10,4,61,23,38,76
Falkirk,2912,2,16,11,9,58,38,20,59
Morton,2912,3,16,11,9,53,45,8,59
Dundee Utd,2912,4,16,10,10,47,36,11,58
Queen of S't,2912,5,12,10,14,42,47,-5,46
Dunfermline,2912,6,10,12,14,47,51,-4,42
Dumbarton,2912,7,9,14,13,49,54,-5,41
Raith,2912,8,9,11,16,34,49,-15,38
Ayr,2912,9,8,12,16,34,56,-22,36
St Mirren,2912,10,6,11,19,35,61,-26,29
Hibernian,2913,1,19,13,4,56,26,30,70
Morton,2913,2,16,14,6,50,35,15,62
Falkirk,2913,3,17,10,9,61,38,23,61
Dundee Utd,2913,4,16,10,10,51,42,9,58
Dunfermline,2913,5,11,13,12,50,49,1,46
Raith,2913,6,11,10,15,33,47,-14,43
Queen of S't,2913,7,10,9,17,45,55,-10,39
Ayr,2913,8,7,15,14,35,54,-19,36
Dumbarton,2913,9,8,10,18,46,65,-19,34
St Mirren,2913,10,7,12,17,38,54,-16,33
Hibernian,2914,1,18,13,5,51,26,25,67
Falkirk,2914,2,17,12,7,59,35,24,63
Morton,2914,3,15,13,8,48,39,9,58
Dundee Utd,2914,4,15,11,10,50,40,10,56
Dunfermline,2914,5,11,15,10,49,44,5,48
Queen of S't,2914,6,11,11,14,45,52,-7,44
Raith,2914,7,11,10,15,36,45,-9,43
St Mirren,2914,8,8,12,16,40,53,-13,36
Dumbarton,2914,9,8,11,17,46,65,-19,35
Ayr,2914,10,6,12,18,33,58,-25,30
Hibernian,2915,1,18,11,7,55,28,27,65
Morton,2915,2,18,10,8,48,34,14,64
Dundee Utd,2915,3,16,9,11,50,39,11,57
Falkirk,2915,4,15,11,10,54,39,15,56
Dumbarton,2915,5,11,11,14,53,55,-2,44
Ayr,2915,6,11,11,14,37,54,-17,44
Queen of S't,2915,7,11,10,15,43,50,-7,43
Raith,2915,8,11,9,16,36,50,-14,42
Dunfermline,2915,9,9,12,15,42,50,-8,39
St Mirren,2915,10,8,10,18,38,57,-19,34
Hibernian,2916,1,18,13,5,52,26,26,67
Falkirk,2916,2,18,9,9,59,38,21,63
Morton,2916,3,17,12,7,46,32,14,63
Dundee Utd,2916,4,14,11,11,46,40,6,53
Dumbarton,2916,5,11,11,14,49,54,-5,44
Dunfermline,2916,6,10,12,14,50,53,-3,42
Queen of S't,2916,7,11,9,16,43,51,-8,42
St Mirren,2916,8,10,10,16,41,51,-10,40
Raith,2916,9,10,9,17,35,52,-17,39
Ayr,2916,10,6,14,16,31,55,-24,32
Hibernian,2917,1,19,13,4,57,25,32,70
Morton,2917,2,17,11,8,49,40,9,62
Dundee Utd,2917,3,16,12,8,52,39,13,60
Falkirk,2917,4,15,10,11,57,49,8,55
Dunfermline,2917,5,11,11,14,51,51,0,44
Queen of S't,2917,6,11,10,15,49,53,-4,43
St Mirren,2917,7,11,10,15,45,54,-9,43
Dumbarton,2917,8,8,12,16,49,60,-11,36
Raith,2917,9,9,9,18,38,55,-17,36
Ayr,2917,10,7,14,15,34,55,-21,35
Hibernian,2918,1,20,12,4,56,26,30,72
Morton,2918,2,18,12,6,54,36,18,66
Dundee Utd,2918,3,16,12,8,50,36,14,60
Falkirk,2918,4,16,10,10,55,40,15,58
Dunfermline,2918,5,9,14,13,44,49,-5,41
Dumbarton,2918,6,10,11,15,51,59,-8,41
Queen of S't,2918,7,10,9,17,41,52,-11,39
Raith,2918,8,10,8,18,32,48,-16,38
Ayr,2918,9,8,12,16,37,57,-20,36
St Mirren,2918,10,8,10,18,37,54,-17,34
Hibernian,2919,1,19,13,4,60,25,35,70
Morton,2919,2,19,12,5,55,33,22,69
Falkirk,2919,3,18,9,9,62,40,22,63
Dundee Utd,2919,4,15,9,12,50,47,3,54
Dunfermline,2919,5,10,14,12,43,44,-1,44
Queen of S't,2919,6,10,10,16,45,55,-10,40
Dumbarton,2919,7,9,11,16,48,59,-11,38
Raith,2919,8,9,11,16,35,55,-20,38
St Mirren,2919,9,8,10,18,42,61,-19,34
Ayr,2919,10,7,13,16,34,55,-21,34
Hibernian,2920,1,20,12,4,60,27,33,72
Morton,2920,2,17,11,8,59,39,20,62
Falkirk,2920,3,16,10,10,65,46,19,58
Dundee Utd,2920,4,16,9,11,53,42,11,57
Dunfermline,2920,5,10,12,14,47,53,-6,42
Ayr,2920,6,10,12,14,39,53,-14,42
Raith,2920,7,11,9,16,37,54,-17,42
Queen of S't,2920,8,10,11,15,46,54,-8,41
Dumbarton,2920,9,9,11,16,47,63,-16,38
St Mirren,2920,10,7,11,18,38,60,-22,32
Morton,2921,1,18,12,6,52,32,20,66
Falkirk,2921,2,17,11,8,62,41,21,62
Hibernian,2921,3,16,12,8,50,29,21,60
Dundee Utd,2921,4,15,10,11,51,41,10,55
Queen of S't,2921,5,12,10,14,50,50,0,46
Ayr,2921,6,11,12,13,38,54,-16,45
Dunfermline,2921,7,9,14,13,46,52,-6,41
Dumbarton,2921,8,8,13,15,47,59,-12,37
Raith,2921,9,8,12,16,33,51,-18,36
St Mirren,2921,10,8,10,18,37,57,-20,34
Hibernian,2922,1,20,13,3,58,25,33,73
Falkirk,2922,2,17,10,9,57,38,19,61
Morton,2922,3,16,12,8,48,37,11,60
Dundee Utd,2922,4,15,11,10,47,39,8,56
Queen of S't,2922,5,13,9,14,43,47,-4,48
Dunfermline,2922,6,8,16,12,41,46,-5,40
Ayr,2922,7,9,11,16,35,55,-20,38
St Mirren,2922,8,9,10,17,41,54,-13,37
Dumbarton,2922,9,8,12,16,45,55,-10,36
Raith,2922,10,9,8,19,32,51,-19,35
Hibernian,2923,1,20,12,4,57,23,34,72
Morton,2923,2,18,10,8,52,36,16,64
Falkirk,2923,3,18,9,9,60,38,22,63
Dundee Utd,2923,4,14,11,11,44,40,4,53
Queen of S't,2923,5,12,10,14,48,50,-2,46
Dumbarton,2923,6,11,11,14,49,57,-8,44
Dunfermline,2923,7,9,14,13,43,47,-4,41
Raith,2923,8,9,9,18,33,46,-13,36
Ayr,2923,9,7,12,17,29,58,-29,33
St Mirren,2923,10,6,14,16,35,55,-20,32
Hibernian,2924,1,19,11,6,51,23,28,68
Falkirk,2924,2,18,10,8,57,35,22,64
Morton,2924,3,17,11,8,48,37,11,62
Dundee Utd,2924,4,15,10,11,54,39,15,55
Queen of S't,2924,5,12,9,15,43,51,-8,45
Ayr,2924,6,10,12,14,40,56,-16,42
Dumbarton,2924,7,10,11,15,48,56,-8,41
Dunfermline,2924,8,9,12,15,43,50,-7,39
Raith,2924,9,10,9,17,35,49,-14,39
St Mirren,2924,10,8,9,19,36,59,-23,33
Morton,2925,1,19,11,6,56,33,23,68
Hibernian,2925,2,17,11,8,49,28,21,62
Falkirk,2925,3,15,12,9,58,43,15,57
Dundee Utd,2925,4,16,9,11,52,40,12,57
Raith,2925,5,13,10,13,40,45,-5,49
Dumbarton,2925,6,11,11,14,52,59,-7,44
Queen of S't,2925,7,11,10,15,46,52,-6,43
Dunfermline,2925,8,8,14,14,44,52,-8,38
St Mirren,2925,9,9,9,18,38,54,-16,36
Ayr,2925,10,7,11,18,31,60,-29,32
Hibernian,2926,1,17,14,5,48,23,25,65
Falkirk,2926,2,17,12,7,59,37,22,63
Morton,2926,3,17,11,8,48,35,13,62
Dundee Utd,2926,4,15,10,11,51,48,3,55
Queen of S't,2926,5,13,10,13,50,48,2,49
Ayr,2926,6,10,11,15,34,50,-16,41
Dunfermline,2926,7,9,13,14,44,50,-6,40
Raith,2926,8,10,9,17,36,50,-14,39
Dumbarton,2926,9,8,11,17,49,64,-15,35
St Mirren,2926,10,7,13,16,41,55,-14,34
Hibernian,2927,1,18,13,5,51,23,28,67
Morton,2927,2,15,14,7,48,35,13,59
Falkirk,2927,3,15,12,9,55,40,15,57
Dundee Utd,2927,4,15,9,12,47,42,5,54
Dunfermline,2927,5,11,13,12,46,47,-1,46
Raith,2927,6,11,11,14,33,42,-9,44
Dumbarton,2927,7,10,13,13,49,52,-3,43
Queen of S't,2927,8,11,10,15,44,49,-5,43
St Mirren,2927,9,10,10,16,40,54,-14,40
Ayr,2927,10,6,11,19,28,57,-29,29
Hibernian,2928,1,22,11,3,62,25,37,77
Falkirk,2928,2,17,11,8,60,43,17,62
Morton,2928,3,15,12,9,52,40,12,57
Dundee Utd,2928,4,15,10,11,55,44,11,55
St Mirren,2928,5,10,11,15,42,54,-12,41
Ayr,2928,6,10,11,15,38,56,-18,41
Queen of S't,2928,7,10,10,16,47,56,-9,40
Raith,2928,8,10,9,17,36,50,-14,39
Dunfermline,2928,9,8,13,15,42,52,-10,37
Dumbarton,2928,10,8,12,16,49,63,-14,36
Hibernian,2929,1,19,11,6,55,25,30,68
Falkirk,2929,2,15,13,8,62,40,22,58
Dundee Utd,2929,3,16,10,10,55,41,14,58
Morton,2929,4,15,10,11,49,43,6,55
Dunfermline,2929,5,10,13,13,51,52,-1,43
Raith,2929,6,11,10,15,37,49,-12,43
Dumbarton,2929,7,10,12,14,50,59,-9,42
St Mirren,2929,8,11,9,16,41,54,-13,42
Queen of S't,2929,9,11,8,17,42,53,-11,41
Ayr,2929,10,9,10,17,35,61,-26,37
Hibernian,2930,1,22,10,4,60,24,36,76
Falkirk,2930,2,19,9,8,59,38,21,66
Morton,2930,3,18,9,9,52,35,17,63
Dundee Utd,2930,4,14,12,10,48,40,8,54
Dumbarton,2930,5,12,11,13,49,50,-1,47
Raith,2930,6,10,9,17,36,51,-15,39
Queen of S't,2930,7,9,11,16,40,51,-11,38
Dunfermline,2930,8,8,13,15,42,50,-8,37
Ayr,2930,9,9,10,17,36,61,-25,37
St Mirren,2930,10,7,10,19,39,61,-22,31
Hibernian,2931,1,23,10,3,65,24,41,79
Morton,2931,2,18,11,7,57,38,19,65
Dundee Utd,2931,3,16,10,10,46,40,6,58
Falkirk,2931,4,15,11,10,56,41,15,56
Queen of S't,2931,5,13,9,14,46,47,-1,48
Dunfermline,2931,6,9,12,15,46,54,-8,39
Dumbarton,2931,7,9,12,15,45,55,-10,39
Raith,2931,8,10,9,17,34,52,-18,39
Ayr,2931,9,7,11,18,29,55,-26,32
St Mirren,2931,10,6,13,17,37,55,-18,31
Morton,2932,1,19,9,8,51,36,15,66
Dundee Utd,2932,2,19,8,9,53,38,15,65
Hibernian,2932,3,17,12,7,54,31,23,63
Falkirk,2932,4,17,9,10,57,41,16,60
Queen of S't,2932,5,13,9,14,47,49,-2,48
Raith,2932,6,12,9,15,38,47,-9,45
Dunfermline,2932,7,10,12,14,44,47,-3,42
Dumbarton,2932,8,8,11,17,44,57,-13,35
Ayr,2932,9,8,11,17,34,56,-22,35
St Mirren,2932,10,7,10,19,38,58,-20,31
Hibernian,2933,1,22,11,3,57,21,36,77
Dundee Utd,2933,2,16,10,10,54,44,10,58
Morton,2933,3,16,10,10,47,38,9,58
Falkirk,2933,4,14,11,11,60,49,11,53
Dunfermline,2933,5,12,12,12,51,46,5,48
Raith,2933,6,13,8,15,36,46,-10,47
Queen of S't,2933,7,11,10,15,42,49,-7,43
Dumbarton,2933,8,10,12,14,50,57,-7,42
St Mirren,2933,9,7,11,18,37,55,-18,32
Ayr,2933,10,6,11,19,32,61,-29,29
Hibernian,2934,1,20,13,3,51,21,30,73
Falkirk,2934,2,17,10,9,57,37,20,61
Morton,2934,3,15,12,9,49,37,12,57
Dundee Utd,2934,4,14,11,11,47,41,6,53
Raith,2934,5,12,9,15,41,48,-7,45
Dumbarton,2934,6,10,12,14,46,54,-8,42
St Mirren,2934,7,11,9,16,44,53,-9,42
Queen of S't,2934,8,11,9,16,42,52,-10,42
Dunfermline,2934,9,9,13,14,42,48,-6,40
Ayr,2934,10,6,12,18,32,60,-28,30
Hibernian,2935,1,20,11,5,60,26,34,71
Morton,2935,2,18,11,7,51,37,14,65
Falkirk,2935,3,15,10,11,58,51,7,55
Dundee Utd,2935,4,15,9,12,52,44,8,54
Raith,2935,5,13,9,14,43,47,-4,48
Queen of S't,2935,6,12,10,14,47,48,-1,46
St Mirren,2935,7,11,9,16,47,59,-12,42
Dumbarton,2935,8,10,10,16,48,57,-9,40
Dunfermline,2935,9,8,13,15,46,56,-10,37
Ayr,2935,10,7,10,19,32,59,-27,31
Hibernian,2936,1,19,11,6,58,28,30,68
Morton,2936,2,17,11,8,48,33,15,62
Falkirk,2936,3,14,11,11,51,42,9,53
Queen of S't,2936,4,13,9,14,48,50,-2,48
Dundee Utd,2936,5,12,11,13,43,47,-4,47
Dunfermline,2936,6,11,11,14,50,51,-1,44
Dumbarton,2936,7,11,11,14,50,54,-4,44
Raith,2936,8,11,11,14,37,47,-10,44
St Mirren,2936,9,11,10,15,43,52,-9,43
Ayr,2936,10,7,12,17,31,55,-24,33
Hibernian,2937,1,20,11,5,56,26,30,71
Morton,2937,2,18,10,8,51,36,15,64
Dundee Utd,2937,3,17,10,9,54,36,18,61
Falkirk,2937,4,16,9,11,59,44,15,57
Queen of S't,2937,5,13,9,14,49,54,-5,48
Raith,2937,6,12,8,16,37,48,-11,44
Dunfermline,2937,7,10,12,14,48,53,-5,42
Dumbarton,2937,8,8,12,16,54,66,-12,36
Ayr,2937,9,8,11,17,32,60,-28,35
St Mirren,2937,10,7,10,19,38,55,-17,31
Hibernian,2938,1,18,13,5,54,26,28,67
Falkirk,2938,2,16,12,8,57,39,18,60
Morton,2938,3,16,11,9,52,40,12,59
Dundee Utd,2938,4,16,10,10,52,39,13,58
Queen of S't,2938,5,12,11,13,49,47,2,47
Dumbarton,2938,6,10,12,14,46,55,-9,42
Raith,2938,7,10,10,16,37,53,-16,40
Dunfermline,2938,8,9,12,15,49,54,-5,39
St Mirren,2938,9,8,11,17,37,56,-19,35
Ayr,2938,10,7,14,15,32,56,-24,35
Morton,2939,1,18,11,7,57,38,19,65
Hibernian,2939,2,17,12,7,49,28,21,63
Falkirk,2939,3,17,11,8,62,39,23,62
Dundee Utd,2939,4,14,11,11,51,38,13,53
Dunfermline,2939,5,10,14,12,48,53,-5,44
Queen of S't,2939,6,11,10,15,43,51,-8,43
Raith,2939,7,11,9,16,36,48,-12,42
Ayr,2939,8,10,10,16,37,61,-24,40
St Mirren,2939,9,9,10,17,42,54,-12,37
Dumbarton,2939,10,7,14,15,49,64,-15,35
Hibernian,2940,1,18,13,5,54,27,27,67
Morton,2940,2,18,12,6,46,31,15,66
Dundee Utd,2940,3,16,11,9,49,37,12,59
Falkirk,2940,4,15,11,10,58,41,17,56
Queen of S't,2940,5,12,8,16,40,49,-9,44
Dumbarton,2940,6,10,12,14,46,51,-5,42
Raith,2940,7,11,9,16,35,47,-12,42
Dunfermline,2940,8,9,12,15,43,48,-5,39
St Mirren,2940,9,8,11,17,39,57,-18,35
Ayr,2940,10,7,13,16,34,56,-22,34
Hibernian,2941,1,19,12,5,58,28,30,69
Morton,2941,2,17,12,7,50,36,14,63
Dundee Utd,2941,3,17,10,9,52,37,15,61
Falkirk,2941,4,15,12,9,59,41,18,57
Raith,2941,5,11,10,15,37,48,-11,43
Dumbarton,2941,6,9,13,14,48,56,-8,40
Dunfermline,2941,7,8,15,13,46,50,-4,39
Queen of S't,2941,8,9,11,16,42,53,-11,38
Ayr,2941,9,8,13,15,33,52,-19,37
St Mirren,2941,10,8,10,18,36,60,-24,34
Hibernian,2942,1,20,12,4,59,28,31,72
Morton,2942,2,17,10,9,54,40,14,61
Falkirk,2942,3,16,11,9,63,44,19,59
Dundee Utd,2942,4,17,8,11,53,47,6,59
Dunfermline,2942,5,11,13,12,50,48,2,46
Dumbarton,2942,6,11,10,15,51,55,-4,43
Queen of S't,2942,7,11,9,16,44,56,-12,42
Raith,2942,8,9,10,17,36,55,-19,37
St Mirren,2942,9,9,9,18,42,57,-15,36
Ayr,2942,10,7,12,17,37,59,-22,33
Hibernian,2943,1,20,12,4,60,27,33,72
Dundee Utd,2943,2,18,9,9,58,41,17,63
Morton,2943,3,15,12,9,47,40,7,57
Falkirk,2943,4,14,9,13,53,45,8,51
Dunfermline,2943,5,13,12,11,54,51,3,51
Queen of S't,2943,6,13,9,14,49,48,1,48
Raith,2943,7,10,10,16,39,51,-12,40
Dumbarton,2943,8,9,11,16,50,64,-14,38
Ayr,2943,9,8,11,17,35,58,-23,35
St Mirren,2943,10,7,11,18,35,55,-20,32
Hibernian,2944,1,19,10,7,58,29,29,67
Morton,2944,2,17,13,6,55,34,21,64
Dundee Utd,2944,3,16,11,9,51,37,14,59
Falkirk,2944,4,16,10,10,59,46,13,58
Queen of S't,2944,5,10,11,15,43,55,-12,41
Dumbarton,2944,6,9,13,14,52,59,-7,40
Dunfermline,2944,7,8,15,13,46,55,-9,39
Raith,2944,8,9,12,15,34,47,-13,39
Ayr,2944,9,9,12,15,34,52,-18,39
St Mirren,2944,10,8,11,17,39,57,-18,35
Hibernian,2945,1,19,12,5,60,28,32,69
Dundee Utd,2945,2,16,10,10,52,43,9,58
Falkirk,2945,3,16,9,11,56,38,18,57
Morton,2945,4,15,11,10,52,42,10,56
Queen of S't,2945,5,12,9,15,46,55,-9,45
Raith,2945,6,11,10,15,39,53,-14,43
Ayr,2945,7,10,11,15,40,56,-16,41
St Mirren,2945,8,10,10,16,41,54,-13,40
Dunfermline,2945,9,9,12,15,43,51,-8,39
Dumbarton,2945,10,9,12,15,49,58,-9,39
Hibernian,2946,1,20,11,5,58,27,31,71
Morton,2946,2,19,11,6,53,34,19,68
Falkirk,2946,3,16,11,9,53,36,17,59
Dundee Utd,2946,4,16,11,9,51,38,13,59
Dunfermline,2946,5,10,13,13,50,52,-2,43
Raith,2946,6,11,9,16,39,51,-12,42
Dumbarton,2946,7,10,10,16,49,55,-6,40
Queen of S't,2946,8,9,11,16,41,54,-13,38
St Mirren,2946,9,8,11,17,38,53,-15,35
Ayr,2946,10,6,12,18,32,64,-32,30
Hibernian,2947,1,19,13,4,57,28,29,70
Falkirk,2947,2,17,11,8,63,41,22,62
Morton,2947,3,16,13,7,49,34,15,61
Dundee Utd,2947,4,15,9,12,45,43,2,54
Dumbarton,2947,5,10,13,13,54,55,-1,43
Queen of S't,2947,6,11,10,15,46,54,-8,43
Raith,2947,7,11,9,16,38,50,-12,42
Ayr,2947,8,7,16,13,36,54,-18,37
Dunfermline,2947,9,7,14,15,46,58,-12,35
St Mirren,2947,10,7,12,17,42,59,-17,33
Hibernian,2948,1,19,11,6,55,29,26,68
Morton,2948,2,17,11,8,48,39,9,62
Dundee Utd,2948,3,16,12,8,47,35,12,60
Falkirk,2948,4,15,12,9,55,38,17,57
Ayr,2948,5,11,12,13,38,49,-11,45
Queen of S't,2948,6,10,11,15,44,52,-8,41
Raith,2948,7,11,8,17,35,50,-15,41
Dunfermline,2948,8,9,12,15,48,51,-3,39
Dumbarton,2948,9,8,12,16,44,56,-12,36
St Mirren,2948,10,9,9,18,40,55,-15,36
Hibernian,2949,1,20,11,5,60,28,32,71
Morton,2949,2,18,11,7,52,34,18,65
Dundee Utd,2949,3,17,10,9,52,37,15,61
Falkirk,2949,4,16,9,11,58,41,17,57
Queen of S't,2949,5,11,10,15,48,57,-9,43
Dumbarton,2949,6,9,14,13,47,55,-8,41
Dunfermline,2949,7,9,13,14,46,51,-5,40
Ayr,2949,8,9,12,15,35,54,-19,39
Raith,2949,9,9,9,18,32,52,-20,36
St Mirren,2949,10,8,9,19,35,56,-21,33
Hibernian,2950,1,20,12,4,61,28,33,72
Morton,2950,2,19,11,6,54,33,21,68
Falkirk,2950,3,17,12,7,57,35,22,63
Dundee Utd,2950,4,16,9,11,52,42,10,57
Queen of S't,2950,5,13,9,14,46,49,-3,48
Dumbarton,2950,6,9,12,15,44,54,-10,39
Raith,2950,7,10,8,18,35,53,-18,38
St Mirren,2950,8,8,11,17,40,56,-16,35
Dunfermline,2950,9,7,12,17,38,53,-15,33
Ayr,2950,10,7,12,17,35,59,-24,33
Hibernian,2951,1,20,11,5,57,27,30,71
Morton,2951,2,18,10,8,52,39,13,64
Dundee Utd,2951,3,16,10,10,57,38,19,58
Falkirk,2951,4,15,10,11,52,41,11,55
Dunfermline,2951,5,11,11,14,47,52,-5,44
Dumbarton,2951,6,11,10,15,49,55,-6,43
Raith,2951,7,10,11,15,37,47,-10,41
St Mirren,2951,8,9,12,15,41,52,-11,39
Queen of S't,2951,9,10,8,18,43,58,-15,38
Ayr,2951,10,8,11,17,34,60,-26,35
Morton,2952,1,19,12,5,53,33,20,69
Hibernian,2952,2,18,13,5,58,29,29,67
Falkirk,2952,3,17,10,9,64,40,24,61
Dundee Utd,2952,4,16,10,10,50,40,10,58
Queen of S't,2952,5,11,10,15,45,52,-7,43
Raith,2952,6,10,10,16,35,50,-15,40
Dunfermline,2952,7,8,14,14,45,53,-8,38
Dumbarton,2952,8,8,13,15,46,59,-13,37
St Mirren,2952,9,7,13,16,36,54,-18,34
Ayr,2952,10,6,15,15,29,51,-22,33
Hibernian,2953,1,18,14,4,60,28,32,68
Dundee Utd,2953,2,18,9,9,55,42,13,63
Morton,2953,3,16,13,7,55,42,13,61
Falkirk,2953,4,16,10,10,63,44,19,58
Raith,2953,5,12,8,16,44,56,-12,44
Dunfermline,2953,6,9,16,11,51,49,2,43
Dumbarton,2953,7,10,11,15,46,55,-9,41
Queen of S't,2953,8,11,8,17,41,56,-15,41
St Mirren,2953,9,8,11,17,39,57,-18,35
Ayr,2953,10,7,10,19,30,55,-25,31
Hibernian,2954,1,20,11,5,60,26,34,71
Morton,2954,2,18,12,6,59,40,19,66
Dundee Utd,2954,3,15,11,10,55,41,14,56
Falkirk,2954,4,14,11,11,52,47,5,53
Queen of S't,2954,5,11,11,14,44,50,-6,44
Dunfermline,2954,6,10,11,15,49,55,-6,41
Dumbarton,2954,7,8,14,14,53,62,-9,38
St Mirren,2954,8,9,11,16,43,58,-15,38
Raith,2954,9,9,11,16,32,50,-18,38
Ayr,2954,10,8,13,15,35,53,-18,37
Hibernian,2955,1,20,12,4,59,27,32,72
Morton,2955,2,17,12,7,53,33,20,63
Dundee Utd,2955,3,17,10,9,50,39,11,61
Falkirk,2955,4,17,9,10,65,42,23,60
Raith,2955,5,12,9,15,37,52,-15,45
Queen of S't,2955,6,10,11,15,51,58,-7,41
Ayr,2955,7,8,14,14,38,54,-16,38
Dunfermline,2955,8,8,13,15,40,49,-9,37
Dumbarton,2955,9,8,12,16,48,61,-13,36
St Mirren,2955,10,7,10,19,37,63,-26,31
Hibernian,2956,1,16,11,9,51,34,17,59
Dundee Utd,2956,2,16,10,10,47,40,7,58
Falkirk,2956,3,16,9,11,58,41,17,57
Morton,2956,4,14,14,8,48,37,11,56
Queen of S't,2956,5,13,10,13,44,46,-2,49
Dunfermline,2956,6,11,13,12,51,49,2,46
Raith,2956,7,12,8,16,35,48,-13,44
Ayr,2956,8,10,11,15,38,53,-15,41
St Mirren,2956,9,10,10,16,41,52,-11,40
Dumbarton,2956,10,8,12,16,49,62,-13,36
Hibernian,2957,1,19,12,5,56,27,29,69
Falkirk,2957,2,16,12,8,58,39,19,60
Morton,2957,3,16,11,9,52,40,12,59
Queen of S't,2957,4,15,9,12,50,46,4,54
Dundee Utd,2957,5,15,8,13,50,45,5,53
Dunfermline,2957,6,10,13,13,51,50,1,43
Ayr,2957,7,10,11,15,36,55,-19,41
Raith,2957,8,10,10,16,35,50,-15,40
St Mirren,2957,9,8,11,17,39,58,-19,35
Dumbarton,2957,10,7,11,18,48,65,-17,32
Hibernian,2958,1,20,11,5,57,27,30,71
Morton,2958,2,20,10,6,51,31,20,70
Falkirk,2958,3,17,9,10,61,39,22,60
Dundee Utd,2958,4,14,11,11,48,43,5,53
Dunfermline,2958,5,11,13,12,48,44,4,46
Raith,2958,6,11,9,16,37,50,-13,42
Dumbarton,2958,7,9,12,15,47,59,-12,39
Queen of S't,2958,8,10,9,17,45,58,-13,39
Ayr,2958,9,9,11,16,38,57,-19,38
St Mirren,2958,10,6,11,19,35,59,-24,29
Hibernian,2959,1,18,13,5,55,28,27,67
Falkirk,2959,2,17,9,10,63,43,20,60
Dundee Utd,2959,3,16,9,11,54,41,13,57
Morton,2959,4,15,12,9,45,34,11,57
Dunfermline,2959,5,11,14,11,51,48,3,47
Dumbarton,2959,6,12,10,14,57,57,0,46
Queen of S't,2959,7,11,8,17,42,55,-13,41
Raith,2959,8,11,8,17,34,53,-19,41
Ayr,2959,9,8,12,16,33,59,-26,36
St Mirren,2959,10,8,11,17,43,59,-16,35
Hibernian,2960,1,21,11,4,64,27,37,74
Dundee Utd,2960,2,18,10,8,54,35,19,64
Falkirk,2960,3,16,12,8,57,40,17,60
Morton,2960,4,16,12,8,51,41,10,60
Dunfermline,2960,5,9,14,13,48,53,-5,41
Queen of S't,2960,6,10,11,15,43,50,-7,41
Dumbarton,2960,7,9,11,16,48,58,-10,38
St Mirren,2960,8,8,12,16,36,53,-17,36
Ayr,2960,9,8,12,16,37,59,-22,36
Raith,2960,10,8,9,19,34,56,-22,33
Morton,2961,1,17,12,7,49,34,15,63
Hibernian,2961,2,16,12,8,52,32,20,60
Falkirk,2961,3,16,10,10,57,41,16,58
Dundee Utd,2961,4,14,13,9,49,41,8,55
Queen of S't,2961,5,12,11,13,48,49,-1,47
Dunfermline,2961,6,11,12,13,49,51,-2,45
St Mirren,2961,7,12,9,15,49,53,-4,45
Dumbarton,2961,8,10,11,15,48,58,-10,41
Ayr,2961,9,7,14,15,34,55,-21,35
Raith,2961,10,8,10,18,32,53,-21,34
Hibernian,2962,1,19,13,4,60,29,31,70
Dundee Utd,2962,2,17,9,10,51,40,11,60
Falkirk,2962,3,15,11,10,56,41,15,56
Morton,2962,4,14,11,11,45,42,3,53
Dunfermline,2962,5,10,14,12,48,47,1,44
Queen of S't,2962,6,10,13,13,43,49,-6,43
St Mirren,2962,7,10,11,15,40,53,-13,41
Raith,2962,8,10,10,16,36,49,-13,40
Ayr,2962,9,9,12,15,37,55,-18,39
Dumbarton,2962,10,8,12,16,45,56,-11,36
Hibernian,2963,1,19,10,7,54,25,29,67
Morton,2963,2,19,10,7,52,37,15,67
Falkirk,2963,3,15,13,8,56,40,16,58
Dundee Utd,2963,4,16,10,10,55,45,10,58
Dunfermline,2963,5,11,15,10,50,47,3,48
Queen of S't,2963,6,10,11,15,46,55,-9,41
Ayr,2963,7,8,14,14,41,58,-17,38
Raith,2963,8,8,12,16,33,48,-15,36
St Mirren,2963,9,8,12,16,38,55,-17,36
Dumbarton,2963,10,7,11,18,46,61,-15,32
Hibernian,2964,1,19,11,6,57,29,28,68
Falkirk,2964,2,16,11,9,57,42,15,59
Dundee Utd,2964,3,16,11,9,51,39,12,59
Morton,2964,4,15,10,11,48,42,6,55
Dunfermline,2964,5,10,14,12,48,48,0,44
Ayr,2964,6,11,10,15,38,53,-15,43
Dumbarton,2964,7,10,12,14,49,56,-7,42
Raith,2964,8,11,8,17,37,50,-13,41
Queen of S't,2964,9,10,10,16,44,55,-11,40
St Mirren,2964,10,8,11,17,38,53,-15,35
Hibernian,2965,1,18,13,5,56,30,26,67
Falkirk,2965,2,16,12,8,63,40,23,60
Morton,2965,3,15,14,7,50,39,11,59
Dundee Utd,2965,4,13,12,11,46,45,1,51
Queen of S't,2965,5,12,9,15,50,53,-3,45
Dunfermline,2965,6,10,14,12,49,49,0,44
Ayr,2965,7,10,12,14,38,54,-16,42
Raith,2965,8,10,10,16,34,49,-15,40
Dumbarton,2965,9,9,11,16,49,60,-11,38
St Mirren,2965,10,8,11,17,44,60,-16,35
Hibernian,2966,1,18,12,6,59,29,30,66
Morton,2966,2,16,12,8,49,36,13,60
Dundee Utd,2966,3,16,11,9,51,37,14,59
Falkirk,2966,4,15,10,11,58,42,16,55
Dunfermline,2966,5,11,12,13,48,47,1,45
Raith,2966,6,12,9,15,35,45,-10,45
Queen of S't,2966,7,10,12,14,40,51,-11,42
Dumbarton,2966,8,9,14,13,46,54,-8,41
Ayr,2966,9,7,14,15,36,59,-23,35
St Mirren,2966,10,7,12,17,37,59,-22,33
Hibernian,2967,1,20,11,5,54,24,30,71
Morton,2967,2,16,13,7,48,35,13,61
Falkirk,2967,3,17,9,10,60,40,20,60
Dundee Utd,2967,4,13,12,11,50,47,3,51
Queen of S't,2967,5,13,10,13,47,47,0,49
Dunfermline,2967,6,10,14,12,49,47,2,44
Dumbarton,2967,7,9,11,16,48,58,-10,38
St Mirren,2967,8,9,11,16,38,56,-18,38
Raith,2967,9,9,9,18,31,50,-19,36
Ayr,2967,10,8,12,16,33,54,-21,36
Hibernian,2968,1,21,10,5,55,24,31,73
Dundee Utd,2968,2,16,11,9,55,40,15,59
Morton,2968,3,16,11,9,50,39,11,59
Falkirk,2968,4,15,13,8,63,45,18,58
Dunfermline,2968,5,10,13,13,48,49,-1,43
Queen of S't,2968,6,11,10,15,49,53,-4,43
Raith,2968,7,11,9,16,37,50,-13,42
St Mirren,2968,8,9,11,16,43,57,-14,38
Dumbarton,2968,9,8,12,16,47,63,-16,36
Ayr,2968,10,7,12,17,34,61,-27,33
Hibernian,2969,1,21,11,4,58,25,33,74
Morton,2969,2,17,10,9,55,44,11,61
Falkirk,2969,3,16,9,11,58,43,15,57
Dundee Utd,2969,4,14,10,12,48,45,3,52
Queen of S't,2969,5,12,10,14,45,50,-5,46
Dumbarton,2969,6,10,13,13,52,56,-4,43
Dunfermline,2969,7,9,14,13,52,53,-1,41
St Mirren,2969,8,10,9,17,47,61,-14,39
Ayr,2969,9,9,12,15,36,53,-17,39
Raith,2969,10,9,8,19,33,54,-21,35
Hibernian,2970,1,20,11,5,63,28,35,71
Morton,2970,2,16,12,8,50,40,10,60
Falkirk,2970,3,16,9,11,57,45,12,57
Dundee Utd,2970,4,15,9,12,49,45,4,54
Dunfermline,2970,5,11,13,12,54,48,6,46
Queen of S't,2970,6,12,9,15,49,54,-5,45
Ayr,2970,7,10,12,14,39,53,-14,42
Dumbarton,2970,8,9,12,15,51,61,-10,39
Raith,2970,9,10,8,18,34,59,-25,38
St Mirren,2970,10,8,11,17,49,62,-13,35
Morton,2971,1,18,10,8,50,34,16,64
Hibernian,2971,2,17,12,7,54,31,23,63
Falkirk,2971,3,18,9,9,61,39,22,63
Dundee Utd,2971,4,17,8,11,53,38,15,59
Queen of S't,2971,5,12,11,13,48,51,-3,47
Dunfermline,2971,6,10,11,15,46,51,-5,41
Raith,2971,7,11,8,17,35,49,-14,41
Dumbarton,2971,8,9,11,16,49,65,-16,38
Ayr,2971,9,8,13,15,38,58,-20,37
St Mirren,2971,10,8,11,17,40,58,-18,35
Hibernian,2972,1,19,11,6,62,29,33,68
Morton,2972,2,19,9,8,56,41,15,66
Dundee Utd,2972,3,15,10,11,55,44,11,55
Falkirk,2972,4,14,12,10,58,45,13,54
Raith,2972,5,12,9,15,37,50,-13,45
Dunfermline,2972,6,11,11,14,50,55,-5,44
Ayr,2972,7,10,12,14,39,54,-15,42
Dumbarton,2972,8,10,10,16,52,61,-9,40
Queen of S't,2972,9,10,9,17,43,55,-12,39
St Mirren,2972,10,8,11,17,40,58,-18,35
Hibernian,2973,1,19,12,5,56,27,29,69
Falkirk,2973,2,17,10,9,62,41,21,61
Morton,2973,3,16,13,7,48,35,13,61
Dundee Utd,2973,4,16,9,11,48,39,9,57
Queen of S't,2973,5,13,9,14,46,49,-3,48
Dunfermline,2973,6,10,14,12,47,44,3,44
Dumbarton,2973,7,10,11,15,44,55,-11,41
Raith,2973,8,10,10,16,31,47,-16,40
Ayr,2973,9,7,12,17,32,55,-23,33
St Mirren,2973,10,7,10,19,36,58,-22,31
Hibernian,2974,1,18,14,4,55,26,29,68
Morton,2974,2,17,12,7,55,36,19,63
Dundee Utd,2974,3,17,9,10,51,44,7,60
Falkirk,2974,4,15,12,9,63,43,20,57
Dunfermline,2974,5,10,12,14,45,49,-4,42
Dumbarton,2974,6,10,11,15,49,57,-8,41
Raith,2974,7,10,11,15,35,47,-12,41
Queen of S't,2974,8,10,9,17,41,56,-15,39
St Mirren,2974,9,9,10,17,40,56,-16,37
Ayr,2974,10,8,12,16,32,52,-20,36
Hibernian,2975,1,17,13,6,51,28,23,64
Falkirk,2975,2,18,9,9,57,39,18,63
Dundee Utd,2975,3,16,12,8,56,42,14,60
Morton,2975,4,16,12,8,49,37,12,60
Raith,2975,5,12,8,16,38,50,-12,44
Dumbarton,2975,6,10,13,13,51,55,-4,43
Dunfermline,2975,7,10,12,14,42,49,-7,42
Queen of S't,2975,8,10,9,17,42,52,-10,39
Ayr,2975,9,9,12,15,40,54,-14,39
St Mirren,2975,10,7,10,19,35,55,-20,31
Hibernian,2976,1,19,12,5,58,25,33,69
Falkirk,2976,2,17,10,9,59,40,19,61
Morton,2976,3,14,14,8,48,45,3,56
Dundee Utd,2976,4,14,11,11,49,40,9,53
Dunfermline,2976,5,12,12,12,48,45,3,48
Raith,2976,6,10,11,15,38,53,-15,41
Queen of S't,2976,7,10,10,16,42,49,-7,40
Ayr,2976,8,9,13,14,34,49,-15,40
Dumbarton,2976,9,9,11,16,48,61,-13,38
St Mirren,2976,10,8,12,16,39,56,-17,36
Hibernian,2977,1,19,14,3,54,21,33,71
Dundee Utd,2977,2,17,10,9,55,39,16,61
Morton,2977,3,16,11,9,47,37,10,59
Falkirk,2977,4,15,13,8,54,35,19,58
Queen of S't,2977,5,12,10,14,44,49,-5,46
Raith,2977,6,11,10,15,32,43,-11,43
Dunfermline,2977,7,8,15,13,44,48,-4,39
Dumbarton,2977,8,7,14,15,42,54,-12,35
Ayr,2977,9,7,14,15,30,52,-22,35
St Mirren,2977,10,6,13,17,37,61,-24,31
Hibernian,2978,1,19,13,4,58,30,28,70
Dundee Utd,2978,2,18,9,9,51,36,15,63
Morton,2978,3,17,11,8,52,38,14,62
Falkirk,2978,4,16,11,9,54,37,17,59
Raith,2978,5,11,9,16,39,51,-12,42
Queen of S't,2978,6,10,10,16,49,57,-8,40
Dumbarton,2978,7,10,10,16,48,60,-12,40
St Mirren,2978,8,10,9,17,45,54,-9,39
Dunfermline,2978,9,8,14,14,42,50,-8,38
Ayr,2978,10,7,12,17,36,61,-25,33
Hibernian,2979,1,20,12,4,58,24,34,72
Morton,2979,2,18,10,8,50,33,17,64
Dundee Utd,2979,3,14,12,10,51,43,8,54
Falkirk,2979,4,13,13,10,55,45,10,52
Dunfermline,2979,5,10,16,10,49,46,3,46
Dumbarton,2979,6,10,12,14,53,58,-5,42
Queen of S't,2979,7,9,13,14,44,54,-10,40
Ayr,2979,8,9,12,15,35,58,-23,39
Raith,2979,9,8,12,16,32,47,-15,36
St Mirren,2979,10,8,10,18,40,59,-19,34
Hibernian,2980,1,20,10,6,52,24,28,70
Morton,2980,2,17,12,7,49,34,15,63
Falkirk,2980,3,17,11,8,61,37,24,62
Dundee Utd,2980,4,17,8,11,55,44,11,59
Queen of S't,2980,5,13,8,15,51,50,1,47
Dumbarton,2980,6,10,12,14,51,57,-6,42
St Mirren,2980,7,10,10,16,40,56,-16,40
Raith,2980,8,10,8,18,35,53,-18,38
Dunfermline,2980,9,8,12,16,42,54,-12,36
Ayr,2980,10,7,11,18,33,60,-27,32
Hibernian,2981,1,19,13,4,54,22,32,70
Dundee Utd,2981,2,17,11,8,53,36,17,62
Falkirk,2981,3,15,10,11,58,43,15,55
Morton,2981,4,14,11,11,43,40,3,53
Dunfermline,2981,5,10,14,12,42,46,-4,44
Raith,2981,6,11,10,15,36,45,-9,43
Queen of S't,2981,7,9,14,13,44,53,-9,41
Dumbarton,2981,8,9,13,14,49,60,-11,40
St Mirren,2981,9,9,10,17,45,57,-12,37
Ayr,2981,10,7,14,15,33,55,-22,35
Hibernian,2982,1,19,13,4,56,26,30,70
Morton,2982,2,17,12,7,49,35,14,63
Dundee Utd,2982,3,16,10,10,50,40,10,58
Falkirk,2982,4,15,12,9,57,41,16,57
Queen of S't,2982,5,12,10,14,50,49,1,46
Dunfermline,2982,6,11,12,13,47,50,-3,45
Ayr,2982,7,8,13,15,33,54,-21,37
Dumbarton,2982,8,7,15,14,45,59,-14,36
Raith,2982,9,9,9,18,36,52,-16,36
St Mirren,2982,10,8,10,18,37,54,-17,34
Hibernian,2983,1,19,13,4,58,26,32,70
Morton,2983,2,16,13,7,51,34,17,61
Dundee Utd,2983,3,17,8,11,54,40,14,59
Falkirk,2983,4,16,9,11,61,42,19,57
Dunfermline,2983,5,11,13,12,46,47,-1,46
Queen of S't,2983,6,12,9,15,47,55,-8,45
Raith,2983,7,11,10,15,38,51,-13,43
Dumbarton,2983,8,8,13,15,45,58,-13,37
Ayr,2983,9,6,16,14,34,60,-26,34
St Mirren,2983,10,6,12,18,36,57,-21,30
Hibernian,2984,1,19,11,6,53,25,28,68
Falkirk,2984,2,18,9,9,64,42,22,63
Dundee Utd,2984,3,17,9,10,59,40,19,60
Morton,2984,4,15,11,10,47,39,8,56
Queen of S't,2984,5,11,10,15,44,50,-6,43
Dunfermline,2984,6,10,12,14,43,48,-5,42
Raith,2984,7,10,12,14,34,46,-12,42
Ayr,2984,8,10,11,15,35,55,-20,41
Dumbarton,2984,9,9,10,17,49,60,-11,37
St Mirren,2984,10,8,11,17,36,59,-23,35
Hibernian,2985,1,21,12,3,57,23,34,75
Morton,2985,2,16,12,8,54,41,13,60
Falkirk,2985,3,16,11,9,63,40,23,59
Dundee Utd,2985,4,15,10,11,49,37,12,55
Queen of S't,2985,5,12,9,15,42,48,-6,45
Dunfermline,2985,6,10,14,12,46,47,-1,44
Ayr,2985,7,9,12,15,35,55,-20,39
Raith,2985,8,9,11,16,32,48,-16,38
Dumbarton,2985,9,9,10,17,47,62,-15,37
St Mirren,2985,10,7,11,18,36,60,-24,32
Hibernian,2986,1,21,11,4,58,26,32,74
Falkirk,2986,2,18,10,8,62,41,21,64
Dundee Utd,2986,3,17,9,10,58,40,18,60
Morton,2986,4,15,10,11,49,40,9,55
Dunfermline,2986,5,11,11,14,46,54,-8,44
Queen of S't,2986,6,11,10,15,47,52,-5,43
Raith,2986,7,10,10,16,35,49,-14,40
St Mirren,2986,8,9,10,17,42,55,-13,37
Dumbarton,2986,9,8,12,16,48,62,-14,36
Ayr,2986,10,8,11,17,35,61,-26,35
Hibernian,2987,1,20,12,4,54,24,30,72
Morton,2987,2,18,11,7,55,37,18,65
Falkirk,2987,3,16,10,10,56,39,17,58
Dundee Utd,2987,4,14,10,12,46,41,5,52
Queen of S't,2987,5,11,10,15,43,47,-4,43
Dunfermline,2987,6,10,12,14,44,51,-7,42
Raith,2987,7,10,11,15,43,53,-10,41
Ayr,2987,8,9,13,14,35,54,-19,40
Dumbarton,2987,9,9,12,15,49,58,-9,39
St Mirren,2987,10,7,11,18,33,54,-21,32
Hibernian,2988,1,18,15,3,53,22,31,69
Falkirk,2988,2,18,10,8,62,37,25,64
Morton,2988,3,16,12,8,48,38,10,60
Dundee Utd,2988,4,16,9,11,48,41,7,57
Raith,2988,5,12,9,15,38,48,-10,45
Dunfermline,2988,6,10,13,13,47,47,0,43
Dumbarton,2988,7,10,11,15,48,56,-8,41
Queen of S't,2988,8,10,9,17,42,54,-12,39
St Mirren,2988,9,8,10,18,37,58,-21,34
Ayr,2988,10,7,12,17,33,55,-22,33
Hibernian,2989,1,20,11,5,55,24,31,71
Falkirk,2989,2,15,12,9,60,45,15,57
Morton,2989,3,15,11,10,52,44,8,56
Dundee Utd,2989,4,14,12,10,54,44,10,54
Dunfermline,2989,5,10,15,11,48,49,-1,45
Queen of S't,2989,6,11,9,16,49,56,-7,42
Raith,2989,7,11,9,16,37,48,-11,42
Ayr,2989,8,9,14,13,37,53,-16,41
Dumbarton,2989,9,9,12,15,52,66,-14,39
St Mirren,2989,10,8,11,17,41,56,-15,35
Hibernian,2990,1,21,11,4,62,22,40,74
Morton,2990,2,18,10,8,53,36,17,64
Dundee Utd,2990,3,18,9,9,51,36,15,63
Falkirk,2990,4,15,12,9,56,41,15,57
Queen of S't,2990,5,13,10,13,49,49,0,49
Dumbarton,2990,6,10,11,15,49,56,-7,41
Dunfermline,2990,7,8,13,15,43,52,-9,37
Ayr,2990,8,8,12,16,32,55,-23,36
Raith,2990,9,8,11,17,33,53,-20,35
St Mirren,2990,10,6,11,19,33,61,-28,29
Hibernian,2991,1,21,10,5,62,29,33,73
Dundee Utd,2991,2,18,10,8,58,40,18,64
Morton,2991,3,16,12,8,49,38,11,60
Falkirk,2991,4,15,10,11,57,44,13,55
Dunfermline,2991,5,9,15,12,47,49,-2,42
Queen of S't,2991,6,11,8,17,47,54,-7,41
Raith,2991,7,10,11,15,36,46,-10,41
Dumbarton,2991,8,10,10,16,52,68,-16,40
Ayr,2991,9,8,12,16,34,56,-22,36
St Mirren,2991,10,7,12,17,44,62,-18,33
Hibernian,2992,1,19,14,3,56,24,32,71
Falkirk,2992,2,16,10,10,59,45,14,58
Morton,2992,3,15,11,10,45,36,9,56
Dundee Utd,2992,4,14,10,12,46,43,3,52
Dunfermline,2992,5,12,12,12,53,46,7,48
Raith,2992,6,11,10,15,38,52,-14,43
St Mirren,2992,7,10,11,15,45,55,-10,41
Queen of S't,2992,8,11,8,17,48,59,-11,41
Dumbarton,2992,9,9,11,16,51,62,-11,38
Ayr,2992,10,8,13,15,35,54,-19,37
Hibernian,2993,1,19,12,5,58,28,30,69
Morton,2993,2,17,12,7,47,34,13,63
Dundee Utd,2993,3,16,10,10,50,37,13,58
Falkirk,2993,4,15,11,10,57,44,13,56
Queen of S't,2993,5,12,10,14,47,47,0,46
Dunfermline,2993,6,9,13,14,45,53,-8,40
St Mirren,2993,7,10,10,16,42,53,-11,40
Dumbarton,2993,8,9,12,15,51,60,-9,39
Ayr,2993,9,8,14,14,34,56,-22,38
Raith,2993,10,9,8,19,35,54,-19,35
Hibernian,2994,1,20,10,6,54,24,30,70
Morton,2994,2,16,13,7,51,37,14,61
Falkirk,2994,3,16,11,9,63,43,20,59
Dundee Utd,2994,4,15,11,10,48,37,11,56
Queen of S't,2994,5,12,10,14,46,51,-5,46
Dunfermline,2994,6,10,13,13,46,47,-1,43
Raith,2994,7,11,10,15,36,50,-14,43
Ayr,2994,8,8,13,15,33,55,-22,37
St Mirren,2994,9,8,11,17,39,56,-17,35
Dumbarton,2994,10,7,12,17,47,63,-16,33
Hibernian,2995,1,18,15,3,61,26,35,69
Morton,2995,2,19,9,8,58,43,15,66
Dundee Utd,2995,3,17,9,10,48,38,10,60
Falkirk,2995,4,13,14,9,55,42,13,53
Dumbarton,2995,5,11,11,14,51,58,-7,44
Queen of S't,2995,6,11,10,15,50,55,-5,43
Raith,2995,7,10,11,15,36,49,-13,41
Dunfermline,2995,8,8,13,15,45,52,-7,37
Ayr,2995,9,8,12,16,33,57,-24,36
St Mirren,2995,10,8,10,18,38,55,-17,34
Hibernian,2996,1,19,10,7,54,27,27,67
Falkirk,2996,2,17,11,8,58,41,17,62
Morton,2996,3,17,11,8,49,36,13,62
Dundee Utd,2996,4,14,13,9,49,38,11,55
Dunfermline,2996,5,11,12,13,47,48,-1,45
Raith,2996,6,11,8,17,33,46,-13,41
Ayr,2996,7,10,11,15,33,51,-18,41
Queen of S't,2996,8,10,10,16,42,48,-6,40
Dumbarton,2996,9,9,11,16,47,59,-12,38
St Mirren,2996,10,9,9,18,36,54,-18,36
Hibernian,2997,1,20,13,3,59,25,34,73
Morton,2997,2,17,11,8,50,37,13,62
Falkirk,2997,3,14,11,11,52,41,11,53
Dundee Utd,2997,4,14,11,11,44,38,6,53
Queen of S't,2997,5,13,10,13,50,51,-1,49
Dunfermline,2997,6,10,12,14,48,52,-4,42
Raith,2997,7,11,8,17,36,49,-13,41
Ayr,2997,8,10,11,15,35,49,-14,41
St Mirren,2997,9,9,10,17,41,54,-13,37
Dumbarton,2997,10,8,11,17,44,63,-19,35
Hibernian,2998,1,18,13,5,53,27,26,67
Morton,2998,2,18,12,6,54,35,19,66
Falkirk,2998,3,16,11,9,56,39,17,59
Dundee Utd,2998,4,16,9,11,51,46,5,57
Queen of S't,2998,5,11,11,14,49,54,-5,44
Dunfermline,2998,6,9,16,11,47,47,0,43
Dumbarton,2998,7,9,13,14,50,59,-9,40
Ayr,2998,8,9,11,16,41,56,-15,38
Raith,2998,9,9,9,18,37,55,-18,36
St Mirren,2998,10,7,11,18,39,59,-20,32
Hibernian,2999,1,21,11,4,53,21,32,74
Morton,2999,2,18,10,8,50,36,14,64
Falkirk,2999,3,15,11,10,56,41,15,56
Dundee Utd,2999,4,14,11,11,51,41,10,53
Dunfermline,2999,5,11,11,14,48,52,-4,44
Queen of S't,2999,6,12,8,16,48,54,-6,44
St Mirren,2999,7,10,11,15,39,51,-12,41
Ayr,2999,8,10,10,16,38,57,-19,40
Raith,2999,9,9,10,17,35,51,-16,37
Dumbarton,2999,10,8,11,17,48,62,-14,35
Dundee Utd,3000,1,18,10,8,53,35,18,64
Hibernian,3000,2,17,12,7,51,28,23,63
Morton,3000,3,17,12,7,52,34,18,63
Falkirk,3000,4,15,10,11,61,46,15,55
Raith,3000,5,13,10,13,37,42,-5,49
Queen of S't,3000,6,12,8,16,44,54,-10,44
Dunfermline,3000,7,9,13,14,41,47,-6,40
Ayr,3000,8,9,12,15,35,56,-21,39
Dumbarton,3000,9,8,12,16,46,58,-12,36
St Mirren,3000,10,7,11,18,41,61,-20,32
Hibernian,3001,1,18,14,4,54,26,28,68
Morton,3001,2,16,11,9,47,36,11,59
Dundee Utd,3001,3,16,10,10,50,39,11,58
Falkirk,3001,4,14,12,10,58,43,15,54
Queen of S't,3001,5,13,8,15,45,50,-5,47
St Mirren,3001,6,11,11,14,46,52,-6,44
Dunfermline,3001,7,10,13,13,46,51,-5,43
Raith,3001,8,11,10,15,34,45,-11,43
Dumbarton,3001,9,8,11,17,46,60,-14,35
Ayr,3001,10,7,12,17,32,56,-24,33
Hibernian,3002,1,18,13,5,55,31,24,67
Morton,3002,2,18,11,7,55,37,18,65
Dundee Utd,3002,3,14,12,10,46,38,8,54
Falkirk,3002,4,13,14,9,51,38,13,53
Dunfermline,3002,5,12,12,12,51,48,3,48
Queen of S't,3002,6,11,10,15,44,52,-8,43
Dumbarton,3002,7,10,11,15,50,58,-8,41
Ayr,3002,8,10,11,15,37,54,-17,41
Raith,3002,9,8,12,16,30,46,-16,36
St Mirren,3002,10,7,12,17,41,58,-17,33
Hibernian,3003,1,20,11,5,58,25,33,71
Falkirk,3003,2,17,10,9,60,42,18,61
Dundee Utd,3003,3,17,10,9,53,40,13,61
Morton,3003,4,15,11,10,45,41,4,56
Queen of S't,3003,5,11,10,15,43,50,-7,43
Dunfermline,3003,6,9,15,12,46,47,-1,42
Dumbarton,3003,7,10,12,14,49,55,-6,42
Ayr,3003,8,9,12,15,36,52,-16,39
Raith,3003,9,9,9,18,36,54,-18,36
St Mirren,3003,10,8,10,18,40,60,-20,34
Hibernian,3004,1,20,12,4,57,26,31,72
Morton,3004,2,16,14,6,48,32,16,62
Falkirk,3004,3,16,10,10,59,42,17,58
Dundee Utd,3004,4,15,12,9,51,38,13,57
Queen of S't,3004,5,12,10,14,44,48,-4,46
Dunfermline,3004,6,9,14,13,42,47,-5,41
Raith,3004,7,10,11,15,37,47,-10,41
Dumbarton,3004,8,9,12,15,46,57,-11,39
Ayr,3004,9,7,12,17,30,56,-26,33
St Mirren,3004,10,7,11,18,35,56,-21,32
Hibernian,3005,1,18,12,6,60,26,34,66
Morton,3005,2,18,11,7,53,36,17,65
Falkirk,3005,3,15,11,10,58,43,15,56
Dundee Utd,3005,4,16,8,12,46,37,9,56
Raith,3005,5,12,10,14,37,45,-8,46
Queen of S't,3005,6,12,8,16,44,53,-9,44
St Mirren,3005,7,10,10,16,46,56,-10,40
Dunfermline,3005,8,8,15,13,42,47,-5,39
Dumbarton,3005,9,9,11,16,45,63,-18,38
Ayr,3005,10,9,10,17,34,59,-25,37
Hibernian,3006,1,17,12,7,53,29,24,63
Falkirk,3006,2,17,9,10,58,42,16,60
Morton,3006,3,15,15,6,49,33,16,60
Dundee Utd,3006,4,16,10,10,50,39,11,58
Dunfermline,3006,5,11,12,13,46,47,-1,45
Ayr,3006,6,11,12,13,36,50,-14,45
Queen of S't,3006,7,12,8,16,47,52,-5,44
Raith,3006,8,10,9,17,37,52,-15,39
Dumbarton,3006,9,8,12,16,48,63,-15,36
St Mirren,3006,10,8,11,17,37,54,-17,35
Hibernian,3007,1,19,11,6,55,25,30,68
Dundee Utd,3007,2,18,8,10,58,40,18,62
Falkirk,3007,3,16,10,10,58,38,20,58
Morton,3007,4,16,10,10,49,41,8,58
Dumbarton,3007,5,12,10,14,51,56,-5,46
Raith,3007,6,11,10,15,37,47,-10,43
Queen of S't,3007,7,11,10,15,44,58,-14,43
St Mirren,3007,8,10,9,17,41,56,-15,39
Dunfermline,3007,9,7,15,14,42,50,-8,36
Ayr,3007,10,8,11,17,33,57,-24,35
Hibernian,3008,1,20,12,4,59,26,33,72
Dundee Utd,3008,2,18,9,9,51,37,14,63
Falkirk,3008,3,17,9,10,59,40,19,60
Morton,3008,4,16,9,11,48,44,4,57
Dunfermline,3008,5,12,11,13,53,48,5,47
Dumbarton,3008,6,11,11,14,53,57,-4,44
Queen of S't,3008,7,11,10,15,47,55,-8,43
Raith,3008,8,10,10,16,41,54,-13,40
St Mirren,3008,9,7,10,19,38,60,-22,31
Ayr,3008,10,6,13,17,31,59,-28,31
Hibernian,3009,1,21,10,5,61,29,32,73
Falkirk,3009,2,17,9,10,61,42,19,60
Morton,3009,3,16,10,10,53,42,11,58
Dundee Utd,3009,4,15,10,11,55,47,8,55
Dunfermline,3009,5,11,14,11,45,42,3,47
Queen of S't,3009,6,10,11,15,44,54,-10,41
Dumbarton,3009,7,9,12,15,52,59,-7,39
Raith,3009,8,10,9,17,38,53,-15,39
Ayr,3009,9,9,11,16,39,65,-26,38
St Mirren,3009,10,9,10,17,45,60,-15,37
Hibernian,3010,1,17,13,6,51,26,25,64
Morton,3010,2,18,10,8,54,36,18,64
Dundee Utd,3010,3,16,11,9,47,38,9,59
Falkirk,3010,4,14,12,10,55,42,13,54
Dunfermline,3010,5,10,14,12,50,51,-1,44
Raith,3010,6,11,9,16,35,47,-12,42
Queen of S't,3010,7,11,8,17,43,56,-13,41
Dumbarton,3010,8,10,10,16,45,56,-11,40
St Mirren,3010,9,10,10,16,40,51,-11,40
Ayr,3010,10,8,13,15,36,53,-17,37
Hibernian,3011,1,19,14,3,56,23,33,71
Morton,3011,2,15,13,8,46,39,7,58
Dundee Utd,3011,3,16,9,11,57,44,13,57
Falkirk,3011,4,15,9,12,55,45,10,54
Dunfermline,3011,5,11,15,10,50,46,4,48
Ayr,3011,6,11,11,14,41,57,-16,44
Dumbarton,3011,7,11,10,15,53,59,-6,43
Queen of S't,3011,8,10,10,16,44,53,-9,40
Raith,3011,9,9,11,16,33,49,-16,38
St Mirren,3011,10,7,10,19,36,56,-20,31
Morton,3012,1,19,10,7,56,36,20,67
Hibernian,3012,2,17,12,7,52,28,24,63
Falkirk,3012,3,17,11,8,59,39,20,62
Dundee Utd,3012,4,15,10,11,53,40,13,55
Queen of S't,3012,5,11,10,15,42,50,-8,43
Dunfermline,3012,6,9,15,12,46,47,-1,42
Ayr,3012,7,10,10,16,35,56,-21,40
St Mirren,3012,8,9,11,16,40,54,-14,38
Raith,3012,9,9,11,16,32,47,-15,38
Dumbarton,3012,10,8,12,16,45,63,-18,36
Hibernian,3013,1,19,12,5,55,27,28,69
Morton,3013,2,16,14,6,50,34,16,62
Dundee Utd,3013,3,16,10,10,52,41,11,58
Falkirk,3013,4,14,13,9,60,41,19,55
Queen of S't,3013,5,12,10,14,43,52,-9,46
Dunfermline,3013,6,9,14,13,46,47,-1,41
Dumbarton,3013,7,9,13,14,49,57,-8,40
Raith,3013,8,10,10,16,35,49,-14,40
Ayr,3013,9,9,11,16,32,53,-21,38
St Mirren,3013,10,7,11,18,34,55,-21,32
Hibernian,3014,1,19,13,4,54,25,29,70
Falkirk,3014,2,17,10,9,61,40,21,61
Morton,3014,3,16,13,7,47,35,12,61
Dundee Utd,3014,4,16,10,10,47,40,7,58
Raith,3014,5,13,10,13,40,46,-6,49
Queen of S't,3014,6,12,9,15,45,51,-6,45
Dunfermline,3014,7,9,11,16,46,49,-3,38
Dumbarton,3014,8,8,12,16,46,58,-12,36
St Mirren,3014,9,7,13,16,38,54,-16,34
Ayr,3014,10,7,11,18,31,57,-26,32
Hibernian,3015,1,19,12,5,62,28,34,69
Morton,3015,2,18,9,9,49,39,10,63
Falkirk,3015,3,17,9,10,61,43,18,60
Dundee Utd,3015,4,14,10,12,51,46,5,52
Dumbarton,3015,5,11,12,13,51,53,-2,45
Raith,3015,6,12,8,16,40,51,-11,44
Dunfermline,3015,7,10,13,13,47,51,-4,43
Queen of S't,3015,8,10,10,16,41,52,-11,40
St Mirren,3015,9,10,10,16,41,55,-14,40
Ayr,3015,10,6,13,17,31,56,-25,31
Hibernian,3016,1,19,11,6,52,27,25,68
Morton,3016,2,18,10,8,52,35,17,64
Falkirk,3016,3,16,12,8,60,36,24,60
Dundee Utd,3016,4,16,11,9,46,37,9,59
Queen of S't,3016,5,10,11,15,42,52,-10,41
Raith,3016,6,10,10,16,34,50,-16,40
Ayr,3016,7,9,13,14,33,49,-16,40
Dunfermline,3016,8,9,12,15,46,50,-4,39
Dumbarton,3016,9,9,11,16,51,67,-16,38
St Mirren,3016,10,8,11,17,42,55,-13,35
Hibernian,3017,1,17,13,6,53,29,24,64
Dundee Utd,3017,2,17,10,9,53,40,13,61
Morton,3017,3,16,12,8,53,40,13,60
Falkirk,3017,4,16,10,10,57,42,15,58
Raith,3017,5,13,9,14,39,46,-7,48
Dunfermline,3017,6,10,12,14,48,53,-5,42
Dumbarton,3017,7,10,12,14,51,57,-6,42
Queen of S't,3017,8,10,11,15,41,48,-7,41
St Mirren,3017,9,9,11,16,41,53,-12,38
Ayr,3017,10,6,12,18,35,63,-28,30
Hibernian,3018,1,21,11,4,56,22,34,74
Dundee Utd,3018,2,17,10,9,49,39,10,61
Morton,3018,3,16,11,9,49,38,11,59
Falkirk,3018,4,14,13,9,54,40,14,55
Queen of S't,3018,5,12,10,14,48,52,-4,46
Dunfermline,3018,6,9,12,15,44,48,-4,39
Ayr,3018,7,9,12,15,36,52,-16,39
St Mirren,3018,8,9,11,16,41,55,-14,38
Dumbarton,3018,9,8,13,15,45,57,-12,37
Raith,3018,10,9,9,18,33,52,-19,36
Morton,3019,1,19,10,7,55,35,20,67
Hibernian,3019,2,18,11,7,54,29,25,65
Falkirk,3019,3,18,10,8,67,39,28,64
Dundee Utd,3019,4,16,10,10,48,38,10,58
Queen of S't,3019,5,12,10,14,42,47,-5,46
Dunfermline,3019,6,8,15,13,42,52,-10,39
Ayr,3019,7,9,12,15,33,50,-17,39
St Mirren,3019,8,9,10,17,41,57,-16,37
Raith,3019,9,9,9,18,32,53,-21,36
Dumbarton,3019,10,8,11,17,46,60,-14,35
Hibernian,3020,1,19,11,6,59,30,29,68
Dundee Utd,3020,2,17,10,9,54,36,18,61
Morton,3020,3,16,11,9,52,43,9,59
Falkirk,3020,4,16,10,10,57,46,11,58
Dunfermline,3020,5,11,12,13,49,53,-4,45
Dumbarton,3020,6,11,11,14,57,60,-3,44
Raith,3020,7,12,8,16,39,49,-10,44
Queen of S't,3020,8,10,8,18,44,53,-9,38
Ayr,3020,9,9,11,16,35,57,-22,38
St Mirren,3020,10,8,10,18,39,58,-19,34
Hibernian,3021,1,21,11,4,58,24,34,74
Falkirk,3021,2,18,10,8,62,40,22,64
Morton,3021,3,14,12,10,48,42,6,54
Dundee Utd,3021,4,14,12,10,49,45,4,54
Dumbarton,3021,5,11,12,13,51,53,-2,45
Queen of S't,3021,6,11,11,14,47,52,-5,44
Dunfermline,3021,7,9,14,13,49,50,-1,41
Raith,3021,8,10,9,17,37,55,-18,39
St Mirren,3021,9,8,12,16,44,58,-14,36
Ayr,3021,10,7,11,18,34,60,-26,32
Hibernian,3022,1,19,11,6,54,28,26,68
Morton,3022,2,17,10,9,53,36,17,61
Dundee Utd,3022,3,17,9,10,50,36,14,60
Falkirk,3022,4,13,13,10,56,44,12,52
Queen of S't,3022,5,12,11,13,46,47,-1,47
Raith,3022,6,11,11,14,38,45,-7,44
Dumbarton,3022,7,9,14,13,47,54,-7,41
Dunfermline,3022,8,9,13,14,45,55,-10,40
Ayr,3022,9,8,12,16,32,54,-22,36
St Mirren,3022,10,8,10,18,37,59,-22,34
Hibernian,3023,1,17,14,5,52,27,25,65
Falkirk,3023,2,17,11,8,61,39,22,62
Morton,3023,3,15,14,7,47,37,10,59
Dundee Utd,3023,4,15,10,11,48,40,8,55
Dunfermline,3023,5,10,14,12,47,46,1,44
Dumbarton,3023,6,11,10,15,58,64,-6,43
Queen of S't,3023,7,10,10,16,41,50,-9,40
St Mirren,3023,8,10,10,16,41,57,-16,40
Raith,3023,9,10,9,17,36,49,-13,39
Ayr,3023,10,9,10,17,36,58,-22,37
Hibernian,3024,1,20,11,5,55,27,28,71
Falkirk,3024,2,17,10,9,60,40,20,61
Morton,3024,3,16,12,8,52,40,12,60
Dundee Utd,3024,4,17,9,10,51,43,8,60
Queen of S't,3024,5,11,9,16,46,53,-7,42
Dunfermline,3024,6,9,12,15,46,48,-2,39
Raith,3024,7,10,9,17,35,49,-14,39
Ayr,3024,8,9,12,15,34,53,-19,39
Dumbarton,3024,9,8,13,15,51,64,-13,37
St Mirren,3024,10,8,13,15,39,52,-13,37
Hibernian,3025,1,19,14,3,58,23,35,71
Morton,3025,2,17,12,7,54,36,18,63
Dundee Utd,3025,3,15,11,10,55,44,11,56
Falkirk,3025,4,15,10,11,57,41,16,55
Dunfermline,3025,5,12,12,12,53,51,2,48
Queen of S't,3025,6,12,9,15,42,48,-6,45
Raith,3025,7,10,10,16,37,54,-17,40
Dumbarton,3025,8,9,10,17,46,61,-15,37
St Mirren,3025,9,9,10,17,41,58,-17,37
Ayr,3025,10,6,14,16,34,61,-27,32
Hibernian,3026,1,19,12,5,53,26,27,69
Falkirk,3026,2,18,10,8,60,36,24,64
Morton,3026,3,17,11,8,53,40,13,62
Dundee Utd,3026,4,14,11,11,47,42,5,53
Dunfermline,3026,5,11,13,12,49,46,3,46
Queen of S't,3026,6,11,11,14,45,48,-3,44
Ayr,3026,7,9,14,13,36,50,-14,41
Dumbarton,3026,8,8,12,16,45,57,-12,36
St Mirren,3026,9,8,10,18,39,58,-19,34
Raith,3026,10,8,10,18,31,55,-24,34
Hibernian,3027,1,19,12,5,57,32,25,69
Morton,3027,2,18,11,7,65,42,23,65
Falkirk,3027,3,16,10,10,56,40,16,58
Dundee Utd,3027,4,15,8,13,46,41,5,53
Queen of S't,3027,5,11,12,13,48,51,-3,45
Dunfermline,3027,6,10,13,13,50,48,2,43
Dumbarton,3027,7,9,12,15,48,61,-13,39
St Mirren,3027,8,9,11,16,41,56,-15,38
Raith,3027,9,9,11,16,34,52,-18,38
Ayr,3027,10,7,14,15,37,59,-22,35
Hibernian,3028,1,20,10,6,51,25,26,70
Morton,3028,2,16,11,9,52,40,12,59
Falkirk,3028,3,15,11,10,55,45,10,56
Dundee Utd,3028,4,15,10,11,48,42,6,55
Dumbarton,3028,5,11,11,14,56,56,0,44
St Mirren,3028,6,11,11,14,46,54,-8,44
Queen of S't,3028,7,11,8,17,43,51,-8,41
Dunfermline,3028,8,9,13,14,45,48,-3,40
Ayr,3028,9,9,12,15,35,54,-19,39
Raith,3028,10,9,11,16,36,52,-16,38
Hibernian,3029,1,20,12,4,54,22,32,72
Morton,3029,2,19,11,6,55,33,22,68
Falkirk,3029,3,15,12,9,57,41,16,57
Dundee Utd,3029,4,16,9,11,50,41,9,57
Dunfermline,3029,5,10,12,14,46,55,-9,42
Dumbarton,3029,6,10,11,15,47,56,-9,41
Raith,3029,7,10,10,16,34,50,-16,40
Queen of S't,3029,8,10,9,17,44,51,-7,39
Ayr,3029,9,8,13,15,35,56,-21,37
St Mirren,3029,10,8,9,19,37,54,-17,33
Hibernian,3030,1,18,13,5,58,28,30,67
Morton,3030,2,17,11,8,52,42,10,62
Dundee Utd,3030,3,15,12,9,47,38,9,57
Falkirk,3030,4,15,11,10,53,40,13,56
Queen of S't,3030,5,11,11,14,47,52,-5,44
Dunfermline,3030,6,9,13,14,48,53,-5,40
Dumbarton,3030,7,9,13,14,51,58,-7,40
Ayr,3030,8,10,10,16,33,53,-20,40
St Mirren,3030,9,9,12,15,42,50,-8,39
Raith,3030,10,10,8,18,36,53,-17,38
Hibernian,3031,1,22,11,3,66,23,43,77
Dundee Utd,3031,2,16,10,10,55,42,13,58
Morton,3031,3,16,10,10,51,41,10,58
Falkirk,3031,4,15,9,12,61,50,11,54
Dunfermline,3031,5,11,13,12,48,48,0,46
Queen of S't,3031,6,11,9,16,44,55,-11,42
Dumbarton,3031,7,10,11,15,52,58,-6,41
Ayr,3031,8,10,10,16,36,58,-22,40
Raith,3031,9,9,11,16,37,57,-20,38
St Mirren,3031,10,8,10,18,38,56,-18,34
Dundee Utd,3032,1,20,8,8,63,34,29,68
Hibernian,3032,2,16,13,7,49,27,22,61
Falkirk,3032,3,16,10,10,62,47,15,58
Morton,3032,4,15,12,9,47,39,8,57
Dunfermline,3032,5,12,11,13,48,47,1,47
Raith,3032,6,12,9,15,41,47,-6,45
Queen of S't,3032,7,12,9,15,46,55,-9,45
Ayr,3032,8,9,12,15,34,56,-22,39
Dumbarton,3032,9,8,12,16,48,59,-11,36
St Mirren,3032,10,6,12,18,34,61,-27,30
Hibernian,3033,1,19,12,5,56,28,28,69
Dundee Utd,3033,2,17,11,8,51,36,15,62
Morton,3033,3,16,12,8,48,35,13,60
Falkirk,3033,4,16,10,10,58,44,14,58
Queen of S't,3033,5,13,9,14,48,50,-2,48
Raith,3033,6,12,9,15,41,46,-5,45
Dumbarton,3033,7,9,12,15,50,55,-5,39
Dunfermline,3033,8,8,12,16,43,56,-13,36
Ayr,3033,9,8,12,16,30,55,-25,36
St Mirren,3033,10,7,11,18,37,57,-20,32
Hibernian,3034,1,18,14,4,52,23,29,68
Falkirk,3034,2,16,11,9,62,44,18,59
Dundee Utd,3034,3,16,11,9,53,41,12,59
Morton,3034,4,15,11,10,46,42,4,56
Queen of S't,3034,5,11,10,15,47,54,-7,43
Raith,3034,6,11,10,15,35,45,-10,43
Dunfermline,3034,7,9,14,13,55,56,-1,41
St Mirren,3034,8,10,11,15,41,53,-12,41
Dumbarton,3034,9,9,11,16,49,59,-10,38
Ayr,3034,10,7,13,16,30,53,-23,34
Hibernian,3035,1,19,12,5,55,29,26,69
Morton,3035,2,17,11,8,52,38,14,62
Falkirk,3035,3,15,11,10,57,41,16,56
Dundee Utd,3035,4,14,11,11,46,40,6,53
Dunfermline,3035,5,12,12,12,48,46,2,48
Queen of S't,3035,6,13,9,14,43,46,-3,48
Raith,3035,7,12,8,16,33,45,-12,44
St Mirren,3035,8,9,11,16,44,56,-12,38
Dumbarton,3035,9,7,13,16,48,63,-15,34
Ayr,3035,10,6,14,16,30,52,-22,32
Hibernian,3036,1,19,11,6,54,26,28,68
Dundee Utd,3036,2,18,9,9,56,38,18,63
Falkirk,3036,3,15,12,9,53,36,17,57
Morton,3036,4,15,11,10,45,37,8,56
Dunfermline,3036,5,11,12,13,45,45,0,45
Queen of S't,3036,6,12,8,16,43,50,-7,44
St Mirren,3036,7,11,10,15,47,51,-4,43
Raith,3036,8,10,11,15,35,49,-14,41
Ayr,3036,9,8,12,16,32,56,-24,36
Dumbarton,3036,10,7,12,17,45,67,-22,33
Hibernian,3037,1,20,10,6,58,29,29,70
Morton,3037,2,18,11,7,52,36,16,65
Dundee Utd,3037,3,17,10,9,55,41,14,61
Falkirk,3037,4,16,10,10,56,40,16,58
Queen of S't,3037,5,11,10,15,44,51,-7,43
Dunfermline,3037,6,10,12,14,47,48,-1,42
Dumbarton,3037,7,9,12,15,48,56,-8,39
Raith,3037,8,9,10,17,33,49,-16,37
Ayr,3037,9,8,12,16,35,63,-28,36
St Mirren,3037,10,8,11,17,38,53,-15,35
Hibernian,3038,1,18,13,5,51,23,28,67
Morton,3038,2,18,11,7,50,34,16,65
Falkirk,3038,3,18,9,9,59,37,22,63
Dundee Utd,3038,4,15,10,11,48,38,10,55
Dunfermline,3038,5,12,13,11,45,42,3,49
Queen of S't,3038,6,10,10,16,44,52,-8,40
St Mirren,3038,7,10,9,17,37,54,-17,39
Dumbarton,3038,8,9,10,17,44,60,-16,37
Ayr,3038,9,8,13,15,34,53,-19,37
Raith,3038,10,8,10,18,30,49,-19,34
Hibernian,3039,1,17,15,4,54,25,29,66
Dundee Utd,3039,2,16,10,10,46,38,8,58
Morton,3039,3,14,14,8,46,37,9,56
Falkirk,3039,4,14,13,9,55,42,13,55
Dunfermline,3039,5,10,14,12,48,48,0,44
Ayr,3039,6,10,13,13,36,50,-14,43
Dumbarton,3039,7,9,14,13,47,52,-5,41
Queen of S't,3039,8,11,8,17,43,50,-7,41
Raith,3039,9,9,11,16,33,51,-18,38
St Mirren,3039,10,8,12,16,36,51,-15,36
Hibernian,3040,1,19,13,4,56,23,33,70
Morton,3040,2,18,10,8,54,41,13,64
Falkirk,3040,3,15,13,8,60,44,16,58
Dundee Utd,3040,4,16,9,11,50,41,9,57
Dunfermline,3040,5,11,12,13,46,46,0,45
Queen of S't,3040,6,12,9,15,44,50,-6,45
Raith,3040,7,10,9,17,37,53,-16,39
St Mirren,3040,8,9,10,17,44,58,-14,37
Dumbarton,3040,9,8,12,16,48,63,-15,36
Ayr,3040,10,8,11,17,37,57,-20,35
Hibernian,3041,1,19,11,6,54,26,28,68
Morton,3041,2,17,11,8,49,37,12,62
Dundee Utd,3041,3,17,9,10,50,39,11,60
Falkirk,3041,4,14,11,11,58,43,15,53
Queen of S't,3041,5,12,9,15,43,49,-6,45
Raith,3041,6,11,12,13,40,48,-8,45
Dunfermline,3041,7,10,12,14,46,49,-3,42
Ayr,3041,8,9,13,14,35,52,-17,40
Dumbarton,3041,9,8,12,16,44,58,-14,36
St Mirren,3041,10,7,12,17,42,60,-18,33
Hibernian,3042,1,17,14,5,55,29,26,65
Morton,3042,2,16,13,7,48,34,14,61
Falkirk,3042,3,16,12,8,59,41,18,60
Dundee Utd,3042,4,16,11,9,55,38,17,59
Queen of S't,3042,5,12,9,15,45,51,-6,45
Dumbarton,3042,6,10,12,14,52,55,-3,42
Raith,3042,7,9,13,14,36,47,-11,40
Dunfermline,3042,8,8,14,14,47,54,-7,38
Ayr,3042,9,8,12,16,34,57,-23,36
St Mirren,3042,10,7,12,17,36,61,-25,33
Hibernian,3043,1,18,13,5,55,28,27,67
Morton,3043,2,16,12,8,46,35,11,60
Dundee Utd,3043,3,17,8,11,55,38,17,59
Falkirk,3043,4,15,10,11,53,40,13,55
Queen of S't,3043,5,13,9,14,46,49,-3,48
Dunfermline,3043,6,12,11,13,46,44,2,47
Raith,3043,7,12,10,14,37,45,-8,46
St Mirren,3043,8,10,9,17,42,52,-10,39
Dumbarton,3043,9,7,12,17,42,65,-23,33
Ayr,3043,10,7,12,17,34,60,-26,33
Hibernian,3044,1,18,14,4,56,28,28,68
Dundee Utd,3044,2,16,10,10,55,41,14,58
Morton,3044,3,15,12,9,48,37,11,57
Falkirk,3044,4,14,11,11,55,43,12,53
Dumbarton,3044,5,13,11,12,57,54,3,50
Dunfermline,3044,6,11,13,12,44,46,-2,46
Raith,3044,7,12,9,15,39,49,-10,45
Queen of S't,3044,8,11,10,15,46,50,-4,43
St Mirren,3044,9,7,11,18,39,60,-21,32
Ayr,3044,10,7,11,18,32,63,-31,32
Hibernian,3045,1,20,12,4,59,28,31,72
Morton,3045,2,17,11,8,55,37,18,62
Dundee Utd,3045,3,16,9,11,53,41,12,57
Falkirk,3045,4,14,12,10,54,44,10,54
Queen of S't,3045,5,11,11,14,44,51,-7,44
Raith,3045,6,11,9,16,35,48,-13,42
Dunfermline,3045,7,9,13,14,45,49,-4,40
Dumbarton,3045,8,9,11,16,46,58,-12,38
St Mirren,3045,9,8,14,14,40,52,-12,38
Ayr,3045,10,8,12,16,37,60,-23,36
Hibernian,3046,1,20,11,5,60,25,35,71
Falkirk,3046,2,18,9,9,64,42,22,63
Morton,3046,3,16,12,8,48,37,11,60
Dundee Utd,3046,4,16,11,9,50,35,15,59
Queen of S't,3046,5,13,9,14,43,48,-5,48
Raith,3046,6,10,10,16,36,50,-14,40
Dunfermline,3046,7,9,11,16,43,50,-7,38
St Mirren,3046,8,9,11,16,41,59,-18,38
Ayr,3046,9,8,11,17,32,57,-25,35
Dumbarton,3046,10,7,13,16,48,62,-14,34
Hibernian,3047,1,21,12,3,62,27,35,75
Morton,3047,2,17,11,8,56,39,17,62
Falkirk,3047,3,14,12,10,52,39,13,54
Dundee Utd,3047,4,13,13,10,46,40,6,52
Dunfermline,3047,5,10,15,11,46,47,-1,45
Queen of S't,3047,6,11,12,13,43,47,-4,45
Dumbarton,3047,7,9,11,16,46,57,-11,38
Ayr,3047,8,8,13,15,37,58,-21,37
Raith,3047,9,8,12,16,32,51,-19,36
St Mirren,3047,10,7,13,16,42,57,-15,34
Hibernian,3048,1,19,11,6,54,27,27,68
Falkirk,3048,2,19,10,7,60,34,26,67
Morton,3048,3,16,12,8,49,39,10,60
Dundee Utd,3048,4,14,13,9,50,42,8,55
Dunfermline,3048,5,11,12,13,48,49,-1,45
Queen of S't,3048,6,11,11,14,45,48,-3,44
Dumbarton,3048,7,8,15,13,49,59,-10,39
Raith,3048,8,9,10,17,32,51,-19,37
Ayr,3048,9,7,13,16,34,56,-22,34
St Mirren,3048,10,8,9,19,39,55,-16,33
Hibernian,3049,1,20,12,4,59,27,32,72
Dundee Utd,3049,2,17,11,8,54,39,15,62
Morton,3049,3,16,12,8,47,34,13,60
Falkirk,3049,4,15,10,11,53,40,13,55
Dumbarton,3049,5,11,11,14,48,53,-5,44
Raith,3049,6,11,11,14,39,47,-8,44
Queen of S't,3049,7,10,11,15,45,53,-8,41
Dunfermline,3049,8,8,13,15,41,51,-10,37
Ayr,3049,9,7,13,16,33,57,-24,34
St Mirren,3049,10,7,12,17,40,58,-18,33
Morton,3050,1,20,10,6,55,34,21,70
Hibernian,3050,2,19,11,6,53,26,27,68
Dundee Utd,3050,3,17,9,10,56,42,14,60
Falkirk,3050,4,14,11,11,55,43,12,53
Dunfermline,3050,5,11,13,12,47,47,0,46
Queen of S't,3050,6,10,10,16,45,52,-7,40
Raith,3050,7,10,10,16,35,51,-16,40
Ayr,3050,8,9,11,16,35,54,-19,38
Dumbarton,3050,9,8,13,15,51,62,-11,37
St Mirren,3050,10,8,10,18,39,60,-21,34
Hibernian,3051,1,19,13,4,59,25,34,70
Morton,3051,2,17,12,7,54,35,19,63
Falkirk,3051,3,17,10,9,60,43,17,61
Dundee Utd,3051,4,15,11,10,54,39,15,56
Dunfermline,3051,5,11,13,12,51,49,2,46
Queen of S't,3051,6,11,8,17,41,49,-8,41
Raith,3051,7,10,10,16,35,49,-14,40
Dumbarton,3051,8,9,11,16,46,58,-12,38
St Mirren,3051,9,9,9,18,42,68,-26,36
Ayr,3051,10,7,13,16,31,58,-27,34
Hibernian,3052,1,19,12,5,56,28,28,69
Falkirk,3052,2,17,9,10,58,40,18,60
Dundee Utd,3052,3,16,10,10,54,41,13,58
Morton,3052,4,14,13,9,50,42,8,55
Dunfermline,3052,5,12,12,12,49,46,3,48
Queen of S't,3052,6,10,11,15,44,54,-10,41
Raith,3052,7,10,11,15,34,47,-13,41
Dumbarton,3052,8,9,12,15,50,59,-9,39
Ayr,3052,9,8,14,14,34,54,-20,38
St Mirren,3052,10,7,12,17,38,56,-18,33
Hibernian,3053,1,20,12,4,60,31,29,72
Morton,3053,2,17,12,7,48,32,16,63
Falkirk,3053,3,16,12,8,63,43,20,60
Dundee Utd,3053,4,16,10,10,53,44,9,58
Queen of S't,3053,5,11,11,14,47,51,-4,44
Raith,3053,6,10,12,14,37,46,-9,42
Dumbarton,3053,7,8,14,14,48,57,-9,38
Ayr,3053,8,8,12,16,38,57,-19,36
Dunfermline,3053,9,7,13,16,45,56,-11,34
St Mirren,3053,10,8,10,18,37,59,-22,34
Hibernian,3054,1,18,13,5,56,26,30,67
Morton,3054,2,19,10,7,57,42,15,67
Falkirk,3054,3,16,13,7,59,36,23,61
Dundee Utd,3054,4,16,9,11,49,40,9,57
Queen of S't,3054,5,13,11,12,45,43,2,50
Dunfermline,3054,6,9,12,15,49,56,-7,39
Raith,3054,7,10,9,17,40,54,-14,39
Ayr,3054,8,8,13,15,38,56,-18,37
St Mirren,3054,9,8,11,17,35,56,-21,35
Dumbarton,3054,10,7,11,18,44,63,-19,32
Hibernian,3055,1,20,10,6,59,29,30,70
Morton,3055,2,18,10,8,54,38,16,64
Dundee Utd,3055,3,16,10,10,50,38,12,58
Falkirk,3055,4,15,10,11,55,46,9,55
Dunfermline,3055,5,10,13,13,45,49,-4,43
Queen of S't,3055,6,11,10,15,43,48,-5,43
Dumbarton,3055,7,10,12,14,53,60,-7,42
Ayr,3055,8,8,14,14,37,56,-19,38
St Mirren,3055,9,9,10,17,44,59,-15,37
Raith,3055,10,9,9,18,35,52,-17,36
Morton,3056,1,19,11,6,56,32,24,68
Hibernian,3056,2,18,13,5,51,25,26,67
Falkirk,3056,3,16,10,10,56,43,13,58
Dundee Utd,3056,4,16,9,11,54,43,11,57
Queen of S't,3056,5,13,8,15,44,46,-2,47
Dunfermline,3056,6,10,12,14,44,49,-5,42
Raith,3056,7,10,10,16,38,50,-12,40
Ayr,3056,8,8,14,14,36,60,-24,38
Dumbarton,3056,9,7,13,16,47,61,-14,34
St Mirren,3056,10,8,10,18,44,61,-17,34
Hibernian,3057,1,17,15,4,50,22,28,66
Morton,3057,2,17,12,7,52,36,16,63
Falkirk,3057,3,17,11,8,56,36,20,62
Dundee Utd,3057,4,16,8,12,47,38,9,56
Queen of S't,3057,5,13,11,12,45,45,0,50
Raith,3057,6,10,9,17,34,48,-14,39
Ayr,3057,7,9,12,15,36,58,-22,39
Dunfermline,3057,8,8,12,16,41,50,-9,36
Dumbarton,3057,9,8,12,16,45,59,-14,36
St Mirren,3057,10,8,12,16,40,54,-14,36
Hibernian,3058,1,19,10,7,56,29,27,67
Morton,3058,2,17,11,8,55,42,13,62
Falkirk,3058,3,16,11,9,57,39,18,59
Dundee Utd,3058,4,16,10,10,51,38,13,58
Raith,3058,5,14,8,14,39,43,-4,50
Queen of S't,3058,6,11,9,16,41,51,-10,42
Dunfermline,3058,7,9,14,13,48,50,-2,41
Dumbarton,3058,8,8,13,15,53,64,-11,37
Ayr,3058,9,8,12,16,33,60,-27,36
St Mirren,3058,10,8,10,18,40,57,-17,34
Hibernian,3059,1,21,10,5,55,24,31,73
Morton,3059,2,16,12,8,48,36,12,60
Dundee Utd,3059,3,16,9,11,51,39,12,57
Falkirk,3059,4,14,9,13,53,44,9,51
Queen of S't,3059,5,14,9,13,50,47,3,51
Ayr,3059,6,10,13,13,36,51,-15,43
Dunfermline,3059,7,9,14,13,45,48,-3,41
Raith,3059,8,10,10,16,35,52,-17,40
Dumbarton,3059,9,9,11,16,47,61,-14,38
St Mirren,3059,10,7,11,18,39,57,-18,32
Hibernian,3060,1,18,11,7,56,30,26,65
Falkirk,3060,2,17,9,10,58,42,16,60
Morton,3060,3,16,10,10,48,40,8,58
Dundee Utd,3060,4,16,9,11,46,36,10,57
Dunfermline,3060,5,13,12,11,50,44,6,51
Queen of S't,3060,6,14,8,14,47,52,-5,50
Raith,3060,7,10,10,16,39,49,-10,40
Ayr,3060,8,9,12,15,37,58,-21,39
Dumbarton,3060,9,9,11,16,52,60,-8,38
St Mirren,3060,10,6,12,18,38,60,-22,30
Hibernian,3061,1,19,10,7,54,32,22,67
Falkirk,3061,2,19,9,8,60,35,25,66
Morton,3061,3,17,10,9,52,40,12,61
Dundee Utd,3061,4,16,9,11,49,39,10,57
Queen of S't,3061,5,12,10,14,51,53,-2,46
Dunfermline,3061,6,9,14,13,45,50,-5,41
St Mirren,3061,7,10,9,17,44,54,-10,39
Dumbarton,3061,8,9,12,15,48,59,-11,39
Raith,3061,9,10,8,18,33,52,-19,38
Ayr,3061,10,7,13,16,33,55,-22,34
Hibernian,3062,1,20,12,4,60,27,33,72
Dundee Utd,3062,2,17,9,10,53,40,13,60
Morton,3062,3,16,10,10,53,44,9,58
Falkirk,3062,4,15,11,10,57,40,17,56
Dunfermline,3062,5,11,13,12,50,48,2,46
Queen of S't,3062,6,10,12,14,43,48,-5,42
Dumbarton,3062,7,10,12,14,47,58,-11,42
Raith,3062,8,9,10,17,32,49,-17,37
St Mirren,3062,9,8,12,16,39,55,-16,36
Ayr,3062,10,7,13,16,33,58,-25,34
Hibernian,3063,1,21,12,3,53,20,33,75
Falkirk,3063,2,18,9,9,59,38,21,63
Dundee Utd,3063,3,16,10,10,51,39,12,58
Morton,3063,4,15,12,9,45,37,8,57
Dunfermline,3063,5,10,12,14,44,51,-7,42
Dumbarton,3063,6,9,13,14,49,56,-7,40
Queen of S't,3063,7,10,9,17,42,53,-11,39
Raith,3063,8,10,9,17,36,49,-13,39
Ayr,3063,9,8,14,14,32,52,-20,38
St Mirren,3063,10,8,10,18,39,55,-16,34
Hibernian,3064,1,20,11,5,55,26,29,71
Morton,3064,2,18,11,7,56,37,19,65
Falkirk,3064,3,17,11,8,63,39,24,62
Dundee Utd,3064,4,15,11,10,50,41,9,56
Queen of S't,3064,5,11,13,12,47,50,-3,46
St Mirren,3064,6,11,9,16,44,59,-15,42
Dumbarton,3064,7,9,10,17,45,59,-14,37
Dunfermline,3064,8,7,15,14,44,52,-8,36
Raith,3064,9,8,11,17,32,48,-16,35
Ayr,3064,10,7,12,17,34,59,-25,33
Hibernian,3065,1,19,10,7,51,28,23,67
Morton,3065,2,18,9,9,55,35,20,63
Dundee Utd,3065,3,16,10,10,51,38,13,58
Falkirk,3065,4,15,9,12,55,42,13,54
Queen of S't,3065,5,13,9,14,46,52,-6,48
Dunfermline,3065,6,12,11,13,48,48,0,47
Dumbarton,3065,7,11,12,13,52,54,-2,45
Raith,3065,8,11,8,17,40,54,-14,41
Ayr,3065,9,9,11,16,33,59,-26,38
St Mirren,3065,10,7,9,20,36,57,-21,30
Hibernian,3066,1,19,11,6,56,27,29,68
Morton,3066,2,16,10,10,48,39,9,58
Falkirk,3066,3,15,11,10,60,45,15,56
Dundee Utd,3066,4,14,11,11,50,41,9,53
Dunfermline,3066,5,12,13,11,50,49,1,49
Ayr,3066,6,11,11,14,40,55,-15,44
St Mirren,3066,7,11,10,15,46,56,-10,43
Queen of S't,3066,8,10,11,15,45,54,-9,41
Dumbarton,3066,9,9,12,15,50,57,-7,39
Raith,3066,10,8,10,18,29,51,-22,34
Hibernian,3067,1,21,11,4,60,26,34,74
Morton,3067,2,17,11,8,47,35,12,62
Falkirk,3067,3,15,10,11,61,42,19,55
Dundee Utd,3067,4,15,10,11,50,45,5,55
Dunfermline,3067,5,11,13,12,47,44,3,46
Queen of S't,3067,6,12,9,15,43,50,-7,45
Raith,3067,7,10,9,17,37,51,-14,39
Dumbarton,3067,8,9,12,15,48,63,-15,39
Ayr,3067,9,8,12,16,35,58,-23,36
St Mirren,3067,10,8,11,17,47,61,-14,35
Morton,3068,1,20,10,6,61,39,22,70
Hibernian,3068,2,17,12,7,54,29,25,63
Dundee Utd,3068,3,18,8,10,55,41,14,62
Falkirk,3068,4,17,10,9,61,40,21,61
Queen of S't,3068,5,13,8,15,48,51,-3,47
Dunfermline,3068,6,10,12,14,46,52,-6,42
Raith,3068,7,10,8,18,32,48,-16,38
Ayr,3068,8,8,12,16,37,59,-22,36
Dumbarton,3068,9,8,11,17,48,61,-13,35
St Mirren,3068,10,8,11,17,40,62,-22,35
Hibernian,3069,1,21,12,3,62,24,38,75
Morton,3069,2,17,12,7,53,35,18,63
Dundee Utd,3069,3,18,8,10,55,38,17,62
Falkirk,3069,4,16,9,11,55,41,14,57
Queen of S't,3069,5,12,9,15,43,50,-7,45
Dunfermline,3069,6,9,13,14,43,51,-8,40
Dumbarton,3069,7,9,12,15,46,58,-12,39
Raith,3069,8,9,12,15,32,45,-13,39
Ayr,3069,9,7,12,17,34,59,-25,33
St Mirren,3069,10,7,11,18,38,60,-22,32
Hibernian,3070,1,19,13,4,56,25,31,70
Dundee Utd,3070,2,20,8,8,56,36,20,68
Falkirk,3070,3,16,10,10,58,41,17,58
Morton,3070,4,16,10,10,44,42,2,58
Dunfermline,3070,5,11,12,13,47,47,0,45
Raith,3070,6,11,9,16,36,45,-9,42
Ayr,3070,7,9,12,15,40,53,-13,39
Dumbarton,3070,8,9,11,16,47,61,-14,38
Queen of S't,3070,9,9,10,17,42,55,-13,37
St Mirren,3070,10,8,9,19,41,62,-21,33
Hibernian,3071,1,18,13,5,55,30,25,67
Morton,3071,2,17,11,8,55,38,17,62
Dundee Utd,3071,3,17,9,10,55,40,15,60
Falkirk,3071,4,16,9,11,58,42,16,57
Dumbarton,3071,5,11,12,13,51,55,-4,45
Dunfermline,3071,6,11,11,14,48,50,-2,44
Queen of S't,3071,7,11,10,15,44,49,-5,43
Raith,3071,8,11,9,16,31,43,-12,42
Ayr,3071,9,8,12,16,33,57,-24,36
St Mirren,3071,10,7,10,19,36,62,-26,31
Hibernian,3072,1,20,12,4,60,29,31,72
Dundee Utd,3072,2,17,10,9,55,40,15,61
Morton,3072,3,16,12,8,50,36,14,60
Falkirk,3072,4,16,10,10,56,42,14,58
Dunfermline,3072,5,8,16,12,41,44,-3,40
Dumbarton,3072,6,8,15,13,50,57,-7,39
Queen of S't,3072,7,9,12,15,41,50,-9,39
St Mirren,3072,8,9,11,16,45,57,-12,38
Raith,3072,9,9,11,16,32,49,-17,38
Ayr,3072,10,6,15,15,34,60,-26,33
Hibernian,3073,1,18,14,4,54,23,31,68
Morton,3073,2,18,11,7,55,38,17,65
Falkirk,3073,3,15,12,9,53,38,15,57
Dundee Utd,3073,4,16,9,11,48,40,8,57
Queen of S't,3073,5,12,11,13,42,45,-3,47
Raith,3073,6,12,8,16,38,46,-8,44
Dumbarton,3073,7,9,13,14,52,59,-7,40
Dunfermline,3073,8,8,14,14,41,50,-9,38
St Mirren,3073,9,8,10,18,39,60,-21,34
Ayr,3073,10,8,10,18,32,55,-23,34
Hibernian,3074,1,19,11,6,57,28,29,68
Dundee Utd,3074,2,17,10,9,50,37,13,61
Morton,3074,3,16,12,8,43,31,12,60
Falkirk,3074,4,16,10,10,60,41,19,58
Dunfermline,3074,5,11,12,13,48,48,0,45
Raith,3074,6,11,10,15,38,47,-9,43
Queen of S't,3074,7,11,9,16,44,54,-10,42
Ayr,3074,8,8,13,15,33,53,-20,37
St Mirren,3074,9,8,12,16,40,58,-18,36
Dumbarton,3074,10,7,13,16,46,62,-16,34
Hibernian,3075,1,18,13,5,56,26,30,67
Dundee Utd,3075,2,17,10,9,60,42,18,61
Falkirk,3075,3,16,11,9,58,43,15,59
Morton,3075,4,13,12,11,43,41,2,51
Queen of S't,3075,5,12,9,15,42,51,-9,45
St Mirren,3075,6,11,10,15,43,52,-9,43
Dunfermline,3075,7,10,12,14,45,49,-4,42
Dumbarton,3075,8,10,11,15,52,62,-10,41
Ayr,3075,9,10,11,15,40,56,-16,41
Raith,3075,10,8,11,17,34,51,-17,35
Morton,3076,1,20,10,6,56,33,23,70
Hibernian,3076,2,19,11,6,59,28,31,68
Falkirk,3076,3,16,11,9,56,39,17,59
Dundee Utd,3076,4,16,8,12,52,45,7,56
Dunfermline,3076,5,12,11,13,48,45,3,47
Queen of S't,3076,6,12,10,14,46,47,-1,46
Raith,3076,7,9,11,16,37,51,-14,38
Ayr,3076,8,9,10,17,37,60,-23,37
Dumbarton,3076,9,8,10,18,44,65,-21,34
St Mirren,3076,10,8,10,18,39,61,-22,34
Hibernian,3077,1,19,12,5,61,26,35,69
Morton,3077,2,17,13,6,52,39,13,64
Falkirk,3077,3,15,12,9,56,40,16,57
Dundee Utd,3077,4,15,10,11,50,41,9,55
Queen of S't,3077,5,12,9,15,43,49,-6,45
Raith,3077,6,11,10,15,40,53,-13,43
Ayr,3077,7,10,11,15,35,53,-18,41
Dunfermline,3077,8,8,14,14,43,48,-5,38
Dumbarton,3077,9,8,13,15,43,54,-11,37
St Mirren,3077,10,8,10,18,40,60,-20,34
Hibernian,3078,1,16,15,5,55,30,25,63
Dundee Utd,3078,2,16,10,10,57,41,16,58
Morton,3078,3,15,12,9,51,44,7,57
Falkirk,3078,4,15,11,10,57,43,14,56
Queen of S't,3078,5,11,11,14,45,49,-4,44
Dunfermline,3078,6,9,16,11,48,50,-2,43
Raith,3078,7,10,13,13,35,44,-9,43
St Mirren,3078,8,10,11,15,41,54,-13,41
Dumbarton,3078,9,9,12,15,47,58,-11,39
Ayr,3078,10,8,11,17,37,60,-23,35
Hibernian,3079,1,19,10,7,60,30,30,67
Falkirk,3079,2,16,10,10,59,45,14,58
Dundee Utd,3079,3,16,10,10,52,38,14,58
Morton,3079,4,14,13,9,43,39,4,55
Queen of S't,3079,5,13,10,13,47,50,-3,49
Dunfermline,3079,6,11,14,11,48,43,5,47
St Mirren,3079,7,10,11,15,43,52,-9,41
Raith,3079,8,9,10,17,35,52,-17,37
Ayr,3079,9,8,13,15,33,52,-19,37
Dumbarton,3079,10,8,11,17,45,64,-19,35
Hibernian,3080,1,19,13,4,57,22,35,70
Morton,3080,2,19,11,6,54,35,19,68
Dundee Utd,3080,3,16,11,9,53,40,13,59
Falkirk,3080,4,15,13,8,55,39,16,58
Queen of S't,3080,5,11,11,14,47,51,-4,44
Raith,3080,6,10,10,16,34,48,-14,40
Dumbarton,3080,7,9,11,16,49,63,-14,38
Dunfermline,3080,8,8,13,15,45,54,-9,37
St Mirren,3080,9,7,13,16,40,54,-14,34
Ayr,3080,10,8,10,18,32,60,-28,34
Morton,3081,1,20,10,6,58,34,24,70
Hibernian,3081,2,19,12,5,58,28,30,69
Falkirk,3081,3,17,9,10,61,44,17,60
Dundee Utd,3081,4,14,9,13,52,49,3,51
Queen of S't,3081,5,11,9,16,42,52,-10,42
Dunfermline,3081,6,10,11,15,48,52,-4,41
Raith,3081,7,11,8,17,33,49,-16,41
Dumbarton,3081,8,10,10,16,53,64,-11,40
Ayr,3081,9,10,10,16,38,56,-18,40
St Mirren,3081,10,9,10,17,40,55,-15,37
Hibernian,3082,1,20,12,4,61,28,33,72
Morton,3082,2,19,10,7,52,35,17,67
Falkirk,3082,3,16,10,10,61,42,19,58
Dundee Utd,3082,4,15,10,11,48,42,6,55
Queen of S't,3082,5,11,10,15,45,51,-6,43
Dunfermline,3082,6,9,13,14,46,50,-4,40
Raith,3082,7,10,10,16,38,51,-13,40
Ayr,3082,8,9,13,14,40,55,-15,40
Dumbarton,3082,9,9,11,16,48,61,-13,38
St Mirren,3082,10,7,11,18,40,64,-24,32
Hibernian,3083,1,19,13,4,54,25,29,70
Dundee Utd,3083,2,18,8,10,54,39,15,62
Morton,3083,3,16,11,9,47,35,12,59
Falkirk,3083,4,15,12,9,58,40,18,57
Queen of S't,3083,5,12,9,15,42,48,-6,45
Dunfermline,3083,6,10,12,14,49,52,-3,42
St Mirren,3083,7,10,9,17,42,54,-12,39
Dumbarton,3083,8,9,12,15,46,59,-13,39
Raith,3083,9,9,11,16,33,49,-16,38
Ayr,3083,10,7,13,16,34,58,-24,34
Hibernian,3084,1,17,14,5,56,29,27,65
Morton,3084,2,18,11,7,51,34,17,65
Falkirk,3084,3,15,13,8,63,43,20,58
Dundee Utd,3084,4,14,11,11,49,48,1,53
Queen of S't,3084,5,11,10,15,46,54,-8,43
Raith,3084,6,11,10,15,36,48,-12,43
Dumbarton,3084,7,10,11,15,47,56,-9,41
St Mirren,3084,8,9,12,15,42,57,-15,39
Dunfermline,3084,9,7,16,13,41,47,-6,37
Ayr,3084,10,9,10,17,40,55,-15,37
Hibernian,3085,1,19,12,5,55,26,29,69
Falkirk,3085,2,17,9,10,61,42,19,60
Dundee Utd,3085,3,15,11,10,45,37,8,56
Morton,3085,4,14,12,10,43,34,9,54
Queen of S't,3085,5,14,9,13,45,46,-1,51
Dumbarton,3085,6,12,10,14,48,51,-3,46
Raith,3085,7,10,11,15,34,48,-14,41
Dunfermline,3085,8,9,12,15,45,53,-8,39
Ayr,3085,9,8,13,15,34,53,-19,37
St Mirren,3085,10,6,13,17,35,55,-20,31
Hibernian,3086,1,18,14,4,53,24,29,68
Falkirk,3086,2,17,10,9,59,38,21,61
Morton,3086,3,15,14,7,47,33,14,59
Dundee Utd,3086,4,15,11,10,52,44,8,56
Dunfermline,3086,5,10,13,13,47,51,-4,43
Queen of S't,3086,6,10,11,15,44,51,-7,41
Dumbarton,3086,7,8,15,13,45,53,-8,39
Ayr,3086,8,9,12,15,33,52,-19,39
St Mirren,3086,9,9,11,16,39,55,-16,38
Raith,3086,10,9,9,18,33,51,-18,36
Hibernian,3087,1,17,14,5,50,26,24,65
Falkirk,3087,2,17,11,8,56,37,19,62
Morton,3087,3,15,12,9,52,42,10,57
Dundee Utd,3087,4,16,9,11,50,44,6,57
Queen of S't,3087,5,13,10,13,50,44,6,49
Raith,3087,6,13,8,15,45,45,0,47
Dunfermline,3087,7,9,13,14,42,52,-10,40
Ayr,3087,8,9,12,15,33,53,-20,39
Dumbarton,3087,9,9,10,17,45,59,-14,37
St Mirren,3087,10,7,11,18,40,61,-21,32
Hibernian,3088,1,18,11,7,54,29,25,65
Morton,3088,2,18,11,7,53,37,16,65
Falkirk,3088,3,17,10,9,59,42,17,61
Dundee Utd,3088,4,16,9,11,57,43,14,57
Queen of S't,3088,5,12,10,14,49,50,-1,46
Dunfermline,3088,6,9,15,12,45,51,-6,42
St Mirren,3088,7,10,10,16,43,58,-15,40
Raith,3088,8,9,11,16,35,50,-15,38
Ayr,3088,9,8,12,16,36,58,-22,36
Dumbarton,3088,10,8,11,17,48,61,-13,35
Hibernian,3089,1,19,13,4,56,24,32,70
Falkirk,3089,2,17,10,9,58,40,18,61
Dundee Utd,3089,3,16,11,9,51,41,10,59
Morton,3089,4,13,12,11,47,46,1,51
Dunfermline,3089,5,10,14,12,51,51,0,44
Raith,3089,6,11,9,16,33,48,-15,42
Queen of S't,3089,7,10,11,15,46,52,-6,41
Ayr,3089,8,9,13,14,37,54,-17,40
Dumbarton,3089,9,9,12,15,54,63,-9,39
St Mirren,3089,10,8,11,17,42,56,-14,35
Hibernian,3090,1,22,11,3,55,21,34,77
Falkirk,3090,2,17,11,8,57,34,23,62
Morton,3090,3,14,13,9,40,34,6,55
Dundee Utd,3090,4,12,12,12,44,43,1,48
Dunfermline,3090,5,11,12,13,48,48,0,45
St Mirren,3090,6,10,11,15,45,54,-9,41
Dumbarton,3090,7,9,13,14,48,56,-8,40
Queen of S't,3090,8,10,10,16,44,55,-11,40
Raith,3090,9,9,11,16,32,47,-15,38
Ayr,3090,10,7,14,15,33,54,-21,35
Hibernian,3091,1,20,11,5,57,25,32,71
Falkirk,3091,2,17,12,7,58,34,24,63
Dundee Utd,3091,3,15,13,8,54,37,17,58
Morton,3091,4,14,12,10,48,44,4,54
Dunfermline,3091,5,10,14,12,49,48,1,44
Raith,3091,6,11,9,16,39,51,-12,42
Dumbarton,3091,7,9,13,14,49,60,-11,40
Queen of S't,3091,8,10,9,17,41,56,-15,39
St Mirren,3091,9,9,10,17,40,55,-15,37
Ayr,3091,10,7,13,16,32,57,-25,34
Hibernian,3092,1,19,14,3,57,26,31,71
Falkirk,3092,2,16,12,8,61,41,20,60
Dundee Utd,3092,3,15,11,10,48,36,12,56
Morton,3092,4,14,14,8,45,36,9,56
Queen of S't,3092,5,11,11,14,43,49,-6,44
Dumbarton,3092,6,10,11,15,47,55,-8,41
St Mirren,3092,7,10,11,15,44,52,-8,41
Raith,3092,8,10,10,16,35,48,-13,40
Dunfermline,3092,9,8,13,15,42,54,-12,37
Ayr,3092,10,8,11,17,31,56,-25,35
Hibernian,3093,1,19,13,4,60,28,32,70
Morton,3093,2,17,12,7,53,35,18,63
Falkirk,3093,3,16,13,7,60,39,21,61
Dundee Utd,3093,4,15,12,9,58,43,15,57
Queen of S't,3093,5,12,9,15,46,59,-13,45
Dunfermline,3093,6,9,14,13,53,55,-2,41
Raith,3093,7,10,11,15,40,50,-10,41
St Mirren,3093,8,8,11,17,38,61,-23,35
Ayr,3093,9,7,13,16,33,53,-20,34
Dumbarton,3093,10,7,12,17,47,65,-18,33
Hibernian,3094,1,22,11,3,58,23,35,77
Falkirk,3094,2,17,10,9,61,40,21,61
Morton,3094,3,15,13,8,47,39,8,58
Dundee Utd,3094,4,16,9,11,52,42,10,57
Dunfermline,3094,5,11,11,14,50,51,-1,44
Queen of S't,3094,6,11,11,14,42,48,-6,44
Dumbarton,3094,7,9,12,15,50,58,-8,39
Ayr,3094,8,8,12,16,34,57,-23,36
St Mirren,3094,9,8,11,17,39,56,-17,35
Raith,3094,10,8,10,18,36,55,-19,34
Hibernian,3095,1,19,12,5,52,25,27,69
Morton,3095,2,18,10,8,54,36,18,64
Falkirk,3095,3,15,12,9,61,39,22,57
Dundee Utd,3095,4,15,10,11,46,43,3,55
Queen of S't,3095,5,13,10,13,47,45,2,49
Dunfermline,3095,6,11,13,12,44,46,-2,46
Raith,3095,7,10,10,16,36,51,-15,40
St Mirren,3095,8,9,9,18,38,56,-18,36
Dumbarton,3095,9,8,11,17,43,60,-17,35
Ayr,3095,10,7,13,16,33,53,-20,34
Hibernian,3096,1,19,10,7,52,26,26,67
Dundee Utd,3096,2,19,9,8,57,34,23,66
Morton,3096,3,17,9,10,53,36,17,60
Falkirk,3096,4,15,11,10,60,45,15,56
Raith,3096,5,14,8,14,38,46,-8,50
Ayr,3096,6,11,10,15,41,54,-13,43
Dunfermline,3096,7,10,12,14,45,51,-6,42
Dumbarton,3096,8,10,10,16,45,58,-13,40
Queen of S't,3096,9,9,9,18,41,57,-16,36
St Mirren,3096,10,7,10,19,34,59,-25,31
Hibernian,3097,1,19,12,5,53,27,26,69
Falkirk,3097,2,16,12,8,61,41,20,60
Morton,3097,3,16,12,8,50,37,13,60
Dundee Utd,3097,4,16,11,9,52,40,12,59
Dunfermline,3097,5,10,13,13,51,50,1,43
Queen of S't,3097,6,11,10,15,45,52,-7,43
Raith,3097,7,10,9,17,32,48,-16,39
Dumbarton,3097,8,9,11,16,49,61,-12,38
Ayr,3097,9,8,13,15,33,53,-20,37
St Mirren,3097,10,8,11,17,41,58,-17,35
Hibernian,3098,1,18,13,5,51,25,26,67
Dundee Utd,3098,2,17,10,9,56,38,18,61
Morton,3098,3,15,14,7,48,36,12,59
Falkirk,3098,4,16,10,10,58,37,21,58
Queen of S't,3098,5,13,8,15,48,50,-2,47
Raith,3098,6,12,9,15,38,49,-11,45
St Mirren,3098,7,9,11,16,41,56,-15,38
Dumbarton,3098,8,9,11,16,44,62,-18,38
Ayr,3098,9,9,10,17,35,54,-19,37
Dunfermline,3098,10,8,12,16,41,53,-12,36
Morton,3099,1,20,10,6,53,31,22,70
Hibernian,3099,2,18,11,7,54,28,26,65
Falkirk,3099,3,18,9,9,64,42,22,63
Dundee Utd,3099,4,14,9,13,48,43,5,51
Dunfermline,3099,5,12,12,12,50,45,5,48
Queen of S't,3099,6,11,10,15,42,50,-8,43
St Mirren,3099,7,10,10,16,41,56,-15,40
Dumbarton,3099,8,8,13,15,46,58,-12,37
Raith,3099,9,9,10,17,35,54,-19,37
Ayr,3099,10,7,12,17,32,58,-26,33
Hibernian,3100,1,20,11,5,57,27,30,71
Falkirk,3100,2,16,13,7,56,36,20,61
Morton,3100,3,16,11,9,50,38,12,59
Dundee Utd,3100,4,15,11,10,53,39,14,56
Dumbarton,3100,5,10,13,13,48,51,-3,43
Raith,3100,6,11,9,16,36,48,-12,42
Dunfermline,3100,7,9,12,15,46,56,-10,39
Queen of S't,3100,8,10,9,17,41,53,-12,39
St Mirren,3100,9,9,10,17,41,57,-16,37
Ayr,3100,10,8,13,15,36,59,-23,37
Hibernian,3101,1,21,10,5,57,23,34,73
Morton,3101,2,19,10,7,58,40,18,67
Falkirk,3101,3,15,12,9,56,40,16,57
Dundee Utd,3101,4,14,9,13,52,48,4,51
Dunfermline,3101,5,10,13,13,51,55,-4,43
Queen of S't,3101,6,11,10,15,45,52,-7,43
Ayr,3101,7,10,11,15,39,57,-18,41
Dumbarton,3101,8,9,12,15,53,64,-11,39
St Mirren,3101,9,8,12,16,43,57,-14,36
Raith,3101,10,8,11,17,36,54,-18,35
Hibernian,3102,1,22,11,3,59,23,36,77
Morton,3102,2,16,12,8,46,37,9,60
Falkirk,3102,3,15,11,10,62,45,17,56
Dundee Utd,3102,4,13,10,13,43,40,3,49
Queen of S't,3102,5,13,9,14,52,49,3,48
Dumbarton,3102,6,9,13,14,50,58,-8,40
St Mirren,3102,7,10,10,16,40,54,-14,40
Ayr,3102,8,9,13,14,35,51,-16,40
Dunfermline,3102,9,9,12,15,42,55,-13,39
Raith,3102,10,8,11,17,35,52,-17,35
Hibernian,3103,1,18,12,6,56,29,27,66
Morton,3103,2,17,13,6,55,37,18,64
Dundee Utd,3103,3,15,11,10,55,40,15,56
Falkirk,3103,4,13,10,13,54,49,5,49
Queen of S't,3103,5,12,11,13,44,47,-3,47
Dunfermline,3103,6,11,12,13,48,52,-4,45
Raith,3103,7,12,9,15,41,47,-6,45
Ayr,3103,8,9,12,15,41,60,-19,39
St Mirren,3103,9,9,11,16,43,57,-14,38
Dumbarton,3103,10,8,11,17,47,66,-19,35
Hibernian,3104,1,20,11,5,55,28,27,71
Morton,3104,2,19,10,7,57,35,22,67
Falkirk,3104,3,16,13,7,63,41,22,61
Dundee Utd,3104,4,15,9,12,46,40,6,54
Dumbarton,3104,5,10,12,14,50,56,-6,42
Ayr,3104,6,10,11,15,33,53,-20,41
Queen of S't,3104,7,10,9,17,44,56,-12,39
Raith,3104,8,9,11,16,33,49,-16,38
Dunfermline,3104,9,8,13,15,46,53,-7,37
St Mirren,3104,10,8,11,17,35,51,-16,35
Hibernian,3105,1,17,15,4,50,24,26,66
Falkirk,3105,2,16,11,9,63,44,19,59
Morton,3105,3,16,11,9,48,40,8,59
Dundee Utd,3105,4,15,10,11,48,45,3,55
Dunfermline,3105,5,13,11,12,58,48,10,50
Raith,3105,6,12,9,15,37,46,-9,45
Queen of S't,3105,7,11,11,14,45,50,-5,44
Dumbarton,3105,8,8,12,16,49,62,-13,36
St Mirren,3105,9,8,11,17,42,58,-16,35
Ayr,3105,10,7,13,16,29,52,-23,34
Hibernian,3106,1,20,12,4,57,24,33,72
Falkirk,3106,2,16,11,9,59,44,15,59
Dundee Utd,3106,3,15,10,11,48,39,9,55
Morton,3106,4,13,14,9,47,46,1,53
Dunfermline,3106,5,13,12,11,53,44,9,51
Queen of S't,3106,6,12,10,14,44,46,-2,46
Ayr,3106,7,9,12,15,35,55,-20,39
Dumbarton,3106,8,8,13,15,49,61,-12,37
Raith,3106,9,9,10,17,35,50,-15,37
St Mirren,3106,10,7,12,17,39,57,-18,33
Hibernian,3107,1,19,13,4,56,25,31,70
Morton,3107,2,16,12,8,47,34,13,60
Falkirk,3107,3,16,10,10,59,43,16,58
Dundee Utd,3107,4,13,10,13,48,46,2,49
Queen of S't,3107,5,12,10,14,46,51,-5,46
Raith,3107,6,10,13,13,42,49,-7,43
Dumbarton,3107,7,10,11,15,51,57,-6,41
Dunfermline,3107,8,8,15,13,44,52,-8,39
Ayr,3107,9,9,11,16,36,56,-20,38
St Mirren,3107,10,8,13,15,38,54,-16,37
Hibernian,3108,1,21,11,4,61,26,35,74
Morton,3108,2,18,10,8,53,35,18,64
Falkirk,3108,3,16,11,9,57,38,19,59
Dundee Utd,3108,4,14,12,10,50,41,9,54
Raith,3108,5,13,8,15,38,45,-7,47
Queen of S't,3108,6,12,9,15,48,58,-10,45
Dumbarton,3108,7,8,14,14,49,59,-10,38
Dunfermline,3108,8,8,13,15,43,50,-7,37
St Mirren,3108,9,8,10,18,37,59,-22,34
Ayr,3108,10,7,12,17,34,59,-25,33
Morton,3109,1,19,10,7,55,36,19,67
Hibernian,3109,2,17,13,6,59,27,32,64
Dundee Utd,3109,3,16,9,11,52,38,14,57
Falkirk,3109,4,15,11,10,51,38,13,56
Dunfermline,3109,5,11,12,13,45,45,0,45
Raith,3109,6,11,11,14,35,48,-13,44
Queen of S't,3109,7,11,10,15,46,52,-6,43
Dumbarton,3109,8,9,11,16,47,61,-14,38
Ayr,3109,9,8,12,16,33,53,-20,36
St Mirren,3109,10,8,11,17,39,64,-25,35
Morton,3110,1,20,9,7,53,35,18,69
Hibernian,3110,2,18,13,5,62,29,33,67
Falkirk,3110,3,15,11,10,56,42,14,56
Dundee Utd,3110,4,16,8,12,47,39,8,56
Dunfermline,3110,5,12,12,12,47,44,3,48
Queen of S't,3110,6,12,9,15,46,50,-4,45
Raith,3110,7,10,9,17,34,52,-18,39
Ayr,3110,8,9,12,15,35,55,-20,39
Dumbarton,3110,9,8,11,17,44,58,-14,35
St Mirren,3110,10,8,10,18,37,57,-20,34
Hibernian,3111,1,18,13,5,62,26,36,67
Morton,3111,2,16,12,8,50,42,8,60
Falkirk,3111,3,16,10,10,61,44,17,58
Dundee Utd,3111,4,15,11,10,52,44,8,56
Dunfermline,3111,5,14,11,11,54,45,9,53
Raith,3111,6,12,9,15,36,46,-10,45
Queen of S't,3111,7,10,9,17,40,53,-13,39
Ayr,3111,8,9,11,16,37,55,-18,38
St Mirren,3111,9,9,9,18,40,58,-18,36
Dumbarton,3111,10,8,11,17,47,66,-19,35
Hibernian,3112,1,19,12,5,53,25,28,69
Dundee Utd,3112,2,18,9,9,56,38,18,63
Morton,3112,3,16,12,8,48,37,11,60
Falkirk,3112,4,15,10,11,60,40,20,55
Queen of S't,3112,5,14,8,14,48,49,-1,50
Raith,3112,6,11,8,17,38,54,-16,41
Dunfermline,3112,7,9,13,14,44,47,-3,40
Dumbarton,3112,8,9,13,14,49,57,-8,40
St Mirren,3112,9,10,9,17,43,58,-15,39
Ayr,3112,10,7,10,19,32,66,-34,31
Hibernian,3113,1,18,12,6,52,26,26,66
Morton,3113,2,18,9,9,51,35,16,63
Falkirk,3113,3,16,11,9,57,39,18,59
Dundee Utd,3113,4,16,11,9,49,36,13,59
Dunfermline,3113,5,10,14,12,47,50,-3,44
Queen of S't,3113,6,11,9,16,43,53,-10,42
Raith,3113,7,10,11,15,37,49,-12,41
Dumbarton,3113,8,8,13,15,47,59,-12,37
St Mirren,3113,9,8,12,16,41,56,-15,36
Ayr,3113,10,8,12,16,34,55,-21,36
Falkirk,3114,1,19,10,7,62,35,27,67
Hibernian,3114,2,17,14,5,53,27,26,65
Morton,3114,3,16,13,7,47,34,13,61
Dundee Utd,3114,4,14,11,11,49,41,8,53
Queen of S't,3114,5,12,9,15,44,51,-7,45
Raith,3114,6,11,11,14,37,46,-9,44
Dumbarton,3114,7,10,11,15,48,57,-9,41
Dunfermline,3114,8,8,13,15,41,49,-8,37
St Mirren,3114,9,8,11,17,39,55,-16,35
Ayr,3114,10,7,13,16,32,57,-25,34
Morton,3115,1,18,11,7,54,37,17,65
Falkirk,3115,2,16,12,8,53,35,18,60
Hibernian,3115,3,16,12,8,50,32,18,60
Dundee Utd,3115,4,17,9,10,56,43,13,60
Ayr,3115,5,11,11,14,36,53,-17,44
Queen of S't,3115,6,11,10,15,46,52,-6,43
Dunfermline,3115,7,9,15,12,46,48,-2,42
Raith,3115,8,10,9,17,36,51,-15,39
Dumbarton,3115,9,9,11,16,50,61,-11,38
St Mirren,3115,10,8,10,18,40,55,-15,34
Hibernian,3116,1,20,12,4,57,26,31,72
Morton,3116,2,16,12,8,51,38,13,60
Falkirk,3116,3,16,11,9,57,38,19,59
Dundee Utd,3116,4,14,13,9,47,39,8,55
Dumbarton,3116,5,12,10,14,49,53,-4,46
Queen of S't,3116,6,11,9,16,44,54,-10,42
Ayr,3116,7,10,11,15,35,51,-16,41
Dunfermline,3116,8,9,13,14,45,50,-5,40
Raith,3116,9,10,9,17,35,49,-14,39
St Mirren,3116,10,7,10,19,34,56,-22,31
Hibernian,3117,1,18,13,5,54,27,27,67
Morton,3117,2,16,12,8,48,37,11,60
Falkirk,3117,3,16,11,9,60,39,21,59
Dundee Utd,3117,4,15,9,12,49,44,5,54
St Mirren,3117,5,11,11,14,44,51,-7,44
Queen of S't,3117,6,11,10,15,44,52,-8,43
Dunfermline,3117,7,10,12,14,45,51,-6,42
Raith,3117,8,10,12,14,36,46,-10,42
Dumbarton,3117,9,8,12,16,47,59,-12,36
Ayr,3117,10,7,14,15,34,55,-21,35
Hibernian,3118,1,20,12,4,62,28,34,72
Dundee Utd,3118,2,17,9,10,48,43,5,60
Morton,3118,3,15,13,8,51,39,12,58
Falkirk,3118,4,15,11,10,58,44,14,56
Dunfermline,3118,5,12,12,12,51,47,4,48
Queen of S't,3118,6,12,9,15,44,49,-5,45
Raith,3118,7,10,11,15,38,51,-13,41
Dumbarton,3118,8,8,12,16,48,61,-13,36
Ayr,3118,9,7,13,16,33,55,-22,34
St Mirren,3118,10,7,12,17,40,56,-16,33
Hibernian,3119,1,19,12,5,52,23,29,69
Falkirk,3119,2,17,12,7,56,36,20,63
Morton,3119,3,16,10,10,47,38,9,58
Dundee Utd,3119,4,16,8,12,53,46,7,56
Dunfermline,3119,5,11,11,14,51,55,-4,44
St Mirren,3119,6,11,11,14,44,51,-7,44
Queen of S't,3119,7,11,10,15,44,49,-5,43
Dumbarton,3119,8,10,10,16,49,60,-11,40
Raith,3119,9,10,8,18,33,49,-16,38
Ayr,3119,10,7,12,17,30,52,-22,33
Hibernian,3120,1,19,12,5,55,26,29,69
Dundee Utd,3120,2,17,9,10,54,42,12,60
Morton,3120,3,16,12,8,45,33,12,60
Falkirk,3120,4,14,13,9,55,41,14,55
Dunfermline,3120,5,11,14,11,47,42,5,47
Dumbarton,3120,6,10,13,13,51,57,-6,43
Queen of S't,3120,7,10,10,16,44,52,-8,40
Raith,3120,8,10,8,18,32,50,-18,38
St Mirren,3120,9,8,12,16,40,56,-16,36
Ayr,3120,10,8,11,17,33,57,-24,35
Hibernian,3121,1,19,11,6,55,28,27,68
Falkirk,3121,2,18,11,7,56,35,21,65
Morton,3121,3,17,10,9,56,39,17,61
Dundee Utd,3121,4,17,9,10,52,38,14,60
Dunfermline,3121,5,11,13,12,52,49,3,46
Raith,3121,6,11,10,15,41,48,-7,43
Dumbarton,3121,7,9,14,13,51,57,-6,41
Queen of S't,3121,8,9,8,19,40,59,-19,35
Ayr,3121,9,7,13,16,35,65,-30,34
St Mirren,3121,10,7,11,18,38,58,-20,32
Hibernian,3122,1,19,13,4,55,23,32,70
Morton,3122,2,18,11,7,52,36,16,65
Dundee Utd,3122,3,16,11,9,49,40,9,59
Falkirk,3122,4,15,11,10,58,43,15,56
Queen of S't,3122,5,13,9,14,48,47,1,48
Dunfermline,3122,6,9,14,13,47,48,-1,41
Raith,3122,7,10,11,15,34,50,-16,41
Dumbarton,3122,8,9,13,14,50,57,-7,40
St Mirren,3122,9,8,10,18,41,59,-18,34
Ayr,3122,10,6,11,19,30,61,-31,29
Hibernian,3123,1,20,12,4,58,26,32,72
Falkirk,3123,2,16,11,9,63,46,17,59
Morton,3123,3,15,12,9,44,34,10,57
Dundee Utd,3123,4,15,10,11,48,45,3,55
Dunfermline,3123,5,12,11,13,53,50,3,47
Ayr,3123,6,11,12,13,36,47,-11,45
Raith,3123,7,10,10,16,39,50,-11,40
Queen of S't,3123,8,10,9,17,47,59,-12,39
St Mirren,3123,9,9,10,17,40,56,-16,37
Dumbarton,3123,10,7,13,16,47,62,-15,34
Hibernian,3124,1,18,12,6,51,24,27,66
Morton,3124,2,17,11,8,52,35,17,62
Dundee Utd,3124,3,16,9,11,50,38,12,57
Falkirk,3124,4,14,11,11,55,44,11,53
Queen of S't,3124,5,13,8,15,46,52,-6,47
Dumbarton,3124,6,12,10,14,57,60,-3,46
Raith,3124,7,12,9,15,39,49,-10,45
Dunfermline,3124,8,10,14,12,44,46,-2,44
Ayr,3124,9,8,11,17,34,57,-23,35
St Mirren,3124,10,7,11,18,37,60,-23,32
Hibernian,3125,1,20,12,4,56,25,31,72
Falkirk,3125,2,17,10,9,61,41,20,61
Morton,3125,3,17,10,9,51,35,16,61
Dundee Utd,3125,4,15,11,10,51,41,10,56
Raith,3125,5,12,10,14,35,45,-10,46
Dumbarton,3125,6,10,12,14,50,54,-4,42
Dunfermline,3125,7,10,12,14,44,52,-8,42
Queen of S't,3125,8,11,9,16,42,51,-9,42
Ayr,3125,9,7,13,16,35,55,-20,34
St Mirren,3125,10,7,9,20,38,64,-26,30
Hibernian,3126,1,21,11,4,59,26,33,74
Morton,3126,2,17,10,9,49,35,14,61
Falkirk,3126,3,16,12,8,57,39,18,60
Dundee Utd,3126,4,16,10,10,50,38,12,58
Queen of S't,3126,5,12,11,13,47,48,-1,47
Raith,3126,6,10,12,14,37,48,-11,42
Dumbarton,3126,7,9,11,16,47,61,-14,38
Dunfermline,3126,8,8,12,16,42,54,-12,36
St Mirren,3126,9,9,9,18,39,56,-17,36
Ayr,3126,10,7,12,17,36,58,-22,33
Hibernian,3127,1,18,12,6,56,27,29,66
Morton,3127,2,18,11,7,53,34,19,65
Dundee Utd,3127,3,16,11,9,50,42,8,59
Falkirk,3127,4,14,12,10,56,46,10,54
Queen of S't,3127,5,12,11,13,49,46,3,47
Dunfermline,3127,6,9,14,13,45,52,-7,41
Ayr,3127,7,9,13,14,35,52,-17,40
Raith,3127,8,9,11,16,35,53,-18,38
Dumbarton,3127,9,9,10,17,51,62,-11,37
St Mirren,3127,10,8,11,17,41,57,-16,35
Hibernian,3128,1,20,10,6,62,29,33,70
Morton,3128,2,18,10,8,53,33,20,64
Falkirk,3128,3,16,11,9,57,41,16,59
Dundee Utd,3128,4,16,10,10,52,39,13,58
Queen of S't,3128,5,11,10,15,42,51,-9,43
Dunfermline,3128,6,10,12,14,51,55,-4,42
Ayr,3128,7,9,13,14,33,52,-19,40
Dumbarton,3128,8,9,12,15,47,59,-12,39
Raith,3128,9,10,9,17,34,51,-17,39
St Mirren,3128,10,7,11,18,37,58,-21,32
Hibernian,3129,1,19,12,5,52,25,27,69
Morton,3129,2,18,11,7,48,33,15,65
Falkirk,3129,3,16,11,9,61,41,20,59
Dundee Utd,3129,4,15,9,12,48,40,8,54
Queen of S't,3129,5,11,11,14,47,53,-6,44
St Mirren,3129,6,11,9,16,42,54,-12,42
Dumbarton,3129,7,9,14,13,48,52,-4,41
Dunfermline,3129,8,9,14,13,43,49,-6,41
Ayr,3129,9,8,12,16,34,57,-23,36
Raith,3129,10,8,9,19,34,53,-19,33
Hibernian,3130,1,22,10,4,59,23,36,76
Falkirk,3130,2,16,10,10,60,44,16,58
Dundee Utd,3130,3,15,11,10,50,39,11,56
Morton,3130,4,15,11,10,45,38,7,56
Dunfermline,3130,5,13,11,12,48,49,-1,50
Ayr,3130,6,11,11,14,39,53,-14,44
Queen of S't,3130,7,11,9,16,43,47,-4,42
Dumbarton,3130,8,8,12,16,44,59,-15,36
St Mirren,3130,9,8,11,17,36,51,-15,35
Raith,3130,10,8,10,18,33,54,-21,34
Hibernian,3131,1,23,10,3,60,23,37,79
Dundee Utd,3131,2,17,11,8,55,39,16,62
Falkirk,3131,3,14,12,10,54,40,14,54
Morton,3131,4,15,9,12,52,47,5,54
Dunfermline,3131,5,11,12,13,51,50,1,45
Dumbarton,3131,6,10,11,15,50,60,-10,41
Raith,3131,7,10,11,15,35,48,-13,41
Queen of S't,3131,8,10,10,16,45,55,-10,40
St Mirren,3131,9,8,11,17,38,54,-16,35
Ayr,3131,10,7,13,16,33,57,-24,34
Hibernian,3132,1,21,11,4,59,23,36,74
Dundee Utd,3132,2,18,9,9,55,37,18,63
Morton,3132,3,16,12,8,51,40,11,60
Falkirk,3132,4,14,12,10,53,47,6,54
Queen of S't,3132,5,11,11,14,45,49,-4,44
Dunfermline,3132,6,10,13,13,46,48,-2,43
Dumbarton,3132,7,9,12,15,56,60,-4,39
Raith,3132,8,9,10,17,33,49,-16,37
St Mirren,3132,9,8,11,17,38,58,-20,35
Ayr,3132,10,8,11,17,35,60,-25,35
Hibernian,3133,1,18,12,6,49,24,25,66
Morton,3133,2,18,11,7,53,40,13,65
Falkirk,3133,3,15,10,11,53,46,7,55
Dundee Utd,3133,4,15,10,11,48,41,7,55
Queen of S't,3133,5,11,10,15,48,52,-4,43
Raith,3133,6,10,12,14,38,46,-8,42
Ayr,3133,7,10,11,15,34,51,-17,41
Dunfermline,3133,8,9,13,14,50,50,0,40
Dumbarton,3133,9,8,14,14,45,54,-9,38
St Mirren,3133,10,9,11,16,40,54,-14,38
Hibernian,3134,1,21,11,4,58,27,31,74
Morton,3134,2,16,12,8,51,36,15,60
Dundee Utd,3134,3,17,9,10,52,41,11,60
Falkirk,3134,4,15,12,9,59,41,18,57
Raith,3134,5,12,9,15,36,46,-10,45
Queen of S't,3134,6,11,9,16,46,52,-6,42
Dunfermline,3134,7,9,14,13,47,49,-2,41
Ayr,3134,8,9,10,17,33,57,-24,37
St Mirren,3134,9,9,9,18,39,56,-17,36
Dumbarton,3134,10,8,11,17,48,64,-16,35
Hibernian,3135,1,19,12,5,54,24,30,69
Morton,3135,2,17,11,8,48,35,13,62
Dundee Utd,3135,3,16,12,8,50,36,14,60
Falkirk,3135,4,16,10,10,56,40,16,58
Queen of S't,3135,5,12,11,13,40,43,-3,47
Dunfermline,3135,6,9,14,13,48,51,-3,41
Dumbarton,3135,7,9,13,14,49,58,-9,40
Raith,3135,8,9,10,17,34,50,-16,37
Ayr,3135,9,7,14,15,30,51,-21,35
St Mirren,3135,10,7,11,18,36,57,-21,32
Hibernian,3136,1,20,13,3,59,24,35,73
Morton,3136,2,15,14,7,54,41,13,59
Falkirk,3136,3,16,10,10,58,42,16,58
Dundee Utd,3136,4,15,11,10,53,43,10,56
Dunfermline,3136,5,10,15,11,49,47,2,45
Queen of S't,3136,6,11,12,13,47,52,-5,45
Raith,3136,7,10,9,17,37,55,-18,39
St Mirren,3136,8,9,9,18,45,60,-15,36
Ayr,3136,9,7,14,15,34,57,-23,35
Dumbarton,3136,10,7,13,16,44,59,-15,34
Hibernian,3137,1,19,12,5,53,26,27,69
Morton,3137,2,17,11,8,51,35,16,62
Falkirk,3137,3,17,10,9,60,44,16,61
Dundee Utd,3137,4,13,12,11,43,39,4,51
Queen of S't,3137,5,12,10,14,48,48,0,46
Dumbarton,3137,6,10,14,12,50,54,-4,44
Dunfermline,3137,7,10,12,14,55,54,1,42
Raith,3137,8,10,9,17,32,51,-19,39
St Mirren,3137,9,9,10,17,40,57,-17,37
Ayr,3137,10,7,12,17,29,53,-24,33
Hibernian,3138,1,18,12,6,51,27,24,66
Morton,3138,2,17,13,6,53,36,17,64
Falkirk,3138,3,17,10,9,61,44,17,61
Dundee Utd,3138,4,16,11,9,55,41,14,59
Dunfermline,3138,5,12,12,12,51,45,6,48
St Mirren,3138,6,10,10,16,46,57,-11,40
Queen of S't,3138,7,9,12,15,40,49,-9,39
Raith,3138,8,10,9,17,37,54,-17,39
Ayr,3138,9,7,13,16,33,58,-25,34
Dumbarton,3138,10,7,12,17,45,61,-16,33
Hibernian,3139,1,19,13,4,58,27,31,70
Falkirk,3139,2,17,12,7,61,40,21,63
Morton,3139,3,17,11,8,47,35,12,62
Dundee Utd,3139,4,17,10,9,53,38,15,61
Raith,3139,5,12,9,15,36,50,-14,45
Queen of S't,3139,6,10,11,15,45,53,-8,41
Dunfermline,3139,7,9,13,14,51,51,0,40
Ayr,3139,8,8,11,17,39,59,-20,35
St Mirren,3139,9,8,10,18,37,55,-18,34
Dumbarton,3139,10,7,12,17,43,62,-19,33
Hibernian,3140,1,18,15,3,54,25,29,69
Morton,3140,2,17,12,7,49,37,12,63
Dundee Utd,3140,3,16,10,10,49,37,12,58
Falkirk,3140,4,15,10,11,59,45,14,55
Raith,3140,5,12,10,14,39,46,-7,46
Dumbarton,3140,6,9,14,13,49,54,-5,41
Queen of S't,3140,7,10,11,15,39,48,-9,41
Dunfermline,3140,8,8,15,13,43,47,-4,39
Ayr,3140,9,8,14,14,34,52,-18,38
St Mirren,3140,10,6,11,19,37,61,-24,29
Hibernian,3141,1,19,13,4,53,24,29,70
Falkirk,3141,2,18,9,9,61,40,21,63
Dundee Utd,3141,3,17,10,9,54,37,17,61
Morton,3141,4,15,13,8,45,36,9,58
Dunfermline,3141,5,10,13,13,46,47,-1,43
Queen of S't,3141,6,11,10,15,45,50,-5,43
Dumbarton,3141,7,10,11,15,49,61,-12,41
Raith,3141,8,10,10,16,37,49,-12,40
Ayr,3141,9,7,14,15,31,53,-22,35
St Mirren,3141,10,7,9,20,36,60,-24,30
Hibernian,3142,1,19,11,6,56,27,29,68
Morton,3142,2,17,13,6,52,39,13,64
Dundee Utd,3142,3,17,9,10,57,40,17,60
Falkirk,3142,4,16,9,11,58,41,17,57
Dunfermline,3142,5,10,14,12,46,48,-2,44
Queen of S't,3142,6,11,8,17,42,53,-11,41
Raith,3142,7,10,11,15,36,53,-17,41
St Mirren,3142,8,10,9,17,44,57,-13,39
Dumbarton,3142,9,9,10,17,48,59,-11,37
Ayr,3142,10,8,12,16,34,56,-22,36
Hibernian,3143,1,19,13,4,56,26,30,70
Falkirk,3143,2,18,9,9,57,38,19,63
Dundee Utd,3143,3,17,10,9,50,35,15,61
Morton,3143,4,13,14,9,47,43,4,53
Dunfermline,3143,5,11,14,11,50,44,6,47
Raith,3143,6,11,9,16,33,45,-12,42
Queen of S't,3143,7,10,9,17,37,51,-14,39
Dumbarton,3143,8,9,11,16,45,57,-12,38
Ayr,3143,9,9,11,16,34,53,-19,38
St Mirren,3143,10,7,12,17,36,53,-17,33
Hibernian,3144,1,18,14,4,60,29,31,68
Morton,3144,2,15,15,6,47,34,13,60
Dundee Utd,3144,3,15,11,10,50,39,11,56
Falkirk,3144,4,15,9,12,56,50,6,54
Dunfermline,3144,5,11,14,11,51,46,5,47
Queen of S't,3144,6,11,10,15,45,53,-8,43
St Mirren,3144,7,11,10,15,43,51,-8,43
Ayr,3144,8,9,12,15,32,51,-19,39
Raith,3144,9,9,10,17,33,49,-16,37
Dumbarton,3144,10,8,11,17,42,57,-15,35
Hibernian,3145,1,18,13,5,54,31,23,67
Morton,3145,2,16,13,7,49,33,16,61
Dundee Utd,3145,3,16,11,9,50,40,10,59
Falkirk,3145,4,16,10,10,56,42,14,58
Queen of S't,3145,5,11,10,15,43,49,-6,43
Raith,3145,6,10,11,15,35,48,-13,41
Dunfermline,3145,7,9,13,14,50,54,-4,40
Dumbarton,3145,8,9,13,14,49,56,-7,40
Ayr,3145,9,9,11,16,35,54,-19,38
St Mirren,3145,10,7,13,16,39,53,-14,34
Hibernian,3146,1,19,12,5,58,29,29,69
Morton,3146,2,16,13,7,49,36,13,61
Falkirk,3146,3,16,9,11,55,42,13,57
Dundee Utd,3146,4,15,11,10,53,41,12,56
Dumbarton,3146,5,11,12,13,51,55,-4,45
Queen of S't,3146,6,10,13,13,48,52,-4,43
Ayr,3146,7,9,14,13,38,53,-15,41
Dunfermline,3146,8,8,14,14,43,48,-5,38
Raith,3146,9,9,10,17,33,53,-20,37
St Mirren,3146,10,7,12,17,43,62,-19,33
Hibernian,3147,1,20,12,4,60,25,35,72
Falkirk,3147,2,16,12,8,60,41,19,60
Dundee Utd,3147,3,16,9,11,51,42,9,57
Morton,3147,4,14,12,10,46,41,5,54
Dunfermline,3147,5,9,16,11,42,44,-2,43
Raith,3147,6,11,10,15,35,46,-11,43
Queen of S't,3147,7,10,11,15,42,50,-8,41
Ayr,3147,8,9,11,16,31,54,-23,38
Dumbarton,3147,9,8,13,15,44,54,-10,37
St Mirren,3147,10,9,10,17,39,53,-14,37
Falkirk,3148,1,19,10,7,62,37,25,67
Morton,3148,2,19,10,7,50,33,17,67
Hibernian,3148,3,18,12,6,55,28,27,66
Dundee Utd,3148,4,16,8,12,56,42,14,56
Dumbarton,3148,5,10,12,14,51,57,-6,42
Queen of S't,3148,6,10,11,15,43,51,-8,41
Dunfermline,3148,7,10,11,15,42,50,-8,41
Ayr,3148,8,9,12,15,38,58,-20,39
Raith,3148,9,8,11,17,31,49,-18,35
St Mirren,3148,10,8,9,19,39,62,-23,33
Hibernian,3149,1,21,11,4,58,22,36,74
Morton,3149,2,19,10,7,53,33,20,67
Falkirk,3149,3,16,11,9,58,40,18,59
Dundee Utd,3149,4,16,11,9,49,38,11,59
Queen of S't,3149,5,11,11,14,45,50,-5,44
Dumbarton,3149,6,10,10,16,50,60,-10,40
Dunfermline,3149,7,9,11,16,43,51,-8,38
Raith,3149,8,9,10,17,34,51,-17,37
Ayr,3149,9,8,11,17,34,58,-24,35
St Mirren,3149,10,8,10,18,41,62,-21,34
Hibernian,3150,1,18,12,6,56,31,25,66
Falkirk,3150,2,19,9,8,61,37,24,66
Morton,3150,3,18,9,9,47,34,13,63
Dundee Utd,3150,4,15,9,12,50,39,11,54
Ayr,3150,5,11,10,15,34,51,-17,43
Raith,3150,6,11,9,16,38,49,-11,42
Queen of S't,3150,7,10,11,15,42,50,-8,41
Dunfermline,3150,8,9,13,14,45,50,-5,40
Dumbarton,3150,9,9,12,15,48,60,-12,39
St Mirren,3150,10,8,10,18,37,57,-20,34
Hibernian,3151,1,19,13,4,62,30,32,70
Falkirk,3151,2,18,10,8,65,40,25,64
Morton,3151,3,18,9,9,50,35,15,63
Dundee Utd,3151,4,17,8,11,54,37,17,59
Queen of S't,3151,5,12,11,13,45,47,-2,47
Dumbarton,3151,6,10,10,16,55,69,-14,40
Raith,3151,7,9,10,17,32,54,-22,37
Dunfermline,3151,8,8,12,16,48,54,-6,36
St Mirren,3151,9,8,12,16,40,56,-16,36
Ayr,3151,10,8,11,17,32,61,-29,35
Hibernian,3152,1,19,13,4,55,23,32,70
Morton,3152,2,17,10,9,54,40,14,61
Falkirk,3152,3,16,10,10,58,42,16,58
Dundee Utd,3152,4,16,9,11,54,49,5,57
Queen of S't,3152,5,13,10,13,51,51,0,49
Dunfermline,3152,6,12,11,13,49,48,1,47
Raith,3152,7,12,8,16,38,47,-9,44
Dumbarton,3152,8,8,11,17,46,59,-13,35
St Mirren,3152,9,8,10,18,40,59,-19,34
Ayr,3152,10,8,10,18,32,59,-27,34
Morton,3153,1,20,9,7,58,36,22,69
Hibernian,3153,2,19,11,6,57,26,31,68
Falkirk,3153,3,17,11,8,65,43,22,62
Dundee Utd,3153,4,15,11,10,49,42,7,56
Queen of S't,3153,5,12,10,14,44,48,-4,46
Dumbarton,3153,6,10,12,14,54,59,-5,42
Dunfermline,3153,7,9,12,15,49,54,-5,39
St Mirren,3153,8,8,11,17,41,62,-21,35
Raith,3153,9,9,8,19,37,59,-22,35
Ayr,3153,10,7,13,16,30,55,-25,34
Hibernian,3154,1,22,11,3,58,23,35,77
Dundee Utd,3154,2,18,9,9,59,40,19,63
Morton,3154,3,17,10,9,48,36,12,61
Falkirk,3154,4,15,12,9,57,41,16,57
Queen of S't,3154,5,12,9,15,46,51,-5,45
Dunfermline,3154,6,10,13,13,51,52,-1,43
Dumbarton,3154,7,9,10,17,49,64,-15,37
St Mirren,3154,8,8,11,17,48,63,-15,35
Raith,3154,9,8,11,17,33,52,-19,35
Ayr,3154,10,7,12,17,32,59,-27,33
Hibernian,3155,1,22,10,4,64,24,40,76
Morton,3155,2,18,10,8,55,40,15,64
Falkirk,3155,3,17,9,10,58,40,18,60
Dundee Utd,3155,4,15,10,11,48,43,5,55
Queen of S't,3155,5,14,9,13,52,52,0,51
Ayr,3155,6,9,13,14,39,55,-16,40
Dunfermline,3155,7,9,11,16,42,54,-12,38
St Mirren,3155,8,9,10,17,43,58,-15,37
Raith,3155,9,9,8,19,34,51,-17,35
Dumbarton,3155,10,8,10,18,46,64,-18,34
Hibernian,3156,1,19,12,5,57,26,31,69
Falkirk,3156,2,18,10,8,64,37,27,64
Morton,3156,3,16,11,9,48,37,11,59
Dundee Utd,3156,4,16,9,11,47,39,8,57
Raith,3156,5,12,8,16,38,53,-15,44
Dumbarton,3156,6,10,12,14,47,55,-8,42
Dunfermline,3156,7,9,13,14,45,49,-4,40
Queen of S't,3156,8,10,10,16,41,51,-10,40
St Mirren,3156,9,8,12,16,37,55,-18,36
Ayr,3156,10,7,13,16,32,54,-22,34
Hibernian,3157,1,19,13,4,53,25,28,70
Morton,3157,2,16,13,7,51,35,16,61
Falkirk,3157,3,16,12,8,62,42,20,60
Dundee Utd,3157,4,14,13,9,53,43,10,55
Queen of S't,3157,5,12,10,14,46,49,-3,46
Raith,3157,6,11,10,15,39,47,-8,43
Dunfermline,3157,7,10,12,14,47,49,-2,42
Dumbarton,3157,8,8,12,16,44,62,-18,36
St Mirren,3157,9,8,11,17,40,60,-20,35
Ayr,3157,10,6,14,16,33,56,-23,32
Hibernian,3158,1,19,11,6,54,29,25,68
Falkirk,3158,2,16,12,8,58,37,21,60
Dundee Utd,3158,3,16,10,10,50,38,12,58
Morton,3158,4,15,11,10,48,39,9,56
Dunfermline,3158,5,10,14,12,47,46,1,44
Dumbarton,3158,6,10,11,15,46,56,-10,41
Queen of S't,3158,7,10,10,16,39,47,-8,40
St Mirren,3158,8,10,10,16,40,52,-12,40
Raith,3158,9,10,10,16,33,49,-16,40
Ayr,3158,10,9,11,16,30,52,-22,38
Hibernian,3159,1,20,11,5,59,28,31,71
Morton,3159,2,17,13,6,52,34,18,64
Falkirk,3159,3,17,9,10,61,41,20,60
Dundee Utd,3159,4,16,11,9,49,38,11,59
Dunfermline,3159,5,9,14,13,48,49,-1,41
Dumbarton,3159,6,10,11,15,46,54,-8,41
Queen of S't,3159,7,10,11,15,40,50,-10,41
St Mirren,3159,8,9,10,17,41,57,-16,37
Raith,3159,9,9,9,18,33,56,-23,36
Ayr,3159,10,7,13,16,30,52,-22,34
Hibernian,3160,1,19,12,5,58,24,34,69
Morton,3160,2,16,13,7,48,37,11,61
Falkirk,3160,3,16,11,9,57,42,15,59
Dundee Utd,3160,4,14,12,10,49,40,9,54
Queen of S't,3160,5,14,9,13,48,46,2,51
Dumbarton,3160,6,10,12,14,51,57,-6,42
Dunfermline,3160,7,8,14,14,43,51,-8,38
Raith,3160,8,10,8,18,35,52,-17,38
Ayr,3160,9,9,11,16,34,54,-20,38
St Mirren,3160,10,8,10,18,39,59,-20,34
Hibernian,3161,1,17,14,5,55,29,26,65
Falkirk,3161,2,17,11,8,61,42,19,62
Morton,3161,3,16,12,8,49,38,11,60
Dundee Utd,3161,4,15,12,9,52,39,13,57
Dunfermline,3161,5,12,12,12,46,47,-1,48
Queen of S't,3161,6,10,12,14,44,51,-7,42
Ayr,3161,7,9,13,14,38,52,-14,40
Raith,3161,8,8,13,15,31,47,-16,37
Dumbarton,3161,9,8,11,17,48,63,-15,35
St Mirren,3161,10,7,12,17,37,53,-16,33
Hibernian,3162,1,17,14,5,53,30,23,65
Morton,3162,2,17,11,8,56,38,18,62
Falkirk,3162,3,17,10,9,60,42,18,61
Dundee Utd,3162,4,15,10,11,49,43,6,55
Dunfermline,3162,5,12,11,13,49,47,2,47
Queen of S't,3162,6,11,12,13,47,47,0,45
Dumbarton,3162,7,10,10,16,49,63,-14,40
Raith,3162,8,10,10,16,34,50,-16,40
St Mirren,3162,9,8,12,16,48,57,-9,36
Ayr,3162,10,7,12,17,33,61,-28,33
Hibernian,3163,1,21,12,3,56,22,34,75
Morton,3163,2,15,14,7,51,37,14,59
Dundee Utd,3163,3,16,10,10,53,41,12,58
Falkirk,3163,4,15,12,9,58,43,15,57
Dumbarton,3163,5,9,13,14,55,62,-7,40
Queen of S't,3163,6,10,10,16,44,55,-11,40
St Mirren,3163,7,9,12,15,40,52,-12,39
Raith,3163,8,9,12,15,33,47,-14,39
Dunfermline,3163,9,8,14,14,47,54,-7,38
Ayr,3163,10,6,15,15,32,56,-24,33
Hibernian,3164,1,21,10,5,56,28,28,73
Morton,3164,2,17,13,6,51,33,18,64
Falkirk,3164,3,17,9,10,58,40,18,60
Dundee Utd,3164,4,14,12,10,48,41,7,54
Queen of S't,3164,5,12,9,15,50,55,-5,45
Dumbarton,3164,6,10,11,15,49,56,-7,41
Raith,3164,7,10,11,15,36,47,-11,41
Dunfermline,3164,8,8,14,14,48,54,-6,38
Ayr,3164,9,9,11,16,34,55,-21,38
St Mirren,3164,10,7,10,19,37,58,-21,31
Hibernian,3165,1,18,13,5,54,28,26,67
Morton,3165,2,18,13,5,48,31,17,67
Dundee Utd,3165,3,18,9,9,47,36,11,63
Falkirk,3165,4,17,10,9,55,36,19,61
Raith,3165,5,11,10,15,39,45,-6,43
Dunfermline,3165,6,10,12,14,45,48,-3,42
Queen of S't,3165,7,10,9,17,40,49,-9,39
Dumbarton,3165,8,8,13,15,45,55,-10,37
St Mirren,3165,9,7,11,18,39,57,-18,32
Ayr,3165,10,6,14,16,30,57,-27,32
Hibernian,3166,1,17,13,6,51,25,26,64
Morton,3166,2,17,12,7,53,39,14,63
Dundee Utd,3166,3,17,10,9,51,43,8,61
Falkirk,3166,4,14,11,11,54,42,12,53
Queen of S't,3166,5,13,9,14,48,50,-2,48
Dunfermline,3166,6,10,13,13,46,50,-4,43
St Mirren,3166,7,10,11,15,42,52,-10,41
Ayr,3166,8,9,12,15,37,52,-15,39
Raith,3166,9,9,10,17,34,49,-15,37
Dumbarton,3166,10,8,11,17,47,61,-14,35
Hibernian,3167,1,19,13,4,64,24,40,70
Falkirk,3167,2,18,10,8,60,38,22,64
Morton,3167,3,16,11,9,50,42,8,59
Dundee Utd,3167,4,15,10,11,52,38,14,55
Dunfermline,3167,5,10,15,11,44,43,1,45
Queen of S't,3167,6,11,9,16,42,55,-13,42
Ayr,3167,7,10,12,14,36,54,-18,42
Dumbarton,3167,8,9,12,15,51,58,-7,39
Raith,3167,9,8,10,18,31,58,-27,34
St Mirren,3167,10,7,12,17,38,58,-20,33
Hibernian,3168,1,19,12,5,57,29,28,69
Morton,3168,2,18,13,5,57,33,24,67
Dundee Utd,3168,3,19,8,9,62,41,21,65
Falkirk,3168,4,15,9,12,59,47,12,54
Dunfermline,3168,5,10,12,14,48,54,-6,42
Raith,3168,6,10,11,15,35,46,-11,41
Queen of S't,3168,7,10,9,17,45,56,-11,39
Dumbarton,3168,8,9,12,15,49,61,-12,39
Ayr,3168,9,9,12,15,34,54,-20,39
St Mirren,3168,10,7,10,19,40,65,-25,31
Hibernian,3169,1,20,12,4,57,23,34,72
Falkirk,3169,2,17,10,9,57,39,18,61
Dundee Utd,3169,3,17,9,10,53,42,11,60
Morton,3169,4,16,11,9,50,38,12,59
Raith,3169,5,13,9,14,36,44,-8,48
Queen of S't,3169,6,11,11,14,44,49,-5,44
Dumbarton,3169,7,9,12,15,53,61,-8,39
Ayr,3169,8,8,12,16,32,53,-21,36
Dunfermline,3169,9,7,14,15,43,52,-9,35
St Mirren,3169,10,7,10,19,39,63,-24,31
Hibernian,3170,1,20,13,3,54,23,31,73
Morton,3170,2,18,12,6,55,33,22,66
Falkirk,3170,3,15,11,10,57,40,17,56
Dundee Utd,3170,4,15,11,10,45,37,8,56
Queen of S't,3170,5,10,11,15,44,50,-6,41
Raith,3170,6,10,11,15,32,47,-15,41
Dunfermline,3170,7,9,13,14,46,51,-5,40
Dumbarton,3170,8,9,11,16,46,57,-11,38
St Mirren,3170,9,8,12,16,40,56,-16,36
Ayr,3170,10,8,11,17,30,55,-25,35
Hibernian,3171,1,20,12,4,55,24,31,72
Morton,3171,2,18,9,9,51,37,14,63
Dundee Utd,3171,3,17,9,10,60,39,21,60
Falkirk,3171,4,14,9,13,51,43,8,51
Raith,3171,5,12,11,13,37,43,-6,47
Dumbarton,3171,6,12,10,14,51,55,-4,46
Queen of S't,3171,7,11,10,15,44,50,-6,43
Dunfermline,3171,8,9,12,15,46,55,-9,39
Ayr,3171,9,8,11,17,35,61,-26,35
St Mirren,3171,10,7,11,18,33,56,-23,32
Hibernian,3172,1,17,13,6,54,26,28,64
Morton,3172,2,17,13,6,50,33,17,64
Falkirk,3172,3,17,10,9,61,42,19,61
Dundee Utd,3172,4,17,8,11,52,43,9,59
Queen of S't,3172,5,12,9,15,46,55,-9,45
Dumbarton,3172,6,11,11,14,54,56,-2,44
Raith,3172,7,10,11,15,38,46,-8,41
St Mirren,3172,8,9,10,17,37,54,-17,37
Dunfermline,3172,9,7,15,14,40,52,-12,36
Ayr,3172,10,8,10,18,32,57,-25,34
Morton,3173,1,18,11,7,53,37,16,65
Hibernian,3173,2,17,13,6,57,32,25,64
Falkirk,3173,3,16,12,8,59,38,21,60
Queen of S't,3173,4,14,8,14,47,49,-2,50
Dundee Utd,3173,5,13,10,13,44,43,1,49
Dumbarton,3173,6,11,11,14,51,54,-3,44
Raith,3173,7,11,11,14,41,51,-10,44
Dunfermline,3173,8,8,15,13,45,52,-7,39
Ayr,3173,9,9,11,16,34,55,-21,38
St Mirren,3173,10,7,10,19,38,58,-20,31
Hibernian,3174,1,18,15,3,52,22,30,69
Morton,3174,2,19,12,5,54,30,24,69
Falkirk,3174,3,15,13,8,57,38,19,58
Dundee Utd,3174,4,14,11,11,49,42,7,53
Queen of S't,3174,5,13,9,14,46,49,-3,48
St Mirren,3174,6,10,10,16,40,51,-11,40
Raith,3174,7,10,10,16,35,48,-13,40
Dumbarton,3174,8,9,10,17,49,60,-11,37
Ayr,3174,9,7,14,15,33,59,-26,35
Dunfermline,3174,10,7,12,17,45,61,-16,33
Hibernian,3175,1,19,11,6,58,28,30,68
Morton,3175,2,17,12,7,51,34,17,63
Falkirk,3175,3,16,12,8,55,36,19,60
Dundee Utd,3175,4,17,8,11,52,41,11,59
Queen of S't,3175,5,14,8,14,47,48,-1,50
Dunfermline,3175,6,10,14,12,49,49,0,44
Dumbarton,3175,7,9,12,15,47,56,-9,39
Raith,3175,8,10,9,17,37,50,-13,39
Ayr,3175,9,8,10,18,33,63,-30,34
St Mirren,3175,10,7,10,19,36,60,-24,31
Falkirk,3176,1,17,11,8,62,39,23,62
Hibernian,3176,2,16,14,6,52,31,21,62
Morton,3176,3,15,14,7,48,36,12,59
Dundee Utd,3176,4,14,11,11,44,38,6,53
Queen of S't,3176,5,13,8,15,48,53,-5,47
Dunfermline,3176,6,11,13,12,50,49,1,46
St Mirren,3176,7,10,11,15,48,56,-8,41
Ayr,3176,8,9,13,14,35,54,-19,40
Raith,3176,9,9,10,17,34,50,-16,37
Dumbarton,3176,10,7,13,16,48,63,-15,34
Hibernian,3177,1,19,11,6,58,31,27,68
Morton,3177,2,18,10,8,52,36,16,64
Falkirk,3177,3,15,13,8,57,41,16,58
Dundee Utd,3177,4,15,13,8,51,40,11,58
Queen of S't,3177,5,12,11,13,46,48,-2,47
Dumbarton,3177,6,11,13,12,49,50,-1,46
Raith,3177,7,12,8,16,41,51,-10,44
St Mirren,3177,8,9,9,18,41,55,-14,36
Dunfermline,3177,9,7,14,15,40,54,-14,35
Ayr,3177,10,6,10,20,32,61,-29,28
Hibernian,3178,1,18,11,7,54,29,25,65
Morton,3178,2,16,13,7,52,37,15,61
Falkirk,3178,3,16,9,11,60,44,16,57
Dundee Utd,3178,4,14,12,10,50,42,8,54
Queen of S't,3178,5,13,9,14,51,50,1,48
Dunfermline,3178,6,10,13,13,51,52,-1,43
Raith,3178,7,11,9,16,37,52,-15,42
St Mirren,3178,8,10,11,15,45,58,-13,41
Dumbarton,3178,9,9,12,15,51,62,-11,39
Ayr,3178,10,7,13,16,37,62,-25,34
Hibernian,3179,1,19,11,6,53,27,26,68
Morton,3179,2,19,10,7,51,34,17,67
Falkirk,3179,3,18,10,8,68,43,25,64
Dundee Utd,3179,4,15,11,10,51,44,7,56
Dunfermline,3179,5,11,11,14,47,51,-4,44
Queen of S't,3179,6,11,10,15,46,51,-5,43
Ayr,3179,7,8,13,15,35,53,-18,37
Raith,3179,8,9,10,17,33,51,-18,37
St Mirren,3179,9,9,9,18,46,60,-14,36
Dumbarton,3179,10,7,13,16,48,64,-16,34
Hibernian,3180,1,20,11,5,57,26,31,71
Morton,3180,2,19,10,7,56,37,19,67
Dundee Utd,3180,3,15,12,9,47,38,9,57
Falkirk,3180,4,15,9,12,57,45,12,54
Dunfermline,3180,5,11,14,11,51,47,4,47
Raith,3180,6,11,10,15,35,49,-14,43
Queen of S't,3180,7,9,12,15,39,48,-9,39
Dumbarton,3180,8,8,14,14,53,61,-8,38
Ayr,3180,9,8,12,16,30,52,-22,36
St Mirren,3180,10,7,10,19,40,62,-22,31
Hibernian,3181,1,18,13,5,55,27,28,67
Falkirk,3181,2,18,10,8,66,41,25,64
Morton,3181,3,17,10,9,53,37,16,61
Dundee Utd,3181,4,15,9,12,49,47,2,54
Raith,3181,5,12,10,14,40,48,-8,46
Queen of S't,3181,6,12,9,15,47,53,-6,45
Dunfermline,3181,7,10,11,15,49,54,-5,41
Dumbarton,3181,8,9,12,15,50,62,-12,39
Ayr,3181,9,9,12,15,41,63,-22,39
St Mirren,3181,10,7,10,19,41,59,-18,31
Hibernian,3182,1,20,11,5,58,27,31,71
Morton,3182,2,16,10,10,47,40,7,58
Dundee Utd,3182,3,15,11,10,51,43,8,56
Falkirk,3182,4,15,10,11,57,42,15,55
Queen of S't,3182,5,12,9,15,48,50,-2,45
Raith,3182,6,11,11,14,36,45,-9,44
Dunfermline,3182,7,9,14,13,45,48,-3,41
Ayr,3182,8,10,11,15,37,54,-17,41
Dumbarton,3182,9,9,11,16,50,63,-13,38
St Mirren,3182,10,9,10,17,42,59,-17,37
Hibernian,3183,1,18,12,6,56,29,27,66
Dundee Utd,3183,2,17,10,9,52,40,12,61
Falkirk,3183,3,16,11,9,62,42,20,59
Morton,3183,4,15,12,9,47,39,8,57
Queen of S't,3183,5,11,10,15,45,53,-8,43
Dunfermline,3183,6,9,15,12,47,47,0,42
Raith,3183,7,11,9,16,42,53,-11,42
St Mirren,3183,8,10,9,17,48,65,-17,39
Dumbarton,3183,9,9,11,16,48,59,-11,38
Ayr,3183,10,9,11,16,38,58,-20,38
Hibernian,3184,1,20,11,5,58,27,31,71
Morton,3184,2,18,10,8,53,39,14,64
Dundee Utd,3184,3,16,9,11,52,44,8,57
Falkirk,3184,4,14,11,11,59,48,11,53
Queen of S't,3184,5,12,9,15,45,49,-4,45
Dunfermline,3184,6,10,14,12,46,48,-2,44
Raith,3184,7,11,10,15,38,47,-9,43
Ayr,3184,8,9,11,16,34,54,-20,38
Dumbarton,3184,9,9,10,17,48,62,-14,37
St Mirren,3184,10,9,9,18,50,65,-15,36
Hibernian,3185,1,18,12,6,57,32,25,66
Morton,3185,2,17,12,7,49,35,14,63
Dundee Utd,3185,3,17,9,10,60,42,18,60
Falkirk,3185,4,16,9,11,63,48,15,57
Queen of S't,3185,5,12,10,14,50,53,-3,46
Raith,3185,6,11,10,15,38,47,-9,43
Dunfermline,3185,7,9,13,14,41,45,-4,40
Dumbarton,3185,8,9,13,14,46,56,-10,40
Ayr,3185,9,8,13,15,36,57,-21,37
St Mirren,3185,10,6,13,17,40,65,-25,31
Dundee Utd,3186,1,19,8,9,54,37,17,65
Hibernian,3186,2,17,12,7,54,29,25,63
Falkirk,3186,3,16,11,9,59,44,15,59
Morton,3186,4,15,11,10,47,42,5,56
Dunfermline,3186,5,12,12,12,50,44,6,48
Queen of S't,3186,6,12,9,15,47,51,-4,45
Raith,3186,7,12,8,16,42,53,-11,44
Dumbarton,3186,8,9,11,16,47,61,-14,38
St Mirren,3186,9,8,12,16,38,55,-17,36
Ayr,3186,10,8,10,18,35,57,-22,34
Hibernian,3187,1,20,11,5,55,26,29,71
Morton,3187,2,18,12,6,50,31,19,66
Falkirk,3187,3,14,11,11,57,45,12,53
Dundee Utd,3187,4,14,11,11,52,45,7,53
Queen of S't,3187,5,13,10,13,53,52,1,49
Ayr,3187,6,9,14,13,40,53,-13,41
Dunfermline,3187,7,8,15,13,46,55,-9,39
Raith,3187,8,9,11,16,38,53,-15,38
St Mirren,3187,9,8,13,15,41,55,-14,37
Dumbarton,3187,10,7,12,17,44,61,-17,33
Hibernian,3188,1,19,11,6,53,26,27,68
Morton,3188,2,19,10,7,53,39,14,67
Falkirk,3188,3,18,11,7,59,35,24,65
Dundee Utd,3188,4,17,10,9,61,42,19,61
Queen of S't,3188,5,11,10,15,44,51,-7,43
Dumbarton,3188,6,9,12,15,48,62,-14,39
Raith,3188,7,9,10,17,33,48,-15,37
Dunfermline,3188,8,8,12,16,46,54,-8,36
Ayr,3188,9,7,14,15,31,51,-20,35
St Mirren,3188,10,8,10,18,39,59,-20,34
Hibernian,3189,1,18,14,4,56,27,29,68
Morton,3189,2,18,10,8,51,35,16,64
Dundee Utd,3189,3,14,11,11,50,41,9,53
Falkirk,3189,4,14,11,11,55,48,7,53
Ayr,3189,5,11,12,13,44,52,-8,45
Queen of S't,3189,6,12,9,15,42,51,-9,45
Raith,3189,7,11,10,15,37,45,-8,43
Dunfermline,3189,8,9,13,14,45,49,-4,40
Dumbarton,3189,9,9,11,16,47,59,-12,38
St Mirren,3189,10,8,11,17,37,57,-20,35
Hibernian,3190,1,20,11,5,60,27,33,71
Falkirk,3190,2,16,11,9,58,38,20,59
Dundee Utd,3190,3,16,9,11,50,40,10,57
Morton,3190,4,15,11,10,45,40,5,56
Dunfermline,3190,5,11,14,11,45,47,-2,47
Raith,3190,6,11,11,14,38,48,-10,44
Queen of S't,3190,7,11,8,17,45,57,-12,41
Ayr,3190,8,10,11,15,36,51,-15,41
Dumbarton,3190,9,9,11,16,47,59,-12,38
St Mirren,3190,10,8,9,19,39,56,-17,33
Hibernian,3191,1,20,10,6,56,27,29,70
Morton,3191,2,16,13,7,48,34,14,61
Falkirk,3191,3,16,10,10,54,39,15,58
Dundee Utd,3191,4,16,9,11,47,37,10,57
Dunfermline,3191,5,11,12,13,45,50,-5,45
Queen of S't,3191,6,12,9,15,43,50,-7,45
Dumbarton,3191,7,9,13,14,47,52,-5,40
Raith,3191,8,9,10,17,33,47,-14,37
Ayr,3191,9,8,13,15,32,53,-21,37
St Mirren,3191,10,8,11,17,37,53,-16,35
Hibernian,3192,1,19,11,6,57,30,27,68
Falkirk,3192,2,17,10,9,62,43,19,61
Morton,3192,3,17,10,9,53,41,12,61
Dundee Utd,3192,4,14,11,11,49,43,6,53
Dunfermline,3192,5,11,12,13,50,52,-2,45
Raith,3192,6,11,10,15,37,50,-13,43
Dumbarton,3192,7,10,11,15,50,60,-10,41
Queen of S't,3192,8,10,10,16,45,55,-10,40
St Mirren,3192,9,9,10,17,47,59,-12,37
Ayr,3192,10,8,13,15,35,52,-17,37
Hibernian,3193,1,21,11,4,60,25,35,74
Morton,3193,2,17,11,8,53,40,13,62
Falkirk,3193,3,16,11,9,58,41,17,59
Dundee Utd,3193,4,15,9,12,46,43,3,54
Dunfermline,3193,5,12,12,12,49,47,2,48
Raith,3193,6,11,10,15,39,50,-11,43
Queen of S't,3193,7,11,9,16,43,51,-8,42
Dumbarton,3193,8,8,13,15,47,57,-10,37
Ayr,3193,9,9,10,17,33,54,-21,37
St Mirren,3193,10,7,10,19,38,58,-20,31
Hibernian,3194,1,19,11,6,56,28,28,68
Falkirk,3194,2,18,9,9,62,40,22,63
Morton,3194,3,15,13,8,52,43,9,58
Dundee Utd,3194,4,14,11,11,45,41,4,53
Dunfermline,3194,5,12,13,11,56,49,7,49
Queen of S't,3194,6,12,10,14,48,52,-4,46
Raith,3194,7,11,11,14,37,48,-11,44
Dumbarton,3194,8,8,11,17,47,62,-15,35
St Mirren,3194,9,7,13,16,39,57,-18,34
Ayr,3194,10,7,12,17,34,56,-22,33
Hibernian,3195,1,18,15,3,50,22,28,69
Falkirk,3195,2,18,10,8,67,43,24,64
Morton,3195,3,15,12,9,45,36,9,57
Dundee Utd,3195,4,15,10,11,52,42,10,55
Dunfermline,3195,5,11,12,13,46,48,-2,45
Queen of S't,3195,6,10,11,15,43,52,-9,41
Dumbarton,3195,7,10,10,16,49,59,-10,40
Ayr,3195,8,9,13,14,35,53,-18,40
Raith,3195,9,9,11,16,34,48,-14,38
St Mirren,3195,10,7,12,17,40,58,-18,33
Hibernian,3196,1,19,14,3,58,26,32,71
Morton,3196,2,16,15,5,55,36,19,63
Falkirk,3196,3,17,11,8,66,41,25,62
Dundee Utd,3196,4,16,11,9,54,40,14,59
Queen of S't,3196,5,12,9,15,48,53,-5,45
Dunfermline,3196,6,9,12,15,46,54,-8,39
Raith,3196,7,9,10,17,33,50,-17,37
Dumbarton,3196,8,8,12,16,48,60,-12,36
Ayr,3196,9,8,11,17,35,60,-25,35
St Mirren,3196,10,7,13,16,38,61,-23,34
Hibernian,3197,1,19,12,5,58,27,31,69
Falkirk,3197,2,16,12,8,59,38,21,60
Morton,3197,3,15,14,7,51,36,15,59
Dundee Utd,3197,4,14,11,11,50,44,6,53
Queen of S't,3197,5,13,10,13,46,46,0,49
St Mirren,3197,6,10,10,16,42,54,-12,40
Raith,3197,7,10,10,16,33,46,-13,40
Dunfermline,3197,8,7,17,12,40,46,-6,38
Dumbarton,3197,9,9,11,16,46,65,-19,38
Ayr,3197,10,7,13,16,35,58,-23,34
Hibernian,3198,1,19,12,5,53,26,27,69
Morton,3198,2,17,11,8,55,38,17,62
Dundee Utd,3198,3,15,12,9,56,40,16,57
Falkirk,3198,4,14,10,12,55,43,12,52
Dunfermline,3198,5,12,12,12,49,49,0,48
Raith,3198,6,11,9,16,36,48,-12,42
Queen of S't,3198,7,11,9,16,44,57,-13,42
Ayr,3198,8,10,11,15,36,56,-20,41
St Mirren,3198,9,9,11,16,41,54,-13,38
Dumbarton,3198,10,8,11,17,46,60,-14,35
Hibernian,3199,1,20,11,5,59,27,32,71
Falkirk,3199,2,17,9,10,60,39,21,60
Morton,3199,3,16,12,8,54,41,13,60
Dundee Utd,3199,4,16,8,12,52,43,9,56
Queen of S't,3199,5,13,9,14,45,50,-5,48
Dumbarton,3199,6,11,13,12,51,53,-2,46
Dunfermline,3199,7,10,13,13,47,49,-2,43
Raith,3199,8,11,8,17,33,47,-14,41
St Mirren,3199,9,8,9,19,38,63,-25,33
Ayr,3199,10,6,12,18,31,58,-27,30
Hibernian,3200,1,20,12,4,59,25,34,72
Morton,3200,2,16,14,6,51,35,16,62
Falkirk,3200,3,16,10,10,58,40,18,58
Dundee Utd,3200,4,15,12,9,56,44,12,57
Queen of S't,3200,5,12,9,15,47,53,-6,45
Dunfermline,3200,6,10,12,14,47,49,-2,42
Ayr,3200,7,7,16,13,33,50,-17,37
Raith,3200,8,9,10,17,34,54,-20,37
Dumbarton,3200,9,8,12,16,46,63,-17,36
St Mirren,3200,10,8,11,17,37,55,-18,35
Hibernian,3201,1,19,14,3,59,24,35,71
Morton,3201,2,16,13,7,49,37,12,61
Falkirk,3201,3,16,12,8,60,39,21,60
Dundee Utd,3201,4,16,11,9,54,38,16,59
Dunfermline,3201,5,10,15,11,49,46,3,45
Queen of S't,3201,6,11,10,15,46,54,-8,43
Dumbarton,3201,7,9,11,16,50,63,-13,38
Raith,3201,8,10,8,18,34,55,-21,38
St Mirren,3201,9,8,11,17,39,54,-15,35
Ayr,3201,10,7,11,18,32,62,-30,32
Hibernian,3202,1,22,10,4,65,23,42,76
Morton,3202,2,17,9,10,56,39,17,60
Falkirk,3202,3,16,10,10,58,44,14,58
Dundee Utd,3202,4,16,9,11,51,44,7,57
Queen of S't,3202,5,11,9,16,43,50,-7,42
Ayr,3202,6,10,12,14,39,54,-15,42
Dunfermline,3202,7,9,14,13,40,49,-9,41
Raith,3202,8,10,11,15,35,50,-15,41
Dumbarton,3202,9,9,13,14,48,57,-9,40
St Mirren,3202,10,6,11,19,35,60,-25,29
Hibernian,3203,1,18,14,4,53,26,27,68
Dundee Utd,3203,2,18,10,8,53,35,18,64
Falkirk,3203,3,16,12,8,57,35,22,60
Morton,3203,4,16,12,8,51,38,13,60
Dumbarton,3203,5,10,13,13,46,52,-6,43
Queen of S't,3203,6,11,10,15,44,50,-6,43
Dunfermline,3203,7,9,13,14,44,48,-4,40
Raith,3203,8,9,9,18,31,52,-21,36
St Mirren,3203,9,7,13,16,34,49,-15,34
Ayr,3203,10,7,12,17,31,59,-28,33
Dundee Utd,3204,1,20,8,8,66,38,28,68
Morton,3204,2,19,9,8,51,38,13,66
Hibernian,3204,3,17,12,7,53,32,21,63
Falkirk,3204,4,15,12,9,59,42,17,57
Queen of S't,3204,5,12,10,14,52,56,-4,46
Raith,3204,6,12,10,14,38,44,-6,46
Dunfermline,3204,7,9,13,14,43,50,-7,40
St Mirren,3204,8,8,11,17,42,57,-15,35
Ayr,3204,9,7,12,17,35,61,-26,33
Dumbarton,3204,10,7,11,18,44,65,-21,32
Hibernian,3205,1,21,10,5,61,24,37,73
Morton,3205,2,19,10,7,56,35,21,67
Falkirk,3205,3,17,10,9,61,42,19,61
Dundee Utd,3205,4,16,10,10,55,41,14,58
Queen of S't,3205,5,12,9,15,47,53,-6,45
Dunfermline,3205,6,10,12,14,45,50,-5,42
Ayr,3205,7,8,12,16,41,60,-19,36
Raith,3205,8,9,9,18,31,61,-30,36
Dumbarton,3205,9,7,14,15,52,63,-11,35
St Mirren,3205,10,8,10,18,43,63,-20,34
Hibernian,3206,1,18,13,5,54,26,28,67
Morton,3206,2,17,11,8,52,38,14,62
Falkirk,3206,3,15,11,10,53,42,11,56
Dundee Utd,3206,4,15,10,11,48,42,6,55
Dumbarton,3206,5,11,13,12,58,56,2,46
Dunfermline,3206,6,10,13,13,46,52,-6,43
Queen of S't,3206,7,11,10,15,42,50,-8,43
Raith,3206,8,9,11,16,30,43,-13,38
Ayr,3206,9,9,11,16,34,51,-17,38
St Mirren,3206,10,8,11,17,39,56,-17,35
Morton,3207,1,20,9,7,53,35,18,69
Hibernian,3207,2,18,12,6,58,28,30,66
Falkirk,3207,3,18,9,9,60,40,20,63
Dundee Utd,3207,4,15,12,9,48,37,11,57
Dunfermline,3207,5,10,13,13,48,45,3,43
Queen of S't,3207,6,10,10,16,40,53,-13,40
Dumbarton,3207,7,9,11,16,47,58,-11,38
Raith,3207,8,9,11,16,35,51,-16,38
Ayr,3207,9,8,13,15,33,56,-23,37
St Mirren,3207,10,8,10,18,40,59,-19,34
Hibernian,3208,1,19,13,4,55,26,29,70
Falkirk,3208,2,16,10,10,58,42,16,58
Morton,3208,3,15,12,9,44,36,8,57
Dundee Utd,3208,4,13,12,11,50,46,4,51
Queen of S't,3208,5,12,10,14,48,52,-4,46
Dumbarton,3208,6,11,10,15,51,60,-9,43
Dunfermline,3208,7,9,15,12,45,46,-1,42
Raith,3208,8,10,11,15,35,44,-9,41
Ayr,3208,9,8,14,14,33,51,-18,38
St Mirren,3208,10,8,11,17,39,55,-16,35
Hibernian,3209,1,17,13,6,50,26,24,64
Falkirk,3209,2,17,9,10,60,41,19,60
Morton,3209,3,15,14,7,45,35,10,59
Dundee Utd,3209,4,14,10,12,46,43,3,52
Queen of S't,3209,5,14,9,13,48,46,2,51
Raith,3209,6,12,8,16,35,45,-10,44
Dunfermline,3209,7,10,13,13,43,48,-5,43
Ayr,3209,8,9,11,16,38,56,-18,38
Dumbarton,3209,9,8,13,15,43,55,-12,37
St Mirren,3209,10,9,10,17,42,55,-13,37
Hibernian,3210,1,19,13,4,53,24,29,70
Morton,3210,2,19,11,6,51,33,18,68
Dundee Utd,3210,3,17,10,9,53,40,13,61
Falkirk,3210,4,16,10,10,63,46,17,58
Queen of S't,3210,5,13,8,15,50,49,1,47
St Mirren,3210,6,9,12,15,42,56,-14,39
Dumbarton,3210,7,9,10,17,53,66,-13,37
Raith,3210,8,9,9,18,35,52,-17,36
Dunfermline,3210,9,7,14,15,44,55,-11,35
Ayr,3210,10,8,11,17,31,54,-23,35
Morton,3211,1,19,11,6,50,33,17,68
Hibernian,3211,2,18,12,6,49,24,25,66
Dundee Utd,3211,3,16,9,11,53,43,10,57
Falkirk,3211,4,14,10,12,53,44,9,52
Dunfermline,3211,5,11,12,13,50,49,1,45
Queen of S't,3211,6,11,11,14,45,50,-5,44
Dumbarton,3211,7,10,11,15,50,59,-9,41
Raith,3211,8,10,11,15,36,47,-11,41
Ayr,3211,9,9,12,15,34,50,-16,39
St Mirren,3211,10,7,11,18,39,60,-21,32
Hibernian,3212,1,20,11,5,56,26,30,71
Morton,3212,2,18,11,7,54,38,16,65
Falkirk,3212,3,17,11,8,62,41,21,62
Dundee Utd,3212,4,15,10,11,55,43,12,55
Queen of S't,3212,5,12,9,15,46,56,-10,45
St Mirren,3212,6,10,11,15,48,54,-6,41
Dunfermline,3212,7,9,12,15,46,52,-6,39
Raith,3212,8,9,9,18,34,52,-18,36
Ayr,3212,9,8,12,16,32,55,-23,36
Dumbarton,3212,10,7,14,15,45,61,-16,35
Hibernian,3213,1,19,11,6,54,24,30,68
Morton,3213,2,18,10,8,52,34,18,64
Falkirk,3213,3,15,12,9,53,38,15,57
Dundee Utd,3213,4,13,12,11,48,44,4,51
Queen of S't,3213,5,13,9,14,47,50,-3,48
Dunfermline,3213,6,10,12,14,42,47,-5,42
Dumbarton,3213,7,9,14,13,52,57,-5,41
Ayr,3213,8,9,14,13,39,53,-14,41
Raith,3213,9,10,8,18,33,51,-18,38
St Mirren,3213,10,7,12,17,38,60,-22,33
Hibernian,3214,1,21,11,4,60,27,33,74
Morton,3214,2,17,10,9,48,34,14,61
Falkirk,3214,3,16,12,8,62,42,20,60
Dundee Utd,3214,4,15,10,11,48,41,7,55
Dunfermline,3214,5,9,14,13,45,48,-3,41
St Mirren,3214,6,10,11,15,46,52,-6,41
Queen of S't,3214,7,10,10,16,44,56,-12,40
Raith,3214,8,10,10,16,38,51,-13,40
Dumbarton,3214,9,8,13,15,46,59,-13,37
Ayr,3214,10,7,13,16,34,61,-27,34
Hibernian,3215,1,20,12,4,58,26,32,72
Morton,3215,2,17,13,6,53,35,18,64
Falkirk,3215,3,15,11,10,57,40,17,56
Dundee Utd,3215,4,15,10,11,49,44,5,55
Raith,3215,5,11,10,15,37,47,-10,43
Queen of S't,3215,6,11,9,16,48,57,-9,42
Dunfermline,3215,7,9,13,14,49,55,-6,40
Ayr,3215,8,10,10,16,39,56,-17,40
Dumbarton,3215,9,9,12,15,50,60,-10,39
St Mirren,3215,10,8,10,18,37,57,-20,34
Hibernian,3216,1,20,12,4,53,22,31,72
Falkirk,3216,2,16,11,9,61,40,21,59
Morton,3216,3,13,14,9,43,38,5,53
Queen of S't,3216,4,14,8,14,49,49,0,50
Dundee Utd,3216,5,12,12,12,49,47,2,48
Dunfermline,3216,6,9,15,12,45,49,-4,42
Ayr,3216,7,10,12,14,38,53,-15,42
St Mirren,3216,8,10,11,15,42,55,-13,41
Raith,3216,9,11,8,17,38,52,-14,41
Dumbarton,3216,10,8,11,17,48,61,-13,35
Hibernian,3217,1,20,11,5,52,22,30,71
Dundee Utd,3217,2,17,10,9,64,42,22,61
Falkirk,3217,3,16,12,8,62,43,19,60
Morton,3217,4,14,14,8,47,33,14,56
Dunfermline,3217,5,11,13,12,48,48,0,46
Raith,3217,6,11,9,16,36,50,-14,42
Dumbarton,3217,7,9,14,13,49,61,-12,41
Queen of S't,3217,8,10,8,18,41,51,-10,38
Ayr,3217,9,8,11,17,32,60,-28,35
St Mirren,3217,10,7,12,17,39,60,-21,33
Hibernian,3218,1,20,11,5,55,28,27,71
Morton,3218,2,17,13,6,63,44,19,64
Dundee Utd,3218,3,15,10,11,50,43,7,55
Falkirk,3218,4,15,9,12,61,46,15,54
Queen of S't,3218,5,14,9,13,49,46,3,51
Dunfermline,3218,6,10,12,14,50,52,-2,42
Dumbarton,3218,7,10,11,15,49,59,-10,41
Raith,3218,8,10,10,16,40,54,-14,40
Ayr,3218,9,6,16,14,35,58,-23,34
St Mirren,3218,10,8,9,19,45,67,-22,33
Hibernian,3219,1,19,11,6,55,28,27,68
Falkirk,3219,2,18,11,7,64,38,26,65
Morton,3219,3,18,11,7,53,38,15,65
Dundee Utd,3219,4,16,8,12,52,43,9,56
Ayr,3219,5,11,11,14,43,55,-12,44
Dumbarton,3219,6,8,15,13,50,57,-7,39
Queen of S't,3219,7,10,9,17,41,53,-12,39
St Mirren,3219,8,9,10,17,40,55,-15,37
Raith,3219,9,9,10,17,31,51,-20,37
Dunfermline,3219,10,8,12,16,42,53,-11,36
Hibernian,3220,1,20,11,5,56,26,30,71
Morton,3220,2,17,9,10,51,41,10,60
Dundee Utd,3220,3,17,8,11,55,40,15,59
Falkirk,3220,4,14,13,9,54,42,12,55
Queen of S't,3220,5,12,9,15,45,48,-3,45
Dunfermline,3220,6,10,12,14,44,48,-4,42
Dumbarton,3220,7,9,13,14,53,60,-7,40
St Mirren,3220,8,10,10,16,42,59,-17,40
Ayr,3220,9,9,11,16,38,57,-19,38
Raith,3220,10,9,10,17,33,50,-17,37
Hibernian,3221,1,20,12,4,58,26,32,72
Morton,3221,2,17,14,5,51,34,17,65
Falkirk,3221,3,16,12,8,64,46,18,60
Dundee Utd,3221,4,16,10,10,52,39,13,58
Dunfermline,3221,5,10,14,12,50,48,2,44
Queen of S't,3221,6,11,9,16,46,54,-8,42
St Mirren,3221,7,9,11,16,42,56,-14,38
Ayr,3221,8,9,11,16,37,56,-19,38
Dumbarton,3221,9,8,10,18,42,61,-19,34
Raith,3221,10,8,9,19,31,53,-22,33
Hibernian,3222,1,20,11,5,58,25,33,71
Morton,3222,2,19,10,7,52,32,20,67
Dundee Utd,3222,3,17,8,11,52,38,14,59
Falkirk,3222,4,15,10,11,55,45,10,55
Queen of S't,3222,5,12,10,14,45,50,-5,46
Dunfermline,3222,6,10,12,14,42,47,-5,42
Dumbarton,3222,7,10,11,15,50,56,-6,41
Ayr,3222,8,9,11,16,39,59,-20,38
Raith,3222,9,9,10,17,30,47,-17,37
St Mirren,3222,10,7,11,18,37,61,-24,32
Morton,3223,1,17,11,8,48,36,12,62
Dundee Utd,3223,2,17,10,9,50,36,14,61
Hibernian,3223,3,15,14,7,49,29,20,59
Falkirk,3223,4,16,11,9,60,42,18,59
Queen of S't,3223,5,11,11,14,46,52,-6,44
Dunfermline,3223,6,10,12,14,44,47,-3,42
Raith,3223,7,10,12,14,37,46,-9,42
Dumbarton,3223,8,10,11,15,50,58,-8,41
St Mirren,3223,9,10,9,17,45,56,-11,39
Ayr,3223,10,8,11,17,31,58,-27,35
Hibernian,3224,1,18,12,6,58,30,28,66
Morton,3224,2,17,11,8,54,41,13,62
Falkirk,3224,3,16,11,9,56,39,17,59
Dundee Utd,3224,4,16,9,11,52,40,12,57
Queen of S't,3224,5,12,10,14,45,50,-5,46
Dunfermline,3224,6,11,11,14,44,47,-3,44
Dumbarton,3224,7,10,12,14,47,55,-8,42
St Mirren,3224,8,9,10,17,42,57,-15,37
Ayr,3224,9,8,13,15,34,54,-20,37
Raith,3224,10,9,9,18,33,52,-19,36
Hibernian,3225,1,19,12,5,55,24,31,69
Dundee Utd,3225,2,17,10,9,54,38,16,61
Morton,3225,3,16,12,8,49,35,14,60
Falkirk,3225,4,15,10,11,56,45,11,55
Dunfermline,3225,5,10,14,12,46,48,-2,44
Queen of S't,3225,6,11,10,15,45,51,-6,43
Raith,3225,7,10,11,15,36,49,-13,41
Ayr,3225,8,9,13,14,33,51,-18,40
St Mirren,3225,9,9,10,17,41,55,-14,37
Dumbarton,3225,10,7,12,17,44,63,-19,33
Morton,3226,1,20,10,6,56,36,20,70
Hibernian,3226,2,19,11,6,56,29,27,68
Dundee Utd,3226,3,15,10,11,48,40,8,55
Falkirk,3226,4,14,12,10,55,40,15,54
Queen of S't,3226,5,11,10,15,43,52,-9,43
Dunfermline,3226,6,9,14,13,47,52,-5,41
Ayr,3226,7,10,11,15,37,51,-14,41
Raith,3226,8,10,9,17,33,48,-15,39
Dumbarton,3226,9,8,14,14,45,54,-9,38
St Mirren,3226,10,8,11,17,39,57,-18,35
Hibernian,3227,1,20,12,4,56,24,32,72
Dundee Utd,3227,2,17,10,9,55,36,19,61
Falkirk,3227,3,17,9,10,58,37,21,60
Morton,3227,4,15,11,10,47,40,7,56
Queen of S't,3227,5,12,11,13,42,47,-5,47
Dunfermline,3227,6,10,11,15,46,52,-6,41
Raith,3227,7,10,10,16,34,52,-18,40
Ayr,3227,8,9,12,15,32,55,-23,39
Dumbarton,3227,9,8,13,15,42,53,-11,37
St Mirren,3227,10,7,11,18,42,58,-16,32
Hibernian,3228,1,21,12,3,56,23,33,75
Morton,3228,2,17,13,6,50,34,16,64
Falkirk,3228,3,13,13,10,56,45,11,52
Dundee Utd,3228,4,13,12,11,51,47,4,51
Queen of S't,3228,5,12,10,14,45,48,-3,46
Dunfermline,3228,6,9,14,13,44,49,-5,41
St Mirren,3228,7,9,13,14,38,47,-9,40
Dumbarton,3228,8,9,12,15,48,56,-8,39
Ayr,3228,9,7,15,14,35,54,-19,36
Raith,3228,10,9,8,19,33,53,-20,35
Hibernian,3229,1,18,13,5,57,30,27,67
Morton,3229,2,17,13,6,52,33,19,64
Falkirk,3229,3,16,12,8,57,38,19,60
Dundee Utd,3229,4,16,11,9,48,36,12,59
Queen of S't,3229,5,12,9,15,50,52,-2,45
Dumbarton,3229,6,10,12,14,53,62,-9,42
Raith,3229,7,10,9,17,34,52,-18,39
Dunfermline,3229,8,8,13,15,47,53,-6,37
Ayr,3229,9,8,12,16,36,61,-25,36
St Mirren,3229,10,8,10,18,43,60,-17,34
Morton,3230,1,17,14,5,54,33,21,65
Hibernian,3230,2,17,13,6,55,30,25,64
Falkirk,3230,3,18,9,9,59,39,20,63
Dundee Utd,3230,4,16,10,10,51,42,9,58
Raith,3230,5,11,11,14,41,49,-8,44
Dumbarton,3230,6,9,14,13,47,54,-7,41
Dunfermline,3230,7,8,16,12,46,49,-3,40
Queen of S't,3230,8,10,10,16,43,56,-13,40
Ayr,3230,9,7,13,16,31,56,-25,34
St Mirren,3230,10,6,12,18,36,55,-19,30
Hibernian,3231,1,20,11,5,52,22,30,71
Dundee Utd,3231,2,15,12,9,54,45,9,57
Falkirk,3231,3,15,10,11,56,41,15,55
Morton,3231,4,15,9,12,48,40,8,54
Queen of S't,3231,5,11,11,14,44,51,-7,44
Dumbarton,3231,6,10,13,13,49,52,-3,43
Ayr,3231,7,10,13,13,36,50,-14,43
Raith,3231,8,10,11,15,34,49,-15,41
Dunfermline,3231,9,9,13,14,44,49,-5,40
St Mirren,3231,10,8,11,17,39,57,-18,35
Hibernian,3232,1,19,13,4,55,26,29,70
Morton,3232,2,15,15,6,51,38,13,60
Falkirk,3232,3,16,10,10,63,42,21,58
Dundee Utd,3232,4,16,10,10,52,41,11,58
Queen of S't,3232,5,13,9,14,43,47,-4,48
Dumbarton,3232,6,10,12,14,51,56,-5,42
Raith,3232,7,11,9,16,38,48,-10,42
St Mirren,3232,8,8,12,16,39,58,-19,36
Ayr,3232,9,8,11,17,35,56,-21,35
Dunfermline,3232,10,7,13,16,44,59,-15,34
Hibernian,3233,1,20,11,5,63,25,38,71
Falkirk,3233,2,18,9,9,64,39,25,63
Dundee Utd,3233,3,18,8,10,52,37,15,62
Morton,3233,4,16,12,8,49,36,13,60
Dumbarton,3233,5,11,10,15,50,57,-7,43
Queen of S't,3233,6,11,9,16,45,56,-11,42
Ayr,3233,7,9,13,14,34,54,-20,40
Dunfermline,3233,8,8,12,16,44,57,-13,36
St Mirren,3233,9,9,9,18,38,57,-19,36
Raith,3233,10,9,9,18,34,55,-21,36
Hibernian,3234,1,20,11,5,59,28,31,71
Morton,3234,2,18,10,8,52,37,15,64
Dundee Utd,3234,3,16,8,12,51,42,9,56
Falkirk,3234,4,14,10,12,53,43,10,52
Queen of S't,3234,5,14,8,14,53,50,3,50
Dumbarton,3234,6,11,10,15,45,60,-15,43
Dunfermline,3234,7,9,14,13,49,50,-1,41
Raith,3234,8,10,10,16,34,46,-12,40
St Mirren,3234,9,9,11,16,44,58,-14,38
Ayr,3234,10,8,10,18,35,61,-26,34
Hibernian,3235,1,18,13,5,55,26,29,67
Morton,3235,2,15,15,6,52,34,18,60
Falkirk,3235,3,16,11,9,60,39,21,59
Dundee Utd,3235,4,15,11,10,56,46,10,56
Dunfermline,3235,5,11,13,12,46,46,0,46
Dumbarton,3235,6,11,11,14,52,57,-5,44
Queen of S't,3235,7,11,10,15,51,56,-5,43
Raith,3235,8,8,13,15,38,52,-14,37
Ayr,3235,9,7,13,16,32,57,-25,34
St Mirren,3235,10,8,10,18,39,68,-29,34
Hibernian,3236,1,19,11,6,58,28,30,68
Falkirk,3236,2,18,9,9,61,41,20,63
Morton,3236,3,17,11,8,53,39,14,62
Dundee Utd,3236,4,17,9,10,49,39,10,60
Dumbarton,3236,5,12,10,14,54,61,-7,46
Queen of S't,3236,6,12,8,16,47,50,-3,44
Raith,3236,7,9,11,16,34,47,-13,38
Dunfermline,3236,8,8,13,15,45,52,-7,37
St Mirren,3236,9,9,10,17,40,57,-17,37
Ayr,3236,10,7,12,17,30,57,-27,33
Hibernian,3237,1,19,12,5,55,24,31,69
Morton,3237,2,17,11,8,51,37,14,62
Dundee Utd,3237,3,17,10,9,46,37,9,61
Falkirk,3237,4,14,13,9,57,44,13,55
Queen of S't,3237,5,11,12,13,46,51,-5,45
Ayr,3237,6,10,11,15,37,50,-13,41
Dunfermline,3237,7,9,13,14,46,50,-4,40
St Mirren,3237,8,9,12,15,40,53,-13,39
Dumbarton,3237,9,7,14,15,44,56,-12,35
Raith,3237,10,9,8,19,36,56,-20,35
Hibernian,3238,1,18,13,5,53,26,27,67
Falkirk,3238,2,17,10,9,60,39,21,61
Dundee Utd,3238,3,17,8,11,53,42,11,59
Morton,3238,4,15,12,9,49,41,8,57
Dunfermline,3238,5,12,13,11,51,46,5,49
Queen of S't,3238,6,12,10,14,48,51,-3,46
Raith,3238,7,10,9,17,36,53,-17,39
Ayr,3238,8,9,12,15,39,57,-18,39
Dumbarton,3238,9,7,14,15,45,60,-15,35
St Mirren,3238,10,7,11,18,41,60,-19,32
Hibernian,3239,1,21,11,4,61,26,35,74
Dundee Utd,3239,2,18,9,9,55,39,16,63
Morton,3239,3,18,9,9,52,38,14,63
Falkirk,3239,4,14,12,10,54,45,9,54
Dunfermline,3239,5,11,12,13,50,50,0,45
Queen of S't,3239,6,11,9,16,47,55,-8,42
Raith,3239,7,10,8,18,37,50,-13,38
Ayr,3239,8,9,11,16,36,58,-22,38
St Mirren,3239,9,9,10,17,44,55,-11,37
Dumbarton,3239,10,8,11,17,44,64,-20,35
Hibernian,3240,1,20,10,6,59,26,33,70
Dundee Utd,3240,2,17,10,9,50,36,14,61
Morton,3240,3,16,11,9,47,40,7,59
Falkirk,3240,4,16,10,10,57,40,17,58
Dunfermline,3240,5,11,13,12,48,44,4,46
Raith,3240,6,11,11,14,36,43,-7,44
Dumbarton,3240,7,10,12,14,47,52,-5,42
Queen of S't,3240,8,11,9,16,39,49,-10,42
St Mirren,3240,9,6,13,17,36,60,-24,31
Ayr,3240,10,6,13,17,29,58,-29,31
Hibernian,3241,1,19,13,4,56,25,31,70
Morton,3241,2,17,12,7,50,35,15,63
Falkirk,3241,3,15,12,9,60,41,19,57
Dundee Utd,3241,4,15,11,10,54,43,11,56
Queen of S't,3241,5,13,10,13,49,47,2,49
Ayr,3241,6,10,13,13,35,49,-14,43
Raith,3241,7,10,10,16,33,48,-15,40
Dunfermline,3241,8,8,14,14,44,51,-7,38
St Mirren,3241,9,8,10,18,38,55,-17,34
Dumbarton,3241,10,7,11,18,43,68,-25,32
Hibernian,3242,1,16,14,6,47,26,21,62
Morton,3242,2,17,11,8,53,39,14,62
Dundee Utd,3242,3,17,10,9,56,42,14,61
Falkirk,3242,4,14,13,9,55,38,17,55
Queen of S't,3242,5,14,9,13,48,48,0,51
Raith,3242,6,12,10,14,38,45,-7,46
Dunfermline,3242,7,9,15,12,49,51,-2,42
St Mirren,3242,8,8,11,17,38,56,-18,35
Dumbarton,3242,9,8,10,18,49,64,-15,34
Ayr,3242,10,7,13,16,34,58,-24,34
Hibernian,3243,1,19,13,4,63,30,33,70
Morton,3243,2,16,12,8,50,35,15,60
Falkirk,3243,3,15,11,10,61,44,17,56
Dundee Utd,3243,4,14,11,11,42,37,5,53
Dunfermline,3243,5,10,15,11,52,51,1,45
Queen of S't,3243,6,11,10,15,48,52,-4,43
Dumbarton,3243,7,10,11,15,49,58,-9,41
Raith,3243,8,10,9,17,34,54,-20,39
St Mirren,3243,9,8,13,15,41,56,-15,37
Ayr,3243,10,8,13,15,31,54,-23,37
Hibernian,3244,1,21,12,3,58,24,34,75
Dundee Utd,3244,2,18,9,9,54,36,18,63
Morton,3244,3,14,12,10,45,39,6,54
Falkirk,3244,4,14,10,12,56,45,11,52
Raith,3244,5,11,11,14,38,47,-9,44
Dunfermline,3244,6,10,12,14,45,49,-4,42
Dumbarton,3244,7,10,12,14,53,58,-5,42
St Mirren,3244,8,10,11,15,39,50,-11,41
Queen of S't,3244,9,9,10,17,39,57,-18,37
Ayr,3244,10,7,13,16,32,54,-22,34
Hibernian,3245,1,18,15,3,56,24,32,69
Falkirk,3245,2,19,10,7,59,37,22,67
Dundee Utd,3245,3,19,8,9,55,37,18,65
Morton,3245,4,17,11,8,52,36,16,62
St Mirren,3245,5,10,10,16,42,58,-16,40
Raith,3245,6,10,8,18,37,56,-19,38
Queen of S't,3245,7,9,10,17,45,55,-10,37
Ayr,3245,8,9,10,17,34,55,-21,37
Dumbarton,3245,9,8,12,16,47,57,-10,36
Dunfermline,3245,10,8,12,16,46,58,-12,36
Hibernian,3246,1,19,13,4,57,28,29,70
Falkirk,3246,2,17,11,8,60,39,21,62
Dundee Utd,3246,3,18,8,10,57,43,14,62
Morton,3246,4,15,13,8,49,39,10,58
Dunfermline,3246,5,11,13,12,59,50,9,46
Queen of S't,3246,6,11,10,15,47,59,-12,43
Ayr,3246,7,8,13,15,41,62,-21,37
Dumbarton,3246,8,7,14,15,50,63,-13,35
St Mirren,3246,9,8,11,17,39,55,-16,35
Raith,3246,10,8,10,18,35,56,-21,34
Hibernian,3247,1,21,11,4,59,24,35,74
Falkirk,3247,2,16,10,10,57,37,20,58
Dundee Utd,3247,3,16,10,10,49,38,11,58
Morton,3247,4,14,11,11,42,36,6,53
Queen of S't,3247,5,13,9,14,49,51,-2,48
Dunfermline,3247,6,11,12,13,46,45,1,45
Raith,3247,7,12,8,16,40,52,-12,44
Dumbarton,3247,8,10,10,16,47,57,-10,40
Ayr,3247,9,7,13,16,32,55,-23,34
St Mirren,3247,10,8,10,18,37,63,-26,34
Hibernian,3248,1,22,10,4,60,20,40,76
Falkirk,3248,2,16,11,9,56,38,18,59
Dundee Utd,3248,3,15,10,11,49,39,10,55
Morton,3248,4,14,11,11,46,41,5,53
Queen of S't,3248,5,12,9,15,47,56,-9,45
Dumbarton,3248,6,11,11,14,50,58,-8,44
Raith,3248,7,11,9,16,34,49,-15,42
Dunfermline,3248,8,9,14,13,46,49,-3,41
Ayr,3248,9,9,10,17,32,55,-23,37
St Mirren,3248,10,8,11,17,37,52,-15,35
Hibernian,3249,1,20,12,4,54,22,32,72
Morton,3249,2,15,13,8,49,36,13,58
Falkirk,3249,3,15,12,9,58,41,17,57
Dundee Utd,3249,4,16,9,11,49,40,9,57
Queen of S't,3249,5,13,8,15,46,50,-4,47
Raith,3249,6,11,10,15,37,47,-10,43
Dunfermline,3249,7,10,12,14,45,52,-7,42
Dumbarton,3249,8,9,12,15,51,59,-8,39
Ayr,3249,9,8,12,16,33,55,-22,36
St Mirren,3249,10,7,12,17,38,58,-20,33
Hibernian,3250,1,18,12,6,54,27,27,66
Falkirk,3250,2,18,11,7,60,37,23,65
Morton,3250,3,17,12,7,51,40,11,63
Dundee Utd,3250,4,14,10,12,47,41,6,52
Dunfermline,3250,5,12,11,13,50,48,2,47
Dumbarton,3250,6,9,13,14,49,58,-9,40
Queen of S't,3250,7,10,10,16,42,53,-11,40
Raith,3250,8,10,9,17,35,52,-17,39
Ayr,3250,9,9,12,15,33,50,-17,39
St Mirren,3250,10,8,10,18,41,56,-15,34
Hibernian,3251,1,18,13,5,57,29,28,67
Morton,3251,2,18,11,7,57,41,16,65
Dundee Utd,3251,3,16,8,12,54,44,10,56
Falkirk,3251,4,15,10,11,55,46,9,55
Dunfermline,3251,5,10,15,11,46,43,3,45
Queen of S't,3251,6,12,8,16,44,51,-7,44
Raith,3251,7,12,8,16,38,51,-13,44
Dumbarton,3251,8,9,13,14,46,54,-8,40
Ayr,3251,9,9,12,15,39,54,-15,39
St Mirren,3251,10,6,12,18,40,63,-23,30
Hibernian,3252,1,17,14,5,54,29,25,65
Dundee Utd,3252,2,18,9,9,54,34,20,63
Morton,3252,3,16,11,9,51,38,13,59
Falkirk,3252,4,15,12,9,57,41,16,57
Raith,3252,5,13,10,13,41,43,-2,49
Dumbarton,3252,6,11,10,15,53,57,-4,43
Dunfermline,3252,7,9,13,14,40,50,-10,40
Queen of S't,3252,8,10,9,17,39,52,-13,39
Ayr,3252,9,9,11,16,30,52,-22,38
St Mirren,3252,10,6,13,17,36,59,-23,31
Hibernian,3253,1,21,10,5,59,23,36,73
Dundee Utd,3253,2,18,9,9,57,38,19,63
Morton,3253,3,17,12,7,52,39,13,63
Falkirk,3253,4,17,9,10,56,42,14,60
Queen of S't,3253,5,11,9,16,44,54,-10,42
Ayr,3253,6,10,10,16,40,53,-13,40
Dumbarton,3253,7,9,11,16,48,63,-15,38
Dunfermline,3253,8,8,13,15,43,52,-9,37
Raith,3253,9,9,10,17,33,51,-18,37
St Mirren,3253,10,8,11,17,39,56,-17,35
Hibernian,3254,1,21,11,4,67,30,37,74
Dundee Utd,3254,2,16,12,8,54,40,14,60
Morton,3254,3,15,12,9,45,38,7,57
Falkirk,3254,4,14,10,12,55,45,10,52
Dunfermline,3254,5,10,13,13,50,51,-1,43
Dumbarton,3254,6,10,13,13,49,54,-5,43
Ayr,3254,7,9,13,14,42,56,-14,40
Raith,3254,8,10,10,16,35,50,-15,40
Queen of S't,3254,9,9,10,17,43,57,-14,37
St Mirren,3254,10,9,10,17,39,58,-19,37
Hibernian,3255,1,18,11,7,54,26,28,65
Dundee Utd,3255,2,18,10,8,54,39,15,64
Falkirk,3255,3,15,11,10,57,44,13,56
Morton,3255,4,15,10,11,48,47,1,55
Dumbarton,3255,5,12,11,13,53,53,0,47
Queen of S't,3255,6,12,10,14,44,48,-4,46
Dunfermline,3255,7,10,12,14,46,49,-3,42
Raith,3255,8,11,9,16,35,45,-10,42
St Mirren,3255,9,9,10,17,41,57,-16,37
Ayr,3255,10,8,10,18,33,57,-24,34
Hibernian,3256,1,19,13,4,55,25,30,70
Dundee Utd,3256,2,19,8,9,56,41,15,65
Falkirk,3256,3,17,11,8,62,38,24,62
Morton,3256,4,16,11,9,49,34,15,59
Queen of S't,3256,5,12,9,15,48,57,-9,45
Dunfermline,3256,6,10,12,14,43,47,-4,42
Dumbarton,3256,7,10,12,14,49,57,-8,42
Raith,3256,8,10,10,16,34,48,-14,40
Ayr,3256,9,7,12,17,36,57,-21,33
St Mirren,3256,10,6,10,20,34,62,-28,28
Hibernian,3257,1,20,11,5,61,28,33,71
Morton,3257,2,17,11,8,52,38,14,62
Dundee Utd,3257,3,16,11,9,52,36,16,59
Falkirk,3257,4,16,10,10,57,41,16,58
Dunfermline,3257,5,12,13,11,47,44,3,49
Raith,3257,6,10,10,16,36,51,-15,40
Dumbarton,3257,7,9,11,16,48,62,-14,38
Queen of S't,3257,8,9,10,17,41,55,-14,37
St Mirren,3257,9,9,10,17,40,55,-15,37
Ayr,3257,10,7,13,16,31,55,-24,34
Hibernian,3258,1,21,11,4,59,24,35,74
Morton,3258,2,17,12,7,47,35,12,63
Dundee Utd,3258,3,15,11,10,53,44,9,56
Falkirk,3258,4,14,11,11,53,41,12,53
Queen of S't,3258,5,13,8,15,46,49,-3,47
Dunfermline,3258,6,11,11,14,47,48,-1,44
Raith,3258,7,10,10,16,36,48,-12,40
Ayr,3258,8,9,12,15,34,56,-22,39
Dumbarton,3258,9,7,13,16,41,55,-14,34
St Mirren,3258,10,7,13,16,36,52,-16,34
Hibernian,3259,1,18,12,6,54,27,27,66
Morton,3259,2,17,11,8,50,35,15,62
Falkirk,3259,3,16,9,11,58,45,13,57
Dundee Utd,3259,4,15,9,12,51,49,2,54
Dunfermline,3259,5,13,11,12,52,46,6,50
Queen of S't,3259,6,12,10,14,46,51,-5,46
Raith,3259,7,11,10,15,35,49,-14,43
Ayr,3259,8,10,12,14,43,51,-8,42
Dumbarton,3259,9,7,13,16,45,62,-17,34
St Mirren,3259,10,7,11,18,36,55,-19,32
Hibernian,3260,1,18,14,4,58,28,30,68
Morton,3260,2,17,12,7,50,35,15,63
Dundee Utd,3260,3,16,9,11,51,41,10,57
Falkirk,3260,4,14,11,11,55,50,5,53
Dunfermline,3260,5,11,12,13,48,45,3,45
Raith,3260,6,11,11,14,35,45,-10,44
Queen of S't,3260,7,10,11,15,43,53,-10,41
Dumbarton,3260,8,10,10,16,54,62,-8,40
St Mirren,3260,9,10,9,17,44,54,-10,39
Ayr,3260,10,7,13,16,33,58,-25,34
Hibernian,3261,1,18,13,5,53,26,27,67
Dundee Utd,3261,2,17,11,8,51,36,15,62
Falkirk,3261,3,16,10,10,62,44,18,58
Morton,3261,4,15,11,10,45,40,5,56
Raith,3261,5,13,9,14,41,48,-7,48
Dunfermline,3261,6,11,13,12,54,48,6,46
Queen of S't,3261,7,11,10,15,47,55,-8,43
Dumbarton,3261,8,9,12,15,49,61,-12,39
Ayr,3261,9,7,12,17,34,56,-22,33
St Mirren,3261,10,7,11,18,37,59,-22,32
Hibernian,3262,1,20,12,4,58,25,33,72
Morton,3262,2,18,9,9,50,36,14,63
Dundee Utd,3262,3,17,8,11,51,38,13,59
Falkirk,3262,4,15,11,10,54,39,15,56
Queen of S't,3262,5,12,8,16,47,58,-11,44
Dunfermline,3262,6,10,11,15,48,55,-7,41
Ayr,3262,7,9,13,14,42,54,-12,40
Dumbarton,3262,8,9,12,15,48,58,-10,39
Raith,3262,9,10,9,17,34,49,-15,39
St Mirren,3262,10,9,9,18,39,59,-20,36
Hibernian,3263,1,17,15,4,58,27,31,66
Morton,3263,2,16,12,8,52,41,11,60
Falkirk,3263,3,16,11,9,58,40,18,59
Dundee Utd,3263,4,16,9,11,48,39,9,57
Dunfermline,3263,5,11,12,13,48,49,-1,45
Raith,3263,6,11,10,15,38,48,-10,43
Dumbarton,3263,7,9,13,14,50,59,-9,40
Queen of S't,3263,8,10,9,17,43,55,-12,39
St Mirren,3263,9,9,11,16,39,55,-16,38
Ayr,3263,10,7,14,15,32,53,-21,35
Hibernian,3264,1,18,13,5,53,24,29,67
Falkirk,3264,2,17,9,10,59,36,23,60
Dundee Utd,3264,3,17,9,10,53,37,16,60
Morton,3264,4,16,12,8,48,36,12,60
Queen of S't,3264,5,11,10,15,42,54,-12,43
Dumbarton,3264,6,9,13,14,49,57,-8,40
Dunfermline,3264,7,8,15,13,40,50,-10,39
St Mirren,3264,8,10,9,17,40,53,-13,39
Raith,3264,9,10,9,17,33,51,-18,39
Ayr,3264,10,8,13,15,36,55,-19,37
Hibernian,3265,1,22,11,3,57,22,35,77
Morton,3265,2,17,12,7,46,33,13,63
Falkirk,3265,3,15,11,10,57,42,15,56
Dundee Utd,3265,4,15,11,10,46,37,9,56
Queen of S't,3265,5,12,10,14,48,51,-3,46
Dumbarton,3265,6,10,12,14,48,57,-9,42
St Mirren,3265,7,9,10,17,38,52,-14,37
Dunfermline,3265,8,8,12,16,46,53,-7,36
Ayr,3265,9,8,12,16,36,52,-16,36
Raith,3265,10,9,9,18,32,55,-23,36
Hibernian,3266,1,21,10,5,58,23,35,73
Morton,3266,2,16,10,10,50,41,9,58
Falkirk,3266,3,14,12,10,54,39,15,54
Dundee Utd,3266,4,14,11,11,54,49,5,53
Queen of S't,3266,5,12,10,14,42,46,-4,46
Dunfermline,3266,6,11,12,13,46,50,-4,45
St Mirren,3266,7,10,10,16,44,54,-10,40
Raith,3266,8,10,10,16,32,47,-15,40
Ayr,3266,9,9,13,14,37,54,-17,40
Dumbarton,3266,10,8,12,16,47,61,-14,36
Hibernian,3267,1,19,11,6,57,26,31,68
Morton,3267,2,18,13,5,53,35,18,67
Falkirk,3267,3,16,10,10,55,41,14,58
Dundee Utd,3267,4,15,10,11,47,39,8,55
Dumbarton,3267,5,11,11,14,51,56,-5,44
Queen of S't,3267,6,12,8,16,44,51,-7,44
Dunfermline,3267,7,10,12,14,44,49,-5,42
Raith,3267,8,10,11,15,34,47,-13,41
St Mirren,3267,9,8,11,17,38,53,-15,35
Ayr,3267,10,6,13,17,31,57,-26,31
Hibernian,3268,1,20,11,5,55,27,28,71
Morton,3268,2,16,12,8,50,36,14,60
Dundee Utd,3268,3,17,9,10,50,40,10,60
Falkirk,3268,4,15,13,8,57,42,15,58
Dunfermline,3268,5,9,14,13,50,53,-3,41
Dumbarton,3268,6,10,11,15,49,57,-8,41
Queen of S't,3268,7,10,11,15,46,54,-8,41
Raith,3268,8,10,10,16,39,52,-13,40
Ayr,3268,9,9,12,15,37,55,-18,39
St Mirren,3268,10,7,11,18,39,56,-17,32
Hibernian,3269,1,18,13,5,53,24,29,67
Morton,3269,2,18,11,7,49,32,17,65
Falkirk,3269,3,16,9,11,56,42,14,57
Dundee Utd,3269,4,14,9,13,47,43,4,51
Dunfermline,3269,5,11,12,13,46,47,-1,45
Queen of S't,3269,6,12,8,16,44,49,-5,44
Raith,3269,7,10,11,15,34,47,-13,41
Ayr,3269,8,9,14,13,38,53,-15,41
St Mirren,3269,9,10,10,16,41,55,-14,40
Dumbarton,3269,10,8,11,17,44,60,-16,35
Hibernian,3270,1,19,12,5,54,26,28,69
Morton,3270,2,18,9,9,51,34,17,63
Falkirk,3270,3,16,11,9,60,40,20,59
Dundee Utd,3270,4,16,10,10,53,41,12,58
Queen of S't,3270,5,13,10,13,49,49,0,49
Dunfermline,3270,6,12,11,13,55,49,6,47
Ayr,3270,7,8,13,15,36,57,-21,37
St Mirren,3270,8,8,12,16,39,55,-16,36
Raith,3270,9,8,10,18,32,58,-26,34
Dumbarton,3270,10,7,12,17,44,64,-20,33
Hibernian,3271,1,18,14,4,54,26,28,68
Morton,3271,2,17,11,8,50,36,14,62
Falkirk,3271,3,15,11,10,54,39,15,56
Dundee Utd,3271,4,14,12,10,44,37,7,54
Queen of S't,3271,5,11,10,15,46,53,-7,43
Dunfermline,3271,6,9,15,12,46,46,0,42
Raith,3271,7,10,12,14,35,44,-9,42
Ayr,3271,8,10,11,15,33,50,-17,41
Dumbarton,3271,9,8,12,16,45,58,-13,36
St Mirren,3271,10,8,12,16,37,55,-18,36
Hibernian,3272,1,18,13,5,56,24,32,67
Morton,3272,2,18,12,6,49,33,16,66
Falkirk,3272,3,17,11,8,61,38,23,62
Dundee Utd,3272,4,15,10,11,48,40,8,55
Raith,3272,5,11,10,15,37,50,-13,43
Queen of S't,3272,6,11,9,16,45,53,-8,42
Dunfermline,3272,7,9,14,13,48,54,-6,41
St Mirren,3272,8,8,12,16,38,52,-14,36
Dumbarton,3272,9,8,12,16,45,60,-15,36
Ayr,3272,10,8,11,17,32,55,-23,35
Hibernian,3273,1,19,10,7,54,32,22,67
Falkirk,3273,2,17,11,8,63,38,25,62
Morton,3273,3,17,10,9,57,37,20,61
Dundee Utd,3273,4,15,10,11,45,40,5,55
Dumbarton,3273,5,11,11,14,51,58,-7,44
Dunfermline,3273,6,10,12,14,45,49,-4,42
Queen of S't,3273,7,11,9,16,43,54,-11,42
Raith,3273,8,10,11,15,36,48,-12,41
Ayr,3273,9,9,12,15,35,53,-18,39
St Mirren,3273,10,7,12,17,36,56,-20,33
Hibernian,3274,1,17,12,7,55,26,29,63
Falkirk,3274,2,17,10,9,57,38,19,61
Dundee Utd,3274,3,15,12,9,51,40,11,57
Morton,3274,4,14,15,7,45,35,10,57
Dunfermline,3274,5,12,13,11,44,41,3,49
Queen of S't,3274,6,12,9,15,46,45,1,45
Raith,3274,7,10,9,17,33,49,-16,39
Dumbarton,3274,8,9,11,16,49,62,-13,38
St Mirren,3274,9,8,13,15,42,61,-19,37
Ayr,3274,10,7,14,15,34,59,-25,35
Hibernian,3275,1,19,11,6,59,30,29,68
Falkirk,3275,2,18,10,8,64,42,22,64
Morton,3275,3,17,9,10,49,38,11,60
Dunfermline,3275,4,11,13,12,48,47,1,46
Queen of S't,3275,5,12,10,14,48,54,-6,46
Dundee Utd,3275,6,12,8,16,45,51,-6,44
Raith,3275,7,10,11,15,38,51,-13,41
Ayr,3275,8,10,11,15,38,55,-17,41
Dumbarton,3275,9,10,10,16,49,60,-11,40
St Mirren,3275,10,10,9,17,46,56,-10,39
Dundee Utd,3276,1,17,9,10,52,37,15,60
Morton,3276,2,16,12,8,49,36,13,60
Hibernian,3276,3,15,14,7,50,31,19,59
Falkirk,3276,4,16,11,9,59,42,17,59
Dunfermline,3276,5,12,12,12,48,50,-2,48
Queen of S't,3276,6,11,9,16,44,52,-8,42
Dumbarton,3276,7,10,10,16,46,56,-10,40
Raith,3276,8,10,10,16,37,51,-14,40
St Mirren,3276,9,10,9,17,43,57,-14,39
Ayr,3276,10,9,12,15,34,50,-16,39
Hibernian,3277,1,19,13,4,61,27,34,70
Falkirk,3277,2,17,10,9,60,40,20,61
Morton,3277,3,15,15,6,49,37,12,60
Dundee Utd,3277,4,16,10,10,57,40,17,58
Dunfermline,3277,5,11,12,13,48,49,-1,45
St Mirren,3277,6,10,10,16,41,53,-12,40
Raith,3277,7,10,10,16,34,52,-18,40
Queen of S't,3277,8,10,9,17,41,54,-13,39
Ayr,3277,9,8,12,16,34,55,-21,36
Dumbarton,3277,10,8,11,17,45,63,-18,35
Hibernian,3278,1,18,14,4,52,26,26,68
Morton,3278,2,18,12,6,55,34,21,66
Falkirk,3278,3,17,11,8,64,40,24,62
Dundee Utd,3278,4,17,9,10,46,37,9,60
Queen of S't,3278,5,11,10,15,43,51,-8,43
Dunfermline,3278,6,9,15,12,44,46,-2,42
Raith,3278,7,10,9,17,34,52,-18,39
St Mirren,3278,8,9,11,16,45,55,-10,38
Ayr,3278,9,8,10,18,34,58,-24,34
Dumbarton,3278,10,7,11,18,41,59,-18,32
Hibernian,3279,1,20,11,5,60,26,34,71
Morton,3279,2,17,12,7,54,37,17,63
Dundee Utd,3279,3,15,13,8,58,42,16,58
Falkirk,3279,4,15,10,11,64,53,11,55
Dunfermline,3279,5,10,15,11,48,48,0,45
Queen of S't,3279,6,11,12,13,44,50,-6,45
Dumbarton,3279,7,10,12,14,50,57,-7,42
Raith,3279,8,9,10,17,34,58,-24,37
St Mirren,3279,9,8,11,17,40,55,-15,35
Ayr,3279,10,6,12,18,36,62,-26,30
Hibernian,3280,1,18,13,5,57,29,28,67
Morton,3280,2,16,11,9,50,38,12,59
Dundee Utd,3280,3,16,8,12,48,44,4,56
Falkirk,3280,4,15,10,11,57,43,14,55
Raith,3280,5,13,8,15,37,47,-10,47
Dunfermline,3280,6,11,13,12,47,45,2,46
Queen of S't,3280,7,12,10,14,50,52,-2,46
Dumbarton,3280,8,9,11,16,49,60,-11,38
St Mirren,3280,9,8,12,16,39,54,-15,36
Ayr,3280,10,8,12,16,32,54,-22,36
Hibernian,3281,1,18,11,7,56,29,27,65
Morton,3281,2,18,10,8,51,33,18,64
Falkirk,3281,3,17,11,8,62,40,22,62
Dundee Utd,3281,4,16,11,9,51,38,13,59
Queen of S't,3281,5,13,11,12,52,46,6,50
Ayr,3281,6,10,12,14,33,50,-17,42
Dunfermline,3281,7,9,13,14,45,52,-7,40
Raith,3281,8,8,11,17,31,53,-22,35
Dumbarton,3281,9,7,13,16,45,66,-21,34
St Mirren,3281,10,7,11,18,39,58,-19,32
Hibernian,3282,1,18,11,7,59,34,25,65
Morton,3282,2,18,10,8,55,38,17,64
Falkirk,3282,3,16,11,9,57,41,16,59
Dundee Utd,3282,4,16,9,11,52,40,12,57
Dunfermline,3282,5,9,14,13,42,47,-5,41
Queen of S't,3282,6,10,11,15,41,50,-9,41
St Mirren,3282,7,9,13,14,47,56,-9,40
Raith,3282,8,9,12,15,33,50,-17,39
Dumbarton,3282,9,9,11,16,46,56,-10,38
Ayr,3282,10,8,14,14,36,56,-20,38
Morton,3283,1,19,11,6,52,33,19,68
Hibernian,3283,2,18,12,6,51,28,23,66
Falkirk,3283,3,16,13,7,61,39,22,61
Dundee Utd,3283,4,15,10,11,47,41,6,55
Dumbarton,3283,5,10,13,13,50,53,-3,43
Queen of S't,3283,6,11,9,16,43,53,-10,42
Dunfermline,3283,7,9,13,14,46,51,-5,40
Ayr,3283,8,8,15,13,35,53,-18,39
Raith,3283,9,9,10,17,36,52,-16,37
St Mirren,3283,10,7,10,19,39,57,-18,31
Hibernian,3284,1,22,10,4,59,23,36,76
Dundee Utd,3284,2,16,10,10,50,38,12,58
Falkirk,3284,3,15,11,10,57,41,16,56
Morton,3284,4,14,11,11,43,39,4,53
Dunfermline,3284,5,11,14,11,47,44,3,47
Queen of S't,3284,6,13,8,15,51,55,-4,47
Raith,3284,7,11,9,16,36,48,-12,42
Dumbarton,3284,8,9,12,15,50,64,-14,39
St Mirren,3284,9,9,10,17,43,56,-13,37
Ayr,3284,10,7,11,18,31,59,-28,32
Morton,3285,1,18,11,7,47,30,17,65
Falkirk,3285,2,18,10,8,60,40,20,64
Hibernian,3285,3,16,15,5,45,21,24,63
Dundee Utd,3285,4,13,10,13,44,41,3,49
Queen of S't,3285,5,12,10,14,47,46,1,46
Dunfermline,3285,6,11,11,14,45,49,-4,44
Ayr,3285,7,10,13,13,36,49,-13,43
Raith,3285,8,11,9,16,32,47,-15,42
Dumbarton,3285,9,8,11,17,47,63,-16,35
St Mirren,3285,10,8,10,18,42,59,-17,34
Hibernian,3286,1,21,11,4,62,27,35,74
Morton,3286,2,17,11,8,52,38,14,62
Dundee Utd,3286,3,17,9,10,47,39,8,60
Falkirk,3286,4,16,9,11,61,47,14,57
Dunfermline,3286,5,11,12,13,48,49,-1,45
Raith,3286,6,12,8,16,41,47,-6,44
Queen of S't,3286,7,11,9,16,42,54,-12,42
St Mirren,3286,8,9,10,17,37,54,-17,37
Dumbarton,3286,9,8,12,16,47,62,-15,36
Ayr,3286,10,7,11,18,32,52,-20,32
Hibernian,3287,1,18,12,6,52,25,27,66
Morton,3287,2,18,12,6,47,30,17,66
Falkirk,3287,3,17,11,8,57,37,20,62
Dundee Utd,3287,4,14,10,12,47,39,8,52
Queen of S't,3287,5,11,10,15,42,47,-5,43
Dumbarton,3287,6,11,10,15,48,55,-7,43
Dunfermline,3287,7,9,14,13,40,45,-5,41
Raith,3287,8,10,10,16,35,48,-13,40
Ayr,3287,9,9,12,15,35,55,-20,39
St Mirren,3287,10,7,11,18,36,58,-22,32
Morton,3288,1,17,12,7,51,34,17,63
Hibernian,3288,2,17,11,8,49,36,13,62
Dundee Utd,3288,3,16,11,9,50,38,12,59
Falkirk,3288,4,16,10,10,61,43,18,58
Dunfermline,3288,5,12,13,11,50,46,4,49
Raith,3288,6,12,9,15,40,44,-4,45
Queen of S't,3288,7,11,10,15,45,53,-8,43
Dumbarton,3288,8,9,11,16,47,61,-14,38
Ayr,3288,9,9,11,16,31,50,-19,38
St Mirren,3288,10,6,12,18,37,56,-19,30
Hibernian,3289,1,20,11,5,57,25,32,71
Dundee Utd,3289,2,16,11,9,54,41,13,59
Morton,3289,3,16,10,10,50,40,10,58
Falkirk,3289,4,15,9,12,60,50,10,54
Queen of S't,3289,5,13,9,14,50,55,-5,48
Dunfermline,3289,6,10,13,13,51,52,-1,43
Ayr,3289,7,10,12,14,39,53,-14,42
Raith,3289,8,11,9,16,38,52,-14,42
St Mirren,3289,9,8,11,17,41,56,-15,35
Dumbarton,3289,10,8,11,17,47,63,-16,35
Hibernian,3290,1,21,10,5,63,27,36,73
Morton,3290,2,19,10,7,59,38,21,67
Dundee Utd,3290,3,15,11,10,51,41,10,56
Falkirk,3290,4,14,11,11,55,50,5,53
Queen of S't,3290,5,12,10,14,45,49,-4,46
Raith,3290,6,10,12,14,39,49,-10,42
St Mirren,3290,7,10,10,16,44,53,-9,40
Dunfermline,3290,8,9,11,16,51,60,-9,38
Dumbarton,3290,9,8,12,16,45,59,-14,36
Ayr,3290,10,7,13,16,30,56,-26,34
Hibernian,3291,1,19,12,5,58,27,31,69
Dundee Utd,3291,2,17,9,10,53,38,15,60
Morton,3291,3,15,12,9,46,35,11,57
Falkirk,3291,4,15,10,11,57,48,9,55
Dunfermline,3291,5,11,11,14,46,49,-3,44
Dumbarton,3291,6,11,11,14,53,59,-6,44
Raith,3291,7,11,10,15,38,48,-10,43
Queen of S't,3291,8,11,9,16,46,56,-10,42
Ayr,3291,9,9,12,15,36,56,-20,39
St Mirren,3291,10,8,10,18,44,61,-17,34
Morton,3292,1,18,11,7,54,31,23,65
Hibernian,3292,2,17,13,6,49,27,22,64
Dundee Utd,3292,3,18,10,8,57,38,19,64
Falkirk,3292,4,17,12,7,61,35,26,63
Queen of S't,3292,5,11,10,15,45,53,-8,43
Dunfermline,3292,6,10,12,14,49,51,-2,42
Raith,3292,7,10,9,17,32,53,-21,39
St Mirren,3292,8,9,9,18,44,58,-14,36
Ayr,3292,9,8,12,16,30,59,-29,36
Dumbarton,3292,10,8,10,18,45,61,-16,34
Hibernian,3293,1,20,13,3,62,26,36,73
Falkirk,3293,2,17,10,9,60,40,20,61
Morton,3293,3,16,13,7,49,33,16,61
Dundee Utd,3293,4,14,9,13,44,42,2,51
Queen of S't,3293,5,12,8,16,46,57,-11,44
Ayr,3293,6,10,12,14,35,49,-14,42
Dunfermline,3293,7,8,14,14,43,49,-6,38
Raith,3293,8,9,11,16,39,52,-13,38
Dumbarton,3293,9,9,11,16,49,64,-15,38
St Mirren,3293,10,9,11,16,41,56,-15,38
Hibernian,3294,1,20,12,4,58,20,38,72
Morton,3294,2,16,12,8,54,42,12,60
Falkirk,3294,3,16,9,11,60,46,14,57
Dundee Utd,3294,4,14,11,11,49,44,5,53
Dunfermline,3294,5,11,12,13,45,48,-3,45
Raith,3294,6,11,9,16,37,49,-12,42
Queen of S't,3294,7,11,8,17,45,54,-9,41
St Mirren,3294,8,10,11,15,44,54,-10,41
Dumbarton,3294,9,9,12,15,49,60,-11,39
Ayr,3294,10,8,12,16,34,58,-24,36
Hibernian,3295,1,21,12,3,60,21,39,75
Morton,3295,2,18,10,8,50,34,16,64
Dundee Utd,3295,3,17,10,9,51,39,12,61
Falkirk,3295,4,14,12,10,50,42,8,54
Dumbarton,3295,5,11,10,15,51,54,-3,43
Raith,3295,6,11,10,15,37,45,-8,43
Dunfermline,3295,7,9,15,12,45,48,-3,42
Queen of S't,3295,8,9,10,17,42,56,-14,37
Ayr,3295,9,7,12,17,32,60,-28,33
St Mirren,3295,10,7,11,18,39,58,-19,32
Morton,3296,1,19,10,7,54,36,18,67
Hibernian,3296,2,18,11,7,57,31,26,65
Falkirk,3296,3,17,11,8,62,38,24,62
Dundee Utd,3296,4,15,9,12,48,46,2,54
Dunfermline,3296,5,11,12,13,50,51,-1,45
Queen of S't,3296,6,10,12,14,47,53,-6,42
Ayr,3296,7,9,13,14,36,52,-16,40
Raith,3296,8,10,10,16,34,51,-17,40
St Mirren,3296,9,9,11,16,42,51,-9,38
Dumbarton,3296,10,7,11,18,48,69,-21,32
Hibernian,3297,1,19,11,6,52,26,26,68
Falkirk,3297,2,17,9,10,59,44,15,60
Dundee Utd,3297,3,16,9,11,48,39,9,57
Morton,3297,4,14,13,9,45,36,9,55
Dunfermline,3297,5,11,13,12,53,50,3,46
Dumbarton,3297,6,10,13,13,48,51,-3,43
St Mirren,3297,7,10,10,16,38,51,-13,40
Queen of S't,3297,8,9,12,15,40,49,-9,39
Raith,3297,9,10,9,17,31,48,-17,39
Ayr,3297,10,9,11,16,32,52,-20,38
Hibernian,3298,1,17,14,5,51,27,24,65
Morton,3298,2,16,13,7,52,37,15,61
Dundee Utd,3298,3,16,11,9,53,36,17,59
Falkirk,3298,4,16,10,10,58,40,18,58
Queen of S't,3298,5,12,10,14,45,46,-1,46
Raith,3298,6,11,11,14,36,45,-9,44
Dunfermline,3298,7,10,13,13,47,49,-2,43
Dumbarton,3298,8,9,11,16,51,67,-16,38
Ayr,3298,9,7,14,15,30,55,-25,35
St Mirren,3298,10,7,11,18,39,60,-21,32
Hibernian,3299,1,20,13,3,57,25,32,73
Morton,3299,2,17,12,7,51,38,13,63
Falkirk,3299,3,15,13,8,62,42,20,58
Dundee Utd,3299,4,14,13,9,52,43,9,55
Raith,3299,5,11,10,15,37,47,-10,43
Queen of S't,3299,6,11,9,16,49,53,-4,42
Dunfermline,3299,7,9,14,13,44,51,-7,41
Dumbarton,3299,8,7,14,15,50,63,-13,35
St Mirren,3299,9,8,11,17,42,60,-18,35
Ayr,3299,10,8,11,17,32,54,-22,35
Hibernian,3300,1,18,13,5,53,26,27,67
Morton,3300,2,17,12,7,52,38,14,63
Dundee Utd,3300,3,16,11,9,49,39,10,59
Falkirk,3300,4,14,13,9,56,41,15,55
Queen of S't,3300,5,12,9,15,48,55,-7,45
Ayr,3300,6,9,13,14,36,54,-18,40
Dumbarton,3300,7,8,15,13,52,60,-8,39
Raith,3300,8,10,9,17,34,49,-15,39
St Mirren,3300,9,9,11,16,42,54,-12,38
Dunfermline,3300,10,8,12,16,44,50,-6,36
Hibernian,3301,1,20,11,5,55,24,31,71
Morton,3301,2,16,11,9,47,38,9,59
Dundee Utd,3301,3,16,10,10,50,38,12,58
Falkirk,3301,4,13,13,10,53,41,12,52
Queen of S't,3301,5,12,10,14,43,45,-2,46
Dunfermline,3301,6,10,14,12,47,46,1,44
Raith,3301,7,11,11,14,33,44,-11,44
Dumbarton,3301,8,9,12,15,46,54,-8,39
Ayr,3301,9,8,12,16,35,58,-23,36
St Mirren,3301,10,7,12,17,36,57,-21,33
Hibernian,3302,1,20,11,5,57,27,30,71
Dundee Utd,3302,2,18,10,8,52,36,16,64
Morton,3302,3,16,13,7,49,37,12,61
Falkirk,3302,4,14,11,11,52,41,11,53
Queen of S't,3302,5,13,9,14,47,47,0,48
Raith,3302,6,11,10,15,40,47,-7,43
Dumbarton,3302,7,10,10,16,48,56,-8,40
Dunfermline,3302,8,9,13,14,47,55,-8,40
St Mirren,3302,9,8,10,18,37,55,-18,34
Ayr,3302,10,7,11,18,30,58,-28,32
Hibernian,3303,1,19,13,4,54,26,28,70
Dundee Utd,3303,2,18,9,9,55,37,18,63
Morton,3303,3,16,11,9,50,47,3,59
Falkirk,3303,4,15,11,10,58,40,18,56
Queen of S't,3303,5,13,9,14,50,50,0,48
Dunfermline,3303,6,10,14,12,47,47,0,44
Raith,3303,7,10,10,16,34,48,-14,40
Dumbarton,3303,8,8,12,16,46,61,-15,36
St Mirren,3303,9,9,9,18,43,58,-15,36
Ayr,3303,10,7,12,17,31,54,-23,33
Hibernian,3304,1,19,12,5,55,26,29,69
Morton,3304,2,15,14,7,48,36,12,59
Falkirk,3304,3,15,11,10,60,44,16,56
Dundee Utd,3304,4,14,11,11,51,45,6,53
Queen of S't,3304,5,12,12,12,43,44,-1,48
Dunfermline,3304,6,11,14,11,50,47,3,47
St Mirren,3304,7,9,11,16,43,56,-13,38
Ayr,3304,8,9,11,16,33,54,-21,38
Raith,3304,9,9,10,17,31,51,-20,37
Dumbarton,3304,10,8,12,16,51,62,-11,36
Hibernian,3305,1,18,11,7,51,29,22,65
Dundee Utd,3305,2,17,10,9,51,39,12,61
Falkirk,3305,3,15,12,9,55,39,16,57
Morton,3305,4,15,9,12,47,41,6,54
Dunfermline,3305,5,11,14,11,50,49,1,47
Queen of S't,3305,6,11,11,14,47,51,-4,44
Raith,3305,7,10,10,16,37,49,-12,40
Ayr,3305,8,9,13,14,35,52,-17,40
St Mirren,3305,9,9,12,15,40,51,-11,39
Dumbarton,3305,10,8,12,16,50,63,-13,36
Hibernian,3306,1,19,13,4,55,26,29,70
Dundee Utd,3306,2,17,10,9,56,37,19,61
Morton,3306,3,16,12,8,54,39,15,60
Falkirk,3306,4,16,10,10,57,41,16,58
Queen of S't,3306,5,13,9,14,51,51,0,48
Dunfermline,3306,6,9,14,13,44,51,-7,41
Dumbarton,3306,7,10,11,15,52,62,-10,41
Raith,3306,8,9,13,14,33,49,-16,40
Ayr,3306,9,7,12,17,33,57,-24,33
St Mirren,3306,10,6,12,18,37,59,-22,30
Hibernian,3307,1,20,11,5,56,27,29,71
Morton,3307,2,17,11,8,49,37,12,62
Falkirk,3307,3,16,11,9,60,43,17,59
Dundee Utd,3307,4,16,9,11,47,37,10,57
Dunfermline,3307,5,13,13,10,53,45,8,52
Queen of S't,3307,6,10,10,16,43,54,-11,40
Ayr,3307,7,9,11,16,36,56,-20,38
Dumbarton,3307,8,8,13,15,49,60,-11,37
St Mirren,3307,9,9,10,17,41,54,-13,37
Raith,3307,10,8,9,19,31,52,-21,33
Hibernian,3308,1,21,11,4,58,25,33,74
Morton,3308,2,15,13,8,48,38,10,58
Dundee Utd,3308,3,15,11,10,48,39,9,56
Falkirk,3308,4,15,10,11,54,47,7,55
Queen of S't,3308,5,12,10,14,44,48,-4,46
Dunfermline,3308,6,8,15,13,48,49,-1,39
Raith,3308,7,9,12,15,34,48,-14,39
Dumbarton,3308,8,9,11,16,48,59,-11,38
St Mirren,3308,9,9,11,16,42,54,-12,38
Ayr,3308,10,8,14,14,34,51,-17,38
Hibernian,3309,1,18,13,5,54,26,28,67
Morton,3309,2,15,11,10,49,40,9,56
Falkirk,3309,3,14,11,11,58,49,9,53
Dundee Utd,3309,4,15,8,13,49,43,6,53
Queen of S't,3309,5,14,9,13,51,51,0,51
Ayr,3309,6,10,13,13,38,53,-15,43
Dumbarton,3309,7,10,12,14,49,53,-4,42
Dunfermline,3309,8,10,11,15,49,54,-5,41
Raith,3309,9,10,11,15,38,52,-14,41
St Mirren,3309,10,8,13,15,40,54,-14,37
Hibernian,3310,1,20,10,6,58,27,31,70
Falkirk,3310,2,16,11,9,61,44,17,59
Morton,3310,3,14,15,7,50,40,10,57
Dundee Utd,3310,4,14,12,10,49,43,6,54
Queen of S't,3310,5,13,9,14,53,50,3,48
Dunfermline,3310,6,11,13,12,51,51,0,46
Dumbarton,3310,7,11,12,13,52,56,-4,45
Raith,3310,8,10,10,16,36,53,-17,40
St Mirren,3310,9,7,12,17,40,59,-19,33
Ayr,3310,10,6,12,18,32,59,-27,30
Hibernian,3311,1,17,15,4,50,26,24,66
Falkirk,3311,2,17,11,8,59,37,22,62
Morton,3311,3,14,13,9,48,39,9,55
Dundee Utd,3311,4,14,9,13,47,43,4,51
Queen of S't,3311,5,14,9,13,51,50,1,51
Raith,3311,6,11,10,15,37,46,-9,43
Dumbarton,3311,7,10,11,15,49,58,-9,41
St Mirren,3311,8,10,10,16,42,52,-10,40
Ayr,3311,9,9,11,16,33,58,-25,38
Dunfermline,3311,10,8,13,15,43,50,-7,37
Hibernian,3312,1,19,12,5,57,29,28,69
Falkirk,3312,2,17,11,8,58,37,21,62
Dundee Utd,3312,3,15,13,8,50,35,15,58
Morton,3312,4,15,13,8,49,39,10,58
Queen of S't,3312,5,12,10,14,42,46,-4,46
Dumbarton,3312,6,9,12,15,49,58,-9,39
St Mirren,3312,7,9,12,15,44,55,-11,39
Raith,3312,8,10,8,18,34,53,-19,38
Dunfermline,3312,9,8,13,15,41,52,-11,37
Ayr,3312,10,8,12,16,34,54,-20,36
Hibernian,3313,1,20,13,3,59,23,36,73
Morton,3313,2,17,12,7,55,37,18,63
Falkirk,3313,3,16,11,9,58,42,16,59
Dundee Utd,3313,4,16,10,10,50,38,12,58
Dunfermline,3313,5,10,12,14,47,55,-8,42
Queen of S't,3313,6,11,9,16,44,52,-8,42
Dumbarton,3313,7,10,11,15,54,61,-7,41
Raith,3313,8,10,9,17,33,55,-22,39
St Mirren,3313,9,8,11,17,40,54,-14,35
Ayr,3313,10,7,12,17,34,57,-23,33
Hibernian,3314,1,17,14,5,52,26,26,65
Falkirk,3314,2,17,10,9,62,43,19,61
Morton,3314,3,16,13,7,50,38,12,61
Dundee Utd,3314,4,15,11,10,50,41,9,56
Queen of S't,3314,5,13,10,13,50,51,-1,49
Dunfermline,3314,6,10,13,13,46,47,-1,43
Raith,3314,7,10,10,16,34,52,-18,40
Dumbarton,3314,8,9,11,16,51,61,-10,38
St Mirren,3314,9,9,11,16,48,59,-11,38
Ayr,3314,10,7,11,18,33,58,-25,32
Hibernian,3315,1,21,10,5,60,28,32,73
Dundee Utd,3315,2,16,11,9,51,35,16,59
Morton,3315,3,15,10,11,48,41,7,55
Falkirk,3315,4,13,11,12,53,44,9,50
Dunfermline,3315,5,12,13,11,52,49,3,49
Queen of S't,3315,6,11,12,13,44,46,-2,45
Dumbarton,3315,7,10,11,15,45,57,-12,41
Ayr,3315,8,9,12,15,32,50,-18,39
Raith,3315,9,9,10,17,34,48,-14,37
St Mirren,3315,10,9,10,17,39,60,-21,37
Hibernian,3316,1,20,10,6,60,28,32,70
Falkirk,3316,2,16,11,9,60,41,19,59
Morton,3316,3,15,11,10,51,47,4,56
Dundee Utd,3316,4,14,12,10,50,43,7,54
Queen of S't,3316,5,13,8,15,48,48,0,47
Dunfermline,3316,6,11,12,13,45,48,-3,45
Dumbarton,3316,7,10,13,13,53,56,-3,43
St Mirren,3316,8,10,9,17,43,56,-13,39
Raith,3316,9,10,9,17,35,57,-22,39
Ayr,3316,10,7,13,16,36,57,-21,34
Hibernian,3317,1,19,12,5,53,25,28,69
Morton,3317,2,18,12,6,52,34,18,66
Falkirk,3317,3,17,11,8,59,42,17,62
Dundee Utd,3317,4,15,10,11,50,40,10,55
Queen of S't,3317,5,13,10,13,48,46,2,49
Dunfermline,3317,6,8,15,13,47,49,-2,39
Dumbarton,3317,7,8,12,16,47,63,-16,36
St Mirren,3317,8,9,9,18,38,54,-16,36
Ayr,3317,9,8,12,16,32,56,-24,36
Raith,3317,10,8,11,17,33,50,-17,35
Hibernian,3318,1,18,11,7,51,29,22,65
Morton,3318,2,18,10,8,57,34,23,64
Dundee Utd,3318,3,17,8,11,54,45,9,59
Falkirk,3318,4,15,11,10,56,40,16,56
Queen of S't,3318,5,13,10,13,52,52,0,49
Dunfermline,3318,6,11,13,12,48,47,1,46
Ayr,3318,7,10,12,14,37,51,-14,42
Raith,3318,8,10,9,17,33,49,-16,39
Dumbarton,3318,9,8,11,17,46,61,-15,35
St Mirren,3318,10,7,11,18,36,62,-26,32
Hibernian,3319,1,19,12,5,59,29,30,69
Morton,3319,2,16,12,8,49,39,10,60
Falkirk,3319,3,16,10,10,55,42,13,58
Dundee Utd,3319,4,16,10,10,50,38,12,58
Queen of S't,3319,5,12,9,15,50,52,-2,45
Dunfermline,3319,6,9,16,11,47,47,0,43
Ayr,3319,7,9,12,15,33,53,-20,39
St Mirren,3319,8,9,11,16,46,54,-8,38
Dumbarton,3319,9,9,11,16,50,64,-14,38
Raith,3319,10,9,9,18,35,56,-21,36
Hibernian,3320,1,20,12,4,61,25,36,72
Falkirk,3320,2,17,12,7,59,39,20,63
Morton,3320,3,15,12,9,51,43,8,57
Dundee Utd,3320,4,15,10,11,48,43,5,55
Queen of S't,3320,5,11,9,16,45,53,-8,42
Ayr,3320,6,10,11,15,39,49,-10,41
Raith,3320,7,10,11,15,33,50,-17,41
Dunfermline,3320,8,9,13,14,43,48,-5,40
St Mirren,3320,9,9,10,17,41,54,-13,37
Dumbarton,3320,10,7,14,15,44,60,-16,35
Hibernian,3321,1,19,12,5,55,24,31,69
Morton,3321,2,15,14,7,47,34,13,59
Falkirk,3321,3,15,12,9,59,44,15,57
Dundee Utd,3321,4,14,11,11,51,46,5,53
Queen of S't,3321,5,12,9,15,45,46,-1,45
Raith,3321,6,12,9,15,34,45,-11,45
Dunfermline,3321,7,10,13,13,47,49,-2,43
Dumbarton,3321,8,8,13,15,50,62,-12,37
Ayr,3321,9,8,13,15,34,54,-20,37
St Mirren,3321,10,8,12,16,39,57,-18,36
Hibernian,3322,1,16,14,6,52,35,17,62
Falkirk,3322,2,16,12,8,60,38,22,60
Dundee Utd,3322,3,15,12,9,46,36,10,57
Morton,3322,4,14,14,8,47,38,9,56
Dunfermline,3322,5,11,13,12,51,51,0,46
Queen of S't,3322,6,10,13,13,46,47,-1,43
Raith,3322,7,10,11,15,36,48,-12,41
Dumbarton,3322,8,8,14,14,43,55,-12,38
St Mirren,3322,9,9,11,16,41,53,-12,38
Ayr,3322,10,7,14,15,32,53,-21,35
Hibernian,3323,1,21,10,5,60,23,37,73
Falkirk,3323,2,19,9,8,63,36,27,66
Morton,3323,3,17,11,8,49,37,12,62
Dundee Utd,3323,4,14,9,13,48,44,4,51
Queen of S't,3323,5,12,9,15,44,50,-6,45
Dunfermline,3323,6,9,14,13,44,47,-3,41
Ayr,3323,7,9,12,15,34,52,-18,39
Raith,3323,8,9,11,16,32,46,-14,38
Dumbarton,3323,9,9,11,16,45,60,-15,38
St Mirren,3323,10,8,10,18,37,61,-24,34
Hibernian,3324,1,18,13,5,57,26,31,67
Morton,3324,2,17,11,8,47,35,12,62
Falkirk,3324,3,16,11,9,62,43,19,59
Dundee Utd,3324,4,16,9,11,52,41,11,57
Queen of S't,3324,5,12,9,15,45,51,-6,45
Dumbarton,3324,6,11,11,14,53,59,-6,44
Dunfermline,3324,7,8,15,13,43,47,-4,39
Raith,3324,8,9,11,16,32,47,-15,38
Ayr,3324,9,8,14,14,36,57,-21,38
St Mirren,3324,10,8,10,18,43,64,-21,34
Hibernian,3325,1,21,11,4,62,25,37,74
Morton,3325,2,15,15,6,50,37,13,60
Falkirk,3325,3,15,10,11,60,50,10,55
Dundee Utd,3325,4,14,11,11,48,42,6,53
Queen of S't,3325,5,11,10,15,43,47,-4,43
Ayr,3325,6,11,10,15,38,56,-18,43
Dunfermline,3325,7,9,14,13,46,49,-3,41
Dumbarton,3325,8,9,13,14,50,56,-6,40
Raith,3325,9,10,9,17,39,52,-13,39
St Mirren,3325,10,8,11,17,38,60,-22,35
Hibernian,3326,1,19,11,6,53,28,25,68
Morton,3326,2,16,13,7,49,32,17,61
Dundee Utd,3326,3,16,11,9,55,44,11,59
Falkirk,3326,4,15,11,10,62,45,17,56
Dumbarton,3326,5,10,12,14,51,57,-6,42
Queen of S't,3326,6,11,9,16,45,55,-10,42
Raith,3326,7,10,11,15,39,49,-10,41
Dunfermline,3326,8,9,12,15,42,55,-13,39
St Mirren,3326,9,9,11,16,41,55,-14,38
Ayr,3326,10,8,13,15,38,55,-17,37
Hibernian,3327,1,17,11,8,52,33,19,62
Dundee Utd,3327,2,17,10,9,55,39,16,61
Morton,3327,3,16,12,8,53,38,15,60
Falkirk,3327,4,15,11,10,55,41,14,56
Raith,3327,5,12,10,14,40,47,-7,46
Queen of S't,3327,6,11,10,15,41,49,-8,43
St Mirren,3327,7,10,10,16,41,53,-12,40
Dunfermline,3327,8,8,15,13,44,47,-3,39
Dumbarton,3327,9,8,14,14,48,62,-14,38
Ayr,3327,10,8,13,15,35,55,-20,37
Hibernian,3328,1,20,11,5,59,28,31,71
Dundee Utd,3328,2,18,10,8,53,34,19,64
Morton,3328,3,17,10,9,55,42,13,61
Falkirk,3328,4,15,10,11,60,48,12,55
Queen of S't,3328,5,12,10,14,46,50,-4,46
Dunfermline,3328,6,10,11,15,49,50,-1,41
Dumbarton,3328,7,9,14,13,51,60,-9,41
St Mirren,3328,8,9,11,16,46,57,-11,38
Raith,3328,9,9,9,18,36,58,-22,36
Ayr,3328,10,7,12,17,32,60,-28,33
Hibernian,3329,1,21,12,3,55,20,35,75
Dundee Utd,3329,2,18,9,9,48,34,14,63
Falkirk,3329,3,17,10,9,58,40,18,61
Morton,3329,4,16,12,8,47,36,11,60
Dumbarton,3329,5,10,13,13,47,52,-5,43
Queen of S't,3329,6,11,9,16,45,55,-10,42
Raith,3329,7,10,9,17,35,48,-13,39
Ayr,3329,8,9,10,17,34,54,-20,37
Dunfermline,3329,9,7,13,16,41,52,-11,34
St Mirren,3329,10,7,11,18,35,54,-19,32
Hibernian,3330,1,18,14,4,57,25,32,68
Falkirk,3330,2,17,12,7,61,39,22,63
Morton,3330,3,17,12,7,49,32,17,63
Dundee Utd,3330,4,12,11,13,43,44,-1,47
Queen of S't,3330,5,13,8,15,44,48,-4,47
Dunfermline,3330,6,11,13,12,48,43,5,46
St Mirren,3330,7,10,10,16,46,57,-11,40
Raith,3330,8,9,10,17,34,50,-16,37
Dumbarton,3330,9,8,12,16,42,61,-19,36
Ayr,3330,10,8,12,16,30,55,-25,36
Hibernian,3331,1,18,13,5,55,29,26,67
Morton,3331,2,18,11,7,50,34,16,65
Falkirk,3331,3,16,11,9,61,43,18,59
Dundee Utd,3331,4,14,13,9,50,38,12,55
Queen of S't,3331,5,11,9,16,47,51,-4,42
Dumbarton,3331,6,10,12,14,49,59,-10,42
Raith,3331,7,11,9,16,37,49,-12,42
Ayr,3331,8,9,11,16,37,57,-20,38
Dunfermline,3331,9,8,13,15,44,54,-10,37
St Mirren,3331,10,8,12,16,42,58,-16,36
Hibernian,3332,1,21,11,4,62,26,36,74
Morton,3332,2,17,11,8,48,36,12,62
Falkirk,3332,3,16,11,9,60,42,18,59
Dundee Utd,3332,4,16,9,11,54,42,12,57
Raith,3332,5,11,12,13,39,46,-7,45
Dumbarton,3332,6,10,12,14,53,55,-2,42
Queen of S't,3332,7,9,12,15,47,57,-10,39
Dunfermline,3332,8,8,14,14,45,51,-6,38
St Mirren,3332,9,8,10,18,42,66,-24,34
Ayr,3332,10,6,14,16,36,65,-29,32
Hibernian,3333,1,19,13,4,57,28,29,70
Morton,3333,2,19,10,7,51,32,19,67
Falkirk,3333,3,14,11,11,54,45,9,53
Dundee Utd,3333,4,14,10,12,49,46,3,52
Ayr,3333,5,11,11,14,39,53,-14,44
Dunfermline,3333,6,10,12,14,48,52,-4,42
Queen of S't,3333,7,11,9,16,48,58,-10,42
St Mirren,3333,8,10,10,16,46,55,-9,40
Dumbarton,3333,9,9,12,15,48,58,-10,39
Raith,3333,10,10,8,18,39,52,-13,38
Hibernian,3334,1,19,11,6,65,29,36,68
Dundee Utd,3334,2,17,10,9,57,43,14,61
Morton,3334,3,16,12,8,53,41,12,60
Falkirk,3334,4,15,11,10,60,48,12,56
Dunfermline,3334,5,10,15,11,48,48,0,45
Queen of S't,3334,6,11,10,15,43,50,-7,43
Raith,3334,7,11,10,15,41,56,-15,43
St Mirren,3334,8,8,12,16,39,54,-15,36
Ayr,3334,9,8,12,16,40,58,-18,36
Dumbarton,3334,10,7,13,16,46,65,-19,34
Hibernian,3335,1,19,11,6,53,27,26,68
Dundee Utd,3335,2,19,8,9,54,39,15,65
Morton,3335,3,16,11,9,52,38,14,59
Falkirk,3335,4,16,10,10,62,45,17,58
Dunfermline,3335,5,11,12,13,50,49,1,45
Queen of S't,3335,6,11,10,15,44,51,-7,43
Dumbarton,3335,7,10,11,15,46,55,-9,41
Raith,3335,8,11,8,17,35,52,-17,41
St Mirren,3335,9,10,9,17,40,53,-13,39
Ayr,3335,10,7,10,19,34,61,-27,31
Hibernian,3336,1,18,14,4,59,29,30,68
Falkirk,3336,2,18,10,8,58,39,19,64
Morton,3336,3,17,10,9,49,37,12,61
Dundee Utd,3336,4,14,8,14,46,43,3,50
Queen of S't,3336,5,12,10,14,44,47,-3,46
Dunfermline,3336,6,10,13,13,49,50,-1,43
Raith,3336,7,11,10,15,34,45,-11,43
Dumbarton,3336,8,10,11,15,54,66,-12,41
Ayr,3336,9,8,12,16,38,57,-19,36
St Mirren,3336,10,8,10,18,37,55,-18,34
Hibernian,3337,1,22,10,4,63,25,38,76
Morton,3337,2,17,11,8,51,36,15,62
Dundee Utd,3337,3,16,11,9,48,38,10,59
Falkirk,3337,4,16,10,10,57,43,14,58
Dunfermline,3337,5,11,11,14,48,51,-3,44
Dumbarton,3337,6,10,12,14,50,58,-8,42
Raith,3337,7,9,11,16,35,50,-15,38
Queen of S't,3337,8,9,10,17,45,57,-12,37
St Mirren,3337,9,9,9,18,40,56,-16,36
Ayr,3337,10,7,13,16,34,57,-23,34
Hibernian,3338,1,20,12,4,59,26,33,72
Morton,3338,2,18,11,7,56,35,21,65
Falkirk,3338,3,17,10,9,55,37,18,61
Dundee Utd,3338,4,15,10,11,50,39,11,55
Queen of S't,3338,5,12,8,16,46,49,-3,44
Dumbarton,3338,6,11,11,14,48,55,-7,44
Dunfermline,3338,7,8,14,14,38,50,-12,38
St Mirren,3338,8,9,10,17,43,63,-20,37
Ayr,3338,9,8,13,15,35,55,-20,37
Raith,3338,10,8,9,19,34,55,-21,33
Morton,3339,1,16,14,6,52,34,18,62
Dundee Utd,3339,2,17,10,9,54,40,14,61
Hibernian,3339,3,16,12,8,51,32,19,60
Falkirk,3339,4,14,11,11,56,44,12,53
Queen of S't,3339,5,13,9,14,45,46,-1,48
Dunfermline,3339,6,11,12,13,51,53,-2,45
Ayr,3339,7,9,13,14,34,53,-19,40
Dumbarton,3339,8,9,12,15,45,55,-10,39
Raith,3339,9,9,11,16,35,50,-15,38
St Mirren,3339,10,8,12,16,38,54,-16,36
Hibernian,3340,1,19,12,5,58,29,29,69
Dundee Utd,3340,2,16,11,9,44,33,11,59
Morton,3340,3,14,14,8,47,37,10,56
Falkirk,3340,4,15,10,11,57,43,14,55
Queen of S't,3340,5,11,10,15,49,59,-10,43
Ayr,3340,6,10,13,13,37,50,-13,43
Dunfermline,3340,7,9,14,13,48,50,-2,41
Raith,3340,8,10,10,16,37,51,-14,40
St Mirren,3340,9,8,14,14,43,55,-12,38
Dumbarton,3340,10,8,12,16,44,57,-13,36
Hibernian,3341,1,18,11,7,51,29,22,65
Morton,3341,2,17,11,8,52,34,18,62
Dundee Utd,3341,3,16,11,9,57,42,15,59
Falkirk,3341,4,15,12,9,60,45,15,57
Queen of S't,3341,5,13,9,14,44,46,-2,48
Raith,3341,6,11,10,15,37,48,-11,43
Dunfermline,3341,7,9,13,14,47,52,-5,40
Dumbarton,3341,8,8,14,14,47,61,-14,38
Ayr,3341,9,8,13,15,35,55,-20,37
St Mirren,3341,10,6,14,16,40,58,-18,32
Hibernian,3342,1,22,10,4,62,25,37,76
Dundee Utd,3342,2,18,9,9,56,39,17,63
Morton,3342,3,17,11,8,54,39,15,62
Falkirk,3342,4,16,10,10,56,41,15,58
Dunfermline,3342,5,10,14,12,47,50,-3,44
Queen of S't,3342,6,10,11,15,43,52,-9,41
Ayr,3342,7,9,11,16,35,57,-22,38
Dumbarton,3342,8,9,10,17,46,57,-11,37
Raith,3342,9,9,9,18,36,59,-23,36
St Mirren,3342,10,8,9,19,38,54,-16,33
Hibernian,3343,1,20,13,3,55,22,33,73
Morton,3343,2,17,13,6,55,38,17,64
Dundee Utd,3343,3,16,11,9,50,38,12,59
Falkirk,3343,4,14,10,12,54,47,7,52
Dumbarton,3343,5,10,13,13,50,57,-7,43
Queen of S't,3343,6,10,12,14,44,48,-4,42
Raith,3343,7,11,9,16,37,48,-11,42
Ayr,3343,8,9,13,14,37,52,-15,40
Dunfermline,3343,9,8,12,16,43,52,-9,36
St Mirren,3343,10,6,12,18,38,61,-23,30
Hibernian,3344,1,19,13,4,59,26,33,70
Morton,3344,2,18,13,5,51,32,19,67
Dundee Utd,3344,3,18,9,9,55,33,22,63
Falkirk,3344,4,15,9,12,54,45,9,54
Queen of S't,3344,5,12,10,14,47,48,-1,46
Dumbarton,3344,6,10,12,14,47,56,-9,42
Dunfermline,3344,7,9,12,15,43,51,-8,39
St Mirren,3344,8,9,9,18,41,57,-16,36
Raith,3344,9,9,9,18,31,54,-23,36
Ayr,3344,10,7,12,17,32,58,-26,33
Hibernian,3345,1,18,15,3,56,27,29,69
Dundee Utd,3345,2,18,8,10,54,38,16,62
Morton,3345,3,16,10,10,47,36,11,58
Falkirk,3345,4,15,12,9,59,41,18,57
Dunfermline,3345,5,10,13,13,44,48,-4,43
Dumbarton,3345,6,11,10,15,46,56,-10,43
Ayr,3345,7,10,12,14,36,51,-15,42
Queen of S't,3345,8,10,11,15,39,47,-8,41
Raith,3345,9,9,10,17,38,55,-17,37
St Mirren,3345,10,8,9,19,38,58,-20,33
Hibernian,3346,1,19,13,4,51,22,29,70
Dundee Utd,3346,2,17,10,9,50,39,11,61
Falkirk,3346,3,16,10,10,56,42,14,58
Morton,3346,4,15,13,8,47,37,10,58
Dumbarton,3346,5,12,11,13,53,54,-1,47
Raith,3346,6,11,10,15,36,47,-11,43
Dunfermline,3346,7,9,14,13,49,49,0,41
Queen of S't,3346,8,10,10,16,40,51,-11,40
Ayr,3346,9,8,11,17,34,54,-20,35
St Mirren,3346,10,6,12,18,32,53,-21,30
Hibernian,3347,1,21,11,4,59,23,36,74
Falkirk,3347,2,16,12,8,59,38,21,60
Morton,3347,3,16,11,9,48,39,9,59
Dundee Utd,3347,4,16,10,10,48,37,11,58
Raith,3347,5,11,10,15,37,49,-12,43
Queen of S't,3347,6,11,9,16,41,52,-11,42
Dumbarton,3347,7,9,14,13,46,53,-7,41
St Mirren,3347,8,8,12,16,43,57,-14,36
Ayr,3347,9,8,12,16,37,58,-21,36
Dunfermline,3347,10,7,13,16,39,51,-12,34
Hibernian,3348,1,20,12,4,55,25,30,72
Dundee Utd,3348,2,18,9,9,54,39,15,63
Morton,3348,3,17,11,8,51,37,14,62
Falkirk,3348,4,14,12,10,55,40,15,54
Queen of S't,3348,5,13,10,13,51,49,2,49
Dunfermline,3348,6,9,13,14,44,54,-10,40
Dumbarton,3348,7,8,13,15,48,60,-12,37
Raith,3348,8,9,10,17,37,51,-14,37
St Mirren,3348,9,8,12,16,41,54,-13,36
Ayr,3348,10,6,14,16,32,59,-27,32
Hibernian,3349,1,21,12,3,59,20,39,75
Morton,3349,2,15,12,9,50,41,9,57
Falkirk,3349,3,15,11,10,55,36,19,56
Dundee Utd,3349,4,15,11,10,46,41,5,56
Dunfermline,3349,5,10,14,12,42,42,0,44
Queen of S't,3349,6,10,12,14,39,45,-6,42
Dumbarton,3349,7,9,12,15,47,60,-13,39
Ayr,3349,8,9,12,15,34,56,-22,39
St Mirren,3349,9,9,10,17,42,54,-12,37
Raith,3349,10,9,10,17,30,49,-19,37
Hibernian,3350,1,19,12,5,54,27,27,69
Morton,3350,2,18,10,8,56,41,15,64
Falkirk,3350,3,16,12,8,63,42,21,60
Dundee Utd,3350,4,16,9,11,57,45,12,57
Queen of S't,3350,5,12,9,15,48,51,-3,45
Dunfermline,3350,6,11,11,14,52,53,-1,44
St Mirren,3350,7,10,9,17,46,57,-11,39
Ayr,3350,8,9,12,15,37,60,-23,39
Raith,3350,9,9,11,16,31,48,-17,38
Dumbarton,3350,10,7,11,18,48,68,-20,32
Hibernian,3351,1,18,10,8,57,30,27,64
Morton,3351,2,17,10,9,49,37,12,61
Dundee Utd,3351,3,17,9,10,53,41,12,60
Falkirk,3351,4,14,14,8,55,39,16,56
Queen of S't,3351,5,12,9,15,46,51,-5,45
Dumbarton,3351,6,11,11,14,46,53,-7,44
Dunfermline,3351,7,10,13,13,42,46,-4,43
Raith,3351,8,11,10,15,36,46,-10,43
St Mirren,3351,9,8,12,16,38,54,-16,36
Ayr,3351,10,8,10,18,29,54,-25,34
Hibernian,3352,1,18,14,4,55,25,30,68
Dundee Utd,3352,2,18,10,8,52,33,19,64
Morton,3352,3,15,12,9,46,37,9,57
Falkirk,3352,4,15,11,10,56,39,17,56
Raith,3352,5,12,11,13,40,46,-6,47
Dunfermline,3352,6,11,13,12,47,49,-2,46
Queen of S't,3352,7,9,11,16,38,50,-12,38
Dumbarton,3352,8,7,15,14,42,52,-10,36
Ayr,3352,9,7,14,15,31,52,-21,35
St Mirren,3352,10,7,11,18,36,60,-24,32
Hibernian,3353,1,19,12,5,57,25,32,69
Dundee Utd,3353,2,16,11,9,50,37,13,59
Morton,3353,3,15,12,9,47,38,9,57
Falkirk,3353,4,15,11,10,56,44,12,56
Dunfermline,3353,5,12,13,11,48,43,5,49
Ayr,3353,6,11,10,15,39,52,-13,43
Queen of S't,3353,7,11,8,17,43,53,-10,41
Raith,3353,8,10,10,16,35,46,-11,40
Dumbarton,3353,9,9,11,16,49,64,-15,38
St Mirren,3353,10,8,10,18,39,61,-22,34
Hibernian,3354,1,20,12,4,53,21,32,72
Morton,3354,2,17,12,7,47,35,12,63
Dundee Utd,3354,3,17,8,11,55,39,16,59
Falkirk,3354,4,16,9,11,64,44,20,57
Dunfermline,3354,5,11,12,13,50,44,6,45
Queen of S't,3354,6,11,9,16,44,53,-9,42
Ayr,3354,7,10,11,15,33,52,-19,41
Dumbarton,3354,8,9,11,16,50,60,-10,38
Raith,3354,9,9,11,16,30,49,-19,38
St Mirren,3354,10,8,9,19,38,67,-29,33
Hibernian,3355,1,21,12,3,59,24,35,75
Falkirk,3355,2,16,12,8,62,43,19,60
Morton,3355,3,16,12,8,50,35,15,60
Dundee Utd,3355,4,16,8,12,50,41,9,56
Queen of S't,3355,5,13,9,14,50,53,-3,48
Dunfermline,3355,6,9,14,13,49,50,-1,41
Ayr,3355,7,10,10,16,35,55,-20,40
Dumbarton,3355,8,9,11,16,46,60,-14,38
Raith,3355,9,9,9,18,35,55,-20,36
St Mirren,3355,10,8,9,19,37,57,-20,33
Hibernian,3356,1,20,10,6,59,28,31,70
Dundee Utd,3356,2,17,9,10,55,39,16,60
Morton,3356,3,17,9,10,48,37,11,60
Falkirk,3356,4,15,10,11,62,52,10,55
Dunfermline,3356,5,12,11,13,47,46,1,47
Dumbarton,3356,6,11,11,14,53,61,-8,44
St Mirren,3356,7,11,10,15,46,53,-7,43
Queen of S't,3356,8,10,11,15,44,53,-9,41
Raith,3356,9,9,9,18,33,53,-20,36
Ayr,3356,10,7,12,17,34,59,-25,33
Hibernian,3357,1,18,13,5,52,25,27,67
Morton,3357,2,18,11,7,54,33,21,65
Dundee Utd,3357,3,17,9,10,58,46,12,60
Falkirk,3357,4,15,12,9,54,38,16,57
Queen of S't,3357,5,11,11,14,49,53,-4,44
Dumbarton,3357,6,10,12,14,49,59,-10,42
Dunfermline,3357,7,8,14,14,47,54,-7,38
Ayr,3357,8,9,11,16,40,59,-19,38
Raith,3357,9,8,13,15,32,48,-16,37
St Mirren,3357,10,8,10,18,37,57,-20,34
Hibernian,3358,1,19,11,6,54,30,24,68
Morton,3358,2,17,12,7,52,36,16,63
Falkirk,3358,3,16,10,10,54,41,13,58
Dundee Utd,3358,4,15,10,11,49,39,10,55
Dunfermline,3358,5,12,12,12,48,43,5,48
Queen of S't,3358,6,11,10,15,43,50,-7,43
Dumbarton,3358,7,10,12,14,46,57,-11,42
Raith,3358,8,10,10,16,40,50,-10,40
Ayr,3358,9,7,13,16,34,56,-22,34
St Mirren,3358,10,7,12,17,39,57,-18,33
Hibernian,3359,1,19,11,6,57,25,32,68
Morton,3359,2,16,14,6,48,33,15,62
Dundee Utd,3359,3,17,10,9,48,33,15,61
Falkirk,3359,4,16,10,10,59,44,15,58
Queen of S't,3359,5,12,10,14,43,45,-2,46
Dunfermline,3359,6,10,12,14,45,50,-5,42
Ayr,3359,7,9,12,15,31,49,-18,39
Raith,3359,8,9,11,16,33,50,-17,38
Dumbarton,3359,9,8,12,16,48,63,-15,36
St Mirren,3359,10,7,12,17,36,56,-20,33
Hibernian,3360,1,18,14,4,50,23,27,68
Morton,3360,2,16,11,9,51,38,13,59
Falkirk,3360,3,15,11,10,56,43,13,56
Dundee Utd,3360,4,15,10,11,49,43,6,55
Dunfermline,3360,5,12,12,12,47,46,1,48
Raith,3360,6,11,10,15,40,50,-10,43
Ayr,3360,7,10,12,14,40,53,-13,42
Dumbarton,3360,8,10,11,15,50,60,-10,41
Queen of S't,3360,9,9,11,16,39,48,-9,38
St Mirren,3360,10,7,12,17,39,57,-18,33
Hibernian,3361,1,20,12,4,58,26,32,72
Morton,3361,2,18,12,6,54,34,20,66
Falkirk,3361,3,14,12,10,58,42,16,54
Dundee Utd,3361,4,14,12,10,53,40,13,54
Queen of S't,3361,5,11,11,14,47,55,-8,44
Dumbarton,3361,6,10,13,13,51,56,-5,43
Ayr,3361,7,9,14,13,38,54,-16,41
Dunfermline,3361,8,8,13,15,45,57,-12,37
St Mirren,3361,9,8,11,17,42,60,-18,35
Raith,3361,10,9,8,19,35,57,-22,35
Hibernian,3362,1,20,12,4,54,21,33,72
Dundee Utd,3362,2,18,8,10,55,43,12,62
Falkirk,3362,3,16,10,10,57,41,16,58
Morton,3362,4,16,9,11,48,42,6,57
Dunfermline,3362,5,13,11,12,50,45,5,50
Queen of S't,3362,6,11,8,17,40,48,-8,41
Raith,3362,7,10,10,16,34,49,-15,40
Dumbarton,3362,8,9,10,17,51,60,-9,37
St Mirren,3362,9,9,10,17,41,58,-17,37
Ayr,3362,10,8,12,16,34,57,-23,36
Hibernian,3363,1,22,10,4,57,21,36,76
Dundee Utd,3363,2,16,12,8,53,38,15,60
Morton,3363,3,15,13,8,47,36,11,58
Falkirk,3363,4,15,11,10,59,46,13,56
Dumbarton,3363,5,10,12,14,47,54,-7,42
Dunfermline,3363,6,9,13,14,47,52,-5,40
Queen of S't,3363,7,10,10,16,46,54,-8,40
St Mirren,3363,8,9,11,16,41,53,-12,38
Raith,3363,9,9,10,17,35,57,-22,37
Ayr,3363,10,8,12,16,32,53,-21,36
Hibernian,3364,1,17,14,5,56,31,25,65
Morton,3364,2,18,11,7,54,36,18,65
Dundee Utd,3364,3,18,10,8,60,37,23,64
Falkirk,3364,4,16,11,9,58,41,17,59
Queen of S't,3364,5,11,9,16,45,51,-6,42
Dunfermline,3364,6,9,13,14,46,58,-12,40
Ayr,3364,7,9,13,14,39,54,-15,40
Raith,3364,8,9,11,16,36,52,-16,38
St Mirren,3364,9,9,9,18,41,57,-16,36
Dumbarton,3364,10,8,11,17,44,62,-18,35
Hibernian,3365,1,21,11,4,55,22,33,74
Dundee Utd,3365,2,18,9,9,50,35,15,63
Morton,3365,3,17,11,8,47,33,14,62
Falkirk,3365,4,15,9,12,54,42,12,54
Dunfermline,3365,5,10,14,12,48,47,1,44
Queen of S't,3365,6,11,9,16,45,50,-5,42
Raith,3365,7,10,10,16,36,49,-13,40
Ayr,3365,8,10,10,16,34,50,-16,40
Dumbarton,3365,9,8,13,15,46,63,-17,37
St Mirren,3365,10,7,10,19,35,59,-24,31
Hibernian,3366,1,18,13,5,55,27,28,67
Falkirk,3366,2,17,12,7,63,40,23,63
Morton,3366,3,16,11,9,50,38,12,59
Dundee Utd,3366,4,16,10,10,53,43,10,58
Dunfermline,3366,5,11,14,11,49,45,4,47
Queen of S't,3366,6,11,12,13,48,49,-1,45
Dumbarton,3366,7,10,11,15,48,59,-11,41
Raith,3366,8,9,11,16,32,49,-17,38
St Mirren,3366,9,7,11,18,37,59,-22,32
Ayr,3366,10,6,13,17,33,59,-26,31
Hibernian,3367,1,19,14,3,58,23,35,71
Morton,3367,2,19,10,7,48,30,18,67
Dundee Utd,3367,3,18,8,10,54,38,16,62
Falkirk,3367,4,15,11,10,58,38,20,56
Queen of S't,3367,5,12,10,14,48,50,-2,46
Dunfermline,3367,6,10,12,14,43,46,-3,42
Raith,3367,7,10,10,16,34,52,-18,40
Ayr,3367,8,9,12,15,31,51,-20,39
Dumbarton,3367,9,7,13,16,44,60,-16,34
St Mirren,3367,10,6,10,20,35,65,-30,28
Hibernian,3368,1,21,11,4,63,27,36,74
Dundee Utd,3368,2,16,10,10,50,40,10,58
Falkirk,3368,3,15,11,10,56,41,15,56
Morton,3368,4,15,9,12,48,45,3,54
Dunfermline,3368,5,11,13,12,50,50,0,46
Queen of S't,3368,6,11,10,15,46,52,-6,43
Dumbarton,3368,7,10,11,15,52,60,-8,41
Raith,3368,8,10,11,15,36,49,-13,41
Ayr,3368,9,10,11,15,36,53,-17,41
St Mirren,3368,10,7,11,18,38,58,-20,32
Morton,3369,1,17,14,5,53,31,22,65
Hibernian,3369,2,17,13,6,54,29,25,64
Falkirk,3369,3,18,9,9,61,37,24,63
Dundee Utd,3369,4,15,12,9,45,36,9,57
Queen of S't,3369,5,11,10,15,42,50,-8,43
Dunfermline,3369,6,9,15,12,44,47,-3,42
Raith,3369,7,10,11,15,37,51,-14,41
Dumbarton,3369,8,8,12,16,48,58,-10,36
St Mirren,3369,9,8,11,17,39,60,-21,35
Ayr,3369,10,8,11,17,34,58,-24,35
Hibernian,3370,1,18,12,6,57,28,29,66
Dundee Utd,3370,2,18,9,9,52,37,15,63
Morton,3370,3,15,13,8,43,32,11,58
Falkirk,3370,4,15,9,12,57,43,14,54
Dunfermline,3370,5,11,13,12,51,44,7,46
St Mirren,3370,6,11,10,15,39,53,-14,43
Dumbarton,3370,7,10,12,14,48,55,-7,42
Queen of S't,3370,8,10,9,17,40,54,-14,39
Raith,3370,9,10,9,17,32,50,-18,39
Ayr,3370,10,9,10,17,34,57,-23,37
Hibernian,3371,1,19,14,3,61,27,34,71
Falkirk,3371,2,18,11,7,62,40,22,65
Morton,3371,3,15,13,8,55,41,14,58
Dundee Utd,3371,4,15,9,12,51,42,9,54
Queen of S't,3371,5,12,9,15,45,51,-6,45
Raith,3371,6,12,8,16,36,48,-12,44
Dunfermline,3371,7,10,12,14,45,51,-6,42
Dumbarton,3371,8,8,14,14,49,58,-9,38
Ayr,3371,9,7,13,16,36,60,-24,34
St Mirren,3371,10,7,11,18,41,63,-22,32
Hibernian,3372,1,21,11,4,60,24,36,74
Morton,3372,2,17,10,9,51,42,9,61
Dundee Utd,3372,3,16,9,11,61,43,18,57
Falkirk,3372,4,15,11,10,62,44,18,56
Dumbarton,3372,5,11,12,13,54,57,-3,45
Queen of S't,3372,6,12,9,15,41,52,-11,45
Dunfermline,3372,7,10,13,13,46,50,-4,43
St Mirren,3372,8,9,11,16,43,55,-12,38
Raith,3372,9,9,9,18,32,54,-22,36
Ayr,3372,10,7,11,18,33,62,-29,32
Morton,3373,1,19,10,7,53,34,19,67
Hibernian,3373,2,18,12,6,52,27,25,66
Falkirk,3373,3,17,11,8,59,39,20,62
Dundee Utd,3373,4,16,9,11,54,39,15,57
Raith,3373,5,11,10,15,45,51,-6,43
Dunfermline,3373,6,9,13,14,44,49,-5,40
Dumbarton,3373,7,9,13,14,49,58,-9,40
Queen of S't,3373,8,9,12,15,44,55,-11,39
Ayr,3373,9,8,13,15,37,64,-27,37
St Mirren,3373,10,7,11,18,39,60,-21,32
Hibernian,3374,1,19,12,5,53,25,28,69
Dundee Utd,3374,2,17,11,8,53,40,13,62
Falkirk,3374,3,15,13,8,53,37,16,58
Morton,3374,4,15,12,9,45,38,7,57
Queen of S't,3374,5,13,9,14,46,47,-1,48
Dumbarton,3374,6,10,13,13,46,54,-8,43
Raith,3374,7,10,9,17,33,52,-19,39
Dunfermline,3374,8,8,13,15,44,48,-4,37
Ayr,3374,9,8,13,15,34,51,-17,37
St Mirren,3374,10,7,11,18,40,55,-15,32
Hibernian,3375,1,19,12,5,58,28,30,69
Falkirk,3375,2,18,9,9,61,42,19,63
Morton,3375,3,17,11,8,53,36,17,62
Dundee Utd,3375,4,16,10,10,46,36,10,58
Dunfermline,3375,5,11,13,12,51,48,3,46
Ayr,3375,6,10,11,15,39,54,-15,41
Dumbarton,3375,7,9,11,16,45,58,-13,38
Queen of S't,3375,8,9,11,16,41,55,-14,38
St Mirren,3375,9,9,10,17,42,58,-16,37
Raith,3375,10,8,10,18,32,53,-21,34
Hibernian,3376,1,17,14,5,54,29,25,65
Falkirk,3376,2,17,10,9,61,41,20,61
Morton,3376,3,16,13,7,53,38,15,61
Dundee Utd,3376,4,16,11,9,51,39,12,59
Dunfermline,3376,5,10,15,11,47,46,1,45
Queen of S't,3376,6,11,9,16,42,50,-8,42
Raith,3376,7,10,9,17,33,51,-18,39
St Mirren,3376,8,9,11,16,46,57,-11,38
Dumbarton,3376,9,8,13,15,46,57,-11,37
Ayr,3376,10,8,11,17,34,59,-25,35
Hibernian,3377,1,17,15,4,52,27,25,66
Morton,3377,2,18,11,7,54,38,16,65
Falkirk,3377,3,16,11,9,58,46,12,59
Dundee Utd,3377,4,16,8,12,51,43,8,56
Queen of S't,3377,5,12,8,16,46,53,-7,44
Dumbarton,3377,6,11,10,15,50,56,-6,43
Dunfermline,3377,7,9,13,14,50,54,-4,40
Raith,3377,8,10,10,16,34,47,-13,40
St Mirren,3377,9,9,11,16,38,51,-13,38
Ayr,3377,10,8,11,17,37,55,-18,35
Hibernian,3378,1,22,10,4,59,24,35,76
Morton,3378,2,18,10,8,53,38,15,64
Falkirk,3378,3,16,11,9,59,41,18,59
Dundee Utd,3378,4,15,10,11,46,40,6,55
Dunfermline,3378,5,11,12,13,49,48,1,45
Queen of S't,3378,6,11,11,14,48,55,-7,44
Ayr,3378,7,10,10,16,34,51,-17,40
Dumbarton,3378,8,9,11,16,45,56,-11,38
Raith,3378,9,9,9,18,31,52,-21,36
St Mirren,3378,10,7,10,19,37,56,-19,31
Hibernian,3379,1,19,13,4,57,24,33,70
Morton,3379,2,17,11,8,51,34,17,62
Falkirk,3379,3,15,11,10,55,43,12,56
Dundee Utd,3379,4,15,10,11,48,41,7,55
Queen of S't,3379,5,11,12,13,48,54,-6,45
Dunfermline,3379,6,10,14,12,46,47,-1,44
Ayr,3379,7,9,12,15,36,56,-20,39
Dumbarton,3379,8,9,11,16,53,63,-10,38
Raith,3379,9,10,8,18,38,56,-18,38
St Mirren,3379,10,9,10,17,41,55,-14,37
Hibernian,3380,1,20,11,5,57,27,30,71
Morton,3380,2,18,10,8,52,37,15,64
Falkirk,3380,3,15,10,11,55,43,12,55
Dundee Utd,3380,4,14,9,13,47,44,3,51
Queen of S't,3380,5,12,10,14,43,46,-3,46
Dunfermline,3380,6,9,14,13,48,50,-2,41
St Mirren,3380,7,10,11,15,43,52,-9,41
Dumbarton,3380,8,10,10,16,48,58,-10,40
Ayr,3380,9,9,13,14,33,49,-16,40
Raith,3380,10,9,10,17,35,55,-20,37
Hibernian,3381,1,20,11,5,57,29,28,71
Morton,3381,2,18,10,8,50,36,14,64
Dundee Utd,3381,3,17,10,9,54,39,15,61
Falkirk,3381,4,15,12,9,57,40,17,57
Dunfermline,3381,5,10,14,12,47,47,0,44
Raith,3381,6,11,10,15,36,46,-10,43
Queen of S't,3381,7,10,10,16,44,52,-8,40
Dumbarton,3381,8,9,11,16,45,55,-10,38
Ayr,3381,9,7,13,16,31,54,-23,34
St Mirren,3381,10,7,11,18,35,58,-23,32
Hibernian,3382,1,19,11,6,56,28,28,68
Morton,3382,2,18,11,7,49,33,16,65
Falkirk,3382,3,15,10,11,54,45,9,55
Dundee Utd,3382,4,14,12,10,46,39,7,54
Ayr,3382,5,11,12,13,43,52,-9,45
Queen of S't,3382,6,11,11,14,44,51,-7,44
Dunfermline,3382,7,10,13,13,49,48,1,43
Raith,3382,8,10,9,17,35,49,-14,39
Dumbarton,3382,9,8,13,15,46,58,-12,37
St Mirren,3382,10,8,10,18,38,57,-19,34
Hibernian,3383,1,18,14,4,54,26,28,68
Falkirk,3383,2,18,10,8,57,36,21,64
Morton,3383,3,16,14,6,48,34,14,62
Dundee Utd,3383,4,15,12,9,52,37,15,57
Queen of S't,3383,5,11,9,16,47,51,-4,42
Raith,3383,6,11,9,16,37,49,-12,42
Dunfermline,3383,7,8,16,12,41,47,-6,40
Dumbarton,3383,8,9,12,15,47,59,-12,39
Ayr,3383,9,8,11,17,35,59,-24,35
St Mirren,3383,10,7,11,18,35,55,-20,32
Hibernian,3384,1,20,12,4,58,27,31,72
Morton,3384,2,18,12,6,53,35,18,66
Dundee Utd,3384,3,16,10,10,51,40,11,58
Falkirk,3384,4,15,11,10,58,43,15,56
Queen of S't,3384,5,13,9,14,51,49,2,48
Dunfermline,3384,6,9,13,14,45,50,-5,40
Raith,3384,7,10,8,18,35,52,-17,38
Ayr,3384,8,9,11,16,36,57,-21,38
St Mirren,3384,9,9,9,18,39,56,-17,36
Dumbarton,3384,10,8,11,17,44,61,-17,35
Hibernian,3385,1,18,11,7,56,30,26,65
Morton,3385,2,18,11,7,53,36,17,65
Falkirk,3385,3,17,11,8,62,40,22,62
Dundee Utd,3385,4,15,10,11,49,39,10,55
Raith,3385,5,12,9,15,36,45,-9,45
Queen of S't,3385,6,10,13,13,48,53,-5,43
Dunfermline,3385,7,9,14,13,42,49,-7,41
Dumbarton,3385,8,9,11,16,47,59,-12,38
Ayr,3385,9,9,11,16,35,58,-23,38
St Mirren,3385,10,7,11,18,38,57,-19,32
Hibernian,3386,1,19,13,4,56,24,32,70
Dundee Utd,3386,2,16,11,9,51,39,12,59
Morton,3386,3,15,11,10,46,42,4,56
Falkirk,3386,4,15,10,11,58,43,15,55
Dumbarton,3386,5,11,11,14,47,52,-5,44
Queen of S't,3386,6,11,10,15,48,56,-8,43
Dunfermline,3386,7,9,14,13,44,50,-6,41
St Mirren,3386,8,10,10,16,46,52,-6,40
Ayr,3386,9,8,14,14,35,54,-19,38
Raith,3386,10,9,10,17,32,51,-19,37
Hibernian,3387,1,19,12,5,54,25,29,69
Dundee Utd,3387,2,17,10,9,58,39,19,61
Morton,3387,3,17,10,9,50,36,14,61
Falkirk,3387,4,15,12,9,57,40,17,57
Queen of S't,3387,5,14,10,12,48,43,5,52
Dunfermline,3387,6,10,12,14,46,52,-6,42
Dumbarton,3387,7,10,10,16,43,56,-13,40
Raith,3387,8,9,10,17,33,52,-19,37
Ayr,3387,9,8,12,16,36,56,-20,36
St Mirren,3387,10,6,12,18,37,63,-26,30
Hibernian,3388,1,19,12,5,59,26,33,69
Dundee Utd,3388,2,17,10,9,60,38,22,61
Morton,3388,3,16,13,7,49,35,14,61
Falkirk,3388,4,15,11,10,59,48,11,56
Queen of S't,3388,5,13,8,15,48,52,-4,47
Raith,3388,6,13,8,15,38,46,-8,47
Dunfermline,3388,7,11,11,14,47,50,-3,44
Ayr,3388,8,9,11,16,33,57,-24,38
St Mirren,3388,9,7,11,18,40,60,-20,32
Dumbarton,3388,10,7,11,18,43,64,-21,32
Hibernian,3389,1,22,10,4,59,25,34,76
Falkirk,3389,2,17,9,10,63,42,21,60
Morton,3389,3,16,12,8,54,45,9,60
Dundee Utd,3389,4,14,9,13,47,49,-2,51
Queen of S't,3389,5,13,8,15,51,52,-1,47
Dunfermline,3389,6,11,12,13,54,47,7,45
Dumbarton,3389,7,9,13,14,49,60,-11,40
Ayr,3389,8,9,11,16,38,58,-20,38
Raith,3389,9,9,9,18,34,56,-22,36
St Mirren,3389,10,8,11,17,40,55,-15,35
Hibernian,3390,1,20,12,4,56,27,29,72
Dundee Utd,3390,2,18,9,9,53,38,15,63
Falkirk,3390,3,17,10,9,58,41,17,61
Morton,3390,4,14,12,10,45,40,5,54
Dunfermline,3390,5,9,15,12,45,47,-2,42
Ayr,3390,6,10,12,14,39,52,-13,42
Queen of S't,3390,7,10,10,16,41,46,-5,40
Dumbarton,3390,8,9,11,16,48,60,-12,38
St Mirren,3390,9,9,10,17,41,56,-15,37
Raith,3390,10,9,9,18,31,50,-19,36
Hibernian,3391,1,19,10,7,56,30,26,67
Morton,3391,2,18,11,7,54,38,16,65
Dundee Utd,3391,3,16,10,10,55,40,15,58
Falkirk,3391,3,16,10,10,55,40,15,58
Raith,3391,5,11,10,15,36,45,-9,43
Dunfermline,3391,6,10,12,14,46,49,-3,42
Ayr,3391,7,10,12,14,36,51,-15,42
Queen of S't,3391,8,11,8,17,41,52,-11,41
Dumbarton,3391,9,9,10,17,46,63,-17,37
St Mirren,3391,10,8,11,17,40,57,-17,35
Hibernian,3392,1,18,13,5,58,26,32,67
Morton,3392,2,16,12,8,50,37,13,60
Falkirk,3392,3,15,11,10,56,44,12,56
Dundee Utd,3392,4,13,13,10,41,36,5,52
Queen of S't,3392,5,12,11,13,45,46,-1,47
Dunfermline,3392,6,11,11,14,46,47,-1,44
Raith,3392,7,11,10,15,37,50,-13,43
Dumbarton,3392,8,9,12,15,48,59,-11,39
Ayr,3392,9,8,13,15,34,54,-20,37
St Mirren,3392,10,8,12,16,38,54,-16,36
Hibernian,3393,1,19,13,4,57,28,29,70
Falkirk,3393,2,18,9,9,62,39,23,63
Morton,3393,3,15,13,8,52,41,11,58
Dundee Utd,3393,4,16,9,11,49,40,9,57
Dumbarton,3393,5,12,11,13,56,59,-3,47
Queen of S't,3393,6,11,10,15,41,48,-7,43
Dunfermline,3393,7,9,14,13,44,48,-4,41
Ayr,3393,8,7,15,14,31,52,-21,36
Raith,3393,9,8,11,17,32,53,-21,35
St Mirren,3393,10,7,11,18,39,55,-16,32
Hibernian,3394,1,19,12,5,56,25,31,69
Morton,3394,2,17,12,7,48,34,14,63
Falkirk,3394,3,16,11,9,58,41,17,59
Dundee Utd,3394,4,16,10,10,49,39,10,58
Queen of S't,3394,5,12,8,16,48,54,-6,44
Raith,3394,6,11,9,16,38,52,-14,42
Dunfermline,3394,7,9,13,14,44,50,-6,40
Dumbarton,3394,8,9,13,14,49,58,-9,40
Ayr,3394,9,8,13,15,40,58,-18,37
St Mirren,3394,10,6,13,17,37,56,-19,31
Hibernian,3395,1,18,13,5,55,26,29,67
Falkirk,3395,2,15,13,8,58,41,17,58
Morton,3395,3,14,13,9,49,41,8,55
Dundee Utd,3395,4,15,10,11,45,38,7,55
Queen of S't,3395,5,12,10,14,46,45,1,46
Dunfermline,3395,6,11,13,12,43,44,-1,46
St Mirren,3395,7,10,10,16,41,54,-13,40
Ayr,3395,8,9,13,14,36,53,-17,40
Dumbarton,3395,9,9,11,16,48,61,-13,38
Raith,3395,10,8,12,16,33,51,-18,36
Hibernian,3396,1,18,14,4,55,27,28,68
Morton,3396,2,17,12,7,54,37,17,63
Falkirk,3396,3,17,10,9,61,41,20,61
Dundee Utd,3396,4,17,9,10,54,39,15,60
Raith,3396,5,12,8,16,38,50,-12,44
Queen of S't,3396,6,11,10,15,46,55,-9,43
Dunfermline,3396,7,9,14,13,46,52,-6,41
Dumbarton,3396,8,10,10,16,50,61,-11,40
St Mirren,3396,9,8,10,18,42,60,-18,34
Ayr,3396,10,7,11,18,35,59,-24,32
Hibernian,3397,1,20,12,4,61,24,37,72
Morton,3397,2,17,11,8,51,39,12,62
Falkirk,3397,3,15,13,8,54,39,15,58
Dundee Utd,3397,4,15,12,9,52,39,13,57
Queen of S't,3397,5,10,11,15,42,55,-13,41
Dumbarton,3397,6,9,12,15,52,61,-9,39
St Mirren,3397,7,9,12,15,44,54,-10,39
Raith,3397,8,10,9,17,33,50,-17,39
Dunfermline,3397,9,8,14,14,47,53,-6,38
Ayr,3397,10,9,10,17,34,56,-22,37
Hibernian,3398,1,19,12,5,56,28,28,69
Morton,3398,2,18,13,5,55,32,23,67
Falkirk,3398,3,15,13,8,60,43,17,58
Dundee Utd,3398,4,13,11,12,49,48,1,50
Queen of S't,3398,5,12,8,16,45,54,-9,44
Dumbarton,3398,6,11,10,15,53,58,-5,43
Raith,3398,7,10,10,16,38,50,-12,40
St Mirren,3398,8,9,12,15,45,56,-11,39
Dunfermline,3398,9,8,14,14,42,50,-8,38
Ayr,3398,10,8,11,17,33,57,-24,35
Hibernian,3399,1,20,11,5,57,27,30,71
Morton,3399,2,16,12,8,52,38,14,60
Falkirk,3399,3,15,11,10,56,42,14,56
Dundee Utd,3399,4,15,10,11,49,40,9,55
Queen of S't,3399,5,12,9,15,42,46,-4,45
Dumbarton,3399,6,11,11,14,49,55,-6,44
Ayr,3399,7,9,14,13,39,54,-15,41
Dunfermline,3399,8,9,13,14,43,48,-5,40
Raith,3399,9,9,12,15,36,51,-15,39
St Mirren,3399,10,7,11,18,38,60,-22,32
Morton,3400,1,19,10,7,52,31,21,67
Hibernian,3400,2,17,12,7,48,27,21,63
Dundee Utd,3400,3,15,9,12,46,41,5,54
Falkirk,3400,4,14,11,11,56,41,15,53
Ayr,3400,5,12,11,13,37,47,-10,47
Queen of S't,3400,6,12,9,15,45,49,-4,45
Raith,3400,7,11,11,14,35,45,-10,44
Dunfermline,3400,8,10,12,14,45,53,-8,42
Dumbarton,3400,9,9,12,15,45,55,-10,39
St Mirren,3400,10,8,9,19,37,57,-20,33
Hibernian,3401,1,19,13,4,53,24,29,70
Morton,3401,2,18,10,8,53,40,13,64
Falkirk,3401,3,16,10,10,58,41,17,58
Dundee Utd,3401,4,16,10,10,52,41,11,58
Queen of S't,3401,5,11,9,16,42,52,-10,42
Raith,3401,6,11,9,16,35,46,-11,42
Dumbarton,3401,7,10,11,15,51,60,-9,41
Dunfermline,3401,8,8,14,14,47,53,-6,38
Ayr,3401,9,8,13,15,31,49,-18,37
St Mirren,3401,10,9,9,18,39,55,-16,36
Hibernian,3402,1,19,12,5,55,25,30,69
Dundee Utd,3402,2,17,9,10,52,40,12,60
Falkirk,3402,3,16,11,9,59,39,20,59
Morton,3402,4,14,13,9,49,42,7,55
Queen of S't,3402,5,14,9,13,49,47,2,51
Dunfermline,3402,6,9,14,13,48,52,-4,41
Raith,3402,7,10,10,16,32,47,-15,40
Dumbarton,3402,8,9,12,15,49,59,-10,39
Ayr,3402,9,8,12,16,33,53,-20,36
St Mirren,3402,10,7,12,17,37,59,-22,33
Hibernian,3403,1,20,11,5,60,26,34,71
Falkirk,3403,2,16,13,7,58,38,20,61
Dundee Utd,3403,3,16,8,12,51,45,6,56
Dunfermline,3403,4,14,11,11,47,41,6,53
Morton,3403,5,14,11,11,47,43,4,53
Ayr,3403,6,11,11,14,42,52,-10,44
Raith,3403,7,11,10,15,38,47,-9,43
Queen of S't,3403,8,10,9,17,42,53,-11,39
Dumbarton,3403,9,8,11,17,44,64,-20,35
St Mirren,3403,10,8,9,19,39,59,-20,33
Hibernian,3404,1,19,12,5,59,27,32,69
Falkirk,3404,2,18,9,9,63,38,25,63
Morton,3404,3,15,14,7,50,39,11,59
Dundee Utd,3404,4,16,10,10,48,36,12,58
Dunfermline,3404,5,10,15,11,49,47,2,45
Queen of S't,3404,6,10,9,17,40,57,-17,39
Raith,3404,7,10,9,17,36,53,-17,39
St Mirren,3404,8,9,11,16,46,57,-11,38
Ayr,3404,9,8,13,15,34,57,-23,37
Dumbarton,3404,10,8,12,16,47,61,-14,36
Hibernian,3405,1,22,10,4,55,21,34,76
Dundee Utd,3405,2,20,8,8,57,33,24,68
Morton,3405,3,16,11,9,47,39,8,59
Falkirk,3405,4,16,9,11,56,41,15,57
Dunfermline,3405,5,10,12,14,50,49,1,42
Dumbarton,3405,6,10,10,16,48,59,-11,40
Raith,3405,7,9,12,15,33,46,-13,39
Queen of S't,3405,8,10,9,17,38,56,-18,39
St Mirren,3405,9,8,11,17,45,57,-12,35
Ayr,3405,10,8,10,18,35,63,-28,34
Hibernian,3406,1,19,13,4,57,26,31,70
Falkirk,3406,2,18,10,8,59,39,20,64
Dundee Utd,3406,3,17,9,10,54,40,14,60
Morton,3406,4,15,12,9,49,38,11,57
Dumbarton,3406,5,11,11,14,49,54,-5,44
Queen of S't,3406,6,11,9,16,44,51,-7,42
Dunfermline,3406,7,9,14,13,49,54,-5,41
Raith,3406,8,10,10,16,33,48,-15,40
Ayr,3406,9,8,12,16,31,53,-22,36
St Mirren,3406,10,7,10,19,38,60,-22,31
Hibernian,3407,1,21,11,4,59,26,33,74
Falkirk,3407,2,15,12,9,56,43,13,57
Dundee Utd,3407,3,16,9,11,49,41,8,57
Morton,3407,4,15,10,11,46,39,7,55
Dunfermline,3407,5,12,12,12,57,48,9,48
Raith,3407,6,10,11,15,39,50,-11,41
Dumbarton,3407,7,9,13,14,48,59,-11,40
Ayr,3407,8,10,10,16,35,52,-17,40
Queen of S't,3407,9,10,8,18,41,55,-14,38
St Mirren,3407,10,8,12,16,41,58,-17,36
Hibernian,3408,1,20,13,3,54,22,32,73
Falkirk,3408,2,17,10,9,60,41,19,61
Dundee Utd,3408,3,17,10,9,55,39,16,61
Morton,3408,4,14,13,9,44,37,7,55
Queen of S't,3408,5,12,11,13,48,48,0,47
Dunfermline,3408,6,9,13,14,43,48,-5,40
Raith,3408,7,10,9,17,36,53,-17,39
St Mirren,3408,8,7,15,14,36,50,-14,36
Dumbarton,3408,9,8,11,17,45,59,-14,35
Ayr,3408,10,7,13,16,29,53,-24,34
Hibernian,3409,1,19,11,6,55,27,28,68
Morton,3409,2,16,12,8,50,35,15,60
Falkirk,3409,3,16,10,10,57,41,16,58
Dundee Utd,3409,4,16,10,10,53,40,13,58
Queen of S't,3409,5,13,10,13,51,50,1,49
Dumbarton,3409,6,10,13,13,52,58,-6,43
Dunfermline,3409,7,10,11,15,44,53,-9,41
Raith,3409,8,9,10,17,35,53,-18,37
Ayr,3409,9,7,15,14,30,49,-19,36
St Mirren,3409,10,8,10,18,38,59,-21,34
Hibernian,3410,1,17,14,5,51,25,26,65
Falkirk,3410,2,16,12,8,61,41,20,60
Morton,3410,3,15,13,8,46,35,11,58
Dundee Utd,3410,4,15,12,9,50,42,8,57
Dunfermline,3410,5,11,14,11,48,45,3,47
Queen of S't,3410,6,11,11,14,44,49,-5,44
Raith,3410,7,11,9,16,35,49,-14,42
Dumbarton,3410,8,8,13,15,43,55,-12,37
Ayr,3410,9,8,12,16,38,57,-19,36
St Mirren,3410,10,8,10,18,37,55,-18,34
Hibernian,3411,1,20,11,5,55,28,27,71
Dundee Utd,3411,2,16,10,10,49,39,10,58
Falkirk,3411,3,15,12,9,60,42,18,57
Morton,3411,4,16,9,11,49,42,7,57
Queen of S't,3411,5,12,10,14,47,47,0,46
Dunfermline,3411,6,10,12,14,49,51,-2,42
Dumbarton,3411,7,10,11,15,48,57,-9,41
St Mirren,3411,8,10,11,15,43,55,-12,41
Ayr,3411,9,9,11,16,34,53,-19,38
Raith,3411,10,9,9,18,36,56,-20,36
Hibernian,3412,1,20,12,4,57,25,32,72
Falkirk,3412,2,18,10,8,57,36,21,64
Morton,3412,3,16,12,8,50,38,12,60
Dundee Utd,3412,4,16,9,11,52,43,9,57
Dunfermline,3412,5,11,12,13,49,51,-2,45
Dumbarton,3412,6,10,10,16,50,58,-8,40
Ayr,3412,7,9,12,15,34,55,-21,39
Queen of S't,3412,8,10,8,18,45,56,-11,38
St Mirren,3412,9,9,10,17,42,56,-14,37
Raith,3412,10,9,9,18,34,52,-18,36
Hibernian,3413,1,21,11,4,58,25,33,74
Falkirk,3413,2,18,10,8,63,39,24,64
Morton,3413,3,17,9,10,52,40,12,60
Dundee Utd,3413,4,15,11,10,49,41,8,56
Queen of S't,3413,5,12,9,15,44,52,-8,45
Dunfermline,3413,6,10,11,15,48,54,-6,41
Ayr,3413,7,9,13,14,35,52,-17,40
Dumbarton,3413,8,9,11,16,46,56,-10,38
Raith,3413,9,9,9,18,34,52,-18,36
St Mirren,3413,10,8,10,18,39,57,-18,34
Morton,3414,1,18,13,5,51,31,20,67
Hibernian,3414,2,17,12,7,50,27,23,63
Falkirk,3414,3,17,9,10,57,38,19,60
Dundee Utd,3414,4,16,9,11,48,41,7,57
Queen of S't,3414,5,11,10,15,46,52,-6,43
Dumbarton,3414,6,10,11,15,50,58,-8,41
Raith,3414,7,10,11,15,35,47,-12,41
Dunfermline,3414,8,9,13,14,45,50,-5,40
St Mirren,3414,9,9,10,17,35,52,-17,37
Ayr,3414,10,7,14,15,30,51,-21,35
Hibernian,3415,1,18,12,6,54,29,25,66
Falkirk,3415,2,16,12,8,61,43,18,60
Dundee Utd,3415,3,16,11,9,57,42,15,59
Morton,3415,4,16,11,9,46,41,5,59
Queen of S't,3415,5,14,10,12,49,46,3,52
Dunfermline,3415,6,10,12,14,49,51,-2,42
Dumbarton,3415,7,10,12,14,48,54,-6,42
Raith,3415,8,10,8,18,36,49,-13,38
Ayr,3415,9,7,13,16,35,60,-25,34
St Mirren,3415,10,8,9,19,36,56,-20,33
Hibernian,3416,1,18,10,8,52,31,21,64
Morton,3416,2,17,11,8,50,35,15,62
Falkirk,3416,3,15,13,8,64,41,23,58
Dundee Utd,3416,4,15,10,11,49,46,3,55
Dunfermline,3416,5,11,12,13,48,54,-6,45
Queen of S't,3416,6,11,10,15,49,54,-5,43
Raith,3416,7,11,10,15,42,52,-10,43
Ayr,3416,8,10,10,16,38,56,-18,40
St Mirren,3416,9,9,12,15,41,52,-11,39
Dumbarton,3416,10,8,12,16,44,56,-12,36
Hibernian,3417,1,18,15,3,52,24,28,69
Dundee Utd,3417,2,18,8,10,59,42,17,62
Morton,3417,3,15,13,8,52,41,11,58
Falkirk,3417,4,15,11,10,57,41,16,56
Raith,3417,5,12,10,14,44,51,-7,46
Queen of S't,3417,6,11,11,14,45,48,-3,44
Dumbarton,3417,7,9,11,16,48,63,-15,38
St Mirren,3417,8,8,13,15,46,59,-13,37
Dunfermline,3417,9,8,13,15,43,56,-13,37
Ayr,3417,10,8,11,17,35,56,-21,35
Hibernian,3418,1,18,12,6,50,25,25,66
Morton,3418,2,17,12,7,54,37,17,63
Falkirk,3418,3,15,11,10,55,42,13,56
Dundee Utd,3418,4,13,10,13,49,45,4,49
Dunfermline,3418,5,11,13,12,44,45,-1,46
Queen of S't,3418,6,12,10,14,44,48,-4,46
St Mirren,3418,7,11,9,16,42,54,-12,42
Raith,3418,8,10,11,15,37,46,-9,41
Ayr,3418,9,9,13,14,33,50,-17,40
Dumbarton,3418,10,7,13,16,43,59,-16,34
Hibernian,3419,1,17,14,5,53,25,28,65
Dundee Utd,3419,2,17,10,9,50,35,15,61
Morton,3419,3,16,13,7,46,33,13,61
Falkirk,3419,4,16,10,10,56,40,16,58
Queen of S't,3419,5,13,9,14,50,49,1,48
Dunfermline,3419,6,10,14,12,48,49,-1,44
Dumbarton,3419,7,10,12,14,44,51,-7,42
Ayr,3419,8,9,11,16,34,55,-21,38
Raith,3419,9,8,10,18,31,53,-22,34
St Mirren,3419,10,7,11,18,34,56,-22,32
Morton,3420,1,18,11,7,57,37,20,65
Falkirk,3420,2,18,10,8,60,40,20,64
Hibernian,3420,3,18,10,8,54,34,20,64
Dundee Utd,3420,4,18,8,10,56,40,16,62
Dunfermline,3420,5,11,12,13,49,47,2,45
Queen of S't,3420,6,11,11,14,50,54,-4,44
Raith,3420,7,10,9,17,38,56,-18,39
St Mirren,3420,8,8,11,17,39,58,-19,35
Ayr,3420,9,8,11,17,39,61,-22,35
Dumbarton,3420,10,7,13,16,47,62,-15,34
Hibernian,3421,1,21,11,4,59,24,35,74
Morton,3421,2,17,11,8,49,34,15,62
Dundee Utd,3421,3,17,9,10,51,36,15,60
Falkirk,3421,4,16,10,10,61,41,20,58
Dumbarton,3421,5,11,12,13,47,55,-8,45
Dunfermline,3421,6,10,12,14,45,47,-2,42
Queen of S't,3421,7,10,10,16,44,54,-10,40
Ayr,3421,8,9,10,17,34,55,-21,37
Raith,3421,9,9,9,18,31,53,-22,36
St Mirren,3421,10,8,10,18,43,65,-22,34
Hibernian,3422,1,19,11,6,52,26,26,68
Dundee Utd,3422,2,18,9,9,55,37,18,63
Falkirk,3422,3,17,11,8,60,40,20,62
Morton,3422,4,14,12,10,44,37,7,54
Dunfermline,3422,5,11,14,11,43,42,1,47
Queen of S't,3422,6,11,10,15,45,48,-3,43
Raith,3422,7,9,11,16,37,50,-13,38
Ayr,3422,8,9,11,16,32,57,-25,38
St Mirren,3422,9,9,10,17,38,54,-16,37
Dumbarton,3422,10,7,13,16,45,60,-15,34
Hibernian,3423,1,19,12,5,49,22,27,69
Morton,3423,2,18,10,8,50,35,15,64
Dundee Utd,3423,3,16,10,10,55,42,13,58
Falkirk,3423,4,16,9,11,54,42,12,57
Queen of S't,3423,5,12,10,14,45,46,-1,46
Raith,3423,6,12,9,15,36,44,-8,45
Dunfermline,3423,7,9,15,12,44,44,0,42
Dumbarton,3423,8,10,11,15,52,60,-8,41
St Mirren,3423,9,8,11,17,35,52,-17,35
Ayr,3423,10,6,11,19,28,61,-33,29
Hibernian,3424,1,20,12,4,63,28,35,72
Morton,3424,2,17,14,5,51,32,19,65
Dundee Utd,3424,3,16,10,10,52,41,11,58
Falkirk,3424,4,16,9,11,57,40,17,57
Queen of S't,3424,5,13,9,14,43,47,-4,48
Dunfermline,3424,6,10,11,15,46,50,-4,41
Ayr,3424,7,10,11,15,38,56,-18,41
Raith,3424,8,9,11,16,30,45,-15,38
Dumbarton,3424,9,9,10,17,47,63,-16,37
St Mirren,3424,10,6,11,19,36,61,-25,29
Morton,3425,1,21,10,5,54,30,24,73
Hibernian,3425,2,20,12,4,54,22,32,72
Dundee Utd,3425,3,17,9,10,53,39,14,60
Falkirk,3425,4,15,11,10,55,41,14,56
Queen of S't,3425,5,12,10,14,46,51,-5,46
Dunfermline,3425,6,10,12,14,45,50,-5,42
Dumbarton,3425,7,8,12,16,46,62,-16,36
St Mirren,3425,8,9,9,18,41,58,-17,36
Raith,3425,9,9,9,18,32,49,-17,36
Ayr,3425,10,6,12,18,29,53,-24,30
Morton,3426,1,18,12,6,55,35,20,66
Hibernian,3426,2,17,13,6,53,25,28,64
Falkirk,3426,3,17,11,8,58,36,22,62
Dundee Utd,3426,4,17,8,11,55,41,14,59
Queen of S't,3426,5,14,9,13,49,46,3,51
Dunfermline,3426,6,9,15,12,43,45,-2,42
Raith,3426,7,10,10,16,35,52,-17,40
St Mirren,3426,8,8,12,16,39,55,-16,36
Dumbarton,3426,9,8,10,18,42,65,-23,34
Ayr,3426,10,6,12,18,30,59,-29,30
Hibernian,3427,1,18,12,6,53,26,27,66
Morton,3427,2,17,10,9,50,37,13,61
Dundee Utd,3427,3,16,10,10,55,41,14,58
Falkirk,3427,4,16,9,11,60,42,18,57
Dunfermline,3427,5,10,13,13,45,47,-2,43
Raith,3427,6,11,9,16,35,48,-13,42
Dumbarton,3427,7,9,13,14,52,60,-8,40
Queen of S't,3427,8,10,10,16,44,57,-13,40
St Mirren,3427,9,10,10,16,39,53,-14,40
Ayr,3427,10,9,12,15,34,56,-22,39
Hibernian,3428,1,22,10,4,60,26,34,76
Morton,3428,2,17,10,9,55,43,12,61
Dundee Utd,3428,3,15,11,10,54,45,9,56
Falkirk,3428,4,15,10,11,59,48,11,55
Dunfermline,3428,5,10,13,13,51,51,0,43
Dumbarton,3428,6,10,12,14,52,63,-11,42
Queen of S't,3428,7,10,11,15,42,48,-6,41
Raith,3428,8,10,11,15,35,46,-11,41
St Mirren,3428,9,9,10,17,45,58,-13,37
Ayr,3428,10,6,14,16,31,56,-25,32
Hibernian,3429,1,18,12,6,53,32,21,66
Dundee Utd,3429,2,17,10,9,48,37,11,61
Falkirk,3429,3,15,12,9,61,42,19,57
Morton,3429,4,15,11,10,49,39,10,56
Queen of S't,3429,5,12,10,14,45,48,-3,46
Dunfermline,3429,6,10,15,11,46,45,1,45
St Mirren,3429,7,10,10,16,46,54,-8,40
Dumbarton,3429,8,10,10,16,48,61,-13,40
Ayr,3429,9,9,11,16,36,57,-21,38
Raith,3429,10,8,11,17,30,47,-17,35
Hibernian,3430,1,21,12,3,60,20,40,75
Morton,3430,2,15,11,10,51,43,8,56
Dundee Utd,3430,3,15,10,11,49,46,3,55
Falkirk,3430,4,14,11,11,56,47,9,53
Dumbarton,3430,5,12,11,13,54,55,-1,47
Queen of S't,3430,6,12,9,15,45,53,-8,45
Dunfermline,3430,7,9,14,13,48,48,0,41
St Mirren,3430,8,10,10,16,43,56,-13,40
Ayr,3430,9,8,13,15,36,57,-21,37
Raith,3430,10,9,9,18,40,57,-17,36
Hibernian,3431,1,20,12,4,56,26,30,72
Morton,3431,2,15,13,8,47,36,11,58
Falkirk,3431,3,15,12,9,60,42,18,57
Dundee Utd,3431,4,16,9,11,48,41,7,57
Queen of S't,3431,5,12,8,16,48,54,-6,44
Dunfermline,3431,6,10,13,13,48,49,-1,43
Raith,3431,7,11,10,15,34,45,-11,43
Dumbarton,3431,8,10,12,14,46,55,-9,42
St Mirren,3431,9,8,11,17,38,51,-13,35
Ayr,3431,10,7,12,17,32,58,-26,33
Hibernian,3432,1,19,10,7,53,26,27,67
Morton,3432,2,16,10,10,48,41,7,58
Falkirk,3432,3,15,11,10,57,42,15,56
Dundee Utd,3432,4,15,11,10,55,44,11,56
Queen of S't,3432,5,14,9,13,51,49,2,51
Dunfermline,3432,6,10,14,12,50,51,-1,44
Dumbarton,3432,7,10,11,15,53,63,-10,41
Raith,3432,8,11,8,17,37,51,-14,41
St Mirren,3432,9,8,12,16,44,58,-14,36
Ayr,3432,10,8,12,16,33,56,-23,36
Hibernian,3433,1,19,14,3,57,24,33,71
Morton,3433,2,16,13,7,46,36,10,61
Falkirk,3433,3,16,12,8,63,41,22,60
Dundee Utd,3433,4,14,11,11,52,41,11,53
Dunfermline,3433,5,10,13,13,43,47,-4,43
Raith,3433,6,11,10,15,38,50,-12,43
Dumbarton,3433,7,10,12,14,51,60,-9,42
Queen of S't,3433,8,10,9,17,44,54,-10,39
St Mirren,3433,9,8,12,16,41,52,-11,36
Ayr,3433,10,6,14,16,35,65,-30,32
Hibernian,3434,1,17,14,5,56,28,28,65
Morton,3434,2,16,11,9,48,39,9,59
Dundee Utd,3434,3,16,9,11,57,43,14,57
Falkirk,3434,4,15,11,10,62,46,16,56
Raith,3434,5,12,10,14,38,46,-8,46
Queen of S't,3434,6,12,9,15,42,50,-8,45
Dunfermline,3434,7,10,13,13,48,49,-1,43
Dumbarton,3434,8,9,12,15,46,61,-15,39
Ayr,3434,9,9,11,16,32,52,-20,38
St Mirren,3434,10,8,12,16,42,57,-15,36
Hibernian,3435,1,20,13,3,57,24,33,73
Morton,3435,2,17,11,8,49,33,16,62
Dundee Utd,3435,3,16,10,10,59,43,16,58
Falkirk,3435,4,14,9,13,55,50,5,51
Dunfermline,3435,5,10,15,11,50,48,2,45
Raith,3435,6,11,10,15,36,45,-9,43
Queen of S't,3435,7,11,9,16,43,52,-9,42
St Mirren,3435,8,10,10,16,42,54,-12,40
Ayr,3435,9,8,13,15,36,57,-21,37
Dumbarton,3435,10,8,10,18,46,67,-21,34
Hibernian,3436,1,21,10,5,58,27,31,73
Morton,3436,2,17,10,9,49,36,13,61
Dundee Utd,3436,3,15,12,9,45,36,9,57
Falkirk,3436,4,13,13,10,52,42,10,52
Queen of S't,3436,5,12,11,13,46,45,1,47
Dunfermline,3436,6,9,15,12,47,51,-4,42
Raith,3436,7,10,11,15,37,46,-9,41
St Mirren,3436,8,9,10,17,40,56,-16,37
Dumbarton,3436,9,8,12,16,45,58,-13,36
Ayr,3436,10,7,14,15,33,55,-22,35
Hibernian,3437,1,19,11,6,54,26,28,68
Morton,3437,2,15,14,7,45,34,11,59
Dundee Utd,3437,3,16,10,10,48,37,11,58
Falkirk,3437,4,16,9,11,56,40,16,57
Dunfermline,3437,5,12,11,13,44,43,1,47
Raith,3437,6,12,10,14,37,47,-10,46
Queen of S't,3437,7,11,9,16,44,50,-6,42
St Mirren,3437,8,9,11,16,42,55,-13,38
Dumbarton,3437,9,8,11,17,44,61,-17,35
Ayr,3437,10,7,14,15,34,55,-21,35
Hibernian,3438,1,19,11,6,59,26,33,68
Morton,3438,2,17,13,6,52,36,16,64
Falkirk,3438,3,16,9,11,53,42,11,57
Dundee Utd,3438,4,15,11,10,51,41,10,56
Queen of S't,3438,5,13,8,15,44,51,-7,47
Dunfermline,3438,6,10,12,14,46,46,0,42
St Mirren,3438,7,9,12,15,40,52,-12,39
Raith,3438,8,10,9,17,35,49,-14,39
Dumbarton,3438,9,9,11,16,47,61,-14,38
Ayr,3438,10,8,12,16,36,59,-23,36
Hibernian,3439,1,18,13,5,53,27,26,67
Falkirk,3439,2,18,9,9,59,37,22,63
Morton,3439,3,16,11,9,48,39,9,59
Dundee Utd,3439,4,15,11,10,52,39,13,56
Dunfermline,3439,5,12,12,12,52,47,5,48
Queen of S't,3439,6,11,12,13,47,51,-4,45
St Mirren,3439,7,10,9,17,39,54,-15,39
Raith,3439,8,10,9,17,35,54,-19,39
Dumbarton,3439,9,9,11,16,51,57,-6,38
Ayr,3439,10,6,13,17,30,61,-31,31
Hibernian,3440,1,17,13,6,57,30,27,64
Dundee Utd,3440,2,16,11,9,49,37,12,59
Morton,3440,3,14,15,7,49,39,10,57
Falkirk,3440,4,15,11,10,56,43,13,56
Queen of S't,3440,5,15,8,13,51,49,2,53
Raith,3440,6,11,10,15,39,50,-11,43
Dunfermline,3440,7,8,16,12,50,51,-1,40
Dumbarton,3440,8,9,11,16,52,66,-14,38
Ayr,3440,9,8,14,14,34,51,-17,38
St Mirren,3440,10,7,11,18,33,54,-21,32
Hibernian,3441,1,17,15,4,57,31,26,66
Morton,3441,2,16,13,7,49,34,15,61
Falkirk,3441,3,15,12,9,58,41,17,57
Dundee Utd,3441,4,14,9,13,49,46,3,51
Queen of S't,3441,5,13,9,14,46,47,-1,48
Dunfermline,3441,6,10,14,12,49,48,1,44
St Mirren,3441,7,10,11,15,43,53,-10,41
Raith,3441,8,9,12,15,35,50,-15,39
Dumbarton,3441,9,8,13,15,47,61,-14,37
Ayr,3441,10,8,12,16,36,58,-22,36
Hibernian,3442,1,19,11,6,51,26,25,68
Morton,3442,2,19,11,6,53,32,21,68
Dundee Utd,3442,3,18,8,10,59,40,19,62
Falkirk,3442,4,16,10,10,60,43,17,58
Queen of S't,3442,5,11,10,15,48,54,-6,43
Raith,3442,6,11,10,15,38,50,-12,43
Dunfermline,3442,7,8,14,14,43,51,-8,38
Dumbarton,3442,8,8,12,16,42,56,-14,36
St Mirren,3442,9,8,11,17,37,57,-20,35
Ayr,3442,10,8,11,17,36,58,-22,35
Morton,3443,1,18,11,7,55,35,20,65
Hibernian,3443,2,16,13,7,51,30,21,61
Dundee Utd,3443,3,17,9,10,48,39,9,60
Falkirk,3443,4,16,11,9,54,36,18,59
Dunfermline,3443,5,10,14,12,43,45,-2,44
Dumbarton,3443,6,10,12,14,49,54,-5,42
Queen of S't,3443,7,11,9,16,43,49,-6,42
Raith,3443,8,10,9,17,34,51,-17,39
Ayr,3443,9,9,12,15,36,55,-19,39
St Mirren,3443,10,8,10,18,39,58,-19,34
Hibernian,3444,1,18,11,7,54,33,21,65
Morton,3444,2,17,12,7,55,36,19,63
Falkirk,3444,3,16,12,8,59,38,21,60
Dundee Utd,3444,4,13,11,12,52,44,8,50
Dunfermline,3444,5,11,13,12,48,49,-1,46
Queen of S't,3444,6,11,9,16,44,53,-9,42
Dumbarton,3444,7,10,12,14,48,60,-12,42
Ayr,3444,8,10,11,15,43,61,-18,41
Raith,3444,9,10,10,16,32,47,-15,40
St Mirren,3444,10,9,9,18,37,51,-14,36
Hibernian,3445,1,19,14,3,62,28,34,71
Dundee Utd,3445,2,18,9,9,54,38,16,63
Falkirk,3445,3,17,11,8,60,39,21,62
Morton,3445,4,16,13,7,48,35,13,61
Queen of S't,3445,5,11,10,15,47,55,-8,43
Dumbarton,3445,6,10,11,15,51,65,-14,41
Raith,3445,7,9,10,17,35,53,-18,37
Dunfermline,3445,8,8,12,16,45,53,-8,36
Ayr,3445,9,7,14,15,36,57,-21,35
St Mirren,3445,10,8,10,18,42,57,-15,34
Hibernian,3446,1,20,12,4,56,26,30,72
Morton,3446,2,17,14,5,51,34,17,65
Dundee Utd,3446,3,16,10,10,56,43,13,58
Falkirk,3446,4,14,13,9,56,41,15,55
Dunfermline,3446,5,9,14,13,44,47,-3,41
St Mirren,3446,6,9,12,15,42,56,-14,39
Queen of S't,3446,7,9,11,16,43,56,-13,38
Raith,3446,8,10,8,18,35,49,-14,38
Ayr,3446,9,9,11,16,33,54,-21,38
Dumbarton,3446,10,8,13,15,50,60,-10,37
Hibernian,3447,1,20,12,4,56,24,32,72
Morton,3447,2,20,11,5,56,29,27,71
Dundee Utd,3447,3,16,11,9,50,36,14,59
Falkirk,3447,4,15,11,10,53,41,12,56
Queen of S't,3447,5,12,9,15,46,54,-8,45
Dumbarton,3447,6,11,11,14,52,53,-1,44
Dunfermline,3447,7,8,14,14,42,49,-7,38
Raith,3447,8,9,9,18,33,49,-16,36
Ayr,3447,9,6,14,16,30,61,-31,32
St Mirren,3447,10,7,10,19,35,57,-22,31
Hibernian,3448,1,21,12,3,61,25,36,75
Dundee Utd,3448,2,17,10,9,49,42,7,61
Falkirk,3448,3,15,11,10,54,40,14,56
Morton,3448,4,15,11,10,47,37,10,56
Dunfermline,3448,5,10,14,12,43,44,-1,44
Queen of S't,3448,6,11,10,15,50,56,-6,43
Ayr,3448,7,10,12,14,43,56,-13,42
Raith,3448,8,11,9,16,34,48,-14,42
Dumbarton,3448,9,8,11,17,45,57,-12,35
St Mirren,3448,10,7,10,19,35,56,-21,31
Hibernian,3449,1,19,12,5,56,25,31,69
Dundee Utd,3449,2,17,11,8,52,37,15,62
Falkirk,3449,3,17,10,9,63,41,22,61
Morton,3449,4,14,13,9,46,39,7,55
Queen of S't,3449,5,11,11,14,47,53,-6,44
Raith,3449,6,11,11,14,35,45,-10,44
Dunfermline,3449,7,10,12,14,45,45,0,42
Ayr,3449,8,9,11,16,36,55,-19,38
Dumbarton,3449,9,9,10,17,46,65,-19,37
St Mirren,3449,10,7,11,18,33,54,-21,32
Hibernian,3450,1,21,12,3,56,21,35,75
Morton,3450,2,19,10,7,51,34,17,67
Falkirk,3450,3,18,9,9,64,40,24,63
Dundee Utd,3450,4,13,12,11,44,42,2,51
Queen of S't,3450,5,12,10,14,43,49,-6,46
Dunfermline,3450,6,10,12,14,49,49,0,42
Ayr,3450,7,10,11,15,38,54,-16,41
Dumbarton,3450,8,8,12,16,46,58,-12,36
Raith,3450,9,9,9,18,36,55,-19,36
St Mirren,3450,10,6,11,19,34,59,-25,29
Hibernian,3451,1,21,12,3,64,26,38,75
Morton,3451,2,19,11,6,59,36,23,68
Falkirk,3451,3,16,11,9,58,43,15,59
Dundee Utd,3451,4,15,9,12,46,41,5,54
Queen of S't,3451,5,11,9,16,46,57,-11,42
Dunfermline,3451,6,9,13,14,48,53,-5,40
Dumbarton,3451,7,9,11,16,51,62,-11,38
St Mirren,3451,8,9,11,16,40,53,-13,38
Raith,3451,9,9,10,17,32,50,-18,37
Ayr,3451,10,8,11,17,33,56,-23,35
Morton,3452,1,18,11,7,53,35,18,65
Hibernian,3452,2,17,13,6,51,29,22,64
Dundee Utd,3452,3,18,9,9,57,37,20,63
Falkirk,3452,4,16,11,9,58,39,19,59
Queen of S't,3452,5,12,10,14,49,51,-2,46
Dunfermline,3452,6,10,13,13,47,51,-4,43
Raith,3452,7,10,10,16,34,47,-13,40
Dumbarton,3452,8,9,11,16,50,66,-16,38
St Mirren,3452,9,7,12,17,38,55,-17,33
Ayr,3452,10,7,12,17,34,61,-27,33
Hibernian,3453,1,19,13,4,55,26,29,70
Falkirk,3453,2,19,9,8,65,39,26,66
Morton,3453,3,18,12,6,53,32,21,66
Dundee Utd,3453,4,14,10,12,47,44,3,52
Queen of S't,3453,5,13,8,15,48,49,-1,47
Raith,3453,6,11,9,16,37,51,-14,42
Dunfermline,3453,7,9,12,15,46,53,-7,39
Dumbarton,3453,8,9,12,15,51,61,-10,39
Ayr,3453,9,7,13,16,35,59,-24,34
St Mirren,3453,10,6,12,18,37,60,-23,30
Hibernian,3454,1,19,14,3,55,20,35,71
Morton,3454,2,17,12,7,50,34,16,63
Falkirk,3454,3,15,11,10,59,42,17,56
Dundee Utd,3454,4,15,10,11,50,42,8,55
Dunfermline,3454,5,11,13,12,52,48,4,46
Ayr,3454,6,9,14,13,31,48,-17,41
St Mirren,3454,7,9,12,15,43,54,-11,39
Dumbarton,3454,8,9,12,15,47,59,-12,39
Queen of S't,3454,9,9,9,18,39,56,-17,36
Raith,3454,10,9,9,18,32,55,-23,36
Hibernian,3455,1,19,13,4,59,29,30,70
Falkirk,3455,2,17,11,8,66,44,22,62
Morton,3455,3,17,9,10,51,39,12,60
Dundee Utd,3455,4,15,10,11,50,43,7,55
Queen of S't,3455,5,11,10,15,48,56,-8,43
Dunfermline,3455,6,10,12,14,45,51,-6,42
Raith,3455,7,10,11,15,37,49,-12,41
Dumbarton,3455,8,9,12,15,50,58,-8,39
Ayr,3455,9,9,11,16,35,54,-19,38
St Mirren,3455,10,8,11,17,38,56,-18,35
Hibernian,3456,1,17,14,5,56,30,26,65
Falkirk,3456,2,16,11,9,59,43,16,59
Dundee Utd,3456,3,16,9,11,53,40,13,57
Morton,3456,4,15,12,9,49,42,7,57
Queen of S't,3456,5,14,9,13,48,45,3,51
Dunfermline,3456,6,10,13,13,47,49,-2,43
Raith,3456,7,10,10,16,37,50,-13,40
Dumbarton,3456,8,9,11,16,46,63,-17,38
Ayr,3456,9,9,11,16,37,56,-19,38
St Mirren,3456,10,9,10,17,45,59,-14,37
Hibernian,3457,1,19,11,6,54,28,26,68
Morton,3457,2,18,10,8,56,37,19,64
Dundee Utd,3457,3,18,9,9,60,43,17,63
Falkirk,3457,4,16,11,9,59,41,18,59
Dunfermline,3457,5,11,13,12,47,44,3,46
Dumbarton,3457,6,10,12,14,47,54,-7,42
Raith,3457,7,10,10,16,34,47,-13,40
Queen of S't,3457,8,10,9,17,45,56,-11,39
St Mirren,3457,9,8,10,18,37,60,-23,34
Ayr,3457,10,7,11,18,34,63,-29,32
Hibernian,3458,1,19,13,4,54,24,30,70
Morton,3458,2,17,12,7,53,34,19,63
Dundee Utd,3458,3,15,11,10,51,38,13,56
Falkirk,3458,4,13,10,13,55,48,7,49
Dunfermline,3458,5,12,13,11,47,45,2,49
Queen of S't,3458,6,13,8,15,46,52,-6,47
Dumbarton,3458,7,10,11,15,50,60,-10,41
Ayr,3458,8,9,11,16,39,59,-20,38
St Mirren,3458,9,9,10,17,40,58,-18,37
Raith,3458,10,9,9,18,33,50,-17,36
Hibernian,3459,1,19,12,5,59,29,30,69
Falkirk,3459,2,18,11,7,63,40,23,65
Morton,3459,3,17,11,8,52,37,15,62
Dundee Utd,3459,4,16,8,12,52,41,11,56
Queen of S't,3459,5,11,9,16,46,51,-5,42
Dunfermline,3459,6,9,14,13,45,49,-4,41
Raith,3459,7,10,11,15,36,47,-11,41
Ayr,3459,8,9,11,16,35,59,-24,38
Dumbarton,3459,9,8,12,16,47,59,-12,36
St Mirren,3459,10,8,11,17,41,64,-23,35
Hibernian,3460,1,20,11,5,56,25,31,71
Dundee Utd,3460,2,19,9,8,61,35,26,66
Falkirk,3460,3,17,10,9,58,41,17,61
Morton,3460,4,17,10,9,52,42,10,61
Dunfermline,3460,5,10,13,13,42,45,-3,43
Queen of S't,3460,6,10,11,15,45,50,-5,41
St Mirren,3460,7,10,9,17,42,55,-13,39
Raith,3460,8,10,9,17,36,51,-15,39
Ayr,3460,9,7,13,16,34,61,-27,34
Dumbarton,3460,10,7,11,18,45,66,-21,32
Hibernian,3461,1,18,13,5,52,26,26,67
Morton,3461,2,17,10,9,51,42,9,61
Falkirk,3461,3,14,12,10,56,44,12,54
Dundee Utd,3461,4,14,10,12,49,42,7,52
Dunfermline,3461,5,11,13,12,50,45,5,46
Queen of S't,3461,6,11,10,15,45,57,-12,43
Dumbarton,3461,7,9,14,13,52,56,-4,41
Raith,3461,8,10,10,16,38,50,-12,40
St Mirren,3461,9,10,10,16,40,54,-14,40
Ayr,3461,10,9,12,15,37,54,-17,39
Hibernian,3462,1,19,12,5,57,26,31,69
Morton,3462,2,15,11,10,46,39,7,56
Dundee Utd,3462,3,15,10,11,52,46,6,55
Falkirk,3462,4,14,12,10,54,44,10,54
Dunfermline,3462,5,12,13,11,49,46,3,49
Queen of S't,3462,6,11,10,15,49,52,-3,43
Raith,3462,7,11,10,15,36,46,-10,43
Ayr,3462,8,10,11,15,38,56,-18,41
Dumbarton,3462,9,9,11,16,52,65,-13,38
St Mirren,3462,10,9,10,17,44,57,-13,37
Hibernian,3463,1,20,11,5,55,26,29,71
Dundee Utd,3463,2,16,11,9,56,40,16,59
Morton,3463,3,16,10,10,48,43,5,58
Falkirk,3463,4,15,11,10,57,43,14,56
Queen of S't,3463,5,14,8,14,47,49,-2,50
Dunfermline,3463,6,11,14,11,50,45,5,47
Raith,3463,7,9,11,16,36,50,-14,38
St Mirren,3463,8,9,10,17,43,55,-12,37
Dumbarton,3463,9,8,12,16,47,63,-16,36
Ayr,3463,10,7,12,17,32,57,-25,33
Hibernian,3464,1,18,12,6,51,28,23,66
Morton,3464,2,16,12,8,53,39,14,60
Falkirk,3464,3,16,11,9,58,39,19,59
Dundee Utd,3464,4,15,12,9,49,40,9,57
Dunfermline,3464,5,11,12,13,48,50,-2,45
Raith,3464,6,11,9,16,35,48,-13,42
St Mirren,3464,7,10,10,16,42,53,-11,40
Dumbarton,3464,8,9,12,15,48,61,-13,39
Queen of S't,3464,9,10,8,18,40,51,-11,38
Ayr,3464,10,8,14,14,38,53,-15,38
Hibernian,3465,1,19,11,6,53,24,29,68
Morton,3465,2,19,11,6,51,32,19,68
Falkirk,3465,3,15,12,9,55,39,16,57
Dundee Utd,3465,4,13,10,13,46,46,0,49
Queen of S't,3465,5,12,10,14,45,47,-2,46
Dunfermline,3465,6,9,14,13,44,48,-4,41
Raith,3465,7,10,10,16,38,48,-10,40
Dumbarton,3465,8,10,10,16,47,59,-12,40
Ayr,3465,9,9,13,14,39,56,-17,40
St Mirren,3465,10,8,11,17,39,58,-19,35
Hibernian,3466,1,18,12,6,58,33,25,66
Falkirk,3466,2,17,10,9,63,39,24,61
Morton,3466,3,17,10,9,48,35,13,61
Dundee Utd,3466,4,16,8,12,51,42,9,56
Dunfermline,3466,5,11,14,11,49,47,2,47
Queen of S't,3466,6,11,10,15,41,53,-12,43
Raith,3466,7,11,9,16,41,50,-9,42
Ayr,3466,8,8,13,15,33,54,-21,37
St Mirren,3466,9,8,12,16,44,56,-12,36
Dumbarton,3466,10,8,12,16,43,62,-19,36
Hibernian,3467,1,20,10,6,56,28,28,70
Morton,3467,2,19,10,7,52,36,16,67
Falkirk,3467,3,16,11,9,63,42,21,59
Dundee Utd,3467,4,14,10,12,46,43,3,52
Queen of S't,3467,5,13,9,14,51,53,-2,48
Dunfermline,3467,6,9,14,13,47,48,-1,41
Dumbarton,3467,7,10,11,15,47,54,-7,41
Raith,3467,8,11,8,17,36,53,-17,41
St Mirren,3467,9,9,10,17,42,56,-14,37
Ayr,3467,10,7,11,18,33,60,-27,32
Hibernian,3468,1,18,11,7,51,29,22,65
Dundee Utd,3468,2,17,11,8,53,38,15,62
Falkirk,3468,3,16,10,10,59,44,15,58
Morton,3468,4,15,9,12,47,41,6,54
Dunfermline,3468,5,11,13,12,53,49,4,46
Queen of S't,3468,6,12,10,14,46,49,-3,46
Raith,3468,7,11,9,16,38,50,-12,42
Dumbarton,3468,8,9,12,15,44,58,-14,39
St Mirren,3468,9,9,10,17,46,57,-11,37
Ayr,3468,10,8,13,15,31,53,-22,37
Hibernian,3469,1,19,11,6,57,27,30,68
Morton,3469,2,16,11,9,51,39,12,59
Falkirk,3469,3,16,10,10,57,44,13,58
Dundee Utd,3469,4,14,10,12,46,41,5,52
Dunfermline,3469,5,12,13,11,52,44,8,49
Dumbarton,3469,6,10,11,15,47,57,-10,41
Queen of S't,3469,7,11,8,17,42,53,-11,41
Ayr,3469,8,10,11,15,36,53,-17,41
Raith,3469,9,9,12,15,35,50,-15,39
St Mirren,3469,10,9,11,16,42,57,-15,38
Hibernian,3470,1,18,13,5,56,29,27,67
Morton,3470,2,17,11,8,56,40,16,62
Dundee Utd,3470,3,16,8,12,51,42,9,56
Falkirk,3470,4,15,10,11,60,44,16,55
Queen of S't,3470,5,14,8,14,51,53,-2,50
Ayr,3470,6,11,10,15,37,54,-17,43
Dunfermline,3470,7,9,14,13,50,56,-6,41
Raith,3470,8,11,8,17,41,51,-10,41
Dumbarton,3470,9,9,11,16,49,65,-16,38
St Mirren,3470,10,9,9,18,38,55,-17,36
Hibernian,3471,1,19,13,4,60,31,29,70
Morton,3471,2,17,11,8,56,41,15,62
Falkirk,3471,3,15,13,8,59,40,19,58
Dundee Utd,3471,4,16,9,11,54,44,10,57
Queen of S't,3471,5,12,10,14,46,54,-8,46
Ayr,3471,6,11,11,14,43,55,-12,44
Dunfermline,3471,7,8,15,13,43,49,-6,39
Dumbarton,3471,8,8,14,14,50,60,-10,38
Raith,3471,9,9,11,16,38,53,-15,38
St Mirren,3471,10,6,11,19,36,58,-22,29
Hibernian,3472,1,17,14,5,56,30,26,65
Morton,3472,2,17,14,5,50,34,16,65
Falkirk,3472,3,18,9,9,58,39,19,63
Dundee Utd,3472,4,17,11,8,51,36,15,62
Queen of S't,3472,5,11,9,16,47,53,-6,42
Dumbarton,3472,6,10,10,16,51,59,-8,40
Dunfermline,3472,7,8,15,13,49,54,-5,39
Ayr,3472,8,9,12,15,38,55,-17,39
St Mirren,3472,9,8,10,18,40,58,-18,34
Raith,3472,10,8,10,18,33,55,-22,34
Hibernian,3473,1,18,12,6,53,29,24,66
Dundee Utd,3473,2,16,12,8,49,35,14,60
Morton,3473,3,16,11,9,49,36,13,59
Falkirk,3473,4,15,10,11,54,42,12,55
Queen of S't,3473,5,14,10,12,52,45,7,52
Raith,3473,6,11,10,15,38,53,-15,43
Dumbarton,3473,7,10,11,15,53,62,-9,41
St Mirren,3473,8,9,10,17,44,55,-11,37
Dunfermline,3473,9,8,12,16,43,52,-9,36
Ayr,3473,10,7,14,15,30,56,-26,35
Hibernian,3474,1,18,14,4,57,29,28,68
Morton,3474,2,17,11,8,54,40,14,62
Falkirk,3474,3,17,10,9,58,39,19,61
Dundee Utd,3474,4,14,10,12,46,41,5,52
Raith,3474,5,13,10,13,40,46,-6,49
Queen of S't,3474,6,11,10,15,50,53,-3,43
Dumbarton,3474,7,10,10,16,46,60,-14,40
Ayr,3474,8,9,12,15,36,54,-18,39
St Mirren,3474,9,9,10,17,40,56,-16,37
Dunfermline,3474,10,7,13,16,43,52,-9,34
Morton,3475,1,19,9,8,53,37,16,66
Hibernian,3475,2,18,10,8,54,33,21,64
Falkirk,3475,3,16,10,10,58,41,17,58
Dundee Utd,3475,4,15,11,10,55,44,11,56
Queen of S't,3475,5,12,9,15,43,46,-3,45
Dunfermline,3475,6,11,11,14,45,50,-5,44
Raith,3475,7,11,8,17,36,50,-14,41
Dumbarton,3475,8,9,12,15,47,59,-12,39
Ayr,3475,9,9,12,15,41,55,-14,39
St Mirren,3475,10,9,10,17,41,58,-17,37
Hibernian,3476,1,18,15,3,56,23,33,69
Falkirk,3476,2,17,11,8,60,37,23,62
Dundee Utd,3476,3,15,11,10,49,42,7,56
Morton,3476,4,13,14,9,45,41,4,53
Dunfermline,3476,5,11,12,13,50,49,1,45
Ayr,3476,6,11,11,14,39,54,-15,44
Queen of S't,3476,7,11,9,16,49,55,-6,42
Raith,3476,8,10,10,16,40,55,-15,40
Dumbarton,3476,9,8,13,15,48,62,-14,37
St Mirren,3476,10,6,14,16,38,56,-18,32
Hibernian,3477,1,18,13,5,58,26,32,67
Falkirk,3477,2,19,9,8,64,37,27,66
Morton,3477,3,18,12,6,49,33,16,66
Dundee Utd,3477,4,15,10,11,49,40,9,55
Queen of S't,3477,5,12,10,14,44,50,-6,46
Dunfermline,3477,6,10,11,15,47,52,-5,41
St Mirren,3477,7,9,12,15,38,52,-14,39
Dumbarton,3477,8,9,10,17,47,61,-14,37
Raith,3477,9,9,9,18,34,53,-19,36
Ayr,3477,10,7,12,17,29,55,-26,33
Hibernian,3478,1,19,12,5,59,28,31,69
Dundee Utd,3478,2,17,10,9,52,37,15,61
Morton,3478,3,16,11,9,47,37,10,59
Falkirk,3478,4,15,11,10,58,45,13,56
Dumbarton,3478,5,12,12,12,55,55,0,48
Dunfermline,3478,6,9,15,12,46,48,-2,42
Queen of S't,3478,7,10,10,16,43,52,-9,40
Raith,3478,8,9,11,16,33,50,-17,38
St Mirren,3478,9,9,9,18,43,60,-17,36
Ayr,3478,10,7,13,16,33,57,-24,34
Falkirk,3479,1,19,9,8,64,35,29,66
Hibernian,3479,2,17,12,7,50,28,22,63
Morton,3479,3,16,13,7,49,36,13,61
Dundee Utd,3479,4,15,9,12,50,45,5,54
Ayr,3479,5,12,10,14,39,54,-15,46
Dunfermline,3479,6,10,15,11,46,47,-1,45
Dumbarton,3479,7,10,10,16,50,58,-8,40
Queen of S't,3479,8,10,10,16,41,51,-10,40
St Mirren,3479,9,9,9,18,41,57,-16,36
Raith,3479,10,9,9,18,32,51,-19,36
Hibernian,3480,1,20,10,6,53,27,26,70
Morton,3480,2,17,12,7,51,34,17,63
Dundee Utd,3480,3,16,9,11,55,39,16,57
Falkirk,3480,4,14,10,12,54,45,9,52
Dumbarton,3480,5,10,13,13,53,59,-6,43
Dunfermline,3480,6,10,12,14,42,49,-7,42
Ayr,3480,7,10,12,14,34,52,-18,42
Queen of S't,3480,8,10,11,15,44,50,-6,41
Raith,3480,9,10,11,15,34,45,-11,41
St Mirren,3480,10,7,12,17,37,57,-20,33
Hibernian,3481,1,19,13,4,55,26,29,70
Falkirk,3481,2,19,10,7,64,38,26,67
Morton,3481,3,17,9,10,45,35,10,60
Dundee Utd,3481,4,16,8,12,51,41,10,56
Dunfermline,3481,5,11,12,13,45,51,-6,45
Ayr,3481,6,10,12,14,36,51,-15,42
Dumbarton,3481,7,9,12,15,47,55,-8,39
Raith,3481,8,10,9,17,36,48,-12,39
Queen of S't,3481,9,10,9,17,44,57,-13,39
St Mirren,3481,10,6,12,18,36,57,-21,30
Hibernian,3482,1,20,10,6,60,28,32,70
Dundee Utd,3482,2,17,9,10,54,39,15,60
Morton,3482,3,16,12,8,51,39,12,60
Falkirk,3482,4,16,11,9,58,38,20,59
Queen of S't,3482,5,13,8,15,48,54,-6,47
Raith,3482,6,10,10,16,38,52,-14,40
Dumbarton,3482,7,8,14,14,47,55,-8,38
Dunfermline,3482,8,8,13,15,45,56,-11,37
St Mirren,3482,9,8,13,15,41,57,-16,37
Ayr,3482,10,8,12,16,36,60,-24,36
Hibernian,3483,1,18,12,6,53,27,26,66
Morton,3483,2,17,12,7,53,36,17,63
Dundee Utd,3483,3,17,9,10,55,37,18,60
Falkirk,3483,4,17,9,10,53,40,13,60
Queen of S't,3483,5,13,10,13,49,48,1,49
St Mirren,3483,6,10,10,16,42,50,-8,40
Dunfermline,3483,7,9,12,15,46,52,-6,39
Raith,3483,8,10,9,17,34,52,-18,39
Ayr,3483,9,8,12,16,39,58,-19,36
Dumbarton,3483,10,8,11,17,41,65,-24,35
Hibernian,3484,1,19,11,6,54,29,25,68
Morton,3484,2,19,10,7,55,34,21,67
Falkirk,3484,3,16,11,9,58,39,19,59
Dundee Utd,3484,4,16,9,11,49,43,6,57
Queen of S't,3484,5,12,9,15,41,46,-5,45
Dumbarton,3484,6,9,14,13,46,54,-8,41
Dunfermline,3484,7,9,13,14,45,48,-3,40
St Mirren,3484,8,9,11,16,42,56,-14,38
Ayr,3484,9,9,11,16,33,51,-18,38
Raith,3484,10,8,9,19,32,55,-23,33
Hibernian,3485,1,17,15,4,52,26,26,66
Morton,3485,2,18,12,6,53,34,19,66
Falkirk,3485,3,16,11,9,60,41,19,59
Dundee Utd,3485,4,14,10,12,47,42,5,52
Dunfermline,3485,5,10,12,14,43,47,-4,42
Queen of S't,3485,6,10,12,14,42,49,-7,42
Ayr,3485,7,9,14,13,37,54,-17,41
Dumbarton,3485,8,9,13,14,47,57,-10,40
St Mirren,3485,9,8,12,16,43,53,-10,36
Raith,3485,10,8,11,17,36,57,-21,35
Hibernian,3486,1,20,12,4,55,25,30,72
Falkirk,3486,2,16,10,10,55,39,16,58
Morton,3486,3,15,13,8,48,37,11,58
Dundee Utd,3486,4,14,9,13,46,46,0,51
Dunfermline,3486,5,11,13,12,44,45,-1,46
Queen of S't,3486,6,11,9,16,40,46,-6,42
Dumbarton,3486,7,10,12,14,47,54,-7,42
Raith,3486,8,11,9,16,36,46,-10,42
St Mirren,3486,9,9,11,16,41,52,-11,38
Ayr,3486,10,8,12,16,32,54,-22,36
Hibernian,3487,1,20,12,4,56,24,32,72
Morton,3487,2,17,10,9,45,34,11,61
Falkirk,3487,3,16,10,10,61,46,15,58
Dundee Utd,3487,4,16,10,10,47,37,10,58
Queen of S't,3487,5,12,11,13,44,47,-3,47
Raith,3487,6,11,12,13,37,43,-6,45
Dumbarton,3487,7,10,11,15,47,56,-9,41
Dunfermline,3487,8,8,13,15,45,51,-6,37
Ayr,3487,9,7,12,17,28,51,-23,33
St Mirren,3487,10,7,11,18,34,55,-21,32
Hibernian,3488,1,18,13,5,62,33,29,67
Falkirk,3488,2,18,11,7,64,37,27,65
Morton,3488,3,17,12,7,57,37,20,63
Dundee Utd,3488,4,15,9,12,45,40,5,54
Queen of S't,3488,5,12,11,13,44,48,-4,47
Dunfermline,3488,6,10,12,14,42,45,-3,42
Dumbarton,3488,7,9,13,14,46,56,-10,40
Raith,3488,8,10,9,17,33,51,-18,39
St Mirren,3488,9,9,11,16,43,57,-14,38
Ayr,3488,10,6,11,19,27,59,-32,29
Hibernian,3489,1,18,12,6,51,25,26,66
Morton,3489,2,18,11,7,51,36,15,65
Falkirk,3489,3,15,13,8,59,43,16,58
Dundee Utd,3489,4,13,13,10,51,44,7,52
Dunfermline,3489,5,12,13,11,58,47,11,49
Queen of S't,3489,6,12,9,15,43,47,-4,45
Ayr,3489,7,10,12,14,37,51,-14,42
St Mirren,3489,8,8,13,15,39,53,-14,37
Dumbarton,3489,9,8,12,16,43,60,-17,36
Raith,3489,10,8,8,20,31,57,-26,32
Hibernian,3490,1,22,10,4,61,22,39,76
Morton,3490,2,19,10,7,53,34,19,67
Falkirk,3490,3,16,11,9,57,39,18,59
Dundee Utd,3490,4,13,10,13,50,43,7,49
Queen of S't,3490,5,13,8,15,49,53,-4,47
St Mirren,3490,6,10,10,16,44,57,-13,40
Dumbarton,3490,7,9,12,15,49,61,-12,39
Dunfermline,3490,8,8,14,14,38,49,-11,38
Ayr,3490,9,8,12,16,39,61,-22,36
Raith,3490,10,8,11,17,31,52,-21,35
Hibernian,3491,1,16,15,5,50,28,22,63
Falkirk,3491,2,17,10,9,55,34,21,61
Morton,3491,3,15,12,9,52,39,13,57
Dundee Utd,3491,4,14,9,13,44,41,3,51
Queen of S't,3491,5,13,9,14,44,46,-2,48
Dunfermline,3491,6,11,12,13,50,52,-2,45
Raith,3491,7,12,8,16,37,49,-12,44
Ayr,3491,8,9,13,14,34,50,-16,40
Dumbarton,3491,9,9,12,15,47,61,-14,39
St Mirren,3491,10,9,10,17,43,56,-13,37
Hibernian,3492,1,20,10,6,57,27,30,70
Dundee Utd,3492,2,18,9,9,60,39,21,63
Morton,3492,3,16,13,7,52,36,16,61
Falkirk,3492,4,15,12,9,58,42,16,57
Queen of S't,3492,5,12,11,13,47,52,-5,47
Dunfermline,3492,6,9,14,13,45,51,-6,41
Dumbarton,3492,7,9,13,14,49,57,-8,40
Raith,3492,8,9,10,17,34,48,-14,37
Ayr,3492,9,8,11,17,35,61,-26,35
St Mirren,3492,10,8,9,19,39,63,-24,33
Hibernian,3493,1,18,13,5,54,25,29,67
Falkirk,3493,2,17,10,9,64,41,23,61
Dundee Utd,3493,3,15,11,10,48,43,5,56
Morton,3493,4,14,12,10,46,42,4,54
Queen of S't,3493,5,13,10,13,53,50,3,49
Dumbarton,3493,6,11,12,13,49,51,-2,45
Ayr,3493,7,10,11,15,34,53,-19,41
Dunfermline,3493,8,9,12,15,44,52,-8,39
Raith,3493,9,10,9,17,33,50,-17,39
St Mirren,3493,10,8,10,18,38,56,-18,34
Hibernian,3494,1,18,12,6,52,30,22,66
Morton,3494,2,17,13,6,51,32,19,64
Falkirk,3494,3,17,11,8,61,41,20,62
Dundee Utd,3494,4,14,10,12,45,41,4,52
Queen of S't,3494,5,11,10,15,45,53,-8,43
Raith,3494,6,10,11,15,35,48,-13,41
Dunfermline,3494,7,9,13,14,44,47,-3,40
Dumbarton,3494,8,9,13,14,49,56,-7,40
Ayr,3494,9,7,16,13,38,55,-17,37
St Mirren,3494,10,8,11,17,42,59,-17,35
Hibernian,3495,1,18,13,5,50,24,26,67
Morton,3495,2,17,12,7,52,35,17,63
Dundee Utd,3495,3,16,11,9,51,36,15,59
Falkirk,3495,4,15,12,9,51,37,14,57
St Mirren,3495,5,11,10,15,45,50,-5,43
Dumbarton,3495,6,10,12,14,48,57,-9,42
Queen of S't,3495,7,10,10,16,41,51,-10,40
Dunfermline,3495,8,8,14,14,44,49,-5,38
Raith,3495,9,9,11,16,33,52,-19,38
Ayr,3495,10,7,13,16,31,55,-24,34
Hibernian,3496,1,18,12,6,51,31,20,66
Falkirk,3496,2,16,11,9,60,41,19,59
Morton,3496,3,16,11,9,52,37,15,59
Dundee Utd,3496,4,17,8,11,49,37,12,59
Dunfermline,3496,5,11,13,12,47,49,-2,46
Queen of S't,3496,6,11,10,15,45,51,-6,43
Dumbarton,3496,7,11,10,15,50,57,-7,43
St Mirren,3496,8,10,10,16,42,55,-13,40
Raith,3496,9,9,10,17,34,51,-17,37
Ayr,3496,10,8,11,17,34,55,-21,35
Hibernian,3497,1,17,14,5,51,24,27,65
Morton,3497,2,18,11,7,52,39,13,65
Falkirk,3497,3,15,12,9,58,39,19,57
Dundee Utd,3497,4,14,11,11,52,44,8,53
Raith,3497,5,11,10,15,34,45,-11,43
Dunfermline,3497,6,9,15,12,51,50,1,42
Dumbarton,3497,7,9,14,13,55,58,-3,41
Queen of S't,3497,8,10,11,15,45,52,-7,41
Ayr,3497,9,9,13,14,36,54,-18,40
St Mirren,3497,10,8,9,19,38,67,-29,33
Hibernian,3498,1,18,12,6,53,26,27,66
Dundee Utd,3498,2,18,10,8,60,38,22,64
Morton,3498,3,17,12,7,50,34,16,63
Falkirk,3498,4,16,10,10,62,43,19,58
Queen of S't,3498,5,14,8,14,47,50,-3,50
Raith,3498,6,10,10,16,34,49,-15,40
Dumbarton,3498,7,9,12,15,47,57,-10,39
Dunfermline,3498,8,8,13,15,43,55,-12,37
St Mirren,3498,9,8,11,17,40,58,-18,35
Ayr,3498,10,8,10,18,31,57,-26,34
Hibernian,3499,1,20,11,5,55,28,27,71
Morton,3499,2,17,9,10,53,36,17,60
Falkirk,3499,3,16,11,9,56,39,17,59
Dundee Utd,3499,4,16,10,10,53,42,11,58
Raith,3499,5,12,8,16,42,52,-10,44
Dunfermline,3499,6,9,14,13,45,48,-3,41
Queen of S't,3499,7,10,10,16,46,56,-10,40
St Mirren,3499,8,10,10,16,41,56,-15,40
Dumbarton,3499,9,9,11,16,47,63,-16,38
Ayr,3499,10,8,12,16,37,55,-18,36
Hibernian,3500,1,20,12,4,56,24,32,72
Morton,3500,2,16,11,9,50,37,13,59
Falkirk,3500,3,15,11,10,55,39,16,56
Dundee Utd,3500,4,15,11,10,47,39,8,56
Dunfermline,3500,5,10,14,12,41,43,-2,44
Ayr,3500,6,10,13,13,34,51,-17,43
Queen of S't,3500,7,11,9,16,42,52,-10,42
Dumbarton,3500,8,8,13,15,47,57,-10,37
St Mirren,3500,9,9,10,17,40,53,-13,37
Raith,3500,10,8,12,16,33,50,-17,36
Hibernian,3501,1,17,12,7,52,29,23,63
Falkirk,3501,2,17,10,9,61,39,22,61
Dundee Utd,3501,3,17,10,9,54,38,16,61
Morton,3501,4,16,13,7,49,35,14,61
Queen of S't,3501,5,13,8,15,43,47,-4,47
St Mirren,3501,6,12,9,15,50,53,-3,45
Dunfermline,3501,7,11,11,14,43,46,-3,44
Raith,3501,8,10,8,18,37,54,-17,38
Dumbarton,3501,9,8,12,16,45,60,-15,36
Ayr,3501,10,7,11,18,30,63,-33,32
Hibernian,3502,1,20,12,4,58,26,32,72
Morton,3502,2,17,13,6,56,37,19,64
Falkirk,3502,3,17,9,10,58,42,16,60
Dundee Utd,3502,4,15,10,11,49,46,3,55
Queen of S't,3502,5,12,9,15,44,50,-6,45
Dunfermline,3502,6,10,12,14,48,49,-1,42
Ayr,3502,7,8,14,14,36,51,-15,38
Raith,3502,8,9,10,17,31,48,-17,37
St Mirren,3502,9,9,9,18,43,58,-15,36
Dumbarton,3502,10,8,12,16,47,63,-16,36
Hibernian,3503,1,21,10,5,56,26,30,73
Dundee Utd,3503,2,17,8,11,53,41,12,59
Falkirk,3503,3,16,10,10,61,41,20,58
Morton,3503,4,15,13,8,49,38,11,58
Dunfermline,3503,5,11,13,12,49,48,1,46
Raith,3503,6,12,9,15,38,48,-10,45
Queen of S't,3503,7,10,10,16,45,53,-8,40
Ayr,3503,8,8,13,15,33,53,-20,37
Dumbarton,3503,9,8,12,16,45,57,-12,36
St Mirren,3503,10,8,10,18,38,62,-24,34
Hibernian,3504,1,19,12,5,54,27,27,69
Dundee Utd,3504,2,16,11,9,51,37,14,59
Falkirk,3504,3,14,12,10,50,39,11,54
Morton,3504,4,14,12,10,46,38,8,54
Dumbarton,3504,5,10,14,12,49,52,-3,44
Dunfermline,3504,6,9,16,11,47,47,0,43
Queen of S't,3504,7,11,10,15,45,51,-6,43
Raith,3504,8,9,12,15,34,46,-12,39
St Mirren,3504,9,9,11,16,44,57,-13,38
Ayr,3504,10,7,14,15,30,56,-26,35
Hibernian,3505,1,17,11,8,52,32,20,62
Morton,3505,2,15,14,7,49,36,13,59
Dundee Utd,3505,3,16,9,11,48,40,8,57
Falkirk,3505,4,15,11,10,58,44,14,56
Queen of S't,3505,5,14,9,13,49,44,5,51
Dunfermline,3505,6,11,12,13,49,52,-3,45
Raith,3505,7,11,10,15,36,47,-11,43
St Mirren,3505,8,10,10,16,44,54,-10,40
Dumbarton,3505,9,9,12,15,46,57,-11,39
Ayr,3505,10,6,14,16,29,54,-25,32
Hibernian,3506,1,18,13,5,53,27,26,67
Falkirk,3506,2,17,10,9,65,42,23,61
Morton,3506,3,15,11,10,50,39,11,56
Dundee Utd,3506,4,14,12,10,47,41,6,54
Raith,3506,5,13,8,15,39,47,-8,47
Dunfermline,3506,6,11,13,12,47,47,0,46
Ayr,3506,7,10,13,13,39,53,-14,43
Queen of S't,3506,8,11,9,16,45,51,-6,42
St Mirren,3506,9,8,12,16,39,58,-19,36
Dumbarton,3506,10,7,11,18,44,63,-19,32
Hibernian,3507,1,20,12,4,57,26,31,72
Morton,3507,2,18,10,8,57,36,21,64
Dundee Utd,3507,3,17,10,9,51,39,12,61
Falkirk,3507,4,15,11,10,56,38,18,56
Ayr,3507,5,11,12,13,37,50,-13,45
Dumbarton,3507,6,10,11,15,52,58,-6,41
Dunfermline,3507,7,9,13,14,42,52,-10,40
Raith,3507,8,9,12,15,33,47,-14,39
Queen of S't,3507,9,9,10,17,39,53,-14,37
St Mirren,3507,10,6,11,19,38,63,-25,29
Morton,3508,1,18,12,6,53,35,18,66
Falkirk,3508,2,18,10,8,64,43,21,64
Dundee Utd,3508,3,18,8,10,57,44,13,62
Hibernian,3508,4,16,13,7,52,33,19,61
Dunfermline,3508,5,10,12,14,52,51,1,42
Ayr,3508,6,10,12,14,39,51,-12,42
Queen of S't,3508,7,11,8,17,46,56,-10,41
Raith,3508,8,10,9,17,34,51,-17,39
St Mirren,3508,9,9,10,17,39,54,-15,37
Dumbarton,3508,10,8,10,18,44,62,-18,34
Hibernian,3509,1,17,14,5,53,26,27,65
Morton,3509,2,16,12,8,52,37,15,60
Falkirk,3509,3,16,11,9,62,43,19,59
Dundee Utd,3509,4,15,10,11,53,46,7,55
Dumbarton,3509,5,10,14,12,53,55,-2,44
Queen of S't,3509,6,10,12,14,41,47,-6,42
Ayr,3509,7,9,13,14,35,53,-18,40
Dunfermline,3509,8,9,12,15,48,58,-10,39
St Mirren,3509,9,10,9,17,43,58,-15,39
Raith,3509,10,9,11,16,34,51,-17,38
Hibernian,3510,1,19,12,5,54,26,28,69
Falkirk,3510,2,17,9,10,56,41,15,60
Dundee Utd,3510,3,17,8,11,49,37,12,59
Morton,3510,4,15,11,10,46,38,8,56
Dunfermline,3510,5,12,13,11,51,48,3,49
Queen of S't,3510,6,11,9,16,44,51,-7,42
Raith,3510,7,11,9,16,34,47,-13,42
Dumbarton,3510,8,10,10,16,48,57,-9,40
St Mirren,3510,9,9,10,17,38,53,-15,37
Ayr,3510,10,8,11,17,31,53,-22,35
Hibernian,3511,1,19,13,4,57,27,30,70
Dundee Utd,3511,2,18,8,10,58,42,16,62
Morton,3511,3,14,15,7,52,42,10,57
Falkirk,3511,4,15,10,11,57,44,13,55
Queen of S't,3511,5,13,9,14,49,48,1,48
Raith,3511,6,10,10,16,37,51,-14,40
Dunfermline,3511,7,8,15,13,45,46,-1,39
Dumbarton,3511,8,9,12,15,46,60,-14,39
St Mirren,3511,9,9,12,15,41,55,-14,39
Ayr,3511,10,7,12,17,32,59,-27,33
Hibernian,3512,1,18,12,6,51,25,26,66
Morton,3512,2,18,11,7,51,39,12,65
Dundee Utd,3512,3,16,10,10,55,36,19,58
Falkirk,3512,4,16,9,11,58,42,16,57
Queen of S't,3512,5,14,8,14,46,48,-2,50
Dunfermline,3512,6,10,14,12,52,50,2,44
Dumbarton,3512,7,9,11,16,49,62,-13,38
Ayr,3512,8,9,11,16,35,60,-25,38
St Mirren,3512,9,9,10,17,44,59,-15,37
Raith,3512,10,8,10,18,31,51,-20,34
Hibernian,3513,1,20,11,5,58,27,31,71
Morton,3513,2,17,11,8,53,40,13,62
Falkirk,3513,3,16,11,9,60,40,20,59
Dundee Utd,3513,4,14,13,9,49,41,8,55
Dunfermline,3513,5,12,11,13,50,50,0,47
Queen of S't,3513,6,10,12,14,41,47,-6,42
Raith,3513,7,11,9,16,41,54,-13,42
St Mirren,3513,8,9,10,17,42,55,-13,37
Dumbarton,3513,9,8,12,16,46,61,-15,36
Ayr,3513,10,7,12,17,33,58,-25,33
Hibernian,3514,1,19,10,7,55,28,27,67
Dundee Utd,3514,2,17,9,10,51,36,15,60
Morton,3514,3,16,12,8,47,36,11,60
Falkirk,3514,4,14,12,10,55,42,13,54
Queen of S't,3514,5,13,9,14,47,48,-1,48
Dunfermline,3514,6,11,13,12,45,45,0,46
Raith,3514,7,10,11,15,35,47,-12,41
Ayr,3514,8,9,11,16,35,55,-20,38
St Mirren,3514,9,9,10,17,42,58,-16,37
Dumbarton,3514,10,7,13,16,46,63,-17,34
Hibernian,3515,1,19,13,4,62,27,35,70
Morton,3515,2,17,13,6,52,34,18,64
Falkirk,3515,3,17,11,8,64,43,21,62
Dundee Utd,3515,4,18,8,10,54,43,11,62
Dunfermline,3515,5,9,14,13,44,49,-5,41
Dumbarton,3515,6,9,13,14,46,55,-9,40
Queen of S't,3515,7,10,9,17,44,57,-13,39
Raith,3515,8,10,9,17,36,54,-18,39
Ayr,3515,9,7,13,16,34,55,-21,34
St Mirren,3515,10,8,9,19,37,56,-19,33
Hibernian,3516,1,18,14,4,56,22,34,68
Morton,3516,2,16,13,7,48,34,14,61
Falkirk,3516,3,16,11,9,58,39,19,59
Dundee Utd,3516,4,14,10,12,50,47,3,52
Raith,3516,5,11,9,16,36,48,-12,42
Dunfermline,3516,6,9,14,13,41,45,-4,41
Queen of S't,3516,7,11,8,17,42,53,-11,41
Ayr,3516,8,10,11,15,36,56,-20,41
Dumbarton,3516,9,10,10,16,49,58,-9,40
St Mirren,3516,10,10,10,16,41,55,-14,40
Hibernian,3517,1,18,12,6,54,27,27,66
Morton,3517,2,18,11,7,53,39,14,65
Dundee Utd,3517,3,18,9,9,55,38,17,63
Falkirk,3517,4,16,9,11,59,44,15,57
Queen of S't,3517,5,13,9,14,45,50,-5,48
Raith,3517,6,11,9,16,37,49,-12,42
Dumbarton,3517,7,10,11,15,53,57,-4,41
Ayr,3517,8,8,12,16,37,56,-19,36
St Mirren,3517,9,9,9,18,39,62,-23,36
Dunfermline,3517,10,7,13,16,41,51,-10,34
Hibernian,3518,1,20,13,3,58,26,32,73
Morton,3518,2,18,12,6,51,30,21,66
Dundee Utd,3518,3,17,9,10,50,39,11,60
Falkirk,3518,4,16,10,10,59,41,18,58
Queen of S't,3518,5,13,9,14,51,50,1,48
Raith,3518,6,10,10,16,37,53,-16,40
Ayr,3518,7,9,12,15,34,53,-19,39
Dunfermline,3518,8,8,13,15,45,53,-8,37
Dumbarton,3518,9,8,11,17,44,61,-17,35
St Mirren,3518,10,6,11,19,36,59,-23,29
Hibernian,3519,1,19,12,5,54,26,28,69
Morton,3519,2,18,11,7,56,38,18,65
Dundee Utd,3519,3,17,9,10,56,42,14,60
Falkirk,3519,4,15,12,9,57,45,12,57
Queen of S't,3519,5,11,10,15,44,52,-8,43
Dunfermline,3519,6,10,12,14,47,50,-3,42
Raith,3519,7,11,8,17,36,48,-12,41
Ayr,3519,8,9,12,15,36,54,-18,39
Dumbarton,3519,9,9,11,16,45,58,-13,38
St Mirren,3519,10,8,9,19,39,57,-18,33
Hibernian,3520,1,19,13,4,57,27,30,70
Morton,3520,2,17,13,6,53,39,14,64
Dundee Utd,3520,3,15,10,11,52,40,12,55
Falkirk,3520,4,14,11,11,60,51,9,53
Queen of S't,3520,5,14,8,14,49,51,-2,50
Raith,3520,6,11,10,15,40,45,-5,43
Dunfermline,3520,7,7,16,13,40,47,-7,37
Dumbarton,3520,8,8,13,15,44,57,-13,37
St Mirren,3520,9,8,12,16,39,59,-20,36
Ayr,3520,10,7,14,15,35,53,-18,35
Hibernian,3521,1,17,14,5,51,26,25,65
Falkirk,3521,2,18,10,8,63,39,24,64
Dundee Utd,3521,3,18,8,10,56,42,14,62
Morton,3521,4,15,12,9,47,39,8,57
Queen of S't,3521,5,14,8,14,51,48,3,50
Dumbarton,3521,6,11,12,13,53,58,-5,45
Raith,3521,7,10,11,15,38,50,-12,41
Dunfermline,3521,8,9,13,14,44,52,-8,40
St Mirren,3521,9,8,9,19,42,62,-20,33
Ayr,3521,10,6,11,19,34,63,-29,29
Hibernian,3522,1,20,10,6,58,26,32,70
Falkirk,3522,2,17,9,10,59,40,19,60
Dundee Utd,3522,3,17,9,10,51,38,13,60
Morton,3522,4,16,11,9,48,39,9,59
Dunfermline,3522,5,11,13,12,45,46,-1,46
Queen of S't,3522,6,11,8,17,46,53,-7,41
Ayr,3522,7,9,13,14,36,55,-19,40
St Mirren,3522,8,10,9,17,43,55,-12,39
Raith,3522,9,10,9,17,36,53,-17,39
Dumbarton,3522,10,8,11,17,46,63,-17,35
Hibernian,3523,1,19,14,3,59,24,35,71
Morton,3523,2,16,12,8,53,43,10,60
Falkirk,3523,3,14,12,10,52,40,12,54
Dundee Utd,3523,4,14,10,12,52,44,8,52
Dunfermline,3523,5,12,13,11,50,45,5,49
Queen of S't,3523,6,13,8,15,42,46,-4,47
Dumbarton,3523,7,10,11,15,49,59,-10,41
Raith,3523,8,10,9,17,32,48,-16,39
St Mirren,3523,9,9,10,17,41,56,-15,37
Ayr,3523,10,8,11,17,36,61,-25,35
Hibernian,3524,1,17,15,4,52,23,29,66
Dundee Utd,3524,2,16,11,9,52,39,13,59
Falkirk,3524,3,16,10,10,59,46,13,58
Morton,3524,4,14,14,8,49,36,13,56
Queen of S't,3524,5,12,11,13,49,50,-1,47
Dunfermline,3524,6,11,13,12,46,49,-3,46
Dumbarton,3524,7,10,11,15,49,57,-8,41
Raith,3524,8,10,9,17,39,55,-16,39
St Mirren,3524,9,9,11,16,41,57,-16,38
Ayr,3524,10,6,13,17,34,58,-24,31
Hibernian,3525,1,20,12,4,57,25,32,72
Morton,3525,2,18,11,7,54,36,18,65
Falkirk,3525,3,15,13,8,59,41,18,58
Dundee Utd,3525,4,15,11,10,50,42,8,56
Queen of S't,3525,5,13,10,13,45,48,-3,49
Raith,3525,6,10,10,16,38,51,-13,40
Dunfermline,3525,7,9,12,15,43,50,-7,39
Ayr,3525,8,8,13,15,36,55,-19,37
Dumbarton,3525,9,8,12,16,44,54,-10,36
St Mirren,3525,10,7,10,19,39,63,-24,31
Hibernian,3526,1,21,11,4,63,23,40,74
Dundee Utd,3526,2,17,10,9,53,40,13,61
Morton,3526,3,17,9,10,51,42,9,60
Falkirk,3526,4,13,12,11,54,44,10,51
Dunfermline,3526,5,12,13,11,48,45,3,49
Queen of S't,3526,6,12,9,15,45,51,-6,45
Dumbarton,3526,7,9,11,16,49,58,-9,38
Raith,3526,8,10,8,18,35,53,-18,38
Ayr,3526,9,8,12,16,37,58,-21,36
St Mirren,3526,10,8,11,17,37,58,-21,35
Hibernian,3527,1,18,13,5,58,29,29,67
Falkirk,3527,2,16,11,9,58,41,17,59
Dundee Utd,3527,3,15,10,11,50,43,7,55
Morton,3527,4,15,10,11,44,43,1,55
Dunfermline,3527,5,12,14,10,51,43,8,50
Raith,3527,6,10,13,13,40,46,-6,43
Ayr,3527,7,9,13,14,40,57,-17,40
Queen of S't,3527,8,10,9,17,39,54,-15,39
Dumbarton,3527,9,8,13,15,50,65,-15,37
St Mirren,3527,10,8,12,16,44,53,-9,36
Hibernian,3528,1,19,12,5,57,28,29,69
Dundee Utd,3528,2,18,9,9,52,37,15,63
Morton,3528,3,17,10,9,50,40,10,61
Falkirk,3528,4,15,13,8,59,41,18,58
Queen of S't,3528,5,12,10,14,43,47,-4,46
Dunfermline,3528,6,10,11,15,44,48,-4,41
Dumbarton,3528,7,9,12,15,48,58,-10,39
Raith,3528,8,10,8,18,37,50,-13,38
St Mirren,3528,9,8,12,16,39,54,-15,36
Ayr,3528,10,8,11,17,34,60,-26,35
Hibernian,3529,1,20,11,5,57,28,29,71
Dundee Utd,3529,2,18,9,9,51,34,17,63
Morton,3529,3,17,11,8,54,37,17,62
Falkirk,3529,4,16,10,10,57,42,15,58
Queen of S't,3529,5,12,8,16,43,51,-8,44
St Mirren,3529,6,10,12,14,41,50,-9,42
Dunfermline,3529,7,10,11,15,48,58,-10,41
Raith,3529,8,10,8,18,33,51,-18,38
Dumbarton,3529,9,8,12,16,46,55,-9,36
Ayr,3529,10,8,10,18,36,60,-24,34
Morton,3530,1,20,9,7,58,33,25,69
Hibernian,3530,2,17,12,7,50,33,17,63
Falkirk,3530,3,17,11,8,60,38,22,62
Dundee Utd,3530,4,15,10,11,51,45,6,55
Dunfermline,3530,5,10,14,12,43,52,-9,44
Queen of S't,3530,6,11,10,15,45,52,-7,43
Raith,3530,7,9,11,16,33,47,-14,38
Dumbarton,3530,8,8,13,15,51,56,-5,37
St Mirren,3530,9,9,10,17,40,56,-16,37
Ayr,3530,10,7,14,15,38,57,-19,35
Hibernian,3531,1,19,13,4,53,24,29,70
Morton,3531,2,18,11,7,55,35,20,65
Falkirk,3531,3,16,12,8,63,44,19,60
Dunfermline,3531,4,12,12,12,47,43,4,48
Dundee Utd,3531,5,13,9,14,45,44,1,48
Queen of S't,3531,6,12,9,15,48,50,-2,45
Raith,3531,7,10,10,16,35,51,-16,40
Ayr,3531,8,7,15,14,38,57,-19,36
Dumbarton,3531,9,8,12,16,48,68,-20,36
St Mirren,3531,10,8,11,17,37,53,-16,35
Hibernian,3532,1,19,11,6,61,30,31,68
Dundee Utd,3532,2,17,9,10,54,41,13,60
Morton,3532,3,15,11,10,47,41,6,56
Falkirk,3532,4,14,11,11,58,51,7,53
Raith,3532,5,13,9,14,42,47,-5,48
Queen of S't,3532,6,12,9,15,45,49,-4,45
Dunfermline,3532,7,10,14,12,42,43,-1,44
Ayr,3532,8,9,11,16,36,52,-16,38
Dumbarton,3532,9,8,13,15,45,59,-14,37
St Mirren,3532,10,9,10,17,43,60,-17,37
Hibernian,3533,1,20,11,5,57,28,29,71
Dundee Utd,3533,2,19,8,9,57,39,18,65
Morton,3533,3,16,10,10,46,37,9,58
Falkirk,3533,4,15,11,10,57,43,14,56
Queen of S't,3533,5,11,10,15,44,51,-7,43
Ayr,3533,6,10,11,15,42,57,-15,41
Raith,3533,7,10,10,16,38,51,-13,40
Dunfermline,3533,8,9,12,15,43,50,-7,39
Dumbarton,3533,9,9,12,15,52,62,-10,39
St Mirren,3533,10,8,11,17,42,60,-18,35
Hibernian,3534,1,20,10,6,54,25,29,70
Dundee Utd,3534,2,18,8,10,53,40,13,62
Morton,3534,3,17,10,9,52,39,13,61
Falkirk,3534,4,15,9,12,58,43,15,54
Dunfermline,3534,5,13,12,11,51,46,5,51
Queen of S't,3534,6,11,10,15,42,50,-8,43
Ayr,3534,7,9,13,14,35,51,-16,40
Dumbarton,3534,8,9,10,17,46,60,-14,37
Raith,3534,9,8,11,17,31,49,-18,35
St Mirren,3534,10,8,11,17,38,57,-19,35
Hibernian,3535,1,17,12,7,53,29,24,63
Morton,3535,2,16,11,9,49,44,5,59
Falkirk,3535,3,16,10,10,54,41,13,58
Dundee Utd,3535,4,16,9,11,53,40,13,57
Dunfermline,3535,5,12,12,12,53,46,7,48
Queen of S't,3535,6,13,9,14,51,47,4,48
Dumbarton,3535,7,12,11,13,51,53,-2,47
St Mirren,3535,8,10,9,17,43,57,-14,39
Raith,3535,9,9,9,18,32,55,-23,36
Ayr,3535,10,8,10,18,29,56,-27,34
Hibernian,3536,1,17,14,5,54,27,27,65
Dundee Utd,3536,2,17,9,10,52,41,11,60
Morton,3536,3,16,12,8,48,38,10,60
Falkirk,3536,4,16,11,9,57,45,12,59
Dunfermline,3536,5,9,15,12,51,49,2,42
Raith,3536,6,10,12,14,40,49,-9,42
Queen of S't,3536,7,11,9,16,45,55,-10,42
Ayr,3536,8,8,15,13,35,51,-16,39
Dumbarton,3536,9,8,13,15,46,54,-8,37
St Mirren,3536,10,8,10,18,38,57,-19,34
Hibernian,3537,1,20,11,5,61,25,36,71
Dundee Utd,3537,2,18,9,9,55,39,16,63
Falkirk,3537,3,16,11,9,56,40,16,59
Morton,3537,4,14,12,10,44,40,4,54
Queen of S't,3537,5,12,9,15,49,55,-6,45
Raith,3537,6,12,9,15,40,48,-8,45
Dunfermline,3537,7,9,13,14,45,54,-9,40
St Mirren,3537,8,9,10,17,41,54,-13,37
Dumbarton,3537,9,7,15,14,51,65,-14,36
Ayr,3537,10,7,13,16,31,53,-22,34
Hibernian,3538,1,21,12,3,57,23,34,75
Falkirk,3538,2,18,9,9,62,37,25,63
Morton,3538,3,17,10,9,52,36,16,61
Dundee Utd,3538,4,14,10,12,45,44,1,52
Queen of S't,3538,5,13,9,14,48,48,0,48
Dunfermline,3538,6,10,14,12,46,48,-2,44
Raith,3538,7,11,9,16,34,49,-15,42
Dumbarton,3538,8,9,11,16,48,66,-18,38
Ayr,3538,9,7,13,16,36,55,-19,34
St Mirren,3538,10,6,11,19,37,59,-22,29
Hibernian,3539,1,19,11,6,57,25,32,68
Morton,3539,2,18,12,6,51,36,15,66
Falkirk,3539,3,18,10,8,61,37,24,64
Dundee Utd,3539,4,16,9,11,50,43,7,57
Raith,3539,5,10,11,15,31,45,-14,41
Dumbarton,3539,6,10,10,16,47,56,-9,40
Dunfermline,3539,7,8,14,14,42,49,-7,38
St Mirren,3539,8,9,11,16,42,55,-13,38
Queen of S't,3539,9,9,10,17,40,51,-11,37
Ayr,3539,10,7,14,15,31,55,-24,35
Hibernian,3540,1,20,12,4,60,25,35,72
Morton,3540,2,20,10,6,52,32,20,70
Dundee Utd,3540,3,17,9,10,54,40,14,60
Falkirk,3540,4,15,13,8,55,35,20,58
Queen of S't,3540,5,12,9,15,43,51,-8,45
Raith,3540,6,11,9,16,33,48,-15,42
Ayr,3540,7,9,11,16,31,53,-22,38
Dunfermline,3540,8,7,13,16,37,50,-13,34
Dumbarton,3540,9,8,10,18,46,61,-15,34
St Mirren,3540,10,7,12,17,39,55,-16,33
Hibernian,3541,1,20,11,5,56,25,31,71
Dundee Utd,3541,2,18,8,10,58,42,16,62
Falkirk,3541,3,16,11,9,59,42,17,59
Morton,3541,4,16,11,9,50,42,8,59
Queen of S't,3541,5,11,11,14,41,45,-4,44
Raith,3541,6,11,10,15,40,47,-7,43
Dunfermline,3541,7,9,14,13,46,49,-3,41
St Mirren,3541,8,9,10,17,38,54,-16,37
Dumbarton,3541,9,8,12,16,49,62,-13,36
Ayr,3541,10,8,10,18,34,63,-29,34
Hibernian,3542,1,21,11,4,62,27,35,74
Morton,3542,2,17,10,9,56,41,15,61
Falkirk,3542,3,16,11,9,65,40,25,59
Dundee Utd,3542,4,16,8,12,52,44,8,56
Queen of S't,3542,5,11,10,15,45,51,-6,43
Dunfermline,3542,6,10,12,14,49,52,-3,42
Ayr,3542,7,10,11,15,36,55,-19,41
Dumbarton,3542,8,9,12,15,47,58,-11,39
St Mirren,3542,9,9,10,17,39,59,-20,37
Raith,3542,10,9,9,18,35,59,-24,36
Hibernian,3543,1,17,16,3,52,23,29,67
Morton,3543,2,17,11,8,46,37,9,62
Falkirk,3543,3,16,12,8,58,38,20,60
Dundee Utd,3543,4,16,11,9,54,41,13,59
Raith,3543,5,11,12,13,42,45,-3,45
Queen of S't,3543,6,11,9,16,45,58,-13,42
Dunfermline,3543,7,9,13,14,46,50,-4,40
Dumbarton,3543,8,9,10,17,45,60,-15,37
Ayr,3543,9,8,12,16,34,54,-20,36
St Mirren,3543,10,8,10,18,38,54,-16,34
Hibernian,3544,1,17,14,5,57,30,27,65
Falkirk,3544,2,18,10,8,60,38,22,64
Morton,3544,3,16,14,6,53,36,17,62
Dundee Utd,3544,4,15,12,9,51,39,12,57
Raith,3544,5,11,11,14,37,47,-10,44
Dunfermline,3544,6,9,13,14,42,48,-6,40
Queen of S't,3544,7,10,10,16,43,52,-9,40
Dumbarton,3544,8,9,12,15,47,59,-12,39
Ayr,3544,9,8,12,16,36,57,-21,36
St Mirren,3544,10,8,10,18,39,59,-20,34
Hibernian,3545,1,20,12,4,56,24,32,72
Morton,3545,2,16,12,8,48,39,9,60
Falkirk,3545,3,16,11,9,61,46,15,59
Dundee Utd,3545,4,13,12,11,49,43,6,51
Queen of S't,3545,5,12,10,14,45,48,-3,46
Dunfermline,3545,6,10,14,12,50,48,2,44
Dumbarton,3545,7,9,14,13,51,58,-7,41
Ayr,3545,8,8,15,13,38,53,-15,39
Raith,3545,9,9,10,17,34,50,-16,37
St Mirren,3545,10,7,10,19,38,61,-23,31
Hibernian,3546,1,19,11,6,52,26,26,68
Morton,3546,2,18,9,9,51,35,16,63
Falkirk,3546,3,17,9,10,60,44,16,60
Dundee Utd,3546,4,15,10,11,44,40,4,55
Raith,3546,5,12,9,15,37,49,-12,45
Queen of S't,3546,6,12,8,16,49,51,-2,44
Dumbarton,3546,7,11,11,14,46,52,-6,44
Dunfermline,3546,8,9,12,15,43,49,-6,39
St Mirren,3546,9,9,10,17,44,57,-13,37
Ayr,3546,10,7,13,16,31,54,-23,34
Hibernian,3547,1,17,13,6,51,27,24,64
Falkirk,3547,2,17,11,8,60,40,20,62
Morton,3547,3,15,13,8,49,38,11,58
Dundee Utd,3547,4,15,11,10,49,41,8,56
Dunfermline,3547,5,11,13,12,46,47,-1,46
Queen of S't,3547,6,12,8,16,46,52,-6,44
Raith,3547,7,10,10,16,35,48,-13,40
Dumbarton,3547,8,9,11,16,49,57,-8,38
St Mirren,3547,9,9,11,16,39,54,-15,38
Ayr,3547,10,9,11,16,39,59,-20,38
Hibernian,3548,1,19,11,6,57,28,29,68
Morton,3548,2,19,10,7,52,34,18,67
Falkirk,3548,3,18,10,8,64,41,23,64
Dundee Utd,3548,4,15,11,10,51,43,8,56
Queen of S't,3548,5,12,11,13,49,48,1,47
Dumbarton,3548,6,11,11,14,51,58,-7,44
Dunfermline,3548,7,9,13,14,44,49,-5,40
Ayr,3548,8,9,11,16,33,53,-20,38
Raith,3548,9,8,9,19,32,53,-21,33
St Mirren,3548,10,7,9,20,37,63,-26,30
Hibernian,3549,1,19,12,5,53,25,28,69
Morton,3549,2,19,10,7,55,34,21,67
Dundee Utd,3549,3,17,8,11,56,43,13,59
Falkirk,3549,4,15,11,10,56,44,12,56
Queen of S't,3549,5,11,11,14,43,51,-8,44
Dunfermline,3549,6,10,13,13,43,47,-4,43
Raith,3549,7,10,11,15,36,48,-12,41
St Mirren,3549,8,8,12,16,42,54,-12,36
Dumbarton,3549,9,8,12,16,48,63,-15,36
Ayr,3549,10,8,10,18,33,56,-23,34
Morton,3550,1,19,12,5,54,32,22,69
Hibernian,3550,2,17,14,5,52,27,25,65
Falkirk,3550,3,17,11,8,63,42,21,62
Dundee Utd,3550,4,16,11,9,58,41,17,59
Queen of S't,3550,5,12,9,15,46,50,-4,45
Raith,3550,6,11,10,15,36,49,-13,43
Dunfermline,3550,7,9,13,14,44,49,-5,40
Dumbarton,3550,8,9,10,17,49,67,-18,37
St Mirren,3550,9,8,11,17,41,57,-16,35
Ayr,3550,10,6,11,19,34,63,-29,29
Hibernian,3551,1,19,14,3,55,23,32,71
Morton,3551,2,18,10,8,48,35,13,64
Falkirk,3551,3,16,11,9,58,45,13,59
Dundee Utd,3551,4,16,8,12,52,40,12,56
Queen of S't,3551,5,12,9,15,46,50,-4,45
Dunfermline,3551,6,10,13,13,46,50,-4,43
St Mirren,3551,7,10,10,16,41,52,-11,40
Dumbarton,3551,8,9,11,16,48,57,-9,38
Raith,3551,9,9,9,18,32,49,-17,36
Ayr,3551,10,8,11,17,32,57,-25,35
Hibernian,3552,1,19,11,6,54,28,26,68
Morton,3552,2,17,10,9,49,38,11,61
Falkirk,3552,3,17,9,10,61,42,19,60
Dundee Utd,3552,4,15,10,11,48,41,7,55
Dunfermline,3552,5,10,15,11,47,46,1,45
Raith,3552,6,11,10,15,32,45,-13,43
Dumbarton,3552,7,10,12,14,51,55,-4,42
Queen of S't,3552,8,10,9,17,42,52,-10,39
Ayr,3552,9,9,11,16,33,55,-22,38
St Mirren,3552,10,8,11,17,43,58,-15,35
Hibernian,3553,1,18,13,5,52,26,26,67
Falkirk,3553,2,17,12,7,61,37,24,63
Morton,3553,3,16,12,8,59,40,19,60
Dundee Utd,3553,4,14,11,11,45,39,6,53
Queen of S't,3553,5,13,8,15,45,51,-6,47
Dunfermline,3553,6,10,12,14,44,52,-8,42
Raith,3553,7,9,12,15,34,48,-14,39
Ayr,3553,8,8,15,13,33,50,-17,39
Dumbarton,3553,9,8,14,14,48,56,-8,38
St Mirren,3553,10,7,11,18,37,59,-22,32
Hibernian,3554,1,20,11,5,62,27,35,71
Morton,3554,2,17,11,8,51,40,11,62
Falkirk,3554,3,17,9,10,62,46,16,60
Dundee Utd,3554,4,15,8,13,46,42,4,53
Queen of S't,3554,5,13,10,13,50,50,0,49
Dunfermline,3554,6,10,13,13,47,50,-3,43
St Mirren,3554,7,10,10,16,43,55,-12,40
Ayr,3554,8,9,12,15,35,52,-17,39
Raith,3554,9,10,8,18,35,55,-20,38
Dumbarton,3554,10,8,10,18,51,65,-14,34
Hibernian,3555,1,19,12,5,59,27,32,69
Morton,3555,2,17,14,5,59,43,16,65
Falkirk,3555,3,16,12,8,58,40,18,60
Dundee Utd,3555,4,15,11,10,50,40,10,56
Queen of S't,3555,5,12,9,15,46,52,-6,45
Dunfermline,3555,6,9,12,15,45,51,-6,39
St Mirren,3555,7,9,12,15,49,58,-9,39
Raith,3555,8,9,12,15,38,52,-14,39
Dumbarton,3555,9,7,13,16,50,65,-15,34
Ayr,3555,10,7,13,16,34,60,-26,34
Dundee Utd,3556,1,20,8,8,63,41,22,68
Hibernian,3556,2,18,12,6,56,29,27,66
Morton,3556,3,18,9,9,57,39,18,63
Falkirk,3556,4,17,11,8,62,39,23,62
Dunfermline,3556,5,11,13,12,49,52,-3,46
Dumbarton,3556,6,10,11,15,48,57,-9,41
Ayr,3556,7,9,11,16,34,57,-23,38
Queen of S't,3556,8,9,9,18,40,53,-13,36
Raith,3556,9,8,11,17,31,53,-22,35
St Mirren,3556,10,7,11,18,37,57,-20,32
Hibernian,3557,1,17,13,6,54,28,26,64
Falkirk,3557,2,17,10,9,58,43,15,61
Dundee Utd,3557,3,16,11,9,52,39,13,59
Morton,3557,4,14,12,10,47,41,6,54
Ayr,3557,5,11,13,12,43,53,-10,46
Dumbarton,3557,6,10,13,13,54,56,-2,43
Raith,3557,7,11,10,15,36,44,-8,43
Dunfermline,3557,8,9,14,13,45,50,-5,41
Queen of S't,3557,9,10,11,15,45,55,-10,41
St Mirren,3557,10,6,11,19,34,59,-25,29
Hibernian,3558,1,20,12,4,53,22,31,72
Falkirk,3558,2,17,10,9,62,41,21,61
Dundee Utd,3558,3,17,10,9,54,35,19,61
Morton,3558,4,16,11,9,53,39,14,59
Dumbarton,3558,5,10,12,14,49,58,-9,42
Raith,3558,6,11,9,16,38,50,-12,42
Dunfermline,3558,7,9,14,13,42,48,-6,41
Queen of S't,3558,8,11,8,17,43,57,-14,41
Ayr,3558,9,8,11,17,34,57,-23,35
St Mirren,3558,10,7,11,18,39,60,-21,32
Hibernian,3559,1,20,11,5,57,30,27,71
Morton,3559,2,17,14,5,55,35,20,65
Falkirk,3559,3,16,11,9,60,44,16,59
Dundee Utd,3559,4,12,12,12,45,42,3,48
Queen of S't,3559,5,13,9,14,48,49,-1,48
Raith,3559,6,10,11,15,38,48,-10,41
Dumbarton,3559,7,10,10,16,52,59,-7,40
St Mirren,3559,8,10,10,16,40,54,-14,40
Dunfermline,3559,9,8,14,14,46,54,-8,38
Ayr,3559,10,7,12,17,32,58,-26,33
Hibernian,3560,1,19,11,6,51,28,23,68
Morton,3560,2,17,12,7,52,37,15,63
Falkirk,3560,3,15,11,10,55,40,15,56
Dundee Utd,3560,4,16,8,12,46,38,8,56
Raith,3560,5,12,9,15,40,44,-4,45
Queen of S't,3560,6,11,10,15,43,49,-6,43
Dumbarton,3560,7,9,14,13,48,55,-7,41
Ayr,3560,8,9,13,14,33,52,-19,40
Dunfermline,3560,9,8,13,15,40,48,-8,37
St Mirren,3560,10,8,11,17,35,52,-17,35
Hibernian,3561,1,18,13,5,51,24,27,67
Falkirk,3561,2,18,10,8,61,40,21,64
Morton,3561,3,17,12,7,48,34,14,63
Dundee Utd,3561,4,15,8,13,50,43,7,53
Dunfermline,3561,5,11,11,14,50,49,1,44
Queen of S't,3561,6,11,10,15,40,49,-9,43
Dumbarton,3561,7,10,12,14,50,57,-7,42
St Mirren,3561,8,10,9,17,42,57,-15,39
Ayr,3561,9,8,13,15,33,53,-20,37
Raith,3561,10,8,10,18,33,52,-19,34
Hibernian,3562,1,19,13,4,54,26,28,70
Dundee Utd,3562,2,18,10,8,59,37,22,64
Falkirk,3562,3,17,10,9,60,39,21,61
Morton,3562,4,15,13,8,46,35,11,58
Queen of S't,3562,5,11,10,15,46,50,-4,43
Dunfermline,3562,6,10,12,14,45,52,-7,42
Raith,3562,7,10,10,16,33,47,-14,40
Ayr,3562,8,9,12,15,37,54,-17,39
Dumbarton,3562,9,8,11,17,45,64,-19,35
St Mirren,3562,10,7,11,18,40,61,-21,32
Hibernian,3563,1,19,11,6,53,25,28,68
Falkirk,3563,2,17,11,8,62,41,21,62
Dundee Utd,3563,3,17,11,8,52,37,15,62
Morton,3563,4,16,13,7,51,37,14,61
Queen of S't,3563,5,14,8,14,46,46,0,50
Raith,3563,6,11,9,16,36,50,-14,42
Dumbarton,3563,7,8,12,16,49,60,-11,36
Dunfermline,3563,8,7,14,15,40,52,-12,35
St Mirren,3563,9,8,11,17,42,58,-16,35
Ayr,3563,10,7,12,17,30,55,-25,33
Hibernian,3564,1,19,12,5,55,28,27,69
Morton,3564,2,18,11,7,50,33,17,65
Dundee Utd,3564,3,18,8,10,56,41,15,62
Falkirk,3564,4,17,10,9,64,44,20,61
Queen of S't,3564,5,12,9,15,47,53,-6,45
Dunfermline,3564,6,10,13,13,45,48,-3,43
St Mirren,3564,7,10,10,16,43,56,-13,40
Raith,3564,8,10,9,17,38,52,-14,39
Ayr,3564,9,8,10,18,36,58,-22,34
Dumbarton,3564,10,7,10,19,42,63,-21,31
Hibernian,3565,1,19,12,5,55,28,27,69
Morton,3565,2,16,11,9,49,36,13,59
Dundee Utd,3565,3,16,11,9,49,38,11,59
Falkirk,3565,4,15,12,9,58,39,19,57
Dunfermline,3565,5,11,13,12,48,47,1,46
St Mirren,3565,6,11,10,15,45,51,-6,43
Queen of S't,3565,7,11,10,15,43,50,-7,43
Raith,3565,8,9,11,16,33,51,-18,38
Dumbarton,3565,9,8,11,17,43,61,-18,35
Ayr,3565,10,6,15,15,30,52,-22,33
Morton,3566,1,19,11,6,51,35,16,68
Hibernian,3566,2,17,15,4,55,27,28,66
Dundee Utd,3566,3,17,9,10,49,37,12,60
Falkirk,3566,4,14,11,11,58,44,14,53
Dunfermline,3566,5,11,13,12,52,50,2,46
Queen of S't,3566,6,11,11,14,44,50,-6,44
Dumbarton,3566,7,9,11,16,46,57,-11,38
St Mirren,3566,8,9,10,17,41,56,-15,37
Ayr,3566,9,8,13,15,36,54,-18,37
Raith,3566,10,8,10,18,33,55,-22,34
Hibernian,3567,1,18,13,5,53,29,24,67
Falkirk,3567,2,18,10,8,67,42,25,64
Morton,3567,3,15,14,7,51,37,14,59
Dundee Utd,3567,4,16,9,11,50,41,9,57
Queen of S't,3567,5,12,8,16,47,55,-8,44
Raith,3567,6,11,10,15,41,53,-12,43
Dunfermline,3567,7,10,12,14,46,49,-3,42
Ayr,3567,8,9,12,15,33,50,-17,39
Dumbarton,3567,9,9,10,17,51,66,-15,37
St Mirren,3567,10,8,10,18,41,58,-17,34
Hibernian,3568,1,20,11,5,60,29,31,71
Dundee Utd,3568,2,17,10,9,56,36,20,61
Falkirk,3568,3,17,10,9,59,40,19,61
Morton,3568,4,17,9,10,48,39,9,60
Dunfermline,3568,5,10,14,12,42,45,-3,44
Raith,3568,6,11,10,15,38,47,-9,43
Queen of S't,3568,7,11,10,15,45,55,-10,43
St Mirren,3568,8,10,9,17,43,55,-12,39
Dumbarton,3568,9,8,11,17,44,63,-19,35
Ayr,3568,10,6,12,18,30,56,-26,30
Hibernian,3569,1,20,10,6,55,27,28,70
Morton,3569,2,17,11,8,49,37,12,62
Falkirk,3569,3,16,12,8,62,40,22,60
Dundee Utd,3569,4,15,10,11,48,41,7,55
Queen of S't,3569,5,12,10,14,46,48,-2,46
St Mirren,3569,6,9,13,14,42,54,-12,40
Raith,3569,7,9,11,16,37,54,-17,38
Ayr,3569,8,9,11,16,39,58,-19,38
Dunfermline,3569,9,7,15,14,43,51,-8,36
Dumbarton,3569,10,7,15,14,48,59,-11,36
Hibernian,3570,1,21,10,5,59,26,33,73
Morton,3570,2,20,9,7,54,32,22,69
Falkirk,3570,3,17,9,10,56,40,16,60
Dundee Utd,3570,4,13,10,13,43,43,0,49
Dunfermline,3570,5,10,12,14,47,50,-3,42
Dumbarton,3570,6,10,12,14,47,53,-6,42
Queen of S't,3570,7,11,8,17,39,53,-14,41
St Mirren,3570,8,10,10,16,46,54,-8,40
Ayr,3570,9,9,12,15,31,51,-20,39
Raith,3570,10,9,8,19,36,56,-20,35
Hibernian,3571,1,21,11,4,61,25,36,74
Dundee Utd,3571,2,18,8,10,51,37,14,62
Falkirk,3571,3,15,10,11,56,44,12,55
Morton,3571,4,15,10,11,48,40,8,55
Queen of S't,3571,5,13,9,14,46,48,-2,48
Raith,3571,6,11,9,16,38,51,-13,42
Dunfermline,3571,7,9,13,14,43,48,-5,40
Dumbarton,3571,8,9,11,16,47,61,-14,38
Ayr,3571,9,9,11,16,39,59,-20,38
St Mirren,3571,10,9,10,17,41,57,-16,37
Hibernian,3572,1,21,11,4,55,22,33,74
Falkirk,3572,2,16,12,8,58,41,17,60
Morton,3572,3,15,12,9,49,40,9,57
Dundee Utd,3572,4,13,14,9,49,42,7,53
Dunfermline,3572,5,10,13,13,48,51,-3,43
Dumbarton,3572,6,9,13,14,48,54,-6,40
Queen of S't,3572,7,10,10,16,42,50,-8,40
Raith,3572,8,10,9,17,34,51,-17,39
Ayr,3572,9,9,11,16,34,54,-20,38
St Mirren,3572,10,8,13,15,42,54,-12,37
Hibernian,3573,1,20,11,5,59,29,30,71
Falkirk,3573,2,18,9,9,60,37,23,63
Morton,3573,3,16,10,10,54,41,13,58
Dundee Utd,3573,4,15,9,12,43,43,0,54
Ayr,3573,5,12,10,14,40,49,-9,46
Dumbarton,3573,6,11,10,15,51,59,-8,43
Dunfermline,3573,7,10,12,14,47,51,-4,42
Raith,3573,8,11,8,17,36,53,-17,41
Queen of S't,3573,9,10,8,18,46,58,-12,38
St Mirren,3573,10,9,9,18,42,58,-16,36
Hibernian,3574,1,19,12,5,55,28,27,69
Dundee Utd,3574,2,18,9,9,56,36,20,63
Morton,3574,3,15,14,7,51,39,12,59
Falkirk,3574,4,15,11,10,52,39,13,56
Queen of S't,3574,5,12,9,15,41,46,-5,45
Dunfermline,3574,6,10,13,13,45,50,-5,43
Raith,3574,7,11,9,16,34,47,-13,42
Ayr,3574,8,9,11,16,35,52,-17,38
Dumbarton,3574,9,8,12,16,45,59,-14,36
St Mirren,3574,10,8,10,18,36,54,-18,34
Hibernian,3575,1,22,10,4,58,24,34,76
Falkirk,3575,2,17,10,9,56,39,17,61
Dundee Utd,3575,3,17,10,9,55,38,17,61
Morton,3575,4,16,11,9,53,38,15,59
Queen of S't,3575,5,12,9,15,46,53,-7,45
Raith,3575,6,10,10,16,36,48,-12,40
Dunfermline,3575,7,7,16,13,39,45,-6,37
Dumbarton,3575,8,9,10,17,47,62,-15,37
Ayr,3575,9,8,12,16,33,55,-22,36
St Mirren,3575,10,8,10,18,41,62,-21,34
Hibernian,3576,1,20,11,5,58,22,36,71
Morton,3576,2,16,12,8,54,42,12,60
Dundee Utd,3576,3,16,11,9,53,39,14,59
Falkirk,3576,4,13,12,11,53,43,10,51
Queen of S't,3576,5,11,11,14,52,55,-3,44
Dunfermline,3576,6,9,15,12,44,46,-2,42
Raith,3576,7,10,11,15,37,50,-13,41
Dumbarton,3576,8,10,10,16,56,65,-9,40
Ayr,3576,9,9,12,15,36,63,-27,39
St Mirren,3576,10,9,9,18,41,59,-18,36
Hibernian,3577,1,21,12,3,58,24,34,75
Morton,3577,2,17,11,8,46,34,12,62
Dundee Utd,3577,3,17,9,10,47,35,12,60
Falkirk,3577,4,15,11,10,55,41,14,56
Queen of S't,3577,5,12,9,15,45,51,-6,45
Dunfermline,3577,6,10,12,14,46,48,-2,42
Raith,3577,7,10,9,17,35,49,-14,39
Ayr,3577,8,8,13,15,35,54,-19,37
St Mirren,3577,9,9,9,18,38,54,-16,36
Dumbarton,3577,10,8,11,17,46,61,-15,35
Hibernian,3578,1,20,11,5,56,26,30,71
Morton,3578,2,19,10,7,53,36,17,67
Falkirk,3578,3,15,12,9,56,41,15,57
Dundee Utd,3578,4,15,11,10,50,41,9,56
Queen of S't,3578,5,11,11,14,41,48,-7,44
Raith,3578,6,11,11,14,37,45,-8,44
Dunfermline,3578,7,8,14,14,42,48,-6,38
Dumbarton,3578,8,9,11,16,49,59,-10,38
Ayr,3578,9,8,12,16,32,55,-23,36
St Mirren,3578,10,8,9,19,42,59,-17,33
Hibernian,3579,1,20,12,4,57,25,32,72
Dundee Utd,3579,2,19,9,8,58,37,21,66
Morton,3579,3,15,15,6,49,34,15,60
Falkirk,3579,4,14,10,12,57,44,13,52
Queen of S't,3579,5,11,9,16,44,51,-7,42
Raith,3579,6,10,11,15,33,46,-13,41
Dumbarton,3579,7,9,13,14,44,55,-11,40
Dunfermline,3579,8,7,16,13,42,50,-8,37
Ayr,3579,9,7,14,15,35,57,-22,35
St Mirren,3579,10,7,13,16,37,57,-20,34
Hibernian,3580,1,20,12,4,56,25,31,72
Morton,3580,2,17,11,8,52,39,13,62
Falkirk,3580,3,15,12,9,55,38,17,57
Dundee Utd,3580,4,16,9,11,49,35,14,57
Dunfermline,3580,5,10,14,12,45,44,1,44
Ayr,3580,6,10,12,14,36,52,-16,42
Dumbarton,3580,7,9,12,15,48,58,-10,39
Queen of S't,3580,8,10,9,17,40,52,-12,39
St Mirren,3580,9,9,10,17,39,57,-18,37
Raith,3580,10,9,9,18,31,51,-20,36
Hibernian,3581,1,22,11,3,57,20,37,77
Dundee Utd,3581,2,15,11,10,50,39,11,56
Falkirk,3581,3,15,11,10,59,50,9,56
Morton,3581,4,14,12,10,44,37,7,54
Dumbarton,3581,5,12,10,14,54,53,1,46
Queen of S't,3581,6,12,8,16,44,53,-9,44
Raith,3581,7,11,10,15,38,49,-11,43
Dunfermline,3581,8,10,11,15,43,49,-6,41
St Mirren,3581,9,8,12,16,41,58,-17,36
Ayr,3581,10,7,12,17,32,54,-22,33
Morton,3582,1,19,11,6,55,35,20,68
Hibernian,3582,2,18,13,5,56,30,26,67
Falkirk,3582,3,17,11,8,63,45,18,62
Dundee Utd,3582,4,17,10,9,55,41,14,61
Dunfermline,3582,5,12,11,13,51,48,3,47
Raith,3582,6,11,10,15,39,50,-11,43
Queen of S't,3582,7,11,8,17,44,51,-7,41
Dumbarton,3582,8,8,11,17,45,59,-14,35
St Mirren,3582,9,7,10,19,36,56,-20,31
Ayr,3582,10,6,13,17,33,62,-29,31
Hibernian,3583,1,18,13,5,51,24,27,67
Morton,3583,2,18,9,9,55,36,19,63
Falkirk,3583,3,15,12,9,57,40,17,57
Dundee Utd,3583,4,14,13,9,47,38,9,55
Queen of S't,3583,5,14,10,12,53,49,4,52
Dunfermline,3583,6,10,13,13,46,51,-5,43
St Mirren,3583,7,9,11,16,39,53,-14,38
Raith,3583,8,10,8,18,39,55,-16,38
Ayr,3583,9,8,12,16,33,55,-22,36
Dumbarton,3583,10,8,11,17,45,64,-19,35
Hibernian,3584,1,17,13,6,54,29,25,64
Dundee Utd,3584,2,16,10,10,49,35,14,58
Morton,3584,3,16,10,10,47,39,8,58
Falkirk,3584,4,15,12,9,60,41,19,57
Dumbarton,3584,5,13,10,13,50,51,-1,49
Queen of S't,3584,6,13,8,15,43,50,-7,47
Dunfermline,3584,7,11,12,13,48,50,-2,45
Raith,3584,8,11,9,16,39,50,-11,42
St Mirren,3584,9,8,10,18,42,61,-19,34
Ayr,3584,10,7,12,17,29,55,-26,33
Hibernian,3585,1,17,15,4,56,28,28,66
Morton,3585,2,18,12,6,55,36,19,66
Falkirk,3585,3,17,12,7,63,40,23,63
Dundee Utd,3585,4,16,10,10,54,43,11,58
Queen of S't,3585,5,11,11,14,44,49,-5,44
Dunfermline,3585,6,9,14,13,49,50,-1,41
Ayr,3585,7,8,13,15,33,54,-21,37
Dumbarton,3585,8,8,12,16,49,64,-15,36
St Mirren,3585,9,8,11,17,41,56,-15,35
Raith,3585,10,9,8,19,37,61,-24,35
Hibernian,3586,1,19,11,6,57,29,28,68
Morton,3586,2,18,11,7,57,37,20,65
Falkirk,3586,3,16,10,10,56,40,16,58
Dundee Utd,3586,4,16,8,12,50,44,6,56
Queen of S't,3586,5,13,10,13,44,46,-2,49
Dunfermline,3586,6,11,12,13,48,46,2,45
Ayr,3586,7,9,12,15,35,54,-19,39
Raith,3586,8,9,10,17,34,51,-17,37
St Mirren,3586,9,9,10,17,40,59,-19,37
Dumbarton,3586,10,8,10,18,46,61,-15,34
Hibernian,3587,1,18,10,8,51,26,25,64
Falkirk,3587,2,18,9,9,60,41,19,63
Morton,3587,3,17,12,7,51,35,16,63
Dundee Utd,3587,4,15,8,13,50,42,8,53
Queen of S't,3587,5,13,8,15,47,51,-4,47
Dunfermline,3587,6,11,13,12,46,46,0,46
Raith,3587,7,11,9,16,35,49,-14,42
Ayr,3587,8,10,10,16,39,58,-19,40
St Mirren,3587,9,9,10,17,37,51,-14,37
Dumbarton,3587,10,8,11,17,44,61,-17,35
Hibernian,3588,1,19,11,6,55,25,30,68
Dundee Utd,3588,2,18,8,10,51,37,14,62
Falkirk,3588,3,16,11,9,59,41,18,59
Morton,3588,4,16,10,10,50,45,5,58
Raith,3588,5,13,8,15,40,50,-10,47
Dunfermline,3588,6,10,13,13,50,49,1,43
Ayr,3588,7,10,12,14,39,55,-16,42
Queen of S't,3588,8,11,8,17,44,52,-8,41
Dumbarton,3588,9,8,12,16,49,62,-13,36
St Mirren,3588,10,8,9,19,39,60,-21,33
Hibernian,3589,1,19,14,3,60,26,34,71
Morton,3589,2,19,11,6,53,32,21,68
Dundee Utd,3589,3,16,12,8,50,33,17,60
Falkirk,3589,4,15,11,10,54,40,14,56
Dumbarton,3589,5,12,10,14,51,59,-8,46
Queen of S't,3589,6,10,11,15,43,51,-8,41
Dunfermline,3589,7,9,12,15,43,53,-10,39
Raith,3589,8,9,9,18,36,53,-17,36
St Mirren,3589,9,8,11,17,36,52,-16,35
Ayr,3589,10,7,11,18,31,58,-27,32
Morton,3590,1,19,10,7,56,34,22,67
Falkirk,3590,2,18,11,7,64,39,25,65
Hibernian,3590,3,17,11,8,52,32,20,62
Dundee Utd,3590,4,17,9,10,56,44,12,60
Dunfermline,3590,5,9,14,13,48,51,-3,41
Dumbarton,3590,6,10,10,16,48,60,-12,40
Raith,3590,7,10,10,16,33,48,-15,40
Queen of S't,3590,8,10,9,17,43,54,-11,39
St Mirren,3590,9,9,10,17,39,54,-15,37
Ayr,3590,10,9,10,17,37,60,-23,37
Hibernian,3591,1,18,13,5,55,29,26,67
Dundee Utd,3591,2,16,12,8,58,41,17,60
Morton,3591,3,15,13,8,49,38,11,58
Falkirk,3591,4,15,11,10,59,42,17,56
Dunfermline,3591,5,11,12,13,54,54,0,45
Dumbarton,3591,6,10,12,14,47,55,-8,42
Raith,3591,7,11,9,16,33,49,-16,42
Queen of S't,3591,8,10,10,16,46,57,-11,40
Ayr,3591,9,8,13,15,39,56,-17,37
St Mirren,3591,10,9,9,18,41,60,-19,36
Hibernian,3592,1,19,11,6,54,29,25,68
Falkirk,3592,2,17,11,8,61,41,20,62
Morton,3592,3,17,9,10,51,40,11,60
Dundee Utd,3592,4,16,9,11,45,37,8,57
Queen of S't,3592,5,12,10,14,46,49,-3,46
Dunfermline,3592,6,10,12,14,50,48,2,42
Dumbarton,3592,7,10,11,15,50,57,-7,41
St Mirren,3592,8,9,11,16,39,55,-16,38
Raith,3592,9,9,10,17,35,54,-19,37
Ayr,3592,10,8,12,16,32,53,-21,36
Hibernian,3593,1,19,11,6,55,28,27,68
Morton,3593,2,17,13,6,50,34,16,64
Dundee Utd,3593,3,15,11,10,57,44,13,56
Falkirk,3593,4,14,11,11,53,44,9,53
Queen of S't,3593,5,12,10,14,45,50,-5,46
Dunfermline,3593,6,11,12,13,50,47,3,45
Raith,3593,7,11,10,15,38,49,-11,43
St Mirren,3593,8,9,11,16,42,54,-12,38
Dumbarton,3593,9,8,12,16,42,56,-14,36
Ayr,3593,10,8,11,17,32,58,-26,35
Hibernian,3594,1,21,11,4,58,23,35,74
Morton,3594,2,17,10,9,48,34,14,61
Dundee Utd,3594,3,17,9,10,50,37,13,60
Falkirk,3594,4,16,9,11,57,45,12,57
Dunfermline,3594,5,11,11,14,46,48,-2,44
Queen of S't,3594,6,11,10,15,40,50,-10,43
Ayr,3594,7,10,11,15,32,50,-18,41
Raith,3594,8,10,9,17,35,50,-15,39
Dumbarton,3594,9,8,11,17,44,57,-13,35
St Mirren,3594,10,8,11,17,37,53,-16,35
Hibernian,3595,1,20,12,4,56,26,30,72
Morton,3595,2,17,10,9,54,44,10,61
Dundee Utd,3595,3,16,12,8,53,40,13,60
Falkirk,3595,4,15,10,11,54,39,15,55
Queen of S't,3595,5,12,10,14,45,50,-5,46
Dunfermline,3595,6,10,12,14,52,52,0,42
Dumbarton,3595,7,10,11,15,48,58,-10,41
Ayr,3595,8,8,14,14,35,52,-17,38
Raith,3595,9,9,9,18,33,53,-20,36
St Mirren,3595,10,8,10,18,36,52,-16,34
Hibernian,3596,1,20,12,4,55,23,32,72
Falkirk,3596,2,16,11,9,56,39,17,59
Morton,3596,3,15,13,8,47,37,10,58
Dundee Utd,3596,4,15,9,12,52,44,8,54
Dunfermline,3596,5,12,12,12,48,47,1,48
Queen of S't,3596,5,13,9,14,48,47,1,48
Raith,3596,7,12,8,16,37,50,-13,44
Dumbarton,3596,8,8,11,17,42,55,-13,35
Ayr,3596,9,8,11,17,37,61,-24,35
St Mirren,3596,10,7,12,17,39,58,-19,33
Hibernian,3597,1,18,15,3,52,23,29,69
Dundee Utd,3597,2,18,8,10,56,41,15,62
Morton,3597,3,16,9,11,46,39,7,57
Falkirk,3597,4,15,11,10,58,45,13,56
Queen of S't,3597,5,13,10,13,50,50,0,49
Raith,3597,6,11,10,15,40,50,-10,43
Dunfermline,3597,7,9,13,14,45,50,-5,40
Ayr,3597,8,9,12,15,33,52,-19,39
Dumbarton,3597,9,9,10,17,53,64,-11,37
St Mirren,3597,10,8,10,18,37,56,-19,34
Hibernian,3598,1,21,10,5,55,24,31,73
Dundee Utd,3598,2,19,9,8,55,38,17,66
Morton,3598,3,16,11,9,51,37,14,59
Falkirk,3598,4,15,11,10,58,44,14,56
Dunfermline,3598,5,11,11,14,44,50,-6,44
Queen of S't,3598,6,11,9,16,44,52,-8,42
Raith,3598,7,10,9,17,35,49,-14,39
Dumbarton,3598,8,8,14,14,45,55,-10,38
St Mirren,3598,9,9,10,17,42,56,-14,37
Ayr,3598,10,7,12,17,32,56,-24,33
Hibernian,3599,1,21,10,5,57,25,32,73
Dundee Utd,3599,2,16,10,10,49,40,9,58
Morton,3599,3,15,10,11,48,38,10,55
Falkirk,3599,4,15,9,12,56,44,12,54
Queen of S't,3599,5,14,8,14,46,47,-1,50
Dumbarton,3599,6,11,11,14,50,50,0,44
Dunfermline,3599,7,10,11,15,42,53,-11,41
St Mirren,3599,8,9,12,15,41,56,-15,39
Ayr,3599,9,9,12,15,35,54,-19,39
Raith,3599,10,9,9,18,37,54,-17,36
Hibernian,3600,1,22,10,4,61,23,38,76
Falkirk,3600,2,16,10,10,60,42,18,58
Dundee Utd,3600,3,15,11,10,49,44,5,56
Morton,3600,4,13,12,11,43,38,5,51
Dunfermline,3600,5,12,12,12,53,47,6,48
Queen of S't,3600,6,12,9,15,46,50,-4,45
Raith,3600,7,10,10,16,36,51,-15,40
Ayr,3600,8,9,11,16,32,58,-26,38
Dumbarton,3600,9,8,13,15,46,58,-12,37
St Mirren,3600,10,8,12,16,43,58,-15,36
Morton,3601,1,19,11,6,53,33,20,68
Hibernian,3601,2,18,13,5,55,26,29,67
Falkirk,3601,3,17,11,8,60,39,21,62
Dundee Utd,3601,4,14,10,12,47,38,9,52
Queen of S't,3601,5,12,10,14,44,50,-6,46
Dunfermline,3601,6,10,13,13,46,48,-2,43
Ayr,3601,7,9,12,15,36,55,-19,39
Raith,3601,8,9,10,17,37,53,-16,37
St Mirren,3601,9,8,11,17,38,59,-21,35
Dumbarton,3601,10,7,13,16,45,60,-15,34
Hibernian,3602,1,19,12,5,58,31,27,69
Dundee Utd,3602,2,17,9,10,53,40,13,60
Morton,3602,3,15,12,9,51,39,12,57
Falkirk,3602,4,15,11,10,56,42,14,56
Dunfermline,3602,5,11,13,12,51,49,2,46
Queen of S't,3602,6,11,10,15,43,49,-6,43
St Mirren,3602,7,11,9,16,37,50,-13,42
Dumbarton,3602,8,9,12,15,45,57,-12,39
Raith,3602,9,10,8,18,32,52,-20,38
Ayr,3602,10,8,12,16,37,54,-17,36
Hibernian,3603,1,19,13,4,55,22,33,70
Morton,3603,2,17,13,6,52,33,19,64
Falkirk,3603,3,16,11,9,62,42,20,59
Dundee Utd,3603,4,15,10,11,53,45,8,55
Dunfermline,3603,5,11,12,13,53,54,-1,45
Queen of S't,3603,6,10,11,15,48,56,-8,41
Raith,3603,7,10,11,15,36,50,-14,41
Ayr,3603,8,9,13,14,41,55,-14,40
Dumbarton,3603,9,9,11,16,49,64,-15,38
St Mirren,3603,10,6,11,19,35,63,-28,29
Hibernian,3604,1,22,10,4,64,24,40,76
Morton,3604,2,16,12,8,49,38,11,60
Dundee Utd,3604,3,15,11,10,53,43,10,56
Falkirk,3604,4,14,11,11,53,44,9,53
Dumbarton,3604,5,11,11,14,50,59,-9,44
Dunfermline,3604,6,10,13,13,42,45,-3,43
Raith,3604,7,10,10,16,34,49,-15,40
Queen of S't,3604,8,9,12,15,41,54,-13,39
Ayr,3604,9,9,11,16,38,56,-18,38
St Mirren,3604,10,8,11,17,42,54,-12,35
Hibernian,3605,1,22,11,3,58,25,33,77
Falkirk,3605,2,16,11,9,60,43,17,59
Dundee Utd,3605,3,15,10,11,55,49,6,55
Morton,3605,4,14,11,11,45,39,6,53
Ayr,3605,5,11,12,13,43,51,-8,45
Queen of S't,3605,6,11,10,15,47,50,-3,43
Dumbarton,3605,7,9,15,12,47,51,-4,42
Dunfermline,3605,8,9,12,15,44,53,-9,39
Raith,3605,9,9,11,16,31,48,-17,38
St Mirren,3605,10,7,11,18,36,57,-21,32
Hibernian,3606,1,19,10,7,54,26,28,67
Morton,3606,2,19,10,7,51,34,17,67
Falkirk,3606,3,15,10,11,59,42,17,55
Dundee Utd,3606,4,15,10,11,47,39,8,55
Queen of S't,3606,5,13,9,14,48,51,-3,48
Dunfermline,3606,6,12,11,13,48,46,2,47
Ayr,3606,7,11,11,14,40,51,-11,44
St Mirren,3606,8,9,10,17,40,59,-19,37
Dumbarton,3606,9,8,11,17,49,64,-15,35
Raith,3606,10,8,10,18,33,57,-24,34
Hibernian,3607,1,19,14,3,56,21,35,71
Morton,3607,2,18,11,7,47,35,12,65
Dundee Utd,3607,3,17,9,10,53,38,15,60
Falkirk,3607,4,16,9,11,54,42,12,57
Queen of S't,3607,5,11,10,15,40,47,-7,43
Dunfermline,3607,6,9,14,13,42,46,-4,41
St Mirren,3607,7,9,11,16,44,56,-12,38
Dumbarton,3607,8,9,10,17,44,57,-13,37
Raith,3607,9,9,10,17,34,50,-16,37
Ayr,3607,10,8,12,16,36,58,-22,36
Hibernian,3608,1,18,15,3,55,22,33,69
Dundee Utd,3608,2,17,10,9,54,39,15,61
Falkirk,3608,3,16,12,8,63,38,25,60
Morton,3608,4,16,11,9,51,39,12,59
Raith,3608,5,11,9,16,38,51,-13,42
Dunfermline,3608,6,9,14,13,46,50,-4,41
Queen of S't,3608,7,10,11,15,41,50,-9,41
Dumbarton,3608,8,8,14,14,49,65,-16,38
Ayr,3608,9,9,11,16,35,55,-20,38
St Mirren,3608,10,7,11,18,39,62,-23,32
Hibernian,3609,1,20,11,5,57,27,30,71
Morton,3609,2,16,12,8,49,37,12,60
Dundee Utd,3609,3,16,10,10,54,39,15,58
Falkirk,3609,4,16,10,10,56,43,13,58
Dunfermline,3609,5,10,12,14,46,46,0,42
Dumbarton,3609,6,10,12,14,46,57,-11,42
Queen of S't,3609,7,10,11,15,42,48,-6,41
Ayr,3609,8,10,11,15,39,57,-18,41
Raith,3609,9,9,10,17,34,52,-18,37
St Mirren,3609,10,9,9,18,42,59,-17,36
Hibernian,3610,1,20,11,5,56,25,31,71
Dundee Utd,3610,2,19,9,8,53,34,19,66
Morton,3610,3,17,10,9,50,37,13,61
Falkirk,3610,4,14,12,10,57,45,12,54
Dunfermline,3610,5,10,16,10,45,43,2,46
Queen of S't,3610,6,11,11,14,45,50,-5,44
Dumbarton,3610,7,9,11,16,45,58,-13,38
Raith,3610,8,9,10,17,33,48,-15,37
St Mirren,3610,9,8,12,16,39,54,-15,36
Ayr,3610,10,6,12,18,30,59,-29,30
Hibernian,3611,1,19,12,5,52,22,30,69
Falkirk,3611,2,17,10,9,61,41,20,61
Dundee Utd,3611,3,17,8,11,52,39,13,59
Morton,3611,4,16,10,10,52,41,11,58
Queen of S't,3611,5,13,9,14,52,49,3,48
Raith,3611,6,11,11,14,38,47,-9,44
Dunfermline,3611,7,10,12,14,46,52,-6,42
Dumbarton,3611,8,8,13,15,45,57,-12,37
Ayr,3611,9,8,13,15,32,57,-25,37
St Mirren,3611,10,6,12,18,39,64,-25,30
Hibernian,3612,1,18,13,5,55,28,27,67
Morton,3612,2,18,11,7,60,39,21,65
Falkirk,3612,3,18,9,9,61,38,23,63
Dundee Utd,3612,4,15,12,9,49,38,11,57
Queen of S't,3612,5,13,9,14,44,50,-6,48
Dunfermline,3612,6,11,13,12,47,49,-2,46
Raith,3612,7,9,10,17,36,50,-14,37
Ayr,3612,8,7,13,16,35,62,-27,34
Dumbarton,3612,9,7,12,17,46,60,-14,33
St Mirren,3612,10,7,12,17,36,55,-19,33
Hibernian,3613,1,18,13,5,51,26,25,67
Falkirk,3613,2,18,9,9,60,37,23,63
Morton,3613,3,18,9,9,53,33,20,63
Dundee Utd,3613,4,15,10,11,49,40,9,55
Dunfermline,3613,5,11,12,13,47,48,-1,45
Raith,3613,6,12,9,15,36,47,-11,45
Dumbarton,3613,7,10,10,16,47,60,-13,40
Queen of S't,3613,8,10,9,17,41,56,-15,39
Ayr,3613,9,8,13,15,31,53,-22,37
St Mirren,3613,10,8,10,18,40,55,-15,34
Hibernian,3614,1,20,10,6,55,24,31,70
Morton,3614,2,19,10,7,52,35,17,67
Falkirk,3614,3,16,10,10,56,40,16,58
Dundee Utd,3614,4,16,10,10,50,41,9,58
Raith,3614,5,12,9,15,37,46,-9,45
Dumbarton,3614,6,11,11,14,49,54,-5,44
Dunfermline,3614,7,10,13,13,49,49,0,43
Queen of S't,3614,8,11,9,16,43,54,-11,42
St Mirren,3614,9,8,10,18,42,60,-18,34
Ayr,3614,10,6,10,20,31,61,-30,28
Morton,3615,1,16,15,5,49,31,18,63
Hibernian,3615,2,16,14,6,49,27,22,62
Dundee Utd,3615,3,15,11,10,51,39,12,56
Falkirk,3615,4,13,12,11,53,42,11,51
Queen of S't,3615,5,13,10,13,49,49,0,49
Dunfermline,3615,6,10,14,12,48,49,-1,44
Dumbarton,3615,7,10,12,14,49,57,-8,42
Raith,3615,8,10,10,16,38,49,-11,40
St Mirren,3615,9,9,10,17,41,59,-18,37
Ayr,3615,10,7,14,15,29,54,-25,35
Hibernian,3616,1,17,14,5,55,27,28,65
Falkirk,3616,2,18,11,7,58,36,22,65
Morton,3616,3,14,15,7,47,36,11,57
Dundee Utd,3616,4,15,9,12,46,38,8,54
Dunfermline,3616,5,11,13,12,45,48,-3,46
Queen of S't,3616,6,11,10,15,47,52,-5,43
Raith,3616,7,10,10,16,36,49,-13,40
Ayr,3616,8,9,13,14,37,56,-19,40
Dumbarton,3616,9,9,12,15,47,55,-8,39
St Mirren,3616,10,7,11,18,37,58,-21,32
Hibernian,3617,1,19,13,4,56,24,32,70
Morton,3617,2,16,13,7,52,38,14,61
Falkirk,3617,3,16,12,8,55,36,19,60
Dundee Utd,3617,4,14,11,11,50,43,7,53
Queen of S't,3617,5,13,8,15,48,49,-1,47
Raith,3617,6,11,10,15,40,50,-10,43
Dunfermline,3617,7,9,12,15,47,55,-8,39
Dumbarton,3617,8,9,11,16,45,61,-16,38
Ayr,3617,9,8,14,14,34,52,-18,38
St Mirren,3617,10,7,12,17,38,57,-19,33
Hibernian,3618,1,18,15,3,55,24,31,69
Morton,3618,2,17,11,8,49,36,13,62
Dundee Utd,3618,3,17,10,9,54,38,16,61
Falkirk,3618,4,14,11,11,52,43,9,53
Queen of S't,3618,5,13,10,13,47,47,0,49
Dunfermline,3618,6,9,14,13,45,52,-7,41
Ayr,3618,7,9,13,14,34,50,-16,40
Raith,3618,8,8,13,15,35,50,-15,37
Dumbarton,3618,9,8,10,18,46,60,-14,34
St Mirren,3618,10,7,13,16,38,55,-17,34
Hibernian,3619,1,20,12,4,56,26,30,72
Dundee Utd,3619,2,18,9,9,53,36,17,63
Morton,3619,3,15,11,10,49,43,6,56
Falkirk,3619,4,15,10,11,54,41,13,55
Dunfermline,3619,5,12,12,12,50,48,2,48
Queen of S't,3619,6,12,9,15,48,50,-2,45
Ayr,3619,7,10,12,14,34,50,-16,42
Dumbarton,3619,8,10,11,15,47,56,-9,41
Raith,3619,9,9,9,18,36,54,-18,36
St Mirren,3619,10,6,11,19,35,58,-23,29
Hibernian,3620,1,19,13,4,53,28,25,70
Morton,3620,2,18,11,7,59,37,22,65
Dundee Utd,3620,3,16,10,10,49,36,13,58
Falkirk,3620,4,15,12,9,60,44,16,57
Queen of S't,3620,5,10,11,15,43,49,-6,41
Dumbarton,3620,6,9,14,13,48,59,-11,41
Raith,3620,7,10,11,15,36,47,-11,41
Dunfermline,3620,8,8,14,14,44,51,-7,38
Ayr,3620,9,8,12,16,36,57,-21,36
St Mirren,3620,10,8,10,18,36,56,-20,34
Morton,3621,1,18,11,7,51,38,13,65
Hibernian,3621,2,17,11,8,51,28,23,62
Dundee Utd,3621,3,16,10,10,47,37,10,58
Falkirk,3621,4,14,13,9,56,42,14,55
Queen of S't,3621,5,12,11,13,45,47,-2,47
Raith,3621,6,11,12,13,39,45,-6,45
Dumbarton,3621,7,10,11,15,52,62,-10,41
Dunfermline,3621,8,8,14,14,41,48,-7,38
Ayr,3621,9,9,10,17,34,54,-20,37
St Mirren,3621,10,7,13,16,40,55,-15,34
Hibernian,3622,1,22,10,4,61,23,38,76
Morton,3622,2,16,12,8,48,36,12,60
Dundee Utd,3622,3,16,9,11,49,41,8,57
Falkirk,3622,4,15,10,11,54,45,9,55
Queen of S't,3622,5,11,10,15,45,54,-9,43
Dunfermline,3622,6,9,14,13,45,45,0,41
Dumbarton,3622,7,10,11,15,49,58,-9,41
Ayr,3622,8,10,10,16,37,57,-20,40
Raith,3622,9,10,9,17,32,47,-15,39
St Mirren,3622,10,9,9,18,40,54,-14,36
Morton,3623,1,18,11,7,52,36,16,65
Falkirk,3623,2,17,10,9,63,46,17,61
Hibernian,3623,3,16,12,8,49,30,19,60
Dundee Utd,3623,4,17,9,10,53,39,14,60
Queen of S't,3623,5,12,9,15,46,48,-2,45
Dunfermline,3623,6,10,12,14,44,50,-6,42
Dumbarton,3623,7,9,14,13,49,55,-6,41
Ayr,3623,8,10,11,15,38,54,-16,41
Raith,3623,9,9,11,16,35,49,-14,38
St Mirren,3623,10,6,13,17,41,63,-22,31
Hibernian,3624,1,19,10,7,53,28,25,67
Dundee Utd,3624,2,17,9,10,52,36,16,60
Morton,3624,3,16,10,10,46,38,8,58
Falkirk,3624,4,15,10,11,56,44,12,55
Queen of S't,3624,5,13,9,14,48,52,-4,48
Dunfermline,3624,6,11,11,14,47,46,1,44
Dumbarton,3624,7,11,11,14,49,57,-8,44
St Mirren,3624,8,10,11,15,42,52,-10,41
Raith,3624,9,10,9,17,36,49,-13,39
Ayr,3624,10,8,10,18,35,62,-27,34
Hibernian,3625,1,19,13,4,58,26,32,70
Falkirk,3625,2,18,9,9,60,41,19,63
Morton,3625,3,15,13,8,47,38,9,58
Dundee Utd,3625,4,14,11,11,47,40,7,53
Queen of S't,3625,5,13,9,14,52,54,-2,48
Dunfermline,3625,6,10,13,13,47,49,-2,43
Raith,3625,7,10,11,15,38,49,-11,41
Ayr,3625,8,8,13,15,38,59,-21,37
Dumbarton,3625,9,8,12,16,47,60,-13,36
St Mirren,3625,10,8,10,18,39,57,-18,34
Hibernian,3626,1,21,11,4,58,25,33,74
Morton,3626,2,18,10,8,48,34,14,64
Dundee Utd,3626,3,17,11,8,54,36,18,62
Falkirk,3626,4,15,10,11,54,45,9,55
Queen of S't,3626,5,11,11,14,43,49,-6,44
Dunfermline,3626,6,10,13,13,43,45,-2,43
Raith,3626,7,10,9,17,33,49,-16,39
Dumbarton,3626,8,9,11,16,45,57,-12,38
St Mirren,3626,9,8,10,18,42,57,-15,34
Ayr,3626,10,8,10,18,34,57,-23,34
Hibernian,3627,1,21,11,4,57,23,34,74
Falkirk,3627,2,17,10,9,60,42,18,61
Morton,3627,3,16,11,9,52,38,14,59
Dundee Utd,3627,4,17,8,11,50,39,11,59
Dunfermline,3627,5,11,13,12,47,49,-2,46
Queen of S't,3627,6,12,9,15,44,50,-6,45
Dumbarton,3627,7,9,14,13,52,58,-6,41
Raith,3627,8,9,11,16,33,47,-14,38
St Mirren,3627,9,8,10,18,41,58,-17,34
Ayr,3627,10,6,11,19,29,61,-32,29
Hibernian,3628,1,21,10,5,61,26,35,73
Dundee Utd,3628,2,18,8,10,50,39,11,62
Falkirk,3628,3,17,10,9,58,41,17,61
Morton,3628,4,15,9,12,46,47,-1,54
Queen of S't,3628,5,12,9,15,46,47,-1,45
Dunfermline,3628,6,11,11,14,54,53,1,44
Dumbarton,3628,7,9,13,14,52,57,-5,40
Raith,3628,8,10,9,17,33,51,-18,39
St Mirren,3628,9,8,11,17,37,55,-18,35
Ayr,3628,10,7,14,15,33,54,-21,35
Hibernian,3629,1,19,14,3,58,23,35,71
Falkirk,3629,2,17,11,8,60,39,21,62
Morton,3629,3,16,10,10,47,39,8,58
Dundee Utd,3629,4,14,11,11,46,39,7,53
Dunfermline,3629,5,11,12,13,47,48,-1,45
Queen of S't,3629,6,11,11,14,46,47,-1,44
Dumbarton,3629,7,10,11,15,45,55,-10,41
Raith,3629,8,10,9,17,33,52,-19,39
Ayr,3629,9,9,10,17,33,60,-27,37
St Mirren,3629,10,8,11,17,41,54,-13,35
Hibernian,3630,1,20,13,3,63,26,37,73
Morton,3630,2,17,9,10,49,42,7,60
Falkirk,3630,3,16,10,10,58,43,15,58
Dundee Utd,3630,4,16,10,10,53,41,12,58
Queen of S't,3630,5,13,9,14,43,47,-4,48
Dumbarton,3630,6,10,11,15,49,58,-9,41
Dunfermline,3630,7,8,15,13,42,47,-5,39
St Mirren,3630,8,9,12,15,41,51,-10,39
Raith,3630,9,10,9,17,32,47,-15,39
Ayr,3630,10,6,12,18,30,58,-28,30
Hibernian,3631,1,18,14,4,53,25,28,68
Morton,3631,2,17,10,9,48,37,11,61
Falkirk,3631,3,16,11,9,57,38,19,59
Dundee Utd,3631,4,14,12,10,51,40,11,54
Queen of S't,3631,5,12,11,13,46,46,0,47
Raith,3631,6,11,10,15,34,42,-8,43
Dunfermline,3631,7,9,12,15,44,55,-11,39
St Mirren,3631,8,9,11,16,39,51,-12,38
Ayr,3631,9,9,11,16,34,56,-22,38
Dumbarton,3631,10,8,12,16,47,63,-16,36
Hibernian,3632,1,20,12,4,58,27,31,72
Dundee Utd,3632,2,19,9,8,58,34,24,66
Morton,3632,3,15,12,9,49,38,11,57
Falkirk,3632,4,13,12,11,53,43,10,51
Queen of S't,3632,5,12,10,14,47,47,0,46
Dunfermline,3632,6,11,12,13,47,51,-4,45
Raith,3632,7,10,11,15,39,52,-13,41
Dumbarton,3632,8,8,13,15,50,65,-15,37
Ayr,3632,9,8,11,17,36,62,-26,35
St Mirren,3632,10,7,12,17,42,60,-18,33
Morton,3633,1,17,13,6,49,30,19,64
Hibernian,3633,2,17,11,8,51,32,19,62
Falkirk,3633,3,16,10,10,57,39,18,58
Dundee Utd,3633,4,15,10,11,46,45,1,55
Queen of S't,3633,5,13,10,13,46,44,2,49
Dumbarton,3633,6,12,10,14,53,56,-3,46
Raith,3633,7,12,9,15,40,48,-8,45
Dunfermline,3633,8,9,13,14,42,46,-4,40
Ayr,3633,9,9,11,16,37,57,-20,38
St Mirren,3633,10,6,11,19,36,60,-24,29
Hibernian,3634,1,20,12,4,56,22,34,72
Morton,3634,2,17,12,7,52,37,15,63
Falkirk,3634,3,15,12,9,54,37,17,57
Dundee Utd,3634,4,14,12,10,45,37,8,54
Queen of S't,3634,5,10,12,14,43,50,-7,42
Raith,3634,6,10,12,14,35,47,-12,42
Dumbarton,3634,7,9,13,14,47,54,-7,40
Dunfermline,3634,8,8,13,15,42,51,-9,37
Ayr,3634,9,8,12,16,33,55,-22,36
St Mirren,3634,10,7,14,15,38,55,-17,35
Morton,3635,1,19,11,6,57,37,20,68
Hibernian,3635,2,17,12,7,56,32,24,63
Falkirk,3635,3,17,9,10,65,44,21,60
Dundee Utd,3635,4,16,11,9,53,38,15,59
Raith,3635,5,12,9,15,38,47,-9,45
Queen of S't,3635,6,11,9,16,46,55,-9,42
Ayr,3635,7,10,11,15,37,57,-20,41
Dumbarton,3635,8,10,10,16,46,60,-14,40
St Mirren,3635,9,8,11,17,41,60,-19,35
Dunfermline,3635,10,7,13,16,46,55,-9,34
Hibernian,3636,1,18,12,6,55,29,26,66
Morton,3636,2,16,12,8,50,36,14,60
Falkirk,3636,3,16,11,9,61,42,19,59
Dundee Utd,3636,4,15,11,10,51,44,7,56
Queen of S't,3636,5,11,12,13,47,51,-4,45
Dunfermline,3636,6,9,14,13,45,51,-6,41
Dumbarton,3636,7,10,11,15,51,58,-7,41
Raith,3636,8,10,10,16,35,48,-13,40
St Mirren,3636,9,10,9,17,43,59,-16,39
Ayr,3636,10,8,12,16,37,57,-20,36
Hibernian,3637,1,22,11,3,61,24,37,77
Falkirk,3637,2,17,10,9,63,42,21,61
Dundee Utd,3637,3,15,9,12,48,43,5,54
Morton,3637,4,14,11,11,46,44,2,53
Dunfermline,3637,5,12,12,12,51,45,6,48
Queen of S't,3637,6,11,9,16,41,49,-8,42
Raith,3637,7,10,10,16,34,50,-16,40
Dumbarton,3637,8,9,12,15,47,58,-11,39
Ayr,3637,9,9,12,15,33,51,-18,39
St Mirren,3637,10,7,12,17,37,55,-18,33
Hibernian,3638,1,21,12,3,61,26,35,75
Dundee Utd,3638,2,16,10,10,50,36,14,58
Falkirk,3638,3,15,12,9,55,39,16,57
Morton,3638,4,15,12,9,47,38,9,57
Dumbarton,3638,5,12,10,14,56,58,-2,46
Raith,3638,6,12,8,16,39,49,-10,44
Dunfermline,3638,7,8,15,13,45,53,-8,39
Ayr,3638,8,9,12,15,34,55,-21,39
Queen of S't,3638,9,9,11,16,42,54,-12,38
St Mirren,3638,10,7,10,19,39,60,-21,31
Hibernian,3639,1,20,13,3,58,26,32,73
Morton,3639,2,17,12,7,50,33,17,63
Falkirk,3639,3,16,11,9,61,48,13,59
Dundee Utd,3639,4,13,12,11,47,44,3,51
Queen of S't,3639,5,14,8,14,48,51,-3,50
Ayr,3639,6,10,12,14,39,53,-14,42
Dunfermline,3639,7,9,12,15,50,52,-2,39
St Mirren,3639,8,8,12,16,39,55,-16,36
Raith,3639,9,9,9,18,33,49,-16,36
Dumbarton,3639,10,8,11,17,50,64,-14,35
Morton,3640,1,18,12,6,55,36,19,66
Hibernian,3640,2,16,15,5,51,28,23,63
Dundee Utd,3640,3,16,11,9,53,38,15,59
Falkirk,3640,4,15,10,11,58,44,14,55
Dunfermline,3640,5,11,14,11,51,47,4,47
Queen of S't,3640,6,11,11,14,43,48,-5,44
Raith,3640,7,11,9,16,37,52,-15,42
Dumbarton,3640,8,9,12,15,47,58,-11,39
St Mirren,3640,9,8,10,18,42,62,-20,34
Ayr,3640,10,7,12,17,34,58,-24,33
Hibernian,3641,1,20,11,5,56,22,34,71
Dundee Utd,3641,2,18,10,8,56,37,19,64
Morton,3641,3,17,12,7,46,32,14,63
Falkirk,3641,4,16,10,10,57,45,12,58
Queen of S't,3641,5,11,9,16,44,55,-11,42
Raith,3641,6,11,9,16,35,48,-13,42
Dunfermline,3641,7,9,14,13,46,48,-2,41
Dumbarton,3641,8,8,12,16,46,60,-14,36
Ayr,3641,9,8,12,16,37,58,-21,36
St Mirren,3641,10,8,9,19,37,55,-18,33
Morton,3642,1,19,11,6,51,30,21,68
Falkirk,3642,2,19,10,7,60,34,26,67
Dundee Utd,3642,3,18,9,9,55,37,18,63
Hibernian,3642,4,17,11,8,51,30,21,62
Raith,3642,5,11,11,14,31,41,-10,44
Dunfermline,3642,6,9,14,13,42,45,-3,41
Queen of S't,3642,7,10,10,16,41,51,-10,40
Dumbarton,3642,8,7,14,15,44,59,-15,35
St Mirren,3642,9,8,9,19,36,56,-20,33
Ayr,3642,10,7,11,18,30,58,-28,32
Hibernian,3643,1,19,12,5,56,27,29,69
Morton,3643,2,18,11,7,54,40,14,65
Dundee Utd,3643,3,17,10,9,54,40,14,61
Falkirk,3643,4,16,10,10,54,41,13,58
Raith,3643,5,12,10,14,35,43,-8,46
Queen of S't,3643,6,11,8,17,40,50,-10,41
Dunfermline,3643,7,8,16,12,42,45,-3,40
Ayr,3643,8,9,12,15,40,58,-18,39
Dumbarton,3643,9,9,10,17,46,56,-10,37
St Mirren,3643,10,7,9,20,40,61,-21,30
Hibernian,3644,1,17,13,6,51,30,21,64
Morton,3644,2,16,13,7,47,35,12,61
Dundee Utd,3644,3,17,8,11,50,37,13,59
Falkirk,3644,4,16,9,11,57,42,15,57
Queen of S't,3644,5,12,11,13,50,48,2,47
Dunfermline,3644,6,10,12,14,48,48,0,42
Raith,3644,7,10,10,16,37,52,-15,40
Ayr,3644,8,9,13,14,32,49,-17,40
St Mirren,3644,9,9,12,15,42,51,-9,39
Dumbarton,3644,10,7,13,16,42,64,-22,34
Hibernian,3645,1,20,12,4,63,29,34,72
Falkirk,3645,2,17,11,8,58,38,20,62
Dundee Utd,3645,3,16,9,11,48,39,9,57
Dunfermline,3645,4,14,11,11,48,42,6,53
Morton,3645,5,14,11,11,48,46,2,53
Raith,3645,6,11,10,15,38,48,-10,43
Queen of S't,3645,7,11,9,16,45,53,-8,42
Dumbarton,3645,8,10,11,15,51,58,-7,41
Ayr,3645,9,7,12,17,32,57,-25,33
St Mirren,3645,10,7,10,19,36,57,-21,31
Hibernian,3646,1,22,10,4,64,24,40,76
Falkirk,3646,2,17,9,10,57,39,18,60
Dundee Utd,3646,3,17,9,10,50,39,11,60
Morton,3646,4,15,13,8,49,39,10,58
Dumbarton,3646,5,10,12,14,50,55,-5,42
Dunfermline,3646,6,10,11,15,44,49,-5,41
Queen of S't,3646,7,10,10,16,41,55,-14,40
St Mirren,3646,8,9,11,16,41,56,-15,38
Raith,3646,9,9,10,17,37,53,-16,37
Ayr,3646,10,7,13,16,32,56,-24,34
Hibernian,3647,1,19,12,5,56,26,30,69
Dundee Utd,3647,2,18,9,9,53,36,17,63
Falkirk,3647,3,16,10,10,53,42,11,58
Morton,3647,4,14,11,11,43,41,2,53
Queen of S't,3647,5,13,9,14,51,50,1,48
Dunfermline,3647,6,12,11,13,49,44,5,47
Dumbarton,3647,7,10,12,14,48,56,-8,42
Raith,3647,8,9,10,17,35,54,-19,37
St Mirren,3647,9,8,11,17,37,54,-17,35
Ayr,3647,10,7,13,16,34,56,-22,34
Hibernian,3648,1,18,13,5,57,30,27,67
Morton,3648,2,18,11,7,54,34,20,65
Dundee Utd,3648,3,17,9,10,52,39,13,60
Falkirk,3648,4,14,12,10,55,41,14,54
Dunfermline,3648,5,9,16,11,45,44,1,43
Queen of S't,3648,6,10,12,14,45,52,-7,42
Raith,3648,7,10,11,15,35,49,-14,41
St Mirren,3648,8,9,11,16,44,56,-12,38
Ayr,3648,9,8,12,16,35,58,-23,36
Dumbarton,3648,10,8,11,17,45,64,-19,35
Hibernian,3649,1,18,13,5,53,24,29,67
Falkirk,3649,2,19,9,8,61,36,25,66
Morton,3649,3,18,11,7,53,34,19,65
Dundee Utd,3649,4,14,10,12,50,44,6,52
Queen of S't,3649,5,11,10,15,43,53,-10,43
Dunfermline,3649,6,10,12,14,47,50,-3,42
Dumbarton,3649,7,9,12,15,49,63,-14,39
Raith,3649,8,9,10,17,34,50,-16,37
Ayr,3649,9,8,13,15,32,54,-22,37
St Mirren,3649,10,8,12,16,40,54,-14,36
Hibernian,3650,1,18,12,6,54,27,27,66
Morton,3650,2,16,14,6,49,32,17,62
Dundee Utd,3650,3,17,9,10,53,38,15,60
Falkirk,3650,4,15,11,10,55,38,17,56
Queen of S't,3650,5,12,10,14,43,50,-7,46
Ayr,3650,6,11,12,13,38,51,-13,45
Dunfermline,3650,7,10,11,15,42,50,-8,41
Dumbarton,3650,8,9,13,14,46,55,-9,40
Raith,3650,9,9,11,16,33,51,-18,38
St Mirren,3650,10,6,11,19,34,55,-21,29
Hibernian,3651,1,20,13,3,55,22,33,73
Morton,3651,2,18,10,8,48,36,12,64
Dundee Utd,3651,3,17,10,9,52,37,15,61
Falkirk,3651,4,14,10,12,58,48,10,52
Raith,3651,5,11,9,16,37,45,-8,42
Queen of S't,3651,6,10,11,15,43,53,-10,41
Dunfermline,3651,7,9,13,14,41,48,-7,40
St Mirren,3651,8,10,10,16,40,52,-12,40
Dumbarton,3651,9,8,12,16,46,60,-14,36
Ayr,3651,10,8,12,16,35,54,-19,36
Hibernian,3652,1,18,12,6,57,29,28,66
Dundee Utd,3652,2,18,10,8,56,37,19,64
Morton,3652,3,16,10,10,49,41,8,58
Falkirk,3652,4,14,11,11,54,44,10,53
Dunfermline,3652,5,11,14,11,52,49,3,47
Queen of S't,3652,6,12,9,15,50,54,-4,45
Raith,3652,7,11,9,16,38,54,-16,42
St Mirren,3652,8,10,11,15,45,52,-7,41
Ayr,3652,9,8,12,16,35,57,-22,36
Dumbarton,3652,10,8,10,18,44,63,-19,34
Hibernian,3653,1,18,13,5,53,29,24,67
Morton,3653,2,19,9,8,59,37,22,66
Dundee Utd,3653,3,17,9,10,53,40,13,60
Falkirk,3653,4,16,10,10,61,38,23,58
Raith,3653,5,12,9,15,37,47,-10,45
Queen of S't,3653,6,11,10,15,43,52,-9,43
Dunfermline,3653,7,9,13,14,45,50,-5,40
St Mirren,3653,8,10,10,16,40,57,-17,40
Ayr,3653,9,8,11,17,33,56,-23,35
Dumbarton,3653,10,7,12,17,46,64,-18,33
Hibernian,3654,1,18,12,6,52,25,27,66
Dundee Utd,3654,2,16,9,11,55,40,15,57
Falkirk,3654,3,15,11,10,58,43,15,56
Morton,3654,4,15,11,10,47,38,9,56
Queen of S't,3654,5,13,10,13,45,46,-1,49
Dunfermline,3654,6,11,12,13,48,50,-2,45
Raith,3654,7,12,9,15,36,48,-12,45
Ayr,3654,8,10,12,14,36,52,-16,42
Dumbarton,3654,9,9,11,16,47,61,-14,38
St Mirren,3654,10,8,9,19,35,56,-21,33
Hibernian,3655,1,21,11,4,56,25,31,74
Falkirk,3655,2,19,10,7,62,38,24,67
Morton,3655,3,18,10,8,53,35,18,64
Dundee Utd,3655,4,15,11,10,50,40,10,56
Queen of S't,3655,5,12,9,15,49,49,0,45
Raith,3655,6,10,9,17,33,46,-13,39
Dunfermline,3655,7,9,11,16,44,56,-12,38
Dumbarton,3655,8,8,12,16,47,58,-11,36
Ayr,3655,9,8,11,17,32,59,-27,35
St Mirren,3655,10,7,12,17,37,57,-20,33
Hibernian,3656,1,19,11,6,51,23,28,68
Falkirk,3656,2,18,10,8,58,36,22,64
Morton,3656,3,16,14,6,47,33,14,62
Dundee Utd,3656,4,18,8,10,50,39,11,62
Queen of S't,3656,5,13,8,15,46,48,-2,47
Dunfermline,3656,6,9,13,14,46,50,-4,40
St Mirren,3656,7,9,12,15,38,51,-13,39
Raith,3656,8,9,10,17,33,50,-17,37
Dumbarton,3656,9,8,11,17,47,62,-15,35
Ayr,3656,10,7,11,18,33,57,-24,32
Hibernian,3657,1,20,11,5,56,23,33,71
Morton,3657,2,19,10,7,48,35,13,67
Falkirk,3657,3,17,10,9,58,43,15,61
Queen of S't,3657,4,15,8,13,53,46,7,53
Dundee Utd,3657,5,14,9,13,51,44,7,51
Ayr,3657,6,9,12,15,36,54,-18,39
Dunfermline,3657,7,8,13,15,41,47,-6,37
Raith,3657,8,9,10,17,32,47,-15,37
Dumbarton,3657,9,8,12,16,43,60,-17,36
St Mirren,3657,10,8,11,17,37,56,-19,35
Hibernian,3658,1,21,12,3,64,25,39,75
Morton,3658,2,17,13,6,53,38,15,64
Falkirk,3658,3,17,11,8,62,41,21,62
Dundee Utd,3658,4,16,9,11,51,43,8,57
Queen of S't,3658,5,12,10,14,45,48,-3,46
Ayr,3658,6,9,13,14,37,51,-14,40
Raith,3658,7,10,8,18,34,54,-20,38
Dunfermline,3658,8,7,16,13,40,47,-7,37
Dumbarton,3658,9,7,12,17,43,60,-17,33
St Mirren,3658,10,7,10,19,37,59,-22,31
Hibernian,3659,1,20,12,4,58,24,34,72
Falkirk,3659,2,17,10,9,59,41,18,61
Morton,3659,3,16,11,9,51,37,14,59
Dundee Utd,3659,4,16,10,10,51,41,10,58
Dunfermline,3659,5,13,12,11,49,46,3,51
Raith,3659,6,11,8,17,35,47,-12,41
St Mirren,3659,7,9,11,16,40,54,-14,38
Dumbarton,3659,8,8,12,16,41,57,-16,36
Ayr,3659,9,8,12,16,33,54,-21,36
Queen of S't,3659,10,9,8,19,40,56,-16,35
Hibernian,3660,1,18,12,6,51,28,23,66
Morton,3660,2,19,9,8,50,35,15,66
Falkirk,3660,3,16,10,10,60,43,17,58
Dundee Utd,3660,4,15,9,12,48,43,5,54
Queen of S't,3660,5,13,10,13,46,46,0,49
Dunfermline,3660,6,11,12,13,47,45,2,45
Raith,3660,7,11,8,17,34,48,-14,41
St Mirren,3660,8,9,10,17,42,52,-10,37
Dumbarton,3660,9,8,12,16,44,61,-17,36
Ayr,3660,10,7,14,15,32,53,-21,35
Hibernian,3661,1,19,12,5,56,25,31,69
Morton,3661,2,18,11,7,55,35,20,65
Falkirk,3661,3,18,10,8,65,41,24,64
Dundee Utd,3661,4,15,10,11,47,40,7,55
Queen of S't,3661,5,12,8,16,46,53,-7,44
Raith,3661,6,11,8,17,36,52,-16,41
Dunfermline,3661,7,9,13,14,48,54,-6,40
Ayr,3661,8,9,13,14,36,51,-15,40
St Mirren,3661,9,9,10,17,41,61,-20,37
Dumbarton,3661,10,7,11,18,42,60,-18,32
Hibernian,3662,1,18,10,8,54,32,22,64
Dundee Utd,3662,2,18,8,10,56,43,13,62
Morton,3662,3,17,10,9,54,40,14,61
Falkirk,3662,4,16,10,10,60,45,15,58
Raith,3662,5,11,11,14,38,47,-9,44
Dunfermline,3662,6,10,13,13,44,46,-2,43
Queen of S't,3662,7,11,10,15,43,50,-7,43
Ayr,3662,8,10,10,16,38,55,-17,40
St Mirren,3662,9,9,11,16,44,59,-15,38
Dumbarton,3662,10,8,11,17,46,60,-14,35
Hibernian,3663,1,21,11,4,60,27,33,74
Morton,3663,2,17,10,9,51,36,15,61
Falkirk,3663,3,16,10,10,55,40,15,58
Dundee Utd,3663,4,16,9,11,48,39,9,57
Ayr,3663,5,11,10,15,39,56,-17,43
Dunfermline,3663,6,10,12,14,46,50,-4,42
Raith,3663,7,10,11,15,35,44,-9,41
Queen of S't,3663,8,10,9,17,45,54,-9,39
Dumbarton,3663,9,9,11,16,48,58,-10,38
St Mirren,3663,10,8,11,17,37,60,-23,35
Hibernian,3664,1,18,13,5,54,27,27,67
Falkirk,3664,2,19,9,8,68,42,26,66
Morton,3664,3,18,11,7,52,38,14,65
Dundee Utd,3664,4,17,8,11,59,44,15,59
Dumbarton,3664,5,11,11,14,53,56,-3,44
Dunfermline,3664,6,10,12,14,45,53,-8,42
Queen of S't,3664,7,10,10,16,42,51,-9,40
Raith,3664,8,10,10,16,35,50,-15,40
St Mirren,3664,9,8,9,19,37,59,-22,33
Ayr,3664,10,7,11,18,34,59,-25,32
Morton,3665,1,19,12,5,56,35,21,69
Hibernian,3665,2,17,13,6,55,31,24,64
Falkirk,3665,3,17,9,10,59,41,18,60
Dundee Utd,3665,4,15,9,12,47,41,6,54
Queen of S't,3665,5,15,8,13,47,44,3,53
Raith,3665,6,9,12,15,37,51,-14,39
Ayr,3665,7,9,12,15,37,52,-15,39
Dunfermline,3665,8,8,14,14,44,50,-6,38
St Mirren,3665,9,9,10,17,43,59,-16,37
Dumbarton,3665,10,7,11,18,44,65,-21,32
Hibernian,3666,1,19,12,5,54,26,28,69
Dundee Utd,3666,2,17,10,9,61,41,20,61
Falkirk,3666,3,17,9,10,58,42,16,60
Morton,3666,4,15,11,10,47,39,8,56
Raith,3666,5,12,8,16,38,50,-12,44
Dumbarton,3666,6,10,13,13,52,58,-6,43
Dunfermline,3666,7,10,11,15,43,50,-7,41
Queen of S't,3666,8,11,8,17,42,50,-8,41
St Mirren,3666,9,9,11,16,41,55,-14,38
Ayr,3666,10,8,11,17,35,60,-25,35
Hibernian,3667,1,20,12,4,60,26,34,72
Dundee Utd,3667,2,17,10,9,56,41,15,61
Morton,3667,3,17,10,9,53,39,14,61
Falkirk,3667,4,14,12,10,53,42,11,54
Dunfermline,3667,5,11,12,13,48,47,1,45
Queen of S't,3667,6,11,9,16,43,49,-6,42
Raith,3667,7,10,11,15,35,48,-13,41
St Mirren,3667,8,8,13,15,46,54,-8,37
Dumbarton,3667,9,9,10,17,45,63,-18,37
Ayr,3667,10,8,11,17,32,62,-30,35
Hibernian,3668,1,19,13,4,55,23,32,70
Morton,3668,2,18,11,7,53,36,17,65
Falkirk,3668,3,16,10,10,57,44,13,58
Dundee Utd,3668,4,15,9,12,48,39,9,54
Dumbarton,3668,5,11,11,14,54,61,-7,44
Raith,3668,6,11,11,14,37,46,-9,44
Dunfermline,3668,7,10,12,14,46,50,-4,42
Queen of S't,3668,8,11,8,17,47,56,-9,41
St Mirren,3668,9,8,13,15,38,53,-15,37
Ayr,3668,10,7,10,19,33,60,-27,31
Hibernian,3669,1,18,11,7,50,23,27,65
Dundee Utd,3669,2,19,8,9,57,34,23,65
Morton,3669,3,18,10,8,45,32,13,64
Falkirk,3669,4,18,9,9,61,37,24,63
Queen of S't,3669,5,12,8,16,42,49,-7,44
Dunfermline,3669,6,10,12,14,42,47,-5,42
Raith,3669,7,10,9,17,36,52,-16,39
Dumbarton,3669,8,9,11,16,44,56,-12,38
St Mirren,3669,9,8,12,16,34,55,-21,36
Ayr,3669,10,8,10,18,33,59,-26,34
Hibernian,3670,1,18,12,6,53,27,26,66
Falkirk,3670,2,16,10,10,58,43,15,58
Morton,3670,3,15,13,8,47,38,9,58
Dundee Utd,3670,4,15,12,9,49,37,12,57
Dunfermline,3670,5,11,15,10,48,42,6,48
Queen of S't,3670,6,11,10,15,47,52,-5,43
Raith,3670,7,10,12,14,36,48,-12,42
Dumbarton,3670,8,9,11,16,49,60,-11,38
St Mirren,3670,9,9,9,18,37,56,-19,36
Ayr,3670,10,8,12,16,34,55,-21,36
Hibernian,3671,1,19,13,4,55,25,30,70
Morton,3671,2,16,13,7,46,36,10,61
Dundee Utd,3671,3,16,9,11,53,42,11,57
Falkirk,3671,4,14,13,9,54,40,14,55
Queen of S't,3671,5,11,11,14,44,49,-5,44
Dunfermline,3671,6,10,13,13,44,46,-2,43
Ayr,3671,7,9,14,13,41,52,-11,41
Dumbarton,3671,8,9,13,14,45,55,-10,40
Raith,3671,9,10,10,16,39,55,-16,40
St Mirren,3671,10,6,11,19,34,55,-21,29
Morton,3672,1,20,9,7,57,39,18,69
Falkirk,3672,2,18,10,8,65,41,24,64
Hibernian,3672,3,18,10,8,49,27,22,64
Queen of S't,3672,4,14,10,12,53,45,8,52
Dundee Utd,3672,5,13,11,12,49,43,6,50
Dunfermline,3672,6,11,11,14,46,51,-5,44
Raith,3672,7,10,9,17,34,54,-20,39
St Mirren,3672,8,9,9,18,42,56,-14,36
Ayr,3672,9,8,12,16,32,54,-22,36
Dumbarton,3672,10,8,11,17,48,65,-17,35
Hibernian,3673,1,20,12,4,56,24,32,72
Morton,3673,2,16,13,7,49,36,13,61
Dundee Utd,3673,3,15,12,9,52,41,11,57
Falkirk,3673,4,14,10,12,56,47,9,52
Dunfermline,3673,5,13,12,11,54,49,5,51
Queen of S't,3673,6,12,9,15,49,56,-7,45
Raith,3673,7,10,9,17,35,50,-15,39
St Mirren,3673,8,9,10,17,39,53,-14,37
Ayr,3673,9,9,10,17,39,57,-18,37
Dumbarton,3673,10,8,11,17,47,63,-16,35
Hibernian,3674,1,18,13,5,53,24,29,67
Morton,3674,2,16,12,8,50,39,11,60
Falkirk,3674,3,16,10,10,57,41,16,58
Dundee Utd,3674,4,15,10,11,45,37,8,55
Queen of S't,3674,5,12,9,15,42,47,-5,45
Dunfermline,3674,6,10,14,12,43,44,-1,44
Ayr,3674,7,10,12,14,36,52,-16,42
St Mirren,3674,8,10,9,17,45,55,-10,39
Dumbarton,3674,9,9,11,16,47,60,-13,38
Raith,3674,10,10,8,18,33,52,-19,38
Hibernian,3675,1,18,13,5,59,31,28,67
Morton,3675,2,17,12,7,51,36,15,63
Dundee Utd,3675,3,17,8,11,60,42,18,59
Falkirk,3675,4,15,9,12,54,41,13,54
Queen of S't,3675,5,13,10,13,46,47,-1,49
Dunfermline,3675,6,11,13,12,50,47,3,46
Dumbarton,3675,7,11,10,15,46,56,-10,43
St Mirren,3675,8,9,10,17,42,59,-17,37
Raith,3675,9,9,9,18,31,49,-18,36
Ayr,3675,10,7,12,17,34,65,-31,33
Hibernian,3676,1,19,10,7,50,26,24,67
Falkirk,3676,2,18,10,8,59,36,23,64
Dundee Utd,3676,3,17,9,10,53,40,13,60
Morton,3676,4,15,12,9,46,35,11,57
Dunfermline,3676,5,11,12,13,48,48,0,45
Ayr,3676,6,11,11,14,38,52,-14,44
Queen of S't,3676,7,11,8,17,46,56,-10,41
Raith,3676,8,10,10,16,35,51,-16,40
St Mirren,3676,9,9,10,17,38,51,-13,37
Dumbarton,3676,10,7,12,17,44,62,-18,33
Hibernian,3677,1,18,12,6,54,26,28,66
Morton,3677,2,16,11,9,48,37,11,59
Dundee Utd,3677,3,16,9,11,53,44,9,57
Falkirk,3677,4,15,10,11,56,42,14,55
Dunfermline,3677,5,12,13,11,51,42,9,49
Raith,3677,6,11,9,16,36,51,-15,42
Queen of S't,3677,7,10,11,15,45,51,-6,41
Ayr,3677,8,9,13,14,31,51,-20,40
Dumbarton,3677,9,9,11,16,47,61,-14,38
St Mirren,3677,10,9,11,16,39,55,-16,38
Hibernian,3678,1,22,11,3,58,22,36,77
Falkirk,3678,2,16,10,10,59,43,16,58
Dundee Utd,3678,3,15,12,9,48,39,9,57
Morton,3678,4,15,11,10,52,45,7,56
Dunfermline,3678,5,11,12,13,48,50,-2,45
Dumbarton,3678,6,10,12,14,52,57,-5,42
St Mirren,3678,7,10,9,17,42,54,-12,39
Raith,3678,8,10,9,17,35,51,-16,39
Queen of S't,3678,9,9,10,17,43,54,-11,37
Ayr,3678,10,7,14,15,29,51,-22,35
Morton,3679,1,19,10,7,50,29,21,67
Falkirk,3679,2,18,9,9,61,37,24,63
Hibernian,3679,3,17,11,8,54,32,22,62
Dundee Utd,3679,4,16,8,12,50,40,10,56
Queen of S't,3679,5,13,9,14,49,52,-3,48
Dunfermline,3679,6,11,13,12,44,48,-4,46
Dumbarton,3679,7,8,14,14,47,58,-11,38
Ayr,3679,8,8,12,16,31,56,-25,36
St Mirren,3679,9,8,11,17,43,59,-16,35
Raith,3679,10,8,11,17,31,49,-18,35
Hibernian,3680,1,19,13,4,54,26,28,70
Falkirk,3680,2,18,9,9,59,39,20,63
Morton,3680,3,15,13,8,54,38,16,58
Dundee Utd,3680,4,15,10,11,46,42,4,55
Dunfermline,3680,5,10,15,11,47,46,1,45
Raith,3680,6,11,9,16,37,46,-9,42
Ayr,3680,7,10,12,14,32,52,-20,42
Queen of S't,3680,8,11,8,17,42,51,-9,41
Dumbarton,3680,9,8,14,14,47,58,-11,38
St Mirren,3680,10,7,9,20,37,57,-20,30
Hibernian,3681,1,20,12,4,55,23,32,72
Dundee Utd,3681,2,16,11,9,49,37,12,59
Morton,3681,3,16,11,9,47,40,7,59
Falkirk,3681,4,16,10,10,56,42,14,58
Queen of S't,3681,5,13,9,14,46,47,-1,48
Dunfermline,3681,6,11,13,12,49,47,2,46
St Mirren,3681,7,9,11,16,47,55,-8,38
Raith,3681,8,9,10,17,35,51,-16,37
Ayr,3681,9,7,13,16,32,51,-19,34
Dumbarton,3681,10,7,12,17,42,65,-23,33
Hibernian,3682,1,19,13,4,59,25,34,70
Morton,3682,2,17,11,8,46,35,11,62
Falkirk,3682,3,16,12,8,59,41,18,60
Dundee Utd,3682,4,15,11,10,47,37,10,56
Dunfermline,3682,5,10,13,13,44,47,-3,43
Queen of S't,3682,6,11,9,16,41,51,-10,42
Dumbarton,3682,7,9,12,15,46,56,-10,39
St Mirren,3682,8,9,12,15,43,53,-10,39
Raith,3682,9,9,11,16,33,48,-15,38
Ayr,3682,10,7,12,17,30,55,-25,33
Morton,3683,1,18,12,6,51,35,16,66
Hibernian,3683,2,16,13,7,47,26,21,61
Falkirk,3683,3,15,13,8,57,38,19,58
Dundee Utd,3683,4,14,13,9,51,42,9,55
Dunfermline,3683,5,11,14,11,47,44,3,47
Ayr,3683,6,11,10,15,41,55,-14,43
Queen of S't,3683,7,10,12,14,42,51,-9,42
St Mirren,3683,8,10,9,17,42,57,-15,39
Raith,3683,9,9,9,18,33,49,-16,36
Dumbarton,3683,10,7,13,16,49,63,-14,34
Hibernian,3684,1,16,13,7,52,30,22,61
Dundee Utd,3684,2,17,9,10,52,39,13,60
Morton,3684,3,16,11,9,52,42,10,59
Falkirk,3684,4,15,12,9,58,42,16,57
Queen of S't,3684,5,13,9,14,46,49,-3,48
Dunfermline,3684,6,11,13,12,48,46,2,46
Raith,3684,7,11,11,14,36,45,-9,44
Ayr,3684,8,9,11,16,35,56,-21,38
Dumbarton,3684,9,8,13,15,46,57,-11,37
St Mirren,3684,10,7,12,17,37,56,-19,33
Hibernian,3685,1,18,12,6,53,27,26,66
Falkirk,3685,2,18,9,9,62,36,26,63
Morton,3685,3,17,12,7,51,37,14,63
Dundee Utd,3685,4,14,11,11,46,37,9,53
Dunfermline,3685,5,11,15,10,49,44,5,48
Queen of S't,3685,6,10,11,15,42,53,-11,41
Raith,3685,7,10,10,16,36,53,-17,40
Dumbarton,3685,8,8,13,15,45,55,-10,37
Ayr,3685,9,9,10,17,34,59,-25,37
St Mirren,3685,10,7,13,16,41,58,-17,34
Falkirk,3686,1,17,12,7,63,38,25,63
Hibernian,3686,2,15,15,6,51,30,21,60
Dundee Utd,3686,3,16,11,9,50,37,13,59
Morton,3686,4,15,12,9,44,37,7,57
Dunfermline,3686,5,11,12,13,48,46,2,45
Ayr,3686,6,10,14,12,35,46,-11,44
Raith,3686,7,9,12,15,37,52,-15,39
Queen of S't,3686,8,9,11,16,41,52,-11,38
St Mirren,3686,9,9,11,16,41,58,-17,38
Dumbarton,3686,10,8,12,16,45,59,-14,36
Hibernian,3687,1,19,10,7,58,31,27,67
Falkirk,3687,2,16,11,9,58,40,18,59
Morton,3687,3,16,11,9,51,42,9,59
Dundee Utd,3687,4,16,10,10,54,42,12,58
Dunfermline,3687,5,13,11,12,51,45,6,50
Queen of S't,3687,6,12,8,16,45,54,-9,44
Raith,3687,7,11,11,14,35,46,-11,44
St Mirren,3687,8,9,10,17,42,58,-16,37
Dumbarton,3687,9,8,11,17,48,63,-15,35
Ayr,3687,10,7,13,16,32,53,-21,34
Hibernian,3688,1,19,11,6,54,26,28,68
Morton,3688,2,18,11,7,53,35,18,65
Falkirk,3688,3,16,12,8,58,42,16,60
Dundee Utd,3688,4,15,10,11,51,43,8,55
Queen of S't,3688,5,11,10,15,44,50,-6,43
Ayr,3688,6,10,12,14,35,51,-16,42
Dumbarton,3688,7,9,12,15,48,57,-9,39
Raith,3688,8,10,9,17,36,51,-15,39
Dunfermline,3688,9,8,13,15,43,53,-10,37
St Mirren,3688,10,9,10,17,41,55,-14,37
Hibernian,3689,1,18,13,5,51,25,26,67
Dundee Utd,3689,2,16,10,10,49,36,13,58
Morton,3689,3,16,10,10,48,43,5,58
Falkirk,3689,4,15,11,10,53,40,13,56
Dunfermline,3689,5,13,12,11,51,45,6,51
Ayr,3689,6,10,12,14,34,50,-16,42
St Mirren,3689,7,10,11,15,44,50,-6,41
Dumbarton,3689,8,9,12,15,48,59,-11,39
Queen of S't,3689,9,10,9,17,41,53,-12,39
Raith,3689,10,9,8,19,33,51,-18,35
Falkirk,3690,1,19,9,8,67,40,27,66
Morton,3690,2,18,11,7,57,38,19,65
Hibernian,3690,3,17,13,6,53,31,22,64
Dundee Utd,3690,4,17,10,9,50,35,15,61
Raith,3690,5,11,9,16,45,55,-10,42
Queen of S't,3690,6,10,11,15,44,54,-10,41
Dumbarton,3690,7,10,10,16,46,59,-13,40
Dunfermline,3690,8,9,12,15,46,55,-9,39
St Mirren,3690,9,8,11,17,37,55,-18,35
Ayr,3690,10,6,14,16,31,54,-23,32
Morton,3691,1,18,12,6,51,32,19,66
Hibernian,3691,2,16,16,4,52,26,26,64
Dundee Utd,3691,3,16,9,11,50,41,9,57
Falkirk,3691,4,15,10,11,55,44,11,55
Queen of S't,3691,5,10,13,13,44,51,-7,43
Dumbarton,3691,6,9,13,14,46,52,-6,40
Raith,3691,7,9,13,14,34,44,-10,40
Dunfermline,3691,8,8,15,13,48,55,-7,39
St Mirren,3691,9,9,10,17,38,54,-16,37
Ayr,3691,10,8,13,15,34,53,-19,37
Hibernian,3692,1,17,14,5,54,28,26,65
Morton,3692,2,17,12,7,56,35,21,63
Falkirk,3692,3,15,12,9,57,40,17,57
Dundee Utd,3692,4,16,8,12,49,44,5,56
Queen of S't,3692,5,14,9,13,54,46,8,51
Dunfermline,3692,6,12,12,12,45,45,0,48
Raith,3692,7,11,9,16,35,49,-14,42
Dumbarton,3692,8,8,12,16,44,62,-18,36
Ayr,3692,9,7,12,17,35,56,-21,33
St Mirren,3692,10,7,12,17,36,60,-24,33
Hibernian,3693,1,18,11,7,56,28,28,65
Morton,3693,2,18,11,7,50,35,15,65
Falkirk,3693,3,17,9,10,62,44,18,60
Dundee Utd,3693,4,14,10,12,46,43,3,52
Queen of S't,3693,5,13,8,15,48,48,0,47
Dumbarton,3693,6,10,11,15,46,54,-8,41
Dunfermline,3693,7,9,13,14,44,49,-5,40
Ayr,3693,8,9,13,14,35,52,-17,40
Raith,3693,9,10,9,17,34,53,-19,39
St Mirren,3693,10,9,11,16,43,58,-15,38
Hibernian,3694,1,21,11,4,58,25,33,74
Morton,3694,2,17,11,8,50,36,14,62
Falkirk,3694,3,15,11,10,54,42,12,56
Dundee Utd,3694,4,14,10,12,47,41,6,52
Raith,3694,5,12,9,15,38,48,-10,45
Dunfermline,3694,6,9,14,13,46,48,-2,41
Queen of S't,3694,7,11,8,17,42,54,-12,41
Ayr,3694,8,9,12,15,40,56,-16,39
Dumbarton,3694,9,8,14,14,46,56,-10,38
St Mirren,3694,10,8,12,16,40,55,-15,36
Hibernian,3695,1,21,11,4,60,23,37,74
Morton,3695,2,16,12,8,49,35,14,60
Falkirk,3695,3,16,9,11,57,44,13,57
Dundee Utd,3695,4,16,9,11,47,40,7,57
Queen of S't,3695,5,14,8,14,50,51,-1,50
Raith,3695,6,11,8,17,37,51,-14,41
Dunfermline,3695,7,9,12,15,41,48,-7,39
St Mirren,3695,8,10,9,17,43,57,-14,39
Dumbarton,3695,9,9,11,16,51,60,-9,38
Ayr,3695,10,8,11,17,32,58,-26,35
Hibernian,3696,1,19,12,5,55,28,27,69
Morton,3696,2,16,12,8,50,36,14,60
Falkirk,3696,3,15,12,9,60,42,18,57
Dundee Utd,3696,4,15,11,10,51,41,10,56
Queen of S't,3696,5,14,8,14,46,47,-1,50
Dunfermline,3696,6,11,12,13,49,48,1,45
Dumbarton,3696,7,9,13,14,50,56,-6,40
Ayr,3696,8,7,15,14,34,53,-19,36
Raith,3696,9,9,8,19,34,58,-24,35
St Mirren,3696,10,7,13,16,40,60,-20,34
Hibernian,3697,1,20,12,4,59,26,33,72
Morton,3697,2,17,13,6,50,35,15,64
Falkirk,3697,3,16,10,10,60,42,18,58
Dundee Utd,3697,4,14,10,12,47,41,6,52
Dunfermline,3697,5,11,12,13,47,49,-2,45
Ayr,3697,6,11,10,15,38,50,-12,43
Raith,3697,7,11,9,16,38,52,-14,42
Queen of S't,3697,8,10,9,17,42,57,-15,39
Dumbarton,3697,9,9,10,17,46,58,-12,37
St Mirren,3697,10,8,11,17,40,57,-17,35
Hibernian,3698,1,18,13,5,55,28,27,67
Falkirk,3698,2,17,11,8,60,39,21,62
Dundee Utd,3698,3,15,12,9,50,39,11,57
Morton,3698,4,15,11,10,47,38,9,56
Queen of S't,3698,5,14,9,13,46,46,0,51
Dunfermline,3698,6,11,12,13,48,48,0,45
Dumbarton,3698,7,9,12,15,47,57,-10,39
Raith,3698,8,10,9,17,35,54,-19,39
St Mirren,3698,9,9,9,18,43,56,-13,36
Ayr,3698,10,7,12,17,28,54,-26,33
Hibernian,3699,1,20,13,3,56,19,37,73
Morton,3699,2,16,10,10,47,37,10,58
Dundee Utd,3699,3,16,9,11,53,40,13,57
Falkirk,3699,4,14,10,12,52,47,5,52
Dunfermline,3699,5,10,14,12,40,42,-2,44
Queen of S't,3699,6,11,11,14,44,47,-3,44
Raith,3699,7,11,10,15,33,46,-13,43
Dumbarton,3699,8,10,12,14,49,53,-4,42
Ayr,3699,9,8,13,15,32,58,-26,37
St Mirren,3699,10,8,10,18,37,54,-17,34
Hibernian,3700,1,17,15,4,55,28,27,66
Dundee Utd,3700,2,16,12,8,56,39,17,60
Falkirk,3700,3,16,10,10,58,42,16,58
Morton,3700,4,14,15,7,49,40,9,57
Queen of S't,3700,5,11,11,14,44,48,-4,44
Raith,3700,6,11,11,14,36,45,-9,44
Dumbarton,3700,7,9,11,16,50,59,-9,38
St Mirren,3700,8,9,11,16,44,60,-16,38
Dunfermline,3700,9,8,13,15,43,53,-10,37
Ayr,3700,10,8,13,15,37,58,-21,37
Hibernian,3701,1,18,12,6,51,26,25,66
Morton,3701,2,17,12,7,54,37,17,63
Dundee Utd,3701,3,17,9,10,57,42,15,60
Falkirk,3701,4,15,10,11,55,44,11,55
Dunfermline,3701,5,11,13,12,50,48,2,46
St Mirren,3701,6,11,9,16,43,57,-14,42
Raith,3701,7,11,9,16,35,49,-14,42
Dumbarton,3701,8,10,10,16,50,56,-6,40
Queen of S't,3701,9,10,8,18,41,55,-14,38
Ayr,3701,10,8,12,16,31,53,-22,36
Hibernian,3702,1,17,14,5,61,29,32,65
Falkirk,3702,2,18,10,8,59,39,20,64
Morton,3702,3,16,13,7,51,40,11,61
Dundee Utd,3702,4,15,9,12,49,40,9,54
Queen of S't,3702,5,14,8,14,48,49,-1,50
Dunfermline,3702,6,10,13,13,49,49,0,43
St Mirren,3702,7,10,10,16,46,58,-12,40
Ayr,3702,8,9,12,15,36,57,-21,39
Dumbarton,3702,9,8,11,17,43,60,-17,35
Raith,3702,10,9,8,19,31,52,-21,35
Hibernian,3703,1,17,15,4,54,26,28,66
Morton,3703,2,17,12,7,56,39,17,63
Falkirk,3703,3,16,12,8,56,36,20,60
Dundee Utd,3703,4,15,10,11,50,43,7,55
Queen of S't,3703,5,12,10,14,50,48,2,46
Ayr,3703,6,9,14,13,39,54,-15,41
St Mirren,3703,7,9,11,16,39,53,-14,38
Dunfermline,3703,8,7,16,13,47,54,-7,37
Dumbarton,3703,9,8,12,16,43,62,-19,36
Raith,3703,10,8,12,16,31,50,-19,36
Hibernian,3704,1,18,11,7,55,29,26,65
Morton,3704,2,18,10,8,54,35,19,64
Dundee Utd,3704,3,18,9,9,59,41,18,63
Falkirk,3704,4,16,11,9,53,36,17,59
Queen of S't,3704,5,11,11,14,45,52,-7,44
Dumbarton,3704,6,10,11,15,47,54,-7,41
Dunfermline,3704,7,9,12,15,43,52,-9,39
Raith,3704,8,10,9,17,36,52,-16,39
St Mirren,3704,9,9,10,17,39,55,-16,37
Ayr,3704,10,7,14,15,32,57,-25,35
Hibernian,3705,1,19,12,5,53,24,29,69
Morton,3705,2,19,10,7,50,33,17,67
Falkirk,3705,3,17,10,9,64,42,22,61
Dundee Utd,3705,4,15,10,11,48,40,8,55
Ayr,3705,5,10,12,14,35,50,-15,42
Dunfermline,3705,6,9,13,14,44,52,-8,40
Queen of S't,3705,7,9,11,16,44,55,-11,38
Raith,3705,8,9,11,16,37,51,-14,38
Dumbarton,3705,9,8,13,15,45,57,-12,37
St Mirren,3705,10,9,10,17,43,59,-16,37
Morton,3706,1,18,11,7,50,34,16,65
Hibernian,3706,2,17,13,6,51,29,22,64
Falkirk,3706,3,17,12,7,60,35,25,63
Dundee Utd,3706,4,15,12,9,50,40,10,57
Raith,3706,5,11,12,13,36,42,-6,45
Dunfermline,3706,6,9,14,13,47,49,-2,41
Queen of S't,3706,7,10,11,15,47,53,-6,41
Ayr,3706,8,8,11,17,38,64,-26,35
St Mirren,3706,9,7,13,16,34,50,-16,34
Dumbarton,3706,10,7,13,16,45,62,-17,34
Hibernian,3707,1,21,11,4,64,27,37,74
Morton,3707,2,18,9,9,56,37,19,63
Dundee Utd,3707,3,16,10,10,48,38,10,58
Falkirk,3707,4,14,10,12,55,46,9,52
Dunfermline,3707,5,11,12,13,48,54,-6,45
Dumbarton,3707,6,10,13,13,49,52,-3,43
Queen of S't,3707,7,10,11,15,42,49,-7,41
Raith,3707,8,9,11,16,32,50,-18,38
Ayr,3707,9,8,12,16,35,59,-24,36
St Mirren,3707,10,8,11,17,38,55,-17,35
Morton,3708,1,20,10,6,53,31,22,70
Hibernian,3708,2,18,12,6,54,27,27,66
Dundee Utd,3708,3,18,10,8,53,36,17,64
Falkirk,3708,4,18,9,9,65,38,27,63
Dumbarton,3708,5,10,10,16,45,57,-12,40
Dunfermline,3708,6,9,12,15,43,52,-9,39
Queen of S't,3708,7,9,10,17,40,55,-15,37
St Mirren,3708,8,9,10,17,38,56,-18,37
Ayr,3708,9,8,12,16,33,52,-19,36
Raith,3708,10,9,9,18,34,54,-20,36
Hibernian,3709,1,22,11,3,62,23,39,77
Morton,3709,2,16,13,7,51,37,14,61
Falkirk,3709,3,16,11,9,58,41,17,59
Dundee Utd,3709,4,16,10,10,54,42,12,58
Queen of S't,3709,5,13,9,14,47,51,-4,48
Dumbarton,3709,6,10,11,15,49,61,-12,41
Raith,3709,7,10,8,18,35,52,-17,38
St Mirren,3709,8,9,10,17,45,58,-13,37
Dunfermline,3709,9,7,15,14,40,50,-10,36
Ayr,3709,10,7,10,19,29,55,-26,31
Hibernian,3710,1,18,14,4,64,27,37,68
Morton,3710,2,15,13,8,46,36,10,58
Dundee Utd,3710,3,16,9,11,50,35,15,57
Falkirk,3710,4,15,11,10,57,42,15,56
Queen of S't,3710,5,13,9,14,50,53,-3,48
Raith,3710,6,11,11,14,39,46,-7,44
Dunfermline,3710,7,10,13,13,44,50,-6,43
Dumbarton,3710,8,10,11,15,45,55,-10,41
Ayr,3710,9,9,10,17,33,55,-22,37
St Mirren,3710,10,7,11,18,35,64,-29,32
Hibernian,3711,1,18,14,4,55,28,27,68
Morton,3711,2,16,13,7,51,36,15,61
Falkirk,3711,3,16,10,10,60,38,22,58
Dundee Utd,3711,4,15,11,10,47,37,10,56
Dumbarton,3711,5,11,10,15,49,56,-7,43
Queen of S't,3711,6,11,10,15,41,50,-9,43
Dunfermline,3711,7,9,13,14,45,52,-7,40
Raith,3711,8,10,10,16,38,51,-13,40
St Mirren,3711,9,9,10,17,40,58,-18,37
Ayr,3711,10,7,15,14,30,50,-20,36
Hibernian,3712,1,19,13,4,57,28,29,70
Falkirk,3712,2,17,11,8,61,42,19,62
Morton,3712,3,16,14,6,53,36,17,62
Dundee Utd,3712,4,16,12,8,56,40,16,60
Queen of S't,3712,5,12,9,15,51,53,-2,45
Raith,3712,6,11,10,15,37,48,-11,43
Dunfermline,3712,7,7,14,15,42,51,-9,35
Dumbarton,3712,8,8,11,17,45,63,-18,35
St Mirren,3712,9,7,13,16,43,58,-15,34
Ayr,3712,10,7,13,16,34,60,-26,34
Hibernian,3713,1,20,13,3,58,26,32,73
Falkirk,3713,2,17,10,9,61,40,21,61
Morton,3713,3,17,10,9,55,37,18,61
Dundee Utd,3713,4,16,9,11,53,44,9,57
Queen of S't,3713,5,13,8,15,46,50,-4,47
Dunfermline,3713,6,11,12,13,48,51,-3,45
Raith,3713,7,10,9,17,37,56,-19,39
Ayr,3713,8,9,11,16,39,57,-18,38
Dumbarton,3713,9,9,10,17,46,60,-14,37
St Mirren,3713,10,7,10,19,38,60,-22,31
Hibernian,3714,1,19,14,3,55,24,31,71
Morton,3714,2,17,13,6,51,38,13,64
Falkirk,3714,3,15,12,9,60,44,16,57
Dundee Utd,3714,4,15,10,11,49,40,9,55
Queen of S't,3714,5,14,9,13,51,48,3,51
Dumbarton,3714,6,10,10,16,50,67,-17,40
Raith,3714,7,9,11,16,31,47,-16,38
Dunfermline,3714,8,7,16,13,47,54,-7,37
Ayr,3714,9,8,13,15,36,50,-14,37
St Mirren,3714,10,7,10,19,39,57,-18,31
Hibernian,3715,1,18,14,4,54,28,26,68
Morton,3715,2,16,13,7,49,35,14,61
Falkirk,3715,3,15,12,9,57,41,16,57
Dundee Utd,3715,4,13,10,13,49,47,2,49
Dunfermline,3715,5,11,13,12,46,43,3,46
Queen of S't,3715,6,12,9,15,47,48,-1,45
Raith,3715,7,10,12,14,35,46,-11,42
Dumbarton,3715,8,10,10,16,45,58,-13,40
Ayr,3715,9,9,11,16,37,59,-22,38
St Mirren,3715,10,8,12,16,39,53,-14,36
Hibernian,3716,1,21,11,4,58,22,36,74
Falkirk,3716,2,16,11,9,56,40,16,59
Dundee Utd,3716,3,15,11,10,50,40,10,56
Morton,3716,4,14,13,9,43,35,8,55
Dumbarton,3716,5,12,11,13,49,54,-5,47
Queen of S't,3716,6,12,9,15,43,48,-5,45
Dunfermline,3716,7,9,14,13,46,53,-7,41
Raith,3716,8,10,8,18,32,51,-19,38
St Mirren,3716,9,9,10,17,42,53,-11,37
Ayr,3716,10,7,12,17,33,56,-23,33
Hibernian,3717,1,21,10,5,58,26,32,73
Morton,3717,2,17,13,6,54,34,20,64
Falkirk,3717,3,16,12,8,58,38,20,60
Dundee Utd,3717,4,14,12,10,48,41,7,54
Queen of S't,3717,5,12,10,14,45,48,-3,46
Ayr,3717,6,10,10,16,40,58,-18,40
Dumbarton,3717,7,8,14,14,44,55,-11,38
Raith,3717,8,9,10,17,31,47,-16,37
Dunfermline,3717,9,7,15,14,43,53,-10,36
St Mirren,3717,10,8,10,18,36,57,-21,34
Hibernian,3718,1,18,13,5,52,24,28,67
Morton,3718,2,15,14,7,48,39,9,59
Falkirk,3718,3,16,9,11,57,42,15,57
Dundee Utd,3718,4,16,8,12,51,42,9,56
Dunfermline,3718,5,13,12,11,49,44,5,51
Dumbarton,3718,6,11,11,14,50,58,-8,44
Raith,3718,7,10,11,15,34,46,-12,41
Queen of S't,3718,8,10,10,16,42,52,-10,40
St Mirren,3718,9,8,11,17,45,57,-12,35
Ayr,3718,10,8,11,17,31,55,-24,35
Hibernian,3719,1,17,13,6,52,27,25,64
Morton,3719,2,17,13,6,47,32,15,64
Dundee Utd,3719,3,17,8,11,49,43,6,59
Falkirk,3719,4,15,11,10,56,44,12,56
Dunfermline,3719,5,11,13,12,46,43,3,46
Queen of S't,3719,6,11,11,14,47,53,-6,44
St Mirren,3719,7,10,9,17,41,53,-12,39
Ayr,3719,8,9,11,16,38,53,-15,38
Raith,3719,9,9,11,16,32,48,-16,38
Dumbarton,3719,10,8,12,16,43,55,-12,36
Hibernian,3720,1,19,12,5,53,24,29,69
Falkirk,3720,2,17,10,9,60,37,23,61
Morton,3720,3,16,12,8,50,38,12,60
Dundee Utd,3720,4,17,8,11,52,40,12,59
Dunfermline,3720,5,13,11,12,47,46,1,50
Queen of S't,3720,6,11,10,15,46,50,-4,43
Raith,3720,7,10,11,15,36,48,-12,41
Dumbarton,3720,8,8,11,17,47,62,-15,35
St Mirren,3720,9,7,12,17,36,57,-21,33
Ayr,3720,10,6,15,15,34,59,-25,33
Hibernian,3721,1,19,12,5,57,25,32,69
Dundee Utd,3721,2,18,9,9,61,39,22,63
Morton,3721,3,17,9,10,51,40,11,60
Falkirk,3721,4,16,10,10,60,42,18,58
Raith,3721,5,13,8,15,37,49,-12,47
Queen of S't,3721,6,11,9,16,46,55,-9,42
Dunfermline,3721,7,9,13,14,45,50,-5,40
St Mirren,3721,8,10,9,17,41,60,-19,39
Dumbarton,3721,9,8,12,16,46,60,-14,36
Ayr,3721,10,7,13,16,31,55,-24,34
Hibernian,3722,1,20,12,4,55,25,30,72
Falkirk,3722,2,17,10,9,58,40,18,61
Morton,3722,3,15,13,8,49,39,10,58
Dundee Utd,3722,4,15,10,11,51,42,9,55
Queen of S't,3722,5,12,10,14,46,48,-2,46
Dunfermline,3722,6,11,11,14,50,47,3,44
Raith,3722,7,10,10,16,38,58,-20,40
Ayr,3722,8,8,14,14,38,55,-17,38
Dumbarton,3722,9,8,12,16,46,60,-14,36
St Mirren,3722,10,7,12,17,39,56,-17,33
Hibernian,3723,1,17,13,6,54,28,26,64
Morton,3723,2,15,14,7,51,40,11,59
Dundee Utd,3723,3,16,11,9,53,43,10,59
Falkirk,3723,4,13,14,9,56,45,11,53
Queen of S't,3723,5,13,11,12,45,41,4,50
St Mirren,3723,6,10,10,16,48,57,-9,40
Dumbarton,3723,7,10,10,16,49,60,-11,40
Dunfermline,3723,8,8,15,13,45,51,-6,39
Ayr,3723,9,8,14,14,38,56,-18,38
Raith,3723,10,8,12,16,34,52,-18,36
Hibernian,3724,1,20,12,4,54,22,32,72
Falkirk,3724,2,17,10,9,57,38,19,61
Morton,3724,3,15,14,7,47,35,12,59
Dundee Utd,3724,4,15,10,11,44,37,7,55
Queen of S't,3724,5,11,11,14,46,50,-4,44
Dunfermline,3724,6,10,13,13,44,48,-4,43
Raith,3724,7,11,9,16,35,47,-12,42
Dumbarton,3724,8,8,13,15,44,54,-10,37
Ayr,3724,9,7,14,15,31,53,-22,35
St Mirren,3724,10,7,12,17,36,54,-18,33
Hibernian,3725,1,19,13,4,62,28,34,70
Morton,3725,2,16,11,9,49,37,12,59
Dundee Utd,3725,3,16,10,10,49,42,7,58
Falkirk,3725,4,16,9,11,61,41,20,57
Queen of S't,3725,5,13,8,15,48,49,-1,47
Dunfermline,3725,6,10,15,11,48,49,-1,45
Dumbarton,3725,7,10,11,15,48,59,-11,41
Raith,3725,8,11,8,17,34,54,-20,41
Ayr,3725,9,10,10,16,32,51,-19,40
St Mirren,3725,10,6,11,19,40,61,-21,29
Hibernian,3726,1,21,12,3,55,22,33,75
Morton,3726,2,16,11,9,50,42,8,59
Falkirk,3726,3,16,9,11,54,39,15,57
Dundee Utd,3726,4,14,11,11,48,48,0,53
Dunfermline,3726,5,11,14,11,48,46,2,47
Queen of S't,3726,6,13,8,15,48,50,-2,47
Raith,3726,7,10,9,17,34,50,-16,39
St Mirren,3726,8,9,10,17,43,53,-10,37
Dumbarton,3726,9,8,12,16,49,61,-12,36
Ayr,3726,10,8,12,16,36,54,-18,36
Hibernian,3727,1,16,13,7,53,30,23,61
Morton,3727,2,16,13,7,52,35,17,61
Falkirk,3727,3,16,11,9,57,38,19,59
Dundee Utd,3727,4,16,9,11,51,40,11,57
Queen of S't,3727,5,14,8,14,53,49,4,50
Dunfermline,3727,6,11,12,13,48,53,-5,45
Dumbarton,3727,7,9,12,15,49,55,-6,39
Raith,3727,8,10,9,17,35,53,-18,39
St Mirren,3727,9,9,11,16,38,60,-22,38
Ayr,3727,10,8,12,16,32,55,-23,36
Hibernian,3728,1,20,11,5,60,26,34,71
Falkirk,3728,2,17,10,9,58,41,17,61
Dundee Utd,3728,3,17,10,9,51,37,14,61
Morton,3728,4,15,12,9,49,39,10,57
Dumbarton,3728,5,12,10,14,49,53,-4,46
Dunfermline,3728,6,10,13,13,47,52,-5,43
Queen of S't,3728,7,10,10,16,43,52,-9,40
Ayr,3728,8,10,10,16,34,54,-20,40
Raith,3728,9,9,10,17,33,49,-16,37
St Mirren,3728,10,7,10,19,36,57,-21,31
Hibernian,3729,1,20,13,3,58,23,35,73
Falkirk,3729,2,17,11,8,58,37,21,62
Dundee Utd,3729,3,17,9,10,52,38,14,60
Morton,3729,4,15,12,9,48,39,9,57
Dunfermline,3729,5,11,12,13,45,49,-4,45
Queen of S't,3729,6,10,11,15,42,48,-6,41
Ayr,3729,7,9,13,14,43,56,-13,40
Raith,3729,8,9,11,16,31,48,-17,38
Dumbarton,3729,9,8,13,15,46,57,-11,37
St Mirren,3729,10,6,11,19,35,63,-28,29
Hibernian,3730,1,20,12,4,56,25,31,72
Falkirk,3730,2,16,10,10,60,41,19,58
Dundee Utd,3730,3,16,10,10,46,35,11,58
Morton,3730,4,16,10,10,47,37,10,58
Queen of S't,3730,5,12,11,13,45,48,-3,47
Dunfermline,3730,6,11,13,12,47,45,2,46
St Mirren,3730,7,10,10,16,41,55,-14,40
Raith,3730,8,10,9,17,36,52,-16,39
Ayr,3730,9,8,13,15,35,56,-21,37
Dumbarton,3730,10,7,10,19,42,61,-19,31
Hibernian,3731,1,18,13,5,54,25,29,67
Morton,3731,2,18,12,6,54,34,20,66
Dundee Utd,3731,3,18,9,9,56,38,18,63
Falkirk,3731,4,15,10,11,57,40,17,55
Dumbarton,3731,5,10,12,14,52,62,-10,42
Queen of S't,3731,6,10,11,15,45,52,-7,41
Dunfermline,3731,7,9,13,14,43,49,-6,40
St Mirren,3731,8,9,11,16,40,54,-14,38
Raith,3731,9,9,10,17,31,54,-23,37
Ayr,3731,10,8,11,17,33,57,-24,35
Hibernian,3732,1,20,11,5,59,26,33,71
Morton,3732,2,16,12,8,58,40,18,60
Falkirk,3732,3,15,12,9,57,40,17,57
Dunfermline,3732,4,12,13,11,50,45,5,49
Dundee Utd,3732,5,13,9,14,44,51,-7,48
Queen of S't,3732,6,12,11,13,49,52,-3,47
St Mirren,3732,7,11,10,15,45,52,-7,43
Raith,3732,8,10,9,17,39,51,-12,39
Ayr,3732,9,8,12,16,33,60,-27,36
Dumbarton,3732,10,8,11,17,45,62,-17,35
Hibernian,3733,1,21,11,4,60,23,37,74
Morton,3733,2,17,10,9,47,36,11,61
Dundee Utd,3733,3,16,9,11,45,38,7,57
Falkirk,3733,4,15,11,10,58,42,16,56
Raith,3733,5,12,9,15,42,50,-8,45
Queen of S't,3733,6,12,8,16,43,51,-8,44
Dunfermline,3733,7,8,15,13,44,48,-4,39
Dumbarton,3733,8,8,14,14,47,56,-9,38
St Mirren,3733,9,8,12,16,37,54,-17,36
Ayr,3733,10,7,13,16,32,57,-25,34
Hibernian,3734,1,20,12,4,58,25,33,72
Morton,3734,2,19,11,6,48,31,17,68
Falkirk,3734,3,16,11,9,61,41,20,59
Dundee Utd,3734,4,15,11,10,52,43,9,56
Queen of S't,3734,5,12,9,15,45,51,-6,45
Dumbarton,3734,6,10,10,16,54,59,-5,40
Raith,3734,7,10,9,17,37,54,-17,39
Dunfermline,3734,8,8,13,15,43,51,-8,37
St Mirren,3734,9,8,11,17,41,58,-17,35
Ayr,3734,10,8,11,17,33,59,-26,35
Hibernian,3735,1,21,11,4,60,25,35,74
Morton,3735,2,18,11,7,51,36,15,65
Falkirk,3735,3,17,11,8,62,40,22,62
Dundee Utd,3735,4,14,13,9,48,38,10,55
Queen of S't,3735,5,11,10,15,42,49,-7,43
Dunfermline,3735,6,9,13,14,45,52,-7,40
Dumbarton,3735,7,8,15,13,50,57,-7,39
Ayr,3735,8,6,16,14,35,55,-20,34
Raith,3735,9,8,10,18,34,58,-24,34
St Mirren,3735,10,7,12,17,40,57,-17,33
Hibernian,3736,1,19,12,5,57,27,30,69
Falkirk,3736,2,17,11,8,61,40,21,62
Morton,3736,3,15,13,8,50,40,10,58
Dundee Utd,3736,4,14,11,11,51,44,7,53
Queen of S't,3736,5,11,9,16,44,54,-10,42
Raith,3736,6,11,9,16,34,50,-16,42
Dunfermline,3736,7,9,13,14,44,51,-7,40
St Mirren,3736,8,9,13,14,44,52,-8,40
Ayr,3736,9,9,12,15,37,55,-18,39
Dumbarton,3736,10,8,13,15,49,58,-9,37
Hibernian,3737,1,20,11,5,61,26,35,71
Falkirk,3737,2,17,9,10,59,43,16,60
Dundee Utd,3737,3,16,10,10,51,42,9,58
Morton,3737,4,14,14,8,45,38,7,56
Dunfermline,3737,5,13,12,11,52,43,9,51
Queen of S't,3737,6,10,10,16,43,51,-8,40
Dumbarton,3737,7,9,12,15,48,56,-8,39
Raith,3737,8,10,8,18,31,54,-23,38
St Mirren,3737,9,9,10,17,43,55,-12,37
Ayr,3737,10,8,12,16,32,57,-25,36
Hibernian,3738,1,18,14,4,58,27,31,68
Morton,3738,2,18,12,6,53,34,19,66
Falkirk,3738,3,16,11,9,62,45,17,59
Dundee Utd,3738,4,15,9,12,48,38,10,54
Dunfermline,3738,5,10,15,11,45,45,0,45
Queen of S't,3738,6,11,9,16,42,51,-9,42
Ayr,3738,7,10,12,14,31,50,-19,42
St Mirren,3738,8,9,10,17,40,54,-14,37
Raith,3738,9,9,9,18,32,50,-18,36
Dumbarton,3738,10,8,11,17,47,64,-17,35
Hibernian,3739,1,18,12,6,53,29,24,66
Morton,3739,2,17,12,7,50,34,16,63
Dundee Utd,3739,3,15,10,11,50,42,8,55
Falkirk,3739,4,13,12,11,58,49,9,51
Dunfermline,3739,5,12,14,10,55,44,11,50
Queen of S't,3739,6,12,11,13,49,51,-2,47
Ayr,3739,7,10,11,15,33,49,-16,41
Dumbarton,3739,8,9,12,15,50,61,-11,39
Raith,3739,9,10,9,17,32,50,-18,39
St Mirren,3739,10,7,11,18,39,60,-21,32
Hibernian,3740,1,18,11,7,55,30,25,65
Falkirk,3740,2,18,10,8,59,36,23,64
Morton,3740,3,18,10,8,58,36,22,64
Dundee Utd,3740,4,18,9,9,52,38,14,63
Dunfermline,3740,5,10,13,13,43,46,-3,43
Queen of S't,3740,6,11,9,16,44,54,-10,42
Raith,3740,7,11,8,17,36,56,-20,41
St Mirren,3740,8,9,10,17,44,57,-13,37
Dumbarton,3740,9,8,11,17,46,60,-14,35
Ayr,3740,10,8,11,17,34,58,-24,35
Hibernian,3741,1,19,14,3,54,24,30,71
Falkirk,3741,2,16,13,7,59,40,19,61
Morton,3741,3,14,14,8,45,34,11,56
Dundee Utd,3741,4,15,11,10,46,38,8,56
Dumbarton,3741,5,12,11,13,49,53,-4,47
Queen of S't,3741,6,11,8,17,46,52,-6,41
St Mirren,3741,7,9,12,15,40,53,-13,39
Dunfermline,3741,8,8,14,14,41,46,-5,38
Raith,3741,9,9,11,16,33,47,-14,38
Ayr,3741,10,7,12,17,32,58,-26,33
Hibernian,3742,1,17,16,3,53,25,28,67
Morton,3742,2,16,13,7,49,35,14,61
Falkirk,3742,3,16,10,10,60,44,16,58
Dundee Utd,3742,4,16,10,10,50,38,12,58
Raith,3742,5,11,12,13,38,47,-9,45
Dumbarton,3742,6,10,12,14,50,54,-4,42
Dunfermline,3742,7,8,15,13,42,51,-9,39
Queen of S't,3742,8,9,12,15,37,46,-9,39
Ayr,3742,9,9,12,15,33,53,-20,39
St Mirren,3742,10,7,10,19,41,60,-19,31
Hibernian,3743,1,20,11,5,56,28,28,71
Morton,3743,2,16,12,8,48,35,13,60
Falkirk,3743,3,16,10,10,58,41,17,58
Dundee Utd,3743,4,15,10,11,51,42,9,55
Dunfermline,3743,5,12,14,10,50,46,4,50
Queen of S't,3743,6,12,9,15,42,51,-9,45
Dumbarton,3743,7,10,10,16,51,58,-7,40
Raith,3743,8,10,9,17,38,53,-15,39
Ayr,3743,9,8,11,17,32,56,-24,35
St Mirren,3743,10,8,10,18,38,54,-16,34
Morton,3744,1,19,10,7,47,31,16,67
Hibernian,3744,2,18,12,6,53,29,24,66
Dundee Utd,3744,3,17,8,11,52,37,15,59
Falkirk,3744,4,16,10,10,61,46,15,58
Queen of S't,3744,5,12,10,14,51,51,0,46
Dumbarton,3744,6,10,13,13,54,57,-3,43
St Mirren,3744,7,10,10,16,41,56,-15,40
Dunfermline,3744,8,9,12,15,44,51,-7,39
Raith,3744,9,9,9,18,33,51,-18,36
Ayr,3744,10,8,10,18,33,60,-27,34
Hibernian,3745,1,19,12,5,55,25,30,69
Morton,3745,2,16,12,8,48,37,11,60
Falkirk,3745,3,16,10,10,57,45,12,58
Dundee Utd,3745,4,16,9,11,53,45,8,57
Queen of S't,3745,5,13,10,13,53,48,5,49
Dunfermline,3745,6,10,13,13,46,46,0,43
Dumbarton,3745,7,9,11,16,45,63,-18,38
Ayr,3745,8,9,11,16,34,52,-18,38
St Mirren,3745,9,9,10,17,39,54,-15,37
Raith,3745,10,9,10,17,35,50,-15,37
Hibernian,3746,1,19,12,5,55,26,29,69
Morton,3746,2,18,11,7,56,39,17,65
Dundee Utd,3746,3,16,9,11,52,43,9,57
Falkirk,3746,4,15,11,10,55,42,13,56
Queen of S't,3746,5,13,8,15,49,52,-3,47
Dunfermline,3746,6,11,11,14,47,49,-2,44
St Mirren,3746,7,10,10,16,45,53,-8,40
Dumbarton,3746,8,8,12,16,50,63,-13,36
Raith,3746,9,8,12,16,31,48,-17,36
Ayr,3746,10,8,12,16,36,61,-25,36
Hibernian,3747,1,19,13,4,55,25,30,70
Dundee Utd,3747,2,17,9,10,52,40,12,60
Morton,3747,3,15,10,11,50,42,8,55
Falkirk,3747,4,14,12,10,54,38,16,54
Queen of S't,3747,5,13,8,15,45,48,-3,47
Dunfermline,3747,6,10,12,14,43,45,-2,42
Raith,3747,7,11,9,16,33,49,-16,42
Ayr,3747,8,9,13,14,34,50,-16,40
Dumbarton,3747,9,9,11,16,46,60,-14,38
St Mirren,3747,10,9,11,16,40,55,-15,38
Hibernian,3748,1,20,11,5,58,24,34,71
Morton,3748,2,18,12,6,54,34,20,66
Falkirk,3748,3,16,9,11,60,45,15,57
Dundee Utd,3748,4,15,10,11,48,43,5,55
Queen of S't,3748,5,14,9,13,43,43,0,51
Dumbarton,3748,6,10,10,16,47,58,-11,40
Raith,3748,7,10,9,17,36,52,-16,39
Dunfermline,3748,8,8,14,14,49,55,-6,38
St Mirren,3748,9,9,11,16,38,53,-15,38
Ayr,3748,10,6,13,17,28,54,-26,31
Hibernian,3749,1,19,12,5,58,28,30,69
Morton,3749,2,17,11,8,52,37,15,62
Falkirk,3749,3,17,10,9,62,42,20,61
Dundee Utd,3749,4,17,10,9,56,38,18,61
Dunfermline,3749,5,12,12,12,52,48,4,48
Queen of S't,3749,6,10,11,15,44,50,-6,41
Raith,3749,7,9,10,17,36,57,-21,37
Dumbarton,3749,8,8,12,16,46,60,-14,36
St Mirren,3749,9,9,9,18,36,59,-23,36
Ayr,3749,10,7,13,16,32,55,-23,34
Hibernian,3750,1,21,11,4,59,27,32,74
Morton,3750,2,17,10,9,50,40,10,61
Falkirk,3750,3,16,11,9,53,37,16,59
Dundee Utd,3750,4,17,8,11,54,41,13,59
Dunfermline,3750,5,11,12,13,46,44,2,45
Raith,3750,6,11,9,16,34,45,-11,42
Queen of S't,3750,7,10,11,15,41,49,-8,41
Dumbarton,3750,8,8,13,15,44,58,-14,37
Ayr,3750,9,7,14,15,35,55,-20,35
St Mirren,3750,10,6,13,17,38,58,-20,31
Hibernian,3751,1,19,12,5,58,26,32,69
Falkirk,3751,2,15,12,9,59,41,18,57
Dundee Utd,3751,3,16,9,11,49,38,11,57
Morton,3751,4,15,11,10,53,44,9,56
Queen of S't,3751,5,13,10,13,48,51,-3,49
Dumbarton,3751,6,10,12,14,49,57,-8,42
Dunfermline,3751,7,9,14,13,47,51,-4,41
Raith,3751,8,10,10,16,35,50,-15,40
Ayr,3751,9,8,13,15,32,56,-24,37
St Mirren,3751,10,8,11,17,40,56,-16,35
Hibernian,3752,1,19,14,3,54,21,33,71
Falkirk,3752,2,16,12,8,61,42,19,60
Morton,3752,3,16,11,9,50,42,8,59
Dundee Utd,3752,4,14,11,11,51,45,6,53
Queen of S't,3752,5,12,10,14,44,49,-5,46
Dumbarton,3752,6,11,10,15,55,57,-2,43
Dunfermline,3752,7,9,14,13,43,45,-2,41
Ayr,3752,8,8,14,14,35,57,-22,38
Raith,3752,9,8,11,17,35,53,-18,35
St Mirren,3752,10,7,13,16,42,59,-17,34
Hibernian,3753,1,19,12,5,57,25,32,69
Dundee Utd,3753,2,17,10,9,52,37,15,61
Falkirk,3753,3,16,11,9,57,41,16,59
Morton,3753,4,15,11,10,46,38,8,56
Dunfermline,3753,5,11,12,13,46,46,0,45
Dumbarton,3753,6,11,10,15,51,61,-10,43
Queen of S't,3753,7,11,9,16,44,54,-10,42
St Mirren,3753,8,10,10,16,46,56,-10,40
Raith,3753,9,9,9,18,32,52,-20,36
Ayr,3753,10,8,12,16,36,57,-21,36
Hibernian,3754,1,18,12,6,53,27,26,66
Morton,3754,2,17,12,7,53,37,16,63
Falkirk,3754,3,14,13,9,54,41,13,55
Dundee Utd,3754,4,13,11,12,43,40,3,50
Dunfermline,3754,5,12,11,13,47,46,1,47
Queen of S't,3754,6,12,9,15,46,50,-4,45
Raith,3754,7,10,11,15,40,50,-10,41
Ayr,3754,8,10,11,15,33,56,-23,41
St Mirren,3754,9,9,11,16,43,54,-11,38
Dumbarton,3754,10,8,13,15,46,57,-11,37
Hibernian,3755,1,18,13,5,55,26,29,67
Falkirk,3755,2,17,10,9,57,38,19,61
Morton,3755,3,16,11,9,50,41,9,59
Dundee Utd,3755,4,16,10,10,51,40,11,58
Dunfermline,3755,5,13,11,12,54,51,3,50
Queen of S't,3755,6,12,11,13,45,46,-1,47
Raith,3755,7,11,10,15,38,49,-11,43
Dumbarton,3755,8,9,10,17,51,56,-5,37
St Mirren,3755,9,7,11,18,37,65,-28,32
Ayr,3755,10,6,13,17,31,57,-26,31
Hibernian,3756,1,18,14,4,53,28,25,68
Morton,3756,2,19,11,6,57,37,20,68
Falkirk,3756,3,15,12,9,59,42,17,57
Dundee Utd,3756,4,15,10,11,50,38,12,55
Queen of S't,3756,5,13,9,14,45,48,-3,48
St Mirren,3756,6,9,12,15,46,55,-9,39
Dunfermline,3756,7,9,12,15,44,53,-9,39
Ayr,3756,8,9,11,16,34,52,-18,38
Dumbarton,3756,9,9,10,17,47,60,-13,37
Raith,3756,10,9,9,18,31,53,-22,36
Hibernian,3757,1,18,14,4,58,27,31,68
Morton,3757,2,18,10,8,53,36,17,64
Falkirk,3757,3,17,9,10,60,45,15,60
Dundee Utd,3757,4,16,8,12,46,46,0,56
Dunfermline,3757,5,12,12,12,54,51,3,48
Queen of S't,3757,6,11,11,14,44,48,-4,44
Dumbarton,3757,7,9,12,15,47,57,-10,39
Raith,3757,8,9,10,17,33,48,-15,37
Ayr,3757,9,8,12,16,35,55,-20,36
St Mirren,3757,10,7,12,17,37,54,-17,33
Hibernian,3758,1,18,14,4,54,25,29,68
Falkirk,3758,2,17,10,9,62,42,20,61
Morton,3758,3,15,13,8,46,35,11,58
Dundee Utd,3758,4,13,11,12,45,44,1,50
Queen of S't,3758,5,11,12,13,44,46,-2,45
Raith,3758,6,12,9,15,37,45,-8,45
Dumbarton,3758,7,11,10,15,50,57,-7,43
Ayr,3758,8,9,14,13,36,51,-15,41
Dunfermline,3758,9,9,13,14,46,53,-7,40
St Mirren,3758,10,7,10,19,38,60,-22,31
Hibernian,3759,1,19,12,5,56,25,31,69
Falkirk,3759,2,17,11,8,58,37,21,62
Dundee Utd,3759,3,17,10,9,52,40,12,61
Morton,3759,4,16,11,9,46,35,11,59
Dunfermline,3759,5,11,11,14,44,47,-3,44
Queen of S't,3759,6,11,9,16,47,58,-11,42
Raith,3759,7,10,9,17,32,49,-17,39
St Mirren,3759,8,9,11,16,42,54,-12,38
Dumbarton,3759,9,8,12,16,48,63,-15,36
Ayr,3759,10,8,12,16,42,59,-17,36
Hibernian,3760,1,19,12,5,57,28,29,69
Morton,3760,2,17,10,9,50,39,11,61
Falkirk,3760,3,16,10,10,61,44,17,58
Dundee Utd,3760,4,16,9,11,53,41,12,57
Dunfermline,3760,5,13,11,12,54,49,5,50
Queen of S't,3760,6,11,10,15,45,54,-9,43
Dumbarton,3760,7,9,12,15,50,59,-9,39
Raith,3760,8,10,9,17,36,52,-16,39
Ayr,3760,9,9,12,15,35,57,-22,39
St Mirren,3760,10,7,11,18,36,54,-18,32
Hibernian,3761,1,19,13,4,56,26,30,70
Falkirk,3761,2,17,11,8,58,41,17,62
Morton,3761,3,16,13,7,51,40,11,61
Dundee Utd,3761,4,15,10,11,52,42,10,55
Dunfermline,3761,5,10,13,13,52,50,2,43
Queen of S't,3761,6,11,9,16,45,52,-7,42
Ayr,3761,7,10,10,16,34,53,-19,40
Raith,3761,8,10,9,17,33,47,-14,39
Dumbarton,3761,9,9,11,16,48,61,-13,38
St Mirren,3761,10,9,9,18,39,56,-17,36
Hibernian,3762,1,19,13,4,56,26,30,70
Morton,3762,2,16,13,7,47,33,14,61
Falkirk,3762,3,15,11,10,56,43,13,56
Dundee Utd,3762,4,14,10,12,46,41,5,52
Queen of S't,3762,5,14,9,13,49,47,2,51
Dunfermline,3762,6,9,15,12,48,51,-3,42
Ayr,3762,7,9,12,15,36,54,-18,39
Dumbarton,3762,8,9,11,16,45,59,-14,38
St Mirren,3762,9,9,10,17,41,55,-14,37
Raith,3762,10,9,10,17,37,52,-15,37
Hibernian,3763,1,23,10,3,65,23,42,79
Falkirk,3763,2,15,11,10,53,39,14,56
Morton,3763,3,14,12,10,42,35,7,54
Dundee Utd,3763,4,13,12,11,46,42,4,51
Queen of S't,3763,5,14,8,14,46,52,-6,50
Dumbarton,3763,6,11,11,14,48,51,-3,44
Dunfermline,3763,7,9,14,13,45,47,-2,41
Raith,3763,8,10,10,16,36,49,-13,40
Ayr,3763,9,8,13,15,34,55,-21,37
St Mirren,3763,10,8,9,19,37,59,-22,33
Hibernian,3764,1,17,13,6,54,26,28,64
Falkirk,3764,2,18,9,9,60,43,17,63
Morton,3764,3,17,12,7,49,38,11,63
Dundee Utd,3764,4,14,11,11,49,41,8,53
Raith,3764,5,11,10,15,38,52,-14,43
Ayr,3764,6,10,12,14,40,54,-14,42
Queen of S't,3764,7,10,11,15,43,52,-9,41
Dunfermline,3764,8,9,12,15,46,50,-4,39
Dumbarton,3764,9,9,12,15,47,57,-10,39
St Mirren,3764,10,8,12,16,41,54,-13,36
Hibernian,3765,1,20,10,6,58,25,33,70
Morton,3765,2,17,13,6,49,34,15,64
Dundee Utd,3765,3,18,9,9,59,39,20,63
Falkirk,3765,4,16,11,9,58,39,19,59
Queen of S't,3765,5,12,10,14,56,59,-3,46
Dunfermline,3765,6,8,15,13,48,55,-7,39
Raith,3765,7,10,9,17,36,51,-15,39
Dumbarton,3765,8,8,13,15,49,64,-15,37
St Mirren,3765,9,8,11,17,37,55,-18,35
Ayr,3765,10,6,13,17,32,61,-29,31
Hibernian,3766,1,19,11,6,57,30,27,68
Falkirk,3766,2,17,11,8,61,41,20,62
Morton,3766,3,16,11,9,49,40,9,59
Dundee Utd,3766,4,15,11,10,46,37,9,56
Dunfermline,3766,5,9,16,11,48,47,1,43
Queen of S't,3766,6,11,10,15,46,51,-5,43
Raith,3766,7,11,10,15,37,48,-11,43
Dumbarton,3766,8,10,11,15,52,60,-8,41
Ayr,3766,9,8,11,17,36,58,-22,35
St Mirren,3766,10,8,10,18,41,61,-20,34
Hibernian,3767,1,21,11,4,58,25,33,74
Falkirk,3767,2,16,10,10,59,41,18,58
Dundee Utd,3767,3,16,10,10,48,36,12,58
Morton,3767,4,16,10,10,49,41,8,58
Ayr,3767,5,12,10,14,38,50,-12,46
Dumbarton,3767,6,10,12,14,51,60,-9,42
Queen of S't,3767,7,11,9,16,43,54,-11,42
Dunfermline,3767,8,8,15,13,45,50,-5,39
Raith,3767,9,10,8,18,37,50,-13,38
St Mirren,3767,10,8,9,19,37,58,-21,33
Hibernian,3768,1,18,13,5,56,28,28,67
Falkirk,3768,2,18,10,8,61,39,22,64
Dundee Utd,3768,3,18,9,9,55,37,18,63
Morton,3768,4,17,11,8,53,37,16,62
Dunfermline,3768,5,12,11,13,49,50,-1,47
Queen of S't,3768,6,10,10,16,45,50,-5,40
Dumbarton,3768,7,9,12,15,47,61,-14,39
Raith,3768,8,10,8,18,34,54,-20,38
St Mirren,3768,9,8,11,17,39,59,-20,35
Ayr,3768,10,6,13,17,29,53,-24,31
Hibernian,3769,1,18,13,5,52,26,26,67
Morton,3769,2,16,13,7,49,36,13,61
Falkirk,3769,3,16,12,8,63,44,19,60
Dundee Utd,3769,4,16,11,9,49,37,12,59
Raith,3769,5,11,10,15,37,49,-12,43
Dunfermline,3769,6,9,15,12,48,48,0,42
Queen of S't,3769,7,11,9,16,44,53,-9,42
Ayr,3769,8,9,13,14,35,51,-16,40
St Mirren,3769,9,8,11,17,36,52,-16,35
Dumbarton,3769,10,7,11,18,41,58,-17,32
Hibernian,3770,1,19,12,5,58,31,27,69
Dundee Utd,3770,2,19,9,8,54,37,17,66
Morton,3770,3,15,14,7,50,36,14,59
Falkirk,3770,4,15,12,9,55,39,16,57
Queen of S't,3770,5,12,8,16,47,52,-5,44
Dunfermline,3770,6,9,15,12,43,48,-5,42
Raith,3770,7,10,10,16,34,49,-15,40
Dumbarton,3770,8,9,12,15,46,58,-12,39
St Mirren,3770,9,8,12,16,43,56,-13,36
Ayr,3770,10,7,10,19,34,58,-24,31
Morton,3771,1,20,10,6,57,35,22,70
Hibernian,3771,2,18,11,7,55,27,28,65
Falkirk,3771,3,17,9,10,57,39,18,60
Dundee Utd,3771,4,16,10,10,55,41,14,58
Queen of S't,3771,5,12,11,13,43,45,-2,47
Dumbarton,3771,6,10,12,14,47,60,-13,42
Raith,3771,7,10,9,17,33,48,-15,39
Dunfermline,3771,8,8,14,14,43,52,-9,38
St Mirren,3771,9,8,10,18,38,56,-18,34
Ayr,3771,10,6,14,16,30,55,-25,32
Hibernian,3772,1,19,11,6,53,27,26,68
Morton,3772,2,17,11,8,54,39,15,62
Dundee Utd,3772,3,14,13,9,50,43,7,55
Falkirk,3772,4,14,10,12,52,42,10,52
Queen of S't,3772,5,14,9,13,52,48,4,51
Dunfermline,3772,6,12,13,11,49,44,5,49
Raith,3772,7,10,9,17,34,50,-16,39
Ayr,3772,8,9,11,16,35,58,-23,38
St Mirren,3772,9,9,9,18,47,57,-10,36
Dumbarton,3772,10,8,12,16,47,65,-18,36
Morton,3773,1,19,12,5,51,32,19,69
Hibernian,3773,2,17,13,6,50,26,24,64
Falkirk,3773,3,16,10,10,57,41,16,58
Dundee Utd,3773,4,16,10,10,46,34,12,58
Dunfermline,3773,5,10,14,12,49,46,3,44
Queen of S't,3773,6,11,10,15,45,49,-4,43
Ayr,3773,7,10,11,15,33,52,-19,41
St Mirren,3773,8,8,12,16,38,52,-14,36
Raith,3773,9,8,11,17,31,48,-17,35
Dumbarton,3773,10,7,13,16,45,65,-20,34
Hibernian,3774,1,22,11,3,62,22,40,77
Dundee Utd,3774,2,18,8,10,53,40,13,62
Falkirk,3774,3,15,11,10,57,44,13,56
Morton,3774,4,15,11,10,45,39,6,56
Queen of S't,3774,5,11,10,15,49,55,-6,43
Raith,3774,6,11,10,15,35,48,-13,43
Dunfermline,3774,7,10,12,14,43,49,-6,42
Ayr,3774,8,8,13,15,36,55,-19,37
Dumbarton,3774,9,8,11,17,46,59,-13,35
St Mirren,3774,10,8,11,17,40,55,-15,35
Hibernian,3775,1,20,11,5,58,25,33,71
Morton,3775,2,17,10,9,49,40,9,61
Dundee Utd,3775,3,17,9,10,54,40,14,60
Falkirk,3775,4,15,11,10,56,41,15,56
Raith,3775,5,13,9,14,40,48,-8,48
Dumbarton,3775,6,10,10,16,50,62,-12,40
Dunfermline,3775,7,9,12,15,45,48,-3,39
Queen of S't,3775,8,10,9,17,44,58,-14,39
Ayr,3775,9,9,12,15,36,53,-17,39
St Mirren,3775,10,8,11,17,39,56,-17,35
Hibernian,3776,1,18,13,5,55,27,28,67
Morton,3776,2,17,13,6,50,35,15,64
Falkirk,3776,3,16,11,9,59,41,18,59
Dundee Utd,3776,4,14,13,9,46,38,8,55
Queen of S't,3776,5,13,10,13,50,50,0,49
Dunfermline,3776,6,9,13,14,44,51,-7,40
Raith,3776,7,10,9,17,34,50,-16,39
Ayr,3776,8,9,11,16,33,53,-20,38
St Mirren,3776,9,9,10,17,36,49,-13,37
Dumbarton,3776,10,8,11,17,49,62,-13,35
Morton,3777,1,18,12,6,50,31,19,66
Falkirk,3777,2,18,11,7,63,36,27,65
Hibernian,3777,3,17,12,7,53,32,21,63
Dundee Utd,3777,4,15,10,11,48,46,2,55
Queen of S't,3777,5,12,10,14,50,50,0,46
Raith,3777,6,10,11,15,38,48,-10,41
Dumbarton,3777,7,10,11,15,50,61,-11,41
Ayr,3777,8,9,11,16,38,56,-18,38
St Mirren,3777,9,8,11,17,39,58,-19,35
Dunfermline,3777,10,7,13,16,43,54,-11,34
Hibernian,3778,1,19,12,5,56,25,31,69
Morton,3778,2,18,11,7,51,32,19,65
Falkirk,3778,3,15,12,9,59,43,16,57
Dundee Utd,3778,4,15,11,10,52,41,11,56
Dunfermline,3778,5,9,13,14,46,53,-7,40
St Mirren,3778,6,10,10,16,40,53,-13,40
Queen of S't,3778,7,9,12,15,36,45,-9,39
Dumbarton,3778,8,9,12,15,50,60,-10,39
Raith,3778,9,9,11,16,34,51,-17,38
Ayr,3778,10,8,14,14,34,55,-21,38
Hibernian,3779,1,18,13,5,55,28,27,67
Morton,3779,2,16,14,6,52,36,16,62
Dundee Utd,3779,3,15,11,10,49,42,7,56
Falkirk,3779,4,15,10,11,57,43,14,55
Queen of S't,3779,5,12,11,13,47,48,-1,47
St Mirren,3779,6,10,11,15,41,53,-12,41
Raith,3779,7,10,11,15,34,47,-13,41
Dunfermline,3779,8,9,13,14,47,54,-7,40
Dumbarton,3779,9,9,12,15,45,54,-9,39
Ayr,3779,10,7,12,17,34,56,-22,33
Hibernian,3780,1,19,11,6,56,28,28,68
Morton,3780,2,18,11,7,56,37,19,65
Falkirk,3780,3,16,11,9,59,40,19,59
Dundee Utd,3780,4,16,10,10,51,42,9,58
Dunfermline,3780,5,10,13,13,49,52,-3,43
Raith,3780,6,11,10,15,36,46,-10,43
Queen of S't,3780,7,11,9,16,48,53,-5,42
St Mirren,3780,8,9,11,16,41,54,-13,38
Dumbarton,3780,9,8,12,16,40,56,-16,36
Ayr,3780,10,8,10,18,36,64,-28,34
Hibernian,3781,1,19,12,5,55,25,30,69
Morton,3781,2,16,14,6,48,32,16,62
Falkirk,3781,3,16,11,9,60,37,23,59
Dundee Utd,3781,4,13,11,12,46,43,3,50
Queen of S't,3781,5,12,11,13,48,50,-2,47
Dunfermline,3781,6,10,13,13,44,50,-6,43
Raith,3781,7,9,11,16,33,48,-15,38
Ayr,3781,8,8,14,14,37,53,-16,38
Dumbarton,3781,9,8,13,15,44,60,-16,37
St Mirren,3781,10,9,10,17,41,58,-17,37
Morton,3782,1,19,10,7,58,37,21,67
Hibernian,3782,2,18,11,7,56,31,25,65
Dundee Utd,3782,3,16,10,10,50,38,12,58
Falkirk,3782,4,14,10,12,59,47,12,52
Dunfermline,3782,5,10,14,12,48,51,-3,44
St Mirren,3782,6,11,10,15,45,57,-12,43
Dumbarton,3782,7,10,11,15,54,62,-8,41
Queen of S't,3782,8,10,11,15,42,51,-9,41
Raith,3782,9,10,11,15,35,47,-12,41
Ayr,3782,10,6,14,16,30,56,-26,32
Hibernian,3783,1,19,12,5,57,26,31,69
Morton,3783,2,17,12,7,48,37,11,63
Falkirk,3783,3,15,10,11,55,40,15,55
Dundee Utd,3783,4,13,12,11,45,41,4,51
Queen of S't,3783,5,13,8,15,49,53,-4,47
Dunfermline,3783,6,11,12,13,47,50,-3,45
Ayr,3783,7,11,11,14,37,51,-14,44
Dumbarton,3783,8,9,11,16,49,57,-8,38
St Mirren,3783,9,9,10,17,38,54,-16,37
Raith,3783,10,9,10,17,32,48,-16,37
Hibernian,3784,1,17,14,5,49,24,25,65
Falkirk,3784,2,16,10,10,53,38,15,58
Morton,3784,3,14,12,10,47,41,6,54
Dundee Utd,3784,4,13,13,10,46,39,7,52
Dunfermline,3784,5,12,14,10,44,40,4,50
Queen of S't,3784,6,12,11,13,42,44,-2,47
Dumbarton,3784,7,9,13,14,51,58,-7,40
Raith,3784,8,9,12,15,32,45,-13,39
St Mirren,3784,9,8,13,15,41,52,-11,37
Ayr,3784,10,7,14,15,33,57,-24,35
Hibernian,3785,1,17,14,5,55,28,27,65
Morton,3785,2,18,10,8,48,36,12,64
Dundee Utd,3785,3,18,9,9,55,37,18,63
Falkirk,3785,4,15,13,8,59,43,16,58
Queen of S't,3785,5,11,11,14,43,49,-6,44
Raith,3785,6,10,10,16,37,49,-12,40
Dunfermline,3785,7,8,15,13,40,45,-5,39
Ayr,3785,8,8,13,15,31,52,-21,37
St Mirren,3785,9,8,12,16,43,56,-13,36
Dumbarton,3785,10,7,13,16,45,61,-16,34
Hibernian,3786,1,19,13,4,55,25,30,70
Falkirk,3786,2,17,11,8,64,38,26,62
Morton,3786,3,16,12,8,51,37,14,60
Dundee Utd,3786,4,16,11,9,48,37,11,59
Dunfermline,3786,5,10,14,12,46,47,-1,44
Queen of S't,3786,6,10,11,15,40,50,-10,41
Raith,3786,7,10,10,16,35,52,-17,40
Dumbarton,3786,8,8,14,14,46,57,-11,38
Ayr,3786,9,7,14,15,34,54,-20,35
St Mirren,3786,10,6,12,18,36,58,-22,30
Morton,3787,1,19,10,7,53,34,19,67
Hibernian,3787,2,18,11,7,57,32,25,65
Falkirk,3787,3,16,10,10,62,44,18,58
Dundee Utd,3787,4,16,9,11,51,41,10,57
Dunfermline,3787,5,12,11,13,52,46,6,47
Queen of S't,3787,6,11,9,16,40,51,-11,42
Raith,3787,7,10,9,17,38,58,-20,39
Dumbarton,3787,8,9,11,16,49,62,-13,38
Ayr,3787,9,8,14,14,35,51,-16,38
St Mirren,3787,10,9,10,17,41,59,-18,37
Hibernian,3788,1,19,11,6,54,27,27,68
Morton,3788,2,19,10,7,54,34,20,67
Falkirk,3788,3,17,10,9,58,38,20,61
Dundee Utd,3788,4,15,9,12,46,42,4,54
Dunfermline,3788,5,11,12,13,47,47,0,45
Queen of S't,3788,6,12,8,16,43,50,-7,44
Raith,3788,7,11,9,16,39,50,-11,42
Dumbarton,3788,8,10,10,16,48,63,-15,40
St Mirren,3788,9,9,9,18,39,54,-15,36
Ayr,3788,10,7,12,17,33,56,-23,33
Morton,3789,1,17,11,8,49,38,11,62
Falkirk,3789,2,16,13,7,60,39,21,61
Dundee Utd,3789,3,17,9,10,50,41,9,60
Hibernian,3789,4,15,14,7,47,27,20,59
Raith,3789,5,11,12,13,37,44,-7,45
Dunfermline,3789,6,10,14,12,46,48,-2,44
Queen of S't,3789,7,11,10,15,45,52,-7,43
Dumbarton,3789,8,10,11,15,56,58,-2,41
Ayr,3789,9,7,13,16,31,54,-23,34
St Mirren,3789,10,7,11,18,35,55,-20,32
Hibernian,3790,1,19,13,4,53,22,31,70
Morton,3790,2,17,11,8,48,35,13,62
Falkirk,3790,3,17,9,10,62,41,21,60
Dundee Utd,3790,4,14,9,13,46,44,2,51
Queen of S't,3790,5,12,9,15,52,56,-4,45
Raith,3790,6,12,8,16,36,48,-12,44
Dumbarton,3790,7,10,11,15,49,60,-11,41
Dunfermline,3790,8,9,13,14,49,54,-5,40
Ayr,3790,9,9,11,16,37,58,-21,38
St Mirren,3790,10,9,10,17,38,52,-14,37
Hibernian,3791,1,20,12,4,60,28,32,72
Morton,3791,2,15,14,7,48,34,14,59
Falkirk,3791,3,15,11,10,57,43,14,56
Dundee Utd,3791,4,14,12,10,47,40,7,54
Raith,3791,5,12,10,14,37,47,-10,46
Dunfermline,3791,6,11,12,13,46,44,2,45
Queen of S't,3791,7,12,9,15,41,50,-9,45
Dumbarton,3791,8,9,11,16,47,55,-8,38
Ayr,3791,9,7,13,16,33,57,-24,34
St Mirren,3791,10,7,12,17,38,56,-18,33
Hibernian,3792,1,19,12,5,54,28,26,69
Morton,3792,2,18,12,6,52,33,19,66
Falkirk,3792,3,18,10,8,63,38,25,64
Dundee Utd,3792,4,16,8,12,51,38,13,56
Queen of S't,3792,5,12,8,16,45,55,-10,44
Raith,3792,6,10,10,16,33,48,-15,40
Dumbarton,3792,7,9,12,15,51,64,-13,39
Ayr,3792,8,9,12,15,40,54,-14,39
Dunfermline,3792,9,9,11,16,46,53,-7,38
St Mirren,3792,10,7,11,18,37,61,-24,32
Hibernian,3793,1,22,11,3,61,23,38,77
Morton,3793,2,16,12,8,52,44,8,60
Dundee Utd,3793,3,16,9,11,50,39,11,57
Falkirk,3793,4,15,10,11,56,40,16,55
Queen of S't,3793,5,12,10,14,44,51,-7,46
Dunfermline,3793,6,11,12,13,52,49,3,45
St Mirren,3793,7,11,9,16,42,52,-10,42
Ayr,3793,8,9,11,16,37,58,-21,38
Raith,3793,9,8,11,17,35,53,-18,35
Dumbarton,3793,10,7,11,18,41,61,-20,32
Hibernian,3794,1,20,12,4,56,23,33,72
Dundee Utd,3794,2,18,10,8,52,34,18,64
Morton,3794,3,14,14,8,48,37,11,56
Falkirk,3794,4,14,12,10,56,43,13,54
Queen of S't,3794,5,13,10,13,47,48,-1,49
Raith,3794,6,12,8,16,37,46,-9,44
Dunfermline,3794,7,8,15,13,42,48,-6,39
St Mirren,3794,8,9,10,17,40,55,-15,37
Dumbarton,3794,9,7,14,15,46,59,-13,35
Ayr,3794,10,7,11,18,33,64,-31,32
Hibernian,3795,1,19,12,5,54,23,31,69
Morton,3795,2,18,11,7,54,37,17,65
Dundee Utd,3795,3,17,10,9,59,42,17,61
Falkirk,3795,4,16,10,10,65,46,19,58
Queen of S't,3795,5,11,11,14,44,51,-7,44
Dunfermline,3795,6,9,14,13,44,51,-7,41
Dumbarton,3795,7,8,15,13,48,59,-11,39
Raith,3795,8,10,9,17,34,53,-19,39
Ayr,3795,9,8,12,16,34,54,-20,36
St Mirren,3795,10,7,10,19,38,58,-20,31
Hibernian,3796,1,18,14,4,59,27,32,68
Morton,3796,2,17,13,6,59,36,23,64
Dundee Utd,3796,3,16,10,10,52,40,12,58
Falkirk,3796,4,16,9,11,58,43,15,57
Dumbarton,3796,5,11,11,14,48,54,-6,44
Dunfermline,3796,6,9,14,13,42,50,-8,41
Queen of S't,3796,7,9,11,16,42,55,-13,38
Ayr,3796,8,8,14,14,31,53,-22,38
Raith,3796,9,9,10,17,32,48,-16,37
St Mirren,3796,10,8,12,16,40,57,-17,36
Hibernian,3797,1,18,11,7,53,26,27,65
Falkirk,3797,2,18,10,8,62,40,22,64
Morton,3797,3,17,10,9,53,38,15,61
Dundee Utd,3797,4,17,9,10,55,43,12,60
Dunfermline,3797,5,11,12,13,49,51,-2,45
Queen of S't,3797,6,12,9,15,47,49,-2,45
Raith,3797,7,10,12,14,31,43,-12,42
Dumbarton,3797,8,9,11,16,47,59,-12,38
Ayr,3797,9,8,11,17,36,61,-25,35
St Mirren,3797,10,8,9,19,38,61,-23,33
Morton,3798,1,21,10,5,54,30,24,73
Falkirk,3798,2,19,9,8,61,38,23,66
Hibernian,3798,3,17,12,7,51,27,24,63
Dundee Utd,3798,4,16,11,9,51,40,11,59
Queen of S't,3798,5,11,10,15,48,57,-9,43
Ayr,3798,6,10,11,15,32,49,-17,41
Dunfermline,3798,7,9,12,15,45,52,-7,39
Dumbarton,3798,8,8,13,15,47,58,-11,37
Raith,3798,9,9,9,18,37,52,-15,36
St Mirren,3798,10,6,11,19,38,61,-23,29
Hibernian,3799,1,19,12,5,59,26,33,69
Morton,3799,2,18,11,7,50,35,15,65
Dundee Utd,3799,3,13,13,10,50,44,6,52
Falkirk,3799,4,14,9,13,54,50,4,51
Dunfermline,3799,5,12,13,11,47,44,3,49
Queen of S't,3799,6,10,12,14,46,51,-5,42
Raith,3799,7,10,10,16,36,50,-14,40
Dumbarton,3799,8,8,14,14,47,56,-9,38
St Mirren,3799,9,9,11,16,39,53,-14,38
Ayr,3799,10,7,15,14,35,54,-19,36
Hibernian,3800,1,19,12,5,57,30,27,69
Morton,3800,2,17,12,7,54,39,15,63
Dundee Utd,3800,3,17,10,9,55,40,15,61
Falkirk,3800,4,14,13,9,56,42,14,55
Dunfermline,3800,5,11,13,12,50,51,-1,46
Queen of S't,3800,6,10,12,14,45,51,-6,42
St Mirren,3800,7,9,12,15,41,55,-14,39
Raith,3800,8,9,11,16,39,51,-12,38
Ayr,3800,9,7,13,16,35,58,-23,34
Dumbarton,3800,10,7,12,17,48,63,-15,33
Hibernian,3801,1,18,12,6,56,27,29,66
Morton,3801,2,16,12,8,47,38,9,60
Dundee Utd,3801,3,15,13,8,51,40,11,58
Falkirk,3801,4,15,11,10,58,43,15,56
Dunfermline,3801,5,10,13,13,49,48,1,43
Raith,3801,6,11,10,15,41,46,-5,43
Dumbarton,3801,7,11,10,15,48,58,-10,43
St Mirren,3801,8,10,12,14,39,49,-10,42
Queen of S't,3801,9,10,10,16,44,58,-14,40
Ayr,3801,10,6,13,17,32,58,-26,31
Hibernian,3802,1,19,13,4,56,26,30,70
Morton,3802,2,17,11,8,48,34,14,62
Falkirk,3802,3,16,10,10,59,44,15,58
Dundee Utd,3802,4,14,10,12,47,44,3,52
Raith,3802,5,13,9,14,36,42,-6,48
Dunfermline,3802,6,10,14,12,47,43,4,44
Queen of S't,3802,7,10,10,16,39,50,-11,40
Ayr,3802,8,8,14,14,36,55,-19,38
Dumbarton,3802,9,8,13,15,42,54,-12,37
St Mirren,3802,10,7,12,17,35,53,-18,33
Hibernian,3803,1,19,12,5,56,29,27,69
Falkirk,3803,2,16,10,10,66,43,23,58
Morton,3803,3,15,12,9,52,41,11,57
Dundee Utd,3803,4,15,10,11,54,49,5,55
Queen of S't,3803,5,13,9,14,49,48,1,48
Raith,3803,6,10,12,14,39,48,-9,42
Dunfermline,3803,7,9,13,14,38,47,-9,40
St Mirren,3803,8,10,10,16,43,61,-18,40
Dumbarton,3803,9,9,12,15,47,55,-8,39
Ayr,3803,10,8,12,16,36,59,-23,36
Hibernian,3804,1,22,11,3,62,22,40,77
Morton,3804,2,17,10,9,50,39,11,61
Falkirk,3804,3,15,12,9,60,46,14,57
Dundee Utd,3804,4,14,12,10,49,39,10,54
Queen of S't,3804,5,12,10,14,45,49,-4,46
Dunfermline,3804,6,10,12,14,48,53,-5,42
Raith,3804,7,10,10,16,39,52,-13,40
Dumbarton,3804,8,9,11,16,46,61,-15,38
Ayr,3804,9,7,15,14,34,55,-21,36
St Mirren,3804,10,8,9,19,40,57,-17,33
Hibernian,3805,1,20,12,4,62,25,37,72
Morton,3805,2,16,11,9,50,41,9,59
Falkirk,3805,3,14,11,11,59,49,10,53
Queen of S't,3805,4,14,9,13,50,47,3,51
Dundee Utd,3805,5,14,9,13,46,47,-1,51
Dunfermline,3805,6,12,12,12,47,47,0,48
Raith,3805,7,11,9,16,38,49,-11,42
St Mirren,3805,8,9,11,16,41,56,-15,38
Dumbarton,3805,9,8,13,15,49,59,-10,37
Ayr,3805,10,8,11,17,37,59,-22,35
Hibernian,3806,1,20,13,3,57,24,33,73
Morton,3806,2,16,12,8,47,35,12,60
Falkirk,3806,3,14,11,11,55,42,13,53
Dundee Utd,3806,4,13,13,10,46,40,6,52
Dunfermline,3806,5,11,14,11,48,46,2,47
Queen of S't,3806,6,12,11,13,48,50,-2,47
Dumbarton,3806,7,9,14,13,51,59,-8,41
Ayr,3806,8,7,15,14,31,52,-21,36
Raith,3806,9,9,8,19,35,56,-21,35
St Mirren,3806,10,7,13,16,40,54,-14,34
Hibernian,3807,1,19,11,6,56,29,27,68
Morton,3807,2,17,12,7,53,37,16,63
Falkirk,3807,3,17,11,8,60,38,22,62
Dundee Utd,3807,4,14,10,12,51,46,5,52
Queen of S't,3807,5,12,9,15,47,49,-2,45
Dunfermline,3807,6,10,12,14,46,51,-5,42
Ayr,3807,7,9,13,14,35,53,-18,40
Dumbarton,3807,8,9,11,16,48,59,-11,38
Raith,3807,9,9,11,16,31,49,-18,38
St Mirren,3807,10,9,10,17,38,54,-16,37
Hibernian,3808,1,19,11,6,56,26,30,68
Morton,3808,2,19,10,7,53,32,21,67
Falkirk,3808,3,16,11,9,58,39,19,59
Dundee Utd,3808,4,16,10,10,52,42,10,58
Dunfermline,3808,5,12,11,13,46,48,-2,47
Dumbarton,3808,6,10,13,13,46,51,-5,43
Queen of S't,3808,7,10,11,15,44,52,-8,41
Ayr,3808,8,8,13,15,33,53,-20,37
Raith,3808,9,8,10,18,32,52,-20,34
St Mirren,3808,10,7,10,19,34,59,-25,31
Hibernian,3809,1,20,11,5,57,24,33,71
Morton,3809,2,18,11,7,57,37,20,65
Dundee Utd,3809,3,18,8,10,62,43,19,62
Falkirk,3809,4,17,10,9,62,47,15,61
Dunfermline,3809,5,10,13,13,52,53,-1,43
Queen of S't,3809,6,11,10,15,41,53,-12,43
Dumbarton,3809,7,8,14,14,50,61,-11,38
Raith,3809,8,9,11,16,30,47,-17,38
St Mirren,3809,9,9,10,17,40,58,-18,37
Ayr,3809,10,6,10,20,28,56,-28,28
Hibernian,3810,1,18,12,6,53,26,27,66
Falkirk,3810,2,18,10,8,63,41,22,64
Dundee Utd,3810,3,17,10,9,55,39,16,61
Morton,3810,4,14,14,8,48,41,7,56
Queen of S't,3810,5,13,9,14,44,48,-4,48
Raith,3810,6,10,11,15,39,50,-11,41
St Mirren,3810,7,10,10,16,44,53,-9,40
Dunfermline,3810,8,8,14,14,44,51,-7,38
Dumbarton,3810,9,8,12,16,46,61,-15,36
Ayr,3810,10,7,12,17,30,56,-26,33
Hibernian,3811,1,18,10,8,55,34,21,64
Falkirk,3811,2,17,10,9,65,44,21,61
Dundee Utd,3811,3,17,9,10,52,39,13,60
Morton,3811,4,16,10,10,46,37,9,58
Dunfermline,3811,5,12,13,11,49,47,2,49
Queen of S't,3811,6,12,8,16,51,56,-5,44
Ayr,3811,7,11,11,14,37,51,-14,44
Raith,3811,8,10,10,16,36,54,-18,40
St Mirren,3811,9,9,9,18,39,55,-16,36
Dumbarton,3811,10,8,10,18,44,57,-13,34
Hibernian,3812,1,18,11,7,56,31,25,65
Morton,3812,2,16,13,7,50,38,12,61
Falkirk,3812,3,16,10,10,55,43,12,58
Dundee Utd,3812,4,15,10,11,51,44,7,55
Dunfermline,3812,5,11,12,13,44,48,-4,45
St Mirren,3812,6,11,10,15,46,55,-9,43
Dumbarton,3812,7,10,12,14,51,53,-2,42
Queen of S't,3812,8,11,9,16,46,57,-11,42
Raith,3812,9,9,10,17,35,48,-13,37
Ayr,3812,10,8,13,15,34,51,-17,37
Hibernian,3813,1,20,12,4,62,27,35,72
Falkirk,3813,2,17,10,9,63,39,24,61
Morton,3813,3,16,12,8,55,40,15,60
Dundee Utd,3813,4,16,10,10,51,45,6,58
Queen of S't,3813,5,12,8,16,46,55,-9,44
Dunfermline,3813,6,10,11,15,51,55,-4,41
Dumbarton,3813,7,9,12,15,46,59,-13,39
Ayr,3813,8,9,12,15,39,57,-18,39
Raith,3813,9,9,10,17,37,59,-22,37
St Mirren,3813,10,9,9,18,46,60,-14,36
Hibernian,3814,1,18,13,5,57,27,30,67
Dundee Utd,3814,2,17,11,8,54,39,15,62
Morton,3814,3,16,11,9,49,39,10,59
Falkirk,3814,4,15,11,10,55,45,10,56
Dunfermline,3814,5,11,14,11,47,44,3,47
Raith,3814,6,9,14,13,35,46,-11,41
Queen of S't,3814,7,10,10,16,43,50,-7,40
St Mirren,3814,8,9,11,16,40,53,-13,38
Dumbarton,3814,9,9,11,16,44,58,-14,38
Ayr,3814,10,7,12,17,33,56,-23,33
Hibernian,3815,1,19,12,5,54,26,28,69
Morton,3815,2,19,11,6,56,31,25,68
Dundee Utd,3815,3,15,11,10,47,37,10,56
Falkirk,3815,4,15,9,12,58,44,14,54
Queen of S't,3815,5,13,9,14,45,47,-2,48
Dunfermline,3815,6,10,14,12,50,53,-3,44
Ayr,3815,7,10,11,15,36,51,-15,41
Raith,3815,8,11,8,17,36,53,-17,41
Dumbarton,3815,9,7,13,16,45,58,-13,34
St Mirren,3815,10,7,10,19,37,64,-27,31
Morton,3816,1,18,11,7,53,35,18,65
Hibernian,3816,2,17,13,6,51,29,22,64
Falkirk,3816,3,17,10,9,63,42,21,61
Dundee Utd,3816,4,16,11,9,50,40,10,59
Dunfermline,3816,5,9,14,13,42,46,-4,41
Queen of S't,3816,6,10,10,16,43,51,-8,40
St Mirren,3816,7,9,12,15,45,56,-11,39
Raith,3816,8,9,11,16,32,50,-18,38
Dumbarton,3816,9,8,13,15,46,57,-11,37
Ayr,3816,10,7,15,14,33,52,-19,36
Hibernian,3817,1,18,13,5,56,26,30,67
Morton,3817,2,15,13,8,49,41,8,58
Falkirk,3817,3,16,9,11,61,41,20,57
Dundee Utd,3817,4,15,10,11,46,39,7,55
Queen of S't,3817,5,15,9,12,47,42,5,54
Dunfermline,3817,6,12,12,12,51,48,3,48
Raith,3817,7,10,9,17,32,51,-19,39
Ayr,3817,8,8,13,15,29,49,-20,37
Dumbarton,3817,9,8,12,16,45,59,-14,36
St Mirren,3817,10,8,10,18,39,59,-20,34
Hibernian,3818,1,19,10,7,57,29,28,67
Morton,3818,2,16,12,8,50,38,12,60
Falkirk,3818,3,16,11,9,57,37,20,59
Dundee Utd,3818,4,16,11,9,49,38,11,59
Raith,3818,5,12,10,14,39,49,-10,46
Dunfermline,3818,6,10,13,13,47,51,-4,43
Dumbarton,3818,7,9,13,14,51,60,-9,40
Ayr,3818,8,9,12,15,33,52,-19,39
Queen of S't,3818,9,10,8,18,46,58,-12,38
St Mirren,3818,10,8,10,18,36,53,-17,34
Hibernian,3819,1,20,12,4,56,24,32,72
Dundee Utd,3819,2,16,11,9,51,39,12,59
Morton,3819,3,14,14,8,44,36,8,56
Falkirk,3819,4,14,12,10,57,42,15,54
Queen of S't,3819,5,13,9,14,46,50,-4,48
Dunfermline,3819,6,11,11,14,43,48,-5,44
St Mirren,3819,7,11,10,15,43,51,-8,43
Dumbarton,3819,8,9,12,15,48,57,-9,39
Raith,3819,9,9,11,16,34,49,-15,38
Ayr,3819,10,6,12,18,32,58,-26,30
Hibernian,3820,1,20,12,4,60,29,31,72
Morton,3820,2,17,12,7,55,35,20,63
Falkirk,3820,3,16,9,11,60,46,14,57
Dundee Utd,3820,4,15,11,10,54,39,15,56
Queen of S't,3820,5,12,9,15,49,52,-3,45
Dunfermline,3820,6,10,13,13,49,54,-5,43
Dumbarton,3820,7,9,13,14,46,56,-10,40
Ayr,3820,8,8,14,14,36,57,-21,38
Raith,3820,9,9,9,18,31,49,-18,36
St Mirren,3820,10,8,10,18,40,63,-23,34
Morton,3821,1,17,13,6,58,36,22,64
Hibernian,3821,2,17,12,7,50,29,21,63
Falkirk,3821,3,17,10,9,59,39,20,61
Dundee Utd,3821,4,15,9,12,49,40,9,54
Queen of S't,3821,5,12,10,14,46,53,-7,46
Dumbarton,3821,6,11,12,13,53,55,-2,45
Dunfermline,3821,7,9,13,14,47,57,-10,40
St Mirren,3821,8,10,9,17,43,58,-15,39
Raith,3821,9,10,8,18,37,54,-17,38
Ayr,3821,10,9,10,17,36,57,-21,37
Hibernian,3822,1,19,14,3,52,21,31,71
Falkirk,3822,2,17,11,8,59,37,22,62
Dundee Utd,3822,3,17,9,10,54,37,17,60
Morton,3822,4,14,12,10,44,39,5,54
Queen of S't,3822,5,12,10,14,44,48,-4,46
Dunfermline,3822,6,10,12,14,48,51,-3,42
Raith,3822,7,10,10,16,33,48,-15,40
St Mirren,3822,8,9,11,16,39,52,-13,38
Dumbarton,3822,9,8,13,15,49,60,-11,37
Ayr,3822,10,7,12,17,34,63,-29,33
Hibernian,3823,1,17,14,5,49,24,25,65
Morton,3823,2,17,11,8,51,36,15,62
Falkirk,3823,3,16,9,11,59,42,17,57
Dundee Utd,3823,4,14,9,13,47,44,3,51
Queen of S't,3823,5,12,10,14,44,47,-3,46
Raith,3823,6,12,10,14,39,48,-9,46
St Mirren,3823,7,10,11,15,40,51,-11,41
Dunfermline,3823,8,9,13,14,44,49,-5,40
Dumbarton,3823,9,9,11,16,43,58,-15,38
Ayr,3823,10,7,16,13,31,48,-17,37
Hibernian,3824,1,20,11,5,60,30,30,71
Morton,3824,2,16,11,9,48,37,11,59
Dundee Utd,3824,3,16,11,9,47,36,11,59
Falkirk,3824,4,15,11,10,58,44,14,56
Dunfermline,3824,5,10,15,11,47,46,1,45
Raith,3824,6,12,8,16,37,48,-11,44
Queen of S't,3824,7,10,10,16,42,53,-11,40
St Mirren,3824,8,10,9,17,42,55,-13,39
Ayr,3824,9,9,11,16,35,54,-19,38
Dumbarton,3824,10,8,11,17,47,60,-13,35
Hibernian,3825,1,21,12,3,59,23,36,75
Dundee Utd,3825,2,18,9,9,58,42,16,63
Morton,3825,3,16,12,8,53,38,15,60
Falkirk,3825,4,15,9,12,58,45,13,54
Raith,3825,5,11,10,15,38,47,-9,43
Dunfermline,3825,6,10,12,14,49,55,-6,42
Queen of S't,3825,7,11,9,16,42,49,-7,42
St Mirren,3825,8,9,11,16,42,53,-11,38
Dumbarton,3825,9,8,11,17,48,68,-20,35
Ayr,3825,10,8,11,17,36,63,-27,35
Hibernian,3826,1,18,14,4,51,24,27,68
Falkirk,3826,2,16,12,8,63,37,26,60
Dundee Utd,3826,3,16,10,10,56,41,15,58
Morton,3826,4,15,11,10,47,40,7,56
Dumbarton,3826,5,11,13,12,52,56,-4,46
Raith,3826,6,11,10,15,35,50,-15,43
Dunfermline,3826,7,10,12,14,48,54,-6,42
Queen of S't,3826,8,9,12,15,41,51,-10,39
Ayr,3826,9,8,13,15,35,55,-20,37
St Mirren,3826,10,7,11,18,40,60,-20,32
Hibernian,3827,1,21,12,3,55,22,33,75
Dundee Utd,3827,2,17,11,8,55,39,16,62
Morton,3827,3,16,12,8,50,38,12,60
Falkirk,3827,4,13,15,8,60,45,15,54
Dunfermline,3827,5,10,13,13,48,50,-2,43
Queen of S't,3827,6,11,10,15,44,50,-6,43
Dumbarton,3827,7,8,13,15,45,59,-14,37
Raith,3827,8,9,10,17,35,53,-18,37
Ayr,3827,9,8,12,16,34,55,-21,36
St Mirren,3827,10,8,10,18,40,55,-15,34
Hibernian,3828,1,19,13,4,58,24,34,70
Morton,3828,2,17,11,8,53,38,15,62
Falkirk,3828,3,16,12,8,61,41,20,60
Dundee Utd,3828,4,16,10,10,51,37,14,58
Queen of S't,3828,5,10,11,15,45,53,-8,41
Dumbarton,3828,6,10,11,15,47,59,-12,41
Dunfermline,3828,7,9,12,15,44,56,-12,39
St Mirren,3828,8,9,11,16,42,54,-12,38
Raith,3828,9,9,11,16,39,53,-14,38
Ayr,3828,10,8,12,16,34,59,-25,36
Hibernian,3829,1,21,10,5,55,30,25,73
Falkirk,3829,2,19,9,8,60,36,24,66
Morton,3829,3,17,11,8,51,34,17,62
Dundee Utd,3829,4,16,9,11,52,42,10,57
Queen of S't,3829,5,11,8,17,41,52,-11,41
Dunfermline,3829,6,9,13,14,42,47,-5,40
Ayr,3829,7,9,13,14,37,53,-16,40
Raith,3829,8,9,11,16,34,48,-14,38
Dumbarton,3829,9,9,10,17,50,64,-14,37
St Mirren,3829,10,7,12,17,41,57,-16,33
Hibernian,3830,1,20,12,4,55,24,31,72
Morton,3830,2,19,11,6,52,33,19,68
Falkirk,3830,3,15,12,9,58,45,13,57
Dundee Utd,3830,4,15,11,10,48,42,6,56
Dumbarton,3830,5,12,11,13,55,51,4,47
St Mirren,3830,6,9,11,16,46,56,-10,38
Raith,3830,7,10,8,18,36,51,-15,38
Dunfermline,3830,8,8,13,15,42,52,-10,37
Queen of S't,3830,9,9,10,17,41,56,-15,37
Ayr,3830,10,8,11,17,35,58,-23,35
Hibernian,3831,1,19,13,4,54,26,28,70
Morton,3831,2,17,12,7,52,32,20,63
Dundee Utd,3831,3,16,9,11,51,45,6,57
Falkirk,3831,4,15,10,11,56,46,10,55
Dunfermline,3831,5,11,13,12,48,48,0,46
Queen of S't,3831,6,12,8,16,44,51,-7,44
Dumbarton,3831,7,11,10,15,53,58,-5,43
Raith,3831,8,10,10,16,39,50,-11,40
St Mirren,3831,9,7,13,16,40,55,-15,34
Ayr,3831,10,7,12,17,36,62,-26,33
Hibernian,3832,1,18,12,6,54,28,26,66
Morton,3832,2,18,10,8,52,39,13,64
Dundee Utd,3832,3,16,9,11,46,40,6,57
Falkirk,3832,4,14,12,10,54,42,12,54
Queen of S't,3832,5,12,10,14,43,47,-4,46
Dumbarton,3832,6,11,10,15,48,57,-9,43
Dunfermline,3832,7,9,15,12,48,48,0,42
St Mirren,3832,8,9,11,16,38,51,-13,38
Raith,3832,9,9,10,17,33,47,-14,37
Ayr,3832,10,8,13,15,36,53,-17,37
Hibernian,3833,1,18,11,7,53,30,23,65
Morton,3833,2,18,10,8,53,36,17,64
Falkirk,3833,3,16,11,9,58,41,17,59
Dundee Utd,3833,4,13,11,12,49,43,6,50
Dunfermline,3833,5,11,13,12,52,48,4,46
Queen of S't,3833,6,12,9,15,45,49,-4,45
Raith,3833,7,11,11,14,35,47,-12,44
Ayr,3833,8,8,14,14,37,54,-17,38
Dumbarton,3833,9,8,13,15,46,61,-15,37
St Mirren,3833,10,8,11,17,41,60,-19,35
Hibernian,3834,1,19,11,6,57,29,28,68
Falkirk,3834,2,19,9,8,59,37,22,66
Dundee Utd,3834,3,18,8,10,57,39,18,62
Morton,3834,4,17,10,9,50,38,12,61
Queen of S't,3834,5,12,9,15,46,52,-6,45
Raith,3834,6,11,11,14,37,47,-10,44
Dumbarton,3834,7,11,10,15,51,58,-7,43
Dunfermline,3834,8,9,11,16,45,53,-8,38
Ayr,3834,9,8,11,17,38,60,-22,35
St Mirren,3834,10,6,10,20,36,63,-27,28
Hibernian,3835,1,19,13,4,56,28,28,70
Morton,3835,2,18,11,7,52,35,17,65
Dundee Utd,3835,3,17,9,10,55,41,14,60
Falkirk,3835,4,14,11,11,56,42,14,53
Dunfermline,3835,5,11,13,12,52,50,2,46
Queen of S't,3835,6,12,10,14,47,48,-1,46
Raith,3835,7,12,9,15,38,46,-8,45
St Mirren,3835,8,9,9,18,40,57,-17,36
Dumbarton,3835,9,8,11,17,49,68,-19,35
Ayr,3835,10,7,10,19,32,62,-30,31
Hibernian,3836,1,20,11,5,55,27,28,71
Dundee Utd,3836,2,17,10,9,47,37,10,61
Falkirk,3836,3,16,12,8,56,35,21,60
Morton,3836,4,15,13,8,50,41,9,58
Queen of S't,3836,5,10,12,14,43,50,-7,42
Dunfermline,3836,6,9,14,13,46,48,-2,41
Raith,3836,7,10,11,15,31,44,-13,41
Ayr,3836,8,9,12,15,35,51,-16,39
Dumbarton,3836,9,8,13,15,46,56,-10,37
St Mirren,3836,10,7,10,19,35,55,-20,31
Hibernian,3837,1,17,15,4,49,24,25,66
Falkirk,3837,2,18,11,7,59,34,25,65
Morton,3837,3,16,11,9,46,36,10,59
Dundee Utd,3837,4,15,9,12,52,39,13,54
St Mirren,3837,5,10,12,14,38,48,-10,42
Dunfermline,3837,6,9,14,13,42,45,-3,41
Dumbarton,3837,7,10,11,15,46,57,-11,41
Raith,3837,8,10,9,17,34,47,-13,39
Queen of S't,3837,9,9,11,16,41,55,-14,38
Ayr,3837,10,8,13,15,31,53,-22,37
Hibernian,3838,1,19,11,6,54,27,27,68
Falkirk,3838,2,18,9,9,61,42,19,63
Dundee Utd,3838,3,16,11,9,54,40,14,59
Morton,3838,4,15,11,10,50,43,7,56
Dunfermline,3838,5,10,13,13,49,53,-4,43
Queen of S't,3838,6,10,11,15,48,51,-3,41
Raith,3838,7,10,10,16,39,51,-12,40
Dumbarton,3838,8,9,12,15,47,59,-12,39
Ayr,3838,9,8,14,14,42,62,-20,38
St Mirren,3838,10,9,10,17,38,54,-16,37
Hibernian,3839,1,21,10,5,60,29,31,73
Falkirk,3839,2,16,11,9,58,42,16,59
Morton,3839,3,15,9,12,48,43,5,54
Dunfermline,3839,4,12,13,11,54,50,4,49
Dundee Utd,3839,5,13,10,13,50,49,1,49
Queen of S't,3839,6,11,12,13,47,53,-6,45
Raith,3839,7,12,9,15,42,51,-9,45
Dumbarton,3839,8,9,11,16,49,58,-9,38
St Mirren,3839,9,9,11,16,45,58,-13,38
Ayr,3839,10,8,12,16,37,57,-20,36
Hibernian,3840,1,18,13,5,53,27,26,67
Falkirk,3840,2,18,10,8,63,39,24,64
Dundee Utd,3840,3,17,11,8,55,36,19,62
Morton,3840,4,17,10,9,47,35,12,61
Queen of S't,3840,5,12,11,13,44,44,0,47
Raith,3840,6,11,9,16,32,47,-15,42
Dunfermline,3840,7,9,12,15,43,49,-6,39
Ayr,3840,8,8,14,14,33,52,-19,38
St Mirren,3840,9,7,11,18,38,53,-15,32
Dumbarton,3840,10,7,11,18,42,68,-26,32
Hibernian,3841,1,18,14,4,57,26,31,68
Morton,3841,2,16,13,7,49,35,14,61
Falkirk,3841,3,16,10,10,57,43,14,58
Dundee Utd,3841,4,16,10,10,49,41,8,58
Queen of S't,3841,5,11,10,15,45,53,-8,43
Dunfermline,3841,6,9,14,13,46,48,-2,41
St Mirren,3841,7,10,10,16,48,55,-7,40
Dumbarton,3841,8,9,13,14,49,60,-11,40
Raith,3841,9,10,10,16,39,51,-12,40
Ayr,3841,10,7,12,17,32,59,-27,33
Hibernian,3842,1,20,12,4,51,20,31,72
Falkirk,3842,2,17,9,10,58,42,16,60
Dundee Utd,3842,3,16,10,10,49,38,11,58
Morton,3842,4,15,12,9,44,35,9,57
Dunfermline,3842,5,11,15,10,47,43,4,48
Queen of S't,3842,6,11,9,16,42,50,-8,42
Dumbarton,3842,7,9,12,15,47,58,-11,39
St Mirren,3842,8,9,10,17,41,56,-15,37
Raith,3842,9,9,9,18,34,51,-17,36
Ayr,3842,10,7,14,15,33,53,-20,35
Hibernian,3843,1,17,14,5,55,25,30,65
Morton,3843,2,17,12,7,55,38,17,63
Falkirk,3843,3,16,11,9,60,43,17,59
Dundee Utd,3843,4,14,11,11,48,41,7,53
Queen of S't,3843,5,12,9,15,47,54,-7,45
Dunfermline,3843,6,9,14,13,44,46,-2,41
Ayr,3843,7,10,11,15,36,56,-20,41
Raith,3843,8,10,10,16,35,52,-17,40
Dumbarton,3843,9,9,12,15,49,61,-12,39
St Mirren,3843,10,8,12,16,40,53,-13,36
Hibernian,3844,1,22,10,4,60,26,34,76
Morton,3844,2,16,12,8,47,39,8,60
Falkirk,3844,3,16,11,9,59,38,21,59
Dundee Utd,3844,4,16,10,10,52,42,10,58
Dunfermline,3844,5,11,14,11,51,46,5,47
Queen of S't,3844,6,10,10,16,41,52,-11,40
Dumbarton,3844,7,9,11,16,45,57,-12,38
Raith,3844,8,9,11,16,34,50,-16,38
St Mirren,3844,9,8,11,17,42,59,-17,35
Ayr,3844,10,7,12,17,36,58,-22,33
Hibernian,3845,1,21,12,3,60,25,35,75
Falkirk,3845,2,17,10,9,63,43,20,61
Morton,3845,3,16,12,8,50,38,12,60
Dundee Utd,3845,4,16,11,9,56,42,14,59
Queen of S't,3845,5,12,9,15,43,50,-7,45
Raith,3845,6,11,9,16,39,47,-8,42
Dunfermline,3845,7,9,13,14,45,51,-6,40
Ayr,3845,8,8,12,16,35,55,-20,36
St Mirren,3845,9,8,11,17,38,59,-21,35
Dumbarton,3845,10,7,11,18,43,62,-19,32
Hibernian,3846,1,17,13,6,57,26,31,64
Morton,3846,2,18,10,8,57,41,16,64
Falkirk,3846,3,17,10,9,59,40,19,61
Dundee Utd,3846,4,17,9,10,55,39,16,60
Dunfermline,3846,5,12,12,12,53,55,-2,48
Raith,3846,6,11,11,14,42,48,-6,44
Queen of S't,3846,7,10,9,17,46,63,-17,39
Dumbarton,3846,8,8,11,17,45,59,-14,35
St Mirren,3846,9,8,11,17,40,61,-21,35
Ayr,3846,10,7,14,15,33,55,-22,35
Hibernian,3847,1,19,12,5,58,26,32,69
Morton,3847,2,19,10,7,51,34,17,67
Falkirk,3847,3,15,12,9,57,40,17,57
Dundee Utd,3847,4,15,9,12,48,41,7,54
Dunfermline,3847,5,13,11,12,53,51,2,50
Queen of S't,3847,6,10,9,17,42,56,-14,39
St Mirren,3847,7,10,9,17,38,53,-15,39
Raith,3847,8,10,9,17,37,52,-15,39
Dumbarton,3847,9,8,13,15,47,56,-9,37
Ayr,3847,10,8,12,16,34,56,-22,36
Hibernian,3848,1,22,11,3,63,24,39,77
Dundee Utd,3848,2,18,9,9,53,36,17,63
Falkirk,3848,3,17,10,9,62,40,22,61
Morton,3848,4,15,13,8,48,38,10,58
Dunfermline,3848,5,10,13,13,46,48,-2,43
Raith,3848,6,10,9,17,38,57,-19,39
Queen of S't,3848,7,10,8,18,42,56,-14,38
Dumbarton,3848,8,8,12,16,45,62,-17,36
Ayr,3848,9,8,12,16,35,58,-23,36
St Mirren,3848,10,8,11,17,43,56,-13,35
Hibernian,3849,1,18,14,4,53,22,31,68
Falkirk,3849,2,16,10,10,59,43,16,58
Dundee Utd,3849,3,16,9,11,53,42,11,57
Morton,3849,4,15,12,9,48,41,7,57
Ayr,3849,5,11,11,14,36,50,-14,44
Dunfermline,3849,6,10,13,13,45,49,-4,43
Raith,3849,7,11,10,15,36,50,-14,43
Queen of S't,3849,8,11,9,16,46,53,-7,42
Dumbarton,3849,9,9,11,16,48,60,-12,38
St Mirren,3849,10,8,11,17,42,56,-14,35
Hibernian,3850,1,19,13,4,59,28,31,70
Morton,3850,2,16,12,8,55,41,14,60
Dundee Utd,3850,3,17,8,11,52,42,10,59
Falkirk,3850,4,16,10,10,61,39,22,58
Raith,3850,5,12,10,14,40,47,-7,46
Queen of S't,3850,6,11,11,14,47,52,-5,44
Dunfermline,3850,7,9,14,13,46,50,-4,41
Dumbarton,3850,8,10,10,16,50,66,-16,40
St Mirren,3850,9,7,12,17,38,59,-21,33
Ayr,3850,10,7,12,17,33,57,-24,33
Hibernian,3851,1,21,12,3,57,24,33,75
Morton,3851,2,17,12,7,51,35,16,63
Falkirk,3851,3,16,10,10,61,44,17,58
Dundee Utd,3851,4,15,11,10,51,42,9,56
Queen of S't,3851,5,13,9,14,42,46,-4,48
Dumbarton,3851,6,10,10,16,51,57,-6,40
Dunfermline,3851,7,9,12,15,43,52,-9,39
Raith,3851,8,9,10,17,33,49,-16,37
Ayr,3851,9,7,14,15,32,54,-22,35
St Mirren,3851,10,6,14,16,38,56,-18,32
Falkirk,3852,1,18,10,8,57,38,19,64
Morton,3852,2,17,12,7,53,38,15,63
Hibernian,3852,3,16,12,8,48,27,21,60
Dundee Utd,3852,4,16,9,11,52,41,11,57
Dunfermline,3852,5,12,12,12,49,49,0,48
Dumbarton,3852,6,11,12,13,51,54,-3,45
Queen of S't,3852,7,11,9,16,42,50,-8,42
Ayr,3852,8,9,12,15,35,52,-17,39
Raith,3852,9,9,10,17,35,51,-16,37
St Mirren,3852,10,6,12,18,37,59,-22,30
Hibernian,3853,1,18,13,5,56,26,30,67
Falkirk,3853,2,18,10,8,62,38,24,64
Morton,3853,3,18,10,8,48,34,14,64
Dundee Utd,3853,4,18,8,10,50,39,11,62
Dunfermline,3853,5,11,11,14,42,47,-5,44
Queen of S't,3853,6,12,8,16,44,51,-7,44
Raith,3853,7,10,9,17,34,52,-18,39
Dumbarton,3853,8,8,12,16,43,54,-11,36
St Mirren,3853,9,8,12,16,42,54,-12,36
Ayr,3853,10,7,11,18,34,60,-26,32
Hibernian,3854,1,21,11,4,59,24,35,74
Morton,3854,2,18,10,8,54,36,18,64
Falkirk,3854,3,17,10,9,61,41,20,61
Dundee Utd,3854,4,14,10,12,49,46,3,52
Queen of S't,3854,5,11,10,15,48,55,-7,43
Raith,3854,6,11,10,15,38,47,-9,43
Dumbarton,3854,7,10,10,16,49,60,-11,40
Ayr,3854,8,10,10,16,37,56,-19,40
Dunfermline,3854,9,8,15,13,46,52,-6,39
St Mirren,3854,10,7,10,19,35,59,-24,31
Hibernian,3855,1,20,12,4,55,23,32,72
Morton,3855,2,20,10,6,54,34,20,70
Dundee Utd,3855,3,15,12,9,48,38,10,57
Falkirk,3855,4,15,10,11,56,39,17,55
Queen of S't,3855,5,11,10,15,42,51,-9,43
Dumbarton,3855,6,10,12,14,47,56,-9,42
Dunfermline,3855,7,9,13,14,45,49,-4,40
Raith,3855,8,9,9,18,33,54,-21,36
St Mirren,3855,9,8,11,17,35,51,-16,35
Ayr,3855,10,7,13,16,36,56,-20,34
Hibernian,3856,1,19,13,4,53,26,27,70
Dundee Utd,3856,2,18,10,8,53,35,18,64
Falkirk,3856,3,16,10,10,59,41,18,58
Morton,3856,4,15,12,9,45,35,10,57
Queen of S't,3856,5,12,9,15,47,52,-5,45
Dumbarton,3856,6,10,10,16,45,59,-14,40
Raith,3856,7,10,10,16,31,45,-14,40
St Mirren,3856,8,9,12,15,40,50,-10,39
Dunfermline,3856,9,8,12,16,41,49,-8,36
Ayr,3856,10,8,12,16,35,57,-22,36
Hibernian,3857,1,19,12,5,53,24,29,69
Morton,3857,2,19,11,6,48,31,17,68
Dundee Utd,3857,3,14,11,11,50,40,10,53
Falkirk,3857,4,14,10,12,55,47,8,52
Queen of S't,3857,5,13,9,14,49,50,-1,48
Dumbarton,3857,6,10,12,14,48,55,-7,42
Raith,3857,7,10,11,15,38,50,-12,41
Dunfermline,3857,8,9,12,15,43,51,-8,39
Ayr,3857,9,8,14,14,32,50,-18,38
St Mirren,3857,10,8,10,18,37,55,-18,34
Hibernian,3858,1,19,12,5,55,27,28,69
Morton,3858,2,17,11,8,51,38,13,62
Falkirk,3858,3,17,9,10,57,40,17,60
Dundee Utd,3858,4,14,11,11,49,39,10,53
Queen of S't,3858,5,11,12,13,45,49,-4,45
Raith,3858,6,11,9,16,40,52,-12,42
Dumbarton,3858,7,10,11,15,49,57,-8,41
Dunfermline,3858,8,9,12,15,45,55,-10,39
Ayr,3858,9,8,14,14,38,56,-18,38
St Mirren,3858,10,8,11,17,41,57,-16,35
Hibernian,3859,1,18,13,5,54,28,26,67
Falkirk,3859,2,18,10,8,58,37,21,64
Dundee Utd,3859,3,17,9,10,55,36,19,60
Morton,3859,4,16,12,8,53,35,18,60
Queen of S't,3859,5,11,10,15,45,55,-10,43
Dunfermline,3859,6,9,13,14,47,49,-2,40
Raith,3859,7,10,10,16,33,46,-13,40
St Mirren,3859,8,10,9,17,39,58,-19,39
Dumbarton,3859,9,9,10,17,44,65,-21,37
Ayr,3859,10,8,12,16,37,56,-19,36
Hibernian,3860,1,17,13,6,49,26,23,64
Morton,3860,2,16,13,7,51,36,15,61
Dundee Utd,3860,3,15,12,9,47,39,8,57
Falkirk,3860,4,14,11,11,52,38,14,53
Queen of S't,3860,5,12,11,13,47,48,-1,47
Dunfermline,3860,6,10,14,12,44,47,-3,44
Raith,3860,7,10,11,15,36,49,-13,41
Dumbarton,3860,8,9,12,15,51,62,-11,39
St Mirren,3860,9,9,12,15,42,55,-13,39
Ayr,3860,10,8,11,17,37,56,-19,35
Hibernian,3861,1,19,11,6,53,28,25,68
Falkirk,3861,2,18,10,8,68,42,26,64
Morton,3861,3,16,12,8,47,33,14,60
Dundee Utd,3861,4,16,9,11,49,44,5,57
Dunfermline,3861,5,11,13,12,47,46,1,46
Queen of S't,3861,6,11,10,15,42,50,-8,43
Ayr,3861,7,10,12,14,40,54,-14,42
Raith,3861,8,9,10,17,33,51,-18,37
Dumbarton,3861,9,7,13,16,49,61,-12,34
St Mirren,3861,10,8,10,18,42,61,-19,34
Morton,3862,1,18,11,7,53,35,18,65
Dundee Utd,3862,2,18,8,10,56,41,15,62
Hibernian,3862,3,16,11,9,47,28,19,59
Falkirk,3862,4,16,9,11,61,48,13,57
Queen of S't,3862,5,13,9,14,50,51,-1,48
Raith,3862,6,12,9,15,35,46,-11,45
St Mirren,3862,7,11,9,16,43,55,-12,42
Dunfermline,3862,8,8,13,15,44,53,-9,37
Ayr,3862,9,8,13,15,31,53,-22,37
Dumbarton,3862,10,8,12,16,46,56,-10,36
Hibernian,3863,1,21,11,4,59,21,38,74
Falkirk,3863,2,16,11,9,56,36,20,59
Morton,3863,3,16,11,9,50,37,13,59
Dundee Utd,3863,4,14,10,12,45,41,4,52
Dunfermline,3863,5,13,11,12,46,44,2,50
Queen of S't,3863,6,14,8,14,49,51,-2,50
Dumbarton,3863,7,8,14,14,44,55,-11,38
St Mirren,3863,8,8,12,16,39,57,-18,36
Raith,3863,9,8,11,17,31,50,-19,35
Ayr,3863,10,6,13,17,31,58,-27,31
Hibernian,3864,1,20,12,4,57,25,32,72
Morton,3864,2,17,12,7,55,39,16,63
Falkirk,3864,3,16,10,10,55,39,16,58
Dundee Utd,3864,4,15,8,13,46,38,8,53
Queen of S't,3864,5,13,9,14,50,49,1,48
Dunfermline,3864,6,10,12,14,51,55,-4,42
Dumbarton,3864,7,10,11,15,51,62,-11,41
Raith,3864,8,9,11,16,33,51,-18,38
St Mirren,3864,9,9,10,17,38,55,-17,37
Ayr,3864,10,8,11,17,31,54,-23,35
Hibernian,3865,1,19,10,7,55,28,27,67
Morton,3865,2,18,12,6,55,37,18,66
Falkirk,3865,3,17,10,9,56,39,17,61
Dundee Utd,3865,4,16,10,10,50,36,14,58
Queen of S't,3865,5,13,9,14,45,46,-1,48
Dunfermline,3865,6,10,12,14,45,50,-5,42
Raith,3865,7,10,9,17,38,50,-12,39
Dumbarton,3865,8,9,10,17,46,61,-15,37
St Mirren,3865,9,8,12,16,39,55,-16,36
Ayr,3865,10,7,12,17,36,63,-27,33
Hibernian,3866,1,22,10,4,61,26,35,76
Morton,3866,2,18,11,7,51,37,14,65
Falkirk,3866,3,16,10,10,62,44,18,58
Dundee Utd,3866,4,15,10,11,51,45,6,55
Dumbarton,3866,5,12,12,12,54,52,2,48
Queen of S't,3866,6,11,10,15,50,54,-4,43
Dunfermline,3866,7,9,13,14,50,59,-9,40
Raith,3866,8,9,9,18,33,53,-20,36
St Mirren,3866,9,8,9,19,39,55,-16,33
Ayr,3866,10,7,12,17,34,60,-26,33
Hibernian,3867,1,21,10,5,62,26,36,73
Morton,3867,2,17,12,7,52,36,16,63
Falkirk,3867,3,17,11,8,60,39,21,62
Dundee Utd,3867,4,16,10,10,46,36,10,58
Dunfermline,3867,5,10,13,13,45,44,1,43
Queen of S't,3867,6,11,9,16,44,52,-8,42
Raith,3867,7,11,8,17,35,50,-15,41
Dumbarton,3867,8,9,11,16,47,62,-15,38
St Mirren,3867,9,8,11,17,39,57,-18,35
Ayr,3867,10,7,11,18,30,58,-28,32
Morton,3868,1,19,11,6,52,36,16,68
Hibernian,3868,2,18,11,7,52,26,26,65
Falkirk,3868,3,17,10,9,60,44,16,61
Dundee Utd,3868,4,13,11,12,44,42,2,50
Dunfermline,3868,5,12,12,12,48,43,5,48
Queen of S't,3868,6,13,8,15,48,48,0,47
Raith,3868,7,11,10,15,37,47,-10,43
St Mirren,3868,8,9,13,14,46,54,-8,40
Dumbarton,3868,9,7,11,18,43,62,-19,32
Ayr,3868,10,6,13,17,31,59,-28,31
Hibernian,3869,1,19,12,5,61,29,32,69
Morton,3869,2,17,12,7,57,41,16,63
Falkirk,3869,3,17,10,9,61,45,16,61
Dundee Utd,3869,4,17,10,9,54,42,12,61
Dumbarton,3869,5,12,10,14,56,52,4,46
Queen of S't,3869,6,12,9,15,50,50,0,45
Raith,3869,7,10,10,16,39,58,-19,40
Dunfermline,3869,8,9,12,15,48,54,-6,39
Ayr,3869,9,6,14,16,31,59,-28,32
St Mirren,3869,10,6,11,19,38,65,-27,29
Hibernian,3870,1,16,15,5,53,27,26,63
Morton,3870,2,17,11,8,52,39,13,62
Falkirk,3870,3,17,10,9,62,41,21,61
Dundee Utd,3870,4,17,10,9,55,42,13,61
Ayr,3870,5,11,11,14,39,54,-15,44
Dunfermline,3870,6,10,12,14,44,50,-6,42
Queen of S't,3870,7,10,10,16,42,51,-9,40
Dumbarton,3870,8,9,12,15,49,57,-8,39
St Mirren,3870,9,8,12,16,38,55,-17,36
Raith,3870,10,9,9,18,34,52,-18,36
Hibernian,3871,1,19,12,5,57,28,29,69
Morton,3871,2,18,11,7,52,36,16,65
Falkirk,3871,3,17,10,9,62,41,21,61
Dundee Utd,3871,4,14,12,10,52,41,11,54
Queen of S't,3871,5,13,9,14,48,48,0,48
Dunfermline,3871,6,10,14,12,47,47,0,44
Raith,3871,7,11,10,15,39,51,-12,43
St Mirren,3871,8,8,12,16,39,56,-17,36
Dumbarton,3871,9,8,10,18,43,60,-17,34
Ayr,3871,10,7,10,19,33,64,-31,31
Hibernian,3872,1,20,12,4,54,25,29,72
Falkirk,3872,2,16,13,7,61,41,20,61
Morton,3872,3,17,10,9,53,40,13,61
Dundee Utd,3872,4,17,9,10,50,38,12,60
Queen of S't,3872,5,12,9,15,44,50,-6,45
Raith,3872,6,10,11,15,35,46,-11,41
Dunfermline,3872,7,9,12,15,45,51,-6,39
Ayr,3872,8,9,11,16,33,51,-18,38
St Mirren,3872,9,8,11,17,42,58,-16,35
Dumbarton,3872,10,7,12,17,48,65,-17,33
Hibernian,3873,1,18,12,6,59,35,24,66
Morton,3873,2,16,12,8,50,32,18,60
Dundee Utd,3873,3,16,10,10,47,41,6,58
Falkirk,3873,4,15,9,12,55,47,8,54
Dunfermline,3873,5,13,11,12,47,44,3,50
Raith,3873,6,12,10,14,42,46,-4,46
Dumbarton,3873,7,11,11,14,52,55,-3,44
Queen of S't,3873,8,10,9,17,43,53,-10,39
Ayr,3873,9,8,12,16,31,56,-25,36
St Mirren,3873,10,7,12,17,41,58,-17,33
Hibernian,3874,1,20,13,3,58,24,34,73
Dundee Utd,3874,2,18,8,10,55,39,16,62
Morton,3874,3,16,14,6,49,35,14,62
Falkirk,3874,4,15,11,10,57,41,16,56
Queen of S't,3874,5,12,8,16,46,51,-5,44
Raith,3874,6,10,11,15,38,53,-15,41
Dunfermline,3874,7,9,13,14,43,48,-5,40
St Mirren,3874,8,9,12,15,44,52,-8,39
Dumbarton,3874,9,7,12,17,43,62,-19,33
Ayr,3874,10,7,12,17,30,58,-28,33
Hibernian,3875,1,19,13,4,55,24,31,70
Dundee Utd,3875,2,16,11,9,49,37,12,59
Morton,3875,3,16,11,9,48,36,12,59
Falkirk,3875,4,13,12,11,51,41,10,51
Dunfermline,3875,5,12,12,12,48,48,0,48
Queen of S't,3875,6,12,9,15,44,50,-6,45
Dumbarton,3875,7,8,15,13,48,55,-7,39
Raith,3875,8,10,9,17,34,51,-17,39
St Mirren,3875,9,8,14,14,39,52,-13,38
Ayr,3875,10,6,14,16,35,57,-22,32
Hibernian,3876,1,18,11,7,56,30,26,65
Morton,3876,2,18,11,7,53,33,20,65
Dundee Utd,3876,3,17,10,9,56,37,19,61
Falkirk,3876,4,15,13,8,58,41,17,58
Dunfermline,3876,5,10,14,12,44,51,-7,44
Queen of S't,3876,6,10,11,15,42,53,-11,41
Raith,3876,7,11,8,17,37,49,-12,41
Dumbarton,3876,8,9,12,15,48,58,-10,39
Ayr,3876,9,9,12,15,31,51,-20,39
St Mirren,3876,10,6,12,18,36,58,-22,30
Hibernian,3877,1,19,11,6,61,29,32,68
Morton,3877,2,19,10,7,56,37,19,67
Dundee Utd,3877,3,17,8,11,52,42,10,59
Falkirk,3877,4,16,10,10,57,42,15,58
Queen of S't,3877,5,12,10,14,49,54,-5,46
Raith,3877,6,10,11,15,35,50,-15,41
Dunfermline,3877,7,9,11,16,40,46,-6,38
St Mirren,3877,8,9,11,16,39,53,-14,38
Dumbarton,3877,9,9,11,16,44,59,-15,38
Ayr,3877,10,8,11,17,33,54,-21,35
Hibernian,3878,1,20,12,4,56,27,29,72
Morton,3878,2,16,12,8,48,38,10,60
Falkirk,3878,3,15,13,8,56,37,19,58
Dundee Utd,3878,4,14,12,10,48,40,8,54
Queen of S't,3878,5,12,9,15,43,48,-5,45
St Mirren,3878,6,10,11,15,45,53,-8,41
Dunfermline,3878,7,8,16,12,47,50,-3,40
Raith,3878,8,9,11,16,34,49,-15,38
Dumbarton,3878,9,8,12,16,46,60,-14,36
Ayr,3878,10,8,12,16,35,56,-21,36
Hibernian,3879,1,19,13,4,54,24,30,70
Morton,3879,2,18,9,9,50,42,8,63
Dundee Utd,3879,3,17,9,10,52,38,14,60
Falkirk,3879,4,14,14,8,58,42,16,56
Raith,3879,5,11,11,14,40,47,-7,44
Dunfermline,3879,6,9,16,11,44,43,1,43
Queen of S't,3879,7,9,11,16,43,57,-14,38
Ayr,3879,8,8,13,15,33,54,-21,37
Dumbarton,3879,9,7,14,15,44,58,-14,35
St Mirren,3879,10,8,10,18,42,55,-13,34
Hibernian,3880,1,21,12,3,58,21,37,75
Morton,3880,2,16,10,10,53,43,10,58
Dundee Utd,3880,3,16,8,12,49,41,8,56
Falkirk,3880,4,14,9,13,53,45,8,51
Queen of S't,3880,5,14,8,14,44,46,-2,50
Raith,3880,6,12,9,15,39,46,-7,45
Dunfermline,3880,7,10,12,14,45,46,-1,42
Ayr,3880,8,10,12,14,36,52,-16,42
Dumbarton,3880,9,9,11,16,49,66,-17,38
St Mirren,3880,10,8,9,19,38,58,-20,33
Hibernian,3881,1,20,12,4,59,28,31,72
Morton,3881,2,19,9,8,53,34,19,66
Falkirk,3881,3,16,11,9,56,38,18,59
Dundee Utd,3881,4,15,10,11,46,44,2,55
Dumbarton,3881,5,14,10,12,53,51,2,52
Dunfermline,3881,6,9,13,14,44,47,-3,40
Queen of S't,3881,7,10,10,16,41,50,-9,40
Ayr,3881,8,9,11,16,33,52,-19,38
Raith,3881,9,9,9,18,37,55,-18,36
St Mirren,3881,10,6,11,19,36,59,-23,29
Hibernian,3882,1,20,13,3,60,26,34,73
Falkirk,3882,2,17,10,9,62,38,24,61
Dundee Utd,3882,3,17,10,9,52,38,14,61
Morton,3882,4,15,11,10,46,38,8,56
Queen of S't,3882,5,12,11,13,46,51,-5,47
Dunfermline,3882,6,11,13,12,46,45,1,46
Dumbarton,3882,7,8,13,15,42,57,-15,37
St Mirren,3882,8,9,10,17,40,56,-16,37
Raith,3882,9,9,8,19,31,53,-22,35
Ayr,3882,10,6,13,17,32,55,-23,31
Hibernian,3883,1,18,11,7,52,30,22,65
Falkirk,3883,2,18,10,8,64,40,24,64
Dundee Utd,3883,3,18,10,8,54,35,19,64
Morton,3883,4,17,10,9,52,43,9,61
Queen of S't,3883,5,12,11,13,50,49,1,47
Dunfermline,3883,6,9,13,14,50,53,-3,40
Dumbarton,3883,7,9,11,16,46,63,-17,38
Raith,3883,8,9,10,17,35,55,-20,37
St Mirren,3883,9,8,12,16,45,58,-13,36
Ayr,3883,10,7,12,17,35,57,-22,33
Hibernian,3884,1,22,10,4,57,22,35,76
Morton,3884,2,16,13,7,51,39,12,61
Falkirk,3884,3,15,11,10,57,44,13,56
Dundee Utd,3884,4,15,10,11,52,41,11,55
Queen of S't,3884,5,11,10,15,44,48,-4,43
Dumbarton,3884,6,10,13,13,46,52,-6,43
Dunfermline,3884,7,10,12,14,46,52,-6,42
Raith,3884,8,11,9,16,36,49,-13,42
St Mirren,3884,9,9,11,16,44,57,-13,38
Ayr,3884,10,6,11,19,29,58,-29,29
Hibernian,3885,1,20,11,5,57,24,33,71
Falkirk,3885,2,17,10,9,59,41,18,61
Morton,3885,3,15,13,8,54,43,11,58
Dundee Utd,3885,4,15,11,10,53,45,8,56
Dunfermline,3885,5,11,13,12,50,48,2,46
Queen of S't,3885,6,12,9,15,46,51,-5,45
St Mirren,3885,7,9,11,16,42,56,-14,38
Ayr,3885,8,9,11,16,39,58,-19,38
Raith,3885,9,9,10,17,34,53,-19,37
Dumbarton,3885,10,8,11,17,48,63,-15,35
Hibernian,3886,1,20,13,3,56,23,33,73
Dundee Utd,3886,2,19,8,9,60,37,23,65
Falkirk,3886,3,17,9,10,60,42,18,60
Morton,3886,4,14,12,10,47,41,6,54
Queen of S't,3886,5,12,8,16,44,50,-6,44
Raith,3886,6,12,8,16,39,50,-11,44
Dumbarton,3886,7,9,12,15,43,55,-12,39
Dunfermline,3886,8,8,14,14,47,54,-7,38
St Mirren,3886,9,9,9,18,41,59,-18,36
Ayr,3886,10,7,13,16,31,57,-26,34
Hibernian,3887,1,20,11,5,57,26,31,71
Morton,3887,2,18,10,8,53,39,14,64
Dundee Utd,3887,3,17,10,9,53,39,14,61
Falkirk,3887,4,16,11,9,57,41,16,59
Raith,3887,5,12,9,15,35,47,-12,45
Dunfermline,3887,6,10,13,13,46,47,-1,43
Queen of S't,3887,7,9,10,17,43,56,-13,37
St Mirren,3887,8,9,9,18,38,55,-17,36
Ayr,3887,9,8,12,16,37,55,-18,36
Dumbarton,3887,10,8,11,17,45,59,-14,35
Hibernian,3888,1,21,11,4,58,24,34,74
Falkirk,3888,2,17,11,8,62,40,22,62
Morton,3888,3,16,13,7,48,34,14,61
Dundee Utd,3888,4,17,10,9,53,42,11,61
Queen of S't,3888,5,11,11,14,45,50,-5,44
St Mirren,3888,6,9,11,16,44,59,-15,38
Dunfermline,3888,7,8,13,15,47,55,-8,37
Dumbarton,3888,8,8,12,16,47,62,-15,36
Raith,3888,9,9,9,18,35,52,-17,36
Ayr,3888,10,8,11,17,35,56,-21,35
Hibernian,3889,1,18,12,6,54,28,26,66
Morton,3889,2,16,12,8,47,39,8,60
Dundee Utd,3889,3,15,12,9,53,43,10,57
Falkirk,3889,4,14,13,9,57,43,14,55
Queen of S't,3889,5,11,11,14,49,51,-2,44
Dunfermline,3889,6,10,14,12,44,47,-3,44
Dumbarton,3889,7,10,10,16,50,60,-10,40
St Mirren,3889,8,10,9,17,41,53,-12,39
Raith,3889,9,10,9,17,39,52,-13,39
Ayr,3889,10,9,12,15,39,57,-18,39
Hibernian,3890,1,20,12,4,54,25,29,72
Falkirk,3890,2,16,12,8,61,38,23,60
Dundee Utd,3890,3,16,10,10,55,43,12,58
Morton,3890,4,15,12,9,48,39,9,57
Queen of S't,3890,5,12,8,16,45,56,-11,44
Raith,3890,6,11,9,16,39,50,-11,42
St Mirren,3890,7,10,9,17,43,56,-13,39
Dumbarton,3890,8,8,14,14,45,55,-10,38
Ayr,3890,9,8,13,15,36,58,-22,37
Dunfermline,3890,10,7,15,14,42,48,-6,36
Hibernian,3891,1,18,14,4,57,26,31,68
Morton,3891,2,17,11,8,54,37,17,62
Falkirk,3891,3,16,11,9,55,38,17,59
Dundee Utd,3891,4,14,10,12,51,43,8,52
Queen of S't,3891,5,12,9,15,43,50,-7,45
Dumbarton,3891,6,10,11,15,48,59,-11,41
Raith,3891,7,10,10,16,34,49,-15,40
Dunfermline,3891,8,9,12,15,43,50,-7,39
St Mirren,3891,9,9,12,15,39,53,-14,39
Ayr,3891,10,9,12,15,39,58,-19,39
Hibernian,3892,1,18,13,5,57,31,26,67
Morton,3892,2,18,10,8,55,37,18,64
Falkirk,3892,3,15,9,12,57,44,13,54
Dundee Utd,3892,4,14,10,12,48,45,3,52
Dunfermline,3892,5,13,11,12,49,45,4,50
Queen of S't,3892,6,12,9,15,47,51,-4,45
Raith,3892,7,11,9,16,37,50,-13,42
Dumbarton,3892,8,10,10,16,48,59,-11,40
Ayr,3892,9,9,11,16,38,58,-20,38
St Mirren,3892,10,8,12,16,38,54,-16,36
Hibernian,3893,1,18,13,5,53,26,27,67
Morton,3893,2,17,12,7,51,37,14,63
Falkirk,3893,3,16,11,9,60,39,21,59
Dundee Utd,3893,4,15,9,12,50,46,4,54
Queen of S't,3893,5,11,12,13,48,50,-2,45
Dunfermline,3893,6,10,13,13,43,45,-2,43
Ayr,3893,7,10,11,15,41,55,-14,41
Dumbarton,3893,8,9,12,15,48,62,-14,39
Raith,3893,9,10,9,17,36,54,-18,39
St Mirren,3893,10,8,10,18,39,55,-16,34
Hibernian,3894,1,20,12,4,58,26,32,72
Morton,3894,2,16,13,7,49,34,15,61
Falkirk,3894,3,17,9,10,60,42,18,60
Dundee Utd,3894,4,16,11,9,49,34,15,59
Queen of S't,3894,5,13,10,13,49,47,2,49
Dunfermline,3894,6,11,11,14,44,52,-8,44
Raith,3894,7,10,9,17,32,48,-16,39
St Mirren,3894,8,9,10,17,41,57,-16,37
Dumbarton,3894,9,8,10,18,46,62,-16,34
Ayr,3894,10,7,11,18,31,57,-26,32
Hibernian,3895,1,18,13,5,55,26,29,67
Dundee Utd,3895,2,17,11,8,51,39,12,62
Morton,3895,3,16,12,8,48,41,7,60
Falkirk,3895,4,15,13,8,56,37,19,58
Queen of S't,3895,5,12,9,15,46,50,-4,45
Ayr,3895,6,10,12,14,43,55,-12,42
Raith,3895,7,10,11,15,36,48,-12,41
Dumbarton,3895,8,9,12,15,46,57,-11,39
Dunfermline,3895,9,8,14,14,41,45,-4,38
St Mirren,3895,10,6,11,19,37,61,-24,29
Hibernian,3896,1,20,13,3,58,25,33,73
Morton,3896,2,18,11,7,48,32,16,65
Dundee Utd,3896,3,16,11,9,52,41,11,59
Falkirk,3896,4,16,10,10,59,42,17,58
Queen of S't,3896,5,13,9,14,52,51,1,48
Raith,3896,6,11,9,16,36,48,-12,42
Dunfermline,3896,7,9,12,15,48,53,-5,39
St Mirren,3896,8,8,11,17,38,55,-17,35
Ayr,3896,9,8,11,17,33,58,-25,35
Dumbarton,3896,10,7,11,18,44,63,-19,32
Hibernian,3897,1,21,10,5,64,26,38,73
Falkirk,3897,2,17,9,10,66,45,21,60
Morton,3897,3,14,14,8,42,36,6,56
Dundee Utd,3897,4,14,10,12,49,43,6,52
Queen of S't,3897,5,12,9,15,47,51,-4,45
Dumbarton,3897,6,11,11,14,51,55,-4,44
Dunfermline,3897,7,9,13,14,43,50,-7,40
Ayr,3897,8,9,12,15,34,53,-19,39
St Mirren,3897,9,9,11,16,40,54,-14,38
Raith,3897,10,9,11,16,33,56,-23,38
Hibernian,3898,1,19,11,6,60,32,28,68
Dundee Utd,3898,2,17,10,9,52,35,17,61
Morton,3898,3,17,10,9,53,43,10,61
Falkirk,3898,4,15,12,9,60,44,16,57
Dunfermline,3898,5,11,13,12,46,45,1,46
Raith,3898,6,12,8,16,37,51,-14,44
Queen of S't,3898,7,11,10,15,42,49,-7,43
Dumbarton,3898,8,8,12,16,47,58,-11,36
Ayr,3898,9,8,12,16,36,57,-21,36
St Mirren,3898,10,8,10,18,39,58,-19,34
Morton,3899,1,20,9,7,56,33,23,69
Hibernian,3899,2,17,13,6,51,27,24,64
Falkirk,3899,3,16,12,8,59,40,19,60
Dundee Utd,3899,4,14,9,13,46,47,-1,51
Queen of S't,3899,5,12,10,14,45,49,-4,46
Dunfermline,3899,6,10,14,12,48,50,-2,44
St Mirren,3899,7,10,11,15,44,54,-10,41
Dumbarton,3899,8,9,12,15,48,57,-9,39
Raith,3899,9,9,11,16,36,51,-15,38
Ayr,3899,10,7,11,18,33,58,-25,32
Hibernian,3900,1,19,13,4,54,22,32,70
Dundee Utd,3900,2,17,9,10,50,35,15,60
Morton,3900,3,16,12,8,48,36,12,60
Falkirk,3900,4,16,11,9,58,40,18,59
Queen of S't,3900,5,11,11,14,39,45,-6,44
Ayr,3900,6,10,11,15,34,52,-18,41
St Mirren,3900,7,10,9,17,45,56,-11,39
Dunfermline,3900,8,8,14,14,44,51,-7,38
Dumbarton,3900,9,8,13,15,47,60,-13,37
Raith,3900,10,9,9,18,35,57,-22,36
Hibernian,3901,1,19,12,5,55,24,31,69
Morton,3901,2,18,11,7,58,37,21,65
Falkirk,3901,3,15,12,9,55,41,14,57
Dundee Utd,3901,4,14,11,11,47,44,3,53
Queen of S't,3901,5,14,10,12,48,44,4,52
Dunfermline,3901,6,11,11,14,50,48,2,44
Ayr,3901,7,9,12,15,36,55,-19,39
Dumbarton,3901,8,9,11,16,49,61,-12,38
St Mirren,3901,9,8,10,18,38,58,-20,34
Raith,3901,10,8,10,18,34,58,-24,34
Morton,3902,1,21,9,6,57,31,26,72
Falkirk,3902,2,18,10,8,62,38,24,64
Hibernian,3902,3,16,15,5,55,31,24,63
Dundee Utd,3902,4,15,8,13,47,43,4,53
Queen of S't,3902,5,12,10,14,49,53,-4,46
Raith,3902,6,11,10,15,37,49,-12,43
Dumbarton,3902,7,10,10,16,49,58,-9,40
Ayr,3902,8,9,12,15,35,53,-18,39
Dunfermline,3902,9,8,12,16,43,56,-13,36
St Mirren,3902,10,6,12,18,35,57,-22,30
Hibernian,3903,1,18,12,6,51,24,27,66
Morton,3903,2,16,10,10,51,41,10,58
Falkirk,3903,3,14,13,9,53,37,16,55
Dundee Utd,3903,4,14,11,11,52,44,8,53
Dunfermline,3903,5,11,14,11,50,48,2,47
Queen of S't,3903,6,11,10,15,44,48,-4,43
St Mirren,3903,7,10,12,14,41,52,-11,42
Raith,3903,8,11,9,16,35,48,-13,42
Ayr,3903,9,10,11,15,36,54,-18,41
Dumbarton,3903,10,8,12,16,48,65,-17,36
Hibernian,3904,1,22,10,4,65,25,40,76
Morton,3904,2,18,9,9,55,42,13,63
Falkirk,3904,3,17,10,9,58,41,17,61
Dundee Utd,3904,4,17,10,9,53,38,15,61
Queen of S't,3904,5,11,9,16,41,48,-7,42
Raith,3904,6,10,10,16,34,48,-14,40
Ayr,3904,7,9,12,15,36,54,-18,39
St Mirren,3904,8,9,10,17,40,61,-21,37
Dumbarton,3904,9,8,12,16,44,57,-13,36
Dunfermline,3904,10,7,12,17,43,55,-12,33
Morton,3905,1,21,10,5,56,31,25,73
Hibernian,3905,2,18,13,5,51,24,27,67
Dundee Utd,3905,3,16,10,10,50,37,13,58
Falkirk,3905,4,14,13,9,58,42,16,55
Queen of S't,3905,5,13,10,13,49,47,2,49
Dunfermline,3905,6,9,13,14,45,52,-7,40
Dumbarton,3905,7,9,12,15,48,61,-13,39
Ayr,3905,8,8,11,17,32,55,-23,35
St Mirren,3905,9,8,10,18,37,57,-20,34
Raith,3905,10,8,10,18,31,51,-20,34
Hibernian,3906,1,21,10,5,58,26,32,73
Falkirk,3906,2,18,9,9,67,40,27,63
Dundee Utd,3906,3,18,9,9,56,38,18,63
Morton,3906,4,16,11,9,47,36,11,59
Dunfermline,3906,5,10,14,12,47,47,0,44
Queen of S't,3906,6,11,10,15,46,53,-7,43
Raith,3906,7,10,10,16,35,50,-15,40
St Mirren,3906,8,8,12,16,41,58,-17,36
Ayr,3906,9,7,12,17,37,66,-29,33
Dumbarton,3906,10,7,11,18,44,64,-20,32
Hibernian,3907,1,17,13,6,51,27,24,64
Falkirk,3907,2,17,11,8,57,36,21,62
Morton,3907,3,17,11,8,55,37,18,62
Dundee Utd,3907,4,15,10,11,52,43,9,55
Queen of S't,3907,5,13,9,14,47,49,-2,48
Dunfermline,3907,6,10,12,14,48,51,-3,42
Ayr,3907,7,9,13,14,37,51,-14,40
St Mirren,3907,8,10,9,17,44,56,-12,39
Raith,3907,9,10,9,17,37,55,-18,39
Dumbarton,3907,10,8,11,17,47,70,-23,35
Hibernian,3908,1,19,10,7,53,28,25,67
Morton,3908,2,16,12,8,46,34,12,60
Falkirk,3908,3,16,9,11,58,44,14,57
Dundee Utd,3908,4,14,10,12,51,45,6,52
Queen of S't,3908,5,13,8,15,53,52,1,47
Raith,3908,6,12,8,16,39,50,-11,44
St Mirren,3908,7,11,10,15,42,54,-12,43
Ayr,3908,8,10,13,13,37,51,-14,43
Dunfermline,3908,9,8,14,14,41,48,-7,38
Dumbarton,3908,10,8,12,16,49,63,-14,36
Hibernian,3909,1,22,10,4,60,25,35,76
Morton,3909,2,18,10,8,49,35,14,64
Falkirk,3909,3,15,10,11,53,42,11,55
Dundee Utd,3909,4,15,10,11,51,42,9,55
Queen of S't,3909,5,12,10,14,48,52,-4,46
Raith,3909,6,12,9,15,37,46,-9,45
Ayr,3909,7,8,14,14,37,53,-16,38
Dunfermline,3909,8,8,13,15,47,55,-8,37
Dumbarton,3909,9,8,12,16,47,62,-15,36
St Mirren,3909,10,7,12,17,37,54,-17,33
Hibernian,3910,1,19,11,6,54,30,24,68
Falkirk,3910,2,16,12,8,63,43,20,60
Dundee Utd,3910,3,15,12,9,52,41,11,57
Morton,3910,4,15,12,9,48,37,11,57
Raith,3910,5,11,11,14,41,49,-8,44
Queen of S't,3910,6,11,10,15,47,52,-5,43
Dunfermline,3910,7,9,15,12,49,51,-2,42
Dumbarton,3910,8,10,12,14,50,56,-6,42
Ayr,3910,9,7,14,15,33,55,-22,35
St Mirren,3910,10,7,11,18,38,61,-23,32
Hibernian,3911,1,20,11,5,56,25,31,71
Falkirk,3911,2,16,11,9,58,36,22,59
Dundee Utd,3911,3,15,11,10,48,40,8,56
Morton,3911,4,15,10,11,47,41,6,55
Queen of S't,3911,5,11,11,14,41,46,-5,44
Ayr,3911,6,10,12,14,36,52,-16,42
St Mirren,3911,7,10,11,15,37,49,-12,41
Dunfermline,3911,8,9,12,15,44,54,-10,39
Raith,3911,9,10,9,17,40,55,-15,39
Dumbarton,3911,10,8,14,14,45,54,-9,38
Hibernian,3912,1,19,11,6,53,27,26,68
Falkirk,3912,2,18,10,8,64,40,24,64
Morton,3912,3,17,12,7,50,32,18,63
Dundee Utd,3912,4,15,11,10,52,42,10,56
Queen of S't,3912,5,11,10,15,42,48,-6,43
Raith,3912,6,11,9,16,35,50,-15,42
St Mirren,3912,7,10,10,16,43,56,-13,40
Dunfermline,3912,8,8,15,13,39,44,-5,39
Dumbarton,3912,9,8,11,17,43,60,-17,35
Ayr,3912,10,7,13,16,31,53,-22,34
Morton,3913,1,20,10,6,61,36,25,70
Falkirk,3913,2,20,9,7,66,37,29,69
Hibernian,3913,3,18,11,7,58,29,29,65
Dundee Utd,3913,4,15,9,12,49,45,4,54
Queen of S't,3913,5,13,9,14,50,51,-1,48
Dunfermline,3913,6,9,11,16,44,52,-8,38
Dumbarton,3913,7,9,11,16,46,58,-12,38
St Mirren,3913,8,9,10,17,42,63,-21,37
Ayr,3913,9,7,14,15,34,58,-24,35
Raith,3913,10,8,10,18,34,55,-21,34
Morton,3914,1,18,11,7,52,38,14,65
Dundee Utd,3914,2,18,9,9,55,39,16,63
Hibernian,3914,3,16,13,7,50,30,20,61
Falkirk,3914,4,16,12,8,62,44,18,60
Dumbarton,3914,5,10,13,13,56,63,-7,43
Dunfermline,3914,6,10,12,14,49,50,-1,42
Queen of S't,3914,7,11,9,16,43,53,-10,42
Ayr,3914,8,9,11,16,38,52,-14,38
Raith,3914,9,9,11,16,34,48,-14,38
St Mirren,3914,10,7,11,18,41,63,-22,32
Hibernian,3915,1,20,11,5,59,28,31,71
Falkirk,3915,2,20,9,7,62,33,29,69
Morton,3915,3,17,10,9,53,42,11,61
Dundee Utd,3915,4,16,8,12,49,38,11,56
Dumbarton,3915,5,10,13,13,49,53,-4,43
Dunfermline,3915,6,10,12,14,47,51,-4,42
Queen of S't,3915,7,10,10,16,41,51,-10,40
St Mirren,3915,8,9,10,17,41,58,-17,37
Ayr,3915,9,7,13,16,34,57,-23,34
Raith,3915,10,8,10,18,31,55,-24,34
Hibernian,3916,1,18,12,6,50,27,23,66
Morton,3916,2,19,9,8,54,34,20,66
Falkirk,3916,3,18,9,9,62,39,23,63
Dundee Utd,3916,4,16,10,10,54,41,13,58
Queen of S't,3916,5,12,9,15,42,46,-4,45
Dunfermline,3916,6,11,11,14,48,49,-1,44
St Mirren,3916,7,9,11,16,41,56,-15,38
Ayr,3916,8,8,13,15,34,55,-21,37
Raith,3916,9,9,9,18,31,52,-21,36
Dumbarton,3916,10,8,11,17,46,63,-17,35
Hibernian,3917,1,21,12,3,61,22,39,75
Morton,3917,2,17,10,9,54,38,16,61
Falkirk,3917,3,14,12,10,55,44,11,54
Dundee Utd,3917,4,14,12,10,50,43,7,54
Dumbarton,3917,5,11,11,14,49,50,-1,44
Raith,3917,6,11,9,16,36,48,-12,42
Dunfermline,3917,7,9,14,13,50,58,-8,41
Ayr,3917,8,9,12,15,32,53,-21,39
Queen of S't,3917,9,10,8,18,41,56,-15,38
St Mirren,3917,10,8,12,16,39,55,-16,36
Hibernian,3918,1,19,12,5,57,30,27,69
Morton,3918,2,18,12,6,51,36,15,66
Falkirk,3918,3,16,10,10,58,39,19,58
Dundee Utd,3918,4,14,9,13,47,44,3,51
Dunfermline,3918,5,12,12,12,52,47,5,48
Ayr,3918,6,10,11,15,35,51,-16,41
Dumbarton,3918,7,10,10,16,50,59,-9,40
St Mirren,3918,8,10,9,17,41,54,-13,39
Queen of S't,3918,9,10,9,17,44,60,-16,39
Raith,3918,10,10,8,18,36,51,-15,38
Hibernian,3919,1,19,10,7,51,26,25,67
Morton,3919,2,17,12,7,53,37,16,63
Falkirk,3919,3,17,11,8,65,42,23,62
Dundee Utd,3919,4,15,10,11,52,44,8,55
Dunfermline,3919,5,11,13,12,52,48,4,46
Queen of S't,3919,6,11,11,14,45,49,-4,44
St Mirren,3919,7,9,11,16,44,54,-10,38
Dumbarton,3919,8,8,14,14,47,58,-11,38
Raith,3919,9,9,9,18,30,54,-24,36
Ayr,3919,10,8,11,17,31,58,-27,35
Hibernian,3920,1,19,12,5,54,25,29,69
Morton,3920,2,17,11,8,52,34,18,62
Falkirk,3920,3,13,13,10,54,44,10,52
Dundee Utd,3920,4,13,12,11,46,43,3,51
Dunfermline,3920,5,12,14,10,46,41,5,50
Queen of S't,3920,6,14,8,14,44,45,-1,50
Raith,3920,7,10,9,17,34,47,-13,39
St Mirren,3920,8,9,11,16,41,59,-18,38
Dumbarton,3920,9,8,12,16,42,54,-12,36
Ayr,3920,10,8,12,16,32,53,-21,36
Hibernian,3921,1,20,11,5,56,27,29,71
Falkirk,3921,2,18,10,8,61,39,22,64
Morton,3921,3,17,11,8,51,39,12,62
Dundee Utd,3921,4,16,11,9,53,38,15,59
Dunfermline,3921,5,11,13,12,48,45,3,46
Queen of S't,3921,6,10,11,15,46,52,-6,41
Dumbarton,3921,7,10,10,16,48,62,-14,40
Raith,3921,8,10,9,17,35,50,-15,39
Ayr,3921,9,8,11,17,37,56,-19,35
St Mirren,3921,10,7,9,20,35,62,-27,30
Hibernian,3922,1,19,12,5,56,24,32,69
Morton,3922,2,18,11,7,52,36,16,65
Falkirk,3922,3,17,10,9,61,41,20,61
Dundee Utd,3922,4,14,12,10,46,42,4,54
Queen of S't,3922,5,12,9,15,45,54,-9,45
Dunfermline,3922,6,9,13,14,48,50,-2,40
Ayr,3922,7,9,12,15,34,52,-18,39
Dumbarton,3922,8,8,14,14,47,56,-9,38
Raith,3922,9,10,8,18,32,50,-18,38
St Mirren,3922,10,9,9,18,42,58,-16,36
Hibernian,3923,1,19,14,3,61,26,35,71
Morton,3923,2,18,12,6,53,33,20,66
Falkirk,3923,3,15,12,9,58,40,18,57
Dundee Utd,3923,4,15,11,10,50,42,8,56
Queen of S't,3923,5,12,11,13,47,46,1,47
Raith,3923,6,11,10,15,34,50,-16,43
Dunfermline,3923,7,9,13,14,44,48,-4,40
Dumbarton,3923,8,9,10,17,49,61,-12,37
St Mirren,3923,9,7,12,17,40,62,-22,33
Ayr,3923,10,6,13,17,34,62,-28,31
Hibernian,3924,1,20,10,6,55,27,28,70
Morton,3924,2,18,11,7,48,31,17,65
Dundee Utd,3924,3,18,9,9,51,35,16,63
Falkirk,3924,4,15,10,11,54,41,13,55
Dunfermline,3924,5,12,12,12,47,45,2,48
Queen of S't,3924,6,11,10,15,47,51,-4,43
Raith,3924,7,10,10,16,34,50,-16,40
St Mirren,3924,8,8,11,17,39,58,-19,35
Ayr,3924,9,8,11,17,32,52,-20,35
Dumbarton,3924,10,8,10,18,44,61,-17,34
Hibernian,3925,1,20,13,3,55,23,32,73
Falkirk,3925,2,17,11,8,59,37,22,62
Dundee Utd,3925,3,16,11,9,57,41,16,59
Morton,3925,4,16,11,9,47,36,11,59
Queen of S't,3925,5,12,10,14,47,54,-7,46
Dunfermline,3925,6,9,13,14,46,51,-5,40
Raith,3925,7,10,10,16,36,51,-15,40
St Mirren,3925,8,9,11,16,42,55,-13,38
Dumbarton,3925,9,8,10,18,45,58,-13,34
Ayr,3925,10,6,14,16,28,56,-28,32
Hibernian,3926,1,19,12,5,60,25,35,69
Morton,3926,2,17,10,9,52,41,11,61
Dundee Utd,3926,3,16,11,9,51,39,12,59
Falkirk,3926,4,13,13,10,48,38,10,52
Queen of S't,3926,5,13,10,13,45,49,-4,49
St Mirren,3926,6,11,10,15,41,53,-12,43
Dunfermline,3926,7,9,14,13,46,48,-2,41
Ayr,3926,8,9,11,16,38,54,-16,38
Raith,3926,9,9,9,18,34,56,-22,36
Dumbarton,3926,10,7,14,15,44,56,-12,35
Hibernian,3927,1,22,10,4,61,22,39,76
Morton,3927,2,16,10,10,45,39,6,58
Falkirk,3927,3,16,9,11,58,45,13,57
Dundee Utd,3927,4,16,8,12,50,43,7,56
Queen of S't,3927,5,13,8,15,46,47,-1,47
Dunfermline,3927,6,11,12,13,44,44,0,45
Raith,3927,7,12,8,16,35,48,-13,44
Dumbarton,3927,8,10,12,14,45,53,-8,42
Ayr,3927,9,7,13,16,32,56,-24,34
St Mirren,3927,10,7,10,19,38,57,-19,31
Hibernian,3928,1,19,12,5,56,24,32,69
Falkirk,3928,2,17,11,8,55,36,19,62
Morton,3928,3,16,11,9,46,37,9,59
Dundee Utd,3928,4,16,9,11,51,42,9,57
Ayr,3928,5,12,10,14,41,53,-12,46
Dunfermline,3928,6,10,14,12,46,47,-1,44
Queen of S't,3928,7,11,9,16,45,53,-8,42
Raith,3928,8,11,8,17,36,50,-14,41
Dumbarton,3928,9,8,13,15,44,57,-13,37
St Mirren,3928,10,7,9,20,37,58,-21,30
Hibernian,3929,1,22,11,3,64,25,39,77
Morton,3929,2,18,11,7,53,40,13,65
Falkirk,3929,3,16,11,9,60,40,20,59
Dundee Utd,3929,4,15,10,11,48,39,9,55
Queen of S't,3929,5,11,9,16,47,58,-11,42
Dunfermline,3929,6,9,14,13,45,49,-4,41
Dumbarton,3929,7,9,12,15,45,57,-12,39
Raith,3929,8,10,8,18,36,52,-16,38
Ayr,3929,9,8,12,16,37,58,-21,36
St Mirren,3929,10,8,10,18,39,56,-17,34
Hibernian,3930,1,18,12,6,51,25,26,66
Dundee Utd,3930,2,17,11,8,58,39,19,62
Morton,3930,3,16,12,8,51,37,14,60
Falkirk,3930,4,16,9,11,59,43,16,57
Queen of S't,3930,5,11,11,14,45,52,-7,44
Dunfermline,3930,6,10,13,13,50,54,-4,43
Raith,3930,7,10,10,16,35,49,-14,40
Dumbarton,3930,8,9,12,15,49,58,-9,39
St Mirren,3930,9,9,10,17,41,61,-20,37
Ayr,3930,10,7,14,15,35,56,-21,35
Hibernian,3931,1,19,12,5,57,28,29,69
Dundee Utd,3931,2,17,11,8,53,38,15,62
Falkirk,3931,3,16,10,10,64,43,21,58
Morton,3931,4,15,11,10,50,44,6,56
Dumbarton,3931,5,11,11,14,48,57,-9,44
Dunfermline,3931,6,10,12,14,50,51,-1,42
Queen of S't,3931,7,11,9,16,45,54,-9,42
Raith,3931,8,10,10,16,39,53,-14,40
St Mirren,3931,9,9,12,15,44,56,-12,39
Ayr,3931,10,7,12,17,32,58,-26,33
Hibernian,3932,1,20,11,5,54,29,25,71
Falkirk,3932,2,18,9,9,64,38,26,63
Dundee Utd,3932,3,17,10,9,59,45,14,61
Morton,3932,4,15,13,8,50,38,12,58
Dunfermline,3932,5,11,12,13,49,49,0,45
Ayr,3932,6,9,15,12,38,53,-15,42
Queen of S't,3932,7,11,8,17,43,55,-12,41
Dumbarton,3932,8,8,12,16,46,60,-14,36
Raith,3932,9,9,9,18,35,52,-17,36
St Mirren,3932,10,7,11,18,37,56,-19,32
Morton,3933,1,17,13,6,51,33,18,64
Hibernian,3933,2,17,11,8,52,31,21,62
Falkirk,3933,3,17,10,9,61,41,20,61
Dundee Utd,3933,4,16,11,9,52,38,14,59
Dunfermline,3933,5,11,13,12,49,49,0,46
Queen of S't,3933,6,12,8,16,47,52,-5,44
St Mirren,3933,7,10,11,15,38,52,-14,41
Ayr,3933,8,8,13,15,34,56,-22,37
Raith,3933,9,8,11,17,34,51,-17,35
Dumbarton,3933,10,7,13,16,46,61,-15,34
Hibernian,3934,1,19,11,6,57,31,26,68
Morton,3934,2,18,11,7,54,38,16,65
Falkirk,3934,3,17,11,8,63,41,22,62
Dundee Utd,3934,4,17,9,10,54,40,14,60
Raith,3934,5,12,10,14,39,47,-8,46
Queen of S't,3934,6,12,8,16,45,52,-7,44
Dunfermline,3934,7,9,13,14,44,51,-7,40
Dumbarton,3934,8,9,11,16,46,58,-12,38
Ayr,3934,9,7,12,17,33,57,-24,33
St Mirren,3934,10,7,10,19,38,58,-20,31
Hibernian,3935,1,19,11,6,54,25,29,68
Falkirk,3935,2,17,10,9,63,38,25,61
Morton,3935,3,17,10,9,51,37,14,61
Dunfermline,3935,4,13,12,11,51,46,5,51
Dundee Utd,3935,5,13,11,12,46,47,-1,50
Queen of S't,3935,6,13,9,14,44,44,0,48
Ayr,3935,7,10,12,14,32,48,-16,42
Dumbarton,3935,8,10,11,15,49,56,-7,41
Raith,3935,9,8,10,18,29,50,-21,34
St Mirren,3935,10,6,12,18,34,62,-28,30
Hibernian,3936,1,17,16,3,56,28,28,67
Morton,3936,2,17,13,6,57,35,22,64
Falkirk,3936,3,17,11,8,65,38,27,62
Dundee Utd,3936,4,14,11,11,47,41,6,53
Dunfermline,3936,5,10,13,13,47,52,-5,43
Dumbarton,3936,6,10,12,14,51,62,-11,42
Queen of S't,3936,7,10,11,15,45,53,-8,41
Ayr,3936,8,8,14,14,34,51,-17,38
Raith,3936,9,8,12,16,33,54,-21,36
St Mirren,3936,10,7,11,18,36,57,-21,32
Morton,3937,1,20,9,7,54,32,22,69
Hibernian,3937,2,18,13,5,56,30,26,67
Dundee Utd,3937,3,17,9,10,55,38,17,60
Falkirk,3937,4,14,11,11,54,41,13,53
Dunfermline,3937,5,11,12,13,50,50,0,45
Queen of S't,3937,6,12,9,15,45,48,-3,45
Raith,3937,7,11,10,15,35,47,-12,43
St Mirren,3937,8,9,11,16,41,55,-14,38
Dumbarton,3937,9,9,10,17,46,66,-20,37
Ayr,3937,10,6,12,18,30,59,-29,30
Hibernian,3938,1,22,10,4,60,26,34,76
Falkirk,3938,2,16,10,10,58,40,18,58
Morton,3938,3,15,12,9,46,35,11,57
Dundee Utd,3938,4,14,11,11,49,44,5,53
Dunfermline,3938,5,10,15,11,48,46,2,45
Dumbarton,3938,6,11,12,13,54,59,-5,45
Queen of S't,3938,7,11,10,15,46,52,-6,43
St Mirren,3938,8,9,10,17,41,57,-16,37
Ayr,3938,9,8,12,16,38,57,-19,36
Raith,3938,10,9,8,19,35,59,-24,35
Hibernian,3939,1,19,14,3,56,23,33,71
Falkirk,3939,2,16,10,10,57,42,15,58
Dundee Utd,3939,3,16,10,10,50,39,11,58
Morton,3939,4,14,12,10,50,44,6,54
Queen of S't,3939,5,12,9,15,47,52,-5,45
Dunfermline,3939,6,10,13,13,48,49,-1,43
Raith,3939,7,11,10,15,42,49,-7,43
Dumbarton,3939,8,9,12,15,50,61,-11,39
Ayr,3939,9,9,12,15,32,55,-23,39
St Mirren,3939,10,8,10,18,41,59,-18,34
Hibernian,3940,1,17,15,4,56,29,27,66
Morton,3940,2,17,11,8,49,35,14,62
Falkirk,3940,3,17,10,9,61,40,21,61
Dundee Utd,3940,4,17,10,9,54,40,14,61
Dunfermline,3940,5,10,13,13,49,52,-3,43
Raith,3940,6,10,11,15,35,46,-11,41
Queen of S't,3940,7,10,9,17,42,56,-14,39
Ayr,3940,8,8,15,13,33,50,-17,39
Dumbarton,3940,9,8,11,17,49,62,-13,35
St Mirren,3940,10,8,11,17,35,53,-18,35
Hibernian,3941,1,20,13,3,58,24,34,73
Dundee Utd,3941,2,18,8,10,51,39,12,62
Falkirk,3941,3,17,10,9,58,38,20,61
Morton,3941,4,14,11,11,48,47,1,53
Dunfermline,3941,5,11,12,13,48,48,0,45
Dumbarton,3941,6,11,12,13,48,53,-5,45
Raith,3941,7,10,10,16,38,50,-12,40
Queen of S't,3941,8,10,9,17,41,51,-10,39
Ayr,3941,9,7,13,16,36,58,-22,34
St Mirren,3941,10,7,12,17,35,53,-18,33
Hibernian,3942,1,18,14,4,58,28,30,68
Dundee Utd,3942,2,17,11,8,56,35,21,62
Morton,3942,3,16,13,7,50,35,15,61
Falkirk,3942,4,14,13,9,51,36,15,55
Dumbarton,3942,5,11,11,14,45,54,-9,44
Dunfermline,3942,6,10,12,14,42,47,-5,42
Raith,3942,7,11,8,17,38,53,-15,41
Ayr,3942,8,10,11,15,35,55,-20,41
Queen of S't,3942,9,9,11,16,42,51,-9,38
St Mirren,3942,10,6,12,18,38,61,-23,30
Hibernian,3943,1,20,13,3,63,28,35,73
Morton,3943,2,15,12,9,51,37,14,57
Dundee Utd,3943,3,15,11,10,54,40,14,56
Falkirk,3943,4,14,12,10,56,43,13,54
Queen of S't,3943,5,11,12,13,47,48,-1,45
Dunfermline,3943,6,10,14,12,44,45,-1,44
Dumbarton,3943,7,10,10,16,48,67,-19,40
Ayr,3943,8,9,13,14,36,55,-19,40
Raith,3943,9,9,11,16,37,56,-19,38
St Mirren,3943,10,7,12,17,42,59,-17,33
Hibernian,3944,1,23,10,3,60,20,40,79
Morton,3944,2,17,12,7,48,32,16,63
Falkirk,3944,3,17,9,10,61,41,20,60
Dundee Utd,3944,4,16,9,11,47,36,11,57
Queen of S't,3944,5,12,9,15,45,53,-8,45
Dunfermline,3944,6,9,14,13,42,48,-6,41
Dumbarton,3944,7,9,12,15,49,58,-9,39
Ayr,3944,8,8,13,15,33,54,-21,37
Raith,3944,9,8,11,17,33,55,-22,35
St Mirren,3944,10,7,9,20,39,60,-21,30
Hibernian,3945,1,18,13,5,56,25,31,67
Morton,3945,2,17,13,6,50,34,16,64
Falkirk,3945,3,15,10,11,54,42,12,55
Dundee Utd,3945,4,15,10,11,48,37,11,55
Queen of S't,3945,5,13,9,14,48,51,-3,48
Raith,3945,6,12,9,15,37,46,-9,45
Dunfermline,3945,7,9,13,14,46,51,-5,40
Ayr,3945,8,9,12,15,37,54,-17,39
Dumbarton,3945,9,8,13,15,49,60,-11,37
St Mirren,3945,10,8,10,18,36,61,-25,34
Hibernian,3946,1,19,11,6,55,27,28,68
Morton,3946,2,17,11,8,50,34,16,62
Falkirk,3946,3,15,12,9,59,42,17,57
Dundee Utd,3946,4,15,8,13,49,42,7,53
Dunfermline,3946,5,12,13,11,49,44,5,49
Dumbarton,3946,6,11,12,13,51,56,-5,45
Queen of S't,3946,7,11,10,15,45,54,-9,43
Raith,3946,8,11,8,17,34,50,-16,41
Ayr,3946,9,8,11,17,37,64,-27,35
St Mirren,3946,10,8,10,18,43,59,-16,34
Hibernian,3947,1,19,11,6,59,32,27,68
Morton,3947,2,17,10,9,55,40,15,61
Falkirk,3947,3,16,11,9,57,41,16,59
Dundee Utd,3947,4,15,11,10,47,38,9,56
Queen of S't,3947,5,13,9,14,47,49,-2,48
Dunfermline,3947,6,9,13,14,44,52,-8,40
Dumbarton,3947,7,9,12,15,52,61,-9,39
St Mirren,3947,8,9,11,16,41,54,-13,38
Raith,3947,9,9,11,16,33,47,-14,38
Ayr,3947,10,8,13,15,33,54,-21,37
Hibernian,3948,1,20,11,5,62,27,35,71
Morton,3948,2,17,11,8,55,41,14,62
Dundee Utd,3948,3,17,10,9,56,40,16,61
Falkirk,3948,4,16,10,10,54,37,17,58
Queen of S't,3948,5,12,10,14,45,54,-9,46
Dunfermline,3948,6,11,12,13,49,48,1,45
Ayr,3948,7,9,12,15,32,52,-20,39
Raith,3948,8,10,8,18,35,52,-17,38
St Mirren,3948,9,8,10,18,38,57,-19,34
Dumbarton,3948,10,7,12,17,47,65,-18,33
Hibernian,3949,1,19,12,5,53,24,29,69
Morton,3949,2,16,14,6,50,35,15,62
Dundee Utd,3949,3,16,11,9,49,36,13,59
Falkirk,3949,4,16,9,11,60,42,18,57
Queen of S't,3949,5,12,10,14,45,53,-8,46
Dunfermline,3949,6,10,13,13,48,49,-1,43
Raith,3949,7,11,8,17,38,52,-14,41
Ayr,3949,8,9,11,16,38,57,-19,38
Dumbarton,3949,9,8,12,16,46,60,-14,36
St Mirren,3949,10,8,10,18,38,57,-19,34
Hibernian,3950,1,19,13,4,56,24,32,70
Falkirk,3950,2,18,10,8,63,43,20,64
Morton,3950,3,14,13,9,48,43,5,55
Dundee Utd,3950,4,14,12,10,49,42,7,54
Queen of S't,3950,5,11,11,14,45,49,-4,44
Raith,3950,6,11,11,14,41,50,-9,44
Dunfermline,3950,7,9,14,13,45,46,-1,41
St Mirren,3950,8,10,10,16,43,56,-13,40
Dumbarton,3950,9,9,11,16,49,61,-12,38
Ayr,3950,10,6,13,17,31,56,-25,31
Hibernian,3951,1,18,14,4,55,27,28,68
Falkirk,3951,2,17,11,8,60,40,20,62
Dundee Utd,3951,3,16,10,10,50,39,11,58
Morton,3951,4,14,12,10,46,40,6,54
Queen of S't,3951,5,12,12,12,46,46,0,48
Ayr,3951,6,10,11,15,37,53,-16,41
Dunfermline,3951,7,9,13,14,43,46,-3,40
Dumbarton,3951,8,9,12,15,49,61,-12,39
Raith,3951,9,10,9,17,37,53,-16,39
St Mirren,3951,10,8,10,18,40,58,-18,34
Morton,3952,1,20,10,6,54,32,22,70
Hibernian,3952,2,19,12,5,60,29,31,69
Falkirk,3952,3,15,9,12,56,43,13,54
Dundee Utd,3952,4,15,9,12,52,40,12,54
Dumbarton,3952,5,11,13,12,51,54,-3,46
Queen of S't,3952,6,11,9,16,43,50,-7,42
Ayr,3952,7,10,12,14,38,53,-15,42
Dunfermline,3952,8,9,13,14,42,50,-8,40
Raith,3952,9,9,11,16,32,52,-20,38
St Mirren,3952,10,7,10,19,33,58,-25,31
Hibernian,3953,1,20,12,4,55,23,32,72
Falkirk,3953,2,18,11,7,64,38,26,65
Morton,3953,3,16,12,8,47,36,11,60
Dundee Utd,3953,4,15,12,9,53,38,15,57
Queen of S't,3953,5,11,10,15,48,54,-6,43
Dunfermline,3953,6,10,12,14,52,52,0,42
Ayr,3953,7,9,14,13,38,51,-13,41
Raith,3953,8,10,9,17,33,49,-16,39
St Mirren,3953,9,8,10,18,36,55,-19,34
Dumbarton,3953,10,7,10,19,43,73,-30,31
Hibernian,3954,1,19,12,5,52,25,27,69
Falkirk,3954,2,17,11,8,57,34,23,62
Morton,3954,3,17,11,8,49,34,15,62
Dundee Utd,3954,4,16,10,10,48,36,12,58
Queen of S't,3954,5,12,10,14,48,51,-3,46
Raith,3954,6,10,11,15,38,48,-10,41
Ayr,3954,7,9,12,15,36,55,-19,39
Dunfermline,3954,8,8,12,16,45,55,-10,36
St Mirren,3954,9,8,12,16,38,53,-15,36
Dumbarton,3954,10,8,11,17,48,68,-20,35
Hibernian,3955,1,20,11,5,59,25,34,71
Morton,3955,2,18,9,9,52,37,15,63
Falkirk,3955,3,17,10,9,62,43,19,61
Dundee Utd,3955,4,16,9,11,50,41,9,57
Dunfermline,3955,5,12,12,12,52,50,2,48
Queen of S't,3955,6,10,12,14,49,55,-6,42
Ayr,3955,7,10,10,16,36,54,-18,40
Raith,3955,8,10,9,17,31,51,-20,39
Dumbarton,3955,9,8,11,17,43,57,-14,35
St Mirren,3955,10,8,9,19,39,60,-21,33
Hibernian,3956,1,19,11,6,53,27,26,68
Morton,3956,2,17,11,8,52,35,17,62
Dundee Utd,3956,3,17,9,10,53,40,13,60
Falkirk,3956,4,14,11,11,59,49,10,53
Ayr,3956,5,11,12,13,34,48,-14,45
Queen of S't,3956,6,10,13,13,44,50,-6,43
Dunfermline,3956,7,9,14,13,49,51,-2,41
Raith,3956,8,10,11,15,41,52,-11,41
Dumbarton,3956,9,10,10,16,46,56,-10,40
St Mirren,3956,10,7,10,19,38,61,-23,31
Hibernian,3957,1,20,11,5,61,30,31,71
Dundee Utd,3957,2,17,9,10,50,35,15,60
Morton,3957,3,16,12,8,50,38,12,60
Falkirk,3957,4,14,13,9,58,45,13,55
Queen of S't,3957,5,15,8,13,50,50,0,53
Dunfermline,3957,6,10,11,15,46,50,-4,41
Raith,3957,7,10,10,16,38,50,-12,40
Ayr,3957,8,8,13,15,33,52,-19,37
St Mirren,3957,9,8,11,17,39,60,-21,35
Dumbarton,3957,10,7,12,17,47,62,-15,33
Hibernian,3958,1,19,14,3,55,23,32,71
Morton,3958,2,17,11,8,52,36,16,62
Falkirk,3958,3,16,11,9,58,41,17,59
Dundee Utd,3958,4,15,10,11,48,41,7,55
Queen of S't,3958,5,11,12,13,43,47,-4,45
Raith,3958,6,11,10,15,35,43,-8,43
Dunfermline,3958,7,9,15,12,45,47,-2,42
St Mirren,3958,8,9,9,18,45,59,-14,36
Dumbarton,3958,9,8,11,17,47,64,-17,35
Ayr,3958,10,7,13,16,37,64,-27,34
Hibernian,3959,1,22,11,3,62,24,38,77
Falkirk,3959,2,16,10,10,55,41,14,58
Dundee Utd,3959,3,16,9,11,48,37,11,57
Morton,3959,4,14,12,10,45,40,5,54
Dunfermline,3959,5,13,11,12,54,49,5,50
Queen of S't,3959,6,11,10,15,45,51,-6,43
Ayr,3959,7,10,12,14,40,56,-16,42
Raith,3959,8,10,9,17,35,53,-18,39
Dumbarton,3959,9,7,13,16,47,60,-13,34
St Mirren,3959,10,8,9,19,38,58,-20,33
Hibernian,3960,1,20,10,6,55,26,29,70
Falkirk,3960,2,18,11,7,61,37,24,65
Morton,3960,3,17,11,8,53,40,13,62
Dundee Utd,3960,4,17,8,11,54,41,13,59
Dunfermline,3960,5,10,13,13,48,48,0,43
Queen of S't,3960,6,11,9,16,45,53,-8,42
Dumbarton,3960,7,8,14,14,46,57,-11,38
Raith,3960,8,9,10,17,32,51,-19,37
St Mirren,3960,9,8,11,17,41,58,-17,35
Ayr,3960,10,8,11,17,30,54,-24,35
Hibernian,3961,1,19,13,4,57,23,34,70
Falkirk,3961,2,16,11,9,56,37,19,59
Morton,3961,3,16,10,10,51,47,4,58
Dundee Utd,3961,4,14,11,11,50,41,9,53
Dunfermline,3961,5,11,13,12,50,47,3,46
Dumbarton,3961,6,10,12,14,54,55,-1,42
Raith,3961,7,10,12,14,40,49,-9,42
Queen of S't,3961,8,11,9,16,41,52,-11,42
Ayr,3961,9,9,13,14,37,56,-19,40
St Mirren,3961,10,7,10,19,33,62,-29,31
Hibernian,3962,1,20,13,3,61,27,34,73
Falkirk,3962,2,18,11,7,64,40,24,65
Morton,3962,3,16,12,8,53,44,9,60
Dundee Utd,3962,4,16,11,9,54,42,12,59
Queen of S't,3962,5,12,9,15,47,52,-5,45
Dumbarton,3962,6,9,13,14,49,60,-11,40
Raith,3962,7,9,10,17,31,50,-19,37
Dunfermline,3962,8,8,12,16,46,54,-8,36
St Mirren,3962,9,8,10,18,46,61,-15,34
Ayr,3962,10,7,13,16,34,55,-21,34
Hibernian,3963,1,19,10,7,55,26,29,67
Morton,3963,2,16,10,10,47,41,6,58
Falkirk,3963,3,15,11,10,54,43,11,56
Dundee Utd,3963,4,15,10,11,53,43,10,55
Queen of S't,3963,5,13,9,14,45,45,0,48
Dumbarton,3963,6,10,12,14,49,56,-7,42
St Mirren,3963,7,11,9,16,44,53,-9,42
Dunfermline,3963,8,9,14,13,44,47,-3,41
Raith,3963,9,11,8,17,32,46,-14,41
Ayr,3963,10,9,11,16,32,55,-23,38
Hibernian,3964,1,20,11,5,57,29,28,71
Morton,3964,2,19,11,6,56,35,21,68
Dundee Utd,3964,3,16,10,10,50,41,9,58
Falkirk,3964,4,15,11,10,53,40,13,56
Ayr,3964,5,11,11,14,38,54,-16,44
Raith,3964,6,11,9,16,37,48,-11,42
Queen of S't,3964,7,10,10,16,41,49,-8,40
Dumbarton,3964,8,9,10,17,47,58,-11,37
Dunfermline,3964,9,7,15,14,41,48,-7,36
St Mirren,3964,10,8,10,18,39,57,-18,34
Hibernian,3965,1,19,11,6,60,27,33,68
Morton,3965,2,17,11,8,47,36,11,62
Dundee Utd,3965,3,15,10,11,49,42,7,55
Falkirk,3965,4,14,12,10,57,43,14,54
Dunfermline,3965,5,11,15,10,48,44,4,48
Raith,3965,6,11,9,16,34,50,-16,42
Queen of S't,3965,7,10,11,15,46,53,-7,41
Ayr,3965,8,9,12,15,37,54,-17,39
Dumbarton,3965,9,8,14,14,50,59,-9,38
St Mirren,3965,10,9,9,18,37,57,-20,36
Hibernian,3966,1,21,12,3,60,25,35,75
Morton,3966,2,15,12,9,49,38,11,57
Dundee Utd,3966,3,15,10,11,47,44,3,55
Falkirk,3966,4,14,12,10,56,44,12,54
Queen of S't,3966,5,15,8,13,51,46,5,53
Dunfermline,3966,6,10,14,12,47,46,1,44
Dumbarton,3966,7,11,10,15,52,57,-5,43
Ayr,3966,8,10,11,15,33,50,-17,41
Raith,3966,9,9,8,19,35,55,-20,35
St Mirren,3966,10,6,11,19,34,59,-25,29
Hibernian,3967,1,19,12,5,54,24,30,69
Falkirk,3967,2,17,10,9,59,39,20,61
Dundee Utd,3967,3,17,10,9,58,39,19,61
Morton,3967,4,15,12,9,47,36,11,57
Dunfermline,3967,5,9,15,12,42,47,-5,42
Queen of S't,3967,6,10,12,14,40,49,-9,42
Raith,3967,7,11,9,16,34,46,-12,42
Ayr,3967,8,10,11,15,32,51,-19,41
Dumbarton,3967,9,8,11,17,42,60,-18,35
St Mirren,3967,10,8,10,18,42,59,-17,34
Hibernian,3968,1,17,16,3,53,25,28,67
Dundee Utd,3968,2,16,11,9,55,40,15,59
Morton,3968,3,14,13,9,43,37,6,55
Falkirk,3968,4,14,11,11,57,47,10,53
Queen of S't,3968,5,11,11,14,43,49,-6,44
Dunfermline,3968,6,10,13,13,49,48,1,43
Ayr,3968,7,10,13,13,36,52,-16,43
Dumbarton,3968,8,10,11,15,49,57,-8,41
Raith,3968,9,10,11,15,35,48,-13,41
St Mirren,3968,10,7,12,17,41,58,-17,33
Hibernian,3969,1,19,12,5,60,28,32,69
Dundee Utd,3969,2,17,9,10,47,39,8,60
Falkirk,3969,3,16,11,9,55,39,16,59
Morton,3969,4,14,12,10,45,40,5,54
Queen of S't,3969,5,13,8,15,45,46,-1,47
Raith,3969,6,11,10,15,33,44,-11,43
Dunfermline,3969,7,9,14,13,44,48,-4,41
St Mirren,3969,8,10,11,15,40,50,-10,41
Dumbarton,3969,9,9,11,16,48,59,-11,38
Ayr,3969,10,7,12,17,30,54,-24,33
Hibernian,3970,1,21,12,3,57,22,35,75
Falkirk,3970,2,15,11,10,59,45,14,56
Dundee Utd,3970,3,15,9,12,48,41,7,54
Morton,3970,4,14,11,11,45,38,7,53
Queen of S't,3970,5,13,10,13,47,48,-1,49
Raith,3970,6,11,12,13,37,45,-8,45
Dunfermline,3970,7,10,11,15,45,49,-4,41
Dumbarton,3970,8,10,11,15,45,55,-10,41
St Mirren,3970,9,9,10,17,42,59,-17,37
Ayr,3970,10,8,11,17,32,55,-23,35
Hibernian,3971,1,18,12,6,52,27,25,66
Morton,3971,2,18,12,6,53,35,18,66
Falkirk,3971,3,16,11,9,61,40,21,59
Dundee Utd,3971,4,14,10,12,45,42,3,52
Dunfermline,3971,5,12,12,12,54,50,4,48
Queen of S't,3971,6,11,11,14,49,53,-4,44
Dumbarton,3971,7,9,13,14,48,57,-9,40
Ayr,3971,8,9,13,14,33,50,-17,40
Raith,3971,9,9,10,17,38,52,-14,37
St Mirren,3971,10,7,10,19,36,63,-27,31
Hibernian,3972,1,19,12,5,57,27,30,69
Dundee Utd,3972,2,16,9,11,54,40,14,57
Falkirk,3972,3,15,11,10,60,44,16,56
Morton,3972,4,15,11,10,47,45,2,56
Dunfermline,3972,5,12,12,12,52,45,7,48
Queen of S't,3972,6,12,11,13,45,50,-5,47
Dumbarton,3972,7,11,11,14,51,59,-8,44
Raith,3972,8,11,9,16,42,51,-9,42
Ayr,3972,9,8,12,16,33,56,-23,36
St Mirren,3972,10,7,10,19,37,61,-24,31
Hibernian,3973,1,20,12,4,60,26,34,72
Morton,3973,2,16,11,9,50,38,12,59
Dundee Utd,3973,3,17,8,11,47,39,8,59
Falkirk,3973,4,15,11,10,57,42,15,56
Queen of S't,3973,5,13,9,14,45,46,-1,48
Dunfermline,3973,6,10,12,14,45,52,-7,42
Raith,3973,7,10,11,15,35,48,-13,41
Dumbarton,3973,8,8,15,13,47,55,-8,39
Ayr,3973,9,8,13,15,30,49,-19,37
St Mirren,3973,10,7,10,19,39,60,-21,31
Hibernian,3974,1,20,11,5,59,23,36,71
Morton,3974,2,17,10,9,55,37,18,61
Dundee Utd,3974,3,17,9,10,50,36,14,60
Falkirk,3974,4,16,11,9,62,42,20,59
Queen of S't,3974,5,13,9,14,47,49,-2,48
Dunfermline,3974,6,10,13,13,43,48,-5,43
Raith,3974,7,10,10,16,34,47,-13,40
Dumbarton,3974,8,8,12,16,46,67,-21,36
St Mirren,3974,9,9,9,18,41,64,-23,36
Ayr,3974,10,7,12,17,37,61,-24,33
Hibernian,3975,1,20,12,4,54,23,31,72
Dundee Utd,3975,2,17,8,11,54,39,15,59
Morton,3975,3,15,11,10,50,45,5,56
Falkirk,3975,4,14,13,9,56,42,14,55
Dumbarton,3975,5,11,12,13,51,55,-4,45
Ayr,3975,6,11,11,14,37,54,-17,44
Raith,3975,7,10,11,15,37,49,-12,41
Queen of S't,3975,8,10,10,16,46,54,-8,40
St Mirren,3975,9,9,10,17,41,55,-14,37
Dunfermline,3975,10,8,12,16,44,54,-10,36
Hibernian,3976,1,18,11,7,53,26,27,65
Morton,3976,2,18,10,8,55,38,17,64
Falkirk,3976,3,17,10,9,63,44,19,61
Dundee Utd,3976,4,16,11,9,51,43,8,59
Queen of S't,3976,5,13,8,15,52,53,-1,47
Raith,3976,6,10,11,15,39,50,-11,41
Dunfermline,3976,7,9,13,14,43,49,-6,40
Dumbarton,3976,8,9,11,16,47,63,-16,38
St Mirren,3976,9,9,10,17,45,58,-13,37
Ayr,3976,10,8,11,17,33,57,-24,35
Hibernian,3977,1,20,12,4,56,25,31,72
Falkirk,3977,2,16,11,9,59,41,18,59
Dundee Utd,3977,3,16,9,11,47,39,8,57
Morton,3977,4,15,9,12,50,43,7,54
Queen of S't,3977,5,12,12,12,50,50,0,48
Dunfermline,3977,6,10,13,13,44,48,-4,43
Dumbarton,3977,7,9,14,13,44,50,-6,41
Raith,3977,8,10,9,17,38,53,-15,39
St Mirren,3977,9,9,10,17,39,56,-17,37
Ayr,3977,10,8,11,17,36,58,-22,35
Hibernian,3978,1,19,13,4,56,27,29,70
Morton,3978,2,17,12,7,54,37,17,63
Dundee Utd,3978,3,17,9,10,53,37,16,60
Falkirk,3978,4,14,13,9,56,42,14,55
Queen of S't,3978,5,12,10,14,49,53,-4,46
Dunfermline,3978,6,9,13,14,46,51,-5,40
Dumbarton,3978,7,9,13,14,49,60,-11,40
Raith,3978,8,9,10,17,35,51,-16,37
St Mirren,3978,9,8,12,16,36,55,-19,36
Ayr,3978,10,7,13,16,32,53,-21,34
Hibernian,3979,1,18,13,5,51,25,26,67
Falkirk,3979,2,17,10,9,60,41,19,61
Dundee Utd,3979,3,17,9,10,49,38,11,60
Morton,3979,4,16,11,9,51,38,13,59
Raith,3979,5,12,9,15,39,47,-8,45
Queen of S't,3979,6,11,9,16,44,50,-6,42
Dunfermline,3979,7,9,14,13,42,50,-8,41
Dumbarton,3979,8,9,11,16,48,58,-10,38
Ayr,3979,9,9,11,16,35,55,-20,38
St Mirren,3979,10,8,11,17,40,57,-17,35
Morton,3980,1,19,10,7,52,30,22,67
Hibernian,3980,2,18,12,6,50,24,26,66
Dundee Utd,3980,3,18,9,9,56,39,17,63
Falkirk,3980,4,16,12,8,59,40,19,60
Queen of S't,3980,5,11,9,16,46,53,-7,42
Dunfermline,3980,6,8,15,13,44,51,-7,39
St Mirren,3980,7,9,11,16,44,58,-14,38
Raith,3980,8,9,11,16,34,50,-16,38
Dumbarton,3980,9,9,10,17,46,62,-16,37
Ayr,3980,10,8,11,17,32,56,-24,35
Hibernian,3981,1,18,13,5,59,29,30,67
Falkirk,3981,2,17,10,9,59,40,19,61
Morton,3981,3,16,12,8,51,43,8,60
Dundee Utd,3981,4,16,10,10,51,39,12,58
Dunfermline,3981,5,10,14,12,51,48,3,44
Dumbarton,3981,6,10,12,14,47,58,-11,42
Raith,3981,7,10,11,15,39,51,-12,41
Ayr,3981,8,9,12,15,36,56,-20,39
Queen of S't,3981,9,9,11,16,44,56,-12,38
St Mirren,3981,10,8,9,19,40,57,-17,33
Hibernian,3982,1,18,13,5,55,26,29,67
Dundee Utd,3982,2,19,8,9,58,38,20,65
Morton,3982,3,17,11,8,48,38,10,62
Falkirk,3982,4,15,10,11,56,45,11,55
Dunfermline,3982,5,10,14,12,49,49,0,44
Queen of S't,3982,6,11,11,14,46,49,-3,44
Raith,3982,7,8,14,14,38,51,-13,38
Dumbarton,3982,8,8,13,15,45,58,-13,37
St Mirren,3982,9,8,12,16,42,59,-17,36
Ayr,3982,10,7,12,17,33,57,-24,33
Hibernian,3983,1,23,10,3,63,22,41,79
Falkirk,3983,2,16,9,11,62,45,17,57
Morton,3983,3,14,14,8,46,37,9,56
Dundee Utd,3983,4,15,11,10,47,39,8,56
Queen of S't,3983,5,13,9,14,47,48,-1,48
Dunfermline,3983,6,10,14,12,41,43,-2,44
Ayr,3983,7,9,11,16,33,53,-20,38
Dumbarton,3983,8,8,13,15,45,60,-15,37
St Mirren,3983,9,8,11,17,41,57,-16,35
Raith,3983,10,8,10,18,33,54,-21,34
Hibernian,3984,1,18,13,5,54,30,24,67
Falkirk,3984,2,16,12,8,57,36,21,60
Morton,3984,3,15,13,8,49,37,12,58
Dundee Utd,3984,4,16,10,10,52,41,11,58
Queen of S't,3984,5,14,8,14,49,53,-4,50
Raith,3984,6,10,11,15,41,49,-8,41
Dunfermline,3984,7,8,16,12,44,47,-3,40
St Mirren,3984,8,9,12,15,39,49,-10,39
Ayr,3984,9,8,13,15,34,58,-24,37
Dumbarton,3984,10,7,10,19,46,65,-19,31
Morton,3985,1,21,9,6,54,34,20,72
Hibernian,3985,2,17,14,5,50,24,26,65
Falkirk,3985,3,15,11,10,62,40,22,56
Dundee Utd,3985,4,15,8,13,45,42,3,53
Queen of S't,3985,5,11,12,13,44,46,-2,45
Raith,3985,6,12,9,15,35,47,-12,45
Dunfermline,3985,7,9,15,12,42,45,-3,42
Dumbarton,3985,8,9,12,15,50,61,-11,39
St Mirren,3985,9,8,11,17,38,54,-16,35
Ayr,3985,10,7,11,18,31,58,-27,32
Morton,3986,1,20,10,6,53,31,22,70
Falkirk,3986,2,17,12,7,60,37,23,63
Hibernian,3986,3,16,12,8,48,31,17,60
Dundee Utd,3986,4,14,8,14,45,45,0,50
Dunfermline,3986,5,9,15,12,44,45,-1,42
Dumbarton,3986,6,10,12,14,46,52,-6,42
Ayr,3986,7,10,11,15,36,51,-15,41
Queen of S't,3986,8,10,10,16,40,48,-8,40
St Mirren,3986,9,9,12,15,41,52,-11,39
Raith,3986,10,9,10,17,30,51,-21,37
Hibernian,3987,1,18,13,5,55,30,25,67
Morton,3987,2,17,11,8,50,36,14,62
Falkirk,3987,3,15,12,9,58,42,16,57
Dundee Utd,3987,4,16,8,12,47,40,7,56
Dunfermline,3987,5,12,13,11,50,44,6,49
Queen of S't,3987,6,11,12,13,42,48,-6,45
Dumbarton,3987,7,10,12,14,52,57,-5,42
Ayr,3987,8,9,14,13,35,49,-14,41
Raith,3987,9,9,10,17,34,50,-16,37
St Mirren,3987,10,6,9,21,32,59,-27,27
Hibernian,3988,1,20,13,3,55,22,33,73
Morton,3988,2,17,13,6,51,36,15,64
Dundee Utd,3988,3,16,10,10,59,42,17,58
Falkirk,3988,4,14,11,11,51,42,9,53
Queen of S't,3988,5,12,8,16,45,51,-6,44
Dumbarton,3988,6,10,11,15,50,59,-9,41
Raith,3988,7,10,10,16,33,45,-12,40
Dunfermline,3988,8,8,14,14,42,53,-11,38
St Mirren,3988,9,9,10,17,40,56,-16,37
Ayr,3988,10,9,10,17,39,59,-20,37
Hibernian,3989,1,21,12,3,56,23,33,75
Falkirk,3989,2,16,12,8,58,38,20,60
Morton,3989,3,16,11,9,48,36,12,59
Dundee Utd,3989,4,15,10,11,52,43,9,55
Queen of S't,3989,5,12,8,16,43,50,-7,44
Raith,3989,6,11,10,15,39,50,-11,43
Dunfermline,3989,7,8,15,13,44,50,-6,39
Dumbarton,3989,8,9,11,16,51,63,-12,38
Ayr,3989,9,8,12,16,35,54,-19,36
St Mirren,3989,10,8,11,17,42,61,-19,35
Hibernian,3990,1,19,12,5,54,24,30,69
Morton,3990,2,16,14,6,49,31,18,62
Falkirk,3990,3,17,9,10,58,41,17,60
Dundee Utd,3990,4,15,9,12,47,41,6,54
Dunfermline,3990,5,10,13,13,42,47,-5,43
Queen of S't,3990,6,10,11,15,43,50,-7,41
St Mirren,3990,7,10,11,15,39,50,-11,41
Raith,3990,8,10,10,16,31,44,-13,40
Dumbarton,3990,9,8,13,15,50,62,-12,37
Ayr,3990,10,8,12,16,32,55,-23,36
Hibernian,3991,1,18,14,4,57,29,28,68
Dundee Utd,3991,2,17,10,9,48,37,11,61
Falkirk,3991,3,15,13,8,56,36,20,58
Morton,3991,4,15,13,8,49,40,9,58
Dunfermline,3991,5,10,14,12,45,45,0,44
Raith,3991,6,12,8,16,37,49,-12,44
Queen of S't,3991,7,10,11,15,44,52,-8,41
Dumbarton,3991,8,9,11,16,49,58,-9,38
St Mirren,3991,9,8,12,16,43,56,-13,36
Ayr,3991,10,7,12,17,31,57,-26,33
Hibernian,3992,1,21,10,5,57,28,29,73
Morton,3992,2,18,12,6,55,35,20,66
Dundee Utd,3992,3,19,9,8,56,38,18,66
Falkirk,3992,4,15,10,11,58,41,17,55
Queen of S't,3992,5,11,11,14,44,51,-7,44
Dunfermline,3992,6,10,13,13,48,48,0,43
Raith,3992,7,9,11,16,36,53,-17,38
Dumbarton,3992,8,8,11,17,49,69,-20,35
St Mirren,3992,9,7,12,17,42,57,-15,33
Ayr,3992,10,6,13,17,32,57,-25,31
Hibernian,3993,1,20,12,4,55,24,31,72
Morton,3993,2,18,9,9,53,36,17,63
Dundee Utd,3993,3,16,10,10,50,41,9,58
Falkirk,3993,4,14,12,10,59,46,13,54
Queen of S't,3993,5,11,11,14,45,51,-6,44
Raith,3993,6,12,8,16,38,51,-13,44
Dunfermline,3993,7,9,14,13,49,52,-3,41
St Mirren,3993,8,9,10,17,42,55,-13,37
Dumbarton,3993,9,8,12,16,44,60,-16,36
Ayr,3993,10,8,12,16,34,53,-19,36
Hibernian,3994,1,16,14,6,52,30,22,62
Morton,3994,2,16,13,7,53,38,15,61
Dundee Utd,3994,3,15,10,11,51,47,4,55
Falkirk,3994,4,13,13,10,53,42,11,52
Dunfermline,3994,5,11,13,12,53,52,1,46
Queen of S't,3994,6,12,10,14,45,48,-3,46
Raith,3994,7,10,13,13,39,47,-8,43
Dumbarton,3994,8,10,11,15,49,56,-7,41
Ayr,3994,9,9,11,16,36,54,-18,38
St Mirren,3994,10,9,10,17,41,58,-17,37
Hibernian,3995,1,20,12,4,57,27,30,72
Morton,3995,2,18,9,9,52,34,18,63
Falkirk,3995,3,17,9,10,58,41,17,60
Dundee Utd,3995,4,16,8,12,50,42,8,56
Queen of S't,3995,5,12,11,13,50,49,1,47
Dunfermline,3995,6,10,13,13,44,50,-6,43
Raith,3995,7,11,9,16,36,50,-14,42
Dumbarton,3995,8,8,13,15,41,52,-11,37
Ayr,3995,9,7,13,16,30,55,-25,34
St Mirren,3995,10,7,11,18,37,55,-18,32
Hibernian,3996,1,19,14,3,57,24,33,71
Falkirk,3996,2,17,11,8,59,39,20,62
Morton,3996,3,16,12,8,49,38,11,60
Dundee Utd,3996,4,15,9,12,45,40,5,54
Queen of S't,3996,5,13,9,14,45,45,0,48
Ayr,3996,6,9,13,14,35,52,-17,40
Dumbarton,3996,7,8,14,14,51,61,-10,38
Dunfermline,3996,8,8,13,15,45,53,-8,37
Raith,3996,9,9,10,17,34,49,-15,37
St Mirren,3996,10,8,11,17,37,56,-19,35
Hibernian,3997,1,19,12,5,61,29,32,69
Dundee Utd,3997,2,19,8,9,58,40,18,65
Falkirk,3997,3,16,12,8,61,39,22,60
Morton,3997,4,14,11,11,45,42,3,53
Dunfermline,3997,5,11,13,12,44,44,0,46
Queen of S't,3997,6,11,11,14,47,52,-5,44
Dumbarton,3997,7,10,12,14,46,54,-8,42
Raith,3997,8,9,11,16,30,46,-16,38
St Mirren,3997,9,8,11,17,40,59,-19,35
Ayr,3997,10,7,11,18,32,59,-27,32
Hibernian,3998,1,18,12,6,55,32,23,66
Morton,3998,2,17,11,8,50,35,15,62
Falkirk,3998,3,17,9,10,60,38,22,60
Dundee Utd,3998,4,14,10,12,45,41,4,52
Raith,3998,5,12,10,14,38,45,-7,46
Queen of S't,3998,6,12,9,15,46,52,-6,45
Dumbarton,3998,7,11,11,14,50,55,-5,44
St Mirren,3998,8,11,10,15,42,49,-7,43
Dunfermline,3998,9,10,11,15,44,55,-11,41
Ayr,3998,10,6,11,19,32,60,-28,29
Morton,3999,1,19,10,7,52,33,19,67
Hibernian,3999,2,17,14,5,50,25,25,65
Falkirk,3999,3,16,12,8,59,40,19,60
Dundee Utd,3999,4,15,8,13,45,40,5,53
Ayr,3999,5,11,12,13,40,51,-11,45
Dunfermline,3999,6,10,13,13,43,45,-2,43
Queen of S't,3999,7,11,8,17,45,51,-6,41
St Mirren,3999,8,9,11,16,43,57,-14,38
Raith,3999,9,9,10,17,38,54,-16,37
Dumbarton,3999,10,9,10,17,45,64,-19,37
Hibernian,4000,1,18,12,6,55,33,22,66
Dundee Utd,4000,2,18,9,9,51,36,15,63
Morton,4000,3,17,11,8,54,36,18,62
Falkirk,4000,4,16,10,10,60,41,19,58
Queen of S't,4000,5,15,8,13,46,45,1,53
Raith,4000,6,10,11,15,37,47,-10,41
Dumbarton,4000,7,9,11,16,45,58,-13,38
Dunfermline,4000,8,8,12,16,40,49,-9,36
Ayr,4000,9,8,12,16,36,57,-21,36
St Mirren,4000,10,7,12,17,34,56,-22,33
Hibernian,4001,1,19,10,7,57,29,28,67
Morton,4001,2,17,13,6,53,36,17,64
Falkirk,4001,3,17,10,9,64,45,19,61
Dundee Utd,4001,4,14,12,10,51,44,7,54
Queen of S't,4001,5,14,8,14,49,50,-1,50
Dunfermline,4001,6,10,14,12,49,45,4,44
St Mirren,4001,7,9,10,17,46,55,-9,37
Ayr,4001,8,9,10,17,36,61,-25,37
Raith,4001,9,9,10,17,34,59,-25,37
Dumbarton,4001,10,8,11,17,48,63,-15,35
Hibernian,4002,1,18,13,5,54,29,25,67
Morton,4002,2,18,13,5,51,29,22,67
Dundee Utd,4002,3,16,9,11,55,42,13,57
Falkirk,4002,4,15,10,11,62,49,13,55
Dunfermline,4002,5,11,14,11,47,45,2,47
Queen of S't,4002,6,12,9,15,48,52,-4,45
Raith,4002,7,11,9,16,33,46,-13,42
Dumbarton,4002,8,9,11,16,48,60,-12,38
St Mirren,4002,9,8,10,18,38,58,-20,34
Ayr,4002,10,8,10,18,34,60,-26,34
Hibernian,4003,1,19,13,4,59,26,33,70
Falkirk,4003,2,17,11,8,60,39,21,62
Morton,4003,3,16,11,9,49,38,11,59
Dundee Utd,4003,4,16,10,10,48,38,10,58
Ayr,4003,5,10,12,14,36,50,-14,42
Dumbarton,4003,6,10,11,15,48,55,-7,41
Dunfermline,4003,7,10,11,15,48,56,-8,41
Queen of S't,4003,8,10,9,17,43,53,-10,39
Raith,4003,9,9,12,15,36,51,-15,39
St Mirren,4003,10,8,10,18,36,57,-21,34
Hibernian,4004,1,19,14,3,57,23,34,71
Morton,4004,2,16,11,9,50,38,12,59
Falkirk,4004,3,16,10,10,58,45,13,58
Dundee Utd,4004,4,15,9,12,50,44,6,54
Dunfermline,4004,5,13,12,11,54,46,8,51
Queen of S't,4004,6,10,11,15,43,52,-9,41
St Mirren,4004,7,10,10,16,45,59,-14,40
Dumbarton,4004,8,9,12,15,46,57,-11,39
Raith,4004,9,10,9,17,35,51,-16,39
Ayr,4004,10,6,14,16,31,54,-23,32
Hibernian,4005,1,19,13,4,56,24,32,70
Morton,4005,2,16,13,7,51,41,10,61
Dundee Utd,4005,3,17,9,10,52,35,17,60
Falkirk,4005,4,16,11,9,59,41,18,59
Dunfermline,4005,5,10,15,11,53,49,4,45
Queen of S't,4005,6,11,8,17,40,54,-14,41
Raith,4005,7,10,10,16,37,51,-14,40
St Mirren,4005,8,8,12,16,40,54,-14,36
Ayr,4005,9,8,12,16,34,56,-22,36
Dumbarton,4005,10,8,11,17,45,62,-17,35
Hibernian,4006,1,21,10,5,59,25,34,73
Dundee Utd,4006,2,17,10,9,55,41,14,61
Morton,4006,3,17,10,9,48,39,9,61
Falkirk,4006,4,16,9,11,57,39,18,57
Queen of S't,4006,5,14,9,13,48,44,4,51
Dunfermline,4006,6,10,11,15,41,50,-9,41
St Mirren,4006,7,9,12,15,44,56,-12,39
Raith,4006,8,10,9,17,36,52,-16,39
Dumbarton,4006,9,9,10,17,48,59,-11,37
Ayr,4006,10,6,12,18,34,65,-31,30
Hibernian,4007,1,21,11,4,55,26,29,74
Morton,4007,2,17,11,8,49,34,15,62
Falkirk,4007,3,16,10,10,58,41,17,58
Dundee Utd,4007,4,14,9,13,46,44,2,51
Queen of S't,4007,5,13,8,15,45,47,-2,47
Raith,4007,6,12,8,16,34,45,-11,44
Dunfermline,4007,7,10,12,14,43,48,-5,42
Dumbarton,4007,8,9,11,16,46,55,-9,38
Ayr,4007,9,9,11,16,33,51,-18,38
St Mirren,4007,10,8,11,17,39,57,-18,35
Hibernian,4008,1,18,13,5,55,26,29,67
Falkirk,4008,2,17,11,8,56,37,19,62
Morton,4008,3,16,13,7,48,37,11,61
Dundee Utd,4008,4,16,11,9,51,39,12,59
Queen of S't,4008,5,11,11,14,44,53,-9,44
Dumbarton,4008,6,10,10,16,47,54,-7,40
Raith,4008,7,10,10,16,38,47,-9,40
Dunfermline,4008,8,8,15,13,44,51,-7,39
St Mirren,4008,9,8,11,17,36,53,-17,35
Ayr,4008,10,8,11,17,35,57,-22,35
Hibernian,4009,1,22,10,4,59,26,33,76
Morton,4009,2,18,11,7,54,36,18,65
Dundee Utd,4009,3,17,9,10,49,37,12,60
Falkirk,4009,4,14,10,12,59,46,13,52
Dunfermline,4009,5,12,11,13,49,47,2,47
Dumbarton,4009,6,11,10,15,49,57,-8,43
Raith,4009,7,9,12,15,35,48,-13,39
Queen of S't,4009,8,9,9,18,41,56,-15,36
St Mirren,4009,9,8,11,17,39,57,-18,35
Ayr,4009,10,7,13,16,32,56,-24,34
Morton,4010,1,17,12,7,54,35,19,63
Hibernian,4010,2,16,14,6,56,32,24,62
Dundee Utd,4010,3,17,10,9,52,35,17,61
Falkirk,4010,4,16,10,10,59,44,15,58
Queen of S't,4010,5,13,9,14,48,47,1,48
Raith,4010,6,13,8,15,43,50,-7,47
Dunfermline,4010,7,8,14,14,44,55,-11,38
St Mirren,4010,8,9,10,17,39,58,-19,37
Dumbarton,4010,9,8,12,16,44,58,-14,36
Ayr,4010,10,8,11,17,31,56,-25,35
Hibernian,4011,1,19,12,5,53,25,28,69
Morton,4011,2,18,11,7,51,34,17,65
Falkirk,4011,3,13,14,9,55,42,13,53
Dundee Utd,4011,4,14,10,12,44,38,6,52
Dunfermline,4011,5,11,12,13,46,51,-5,45
Queen of S't,4011,6,11,10,15,48,55,-7,43
Raith,4011,7,10,11,15,37,47,-10,41
Ayr,4011,8,10,11,15,39,52,-13,41
Dumbarton,4011,9,9,12,15,47,58,-11,39
St Mirren,4011,10,8,11,17,38,56,-18,35
Hibernian,4012,1,19,12,5,54,28,26,69
Morton,4012,2,17,11,8,46,34,12,62
Falkirk,4012,3,16,9,11,54,41,13,57
Dundee Utd,4012,4,16,8,12,53,42,11,56
Queen of S't,4012,5,13,8,15,46,47,-1,47
St Mirren,4012,6,11,10,15,42,51,-9,43
Dunfermline,4012,7,10,12,14,45,45,0,42
Dumbarton,4012,8,9,12,15,46,59,-13,39
Raith,4012,9,10,9,17,33,48,-15,39
Ayr,4012,10,7,13,16,28,52,-24,34
Hibernian,4013,1,18,12,6,53,27,26,66
Morton,4013,2,16,14,6,51,38,13,62
Falkirk,4013,3,16,10,10,58,41,17,58
Dundee Utd,4013,4,15,12,9,51,40,11,57
Dunfermline,4013,5,9,14,13,44,46,-2,41
Dumbarton,4013,6,9,13,14,47,56,-9,40
Queen of S't,4013,7,10,10,16,42,52,-10,40
Raith,4013,8,10,10,16,32,46,-14,40
Ayr,4013,9,8,15,13,35,51,-16,39
St Mirren,4013,10,8,12,16,41,57,-16,36
Hibernian,4014,1,18,12,6,61,27,34,66
Morton,4014,2,16,12,8,51,39,12,60
Falkirk,4014,3,16,9,11,58,45,13,57
Dundee Utd,4014,4,15,10,11,51,40,11,55
Queen of S't,4014,5,13,9,14,49,49,0,48
Ayr,4014,6,10,13,13,38,53,-15,43
Dunfermline,4014,7,10,12,14,46,55,-9,42
Dumbarton,4014,8,10,12,14,49,59,-10,42
Raith,4014,9,9,11,16,34,52,-18,38
St Mirren,4014,10,7,12,17,40,58,-18,33
Hibernian,4015,1,21,12,3,60,23,37,75
Dundee Utd,4015,2,17,9,10,52,40,12,60
Falkirk,4015,3,16,11,9,60,43,17,59
Morton,4015,4,15,12,9,51,38,13,57
Queen of S't,4015,5,12,9,15,45,48,-3,45
Dunfermline,4015,6,10,13,13,44,46,-2,43
Raith,4015,7,10,10,16,35,51,-16,40
St Mirren,4015,8,9,12,15,41,53,-12,39
Dumbarton,4015,9,8,12,16,48,61,-13,36
Ayr,4015,10,6,12,18,32,65,-33,30
Hibernian,4016,1,19,12,5,57,26,31,69
Dundee Utd,4016,2,16,11,9,51,40,11,59
Morton,4016,3,16,11,9,51,44,7,59
Falkirk,4016,4,15,12,9,58,41,17,57
Queen of S't,4016,5,13,9,14,44,47,-3,48
Dunfermline,4016,6,10,15,11,45,45,0,45
Raith,4016,7,11,8,17,37,48,-11,41
Dumbarton,4016,8,9,10,17,47,61,-14,37
Ayr,4016,9,8,12,16,37,56,-19,36
St Mirren,4016,10,8,10,18,40,59,-19,34
Hibernian,4017,1,19,12,5,52,24,28,69
Morton,4017,2,19,10,7,59,36,23,67
Falkirk,4017,3,18,9,9,67,43,24,63
Dundee Utd,4017,4,18,8,10,52,37,15,62
Dunfermline,4017,5,10,11,15,47,57,-10,41
Ayr,4017,6,10,10,16,35,58,-23,40
St Mirren,4017,7,9,11,16,43,51,-8,38
Queen of S't,4017,8,9,10,17,40,50,-10,37
Dumbarton,4017,9,8,12,16,48,62,-14,36
Raith,4017,10,9,9,18,32,57,-25,36
Hibernian,4018,1,18,12,6,54,27,27,66
Morton,4018,2,18,12,6,49,32,17,66
Falkirk,4018,3,17,11,8,62,40,22,62
Dundee Utd,4018,4,16,9,11,55,44,11,57
Dunfermline,4018,5,13,11,12,53,51,2,50
Queen of S't,4018,6,11,9,16,49,57,-8,42
Ayr,4018,7,9,12,15,34,53,-19,39
St Mirren,4018,8,9,9,18,41,56,-15,36
Raith,4018,9,9,8,19,32,52,-20,35
Dumbarton,4018,10,7,13,16,48,65,-17,34
Hibernian,4019,1,20,12,4,58,25,33,72
Falkirk,4019,2,16,11,9,58,41,17,59
Dundee Utd,4019,3,15,11,10,53,41,12,56
Morton,4019,4,14,13,9,45,38,7,55
Dunfermline,4019,5,12,13,11,52,49,3,49
Queen of S't,4019,6,11,9,16,43,50,-7,42
Ayr,4019,7,9,13,14,36,54,-18,40
Dumbarton,4019,8,9,11,16,47,63,-16,38
St Mirren,4019,9,9,10,17,46,57,-11,37
Raith,4019,10,9,9,18,33,53,-20,36
Hibernian,4020,1,19,12,5,59,29,30,69
Dundee Utd,4020,2,16,10,10,52,39,13,58
Morton,4020,3,16,10,10,52,43,9,58
Falkirk,4020,4,16,9,11,56,45,11,57
Dunfermline,4020,5,12,12,12,51,49,2,48
Raith,4020,6,11,9,16,37,51,-14,42
Queen of S't,4020,7,11,8,17,42,50,-8,41
Dumbarton,4020,8,9,12,15,48,57,-9,39
St Mirren,4020,9,8,13,15,36,49,-13,37
Ayr,4020,10,8,13,15,38,59,-21,37
Morton,4021,1,19,10,7,53,30,23,67
Hibernian,4021,2,18,12,6,52,30,22,66
Falkirk,4021,3,15,13,8,59,40,19,58
Dundee Utd,4021,4,15,12,9,49,38,11,57
Queen of S't,4021,5,11,9,16,42,49,-7,42
Dumbarton,4021,6,9,13,14,43,53,-10,40
Ayr,4021,7,9,13,14,32,49,-17,40
Dunfermline,4021,8,9,12,15,41,50,-9,39
Raith,4021,9,10,8,18,34,48,-14,38
St Mirren,4021,10,9,10,17,41,59,-18,37
Hibernian,4022,1,19,12,5,56,30,26,69
Morton,4022,2,17,11,8,52,34,18,62
Falkirk,4022,3,16,11,9,54,35,19,59
Dundee Utd,4022,4,16,9,11,52,41,11,57
Dumbarton,4022,5,11,11,14,52,58,-6,44
Raith,4022,6,12,8,16,39,49,-10,44
Dunfermline,4022,7,9,14,13,45,50,-5,41
Ayr,4022,8,9,12,15,36,56,-20,39
Queen of S't,4022,9,9,11,16,38,48,-10,38
St Mirren,4022,10,8,9,19,41,64,-23,33
Hibernian,4023,1,18,12,6,53,25,28,66
Morton,4023,2,18,11,7,52,37,15,65
Falkirk,4023,3,16,11,9,55,37,18,59
Dundee Utd,4023,4,16,9,11,48,38,10,57
Queen of S't,4023,5,12,11,13,43,48,-5,47
Raith,4023,6,12,9,15,40,45,-5,45
Dumbarton,4023,7,10,13,13,49,56,-7,43
Dunfermline,4023,8,9,13,14,44,48,-4,40
Ayr,4023,9,7,12,17,31,56,-25,33
St Mirren,4023,10,7,9,20,36,61,-25,30
Hibernian,4024,1,20,12,4,58,25,33,72
Morton,4024,2,16,10,10,50,37,13,58
Falkirk,4024,3,15,12,9,54,40,14,57
Dundee Utd,4024,4,15,11,10,54,42,12,56
Dunfermline,4024,5,10,15,11,48,48,0,45
Raith,4024,6,12,8,16,39,50,-11,44
St Mirren,4024,7,11,9,16,44,55,-11,42
Queen of S't,4024,8,9,12,15,42,51,-9,39
Dumbarton,4024,9,9,11,16,51,60,-9,38
Ayr,4024,10,8,10,18,30,62,-32,34
Hibernian,4025,1,19,13,4,56,28,28,70
Morton,4025,2,18,12,6,58,31,27,66
Dundee Utd,4025,3,16,10,10,52,41,11,58
Falkirk,4025,4,15,11,10,56,43,13,56
Queen of S't,4025,5,11,11,14,41,45,-4,44
St Mirren,4025,6,11,10,15,43,51,-8,43
Raith,4025,7,9,13,14,34,46,-12,40
Dunfermline,4025,8,8,14,14,43,54,-11,38
Dumbarton,4025,9,8,10,18,47,65,-18,34
Ayr,4025,10,7,12,17,34,60,-26,33
Hibernian,4026,1,21,12,3,57,24,33,75
Dundee Utd,4026,2,18,10,8,59,39,20,64
Morton,4026,3,18,10,8,52,37,15,64
Falkirk,4026,4,15,11,10,59,47,12,56
Raith,4026,5,11,9,16,35,48,-13,42
Dunfermline,4026,6,9,13,14,48,51,-3,40
Queen of S't,4026,7,10,9,17,42,51,-9,39
Dumbarton,4026,8,8,12,16,51,63,-12,36
St Mirren,4026,9,7,13,16,38,55,-17,34
Ayr,4026,10,7,13,16,32,58,-26,34
Hibernian,4027,1,18,11,7,53,27,26,65
Morton,4027,2,18,11,7,51,35,16,65
Falkirk,4027,3,16,10,10,53,39,14,58
Dundee Utd,4027,4,16,10,10,53,41,12,58
Dunfermline,4027,5,12,11,13,46,45,1,47
Queen of S't,4027,6,11,10,15,46,50,-4,43
St Mirren,4027,7,11,9,16,43,54,-11,42
Dumbarton,4027,8,9,11,16,48,57,-9,38
Raith,4027,9,9,9,18,33,54,-21,36
Ayr,4027,10,8,12,16,33,57,-24,36
Hibernian,4028,1,17,15,4,55,27,28,66
Morton,4028,2,17,12,7,49,32,17,63
Falkirk,4028,3,17,11,8,59,37,22,62
Dundee Utd,4028,4,14,10,12,44,45,-1,52
Queen of S't,4028,5,13,9,14,47,48,-1,48
Dunfermline,4028,6,9,15,12,49,49,0,42
Ayr,4028,7,10,12,14,39,56,-17,42
Raith,4028,8,10,11,15,36,49,-13,41
St Mirren,4028,9,8,10,18,37,56,-19,34
Dumbarton,4028,10,7,11,18,43,59,-16,32
Hibernian,4029,1,21,11,4,60,24,36,74
Falkirk,4029,2,17,10,9,59,38,21,61
Dundee Utd,4029,3,17,10,9,51,36,15,61
Morton,4029,4,15,13,8,54,42,12,58
Queen of S't,4029,5,11,12,13,43,49,-6,45
Raith,4029,6,10,11,15,38,53,-15,41
Dunfermline,4029,7,7,15,14,45,54,-9,36
St Mirren,4029,8,8,12,16,41,58,-17,36
Dumbarton,4029,9,8,11,17,45,60,-15,35
Ayr,4029,10,8,11,17,33,55,-22,35
Hibernian,4030,1,21,12,3,58,26,32,75
Morton,4030,2,15,12,9,46,36,10,57
Dundee Utd,4030,3,15,11,10,55,43,12,56
Falkirk,4030,4,15,10,11,54,40,14,55
Dunfermline,4030,5,11,14,11,50,47,3,47
Queen of S't,4030,6,11,9,16,44,53,-9,42
Raith,4030,7,10,11,15,34,49,-15,41
Dumbarton,4030,8,9,11,16,52,65,-13,38
Ayr,4030,9,9,11,16,34,53,-19,38
St Mirren,4030,10,8,11,17,41,56,-15,35
Hibernian,4031,1,17,13,6,54,26,28,64
Morton,4031,2,18,10,8,49,33,16,64
Falkirk,4031,3,17,9,10,57,39,18,60
Dundee Utd,4031,4,16,9,11,51,39,12,57
Dunfermline,4031,5,11,13,12,42,42,0,46
Raith,4031,6,11,9,16,34,45,-11,42
Ayr,4031,7,10,11,15,34,51,-17,41
Dumbarton,4031,8,10,10,16,46,58,-12,40
St Mirren,4031,9,10,9,17,39,58,-19,39
Queen of S't,4031,10,9,9,18,39,54,-15,36
Hibernian,4032,1,21,12,3,56,23,33,75
Falkirk,4032,2,18,11,7,62,37,25,65
Morton,4032,3,17,9,10,48,36,12,60
Dundee Utd,4032,4,16,10,10,48,39,9,58
Dunfermline,4032,5,10,14,12,43,46,-3,44
Queen of S't,4032,6,11,8,17,42,53,-11,41
Raith,4032,7,10,8,18,36,49,-13,38
Dumbarton,4032,8,8,13,15,45,58,-13,37
St Mirren,4032,9,8,11,17,37,56,-19,35
Ayr,4032,10,7,12,17,38,58,-20,33
Hibernian,4033,1,20,12,4,57,23,34,72
Morton,4033,2,17,10,9,52,44,8,61
Dundee Utd,4033,3,16,8,12,49,47,2,56
Falkirk,4033,4,15,10,11,57,47,10,55
Dunfermline,4033,5,11,12,13,53,49,4,45
Queen of S't,4033,6,11,9,16,47,51,-4,42
Raith,4033,7,11,9,16,34,45,-11,42
Dumbarton,4033,8,10,11,15,53,58,-5,41
Ayr,4033,9,10,10,16,37,55,-18,40
St Mirren,4033,10,9,9,18,39,59,-20,36
Hibernian,4034,1,21,11,4,60,24,36,74
Morton,4034,2,18,12,6,52,34,18,66
Falkirk,4034,3,17,10,9,60,41,19,61
Dundee Utd,4034,4,16,8,12,52,39,13,56
Raith,4034,5,12,8,16,40,51,-11,44
Dumbarton,4034,6,10,13,13,48,55,-7,43
Queen of S't,4034,7,11,8,17,43,54,-11,41
Ayr,4034,8,8,12,16,31,59,-28,36
Dunfermline,4034,9,8,11,17,43,52,-9,35
St Mirren,4034,10,8,9,19,34,54,-20,33
Hibernian,4035,1,20,13,3,56,23,33,73
Dundee Utd,4035,2,18,8,10,59,41,18,62
Falkirk,4035,3,16,11,9,57,42,15,59
Morton,4035,4,14,11,11,45,40,5,53
Dumbarton,4035,5,11,13,12,54,56,-2,46
Raith,4035,6,10,10,16,35,49,-14,40
Ayr,4035,7,9,13,14,33,53,-20,40
Dunfermline,4035,8,8,14,14,44,54,-10,38
Queen of S't,4035,9,10,8,18,41,54,-13,38
St Mirren,4035,10,8,11,17,42,54,-12,35
Hibernian,4036,1,18,12,6,51,25,26,66
Morton,4036,2,17,13,6,49,34,15,64
Falkirk,4036,3,15,10,11,58,42,16,55
Dundee Utd,4036,4,15,10,11,51,42,9,55
Dumbarton,4036,5,10,13,13,49,55,-6,43
Ayr,4036,6,11,10,15,38,53,-15,43
Queen of S't,4036,7,11,9,16,42,50,-8,42
Raith,4036,8,11,8,17,34,50,-16,41
Dunfermline,4036,9,9,13,14,46,49,-3,40
St Mirren,4036,10,9,10,17,41,59,-18,37
Hibernian,4037,1,19,11,6,55,28,27,68
Morton,4037,2,17,10,9,55,39,16,61
Dundee Utd,4037,3,17,10,9,50,35,15,61
Falkirk,4037,4,14,10,12,55,46,9,52
Queen of S't,4037,5,14,9,13,48,46,2,51
Raith,4037,6,12,8,16,35,49,-14,44
Dumbarton,4037,7,9,12,15,52,58,-6,39
Dunfermline,4037,8,9,11,16,45,56,-11,38
St Mirren,4037,9,9,11,16,42,58,-16,38
Ayr,4037,10,7,14,15,32,54,-22,35
Hibernian,4038,1,19,11,6,53,27,26,68
Morton,4038,2,17,10,9,52,38,14,61
Falkirk,4038,3,16,10,10,56,41,15,58
Dundee Utd,4038,4,15,10,11,53,44,9,55
Queen of S't,4038,5,12,9,15,44,52,-8,45
St Mirren,4038,6,11,9,16,48,57,-9,42
Dunfermline,4038,7,9,14,13,47,49,-2,41
Ayr,4038,8,10,10,16,35,57,-22,40
Raith,4038,9,9,12,15,36,49,-13,39
Dumbarton,4038,10,9,11,16,51,61,-10,38
Hibernian,4039,1,20,10,6,55,25,30,70
Falkirk,4039,2,19,9,8,59,37,22,66
Dundee Utd,4039,3,16,10,10,51,37,14,58
Morton,4039,4,15,11,10,48,36,12,56
Dunfermline,4039,5,10,14,12,42,47,-5,44
Queen of S't,4039,6,11,9,16,42,46,-4,42
Raith,4039,7,10,11,15,34,47,-13,41
Ayr,4039,8,9,11,16,30,53,-23,38
Dumbarton,4039,9,9,10,17,44,59,-15,37
St Mirren,4039,10,9,9,18,37,55,-18,36
Hibernian,4040,1,20,11,5,61,25,36,71
Morton,4040,2,16,13,7,48,36,12,61
Falkirk,4040,3,15,11,10,55,45,10,56
Dundee Utd,4040,4,14,12,10,48,42,6,54
Queen of S't,4040,5,13,9,14,51,48,3,48
Dumbarton,4040,6,10,11,15,49,60,-11,41
Dunfermline,4040,7,8,16,12,44,48,-4,40
Raith,4040,8,10,9,17,37,50,-13,39
St Mirren,4040,9,9,11,16,39,55,-16,38
Ayr,4040,10,7,13,16,33,56,-23,34
Hibernian,4041,1,19,14,3,52,22,30,71
Dundee Utd,4041,2,16,11,9,56,40,16,59
Morton,4041,3,16,11,9,50,34,16,59
Falkirk,4041,4,16,10,10,55,39,16,58
Queen of S't,4041,5,13,10,13,45,47,-2,49
Dunfermline,4041,6,11,11,14,45,46,-1,44
Dumbarton,4041,7,11,10,15,45,54,-9,43
Raith,4041,8,10,9,17,35,51,-16,39
St Mirren,4041,9,7,11,18,38,58,-20,32
Ayr,4041,10,7,11,18,31,61,-30,32
Morton,4042,1,20,10,6,54,34,20,70
Hibernian,4042,2,19,10,7,57,28,29,67
Falkirk,4042,3,17,10,9,61,40,21,61
Dundee Utd,4042,4,16,9,11,52,43,9,57
Queen of S't,4042,5,11,11,14,44,51,-7,44
Dunfermline,4042,6,10,12,14,46,48,-2,42
Dumbarton,4042,7,10,10,16,49,60,-11,40
Ayr,4042,8,8,13,15,35,53,-18,37
Raith,4042,9,8,11,17,32,52,-20,35
St Mirren,4042,10,8,10,18,38,59,-21,34
Hibernian,4043,1,18,15,3,56,25,31,69
Morton,4043,2,14,15,7,55,43,12,57
Falkirk,4043,3,15,11,10,59,42,17,56
Dundee Utd,4043,4,14,12,10,50,43,7,54
Queen of S't,4043,5,13,10,13,49,51,-2,49
Dunfermline,4043,6,10,15,11,49,50,-1,45
Dumbarton,4043,7,8,14,14,49,58,-9,38
St Mirren,4043,8,8,13,15,38,52,-14,37
Raith,4043,9,8,12,16,32,51,-19,36
Ayr,4043,10,6,15,15,35,57,-22,33
Falkirk,4044,1,19,10,7,60,36,24,67
Hibernian,4044,2,17,14,5,50,25,25,65
Morton,4044,3,15,15,6,45,32,13,60
Dundee Utd,4044,4,15,8,13,49,41,8,53
Queen of S't,4044,5,13,8,15,48,50,-2,47
Dunfermline,4044,6,9,14,13,43,46,-3,41
Ayr,4044,7,10,10,16,36,55,-19,40
St Mirren,4044,8,9,11,16,39,53,-14,38
Raith,4044,9,9,11,16,35,50,-15,38
Dumbarton,4044,10,8,11,17,47,64,-17,35
Morton,4045,1,21,10,5,56,32,24,73
Hibernian,4045,2,19,11,6,58,28,30,68
Falkirk,4045,3,16,12,8,61,43,18,60
Dundee Utd,4045,4,15,10,11,55,44,11,55
Queen of S't,4045,5,11,9,16,46,60,-14,42
Ayr,4045,6,10,12,14,35,53,-18,42
Dunfermline,4045,7,9,14,13,47,50,-3,41
Raith,4045,8,10,8,18,34,52,-18,38
Dumbarton,4045,9,8,11,17,49,61,-12,35
St Mirren,4045,10,8,9,19,41,59,-18,33
Hibernian,4046,1,19,12,5,55,26,29,69
Dundee Utd,4046,2,18,9,9,63,40,23,63
Morton,4046,3,17,11,8,53,38,15,62
Falkirk,4046,4,17,10,9,60,39,21,61
Queen of S't,4046,5,12,9,15,51,50,1,45
Dumbarton,4046,6,11,11,14,52,62,-10,44
Raith,4046,7,11,8,17,35,51,-16,41
Dunfermline,4046,8,8,13,15,41,55,-14,37
St Mirren,4046,9,9,9,18,44,62,-18,36
Ayr,4046,10,7,10,19,29,60,-31,31
Hibernian,4047,1,18,13,5,56,27,29,67
Dundee Utd,4047,2,18,8,10,54,41,13,62
Morton,4047,3,16,12,8,53,41,12,60
Falkirk,4047,4,15,11,10,56,41,15,56
Queen of S't,4047,5,14,10,12,49,46,3,52
Dumbarton,4047,6,12,11,13,53,53,0,47
Dunfermline,4047,7,10,12,14,48,52,-4,42
Raith,4047,8,9,9,18,34,57,-23,36
Ayr,4047,9,8,10,18,34,59,-25,34
St Mirren,4047,10,7,10,19,43,63,-20,31
Hibernian,4048,1,21,11,4,59,26,33,74
Falkirk,4048,2,16,12,8,58,39,19,60
Morton,4048,3,14,13,9,45,39,6,55
Dundee Utd,4048,4,13,10,13,47,45,2,49
Queen of S't,4048,5,13,9,14,47,48,-1,48
Dunfermline,4048,6,10,13,13,44,44,0,43
Raith,4048,7,11,10,15,35,47,-12,43
St Mirren,4048,8,9,11,16,43,56,-13,38
Ayr,4048,9,8,13,15,36,55,-19,37
Dumbarton,4048,10,8,12,16,46,61,-15,36
Hibernian,4049,1,20,12,4,58,26,32,72
Morton,4049,2,18,11,7,48,33,15,65
Falkirk,4049,3,16,12,8,54,33,21,60
Dundee Utd,4049,4,16,10,10,48,39,9,58
Dunfermline,4049,5,10,12,14,43,48,-5,42
Queen of S't,4049,6,11,9,16,48,54,-6,42
Ayr,4049,7,10,12,14,39,54,-15,42
Raith,4049,8,8,11,17,32,51,-19,35
Dumbarton,4049,9,7,13,16,46,59,-13,34
St Mirren,4049,10,7,12,17,39,58,-19,33
Hibernian,4050,1,19,12,5,57,25,32,69
Dundee Utd,4050,2,17,9,10,51,40,11,60
Morton,4050,3,15,13,8,48,38,10,58
Falkirk,4050,4,15,12,9,55,40,15,57
Queen of S't,4050,5,12,9,15,46,49,-3,45
Dunfermline,4050,6,9,16,11,45,43,2,43
Raith,4050,7,9,12,15,34,46,-12,39
Ayr,4050,8,9,12,15,36,57,-21,39
St Mirren,4050,9,9,10,17,37,52,-15,37
Dumbarton,4050,10,8,11,17,48,67,-19,35
Morton,4051,1,20,10,6,55,32,23,70
Hibernian,4051,2,17,13,6,52,29,23,64
Falkirk,4051,3,17,11,8,64,40,24,62
Dundee Utd,4051,4,16,10,10,57,42,15,58
Queen of S't,4051,5,10,12,14,41,51,-10,42
Raith,4051,6,11,9,16,38,50,-12,42
Dunfermline,4051,7,9,14,13,43,49,-6,41
Dumbarton,4051,8,10,11,15,51,60,-9,41
Ayr,4051,9,7,12,17,35,59,-24,33
St Mirren,4051,10,7,10,19,39,63,-24,31
Hibernian,4052,1,18,12,6,52,25,27,66
Falkirk,4052,2,18,11,7,63,37,26,65
Morton,4052,3,17,13,6,50,33,17,64
Dundee Utd,4052,4,15,12,9,52,42,10,57
Queen of S't,4052,5,10,11,15,47,53,-6,41
Dunfermline,4052,6,9,14,13,41,47,-6,41
St Mirren,4052,7,9,11,16,38,53,-15,38
Ayr,4052,8,9,11,16,36,57,-21,38
Raith,4052,9,9,9,18,31,50,-19,36
Dumbarton,4052,10,7,14,15,46,59,-13,35
Hibernian,4053,1,19,14,3,56,24,32,71
Falkirk,4053,2,18,11,7,62,37,25,65
Morton,4053,3,16,12,8,52,37,15,60
Dundee Utd,4053,4,15,10,11,51,41,10,55
Dunfermline,4053,5,10,15,11,47,46,1,45
Queen of S't,4053,6,10,12,14,45,51,-6,42
Raith,4053,7,9,10,17,30,47,-17,37
Ayr,4053,8,8,13,15,36,58,-22,37
St Mirren,4053,9,9,9,18,40,60,-20,36
Dumbarton,4053,10,7,12,17,43,61,-18,33
Hibernian,4054,1,20,13,3,54,22,32,73
Falkirk,4054,2,17,10,9,60,37,23,61
Dundee Utd,4054,3,16,10,10,47,39,8,58
Morton,4054,4,15,11,10,46,38,8,56
Queen of S't,4054,5,12,9,15,43,50,-7,45
Dunfermline,4054,6,11,11,14,44,45,-1,44
Raith,4054,7,10,10,16,34,50,-16,40
Dumbarton,4054,8,9,11,16,47,61,-14,38
Ayr,4054,9,9,10,17,36,57,-21,37
St Mirren,4054,10,8,11,17,41,53,-12,35
Hibernian,4055,1,21,11,4,61,27,34,74
Falkirk,4055,2,17,10,9,62,43,19,61
Dundee Utd,4055,3,16,10,10,51,39,12,58
Morton,4055,4,15,11,10,47,38,9,56
Queen of S't,4055,5,12,11,13,48,47,1,47
Dumbarton,4055,6,10,13,13,48,57,-9,43
Raith,4055,7,10,10,16,40,50,-10,40
Dunfermline,4055,8,9,12,15,42,52,-10,39
St Mirren,4055,9,8,11,17,42,60,-18,35
Ayr,4055,10,6,13,17,28,56,-28,31
Hibernian,4056,1,18,14,4,55,24,31,68
Morton,4056,2,19,11,6,51,33,18,68
Falkirk,4056,3,18,9,9,61,37,24,63
Dundee Utd,4056,4,15,9,12,51,42,9,54
Queen of S't,4056,5,10,11,15,43,56,-13,41
Dunfermline,4056,6,9,12,15,43,49,-6,39
Dumbarton,4056,7,9,12,15,44,54,-10,39
Ayr,4056,8,9,12,15,36,57,-21,39
St Mirren,4056,9,9,10,17,42,54,-12,37
Raith,4056,10,9,10,17,33,53,-20,37
Morton,4057,1,21,9,6,55,35,20,72
Hibernian,4057,2,17,14,5,52,28,24,65
Falkirk,4057,3,16,11,9,62,42,20,59
Dundee Utd,4057,4,15,10,11,48,36,12,55
Queen of S't,4057,5,13,10,13,43,45,-2,49
Dunfermline,4057,6,8,16,12,43,46,-3,40
Ayr,4057,7,8,14,14,38,53,-15,38
Raith,4057,8,9,10,17,38,55,-17,37
St Mirren,4057,9,7,12,17,40,59,-19,33
Dumbarton,4057,10,7,12,17,42,62,-20,33
Hibernian,4058,1,19,11,6,56,26,30,68
Morton,4058,2,18,13,5,55,32,23,67
Falkirk,4058,3,15,11,10,55,43,12,56
Dundee Utd,4058,4,15,8,13,53,47,6,53
Raith,4058,5,11,11,14,34,44,-10,44
Queen of S't,4058,6,11,10,15,42,49,-7,43
Ayr,4058,7,9,14,13,37,49,-12,41
Dunfermline,4058,8,8,15,13,47,52,-5,39
St Mirren,4058,9,9,10,17,40,59,-19,37
Dumbarton,4058,10,8,11,17,45,63,-18,35
Hibernian,4059,1,19,12,5,57,26,31,69
Falkirk,4059,2,18,9,9,63,39,24,63
Dundee Utd,4059,3,16,11,9,52,39,13,59
Morton,4059,4,16,11,9,50,44,6,59
Dunfermline,4059,5,12,12,12,50,49,1,48
Queen of S't,4059,6,12,8,16,45,53,-8,44
Raith,4059,7,11,9,16,42,51,-9,42
Dumbarton,4059,8,9,11,16,48,58,-10,38
Ayr,4059,9,8,10,18,34,60,-26,34
St Mirren,4059,10,7,11,18,37,59,-22,32
Hibernian,4060,1,19,13,4,57,25,32,70
Falkirk,4060,2,18,10,8,57,37,20,64
Morton,4060,3,15,14,7,47,36,11,59
Dundee Utd,4060,4,13,10,13,50,46,4,49
Dunfermline,4060,5,11,12,13,45,46,-1,45
Dumbarton,4060,6,11,12,13,48,52,-4,45
Ayr,4060,7,10,12,14,43,53,-10,42
Queen of S't,4060,8,10,8,18,41,60,-19,38
Raith,4060,9,10,8,18,36,56,-20,38
St Mirren,4060,10,8,11,17,39,52,-13,35
Hibernian,4061,1,19,12,5,56,26,30,69
Dundee Utd,4061,2,17,11,8,53,39,14,62
Falkirk,4061,3,17,10,9,58,38,20,61
Morton,4061,4,15,13,8,48,36,12,58
Dunfermline,4061,5,11,14,11,47,44,3,47
Queen of S't,4061,6,12,9,15,47,49,-2,45
Dumbarton,4061,7,9,10,17,43,56,-13,37
Ayr,4061,8,8,12,16,33,56,-23,36
Raith,4061,9,8,11,17,31,53,-22,35
St Mirren,4061,10,7,12,17,37,56,-19,33
Hibernian,4062,1,21,11,4,59,26,33,74
Falkirk,4062,2,17,10,9,62,38,24,61
Morton,4062,3,16,9,11,50,43,7,57
Dundee Utd,4062,4,14,10,12,47,39,8,52
Queen of S't,4062,5,12,10,14,40,49,-9,46
Dunfermline,4062,6,10,14,12,45,46,-1,44
St Mirren,4062,7,11,10,15,48,53,-5,43
Ayr,4062,8,9,12,15,33,52,-19,39
Raith,4062,9,9,9,18,31,50,-19,36
Dumbarton,4062,10,8,11,17,43,62,-19,35
Hibernian,4063,1,20,12,4,58,26,32,72
Dundee Utd,4063,2,15,12,9,48,35,13,57
Morton,4063,3,14,14,8,49,39,10,56
Falkirk,4063,4,14,11,11,58,45,13,53
Dunfermline,4063,5,11,11,14,45,47,-2,44
Queen of S't,4063,6,11,10,15,41,47,-6,43
Dumbarton,4063,7,9,15,12,52,56,-4,42
Raith,4063,8,11,9,16,38,51,-13,42
Ayr,4063,9,9,12,15,34,54,-20,39
St Mirren,4063,10,7,12,17,36,59,-23,33
Hibernian,4064,1,20,12,4,54,23,31,72
Dundee Utd,4064,2,17,10,9,58,39,19,61
Falkirk,4064,3,15,12,9,57,42,15,57
Morton,4064,4,15,12,9,44,39,5,57
Queen of S't,4064,5,13,11,12,46,45,1,50
Dunfermline,4064,6,9,15,12,46,49,-3,42
Raith,4064,7,9,11,16,35,50,-15,38
St Mirren,4064,8,8,12,16,44,59,-15,36
Dumbarton,4064,9,7,14,15,45,60,-15,35
Ayr,4064,10,7,11,18,36,59,-23,32
Hibernian,4065,1,20,12,4,61,30,31,72
Morton,4065,2,19,9,8,54,39,15,66
Falkirk,4065,3,16,11,9,63,45,18,59
Dundee Utd,4065,4,16,11,9,57,41,16,59
Dunfermline,4065,5,11,13,12,55,49,6,46
Queen of S't,4065,6,11,9,16,50,54,-4,42
Raith,4065,7,9,10,17,39,54,-15,37
Dumbarton,4065,8,9,10,17,47,67,-20,37
Ayr,4065,9,8,12,16,37,65,-28,36
St Mirren,4065,10,7,11,18,39,58,-19,32
Morton,4066,1,20,9,7,57,35,22,69
Hibernian,4066,2,18,11,7,56,32,24,65
Falkirk,4066,3,17,10,9,59,38,21,61
Dundee Utd,4066,4,15,9,12,47,42,5,54
Dumbarton,4066,5,12,10,14,54,54,0,46
Dunfermline,4066,6,11,12,13,50,52,-2,45
Queen of S't,4066,7,12,8,16,44,54,-10,44
Raith,4066,8,9,9,18,33,52,-19,36
Ayr,4066,9,8,12,16,30,54,-24,36
St Mirren,4066,10,8,10,18,41,58,-17,34
Hibernian,4067,1,19,12,5,54,25,29,69
Morton,4067,2,17,12,7,50,31,19,63
Falkirk,4067,3,16,12,8,60,42,18,60
Dundee Utd,4067,4,15,9,12,52,47,5,54
Queen of S't,4067,5,11,11,14,45,48,-3,44
Dunfermline,4067,6,10,13,13,44,46,-2,43
Raith,4067,7,9,13,14,34,48,-14,40
Ayr,4067,8,9,13,14,35,50,-15,40
Dumbarton,4067,9,7,14,15,46,61,-15,35
St Mirren,4067,10,6,13,17,37,59,-22,31
Hibernian,4068,1,19,13,4,58,24,34,70
Falkirk,4068,2,18,9,9,62,39,23,63
Dundee Utd,4068,3,17,8,11,46,38,8,59
Morton,4068,4,15,12,9,51,41,10,57
Queen of S't,4068,5,12,9,15,45,51,-6,45
Dunfermline,4068,6,11,11,14,48,50,-2,44
Ayr,4068,7,10,12,14,38,50,-12,42
Raith,4068,8,9,10,17,34,51,-17,37
Dumbarton,4068,9,9,10,17,45,63,-18,37
St Mirren,4068,10,8,10,18,34,54,-20,34
Hibernian,4069,1,21,12,3,54,22,32,75
Falkirk,4069,2,17,12,7,65,35,30,63
Morton,4069,3,17,12,7,50,31,19,63
Dundee Utd,4069,4,16,10,10,58,43,15,58
Queen of S't,4069,5,11,10,15,43,52,-9,43
Ayr,4069,6,10,11,15,37,52,-15,41
Dumbarton,4069,7,8,12,16,44,60,-16,36
Dunfermline,4069,8,8,12,16,38,57,-19,36
Raith,4069,9,8,11,17,28,49,-21,35
St Mirren,4069,10,8,10,18,39,55,-16,34
Hibernian,4070,1,20,11,5,59,27,32,71
Morton,4070,2,17,12,7,49,36,13,63
Falkirk,4070,3,16,10,10,56,38,18,58
Dundee Utd,4070,4,16,8,12,47,41,6,56
Queen of S't,4070,5,12,11,13,43,45,-2,47
Dunfermline,4070,6,11,12,13,48,43,5,45
Raith,4070,7,10,9,17,33,50,-17,39
St Mirren,4070,8,9,11,16,42,60,-18,38
Dumbarton,4070,9,8,13,15,46,56,-10,37
Ayr,4070,10,7,11,18,34,61,-27,32
Hibernian,4071,1,20,12,4,57,24,33,72
Dundee Utd,4071,2,18,10,8,56,36,20,64
Falkirk,4071,3,15,12,9,60,41,19,57
Morton,4071,4,15,11,10,49,42,7,56
Dunfermline,4071,5,11,14,11,48,44,4,47
Queen of S't,4071,6,10,12,14,47,53,-6,42
Dumbarton,4071,7,9,12,15,54,65,-11,39
St Mirren,4071,8,10,9,17,43,63,-20,39
Raith,4071,9,8,10,18,33,54,-21,34
Ayr,4071,10,8,10,18,35,60,-25,34
Hibernian,4072,1,20,13,3,54,22,32,73
Falkirk,4072,2,18,10,8,58,35,23,64
Morton,4072,3,16,10,10,50,40,10,58
Dundee Utd,4072,4,16,10,10,47,37,10,58
Queen of S't,4072,5,12,9,15,45,52,-7,45
Raith,4072,6,12,8,16,36,48,-12,44
Dumbarton,4072,7,9,11,16,51,57,-6,38
St Mirren,4072,8,9,11,16,38,52,-14,38
Dunfermline,4072,9,7,13,16,42,56,-14,34
Ayr,4072,10,7,13,16,31,53,-22,34
Hibernian,4073,1,20,12,4,58,23,35,72
Falkirk,4073,2,17,10,9,61,40,21,61
Morton,4073,3,17,10,9,49,39,10,61
Dundee Utd,4073,4,17,9,10,52,39,13,60
Queen of S't,4073,5,11,9,16,49,58,-9,42
Dunfermline,4073,6,9,14,13,48,49,-1,41
St Mirren,4073,7,10,10,16,37,54,-17,40
Dumbarton,4073,8,9,11,16,47,57,-10,38
Raith,4073,9,8,12,16,30,48,-18,36
Ayr,4073,10,7,13,16,36,60,-24,34
Hibernian,4074,1,22,11,3,66,25,41,77
Morton,4074,2,17,10,9,50,34,16,61
Dundee Utd,4074,3,15,11,10,50,40,10,56
Falkirk,4074,4,15,10,11,56,46,10,55
Queen of S't,4074,5,12,10,14,52,54,-2,46
Dunfermline,4074,6,9,13,14,52,58,-6,40
Dumbarton,4074,7,9,12,15,46,61,-15,39
Raith,4074,8,9,11,16,32,47,-15,38
Ayr,4074,9,8,13,15,33,55,-22,37
St Mirren,4074,10,9,9,18,38,55,-17,36
Hibernian,4075,1,19,13,4,55,24,31,70
Falkirk,4075,2,18,10,8,64,37,27,64
Dundee Utd,4075,3,15,11,10,49,40,9,56
Morton,4075,4,15,10,11,44,39,5,55
Dunfermline,4075,5,10,14,12,47,48,-1,44
Ayr,4075,6,10,12,14,36,49,-13,42
Queen of S't,4075,7,10,10,16,39,53,-14,40
Dumbarton,4075,8,9,12,15,50,62,-12,39
Raith,4075,9,9,10,17,36,53,-17,37
St Mirren,4075,10,8,12,16,43,58,-15,36
Hibernian,4076,1,22,11,3,63,24,39,77
Dundee Utd,4076,2,18,9,9,56,37,19,63
Morton,4076,3,16,11,9,49,35,14,59
Falkirk,4076,4,14,10,12,54,47,7,52
Dunfermline,4076,5,11,13,12,48,50,-2,46
Raith,4076,6,11,11,14,34,44,-10,44
Queen of S't,4076,7,11,10,15,41,50,-9,43
Dumbarton,4076,8,9,11,16,49,60,-11,38
St Mirren,4076,9,7,13,16,38,55,-17,34
Ayr,4076,10,6,11,19,32,62,-30,29
Hibernian,4077,1,19,12,5,56,27,29,69
Morton,4077,2,18,11,7,53,35,18,65
Falkirk,4077,3,17,10,9,61,39,22,61
Dundee Utd,4077,4,16,10,10,51,41,10,58
Queen of S't,4077,5,14,9,13,46,45,1,51
Dunfermline,4077,6,9,13,14,44,49,-5,40
Raith,4077,7,9,10,17,36,53,-17,37
St Mirren,4077,8,8,12,16,39,54,-15,36
Dumbarton,4077,9,8,11,17,43,61,-18,35
Ayr,4077,10,7,12,17,32,57,-25,33
Hibernian,4078,1,18,13,5,54,25,29,67
Morton,4078,2,17,11,8,54,37,17,62
Dundee Utd,4078,3,16,11,9,54,41,13,59
Falkirk,4078,4,15,12,9,57,40,17,57
Dunfermline,4078,5,11,12,13,53,49,4,45
Queen of S't,4078,6,11,10,15,48,55,-7,43
Dumbarton,4078,7,10,12,14,49,54,-5,42
Raith,4078,8,10,9,17,35,56,-21,39
Ayr,4078,9,8,12,16,34,60,-26,36
St Mirren,4078,10,8,10,18,38,59,-21,34
Hibernian,4079,1,19,12,5,51,23,28,69
Falkirk,4079,2,17,11,8,57,38,19,62
Morton,4079,3,15,9,12,46,39,7,54
Dundee Utd,4079,4,14,10,12,47,43,4,52
Dumbarton,4079,5,11,12,13,52,58,-6,45
Raith,4079,6,11,10,15,36,47,-11,43
Dunfermline,4079,7,9,15,12,45,47,-2,42
Ayr,4079,8,10,11,15,36,52,-16,41
Queen of S't,4079,9,10,10,16,42,49,-7,40
St Mirren,4079,10,9,10,17,39,55,-16,37
Hibernian,4080,1,18,13,5,56,26,30,67
Morton,4080,2,17,11,8,47,35,12,62
Dundee Utd,4080,3,17,10,9,58,38,20,61
Falkirk,4080,4,16,9,11,59,41,18,57
Dunfermline,4080,5,12,13,11,54,49,5,49
Dumbarton,4080,6,11,10,15,57,67,-10,43
Raith,4080,7,10,9,17,32,51,-19,39
St Mirren,4080,8,9,11,16,41,56,-15,38
Queen of S't,4080,9,9,10,17,43,58,-15,37
Ayr,4080,10,7,12,17,31,57,-26,33
Hibernian,4081,1,20,13,3,56,20,36,73
Falkirk,4081,2,17,11,8,63,43,20,62
Morton,4081,3,16,11,9,47,39,8,59
Dundee Utd,4081,4,15,10,11,51,43,8,55
Queen of S't,4081,5,12,10,14,43,48,-5,46
Dumbarton,4081,6,11,12,13,49,56,-7,45
Raith,4081,7,10,11,15,34,47,-13,41
Dunfermline,4081,8,8,12,16,43,51,-8,36
Ayr,4081,9,7,13,16,31,51,-20,34
St Mirren,4081,10,8,9,19,43,62,-19,33
Hibernian,4082,1,21,12,3,63,26,37,75
Falkirk,4082,2,15,11,10,56,43,13,56
Morton,4082,3,14,12,10,48,43,5,54
Dundee Utd,4082,4,14,10,12,44,45,-1,52
Queen of S't,4082,5,12,11,13,48,48,0,47
Dunfermline,4082,6,10,16,10,48,46,2,46
Raith,4082,7,11,10,15,40,49,-9,43
Dumbarton,4082,8,9,12,15,45,56,-11,39
St Mirren,4082,9,9,11,16,43,53,-10,38
Ayr,4082,10,6,13,17,32,58,-26,31
Hibernian,4083,1,19,13,4,52,22,30,70
Dundee Utd,4083,2,18,9,9,54,37,17,63
Morton,4083,3,17,10,9,49,36,13,61
Falkirk,4083,4,15,11,10,59,43,16,56
Dumbarton,4083,5,11,11,14,45,53,-8,44
Raith,4083,6,10,11,15,34,46,-12,41
Dunfermline,4083,7,8,15,13,41,47,-6,39
Queen of S't,4083,8,10,9,17,44,54,-10,39
Ayr,4083,9,7,15,14,30,49,-19,36
St Mirren,4083,10,8,10,18,36,57,-21,34
Hibernian,4084,1,20,12,4,59,25,34,72
Morton,4084,2,17,13,6,51,34,17,64
Falkirk,4084,3,16,11,9,56,44,12,59
Dundee Utd,4084,4,16,10,10,57,41,16,58
Ayr,4084,5,11,12,13,37,49,-12,45
Queen of S't,4084,6,11,9,16,43,55,-12,42
Dumbarton,4084,7,9,12,15,47,56,-9,39
Raith,4084,8,9,11,16,37,52,-15,38
St Mirren,4084,9,8,10,18,42,61,-19,34
Dunfermline,4084,10,7,12,17,39,51,-12,33
Hibernian,4085,1,20,13,3,60,24,36,73
Falkirk,4085,2,16,11,9,59,39,20,59
Morton,4085,3,15,10,11,46,39,7,55
Dundee Utd,4085,4,14,11,11,51,44,7,53
Dunfermline,4085,5,12,11,13,47,51,-4,47
Queen of S't,4085,6,12,10,14,47,50,-3,46
Raith,4085,7,11,8,17,38,52,-14,41
Dumbarton,4085,8,10,10,16,48,59,-11,40
St Mirren,4085,9,9,11,16,44,55,-11,38
Ayr,4085,10,8,11,17,35,62,-27,35
Hibernian,4086,1,19,14,3,54,24,30,71
Falkirk,4086,2,17,10,9,58,39,19,61
Dundee Utd,4086,3,17,10,9,59,46,13,61
Morton,4086,4,16,11,9,48,35,13,59
Dumbarton,4086,5,11,10,15,48,56,-8,43
Dunfermline,4086,6,10,12,14,45,50,-5,42
Queen of S't,4086,7,11,9,16,44,51,-7,42
Raith,4086,8,10,10,16,32,45,-13,40
Ayr,4086,9,8,13,15,34,53,-19,37
St Mirren,4086,10,7,9,20,37,60,-23,30
Hibernian,4087,1,18,12,6,55,29,26,66
Morton,4087,2,17,10,9,47,34,13,61
Falkirk,4087,3,15,11,10,60,46,14,56
Dundee Utd,4087,4,15,11,10,55,48,7,56
Dunfermline,4087,5,11,15,10,50,44,6,48
Queen of S't,4087,6,11,12,13,44,49,-5,45
Raith,4087,7,10,10,16,34,49,-15,40
Dumbarton,4087,8,8,14,14,46,55,-9,38
St Mirren,4087,9,9,10,17,44,57,-13,37
Ayr,4087,10,7,13,16,31,55,-24,34
Hibernian,4088,1,18,13,5,51,25,26,67
Falkirk,4088,2,16,11,9,58,39,19,59
Morton,4088,3,15,13,8,44,33,11,58
Dundee Utd,4088,4,16,8,12,45,39,6,56
Raith,4088,5,11,11,14,37,46,-9,44
Queen of S't,4088,6,12,8,16,40,51,-11,44
Dunfermline,4088,7,10,13,13,49,46,3,43
Dumbarton,4088,8,10,11,15,47,56,-9,41
St Mirren,4088,9,10,9,17,41,56,-15,39
Ayr,4088,10,8,11,17,31,52,-21,35
Hibernian,4089,1,20,11,5,58,27,31,71
Falkirk,4089,2,18,10,8,61,38,23,64
Morton,4089,3,17,12,7,50,34,16,63
Dundee Utd,4089,4,17,9,10,53,40,13,60
Queen of S't,4089,5,11,10,15,47,54,-7,43
Raith,4089,6,10,11,15,37,49,-12,41
Dunfermline,4089,7,9,13,14,43,54,-11,40
Dumbarton,4089,8,8,12,16,48,57,-9,36
Ayr,4089,9,7,13,16,34,58,-24,34
St Mirren,4089,10,7,11,18,41,61,-20,32
Hibernian,4090,1,18,12,6,51,27,24,66
Morton,4090,2,15,13,8,49,35,14,58
Falkirk,4090,3,15,12,9,59,41,18,57
Dundee Utd,4090,4,13,13,10,48,40,8,52
Queen of S't,4090,5,12,11,13,45,46,-1,47
Dunfermline,4090,6,12,11,13,46,48,-2,47
St Mirren,4090,7,10,11,15,46,55,-9,41
Ayr,4090,8,8,14,14,36,55,-19,38
Dumbarton,4090,9,8,13,15,43,59,-16,37
Raith,4090,10,8,12,16,32,49,-17,36
Hibernian,4091,1,19,12,5,57,26,31,69
Dundee Utd,4091,2,18,10,8,54,39,15,64
Morton,4091,3,17,11,8,51,32,19,62
Falkirk,4091,4,15,11,10,59,47,12,56
Queen of S't,4091,5,11,9,16,44,52,-8,42
Raith,4091,6,10,11,15,36,47,-11,41
Dunfermline,4091,7,8,15,13,46,50,-4,39
Dumbarton,4091,8,8,12,16,47,60,-13,36
St Mirren,4091,9,8,12,16,41,55,-14,36
Ayr,4091,10,7,15,14,34,61,-27,36
Hibernian,4092,1,20,12,4,59,25,34,72
Falkirk,4092,2,17,10,9,61,42,19,61
Dundee Utd,4092,3,16,9,11,51,39,12,57
Morton,4092,4,13,14,9,48,42,6,53
Queen of S't,4092,5,12,9,15,46,50,-4,45
Dumbarton,4092,6,10,12,14,51,59,-8,42
Raith,4092,7,10,11,15,35,47,-12,41
Dunfermline,4092,8,9,13,14,45,53,-8,40
St Mirren,4092,9,9,10,17,39,56,-17,37
Ayr,4092,10,8,12,16,37,59,-22,36
Hibernian,4093,1,20,12,4,59,25,34,72
Morton,4093,2,18,11,7,54,36,18,65
Falkirk,4093,3,16,11,9,64,46,18,59
Dundee Utd,4093,4,16,9,11,52,42,10,57
Dunfermline,4093,5,11,11,14,47,48,-1,44
Queen of S't,4093,6,11,10,15,41,50,-9,43
Dumbarton,4093,7,9,12,15,46,58,-12,39
Raith,4093,8,10,9,17,33,52,-19,39
St Mirren,4093,9,8,11,17,43,60,-17,35
Ayr,4093,10,7,12,17,35,57,-22,33
Hibernian,4094,1,20,12,4,57,24,33,72
Morton,4094,2,17,11,8,49,34,15,62
Dundee Utd,4094,3,15,12,9,48,37,11,57
Falkirk,4094,4,15,11,10,57,43,14,56
Queen of S't,4094,5,12,10,14,46,50,-4,46
Dumbarton,4094,6,10,11,15,46,54,-8,41
Dunfermline,4094,7,9,13,14,45,51,-6,40
Raith,4094,8,9,12,15,31,46,-15,39
St Mirren,4094,9,8,11,17,39,56,-17,35
Ayr,4094,10,7,13,16,31,54,-23,34
Hibernian,4095,1,20,10,6,60,29,31,70
Morton,4095,2,17,12,7,57,40,17,63
Falkirk,4095,3,15,10,11,57,47,10,55
Dundee Utd,4095,4,15,10,11,48,44,4,55
Queen of S't,4095,5,14,9,13,47,47,0,51
Raith,4095,6,12,9,15,42,50,-8,45
Dunfermline,4095,7,10,11,15,47,51,-4,41
Dumbarton,4095,8,9,14,13,48,55,-7,41
Ayr,4095,9,8,11,17,37,59,-22,35
St Mirren,4095,10,6,12,18,39,60,-21,30
Hibernian,4096,1,19,12,5,59,28,31,69
Dundee Utd,4096,2,18,9,9,54,36,18,63
Falkirk,4096,3,16,9,11,55,41,14,57
Morton,4096,4,15,12,9,49,37,12,57
Dunfermline,4096,5,12,11,13,45,46,-1,47
Queen of S't,4096,6,11,9,16,40,51,-11,42
Dumbarton,4096,7,10,11,15,49,58,-9,41
Raith,4096,8,10,9,17,33,49,-16,39
St Mirren,4096,9,9,11,16,43,58,-15,38
Ayr,4096,10,8,11,17,35,58,-23,35
Falkirk,4097,1,18,10,8,63,44,19,64
Hibernian,4097,2,17,12,7,50,25,25,63
Morton,4097,3,17,11,8,51,37,14,62
Dundee Utd,4097,4,16,9,11,51,38,13,57
Queen of S't,4097,5,12,9,15,44,51,-7,45
St Mirren,4097,6,10,11,15,41,53,-12,41
Raith,4097,7,10,11,15,33,46,-13,41
Dunfermline,4097,8,8,15,13,42,49,-7,39
Ayr,4097,9,8,13,15,34,53,-19,37
Dumbarton,4097,10,8,11,17,45,58,-13,35
Hibernian,4098,1,19,12,5,52,24,28,69
Morton,4098,2,16,15,5,48,31,17,63
Dundee Utd,4098,3,17,10,9,56,37,19,61
Falkirk,4098,4,16,11,9,62,42,20,59
Dunfermline,4098,5,10,14,12,47,46,1,44
Queen of S't,4098,6,11,11,14,43,52,-9,44
Raith,4098,7,10,9,17,36,56,-20,39
St Mirren,4098,8,8,11,17,40,55,-15,35
Dumbarton,4098,9,8,11,17,46,63,-17,35
Ayr,4098,10,7,12,17,34,58,-24,33
Hibernian,4099,1,20,12,4,58,24,34,72
Falkirk,4099,2,17,10,9,64,41,23,61
Morton,4099,3,15,13,8,50,41,9,58
Dundee Utd,4099,4,14,13,9,49,41,8,55
Queen of S't,4099,5,12,8,16,45,54,-9,44
Dumbarton,4099,6,10,12,14,49,55,-6,42
Ayr,4099,7,9,14,13,38,51,-13,41
Dunfermline,4099,8,9,13,14,46,49,-3,40
Raith,4099,9,9,10,17,32,55,-23,37
St Mirren,4099,10,7,11,18,43,63,-20,32
Hibernian,4100,1,17,14,5,50,24,26,65
Dundee Utd,4100,2,18,10,8,50,35,15,64
Morton,4100,3,17,12,7,48,33,15,63
Falkirk,4100,4,15,13,8,59,41,18,58
Dunfermline,4100,5,10,15,11,46,44,2,45
Queen of S't,4100,6,11,9,16,40,48,-8,42
Raith,4100,7,11,9,16,34,49,-15,42
Dumbarton,4100,8,9,11,16,49,60,-11,38
Ayr,4100,9,7,15,14,32,51,-19,36
St Mirren,4100,10,6,10,20,37,60,-23,28
Hibernian,4101,1,19,11,6,52,27,25,68
Morton,4101,2,17,13,6,55,32,23,64
Falkirk,4101,3,16,9,11,56,44,12,57
Dundee Utd,4101,4,14,12,10,47,39,8,54
Queen of S't,4101,5,13,9,14,46,49,-3,48
Raith,4101,6,11,9,16,36,51,-15,42
Dunfermline,4101,7,9,13,14,43,49,-6,40
St Mirren,4101,8,9,12,15,42,53,-11,39
Dumbarton,4101,9,9,11,16,49,60,-11,38
Ayr,4101,10,8,11,17,34,56,-22,35
Hibernian,4102,1,18,12,6,56,30,26,66
Morton,4102,2,16,12,8,50,39,11,60
Falkirk,4102,3,16,11,9,55,37,18,59
Dundee Utd,4102,4,16,10,10,48,35,13,58
Dunfermline,4102,5,11,12,13,50,53,-3,45
Queen of S't,4102,6,11,10,15,46,52,-6,43
Dumbarton,4102,7,10,12,14,50,55,-5,42
Raith,4102,8,11,9,16,33,46,-13,42
Ayr,4102,9,9,12,15,33,54,-21,39
St Mirren,4102,10,6,12,18,37,57,-20,30
Hibernian,4103,1,20,11,5,55,25,30,71
Falkirk,4103,2,16,11,9,62,44,18,59
Morton,4103,3,16,11,9,47,36,11,59
Dundee Utd,4103,4,15,10,11,48,39,9,55
Queen of S't,4103,5,13,9,14,50,49,1,48
Raith,4103,6,12,9,15,39,49,-10,45
Dunfermline,4103,7,9,13,14,43,50,-7,40
Dumbarton,4103,8,9,12,15,47,58,-11,39
Ayr,4103,9,9,11,16,34,55,-21,38
St Mirren,4103,10,7,11,18,38,58,-20,32
Hibernian,4104,1,19,11,6,58,29,29,68
Morton,4104,2,16,13,7,52,35,17,61
Falkirk,4104,3,15,11,10,60,47,13,56
Dundee Utd,4104,4,15,10,11,46,45,1,55
Dunfermline,4104,5,12,13,11,55,52,3,49
Raith,4104,6,12,10,14,40,49,-9,46
Queen of S't,4104,7,12,9,15,45,48,-3,45
Dumbarton,4104,8,8,12,16,46,59,-13,36
St Mirren,4104,9,8,12,16,39,53,-14,36
Ayr,4104,10,7,11,18,33,57,-24,32
Hibernian,4105,1,18,12,6,52,28,24,66
Morton,4105,2,18,12,6,57,36,21,66
Falkirk,4105,3,17,11,8,59,38,21,62
Dundee Utd,4105,4,15,9,12,49,44,5,54
Queen of S't,4105,5,13,10,13,46,46,0,49
Raith,4105,6,12,8,16,39,49,-10,44
Dunfermline,4105,7,8,15,13,44,49,-5,39
Ayr,4105,8,9,11,16,36,57,-21,38
Dumbarton,4105,9,8,11,17,45,59,-14,35
St Mirren,4105,10,8,9,19,40,61,-21,33
Morton,4106,1,20,10,6,57,34,23,70
Hibernian,4106,2,18,11,7,58,30,28,65
Falkirk,4106,3,16,11,9,65,45,20,59
Dundee Utd,4106,4,17,8,11,56,47,9,59
Queen of S't,4106,5,12,9,15,47,52,-5,45
Ayr,4106,6,11,10,15,38,56,-18,43
Dumbarton,4106,7,10,11,15,48,58,-10,41
Raith,4106,8,9,10,17,35,50,-15,37
Dunfermline,4106,9,7,15,14,42,50,-8,36
St Mirren,4106,10,8,9,19,40,64,-24,33
Morton,4107,1,18,12,6,49,35,14,66
Hibernian,4107,2,18,11,7,52,25,27,65
Dundee Utd,4107,3,17,8,11,52,41,11,59
Falkirk,4107,4,16,10,10,57,43,14,58
Queen of S't,4107,5,12,10,14,45,47,-2,46
Dunfermline,4107,6,9,13,14,48,52,-4,40
Raith,4107,7,9,13,14,34,46,-12,40
Ayr,4107,8,9,12,15,36,53,-17,39
St Mirren,4107,9,9,10,17,39,57,-18,37
Dumbarton,4107,10,7,13,16,46,59,-13,34
Hibernian,4108,1,19,14,3,56,26,30,71
Dundee Utd,4108,2,19,8,9,60,38,22,65
Morton,4108,3,18,11,7,53,34,19,65
Falkirk,4108,4,15,10,11,57,45,12,55
Dunfermline,4108,5,11,12,13,48,47,1,45
Raith,4108,6,10,10,16,34,48,-14,40
Queen of S't,4108,7,10,9,17,39,51,-12,39
Dumbarton,4108,8,9,12,15,46,62,-16,39
St Mirren,4108,9,8,10,18,37,56,-19,34
Ayr,4108,10,7,12,17,34,57,-23,33
Hibernian,4109,1,19,12,5,53,27,26,69
Morton,4109,2,17,11,8,52,36,16,62
Falkirk,4109,3,16,10,10,57,40,17,58
Dundee Utd,4109,4,15,11,10,45,38,7,56
Queen of S't,4109,5,14,9,13,52,46,6,51
Dunfermline,4109,6,10,12,14,43,48,-5,42
Raith,4109,7,10,10,16,34,50,-16,40
Dumbarton,4109,8,9,11,16,51,63,-12,38
St Mirren,4109,9,9,9,18,39,53,-14,36
Ayr,4109,10,7,13,16,34,59,-25,34
Hibernian,4110,1,21,11,4,62,25,37,74
Morton,4110,2,16,12,8,48,37,11,60
Falkirk,4110,3,14,13,9,55,41,14,55
Dundee Utd,4110,4,15,10,11,49,44,5,55
Queen of S't,4110,5,13,8,15,48,50,-2,47
Raith,4110,6,11,10,15,35,44,-9,43
Dumbarton,4110,7,10,11,15,44,56,-12,41
Dunfermline,4110,8,8,14,14,42,47,-5,38
Ayr,4110,9,9,10,17,34,59,-25,37
St Mirren,4110,10,9,9,18,43,57,-14,36
Hibernian,4111,1,20,10,6,55,29,26,70
Morton,4111,2,16,13,7,48,34,14,61
Falkirk,4111,3,16,11,9,59,39,20,59
Dundee Utd,4111,4,15,8,13,50,48,2,53
Dunfermline,4111,5,10,14,12,49,50,-1,44
Queen of S't,4111,6,11,9,16,46,53,-7,42
Dumbarton,4111,7,10,11,15,49,57,-8,41
Ayr,4111,8,9,12,15,39,55,-16,39
St Mirren,4111,9,9,11,16,39,53,-14,38
Raith,4111,10,9,11,16,31,47,-16,38
Hibernian,4112,1,20,12,4,59,28,31,72
Morton,4112,2,16,12,8,50,37,13,60
Dundee Utd,4112,3,16,11,9,50,37,13,59
Falkirk,4112,4,13,10,13,52,45,7,49
Queen of S't,4112,5,12,10,14,45,50,-5,46
Raith,4112,6,12,9,15,43,49,-6,45
Dunfermline,4112,7,9,15,12,45,49,-4,42
Dumbarton,4112,8,9,12,15,49,55,-6,39
Ayr,4112,9,8,12,16,36,59,-23,36
St Mirren,4112,10,8,11,17,38,58,-20,35
Hibernian,4113,1,18,12,6,49,25,24,66
Falkirk,4113,2,18,9,9,60,39,21,63
Morton,4113,3,17,12,7,47,32,15,63
Dundee Utd,4113,4,15,12,9,51,39,12,57
Raith,4113,5,11,10,15,36,48,-12,43
Ayr,4113,6,10,12,14,35,52,-17,42
Dunfermline,4113,7,10,11,15,43,49,-6,41
Queen of S't,4113,8,10,11,15,42,48,-6,41
Dumbarton,4113,9,9,11,16,45,56,-11,38
St Mirren,4113,10,7,10,19,36,56,-20,31
Morton,4114,1,19,10,7,53,37,16,67
Hibernian,4114,2,18,12,6,53,23,30,66
Falkirk,4114,3,17,10,9,58,39,19,61
Dundee Utd,4114,4,16,11,9,50,40,10,59
Dumbarton,4114,5,10,12,14,51,60,-9,42
Queen of S't,4114,6,11,9,16,44,56,-12,42
Dunfermline,4114,7,9,12,15,44,49,-5,39
St Mirren,4114,8,9,10,17,43,52,-9,37
Raith,4114,9,9,9,18,34,53,-19,36
Ayr,4114,10,7,15,14,32,53,-21,36
Hibernian,4115,1,21,10,5,63,26,37,73
Morton,4115,2,17,12,7,49,33,16,63
Falkirk,4115,3,15,12,9,61,45,16,57
Dundee Utd,4115,4,14,10,12,45,38,7,52
Raith,4115,5,13,8,15,38,46,-8,47
Queen of S't,4115,6,12,9,15,48,52,-4,45
Dunfermline,4115,7,9,14,13,42,50,-8,41
Dumbarton,4115,8,9,11,16,44,56,-12,38
St Mirren,4115,9,8,12,16,36,52,-16,36
Ayr,4115,10,8,10,18,34,62,-28,34
Hibernian,4116,1,21,11,4,59,22,37,74
Dundee Utd,4116,2,18,10,8,54,37,17,64
Morton,4116,3,15,11,10,49,41,8,56
Falkirk,4116,4,15,10,11,52,44,8,55
Dumbarton,4116,5,11,11,14,54,56,-2,44
Dunfermline,4116,6,10,13,13,44,48,-4,43
Raith,4116,7,11,9,16,37,50,-13,42
Queen of S't,4116,8,9,10,17,42,56,-14,37
St Mirren,4116,9,9,9,18,41,59,-18,36
Ayr,4116,10,8,12,16,34,53,-19,36
Hibernian,4117,1,22,11,3,62,24,38,77
Dundee Utd,4117,2,17,9,10,53,38,15,60
Morton,4117,3,15,12,9,49,38,11,57
Falkirk,4117,4,15,11,10,54,38,16,56
Queen of S't,4117,5,12,8,16,46,57,-11,44
Dumbarton,4117,6,10,10,16,52,63,-11,40
Raith,4117,7,10,10,16,38,51,-13,40
Ayr,4117,8,9,12,15,34,57,-23,39
Dunfermline,4117,9,8,13,15,46,53,-7,37
St Mirren,4117,10,7,14,15,42,57,-15,35
Hibernian,4118,1,20,13,3,56,23,33,73
Falkirk,4118,2,17,11,8,62,41,21,62
Morton,4118,3,17,10,9,51,38,13,61
Dundee Utd,4118,4,16,8,12,51,42,9,56
Queen of S't,4118,5,12,8,16,47,50,-3,44
Dumbarton,4118,6,11,10,15,51,61,-10,43
Ayr,4118,7,10,11,15,35,52,-17,41
Dunfermline,4118,8,9,12,15,41,47,-6,39
St Mirren,4118,9,9,11,16,47,57,-10,38
Raith,4118,10,8,8,20,30,60,-30,32
Hibernian,4119,1,17,11,8,53,32,21,62
Falkirk,4119,2,17,10,9,58,41,17,61
Dundee Utd,4119,3,17,9,10,53,39,14,60
Morton,4119,4,15,10,11,51,41,10,55
Queen of S't,4119,5,12,11,13,49,50,-1,47
Dunfermline,4119,6,10,13,13,45,48,-3,43
St Mirren,4119,7,10,11,15,45,56,-11,41
Raith,4119,8,9,12,15,38,51,-13,39
Ayr,4119,9,9,12,15,32,56,-24,39
Dumbarton,4119,10,9,11,16,45,55,-10,38
Hibernian,4120,1,18,13,5,56,26,30,67
Morton,4120,2,16,11,9,49,42,7,59
Falkirk,4120,3,16,10,10,63,44,19,58
Dundee Utd,4120,4,16,9,11,53,42,11,57
Queen of S't,4120,5,13,10,13,52,52,0,49
Dunfermline,4120,6,11,11,14,47,52,-5,44
Ayr,4120,7,11,11,14,39,51,-12,44
Dumbarton,4120,8,10,11,15,57,66,-9,41
Raith,4120,9,9,9,18,33,50,-17,36
St Mirren,4120,10,8,9,19,39,63,-24,33
Hibernian,4121,1,18,12,6,56,29,27,66
Morton,4121,2,18,11,7,55,39,16,65
Falkirk,4121,3,18,10,8,64,41,23,64
Dundee Utd,4121,4,17,11,8,57,41,16,62
Dunfermline,4121,5,11,11,14,51,52,-1,44
Queen of S't,4121,6,11,10,15,46,50,-4,43
Dumbarton,4121,7,9,11,16,45,60,-15,38
Raith,4121,8,9,10,17,35,54,-19,37
Ayr,4121,9,7,13,16,34,59,-25,34
St Mirren,4121,10,7,11,18,38,56,-18,32
Hibernian,4122,1,18,14,4,54,25,29,68
Morton,4122,2,17,12,7,50,36,14,63
Dundee Utd,4122,3,17,8,11,49,42,7,59
Falkirk,4122,4,16,10,10,65,44,21,58
Dunfermline,4122,5,11,12,13,48,48,0,45
Queen of S't,4122,6,11,11,14,44,48,-4,44
Ayr,4122,7,10,11,15,38,52,-14,41
Raith,4122,8,9,10,17,35,51,-16,37
Dumbarton,4122,9,8,12,16,50,65,-15,36
St Mirren,4122,10,7,12,17,36,58,-22,33
Hibernian,4123,1,19,12,5,54,27,27,69
Falkirk,4123,2,16,11,9,56,39,17,59
Morton,4123,3,15,12,9,56,41,15,57
Dundee Utd,4123,4,15,10,11,54,47,7,55
Queen of S't,4123,5,11,13,12,47,48,-1,46
Raith,4123,6,11,10,15,34,48,-14,43
Dumbarton,4123,7,10,11,15,48,56,-8,41
St Mirren,4123,8,10,9,17,40,53,-13,39
Dunfermline,4123,9,7,17,12,44,49,-5,38
Ayr,4123,10,8,11,17,35,60,-25,35
Hibernian,4124,1,23,10,3,67,21,46,79
Dundee Utd,4124,2,18,10,8,52,34,18,64
Morton,4124,3,17,10,9,52,42,10,61
Falkirk,4124,4,15,12,9,55,38,17,57
Queen of S't,4124,5,11,9,16,43,54,-11,42
Dunfermline,4124,6,9,14,13,46,54,-8,41
Dumbarton,4124,7,9,12,15,48,57,-9,39
Raith,4124,8,10,8,18,33,49,-16,38
Ayr,4124,9,9,10,17,35,57,-22,37
St Mirren,4124,10,7,9,20,38,63,-25,30
Hibernian,4125,1,19,13,4,57,25,32,70
Falkirk,4125,2,17,11,8,57,37,20,62
Morton,4125,3,17,10,9,46,36,10,61
Dundee Utd,4125,4,13,12,11,44,41,3,51
Dunfermline,4125,5,11,12,13,46,48,-2,45
Raith,4125,6,11,11,14,39,45,-6,44
Dumbarton,4125,7,11,10,15,48,54,-6,43
Ayr,4125,8,9,13,14,37,52,-15,40
Queen of S't,4125,9,9,9,18,41,56,-15,36
St Mirren,4125,10,7,11,18,34,55,-21,32
Hibernian,4126,1,20,11,5,58,23,35,71
Morton,4126,2,17,11,8,55,38,17,62
Falkirk,4126,3,15,10,11,55,40,15,55
Dundee Utd,4126,4,15,10,11,46,39,7,55
Raith,4126,5,13,8,15,37,48,-11,47
Dunfermline,4126,6,11,11,14,48,52,-4,44
Queen of S't,4126,7,11,9,16,41,48,-7,42
St Mirren,4126,8,9,11,16,41,55,-14,38
Dumbarton,4126,9,8,13,15,49,63,-14,37
Ayr,4126,10,8,12,16,32,56,-24,36
Hibernian,4127,1,22,11,3,56,21,35,77
Morton,4127,2,16,13,7,47,34,13,61
Falkirk,4127,3,17,9,10,60,41,19,60
Dundee Utd,4127,4,14,9,13,44,41,3,51
Raith,4127,5,11,9,16,35,46,-11,42
Dunfermline,4127,6,9,14,13,43,44,-1,41
Queen of S't,4127,7,11,8,17,42,51,-9,41
Dumbarton,4127,8,10,11,15,48,59,-11,41
St Mirren,4127,9,10,9,17,39,56,-17,39
Ayr,4127,10,7,13,16,29,50,-21,34
Hibernian,4128,1,19,12,5,57,28,29,69
Morton,4128,2,17,11,8,52,40,12,62
Falkirk,4128,3,15,11,10,59,39,20,56
Dundee Utd,4128,4,14,12,10,49,43,6,54
St Mirren,4128,5,11,10,15,43,53,-10,43
Dunfermline,4128,6,9,15,12,47,47,0,42
Dumbarton,4128,7,10,12,14,51,58,-7,42
Raith,4128,8,10,10,16,38,53,-15,40
Queen of S't,4128,9,10,9,17,41,56,-15,39
Ayr,4128,10,8,12,16,34,54,-20,36
Hibernian,4129,1,18,12,6,54,27,27,66
Dundee Utd,4129,2,18,9,9,56,41,15,63
Morton,4129,3,16,11,9,54,42,12,59
Falkirk,4129,4,14,11,11,55,43,12,53
Dunfermline,4129,5,12,13,11,50,50,0,49
Queen of S't,4129,6,11,11,14,41,46,-5,44
Raith,4129,7,12,8,16,36,47,-11,44
St Mirren,4129,8,10,10,16,45,56,-11,40
Dumbarton,4129,9,8,13,15,47,59,-12,37
Ayr,4129,10,6,12,18,32,59,-27,30
Hibernian,4130,1,19,13,4,58,21,37,70
Morton,4130,2,18,11,7,50,37,13,65
Dundee Utd,4130,3,16,11,9,50,37,13,59
Falkirk,4130,4,13,10,13,55,48,7,49
Queen of S't,4130,5,12,11,13,45,50,-5,47
Raith,4130,6,11,9,16,35,49,-14,42
Dunfermline,4130,7,9,12,15,45,51,-6,39
Dumbarton,4130,8,9,12,15,54,62,-8,39
Ayr,4130,9,9,12,15,36,54,-18,39
St Mirren,4130,10,8,11,17,39,58,-19,35
Hibernian,4131,1,20,12,4,58,26,32,72
Morton,4131,2,17,11,8,49,35,14,62
Falkirk,4131,3,16,10,10,56,42,14,58
Dundee Utd,4131,4,14,10,12,50,42,8,52
Queen of S't,4131,5,11,11,14,50,52,-2,44
Dunfermline,4131,6,10,14,12,43,46,-3,44
Ayr,4131,7,10,10,16,36,58,-22,40
St Mirren,4131,8,9,11,16,44,55,-11,38
Dumbarton,4131,9,9,11,16,47,61,-14,38
Raith,4131,10,9,10,17,37,53,-16,37
Hibernian,4132,1,17,15,4,54,25,29,66
Falkirk,4132,2,18,9,9,63,39,24,63
Morton,4132,3,15,15,6,50,36,14,60
Dundee Utd,4132,4,15,12,9,50,41,9,57
Queen of S't,4132,5,10,11,15,42,54,-12,41
Raith,4132,6,10,11,15,33,46,-13,41
Dunfermline,4132,7,8,16,12,41,45,-4,40
Ayr,4132,8,8,14,14,33,52,-19,38
St Mirren,4132,9,8,12,16,41,55,-14,36
Dumbarton,4132,10,8,11,17,49,63,-14,35
Hibernian,4133,1,22,11,3,62,21,41,77
Falkirk,4133,2,16,10,10,57,41,16,58
Morton,4133,3,15,12,9,47,37,10,57
Dundee Utd,4133,4,15,9,12,48,42,6,54
Dunfermline,4133,5,10,13,13,48,49,-1,43
Raith,4133,6,11,10,15,37,52,-15,43
Queen of S't,4133,7,11,8,17,47,55,-8,41
Ayr,4133,8,10,11,15,39,56,-17,41
Dumbarton,4133,9,10,10,16,48,60,-12,40
St Mirren,4133,10,8,10,18,38,58,-20,34
Hibernian,4134,1,18,13,5,53,26,27,67
Morton,4134,2,17,11,8,51,39,12,62
Falkirk,4134,3,15,11,10,57,41,16,56
Dundee Utd,4134,4,15,11,10,48,38,10,56
Queen of S't,4134,5,12,11,13,46,49,-3,47
Ayr,4134,6,11,11,14,37,51,-14,44
Dunfermline,4134,7,9,14,13,48,51,-3,41
Dumbarton,4134,8,8,14,14,51,59,-8,38
Raith,4134,9,9,11,16,36,51,-15,38
St Mirren,4134,10,6,13,17,39,61,-22,31
Morton,4135,1,18,13,5,59,34,25,67
Hibernian,4135,2,18,12,6,55,29,26,66
Falkirk,4135,3,16,10,10,62,44,18,58
Dundee Utd,4135,4,15,12,9,51,42,9,57
Dunfermline,4135,5,10,12,14,48,53,-5,42
Dumbarton,4135,6,10,12,14,51,59,-8,42
Raith,4135,7,11,8,17,39,53,-14,41
Queen of S't,4135,8,10,9,17,47,55,-8,39
St Mirren,4135,9,9,9,18,38,58,-20,36
Ayr,4135,10,7,15,14,32,55,-23,36
Hibernian,4136,1,20,12,4,59,24,35,72
Dundee Utd,4136,2,16,11,9,55,43,12,59
Falkirk,4136,3,16,10,10,61,42,19,58
Morton,4136,4,16,10,10,51,40,11,58
Raith,4136,5,12,10,14,37,48,-11,46
Queen of S't,4136,6,11,11,14,40,43,-3,44
Dumbarton,4136,7,10,11,15,50,59,-9,41
Dunfermline,4136,8,8,13,15,43,52,-9,37
St Mirren,4136,9,8,12,16,39,56,-17,36
Ayr,4136,10,7,12,17,32,60,-28,33
Hibernian,4137,1,21,10,5,61,27,34,73
Falkirk,4137,2,17,11,8,61,40,21,62
Dundee Utd,4137,3,17,11,8,54,34,20,62
Morton,4137,4,17,11,8,51,36,15,62
Queen of S't,4137,5,12,8,16,43,50,-7,44
Dumbarton,4137,6,11,10,15,45,57,-12,43
Raith,4137,7,11,8,17,36,53,-17,41
Dunfermline,4137,8,8,13,15,44,52,-8,37
Ayr,4137,9,7,12,17,32,56,-24,33
St Mirren,4137,10,7,10,19,36,58,-22,31
Hibernian,4138,1,21,11,4,62,29,33,74
Falkirk,4138,2,18,9,9,62,40,22,63
Dundee Utd,4138,3,18,8,10,61,39,22,62
Morton,4138,4,15,13,8,50,38,12,58
Dumbarton,4138,5,11,11,14,53,62,-9,44
Dunfermline,4138,6,9,13,14,45,51,-6,40
Raith,4138,7,10,9,17,34,51,-17,39
Queen of S't,4138,8,10,8,18,42,57,-15,38
Ayr,4138,9,9,10,17,34,55,-21,37
St Mirren,4138,10,8,10,18,43,64,-21,34
Hibernian,4139,1,21,11,4,60,25,35,74
Morton,4139,2,18,11,7,47,31,16,65
Falkirk,4139,3,16,10,10,61,44,17,58
Dundee Utd,4139,4,14,12,10,45,37,8,54
Dunfermline,4139,5,9,14,13,46,51,-5,41
Ayr,4139,6,9,14,13,34,50,-16,41
Queen of S't,4139,7,10,10,16,45,54,-9,40
Raith,4139,8,9,12,15,33,48,-15,39
Dumbarton,4139,9,8,12,16,44,56,-12,36
St Mirren,4139,10,8,10,18,38,57,-19,34
Hibernian,4140,1,19,12,5,55,27,28,69
Morton,4140,2,19,11,6,53,31,22,68
Dundee Utd,4140,3,16,11,9,58,38,20,59
Falkirk,4140,4,15,9,12,56,45,11,54
Queen of S't,4140,5,13,9,14,49,51,-2,48
Raith,4140,6,10,12,14,37,47,-10,42
Dunfermline,4140,7,9,13,14,43,53,-10,40
Dumbarton,4140,8,9,10,17,49,67,-18,37
St Mirren,4140,9,8,10,18,41,57,-16,34
Ayr,4140,10,7,13,16,33,58,-25,34
Hibernian,4141,1,21,11,4,58,26,32,74
Falkirk,4141,2,17,9,10,54,43,11,60
Dundee Utd,4141,3,16,10,10,57,41,16,58
Morton,4141,4,15,12,9,53,39,14,57
Dunfermline,4141,5,10,13,13,46,47,-1,43
Queen of S't,4141,6,10,12,14,46,50,-4,42
Dumbarton,4141,7,9,14,13,50,57,-7,41
St Mirren,4141,8,10,9,17,42,59,-17,39
Raith,4141,9,9,11,16,34,50,-16,38
Ayr,4141,10,6,13,17,31,59,-28,31
Hibernian,4142,1,20,11,5,56,26,30,71
Dundee Utd,4142,2,16,10,10,48,37,11,58
Morton,4142,3,15,11,10,47,40,7,56
Falkirk,4142,4,14,10,12,54,45,9,52
Dumbarton,4142,5,11,12,13,52,53,-1,45
Dunfermline,4142,6,10,14,12,50,49,1,44
Queen of S't,4142,7,11,11,14,43,48,-5,44
Ayr,4142,8,10,12,14,40,53,-13,42
Raith,4142,9,10,10,16,39,53,-14,40
St Mirren,4142,10,7,11,18,35,60,-25,32
Morton,4143,1,19,12,5,50,29,21,69
Hibernian,4143,2,18,13,5,55,28,27,67
Falkirk,4143,3,18,9,9,60,36,24,63
Dundee Utd,4143,4,16,8,12,50,42,8,56
Queen of S't,4143,5,13,9,14,48,53,-5,48
St Mirren,4143,6,10,10,16,39,52,-13,40
Raith,4143,7,10,9,17,35,50,-15,39
Dunfermline,4143,8,9,11,16,45,53,-8,38
Dumbarton,4143,9,9,10,17,46,59,-13,37
Ayr,4143,10,7,11,18,32,58,-26,32
Hibernian,4144,1,19,12,5,57,25,32,69
Falkirk,4144,2,18,10,8,61,39,22,64
Morton,4144,3,17,10,9,52,39,13,61
Dundee Utd,4144,4,15,9,12,48,44,4,54
Raith,4144,5,13,8,15,41,50,-9,47
Dunfermline,4144,6,10,13,13,51,51,0,43
Queen of S't,4144,7,10,10,16,42,52,-10,40
Ayr,4144,8,9,12,15,32,51,-19,39
Dumbarton,4144,9,7,14,15,48,61,-13,35
St Mirren,4144,10,7,12,17,37,57,-20,33
Hibernian,4145,1,20,12,4,59,24,35,72
Falkirk,4145,2,16,10,10,57,42,15,58
Dundee Utd,4145,3,16,8,12,51,43,8,56
Morton,4145,4,15,10,11,46,44,2,55
Queen of S't,4145,5,15,8,13,53,47,6,53
Dunfermline,4145,6,13,11,12,47,44,3,50
Ayr,4145,7,10,11,15,39,55,-16,41
Raith,4145,8,9,10,17,33,50,-17,37
Dumbarton,4145,9,8,10,18,45,63,-18,34
St Mirren,4145,10,7,12,17,41,59,-18,33
Hibernian,4146,1,20,13,3,58,22,36,73
Morton,4146,2,17,11,8,46,34,12,62
Dundee Utd,4146,3,16,10,10,52,38,14,58
Falkirk,4146,4,14,13,9,59,46,13,55
Queen of S't,4146,5,11,11,14,43,51,-8,44
Dunfermline,4146,6,10,13,13,47,51,-4,43
Dumbarton,4146,7,9,13,14,53,57,-4,40
St Mirren,4146,8,9,11,16,42,57,-15,38
Raith,4146,9,9,8,19,32,52,-20,35
Ayr,4146,10,7,13,16,30,54,-24,34
Hibernian,4147,1,20,13,3,57,24,33,73
Falkirk,4147,2,16,13,7,60,38,22,61
Dundee Utd,4147,3,16,10,10,51,41,10,58
Morton,4147,4,14,14,8,46,36,10,56
Dunfermline,4147,5,10,14,12,48,48,0,44
Queen of S't,4147,6,11,11,14,43,48,-5,44
St Mirren,4147,7,9,11,16,41,54,-13,38
Ayr,4147,8,8,13,15,37,57,-20,37
Raith,4147,9,9,9,18,33,56,-23,36
Dumbarton,4147,10,7,12,17,46,60,-14,33
Hibernian,4148,1,19,12,5,53,26,27,69
Dundee Utd,4148,2,16,11,9,47,36,11,59
Morton,4148,3,15,11,10,44,38,6,56
Falkirk,4148,4,14,11,11,55,44,11,53
Dunfermline,4148,5,11,14,11,45,43,2,47
Raith,4148,6,11,10,15,38,48,-10,43
Queen of S't,4148,7,10,11,15,43,50,-7,41
Dumbarton,4148,8,10,10,16,48,57,-9,40
Ayr,4148,9,9,13,14,37,50,-13,40
St Mirren,4148,10,8,11,17,40,58,-18,35
Hibernian,4149,1,19,14,3,57,24,33,71
Morton,4149,2,16,12,8,51,41,10,60
Falkirk,4149,3,16,10,10,60,41,19,58
Dundee Utd,4149,4,16,9,11,48,40,8,57
Dunfermline,4149,5,12,13,11,51,44,7,49
Queen of S't,4149,6,12,10,14,47,49,-2,46
Raith,4149,7,11,8,17,35,55,-20,41
Dumbarton,4149,8,8,13,15,45,55,-10,37
Ayr,4149,9,8,13,15,33,53,-20,37
St Mirren,4149,10,6,10,20,34,59,-25,28
Hibernian,4150,1,20,12,4,53,22,31,72
Morton,4150,2,18,11,7,51,34,17,65
Falkirk,4150,3,16,11,9,58,39,19,59
Dundee Utd,4150,4,15,10,11,54,47,7,55
Queen of S't,4150,5,12,10,14,43,48,-5,46
Raith,4150,6,11,9,16,34,46,-12,42
Dunfermline,4150,7,9,14,13,48,52,-4,41
Dumbarton,4150,8,8,12,16,46,59,-13,36
St Mirren,4150,9,8,11,17,42,55,-13,35
Ayr,4150,10,8,10,18,31,58,-27,34
Hibernian,4151,1,18,15,3,54,25,29,69
Morton,4151,2,15,13,8,53,44,9,58
Dundee Utd,4151,3,15,11,10,51,41,10,56
Falkirk,4151,4,13,13,10,56,47,9,52
Raith,4151,5,13,9,14,45,45,0,48
Queen of S't,4151,6,12,11,13,44,47,-3,47
Dunfermline,4151,7,10,11,15,45,51,-6,41
Dumbarton,4151,8,9,11,16,48,59,-11,38
St Mirren,4151,9,9,10,17,43,54,-11,37
Ayr,4151,10,7,14,15,32,58,-26,35
Hibernian,4152,1,19,10,7,54,28,26,67
Morton,4152,2,19,10,7,54,36,18,67
Falkirk,4152,3,17,10,9,60,41,19,61
Dundee Utd,4152,4,14,12,10,48,38,10,54
Queen of S't,4152,5,13,10,13,48,47,1,49
Raith,4152,6,11,10,15,34,45,-11,43
Dunfermline,4152,7,10,12,14,44,47,-3,42
Ayr,4152,8,9,11,16,33,53,-20,38
Dumbarton,4152,9,8,12,16,44,60,-16,36
St Mirren,4152,10,6,11,19,36,60,-24,29
Hibernian,4153,1,21,12,3,59,23,36,75
Morton,4153,2,17,10,9,54,40,14,61
Dundee Utd,4153,3,16,11,9,47,36,11,59
Falkirk,4153,4,15,12,9,58,40,18,57
Dumbarton,4153,5,11,12,13,49,53,-4,45
Dunfermline,4153,6,10,12,14,47,49,-2,42
Queen of S't,4153,7,11,9,16,42,51,-9,42
Raith,4153,8,11,9,16,36,53,-17,42
St Mirren,4153,9,7,10,19,37,56,-19,31
Ayr,4153,10,6,13,17,30,58,-28,31
Hibernian,4154,1,19,12,5,54,26,28,69
Falkirk,4154,2,17,11,8,64,42,22,62
Morton,4154,3,17,10,9,47,34,13,61
Dundee Utd,4154,4,16,11,9,50,41,9,59
Dunfermline,4154,5,11,12,13,52,45,7,45
Dumbarton,4154,6,9,13,14,47,55,-8,40
Ayr,4154,7,9,13,14,39,54,-15,40
Queen of S't,4154,8,10,9,17,41,58,-17,39
Raith,4154,9,9,10,17,34,52,-18,37
St Mirren,4154,10,7,11,18,38,59,-21,32
Hibernian,4155,1,18,12,6,58,30,28,66
Morton,4155,2,18,12,6,56,34,22,66
Falkirk,4155,3,17,11,8,63,43,20,62
Dundee Utd,4155,4,15,11,10,51,42,9,56
Dunfermline,4155,5,11,11,14,48,49,-1,44
Ayr,4155,6,10,11,15,38,56,-18,41
St Mirren,4155,7,9,12,15,46,53,-7,39
Queen of S't,4155,8,10,9,17,41,53,-12,39
Dumbarton,4155,9,8,12,16,45,61,-16,36
Raith,4155,10,8,11,17,32,57,-25,35
Hibernian,4156,1,21,11,4,64,25,39,74
Falkirk,4156,2,17,10,9,55,36,19,61
Dundee Utd,4156,3,16,11,9,50,39,11,59
Morton,4156,4,16,10,10,51,42,9,58
Queen of S't,4156,5,12,10,14,45,48,-3,46
Raith,4156,6,12,8,16,36,49,-13,44
St Mirren,4156,7,10,11,15,41,52,-11,41
Dunfermline,4156,8,8,12,16,42,54,-12,36
Dumbarton,4156,9,8,11,17,46,58,-12,35
Ayr,4156,10,7,12,17,32,59,-27,33
Hibernian,4157,1,21,11,4,57,26,31,74
Falkirk,4157,2,17,10,9,63,41,22,61
Morton,4157,3,17,10,9,49,39,10,61
Dundee Utd,4157,4,13,11,12,43,41,2,50
Dunfermline,4157,5,10,13,13,49,49,0,43
Dumbarton,4157,6,10,11,15,49,54,-5,41
Raith,4157,7,10,10,16,39,50,-11,40
St Mirren,4157,8,10,10,16,41,55,-14,40
Queen of S't,4157,9,10,9,17,42,61,-19,39
Ayr,4157,10,8,13,15,35,51,-16,37
Hibernian,4158,1,20,12,4,56,27,29,72
Falkirk,4158,2,16,13,7,61,41,20,61
Morton,4158,3,17,9,10,50,40,10,60
Dundee Utd,4158,4,15,10,11,51,40,11,55
Queen of S't,4158,5,12,10,14,41,44,-3,46
Dumbarton,4158,6,10,11,15,46,56,-10,41
Dunfermline,4158,7,9,13,14,48,52,-4,40
Ayr,4158,8,8,14,14,33,49,-16,38
St Mirren,4158,9,9,10,17,43,60,-17,37
Raith,4158,10,9,8,19,35,55,-20,35
Hibernian,4159,1,19,12,5,53,26,27,69
Morton,4159,2,16,12,8,48,34,14,60
Falkirk,4159,3,16,10,10,58,40,18,58
Dundee Utd,4159,4,15,12,9,50,37,13,57
Dunfermline,4159,5,9,15,12,45,48,-3,42
Queen of S't,4159,6,11,9,16,46,50,-4,42
Raith,4159,7,11,9,16,33,48,-15,42
St Mirren,4159,8,10,11,15,39,51,-12,41
Dumbarton,4159,9,8,13,15,46,63,-17,37
Ayr,4159,10,8,11,17,31,52,-21,35
Hibernian,4160,1,19,13,4,57,24,33,70
Falkirk,4160,2,18,10,8,61,40,21,64
Morton,4160,3,15,10,11,43,38,5,55
Dundee Utd,4160,4,15,9,12,53,41,12,54
Queen of S't,4160,5,13,9,14,46,49,-3,48
Dumbarton,4160,6,11,11,14,53,55,-2,44
Dunfermline,4160,7,11,11,14,44,50,-6,44
Raith,4160,8,10,8,18,33,50,-17,38
Ayr,4160,9,8,13,15,33,57,-24,37
St Mirren,4160,10,7,12,17,36,55,-19,33
Hibernian,4161,1,19,11,6,55,25,30,68
Dundee Utd,4161,2,17,11,8,56,40,16,62
Falkirk,4161,3,16,10,10,57,42,15,58
Morton,4161,4,15,10,11,45,40,5,55
Dunfermline,4161,5,12,11,13,50,51,-1,47
Dumbarton,4161,6,11,11,14,53,58,-5,44
Queen of S't,4161,7,11,10,15,45,57,-12,43
Ayr,4161,8,10,12,14,40,54,-14,42
St Mirren,4161,9,8,10,18,41,56,-15,34
Raith,4161,10,8,10,18,33,52,-19,34
Morton,4162,1,18,13,5,60,37,23,67
Hibernian,4162,2,17,13,6,50,26,24,64
Dundee Utd,4162,3,16,9,11,54,41,13,57
Falkirk,4162,4,14,12,10,57,44,13,54
Queen of S't,4162,5,13,8,15,49,53,-4,47
Dunfermline,4162,6,9,14,13,46,50,-4,41
Ayr,4162,7,10,11,15,36,51,-15,41
Dumbarton,4162,8,9,13,14,51,60,-9,40
St Mirren,4162,9,8,12,16,38,60,-22,36
Raith,4162,10,8,11,17,35,54,-19,35
Hibernian,4163,1,23,10,3,61,23,38,79
Falkirk,4163,2,17,10,9,59,38,21,61
Morton,4163,3,16,11,9,51,41,10,59
Dundee Utd,4163,4,15,10,11,51,40,11,55
Queen of S't,4163,5,11,11,14,46,51,-5,44
Dumbarton,4163,6,11,10,15,49,56,-7,43
Dunfermline,4163,7,9,13,14,43,50,-7,40
Raith,4163,8,10,10,16,35,51,-16,40
St Mirren,4163,9,7,11,18,35,54,-19,32
Ayr,4163,10,6,14,16,32,58,-26,32
Hibernian,4164,1,20,12,4,56,25,31,72
Morton,4164,2,16,13,7,49,33,16,61
Falkirk,4164,3,16,11,9,58,40,18,59
Dundee Utd,4164,4,16,11,9,48,39,9,59
Queen of S't,4164,5,11,11,14,48,51,-3,44
Dunfermline,4164,6,9,13,14,45,49,-4,40
Ayr,4164,7,8,14,14,36,52,-16,38
Dumbarton,4164,8,8,13,15,47,57,-10,37
Raith,4164,9,8,13,15,31,46,-15,37
St Mirren,4164,10,8,9,19,34,60,-26,33
Hibernian,4165,1,21,11,4,57,23,34,74
Dundee Utd,4165,2,16,11,9,50,39,11,59
Morton,4165,3,15,11,10,46,38,8,56
Falkirk,4165,4,14,9,13,56,46,10,51
Dumbarton,4165,5,11,12,13,50,52,-2,45
Dunfermline,4165,6,10,14,12,45,43,2,44
Queen of S't,4165,7,10,10,16,42,52,-10,40
St Mirren,4165,8,10,9,17,42,59,-17,39
Ayr,4165,9,9,12,15,35,53,-18,39
Raith,4165,10,10,9,17,33,51,-18,39
Hibernian,4166,1,20,12,4,53,22,31,72
Morton,4166,2,19,10,7,57,35,22,67
Falkirk,4166,3,17,9,10,55,38,17,60
Dundee Utd,4166,4,16,9,11,50,39,11,57
Queen of S't,4166,5,11,9,16,46,50,-4,42
Dunfermline,4166,6,10,12,14,42,46,-4,42
Ayr,4166,7,10,10,16,37,59,-22,40
Raith,4166,8,10,9,17,38,54,-16,39
Dumbarton,4166,9,9,11,16,48,65,-17,38
St Mirren,4166,10,7,11,18,43,61,-18,32
Hibernian,4167,1,17,13,6,52,29,23,64
Dundee Utd,4167,2,18,9,9,59,38,21,63
Falkirk,4167,3,17,11,8,70,42,28,62
Morton,4167,4,16,10,10,48,39,9,58
Dunfermline,4167,5,12,13,11,54,48,6,49
Queen of S't,4167,6,10,11,15,50,58,-8,41
Raith,4167,7,10,10,16,34,53,-19,40
St Mirren,4167,8,9,11,16,41,56,-15,38
Dumbarton,4167,9,8,11,17,47,68,-21,35
Ayr,4167,10,8,11,17,32,56,-24,35
Hibernian,4168,1,16,14,6,50,27,23,62
Dundee Utd,4168,2,17,10,9,54,41,13,61
Morton,4168,3,16,12,8,54,42,12,60
Falkirk,4168,4,16,10,10,54,39,15,58
Dunfermline,4168,5,12,12,12,52,50,2,48
Raith,4168,6,11,10,15,39,47,-8,43
Queen of S't,4168,7,9,12,15,43,54,-11,39
Dumbarton,4168,8,9,11,16,50,61,-11,38
St Mirren,4168,9,8,12,16,39,53,-14,36
Ayr,4168,10,7,15,14,32,53,-21,36
Hibernian,4169,1,21,10,5,54,24,30,73
Dundee Utd,4169,2,17,9,10,55,38,17,60
Falkirk,4169,3,16,11,9,57,40,17,59
Morton,4169,4,16,11,9,43,32,11,59
Raith,4169,5,13,9,14,42,46,-4,48
Ayr,4169,6,11,11,14,37,51,-14,44
Queen of S't,4169,7,10,10,16,41,53,-12,40
Dunfermline,4169,8,8,13,15,43,51,-8,37
Dumbarton,4169,9,8,12,16,46,61,-15,36
St Mirren,4169,10,7,10,19,37,59,-22,31
Hibernian,4170,1,20,12,4,55,25,30,72
Falkirk,4170,2,17,10,9,59,40,19,61
Morton,4170,3,15,15,6,51,36,15,60
Dundee Utd,4170,4,16,9,11,55,43,12,57
Queen of S't,4170,5,11,11,14,45,49,-4,44
Raith,4170,6,10,10,16,36,51,-15,40
Dumbarton,4170,7,9,12,15,48,60,-12,39
St Mirren,4170,8,10,9,17,44,56,-12,39
Dunfermline,4170,9,8,14,14,45,53,-8,38
Ayr,4170,10,7,12,17,35,60,-25,33
Hibernian,4171,1,20,12,4,56,22,34,72
Morton,4171,2,19,10,7,53,35,18,67
Falkirk,4171,3,14,10,12,56,47,9,52
Dundee Utd,4171,4,13,10,13,44,41,3,49
Dunfermline,4171,5,12,11,13,50,48,2,47
Queen of S't,4171,6,10,12,14,43,49,-6,42
St Mirren,4171,7,11,9,16,44,56,-12,42
Dumbarton,4171,8,10,11,15,49,57,-8,41
Ayr,4171,9,9,11,16,32,54,-22,38
Raith,4171,10,9,10,17,32,50,-18,37
Hibernian,4172,1,20,11,5,61,30,31,71
Morton,4172,2,17,13,6,49,33,16,64
Falkirk,4172,3,17,10,9,59,39,20,61
Dundee Utd,4172,4,15,12,9,49,37,12,57
Dunfermline,4172,5,10,12,14,51,52,-1,42
Raith,4172,6,11,9,16,38,49,-11,42
Queen of S't,4172,7,10,10,16,42,52,-10,40
Dumbarton,4172,8,9,11,16,46,59,-13,38
St Mirren,4172,9,8,11,17,34,54,-20,35
Ayr,4172,10,8,11,17,36,60,-24,35
Hibernian,4173,1,19,14,3,58,27,31,71
Morton,4173,2,16,12,8,52,42,10,60
Falkirk,4173,3,16,10,10,55,40,15,58
Dundee Utd,4173,4,15,11,10,53,42,11,56
Queen of S't,4173,5,14,9,13,55,52,3,51
Dunfermline,4173,6,9,14,13,50,53,-3,41
St Mirren,4173,7,9,12,15,45,52,-7,39
Raith,4173,8,9,10,17,33,49,-16,37
Dumbarton,4173,9,8,12,16,45,62,-17,36
Ayr,4173,10,7,12,17,33,60,-27,33
Hibernian,4174,1,18,13,5,53,26,27,67
Morton,4174,2,17,11,8,51,37,14,62
Falkirk,4174,3,17,10,9,63,42,21,61
Dundee Utd,4174,4,17,8,11,48,37,11,59
Dunfermline,4174,5,11,12,13,48,47,1,45
Queen of S't,4174,6,12,8,16,45,53,-8,44
Raith,4174,7,10,9,17,38,53,-15,39
St Mirren,4174,8,8,13,15,36,51,-15,37
Dumbarton,4174,9,8,12,16,47,61,-14,36
Ayr,4174,10,8,12,16,34,56,-22,36
Hibernian,4175,1,20,12,4,58,28,30,72
Morton,4175,2,16,12,8,50,34,16,60
Falkirk,4175,3,15,11,10,58,43,15,56
Dundee Utd,4175,4,14,10,12,47,44,3,52
Raith,4175,5,12,10,14,42,50,-8,46
Queen of S't,4175,6,12,9,15,49,51,-2,45
Dumbarton,4175,7,11,12,13,50,55,-5,45
Dunfermline,4175,8,10,13,13,45,47,-2,43
Ayr,4175,9,7,12,17,35,60,-25,33
St Mirren,4175,10,7,11,18,35,57,-22,32
Hibernian,4176,1,23,10,3,61,22,39,79
Morton,4176,2,18,9,9,52,36,16,63
Falkirk,4176,3,17,11,8,63,39,24,62
Dundee Utd,4176,4,16,10,10,46,39,7,58
Dunfermline,4176,5,10,11,15,47,52,-5,41
Dumbarton,4176,6,9,12,15,45,55,-10,39
Queen of S't,4176,7,10,9,17,41,53,-12,39
Raith,4176,8,9,10,17,31,51,-20,37
Ayr,4176,9,8,12,16,33,53,-20,36
St Mirren,4176,10,7,12,17,40,59,-19,33
Hibernian,4177,1,21,11,4,61,23,38,74
Dundee Utd,4177,2,19,8,9,55,39,16,65
Falkirk,4177,3,17,10,9,61,47,14,61
Morton,4177,4,15,9,12,48,47,1,54
Raith,4177,5,12,8,16,40,48,-8,44
Dunfermline,4177,6,9,14,13,45,45,0,41
Queen of S't,4177,7,10,10,16,43,55,-12,40
St Mirren,4177,8,10,10,16,42,56,-14,40
Dumbarton,4177,9,9,12,15,49,57,-8,39
Ayr,4177,10,7,10,19,33,60,-27,31
Morton,4178,1,17,13,6,48,32,16,64
Hibernian,4178,2,17,12,7,54,31,23,63
Dundee Utd,4178,3,16,12,8,50,37,13,60
Falkirk,4178,4,13,10,13,53,47,6,49
Dunfermline,4178,5,12,12,12,51,47,4,48
Queen of S't,4178,6,11,11,14,44,48,-4,44
Raith,4178,7,10,10,16,35,46,-11,40
St Mirren,4178,8,10,9,17,44,56,-12,39
Ayr,4178,9,9,12,15,35,53,-18,39
Dumbarton,4178,10,9,11,16,47,64,-17,38
Hibernian,4179,1,18,14,4,57,27,30,68
Morton,4179,2,18,13,5,52,30,22,67
Falkirk,4179,3,16,11,9,57,39,18,59
Dundee Utd,4179,4,15,9,12,51,43,8,54
Queen of S't,4179,5,13,8,15,45,49,-4,47
Dunfermline,4179,6,10,14,12,47,48,-1,44
Raith,4179,7,12,8,16,36,45,-9,44
Dumbarton,4179,8,9,12,15,46,56,-10,39
Ayr,4179,9,8,10,18,31,59,-28,34
St Mirren,4179,10,6,11,19,35,61,-26,29
Hibernian,4180,1,20,13,3,60,24,36,73
Morton,4180,2,16,11,9,50,39,11,59
Dundee Utd,4180,3,16,8,12,51,40,11,56
Falkirk,4180,4,15,9,12,58,46,12,54
Dunfermline,4180,5,12,13,11,51,47,4,49
Raith,4180,6,10,11,15,34,49,-15,41
Queen of S't,4180,7,10,10,16,44,53,-9,40
Dumbarton,4180,8,9,12,15,49,60,-11,39
Ayr,4180,9,9,12,15,34,54,-20,39
St Mirren,4180,10,8,11,17,39,58,-19,35
Hibernian,4181,1,18,14,4,55,24,31,68
Morton,4181,2,15,13,8,53,42,11,58
Falkirk,4181,3,15,11,10,57,44,13,56
Dundee Utd,4181,4,14,11,11,51,44,7,53
Dumbarton,4181,5,13,10,13,57,57,0,49
Raith,4181,6,11,10,15,38,47,-9,43
Dunfermline,4181,7,10,12,14,46,55,-9,42
Ayr,4181,8,9,13,14,34,51,-17,40
Queen of S't,4181,9,10,8,18,45,56,-11,38
St Mirren,4181,10,8,12,16,39,55,-16,36
Hibernian,4182,1,20,12,4,55,24,31,72
Dundee Utd,4182,2,15,11,10,48,39,9,56
Morton,4182,3,15,11,10,49,41,8,56
Falkirk,4182,4,15,9,12,53,43,10,54
Dunfermline,4182,5,12,12,12,48,44,4,48
Queen of S't,4182,6,12,9,15,46,51,-5,45
Dumbarton,4182,7,10,12,14,52,57,-5,42
Raith,4182,8,10,9,17,33,48,-15,39
St Mirren,4182,9,9,11,16,40,53,-13,38
Ayr,4182,10,8,12,16,31,55,-24,36
Hibernian,4183,1,20,13,3,61,26,35,73
Morton,4183,2,17,11,8,50,39,11,62
Falkirk,4183,3,16,11,9,55,39,16,59
Dundee Utd,4183,4,16,10,10,51,38,13,58
Dunfermline,4183,5,10,14,12,49,46,3,44
Queen of S't,4183,6,11,10,15,45,52,-7,43
Raith,4183,7,11,8,17,36,48,-12,41
Dumbarton,4183,8,9,12,15,45,58,-13,39
St Mirren,4183,9,7,13,16,37,53,-16,34
Ayr,4183,10,6,12,18,31,61,-30,30
Hibernian,4184,1,18,12,6,56,29,27,66
Morton,4184,2,18,9,9,48,35,13,63
Dundee Utd,4184,3,17,9,10,58,40,18,60
Falkirk,4184,4,16,10,10,59,43,16,58
Dunfermline,4184,5,12,12,12,52,50,2,48
Raith,4184,6,11,9,16,34,47,-13,42
Dumbarton,4184,7,10,11,15,54,65,-11,41
Queen of S't,4184,8,10,9,17,43,55,-12,39
St Mirren,4184,9,9,11,16,40,58,-18,38
Ayr,4184,10,7,12,17,36,58,-22,33
Morton,4185,1,19,10,7,57,37,20,67
Hibernian,4185,2,18,10,8,55,33,22,64
Falkirk,4185,3,16,11,9,59,40,19,59
Dundee Utd,4185,4,16,9,11,54,47,7,57
Dunfermline,4185,5,11,12,13,49,48,1,45
Queen of S't,4185,6,12,9,15,44,49,-5,45
Raith,4185,7,11,8,17,40,56,-16,41
Dumbarton,4185,8,9,11,16,45,53,-8,38
Ayr,4185,9,9,11,16,36,58,-22,38
St Mirren,4185,10,8,11,17,41,59,-18,35
Morton,4186,1,18,11,7,49,34,15,65
Hibernian,4186,2,17,13,6,48,27,21,64
Falkirk,4186,3,17,10,9,54,39,15,61
Dundee Utd,4186,4,16,11,9,52,40,12,59
Queen of S't,4186,5,11,10,15,42,47,-5,43
Dunfermline,4186,6,10,12,14,47,50,-3,42
Dumbarton,4186,7,10,11,15,50,53,-3,41
Raith,4186,8,10,10,16,36,48,-12,40
Ayr,4186,9,9,12,15,32,52,-20,39
St Mirren,4186,10,7,10,19,37,57,-20,31
Hibernian,4187,1,20,11,5,57,30,27,71
Morton,4187,2,19,10,7,52,33,19,67
Falkirk,4187,3,16,11,9,61,42,19,59
Dundee Utd,4187,4,14,9,13,46,41,5,51
Ayr,4187,5,12,12,12,41,48,-7,48
Queen of S't,4187,6,12,8,16,46,56,-10,44
Dunfermline,4187,7,9,14,13,49,48,1,41
Dumbarton,4187,8,9,13,14,48,55,-7,40
St Mirren,4187,9,8,10,18,40,58,-18,34
Raith,4187,10,8,8,20,30,59,-29,32
Morton,4188,1,18,12,6,52,35,17,66
Hibernian,4188,2,16,12,8,53,34,19,60
Falkirk,4188,3,17,9,10,60,43,17,60
Dundee Utd,4188,4,14,10,12,47,38,9,52
Queen of S't,4188,5,14,8,14,48,47,1,50
Dunfermline,4188,6,10,13,13,48,51,-3,43
Raith,4188,7,11,9,16,37,49,-12,42
St Mirren,4188,8,10,11,15,42,52,-10,41
Dumbarton,4188,9,8,12,16,43,60,-17,36
Ayr,4188,10,8,12,16,34,55,-21,36
Hibernian,4189,1,19,13,4,53,25,28,70
Falkirk,4189,2,16,11,9,62,42,20,59
Morton,4189,3,15,14,7,53,39,14,59
Dundee Utd,4189,4,14,9,13,46,47,-1,51
Queen of S't,4189,5,13,9,14,51,48,3,48
Dunfermline,4189,6,10,13,13,45,49,-4,43
Dumbarton,4189,7,9,14,13,47,55,-8,41
Raith,4189,8,10,10,16,33,48,-15,40
Ayr,4189,9,9,12,15,36,54,-18,39
St Mirren,4189,10,7,11,18,39,58,-19,32
Morton,4190,1,19,10,7,51,36,15,67
Hibernian,4190,2,18,12,6,54,27,27,66
Dundee Utd,4190,3,16,9,11,52,42,10,57
Falkirk,4190,4,15,11,10,62,47,15,56
Dunfermline,4190,5,11,12,13,50,46,4,45
Queen of S't,4190,6,12,9,15,45,49,-4,45
Raith,4190,7,11,9,16,36,52,-16,42
Dumbarton,4190,8,9,13,14,51,59,-8,40
St Mirren,4190,9,8,11,17,48,64,-16,35
Ayr,4190,10,6,14,16,36,63,-27,32
Hibernian,4191,1,20,12,4,54,22,32,72
Morton,4191,2,18,11,7,51,33,18,65
Dundee Utd,4191,3,16,10,10,52,37,15,58
Falkirk,4191,4,15,12,9,56,39,17,57
Queen of S't,4191,5,13,8,15,43,45,-2,47
Dunfermline,4191,6,8,16,12,41,44,-3,40
Dumbarton,4191,7,9,13,14,47,59,-12,40
Raith,4191,8,9,9,18,35,53,-18,36
St Mirren,4191,9,9,9,18,43,63,-20,36
Ayr,4191,10,8,10,18,34,61,-27,34
Hibernian,4192,1,20,11,5,58,31,27,71
Morton,4192,2,19,10,7,56,35,21,67
Dundee Utd,4192,3,16,10,10,46,38,8,58
Falkirk,4192,4,14,12,10,52,41,11,54
Queen of S't,4192,5,12,9,15,48,50,-2,45
Raith,4192,6,12,9,15,37,47,-10,45
Ayr,4192,7,10,11,15,35,53,-18,41
Dumbarton,4192,8,10,10,16,49,57,-8,40
Dunfermline,4192,9,7,14,15,44,53,-9,35
St Mirren,4192,10,7,10,19,39,59,-20,31
Morton,4193,1,17,13,6,52,35,17,64
Hibernian,4193,2,16,12,8,52,35,17,60
Falkirk,4193,3,14,12,10,57,41,16,54
Dundee Utd,4193,4,14,9,13,46,44,2,51
Queen of S't,4193,5,13,10,13,49,50,-1,49
Dunfermline,4193,6,11,14,11,49,45,4,47
Dumbarton,4193,7,11,11,14,52,58,-6,44
Raith,4193,8,11,9,16,35,49,-14,42
Ayr,4193,9,8,13,15,38,57,-19,37
St Mirren,4193,10,8,11,17,39,55,-16,35
Hibernian,4194,1,22,10,4,60,25,35,76
Morton,4194,2,16,12,8,50,37,13,60
Falkirk,4194,3,16,11,9,64,41,23,59
Dundee Utd,4194,4,16,11,9,48,35,13,59
Dunfermline,4194,5,11,12,13,43,46,-3,45
Dumbarton,4194,6,10,12,14,49,57,-8,42
Raith,4194,7,10,10,16,34,49,-15,40
Ayr,4194,8,8,13,15,33,55,-22,37
Queen of S't,4194,9,9,9,18,37,53,-16,36
St Mirren,4194,10,6,12,18,39,59,-20,30
Hibernian,4195,1,16,17,3,51,24,27,65
Falkirk,4195,2,17,11,8,57,37,20,62
Morton,4195,3,15,13,8,47,38,9,58
Dundee Utd,4195,4,15,9,12,47,41,6,54
Queen of S't,4195,5,13,8,15,47,51,-4,47
Dunfermline,4195,6,10,13,13,51,49,2,43
Raith,4195,7,10,10,16,34,48,-14,40
St Mirren,4195,8,9,12,15,40,51,-11,39
Dumbarton,4195,9,9,11,16,45,57,-12,38
Ayr,4195,10,8,12,16,33,56,-23,36
Hibernian,4196,1,21,12,3,63,23,40,75
Falkirk,4196,2,16,11,9,55,40,15,59
Morton,4196,3,15,13,8,47,33,14,58
Dundee Utd,4196,4,15,11,10,54,41,13,56
Queen of S't,4196,5,12,9,15,47,51,-4,45
Raith,4196,6,11,10,15,35,49,-14,43
Dunfermline,4196,7,9,14,13,41,48,-7,41
St Mirren,4196,8,9,10,17,43,60,-17,37
Dumbarton,4196,9,8,12,16,42,58,-16,36
Ayr,4196,10,7,12,17,34,58,-24,33
Hibernian,4197,1,21,11,4,60,25,35,74
Morton,4197,2,19,11,6,57,37,20,68
Falkirk,4197,3,16,11,9,64,42,22,59
Dundee Utd,4197,4,15,9,12,50,46,4,54
Queen of S't,4197,5,12,10,14,47,50,-3,46
Dumbarton,4197,6,11,10,15,50,56,-6,43
Raith,4197,7,9,10,17,31,50,-19,37
Dunfermline,4197,8,7,14,15,39,51,-12,35
St Mirren,4197,9,8,11,17,42,58,-16,35
Ayr,4197,10,7,13,16,33,58,-25,34
Hibernian,4198,1,20,11,5,55,27,28,71
Falkirk,4198,2,17,10,9,66,47,19,61
Morton,4198,3,16,13,7,51,32,19,61
Dundee Utd,4198,4,14,10,12,47,45,2,52
Queen of S't,4198,5,12,9,15,48,54,-6,45
Raith,4198,6,10,11,15,39,50,-11,41
Dunfermline,4198,7,8,16,12,40,44,-4,40
Ayr,4198,8,9,13,14,33,51,-18,40
Dumbarton,4198,9,8,12,16,44,57,-13,36
St Mirren,4198,10,9,9,18,44,60,-16,36
Morton,4199,1,19,11,6,60,35,25,68
Hibernian,4199,2,17,14,5,54,30,24,65
Falkirk,4199,3,17,9,10,61,43,18,60
Dundee Utd,4199,4,16,8,12,53,43,10,56
Queen of S't,4199,5,12,9,15,46,49,-3,45
Raith,4199,6,11,9,16,35,49,-14,42
Dumbarton,4199,7,10,11,15,45,54,-9,41
Dunfermline,4199,8,9,13,14,46,53,-7,40
Ayr,4199,9,8,13,15,34,53,-19,37
St Mirren,4199,10,7,11,18,36,61,-25,32
Hibernian,4200,1,20,11,5,59,30,29,71
Falkirk,4200,2,19,9,8,61,38,23,66
Morton,4200,3,15,12,9,46,39,7,57
Dundee Utd,4200,4,15,8,13,48,42,6,53
Queen of S't,4200,5,11,10,15,48,52,-4,43
Raith,4200,6,11,10,15,37,47,-10,43
Ayr,4200,7,10,10,16,35,53,-18,40
Dunfermline,4200,8,9,12,15,46,54,-8,39
St Mirren,4200,9,9,12,15,38,50,-12,39
Dumbarton,4200,10,8,12,16,45,58,-13,36
Hibernian,4201,1,21,12,3,55,22,33,75
Falkirk,4201,2,16,12,8,67,42,25,60
Morton,4201,3,16,12,8,52,40,12,60
Dundee Utd,4201,4,14,12,10,51,40,11,54
Queen of S't,4201,5,12,8,16,44,50,-6,44
Dunfermline,4201,6,9,15,12,49,52,-3,42
Raith,4201,7,10,10,16,35,48,-13,40
Ayr,4201,8,9,12,15,37,56,-19,39
Dumbarton,4201,9,8,14,14,48,59,-11,38
St Mirren,4201,10,6,11,19,36,65,-29,29
Hibernian,4202,1,18,13,5,53,26,27,67
Morton,4202,2,18,13,5,53,32,21,67
Dundee Utd,4202,3,15,8,13,51,47,4,53
Falkirk,4202,4,13,12,11,50,44,6,51
Dumbarton,4202,5,11,12,13,50,55,-5,45
Dunfermline,4202,6,10,13,13,46,47,-1,43
Queen of S't,4202,7,11,10,15,50,53,-3,43
Raith,4202,8,11,10,15,38,49,-11,43
Ayr,4202,9,10,12,14,37,52,-15,42
St Mirren,4202,10,6,11,19,35,58,-23,29
Hibernian,4203,1,18,12,6,54,28,26,66
Morton,4203,2,17,11,8,49,36,13,62
Falkirk,4203,3,17,10,9,57,36,21,61
Dundee Utd,4203,4,16,9,11,50,40,10,57
Queen of S't,4203,5,12,9,15,51,57,-6,45
Dumbarton,4203,6,10,12,14,51,57,-6,42
Ayr,4203,7,10,10,16,34,54,-20,40
Dunfermline,4203,8,8,15,13,44,48,-4,39
Raith,4203,9,10,9,17,31,51,-20,39
St Mirren,4203,10,8,11,17,39,53,-14,35
Hibernian,4204,1,18,11,7,55,27,28,65
Morton,4204,2,18,11,7,52,33,19,65
Falkirk,4204,3,18,10,8,60,38,22,64
Dundee Utd,4204,4,15,10,11,51,41,10,55
Dunfermline,4204,5,12,11,13,47,49,-2,47
Queen of S't,4204,6,12,10,14,45,49,-4,46
Raith,4204,7,10,9,17,34,50,-16,39
Dumbarton,4204,8,8,13,15,45,56,-11,37
Ayr,4204,9,9,10,17,33,55,-22,37
St Mirren,4204,10,7,11,18,39,63,-24,32
Morton,4205,1,18,12,6,50,31,19,66
Hibernian,4205,2,18,11,7,56,32,24,65
Falkirk,4205,3,16,10,10,55,43,12,58
Dundee Utd,4205,4,16,9,11,47,37,10,57
Queen of S't,4205,5,14,8,14,47,49,-2,50
Dunfermline,4205,6,9,15,12,45,46,-1,42
Raith,4205,7,9,12,15,35,48,-13,39
St Mirren,4205,8,9,10,17,45,57,-12,37
Ayr,4205,9,8,12,16,32,54,-22,36
Dumbarton,4205,10,8,11,17,43,58,-15,35
Hibernian,4206,1,20,12,4,57,22,35,72
Morton,4206,2,18,10,8,55,39,16,64
Falkirk,4206,3,16,12,8,58,40,18,60
Dundee Utd,4206,4,15,9,12,47,42,5,54
Dunfermline,4206,5,11,12,13,49,47,2,45
Queen of S't,4206,6,10,10,16,43,53,-10,40
Dumbarton,4206,7,10,10,16,51,62,-11,40
Raith,4206,8,10,9,17,35,52,-17,39
St Mirren,4206,9,9,10,17,44,58,-14,37
Ayr,4206,10,9,10,17,35,59,-24,37
Hibernian,4207,1,18,13,5,54,28,26,67
Morton,4207,2,19,10,7,56,34,22,67
Falkirk,4207,3,17,9,10,61,42,19,60
Dundee Utd,4207,4,17,9,10,51,39,12,60
Queen of S't,4207,5,12,10,14,47,51,-4,46
Dunfermline,4207,6,9,14,13,47,49,-2,41
Dumbarton,4207,7,8,13,15,44,59,-15,37
Ayr,4207,8,7,15,14,32,51,-19,36
St Mirren,4207,9,8,11,17,37,57,-20,35
Raith,4207,10,8,10,18,30,49,-19,34
Hibernian,4208,1,19,11,6,60,30,30,68
Dundee Utd,4208,2,16,12,8,53,40,13,60
Morton,4208,3,16,12,8,49,37,12,60
Falkirk,4208,4,16,10,10,59,41,18,58
Queen of S't,4208,5,13,8,15,46,54,-8,47
Dunfermline,4208,6,11,12,13,45,45,0,45
Raith,4208,7,12,8,16,32,48,-16,44
Dumbarton,4208,8,10,12,14,50,55,-5,42
St Mirren,4208,9,7,11,18,37,56,-19,32
Ayr,4208,10,6,12,18,30,55,-25,30
Falkirk,4209,1,18,10,8,63,39,24,64
Morton,4209,2,17,12,7,47,32,15,63
Hibernian,4209,3,16,12,8,47,28,19,60
Dundee Utd,4209,4,15,10,11,47,39,8,55
Dunfermline,4209,5,12,13,11,49,45,4,49
Queen of S't,4209,6,13,9,14,47,47,0,48
St Mirren,4209,7,9,12,15,37,50,-13,39
Ayr,4209,8,8,13,15,34,55,-21,37
Raith,4209,9,9,9,18,35,54,-19,36
Dumbarton,4209,10,7,12,17,45,62,-17,33
Hibernian,4210,1,21,12,3,57,23,34,75
Falkirk,4210,2,17,10,9,59,40,19,61
Morton,4210,3,16,12,8,50,37,13,60
Dundee Utd,4210,4,16,10,10,52,39,13,58
Dunfermline,4210,5,11,14,11,46,44,2,47
Ayr,4210,6,10,11,15,35,53,-18,41
Queen of S't,4210,7,10,9,17,43,52,-9,39
Raith,4210,8,10,9,17,35,52,-17,39
Dumbarton,4210,9,8,12,16,46,59,-13,36
St Mirren,4210,10,7,9,20,35,59,-24,30
Hibernian,4211,1,19,12,5,54,25,29,69
Morton,4211,2,19,10,7,57,37,20,67
Falkirk,4211,3,15,13,8,54,37,17,58
Dundee Utd,4211,4,16,9,11,54,42,12,57
Dumbarton,4211,5,12,10,14,51,58,-7,46
Queen of S't,4211,6,11,11,14,48,51,-3,44
Raith,4211,7,10,8,18,34,55,-21,38
Dunfermline,4211,8,8,13,15,48,52,-4,37
Ayr,4211,9,9,10,17,35,61,-26,37
St Mirren,4211,10,8,10,18,39,56,-17,34
Hibernian,4212,1,18,12,6,55,31,24,66
Morton,4212,2,17,12,7,50,35,15,63
Dundee Utd,4212,3,16,10,10,55,44,11,58
Falkirk,4212,4,13,11,12,54,46,8,50
Queen of S't,4212,5,12,10,14,53,56,-3,46
Ayr,4212,6,10,14,12,38,49,-11,44
Dunfermline,4212,7,9,13,14,47,53,-6,40
Raith,4212,8,10,10,16,35,47,-12,40
St Mirren,4212,9,9,11,16,41,56,-15,38
Dumbarton,4212,10,7,15,14,51,62,-11,36
Hibernian,4213,1,20,11,5,55,27,28,71
Morton,4213,2,17,14,5,54,33,21,65
Falkirk,4213,3,17,10,9,65,42,23,61
Dundee Utd,4213,4,14,10,12,47,44,3,52
Queen of S't,4213,5,12,8,16,43,53,-10,44
Dunfermline,4213,6,10,12,14,50,51,-1,42
Dumbarton,4213,7,10,12,14,49,58,-9,42
St Mirren,4213,8,8,12,16,40,55,-15,36
Ayr,4213,9,8,12,16,37,57,-20,36
Raith,4213,10,9,9,18,32,52,-20,36
Morton,4214,1,19,11,6,48,31,17,68
Hibernian,4214,2,17,13,6,54,31,23,64
Dundee Utd,4214,3,16,11,9,51,39,12,59
Falkirk,4214,4,15,10,11,53,40,13,55
St Mirren,4214,5,11,10,15,45,56,-11,43
Queen of S't,4214,6,10,11,15,42,51,-9,41
Dunfermline,4214,7,8,15,13,43,46,-3,39
Raith,4214,8,9,12,15,34,46,-12,39
Dumbarton,4214,9,9,11,16,46,56,-10,38
Ayr,4214,10,8,12,16,34,54,-20,36
Morton,4215,1,17,14,5,55,33,22,65
Hibernian,4215,2,18,11,7,53,33,20,65
Dundee Utd,4215,3,17,9,10,53,37,16,60
Falkirk,4215,4,16,9,11,59,42,17,57
Queen of S't,4215,5,13,8,15,49,51,-2,47
Raith,4215,6,12,11,13,44,49,-5,47
Dumbarton,4215,7,10,10,16,50,61,-11,40
Dunfermline,4215,8,9,12,15,45,55,-10,39
St Mirren,4215,9,8,11,17,38,56,-18,35
Ayr,4215,10,7,11,18,31,60,-29,32
Hibernian,4216,1,20,11,5,56,23,33,71
Dundee Utd,4216,2,18,9,9,57,39,18,63
Morton,4216,3,17,11,8,48,35,13,62
Falkirk,4216,4,14,12,10,55,44,11,54
Dunfermline,4216,5,10,12,14,48,51,-3,42
Queen of S't,4216,6,10,11,15,45,52,-7,41
Ayr,4216,7,8,15,13,35,52,-17,39
St Mirren,4216,8,9,11,16,42,53,-11,38
Dumbarton,4216,9,8,13,15,46,60,-14,37
Raith,4216,10,8,11,17,33,56,-23,35
Hibernian,4217,1,19,14,3,56,25,31,71
Falkirk,4217,2,18,9,9,66,42,24,63
Morton,4217,3,15,15,6,48,33,15,60
Dundee Utd,4217,4,14,10,12,47,43,4,52
Dunfermline,4217,5,11,13,12,45,44,1,46
Queen of S't,4217,6,11,10,15,47,55,-8,43
Ayr,4217,7,10,11,15,38,56,-18,41
Dumbarton,4217,8,8,12,16,46,58,-12,36
St Mirren,4217,9,8,12,16,37,51,-14,36
Raith,4217,10,8,10,18,34,57,-23,34
Hibernian,4218,1,21,11,4,60,26,34,74
Morton,4218,2,17,11,8,53,42,11,62
Falkirk,4218,3,15,12,9,60,44,16,57
Dundee Utd,4218,4,15,11,10,55,40,15,56
Queen of S't,4218,5,12,10,14,51,54,-3,46
Dunfermline,4218,6,10,13,13,49,54,-5,43
Raith,4218,7,10,9,17,35,52,-17,39
St Mirren,4218,8,9,11,16,41,53,-12,38
Dumbarton,4218,9,8,12,16,48,64,-16,36
Ayr,4218,10,7,12,17,32,55,-23,33
Hibernian,4219,1,19,14,3,56,24,32,71
Morton,4219,2,18,13,5,50,31,19,67
Dundee Utd,4219,3,17,8,11,54,40,14,59
Falkirk,4219,4,16,10,10,59,44,15,58
Queen of S't,4219,5,12,10,14,48,48,0,46
Dunfermline,4219,6,9,14,13,46,53,-7,41
Ayr,4219,7,9,11,16,33,52,-19,38
St Mirren,4219,8,9,9,18,41,57,-16,36
Dumbarton,4219,9,8,11,17,48,67,-19,35
Raith,4219,10,9,8,19,33,52,-19,35
Hibernian,4220,1,22,11,3,57,23,34,77
Falkirk,4220,2,15,12,9,57,42,15,57
Dundee Utd,4220,3,15,12,9,51,41,10,57
Morton,4220,4,14,14,8,51,41,10,56
Queen of S't,4220,5,12,9,15,46,51,-5,45
Dunfermline,4220,6,10,13,13,43,45,-2,43
Raith,4220,7,10,9,17,38,50,-12,39
Dumbarton,4220,8,9,10,17,45,58,-13,37
St Mirren,4220,9,8,12,16,44,58,-14,36
Ayr,4220,10,7,14,15,33,56,-23,35
Hibernian,4221,1,19,12,5,53,26,27,69
Morton,4221,2,20,9,7,59,36,23,69
Falkirk,4221,3,15,12,9,57,41,16,57
Dundee Utd,4221,4,16,9,11,50,42,8,57
Queen of S't,4221,5,11,12,13,46,49,-3,45
Dunfermline,4221,6,9,13,14,44,48,-4,40
Raith,4221,7,10,10,16,38,49,-11,40
Dumbarton,4221,8,8,13,15,46,58,-12,37
St Mirren,4221,9,9,9,18,41,61,-20,36
Ayr,4221,10,8,11,17,32,56,-24,35
Hibernian,4222,1,18,14,4,53,25,28,68
Falkirk,4222,2,16,11,9,60,38,22,59
Morton,4222,3,15,11,10,46,37,9,56
Dundee Utd,4222,4,16,8,12,45,40,5,56
Queen of S't,4222,5,14,9,13,53,44,9,51
Dumbarton,4222,6,12,11,13,49,55,-6,47
Dunfermline,4222,7,9,15,12,43,46,-3,42
Raith,4222,8,10,10,16,33,48,-15,40
Ayr,4222,9,8,12,16,34,58,-24,36
St Mirren,4222,10,7,9,20,36,61,-25,30
Hibernian,4223,1,19,14,3,55,25,30,71
Morton,4223,2,17,12,7,51,35,16,63
Dundee Utd,4223,3,15,11,10,50,41,9,56
Falkirk,4223,4,14,11,11,53,39,14,53
Queen of S't,4223,5,10,12,14,42,48,-6,42
Dunfermline,4223,6,9,13,14,44,52,-8,40
Dumbarton,4223,7,9,13,14,45,54,-9,40
Raith,4223,8,10,10,16,34,45,-11,40
St Mirren,4223,9,9,11,16,37,52,-15,38
Ayr,4223,10,8,13,15,32,52,-20,37
Hibernian,4224,1,18,13,5,57,35,22,67
Morton,4224,2,15,12,9,51,42,9,57
Falkirk,4224,3,14,12,10,53,42,11,54
Dundee Utd,4224,4,14,12,10,47,36,11,54
Dunfermline,4224,5,12,13,11,55,45,10,49
Queen of S't,4224,6,13,9,14,50,50,0,48
Ayr,4224,7,10,12,14,35,53,-18,42
Dumbarton,4224,8,9,11,16,50,61,-11,38
Raith,4224,9,9,11,16,34,50,-16,38
St Mirren,4224,10,9,9,18,40,58,-18,36
Morton,4225,1,18,12,6,52,31,21,66
Hibernian,4225,2,18,11,7,51,32,19,65
Falkirk,4225,3,17,9,10,60,42,18,60
Dundee Utd,4225,4,15,11,10,51,39,12,56
Dunfermline,4225,5,10,14,12,44,46,-2,44
Queen of S't,4225,6,10,11,15,45,53,-8,41
Ayr,4225,7,10,10,16,38,54,-16,40
Raith,4225,8,10,10,16,32,48,-16,40
Dumbarton,4225,9,8,13,15,47,60,-13,37
St Mirren,4225,10,8,11,17,40,55,-15,35
Hibernian,4226,1,18,14,4,53,24,29,68
Dundee Utd,4226,2,17,11,8,57,41,16,62
Morton,4226,3,17,10,9,52,38,14,61
Falkirk,4226,4,16,12,8,58,40,18,60
Queen of S't,4226,5,12,10,14,48,51,-3,46
Raith,4226,6,11,9,16,35,49,-14,42
Dumbarton,4226,7,9,12,15,47,57,-10,39
Dunfermline,4226,8,8,13,15,42,52,-10,37
Ayr,4226,9,8,11,17,35,56,-21,35
St Mirren,4226,10,7,12,17,37,56,-19,33
Hibernian,4227,1,19,13,4,53,25,28,70
Dundee Utd,4227,2,17,11,8,52,37,15,62
Morton,4227,3,16,12,8,53,36,17,60
Falkirk,4227,4,15,12,9,54,40,14,57
Raith,4227,5,13,9,14,41,44,-3,48
Dumbarton,4227,6,10,12,14,48,56,-8,42
Dunfermline,4227,7,9,12,15,44,50,-6,39
Queen of S't,4227,8,10,9,17,38,51,-13,39
St Mirren,4227,9,8,10,18,39,57,-18,34
Ayr,4227,10,8,10,18,36,62,-26,34
Hibernian,4228,1,19,12,5,59,28,31,69
Dundee Utd,4228,2,17,9,10,55,42,13,60
Falkirk,4228,3,16,10,10,59,42,17,58
Morton,4228,4,16,10,10,51,42,9,58
Queen of S't,4228,5,12,9,15,47,50,-3,45
Dunfermline,4228,6,10,13,13,49,50,-1,43
Raith,4228,7,11,8,17,36,55,-19,41
St Mirren,4228,8,9,11,16,42,54,-12,38
Dumbarton,4228,9,9,11,16,48,61,-13,38
Ayr,4228,10,9,11,16,37,59,-22,38
Hibernian,4229,1,19,11,6,59,31,28,68
Morton,4229,2,18,11,7,54,36,18,65
Falkirk,4229,3,17,10,9,60,40,20,61
Dundee Utd,4229,4,17,9,10,48,39,9,60
Queen of S't,4229,5,13,9,14,54,51,3,48
Dunfermline,4229,6,9,13,14,45,53,-8,40
Raith,4229,7,9,11,16,33,50,-17,38
Ayr,4229,8,8,13,15,35,55,-20,37
St Mirren,4229,9,8,11,17,40,60,-20,35
Dumbarton,4229,10,7,12,17,41,54,-13,33
Hibernian,4230,1,19,12,5,57,28,29,69
Dundee Utd,4230,2,18,9,9,50,38,12,63
Falkirk,4230,3,16,11,9,62,41,21,59
Morton,4230,4,14,13,9,52,44,8,55
Dumbarton,4230,5,10,12,14,51,60,-9,42
Queen of S't,4230,6,11,8,17,45,58,-13,41
Dunfermline,4230,7,9,13,14,45,53,-8,40
St Mirren,4230,8,10,9,17,40,51,-11,39
Raith,4230,9,9,12,15,37,49,-12,39
Ayr,4230,10,9,11,16,40,57,-17,38
Hibernian,4231,1,17,12,7,51,26,25,63
Falkirk,4231,2,17,10,9,61,42,19,61
Dundee Utd,4231,3,17,10,9,56,38,18,61
Morton,4231,4,14,13,9,45,40,5,55
Queen of S't,4231,5,13,10,13,47,48,-1,49
Dunfermline,4231,6,11,13,12,49,50,-1,46
Dumbarton,4231,7,10,11,15,49,56,-7,41
Raith,4231,8,10,10,16,41,53,-12,40
St Mirren,4231,9,9,9,18,39,57,-18,36
Ayr,4231,10,7,12,17,32,60,-28,33
Hibernian,4232,1,19,12,5,54,28,26,69
Morton,4232,2,19,11,6,54,30,24,68
Falkirk,4232,3,15,12,9,55,40,15,57
Dundee Utd,4232,4,15,12,9,46,36,10,57
Dunfermline,4232,5,10,14,12,49,47,2,44
Queen of S't,4232,6,9,11,16,42,53,-11,38
Dumbarton,4232,7,9,11,16,45,58,-13,38
Raith,4232,8,9,11,16,34,50,-16,38
St Mirren,4232,9,8,13,15,39,53,-14,37
Ayr,4232,10,7,13,16,31,54,-23,34
Hibernian,4233,1,17,14,5,48,24,24,65
Dundee Utd,4233,2,16,12,8,51,38,13,60
Morton,4233,3,16,11,9,52,41,11,59
Falkirk,4233,4,16,10,10,57,42,15,58
Dunfermline,4233,5,11,12,13,48,48,0,45
Queen of S't,4233,6,11,10,15,46,51,-5,43
Dumbarton,4233,7,9,13,14,53,60,-7,40
Raith,4233,8,10,9,17,35,51,-16,39
Ayr,4233,9,8,14,14,32,52,-20,38
St Mirren,4233,10,8,11,17,41,56,-15,35
Hibernian,4234,1,19,12,5,52,24,28,69
Dundee Utd,4234,2,16,10,10,51,39,12,58
Morton,4234,3,16,10,10,47,36,11,58
Falkirk,4234,4,14,12,10,53,40,13,54
Queen of S't,4234,5,13,9,14,48,49,-1,48
Dunfermline,4234,6,10,13,13,46,47,-1,43
Raith,4234,7,11,9,16,33,47,-14,42
Dumbarton,4234,8,9,12,15,45,55,-10,39
St Mirren,4234,9,10,9,17,38,53,-15,39
Ayr,4234,10,9,10,17,35,58,-23,37
Hibernian,4235,1,16,15,5,50,28,22,63
Dundee Utd,4235,2,17,10,9,54,38,16,61
Morton,4235,3,16,12,8,50,37,13,60
Falkirk,4235,4,16,11,9,61,42,19,59
Dunfermline,4235,5,11,13,12,49,47,2,46
Raith,4235,6,11,10,15,38,50,-12,43
Queen of S't,4235,7,11,9,16,43,50,-7,42
Dumbarton,4235,8,10,11,15,51,60,-9,41
St Mirren,4235,9,9,11,16,39,54,-15,38
Ayr,4235,10,7,10,19,32,61,-29,31
Hibernian,4236,1,18,14,4,56,26,30,68
Morton,4236,2,17,13,6,57,40,17,64
Falkirk,4236,3,15,12,9,57,40,17,57
Dundee Utd,4236,4,14,10,12,55,46,9,52
Queen of S't,4236,5,12,9,15,46,49,-3,45
Raith,4236,6,11,10,15,39,49,-10,43
Dunfermline,4236,7,10,12,14,45,51,-6,42
Dumbarton,4236,8,10,12,14,48,57,-9,42
St Mirren,4236,9,8,12,16,36,50,-14,36
Ayr,4236,10,8,10,18,30,61,-31,34
Morton,4237,1,19,11,6,51,33,18,68
Hibernian,4237,2,19,10,7,53,25,28,67
Falkirk,4237,3,18,10,8,59,40,19,64
Dundee Utd,4237,4,16,9,11,50,39,11,57
Queen of S't,4237,5,13,8,15,44,47,-3,47
Dunfermline,4237,6,10,13,13,42,46,-4,43
Raith,4237,7,9,11,16,34,48,-14,38
St Mirren,4237,8,8,11,17,39,52,-13,35
Dumbarton,4237,9,7,13,16,45,63,-18,34
Ayr,4237,10,7,12,17,32,56,-24,33
Hibernian,4238,1,20,11,5,59,30,29,71
Falkirk,4238,2,16,11,9,60,43,17,59
Morton,4238,3,15,12,9,49,44,5,57
Dundee Utd,4238,4,15,10,11,47,40,7,55
Dunfermline,4238,5,11,14,11,49,44,5,47
Dumbarton,4238,6,12,11,13,57,55,2,47
Queen of S't,4238,7,12,9,15,43,49,-6,45
Ayr,4238,8,9,10,17,39,56,-17,37
St Mirren,4238,9,8,11,17,39,58,-19,35
Raith,4238,10,8,9,19,31,54,-23,33
Hibernian,4239,1,18,13,5,56,28,28,67
Morton,4239,2,17,13,6,58,38,20,64
Dundee Utd,4239,3,17,10,9,58,40,18,61
Falkirk,4239,4,16,10,10,57,43,14,58
Dunfermline,4239,5,11,12,13,51,53,-2,45
Queen of S't,4239,6,10,12,14,45,49,-4,42
Raith,4239,7,10,9,17,36,53,-17,39
Dumbarton,4239,8,8,12,16,46,62,-16,36
Ayr,4239,9,8,12,16,37,59,-22,36
St Mirren,4239,10,8,11,17,41,60,-19,35
Hibernian,4240,1,19,13,4,57,27,30,70
Dundee Utd,4240,2,17,10,9,49,36,13,61
Falkirk,4240,3,16,11,9,57,40,17,59
Morton,4240,4,16,10,10,49,41,8,58
Queen of S't,4240,5,13,8,15,48,51,-3,47
Dunfermline,4240,6,11,11,14,48,50,-2,44
Raith,4240,7,11,11,14,34,43,-9,44
Dumbarton,4240,8,8,12,16,48,61,-13,36
St Mirren,4240,9,8,11,17,39,55,-16,35
Ayr,4240,10,6,13,17,31,56,-25,31
Hibernian,4241,1,19,11,6,58,30,28,68
Morton,4241,2,18,10,8,52,41,11,64
Dundee Utd,4241,3,18,8,10,53,36,17,62
Falkirk,4241,4,15,12,9,55,43,12,57
Queen of S't,4241,5,11,10,15,42,54,-12,43
Dunfermline,4241,6,9,15,12,43,46,-3,42
Raith,4241,7,11,9,16,39,47,-8,42
Dumbarton,4241,8,10,10,16,47,56,-9,40
Ayr,4241,9,8,11,17,37,56,-19,35
St Mirren,4241,10,7,12,17,34,51,-17,33
Hibernian,4242,1,18,13,5,56,29,27,67
Morton,4242,2,16,14,6,48,32,16,62
Dundee Utd,4242,3,16,10,10,54,42,12,58
Falkirk,4242,4,15,10,11,55,50,5,55
Queen of S't,4242,5,13,9,14,46,50,-4,48
Raith,4242,6,11,9,16,39,49,-10,42
Dunfermline,4242,7,9,13,14,47,47,0,40
St Mirren,4242,8,10,10,16,45,57,-12,40
Ayr,4242,9,9,13,14,37,52,-15,40
Dumbarton,4242,10,7,11,18,43,62,-19,32
Hibernian,4243,1,20,12,4,64,26,38,72
Morton,4243,2,16,11,9,53,37,16,59
Dundee Utd,4243,3,16,9,11,47,41,6,57
Falkirk,4243,4,15,11,10,58,41,17,56
Queen of S't,4243,5,13,10,13,45,51,-6,49
Dunfermline,4243,6,11,13,12,48,50,-2,46
Raith,4243,7,10,11,15,35,45,-10,41
St Mirren,4243,8,9,11,16,41,60,-19,38
Dumbarton,4243,9,9,10,17,47,59,-12,37
Ayr,4243,10,7,10,19,34,62,-28,31
Hibernian,4244,1,18,12,6,54,26,28,66
Falkirk,4244,2,17,10,9,64,40,24,61
Morton,4244,3,16,11,9,57,40,17,59
Dundee Utd,4244,4,16,11,9,54,38,16,59
Queen of S't,4244,5,13,9,14,46,48,-2,48
Dunfermline,4244,6,10,12,14,46,52,-6,42
Ayr,4244,7,10,12,14,36,55,-19,42
St Mirren,4244,8,9,10,17,41,58,-17,37
Dumbarton,4244,9,9,10,17,46,67,-21,37
Raith,4244,10,9,9,18,36,56,-20,36
Hibernian,4245,1,18,14,4,52,22,30,68
Morton,4245,2,16,14,6,48,32,16,62
Dundee Utd,4245,3,17,9,10,52,37,15,60
Falkirk,4245,4,15,11,10,57,44,13,56
Dumbarton,4245,5,11,12,13,50,53,-3,45
Queen of S't,4245,6,10,12,14,39,46,-7,42
St Mirren,4245,7,10,10,16,39,53,-14,40
Raith,4245,8,10,9,17,34,49,-15,39
Dunfermline,4245,9,7,15,14,42,50,-8,36
Ayr,4245,10,7,12,17,31,58,-27,33
Hibernian,4246,1,20,10,6,53,24,29,70
Falkirk,4246,2,18,9,9,56,37,19,63
Morton,4246,3,17,11,8,51,37,14,62
Dundee Utd,4246,4,14,12,10,49,40,9,54
Dumbarton,4246,5,11,12,13,53,52,1,45
Queen of S't,4246,6,11,9,16,43,50,-7,42
Raith,4246,7,11,9,16,38,46,-8,42
Dunfermline,4246,8,9,13,14,44,51,-7,40
Ayr,4246,9,7,13,16,30,52,-22,34
St Mirren,4246,10,8,10,18,35,63,-28,34
Hibernian,4247,1,19,12,5,54,25,29,69
Falkirk,4247,2,16,10,10,62,45,17,58
Dundee Utd,4247,3,15,10,11,47,40,7,55
Morton,4247,4,13,11,12,45,44,1,50
Dunfermline,4247,5,12,12,12,48,48,0,48
Dumbarton,4247,6,12,10,14,50,52,-2,46
Queen of S't,4247,7,11,10,15,47,51,-4,43
St Mirren,4247,8,10,10,16,40,54,-14,40
Raith,4247,9,10,9,17,35,51,-16,39
Ayr,4247,10,8,14,14,35,53,-18,38
Hibernian,4248,1,19,12,5,51,22,29,69
Morton,4248,2,17,11,8,49,34,15,62
Falkirk,4248,3,17,9,10,56,37,19,60
Dundee Utd,4248,4,16,10,10,49,39,10,58
Dunfermline,4248,5,10,14,12,44,43,1,44
Queen of S't,4248,6,10,11,15,42,52,-10,41
Dumbarton,4248,7,9,13,14,48,57,-9,40
Raith,4248,8,10,10,16,30,45,-15,40
St Mirren,4248,9,9,11,16,37,52,-15,38
Ayr,4248,10,6,13,17,29,54,-25,31
Hibernian,4249,1,17,12,7,47,25,22,63
Morton,4249,2,17,12,7,48,33,15,63
Falkirk,4249,3,17,11,8,61,38,23,62
Dundee Utd,4249,4,15,9,12,51,45,6,54
Queen of S't,4249,5,12,10,14,44,48,-4,46
Dunfermline,4249,6,9,14,13,42,48,-6,41
Dumbarton,4249,7,10,11,15,50,59,-9,41
Raith,4249,8,10,11,15,32,46,-14,41
St Mirren,4249,9,9,10,17,42,55,-13,37
Ayr,4249,10,9,10,17,37,57,-20,37
Hibernian,4250,1,20,12,4,54,23,31,72
Morton,4250,2,16,13,7,54,41,13,61
Falkirk,4250,3,16,11,9,63,45,18,59
Dundee Utd,4250,4,15,10,11,50,43,7,55
Dunfermline,4250,5,11,12,13,52,49,3,45
Queen of S't,4250,6,11,8,17,44,53,-9,41
Dumbarton,4250,7,9,12,15,50,63,-13,39
St Mirren,4250,8,10,9,17,42,58,-16,39
Raith,4250,9,9,11,16,34,50,-16,38
Ayr,4250,10,8,12,16,34,52,-18,36
Morton,4251,1,19,11,6,58,35,23,68
Hibernian,4251,2,17,13,6,53,32,21,64
Dundee Utd,4251,3,16,11,9,48,38,10,59
Falkirk,4251,4,15,13,8,61,41,20,58
Queen of S't,4251,5,12,12,12,50,50,0,48
Raith,4251,6,12,9,15,34,47,-13,45
Dumbarton,4251,7,9,12,15,51,61,-10,39
Ayr,4251,8,9,11,16,41,59,-18,38
Dunfermline,4251,9,7,12,17,41,55,-14,33
St Mirren,4251,10,7,10,19,37,56,-19,31
Hibernian,4252,1,21,12,3,61,25,36,75
Dundee Utd,4252,2,19,9,8,51,36,15,66
Morton,4252,3,17,11,8,50,38,12,62
Falkirk,4252,4,17,9,10,58,41,17,60
Queen of S't,4252,5,12,9,15,44,51,-7,45
Dumbarton,4252,6,10,11,15,51,56,-5,41
Raith,4252,7,9,12,15,34,49,-15,39
Dunfermline,4252,8,7,12,17,42,54,-12,33
St Mirren,4252,9,7,12,17,40,57,-17,33
Ayr,4252,10,7,11,18,33,57,-24,32
Hibernian,4253,1,21,11,4,56,24,32,74
Dundee Utd,4253,2,17,8,11,53,45,8,59
Falkirk,4253,3,16,9,11,59,42,17,57
Morton,4253,4,15,11,10,43,35,8,56
Queen of S't,4253,5,12,10,14,44,49,-5,46
Dumbarton,4253,6,11,11,14,54,57,-3,44
Raith,4253,7,11,11,14,36,46,-10,44
Dunfermline,4253,8,9,13,14,44,47,-3,40
St Mirren,4253,9,8,10,18,39,59,-20,34
Ayr,4253,10,8,10,18,33,57,-24,34
Hibernian,4254,1,19,12,5,55,26,29,69
Morton,4254,2,17,11,8,51,37,14,62
Falkirk,4254,3,16,10,10,61,39,22,58
Dundee Utd,4254,4,15,12,9,47,37,10,57
Ayr,4254,5,10,13,13,43,56,-13,43
St Mirren,4254,6,11,10,15,42,55,-13,43
Queen of S't,4254,7,11,8,17,41,51,-10,41
Raith,4254,8,11,8,17,40,53,-13,41
Dumbarton,4254,9,10,10,16,51,56,-5,40
Dunfermline,4254,10,7,12,17,38,59,-21,33
Hibernian,4255,1,19,14,3,57,25,32,71
Falkirk,4255,2,16,12,8,60,39,21,60
Morton,4255,3,16,12,8,51,37,14,60
Dundee Utd,4255,4,15,9,12,43,41,2,54
Raith,4255,5,12,9,15,38,48,-10,45
Dumbarton,4255,6,10,11,15,47,54,-7,41
Queen of S't,4255,7,10,11,15,44,55,-11,41
Dunfermline,4255,8,8,13,15,44,51,-7,37
St Mirren,4255,9,9,10,17,38,53,-15,37
Ayr,4255,10,8,13,15,33,52,-19,37
Hibernian,4256,1,21,12,3,57,24,33,75
Morton,4256,2,17,12,7,52,35,17,63
Falkirk,4256,3,16,11,9,58,37,21,59
Dundee Utd,4256,4,14,10,12,51,44,7,52
Raith,4256,5,12,10,14,36,45,-9,46
Dunfermline,4256,6,11,12,13,44,47,-3,45
Queen of S't,4256,7,9,12,15,40,49,-9,39
Ayr,4256,8,9,10,17,37,57,-20,37
Dumbarton,4256,9,8,11,17,47,67,-20,35
St Mirren,4256,10,8,10,18,43,60,-17,34
Hibernian,4257,1,20,10,6,59,29,30,70
Morton,4257,2,18,9,9,50,36,14,63
Dundee Utd,4257,3,17,8,11,51,41,10,59
Falkirk,4257,4,16,9,11,54,42,12,57
Dunfermline,4257,5,15,11,10,49,40,9,56
Queen of S't,4257,6,12,8,16,46,53,-7,44
Dumbarton,4257,7,10,10,16,52,60,-8,40
Raith,4257,8,10,8,18,32,46,-14,38
St Mirren,4257,9,9,10,17,43,56,-13,37
Ayr,4257,10,6,11,19,31,64,-33,29
Hibernian,4258,1,20,12,4,60,24,36,72
Morton,4258,2,18,10,8,52,37,15,64
Falkirk,4258,3,14,12,10,55,40,15,54
Dundee Utd,4258,4,14,10,12,43,37,6,52
Dunfermline,4258,5,11,13,12,47,50,-3,46
Queen of S't,4258,6,12,9,15,44,51,-7,45
St Mirren,4258,7,11,10,15,43,51,-8,43
Ayr,4258,8,9,12,15,35,53,-18,39
Dumbarton,4258,9,8,12,16,46,60,-14,36
Raith,4258,10,8,10,18,32,54,-22,34
Hibernian,4259,1,19,13,4,52,22,30,70
Falkirk,4259,2,16,12,8,56,35,21,60
Morton,4259,3,15,14,7,48,36,12,59
Dundee Utd,4259,4,16,10,10,46,34,12,58
Queen of S't,4259,5,12,9,15,44,47,-3,45
Ayr,4259,6,10,11,15,32,53,-21,41
Raith,4259,7,10,9,17,35,54,-19,39
Dunfermline,4259,8,8,14,14,42,50,-8,38
Dumbarton,4259,9,9,11,16,49,58,-9,38
St Mirren,4259,10,8,11,17,37,52,-15,35
Hibernian,4260,1,20,11,5,55,24,31,71
Dundee Utd,4260,2,18,9,9,53,35,18,63
Morton,4260,3,18,9,9,52,34,18,63
Falkirk,4260,4,15,11,10,53,47,6,56
Queen of S't,4260,5,15,8,13,51,47,4,53
Raith,4260,6,10,10,16,36,47,-11,40
Dumbarton,4260,7,9,10,17,49,62,-13,37
Ayr,4260,8,8,13,15,32,53,-21,37
Dunfermline,4260,9,8,12,16,44,55,-11,36
St Mirren,4260,10,7,11,18,40,61,-21,32
Hibernian,4261,1,19,11,6,56,27,29,68
Morton,4261,2,18,12,6,53,34,19,66
Dundee Utd,4261,3,16,11,9,53,41,12,59
Falkirk,4261,4,15,13,8,55,36,19,58
Dunfermline,4261,5,11,12,13,47,46,1,45
Queen of S't,4261,6,10,10,16,44,53,-9,40
St Mirren,4261,7,10,10,16,38,50,-12,40
Dumbarton,4261,8,9,11,16,46,56,-10,38
Ayr,4261,9,8,12,16,33,59,-26,36
Raith,4261,10,8,10,18,29,52,-23,34
Hibernian,4262,1,20,12,4,54,24,30,72
Dundee Utd,4262,2,17,9,10,52,36,16,60
Morton,4262,3,16,10,10,51,38,13,58
Falkirk,4262,4,15,11,10,54,39,15,56
Dumbarton,4262,5,11,13,12,50,52,-2,46
Queen of S't,4262,6,11,11,14,47,51,-4,44
Ayr,4262,7,8,14,14,34,53,-19,38
Raith,4262,8,9,10,17,32,49,-17,37
Dunfermline,4262,9,8,12,16,44,57,-13,36
St Mirren,4262,10,8,12,16,38,57,-19,36
Hibernian,4263,1,21,12,3,59,24,35,75
Dundee Utd,4263,2,17,9,10,56,43,13,60
Morton,4263,3,16,11,9,52,38,14,59
Falkirk,4263,4,15,10,11,54,41,13,55
Dunfermline,4263,5,11,11,14,47,49,-2,44
Queen of S't,4263,6,11,11,14,42,51,-9,44
Dumbarton,4263,7,11,10,15,51,57,-6,43
Ayr,4263,8,9,12,15,35,53,-18,39
St Mirren,4263,9,8,10,18,41,58,-17,34
Raith,4263,10,8,10,18,31,54,-23,34
Morton,4264,1,18,13,5,52,33,19,67
Hibernian,4264,2,17,14,5,56,31,25,65
Falkirk,4264,3,16,12,8,58,39,19,60
Dundee Utd,4264,4,16,9,11,54,39,15,57
Dumbarton,4264,5,10,12,14,51,55,-4,42
Raith,4264,6,10,11,15,40,51,-11,41
Dunfermline,4264,7,9,13,14,49,53,-4,40
Queen of S't,4264,8,9,11,16,41,55,-14,38
St Mirren,4264,9,8,12,16,42,58,-16,36
Ayr,4264,10,8,11,17,36,65,-29,35
Hibernian,4265,1,17,15,4,52,24,28,66
Morton,4265,2,17,11,8,51,33,18,62
Falkirk,4265,3,16,12,8,63,43,20,60
Dundee Utd,4265,4,14,10,12,52,49,3,52
Queen of S't,4265,5,12,11,13,47,49,-2,47
Raith,4265,6,12,9,15,40,49,-9,45
Dunfermline,4265,7,9,15,12,42,44,-2,42
St Mirren,4265,8,8,12,16,43,58,-15,36
Ayr,4265,9,7,15,14,35,55,-20,36
Dumbarton,4265,10,7,12,17,45,66,-21,33
Hibernian,4266,1,19,12,5,56,24,32,69
Morton,4266,2,18,11,7,49,34,15,65
Falkirk,4266,3,18,9,9,67,42,25,63
Dundee Utd,4266,4,18,8,10,55,41,14,62
Dunfermline,4266,5,9,12,15,43,51,-8,39
Queen of S't,4266,6,10,9,17,44,55,-11,39
Dumbarton,4266,7,9,12,15,48,62,-14,39
Ayr,4266,8,9,12,15,35,53,-18,39
St Mirren,4266,9,9,10,17,39,55,-16,37
Raith,4266,10,9,9,18,32,51,-19,36
Hibernian,4267,1,17,14,5,53,28,25,65
Dundee Utd,4267,2,19,8,9,55,38,17,65
Falkirk,4267,3,16,11,9,60,42,18,59
Morton,4267,4,14,12,10,47,38,9,54
Dunfermline,4267,5,10,15,11,46,45,1,45
Queen of S't,4267,6,11,12,13,46,49,-3,45
St Mirren,4267,7,10,9,17,48,57,-9,39
Dumbarton,4267,8,9,11,16,49,63,-14,38
Raith,4267,9,9,10,17,34,52,-18,37
Ayr,4267,10,9,10,17,36,62,-26,37
Hibernian,4268,1,19,13,4,58,29,29,70
Falkirk,4268,2,18,11,7,66,39,27,65
Morton,4268,3,17,13,6,57,36,21,64
Dundee Utd,4268,4,17,8,11,58,39,19,59
Dunfermline,4268,5,10,14,12,45,50,-5,44
Queen of S't,4268,6,11,8,17,45,57,-12,41
Dumbarton,4268,7,9,12,15,49,60,-11,39
Raith,4268,8,10,8,18,36,52,-16,38
Ayr,4268,9,8,11,17,32,58,-26,35
St Mirren,4268,10,7,10,19,36,62,-26,31
Hibernian,4269,1,20,12,4,57,24,33,72
Dundee Utd,4269,2,18,9,9,56,39,17,63
Morton,4269,3,16,10,10,49,40,9,58
Falkirk,4269,4,14,12,10,58,45,13,54
Queen of S't,4269,5,12,12,12,48,46,2,48
Dunfermline,4269,6,10,13,13,52,57,-5,43
Raith,4269,7,10,10,16,37,50,-13,40
Dumbarton,4269,8,8,12,16,46,59,-13,36
St Mirren,4269,9,8,11,17,38,57,-19,35
Ayr,4269,10,7,13,16,33,57,-24,34
Hibernian,4270,1,21,11,4,59,24,35,74
Morton,4270,2,20,10,6,57,36,21,70
Dundee Utd,4270,3,16,8,12,48,40,8,56
Falkirk,4270,4,15,10,11,60,49,11,55
Queen of S't,4270,5,12,9,15,44,51,-7,45
Raith,4270,6,10,10,16,38,50,-12,40
Dumbarton,4270,7,9,12,15,52,60,-8,39
Ayr,4270,8,8,13,15,35,55,-20,37
Dunfermline,4270,9,7,14,15,46,55,-9,35
St Mirren,4270,10,8,11,17,38,57,-19,35
Morton,4271,1,19,9,8,52,35,17,66
Dundee Utd,4271,2,17,11,8,55,40,15,62
Hibernian,4271,3,16,12,8,49,30,19,60
Falkirk,4271,4,17,9,10,61,45,16,60
Queen of S't,4271,5,11,12,13,48,48,0,45
Dunfermline,4271,6,11,11,14,45,49,-4,44
Raith,4271,7,10,10,16,37,51,-14,40
Dumbarton,4271,8,9,11,16,47,59,-12,38
St Mirren,4271,9,9,11,16,43,56,-13,38
Ayr,4271,10,6,14,16,29,53,-24,32
Hibernian,4272,1,20,12,4,57,27,30,72
Falkirk,4272,2,17,11,8,62,42,20,62
Morton,4272,3,14,12,10,43,39,4,54
Queen of S't,4272,4,14,10,12,56,47,9,52
Dundee Utd,4272,5,14,10,12,48,46,2,52
St Mirren,4272,6,11,9,16,40,51,-11,42
Dumbarton,4272,7,9,12,15,48,57,-9,39
Raith,4272,8,9,11,16,38,53,-15,38
Dunfermline,4272,9,8,13,15,43,54,-11,37
Ayr,4272,10,8,12,16,37,56,-19,36
Hibernian,4273,1,19,13,4,58,28,30,70
Morton,4273,2,18,10,8,56,36,20,64
Dundee Utd,4273,3,17,10,9,53,41,12,61
Falkirk,4273,4,14,12,10,58,41,17,54
Raith,4273,5,13,9,14,36,45,-9,48
Dunfermline,4273,6,9,14,13,44,47,-3,41
Dumbarton,4273,7,10,11,15,48,59,-11,41
Queen of S't,4273,8,9,9,18,39,59,-20,36
St Mirren,4273,9,8,11,17,44,59,-15,35
Ayr,4273,10,8,11,17,37,58,-21,35
Hibernian,4274,1,20,12,4,53,21,32,72
Morton,4274,2,17,10,9,51,42,9,61
Dundee Utd,4274,3,14,11,11,52,42,10,53
Falkirk,4274,4,14,11,11,51,41,10,53
Raith,4274,5,12,8,16,36,48,-12,44
Queen of S't,4274,6,11,9,16,43,52,-9,42
Dumbarton,4274,7,10,12,14,45,57,-12,42
Dunfermline,4274,8,9,14,13,48,48,0,41
St Mirren,4274,9,10,10,16,41,52,-11,40
Ayr,4274,10,8,13,15,38,55,-17,37
Hibernian,4275,1,20,11,5,54,23,31,71
Dundee Utd,4275,2,17,9,10,50,40,10,60
Morton,4275,3,15,11,10,44,37,7,56
Falkirk,4275,4,15,9,12,56,43,13,54
Dunfermline,4275,5,12,12,12,47,43,4,48
Queen of S't,4275,6,11,10,15,43,49,-6,43
Raith,4275,7,11,10,15,38,48,-10,43
Dumbarton,4275,8,10,11,15,47,56,-9,41
Ayr,4275,9,8,14,14,33,51,-18,38
St Mirren,4275,10,7,11,18,36,58,-22,32
Hibernian,4276,1,19,13,4,57,24,33,70
Dundee Utd,4276,2,17,10,9,58,40,18,61
Morton,4276,3,16,11,9,48,36,12,59
Falkirk,4276,4,15,12,9,60,39,21,57
Queen of S't,4276,5,11,10,15,44,53,-9,43
Raith,4276,6,11,9,16,33,48,-15,42
Dunfermline,4276,7,8,15,13,44,48,-4,39
St Mirren,4276,8,9,11,16,39,55,-16,38
Ayr,4276,9,9,11,16,34,60,-26,38
Dumbarton,4276,10,8,12,16,49,63,-14,36
Hibernian,4277,1,19,12,5,60,29,31,69
Falkirk,4277,2,17,10,9,66,43,23,61
Morton,4277,3,16,13,7,58,42,16,61
Dundee Utd,4277,4,14,10,12,47,43,4,52
Dunfermline,4277,5,10,13,13,47,49,-2,43
Queen of S't,4277,6,11,10,15,41,47,-6,43
St Mirren,4277,7,10,10,16,45,58,-13,40
Raith,4277,8,10,10,16,37,58,-21,40
Dumbarton,4277,9,9,12,15,46,57,-11,39
Ayr,4277,10,9,10,17,37,58,-21,37
Hibernian,4278,1,21,12,3,59,22,37,75
Dundee Utd,4278,2,17,8,11,51,39,12,59
Morton,4278,3,16,11,9,49,46,3,59
Falkirk,4278,4,16,10,10,56,39,17,58
Dunfermline,4278,5,10,13,13,54,51,3,43
Raith,4278,6,11,8,17,39,50,-11,41
Ayr,4278,7,10,11,15,35,54,-19,41
Dumbarton,4278,8,9,12,15,47,55,-8,39
St Mirren,4278,9,8,12,16,41,55,-14,36
Queen of S't,4278,10,9,9,18,40,60,-20,36
Morton,4279,1,19,10,7,56,36,20,67
Hibernian,4279,2,17,12,7,51,28,23,63
Falkirk,4279,3,16,12,8,58,38,20,60
Dundee Utd,4279,4,15,12,9,53,39,14,57
Raith,4279,5,13,9,14,44,48,-4,48
Queen of S't,4279,6,11,9,16,47,58,-11,42
Dunfermline,4279,7,9,14,13,47,52,-5,41
Ayr,4279,8,9,13,14,35,54,-19,40
Dumbarton,4279,9,8,13,15,50,62,-12,37
St Mirren,4279,10,6,10,20,35,61,-26,28
Hibernian,4280,1,20,13,3,56,24,32,73
Dundee Utd,4280,2,19,8,9,62,43,19,65
Falkirk,4280,3,17,10,9,60,44,16,61
Morton,4280,4,16,10,10,51,40,11,58
Queen of S't,4280,5,11,10,15,44,56,-12,43
Ayr,4280,6,10,12,14,42,56,-14,42
Raith,4280,7,10,11,15,36,47,-11,41
Dunfermline,4280,8,9,13,14,48,55,-7,40
Dumbarton,4280,9,9,10,17,50,60,-10,37
St Mirren,4280,10,6,9,21,36,60,-24,27
Hibernian,4281,1,18,13,5,55,28,27,67
Morton,4281,2,17,10,9,56,40,16,61
Falkirk,4281,3,16,11,9,60,43,17,59
Dundee Utd,4281,4,13,11,12,48,46,2,50
Dunfermline,4281,5,10,16,10,51,50,1,46
Queen of S't,4281,6,12,10,14,47,49,-2,46
Dumbarton,4281,7,9,13,14,49,61,-12,40
St Mirren,4281,8,10,9,17,42,55,-13,39
Ayr,4281,9,8,14,14,34,53,-19,38
Raith,4281,10,9,9,18,34,51,-17,36
Hibernian,4282,1,21,11,4,59,22,37,74
Dundee Utd,4282,2,16,10,10,50,41,9,58
Morton,4282,3,15,12,9,45,41,4,57
Falkirk,4282,4,15,9,12,56,45,11,54
Queen of S't,4282,5,11,10,15,40,48,-8,43
Dumbarton,4282,6,10,12,14,55,63,-8,42
Dunfermline,4282,7,9,13,14,47,50,-3,40
Ayr,4282,8,8,15,13,35,51,-16,39
St Mirren,4282,9,9,11,16,41,52,-11,38
Raith,4282,10,9,11,16,32,47,-15,38
Hibernian,4283,1,20,11,5,60,26,34,71
Morton,4283,2,17,10,9,51,37,14,61
Dundee Utd,4283,3,17,9,10,51,41,10,60
Falkirk,4283,4,16,9,11,63,45,18,57
Queen of S't,4283,5,13,9,14,45,48,-3,48
Dunfermline,4283,6,10,11,15,47,55,-8,41
Raith,4283,7,10,11,15,36,48,-12,41
Dumbarton,4283,8,10,10,16,46,57,-11,40
Ayr,4283,9,8,12,16,38,61,-23,36
St Mirren,4283,10,8,10,18,36,55,-19,34
Hibernian,4284,1,20,13,3,58,25,33,73
Morton,4284,2,17,12,7,54,39,15,63
Falkirk,4284,3,17,9,10,57,43,14,60
Dundee Utd,4284,4,16,11,9,51,38,13,59
Queen of S't,4284,5,11,9,16,47,51,-4,42
Dunfermline,4284,6,9,13,14,48,53,-5,40
Dumbarton,4284,7,9,12,15,50,60,-10,39
Raith,4284,8,10,9,17,32,48,-16,39
St Mirren,4284,9,9,9,18,41,58,-17,36
Ayr,4284,10,7,13,16,34,57,-23,34
Hibernian,4285,1,19,13,4,57,27,30,70
Falkirk,4285,2,16,10,10,58,43,15,58
Dundee Utd,4285,3,15,11,10,52,42,10,56
Morton,4285,4,15,11,10,45,39,6,56
Dunfermline,4285,5,11,14,11,52,45,7,47
Raith,4285,6,11,11,14,36,43,-7,44
Queen of S't,4285,7,11,9,16,45,58,-13,42
Dumbarton,4285,8,10,11,15,52,64,-12,41
Ayr,4285,9,8,12,16,38,53,-15,36
St Mirren,4285,10,8,10,18,39,60,-21,34
Hibernian,4286,1,21,11,4,68,26,42,74
Falkirk,4286,2,18,9,9,61,43,18,63
Morton,4286,3,17,12,7,53,35,18,63
Dundee Utd,4286,4,17,11,8,56,38,18,62
Dunfermline,4286,5,9,14,13,42,47,-5,41
Queen of S't,4286,6,10,11,15,42,52,-10,41
Raith,4286,7,9,9,18,34,52,-18,36
Ayr,4286,8,8,12,16,32,56,-24,36
Dumbarton,4286,9,7,13,16,44,60,-16,34
St Mirren,4286,10,8,10,18,36,59,-23,34
Hibernian,4287,1,19,12,5,61,23,38,69
Morton,4287,2,17,12,7,51,39,12,63
Dundee Utd,4287,3,16,11,9,54,40,14,59
Falkirk,4287,4,15,10,11,55,44,11,55
Queen of S't,4287,5,11,10,15,45,55,-10,43
Dunfermline,4287,6,10,12,14,47,51,-4,42
Raith,4287,7,11,9,16,34,46,-12,42
Dumbarton,4287,8,9,13,14,51,58,-7,40
Ayr,4287,9,8,13,15,38,55,-17,37
St Mirren,4287,10,8,10,18,36,61,-25,34
Hibernian,4288,1,19,13,4,58,29,29,70
Morton,4288,2,18,12,6,54,31,23,66
Falkirk,4288,3,18,9,9,64,40,24,63
Dundee Utd,4288,4,16,8,12,45,41,4,56
Queen of S't,4288,5,12,8,16,49,55,-6,44
Dumbarton,4288,6,11,11,14,49,57,-8,44
Dunfermline,4288,7,8,13,15,47,56,-9,37
Ayr,4288,8,8,12,16,35,53,-18,36
St Mirren,4288,9,8,11,17,38,57,-19,35
Raith,4288,10,8,11,17,37,57,-20,35
Hibernian,4289,1,21,11,4,62,28,34,74
Morton,4289,2,16,12,8,50,40,10,60
Dundee Utd,4289,3,14,12,10,50,43,7,54
Falkirk,4289,4,14,11,11,58,46,12,53
Ayr,4289,5,11,13,12,38,49,-11,46
Raith,4289,6,12,9,15,38,47,-9,45
Queen of S't,4289,7,11,10,15,45,49,-4,43
Dunfermline,4289,8,8,15,13,45,48,-3,39
Dumbarton,4289,9,8,11,17,48,64,-16,35
St Mirren,4289,10,8,10,18,42,62,-20,34
Hibernian,4290,1,17,15,4,52,25,27,66
Falkirk,4290,2,16,12,8,60,40,20,60
Dundee Utd,4290,3,16,9,11,50,40,10,57
Morton,4290,4,15,12,9,42,34,8,57
Queen of S't,4290,5,14,9,13,51,51,0,51
Raith,4290,6,9,14,13,34,45,-11,41
Dunfermline,4290,7,8,16,12,45,47,-2,40
Ayr,4290,8,9,11,16,35,56,-21,38
Dumbarton,4290,9,8,12,16,44,60,-16,36
St Mirren,4290,10,7,12,17,41,56,-15,33
Hibernian,4291,1,18,14,4,51,24,27,68
Morton,4291,2,18,11,7,51,32,19,65
Dundee Utd,4291,3,17,11,8,54,38,16,62
Falkirk,4291,4,17,9,10,56,44,12,60
Queen of S't,4291,5,11,10,15,45,52,-7,43
Raith,4291,6,11,8,17,38,50,-12,41
Dumbarton,4291,7,10,10,16,46,54,-8,40
Ayr,4291,8,9,11,16,37,56,-19,38
Dunfermline,4291,9,8,12,16,45,57,-12,36
St Mirren,4291,10,8,10,18,39,55,-16,34
Hibernian,4292,1,20,11,5,57,26,31,71
Morton,4292,2,19,12,5,52,31,21,69
Falkirk,4292,3,17,11,8,60,40,20,62
Dundee Utd,4292,4,16,11,9,50,39,11,59
Queen of S't,4292,5,11,8,17,44,52,-8,41
Ayr,4292,6,9,13,14,36,52,-16,40
Dunfermline,4292,7,8,14,14,45,53,-8,38
St Mirren,4292,8,9,10,17,43,56,-13,37
Dumbarton,4292,9,8,12,16,44,58,-14,36
Raith,4292,10,8,8,20,31,55,-24,32
Hibernian,4293,1,19,12,5,57,28,29,69
Dundee Utd,4293,2,18,9,9,55,40,15,63
Falkirk,4293,3,16,10,10,64,47,17,58
Morton,4293,4,14,12,10,46,39,7,54
Dunfermline,4293,5,11,14,11,50,46,4,47
Dumbarton,4293,6,10,12,14,49,55,-6,42
Queen of S't,4293,7,11,9,16,44,54,-10,42
Ayr,4293,8,9,11,16,39,60,-21,38
St Mirren,4293,9,9,10,17,45,60,-15,37
Raith,4293,10,9,9,18,39,59,-20,36
Hibernian,4294,1,18,13,5,57,27,30,67
Morton,4294,2,17,10,9,49,35,14,61
Falkirk,4294,3,15,11,10,57,45,12,56
Dundee Utd,4294,4,15,10,11,53,45,8,55
Dunfermline,4294,5,13,12,11,55,50,5,51
Queen of S't,4294,6,11,10,15,46,53,-7,43
St Mirren,4294,7,11,9,16,48,54,-6,42
Raith,4294,8,10,10,16,34,50,-16,40
Dumbarton,4294,9,9,12,15,47,62,-15,39
Ayr,4294,10,6,13,17,34,59,-25,31
Hibernian,4295,1,21,10,5,57,26,31,73
Morton,4295,2,19,11,6,54,31,23,68
Falkirk,4295,3,18,10,8,61,38,23,64
Dundee Utd,4295,4,15,11,10,47,37,10,56
Queen of S't,4295,5,11,11,14,44,48,-4,44
Raith,4295,6,11,9,16,35,46,-11,42
Ayr,4295,7,8,12,16,34,57,-23,36
Dunfermline,4295,8,7,14,15,40,50,-10,35
St Mirren,4295,9,8,10,18,38,57,-19,34
Dumbarton,4295,10,7,12,17,46,66,-20,33
Hibernian,4296,1,20,13,3,54,21,33,73
Morton,4296,2,17,11,8,50,35,15,62
Falkirk,4296,3,17,10,9,62,40,22,61
Dundee Utd,4296,4,14,8,14,51,46,5,50
Queen of S't,4296,5,14,8,14,48,50,-2,50
St Mirren,4296,6,11,10,15,47,56,-9,43
Dunfermline,4296,7,10,12,14,48,52,-4,42
Dumbarton,4296,8,9,13,14,47,59,-12,40
Ayr,4296,9,8,11,17,35,58,-23,35
Raith,4296,10,8,8,20,32,57,-25,32
Hibernian,4297,1,21,11,4,60,25,35,74
Falkirk,4297,2,16,11,9,57,39,18,59
Morton,4297,3,15,12,9,49,38,11,57
Dundee Utd,4297,4,15,9,12,48,42,6,54
Queen of S't,4297,5,13,8,15,44,49,-5,47
Dunfermline,4297,6,9,15,12,44,48,-4,42
Dumbarton,4297,7,10,12,14,51,58,-7,42
Raith,4297,8,9,11,16,35,51,-16,38
St Mirren,4297,9,9,9,18,38,56,-18,36
Ayr,4297,10,8,12,16,35,55,-20,36
Hibernian,4298,1,19,13,4,56,26,30,70
Morton,4298,2,16,14,6,51,37,14,62
Dundee Utd,4298,3,17,11,8,48,34,14,62
Falkirk,4298,4,15,11,10,60,44,16,56
Dunfermline,4298,5,9,16,11,47,50,-3,43
Raith,4298,6,10,11,15,39,52,-13,41
St Mirren,4298,7,9,10,17,39,52,-13,37
Dumbarton,4298,8,8,12,16,44,56,-12,36
Queen of S't,4298,9,9,9,18,41,54,-13,36
Ayr,4298,10,7,15,14,34,54,-20,36
Hibernian,4299,1,17,13,6,53,29,24,64
Morton,4299,2,16,14,6,51,36,15,62
Falkirk,4299,3,16,10,10,59,42,17,58
Dundee Utd,4299,4,15,9,12,54,49,5,54
Dunfermline,4299,5,11,12,13,51,45,6,45
Queen of S't,4299,6,12,9,15,48,51,-3,45
Dumbarton,4299,7,11,10,15,52,59,-7,43
Ayr,4299,8,10,10,16,39,58,-19,40
Raith,4299,9,9,12,15,31,47,-16,39
St Mirren,4299,10,9,9,18,41,63,-22,36
Hibernian,4300,1,20,11,5,61,25,36,71
Falkirk,4300,2,17,11,8,58,36,22,62
Morton,4300,3,16,12,8,49,37,12,60
Dundee Utd,4300,4,15,11,10,50,43,7,56
Dunfermline,4300,5,12,12,12,47,45,2,48
Raith,4300,6,10,11,15,37,50,-13,41
Queen of S't,4300,7,9,12,15,42,52,-10,39
St Mirren,4300,8,8,11,17,39,56,-17,35
Dumbarton,4300,9,8,11,17,43,61,-18,35
Ayr,4300,10,7,14,15,36,57,-21,35
Hibernian,4301,1,21,11,4,60,24,36,74
Dundee Utd,4301,2,20,8,8,57,38,19,68
Morton,4301,3,16,10,10,50,41,9,58
Falkirk,4301,4,15,9,12,55,42,13,54
Queen of S't,4301,5,14,8,14,47,48,-1,50
Dumbarton,4301,6,11,10,15,48,54,-6,43
Raith,4301,7,9,11,16,35,54,-19,38
Dunfermline,4301,8,8,12,16,42,52,-10,36
Ayr,4301,9,8,12,16,35,56,-21,36
St Mirren,4301,10,8,9,19,37,57,-20,33
Hibernian,4302,1,18,12,6,51,24,27,66
Falkirk,4302,2,17,10,9,65,45,20,61
Morton,4302,3,16,12,8,47,35,12,60
Dundee Utd,4302,4,15,11,10,50,42,8,56
Dunfermline,4302,5,10,15,11,45,43,2,45
Queen of S't,4302,6,11,10,15,42,51,-9,43
Raith,4302,7,10,12,14,35,46,-11,42
Dumbarton,4302,8,9,11,16,45,61,-16,38
Ayr,4302,9,8,13,15,40,55,-15,37
St Mirren,4302,10,8,10,18,42,60,-18,34
Hibernian,4303,1,21,10,5,57,22,35,73
Morton,4303,2,16,11,9,51,42,9,59
Dundee Utd,4303,3,16,10,10,50,40,10,58
Falkirk,4303,4,14,9,13,55,44,11,51
Dunfermline,4303,5,13,11,12,48,45,3,50
Queen of S't,4303,6,11,11,14,48,55,-7,44
Ayr,4303,7,10,11,15,38,53,-15,41
Raith,4303,8,10,9,17,32,48,-16,39
Dumbarton,4303,9,9,10,17,49,63,-14,37
St Mirren,4303,10,9,10,17,40,56,-16,37
Hibernian,4304,1,18,10,8,56,31,25,64
Morton,4304,2,17,11,8,53,40,13,62
Falkirk,4304,3,16,11,9,55,39,16,59
Dundee Utd,4304,4,15,10,11,49,46,3,55
Queen of S't,4304,5,14,8,14,47,50,-3,50
Raith,4304,6,12,8,16,39,48,-9,44
Dunfermline,4304,7,10,13,13,51,45,6,43
Dumbarton,4304,8,10,11,15,46,54,-8,41
Ayr,4304,9,10,11,15,35,55,-20,41
St Mirren,4304,10,7,9,20,36,59,-23,30
Hibernian,4305,1,22,11,3,63,24,39,77
Dundee Utd,4305,2,16,10,10,55,38,17,58
Morton,4305,3,15,13,8,52,41,11,58
Falkirk,4305,4,14,13,9,58,43,15,55
Queen of S't,4305,5,12,10,14,45,50,-5,46
Dumbarton,4305,6,10,13,13,52,60,-8,43
Dunfermline,4305,7,9,15,12,44,46,-2,42
Raith,4305,8,10,11,15,39,49,-10,41
St Mirren,4305,9,7,10,19,38,60,-22,31
Ayr,4305,10,6,12,18,28,63,-35,30
Hibernian,4306,1,20,12,4,57,24,33,72
Morton,4306,2,18,10,8,49,35,14,64
Dundee Utd,4306,3,17,10,9,52,38,14,61
Falkirk,4306,4,17,9,10,56,39,17,60
Dunfermline,4306,5,10,11,15,42,48,-6,41
Dumbarton,4306,6,10,10,16,50,61,-11,40
Raith,4306,7,9,11,16,34,48,-14,38
St Mirren,4306,8,9,11,16,39,55,-16,38
Queen of S't,4306,9,9,10,17,40,52,-12,37
Ayr,4306,10,8,12,16,33,52,-19,36
Hibernian,4307,1,20,11,5,56,29,27,71
Dundee Utd,4307,2,18,9,9,57,37,20,63
Morton,4307,3,15,14,7,48,36,12,59
Falkirk,4307,4,14,11,11,54,43,11,53
Queen of S't,4307,5,11,9,16,45,51,-6,42
Dumbarton,4307,6,9,14,13,46,55,-9,41
Ayr,4307,7,9,13,14,36,55,-19,40
Raith,4307,8,10,9,17,39,51,-12,39
Dunfermline,4307,9,8,14,14,45,53,-8,38
St Mirren,4307,10,9,10,17,41,57,-16,37
Hibernian,4308,1,19,10,7,58,24,34,67
Morton,4308,2,18,10,8,53,39,14,64
Falkirk,4308,3,14,9,13,51,40,11,51
Dundee Utd,4308,4,13,11,12,46,43,3,50
Queen of S't,4308,5,13,10,13,47,46,1,49
Raith,4308,6,12,9,15,34,49,-15,45
Dunfermline,4308,7,10,13,13,46,47,-1,43
Dumbarton,4308,8,10,11,15,46,58,-12,41
Ayr,4308,9,9,13,14,35,55,-20,40
St Mirren,4308,10,9,10,17,37,52,-15,37
Hibernian,4309,1,17,15,4,54,25,29,66
Dundee Utd,4309,2,17,11,8,56,41,15,62
Morton,4309,3,16,12,8,49,36,13,60
Falkirk,4309,4,15,11,10,61,48,13,56
Dunfermline,4309,5,11,12,13,52,52,0,45
Queen of S't,4309,6,12,9,15,49,53,-4,45
Raith,4309,7,10,9,17,37,54,-17,39
Ayr,4309,8,8,15,13,35,53,-18,39
St Mirren,4309,9,9,10,17,38,52,-14,37
Dumbarton,4309,10,7,12,17,44,61,-17,33
Hibernian,4310,1,20,11,5,55,25,30,71
Dundee Utd,4310,2,18,8,10,57,39,18,62
Morton,4310,3,16,11,9,49,39,10,59
Falkirk,4310,4,15,10,11,57,43,14,55
Dunfermline,4310,5,12,11,13,47,46,1,47
Queen of S't,4310,6,12,9,15,47,53,-6,45
Dumbarton,4310,7,10,11,15,53,59,-6,41
Raith,4310,8,10,10,16,34,50,-16,40
St Mirren,4310,9,8,11,17,40,57,-17,35
Ayr,4310,10,7,12,17,38,66,-28,33
Hibernian,4311,1,20,12,4,57,28,29,72
Morton,4311,2,18,11,7,56,37,19,65
Falkirk,4311,3,15,11,10,53,40,13,56
Dundee Utd,4311,4,15,11,10,50,39,11,56
Queen of S't,4311,5,15,9,12,56,47,9,54
Dumbarton,4311,6,10,11,15,48,59,-11,41
Dunfermline,4311,7,9,12,15,45,53,-8,39
St Mirren,4311,8,9,10,17,47,55,-8,37
Raith,4311,9,8,11,17,32,59,-27,35
Ayr,4311,10,6,12,18,34,61,-27,30
Hibernian,4312,1,20,11,5,55,26,29,71
Morton,4312,2,18,11,7,50,33,17,65
Falkirk,4312,3,16,11,9,58,41,17,59
Dundee Utd,4312,4,15,9,12,51,42,9,54
Queen of S't,4312,5,15,8,13,49,47,2,53
Raith,4312,6,11,11,14,38,48,-10,44
Dunfermline,4312,7,9,13,14,45,51,-6,40
Dumbarton,4312,8,8,10,18,45,61,-16,34
Ayr,4312,9,7,13,16,34,57,-23,34
St Mirren,4312,10,7,11,18,39,58,-19,32
Hibernian,4313,1,21,10,5,57,25,32,73
Morton,4313,2,16,12,8,53,37,16,60
Falkirk,4313,3,16,11,9,58,43,15,59
Dundee Utd,4313,4,15,11,10,51,43,8,56
Dumbarton,4313,5,12,10,14,51,56,-5,46
Ayr,4313,6,11,10,15,34,49,-15,43
Queen of S't,4313,7,11,8,17,46,53,-7,41
Dunfermline,4313,8,8,14,14,44,52,-8,38
Raith,4313,9,9,9,18,34,58,-24,36
St Mirren,4313,10,8,11,17,42,54,-12,35
Hibernian,4314,1,18,11,7,54,27,27,65
Falkirk,4314,2,16,12,8,57,37,20,60
Dundee Utd,4314,3,16,10,10,48,37,11,58
Morton,4314,4,15,13,8,47,39,8,58
Queen of S't,4314,5,11,12,13,47,51,-4,45
Dunfermline,4314,6,9,15,12,45,49,-4,42
Ayr,4314,7,10,11,15,38,52,-14,41
Dumbarton,4314,8,9,12,15,50,62,-12,39
Raith,4314,9,9,11,16,32,49,-17,38
St Mirren,4314,10,8,11,17,38,53,-15,35
Hibernian,4315,1,20,12,4,63,29,34,72
Dundee Utd,4315,2,19,8,9,57,39,18,65
Morton,4315,3,17,11,8,52,38,14,62
Falkirk,4315,4,17,10,9,62,42,20,61
Queen of S't,4315,5,13,9,14,52,51,1,48
Dunfermline,4315,6,9,14,13,50,53,-3,41
Raith,4315,7,11,8,17,39,56,-17,41
Dumbarton,4315,8,8,10,18,44,63,-19,34
St Mirren,4315,9,8,10,18,36,57,-21,34
Ayr,4315,10,7,10,19,35,62,-27,31
Hibernian,4316,1,20,12,4,58,23,35,72
Dundee Utd,4316,2,17,9,10,54,41,13,60
Falkirk,4316,3,16,10,10,57,43,14,58
Morton,4316,4,15,12,9,49,37,12,57
Queen of S't,4316,5,13,9,14,47,49,-2,48
Ayr,4316,6,10,11,15,37,52,-15,41
Dunfermline,4316,7,9,13,14,47,54,-7,40
Raith,4316,8,10,10,16,34,47,-13,40
Dumbarton,4316,9,9,12,15,48,63,-15,39
St Mirren,4316,10,7,10,19,38,60,-22,31
Hibernian,4317,1,19,11,6,58,29,29,68
Morton,4317,2,19,9,8,57,44,13,66
Dundee Utd,4317,3,16,10,10,51,37,14,58
Falkirk,4317,4,14,9,13,54,44,10,51
Queen of S't,4317,5,13,9,14,49,52,-3,48
Raith,4317,6,12,11,13,37,42,-5,47
Dumbarton,4317,7,9,13,14,47,56,-9,40
Dunfermline,4317,8,8,14,14,47,54,-7,38
Ayr,4317,9,8,11,17,33,55,-22,35
St Mirren,4317,10,7,13,16,36,56,-20,34
Hibernian,4318,1,19,11,6,54,27,27,68
Falkirk,4318,2,19,9,8,66,39,27,66
Morton,4318,3,19,9,8,50,35,15,66
Dundee Utd,4318,4,15,9,12,45,40,5,54
Queen of S't,4318,5,13,8,15,47,52,-5,47
Dunfermline,4318,6,11,11,14,53,49,4,44
Dumbarton,4318,7,9,11,16,49,61,-12,38
Ayr,4318,8,9,11,16,33,53,-20,38
Raith,4318,9,9,9,18,33,56,-23,36
St Mirren,4318,10,8,10,18,38,56,-18,34
Morton,4319,1,19,11,6,60,39,21,68
Hibernian,4319,2,18,12,6,54,25,29,66
Falkirk,4319,3,15,13,8,63,43,20,58
Dundee Utd,4319,4,14,10,12,53,44,9,52
Ayr,4319,5,11,12,13,39,53,-14,45
Queen of S't,4319,6,11,10,15,44,52,-8,43
Raith,4319,7,11,10,15,39,47,-8,43
St Mirren,4319,8,9,10,17,43,62,-19,37
Dumbarton,4319,9,8,12,16,49,64,-15,36
Dunfermline,4319,10,8,12,16,46,61,-15,36
Hibernian,4320,1,20,12,4,55,22,33,72
Morton,4320,2,17,12,7,49,38,11,63
Falkirk,4320,3,15,11,10,51,36,15,56
Dundee Utd,4320,4,14,10,12,49,43,6,52
Queen of S't,4320,5,13,10,13,49,45,4,49
Dunfermline,4320,6,10,11,15,47,50,-3,41
Dumbarton,4320,7,10,11,15,49,64,-15,41
St Mirren,4320,8,9,12,15,43,53,-10,39
Ayr,4320,9,8,13,15,38,58,-20,37
Raith,4320,10,8,10,18,32,53,-21,34
Hibernian,4321,1,17,15,4,53,26,27,66
Morton,4321,2,16,13,7,49,37,12,61
Falkirk,4321,3,15,12,9,58,43,15,57
Dundee Utd,4321,4,16,9,11,54,40,14,57
Queen of S't,4321,5,13,9,14,50,49,1,48
Dunfermline,4321,6,10,13,13,45,50,-5,43
Raith,4321,7,11,10,15,38,48,-10,43
Dumbarton,4321,8,9,13,14,49,60,-11,40
Ayr,4321,9,8,12,16,36,60,-24,36
St Mirren,4321,10,7,10,19,41,60,-19,31
Hibernian,4322,1,19,11,6,59,33,26,68
Morton,4322,2,18,13,5,51,30,21,67
Falkirk,4322,3,18,10,8,60,39,21,64
Dundee Utd,4322,4,16,11,9,56,40,16,59
Dunfermline,4322,5,9,13,14,47,53,-6,40
Queen of S't,4322,6,10,10,16,41,53,-12,40
Dumbarton,4322,7,8,15,13,47,57,-10,39
Raith,4322,8,9,11,16,37,51,-14,38
Ayr,4322,9,7,13,16,34,58,-24,34
St Mirren,4322,10,7,11,18,39,57,-18,32
Hibernian,4323,1,19,12,5,53,25,28,69
Morton,4323,2,18,11,7,53,38,15,65
Falkirk,4323,3,15,12,9,57,42,15,57
Dundee Utd,4323,4,13,13,10,46,46,0,52
Dunfermline,4323,5,10,14,12,49,50,-1,44
Queen of S't,4323,6,11,9,16,46,53,-7,42
Raith,4323,7,11,9,16,40,50,-10,42
St Mirren,4323,8,9,11,16,45,52,-7,38
Ayr,4323,9,8,13,15,38,59,-21,37
Dumbarton,4323,10,8,12,16,50,62,-12,36
Hibernian,4324,1,19,12,5,55,28,27,69
Morton,4324,2,16,13,7,48,33,15,61
Falkirk,4324,3,15,14,7,58,38,20,59
Dundee Utd,4324,4,14,10,12,50,44,6,52
Queen of S't,4324,5,13,10,13,47,46,1,49
Dunfermline,4324,6,10,13,13,50,49,1,43
Dumbarton,4324,7,10,10,16,48,61,-13,40
Ayr,4324,8,9,11,16,33,57,-24,38
Raith,4324,9,9,10,17,36,53,-17,37
St Mirren,4324,10,8,11,17,39,55,-16,35
Morton,4325,1,18,11,7,53,36,17,65
Hibernian,4325,2,17,12,7,57,31,26,63
Dundee Utd,4325,3,18,9,9,53,37,16,63
Falkirk,4325,4,13,12,11,57,45,12,51
Queen of S't,4325,5,12,8,16,48,54,-6,44
Raith,4325,6,11,11,14,40,49,-9,44
Dumbarton,4325,7,11,10,15,50,57,-7,43
St Mirren,4325,8,11,10,15,44,52,-8,43
Dunfermline,4325,9,8,13,15,44,57,-13,37
Ayr,4325,10,7,12,17,34,62,-28,33
Hibernian,4326,1,19,13,4,59,23,36,70
Morton,4326,2,19,10,7,53,34,19,67
Dundee Utd,4326,3,15,11,10,49,41,8,56
Falkirk,4326,4,14,11,11,58,48,10,53
Dunfermline,4326,5,12,12,12,49,48,1,48
Raith,4326,6,11,9,16,36,48,-12,42
Dumbarton,4326,7,9,12,15,47,59,-12,39
St Mirren,4326,8,10,9,17,43,55,-12,39
Queen of S't,4326,9,10,9,17,45,59,-14,39
Ayr,4326,10,7,12,17,32,56,-24,33
Hibernian,4327,1,19,13,4,56,28,28,70
Morton,4327,2,18,10,8,50,34,16,64
Falkirk,4327,3,14,13,9,54,40,14,55
Dundee Utd,4327,4,15,10,11,49,40,9,55
Queen of S't,4327,5,12,11,13,43,46,-3,47
Dunfermline,4327,6,9,15,12,47,48,-1,42
Dumbarton,4327,7,10,12,14,51,58,-7,42
Raith,4327,8,9,11,16,33,47,-14,38
St Mirren,4327,9,8,11,17,41,58,-17,35
Ayr,4327,10,7,12,17,32,57,-25,33
Hibernian,4328,1,17,11,8,56,35,21,62
Morton,4328,2,17,11,8,50,37,13,62
Falkirk,4328,3,16,11,9,61,44,17,59
Dundee Utd,4328,4,12,13,11,43,42,1,49
Queen of S't,4328,5,13,10,13,49,49,0,49
Raith,4328,6,11,11,14,36,46,-10,44
Dunfermline,4328,7,9,14,13,46,49,-3,41
St Mirren,4328,8,10,10,16,42,55,-13,40
Dumbarton,4328,9,9,12,15,51,57,-6,39
Ayr,4328,10,9,11,16,34,54,-20,38
Hibernian,4329,1,19,12,5,55,25,30,69
Morton,4329,2,16,14,6,48,35,13,62
Dundee Utd,4329,3,16,11,9,51,41,10,59
Falkirk,4329,4,16,10,10,59,43,16,58
Queen of S't,4329,5,12,10,14,45,49,-4,46
Raith,4329,6,11,11,14,39,46,-7,44
Dumbarton,4329,7,10,11,15,45,55,-10,41
Dunfermline,4329,8,8,13,15,43,52,-9,37
Ayr,4329,9,8,11,17,35,55,-20,35
St Mirren,4329,10,7,11,18,38,57,-19,32
Hibernian,4330,1,21,11,4,65,25,40,74
Morton,4330,2,20,10,6,51,35,16,70
Falkirk,4330,3,18,11,7,63,36,27,65
Dundee Utd,4330,4,15,10,11,52,41,11,55
Dunfermline,4330,5,11,12,13,49,49,0,45
Ayr,4330,6,10,10,16,35,54,-19,40
Raith,4330,7,10,9,17,38,54,-16,39
Queen of S't,4330,8,9,9,18,42,61,-19,36
Dumbarton,4330,9,7,12,17,43,60,-17,33
St Mirren,4330,10,6,12,18,37,60,-23,30
Hibernian,4331,1,22,11,3,63,26,37,77
Dundee Utd,4331,2,17,9,10,48,37,11,60
Falkirk,4331,3,16,10,10,58,41,17,58
Morton,4331,4,15,10,11,45,39,6,55
Queen of S't,4331,5,13,8,15,46,51,-5,47
Dumbarton,4331,6,10,12,14,46,53,-7,42
Dunfermline,4331,7,10,11,15,45,51,-6,41
Raith,4331,8,10,10,16,37,49,-12,40
St Mirren,4331,9,8,12,16,40,52,-12,36
Ayr,4331,10,7,11,18,32,61,-29,32
Hibernian,4332,1,20,11,5,59,28,31,71
Morton,4332,2,17,12,7,49,33,16,63
Falkirk,4332,3,16,10,10,57,42,15,58
Dundee Utd,4332,4,15,10,11,49,43,6,55
Queen of S't,4332,5,13,9,14,48,50,-2,48
Dunfermline,4332,6,10,13,13,48,49,-1,43
Raith,4332,7,10,10,16,38,52,-14,40
St Mirren,4332,8,9,10,17,44,56,-12,37
Dumbarton,4332,9,7,15,14,48,60,-12,36
Ayr,4332,10,7,12,17,28,55,-27,33
Hibernian,4333,1,18,14,4,54,26,28,68
Falkirk,4333,2,18,9,9,60,38,22,63
Morton,4333,3,17,12,7,54,38,16,63
Dundee Utd,4333,4,14,10,12,50,46,4,52
Dunfermline,4333,5,10,14,12,43,45,-2,44
Queen of S't,4333,6,11,11,14,51,54,-3,44
Dumbarton,4333,7,10,11,15,51,61,-10,41
St Mirren,4333,8,9,11,16,42,55,-13,38
Raith,4333,9,8,11,17,37,58,-21,35
Ayr,4333,10,7,13,16,36,57,-21,34
Hibernian,4334,1,19,12,5,57,29,28,69
Morton,4334,2,19,10,7,52,35,17,67
Falkirk,4334,3,17,10,9,63,39,24,61
Dundee Utd,4334,4,14,9,13,49,48,1,51
Ayr,4334,5,11,12,13,40,52,-12,45
Queen of S't,4334,6,12,8,16,44,54,-10,44
Dumbarton,4334,7,10,11,15,49,56,-7,41
Raith,4334,8,11,8,17,42,51,-9,41
Dunfermline,4334,9,9,12,15,47,55,-8,39
St Mirren,4334,10,7,10,19,41,65,-24,31
Hibernian,4335,1,20,11,5,53,23,30,71
Morton,4335,2,17,10,9,51,44,7,61
Falkirk,4335,3,16,11,9,63,43,20,59
Dundee Utd,4335,4,13,12,11,49,45,4,51
Dumbarton,4335,5,11,13,12,55,54,1,46
Dunfermline,4335,6,10,12,14,45,50,-5,42
Raith,4335,7,11,9,16,36,47,-11,42
Queen of S't,4335,8,11,8,17,46,55,-9,41
St Mirren,4335,9,9,11,16,37,52,-15,38
Ayr,4335,10,7,13,16,34,56,-22,34
Hibernian,4336,1,18,13,5,52,24,28,67
Morton,4336,2,16,10,10,47,37,10,58
Falkirk,4336,3,15,10,11,52,38,14,55
Dundee Utd,4336,4,15,10,11,50,42,8,55
Queen of S't,4336,5,13,9,14,43,47,-4,48
Dunfermline,4336,6,11,14,11,42,41,1,47
Raith,4336,7,11,10,15,35,46,-11,43
Ayr,4336,8,9,13,14,39,54,-15,40
Dumbarton,4336,9,9,11,16,46,58,-12,38
St Mirren,4336,10,8,10,18,35,54,-19,34
Hibernian,4337,1,22,11,3,59,24,35,77
Falkirk,4337,2,15,10,11,59,43,16,55
Dundee Utd,4337,3,15,10,11,52,41,11,55
Morton,4337,4,14,13,9,48,40,8,55
Queen of S't,4337,5,12,10,14,44,49,-5,46
Raith,4337,6,12,10,14,38,48,-10,46
Dunfermline,4337,7,9,14,13,43,47,-4,41
Dumbarton,4337,8,9,12,15,44,57,-13,39
Ayr,4337,9,8,12,16,36,57,-21,36
St Mirren,4337,10,8,10,18,40,57,-17,34
Hibernian,4338,1,18,15,3,54,22,32,69
Morton,4338,2,19,10,7,51,35,16,67
Falkirk,4338,3,15,13,8,54,38,16,58
Dundee Utd,4338,4,15,10,11,46,40,6,55
Queen of S't,4338,5,12,10,14,46,50,-4,46
Dunfermline,4338,6,11,12,13,47,47,0,45
Raith,4338,7,11,8,17,36,52,-16,41
Dumbarton,4338,8,9,12,15,49,57,-8,39
Ayr,4338,9,7,12,17,32,53,-21,33
St Mirren,4338,10,7,10,19,36,57,-21,31
Morton,4339,1,18,12,6,46,29,17,66
Hibernian,4339,2,17,14,5,51,24,27,65
Falkirk,4339,3,16,10,10,61,43,18,58
Dundee Utd,4339,4,16,9,11,51,43,8,57
Queen of S't,4339,5,12,9,15,48,56,-8,45
Dumbarton,4339,6,11,10,15,53,60,-7,43
Dunfermline,4339,7,10,12,14,42,49,-7,42
Ayr,4339,8,10,12,14,39,51,-12,42
Raith,4339,9,8,11,17,33,52,-19,35
St Mirren,4339,10,7,11,18,39,56,-17,32
Hibernian,4340,1,18,12,6,52,27,25,66
Morton,4340,2,17,12,7,50,38,12,63
Dundee Utd,4340,3,14,12,10,52,42,10,54
Falkirk,4340,4,13,13,10,54,41,13,52
Dunfermline,4340,5,10,13,13,46,45,1,43
Queen of S't,4340,6,11,10,15,43,50,-7,43
St Mirren,4340,7,11,10,15,46,58,-12,43
Ayr,4340,8,10,12,14,36,52,-16,42
Raith,4340,9,9,11,16,35,49,-14,38
Dumbarton,4340,10,8,13,15,48,60,-12,37
Morton,4341,1,18,12,6,55,33,22,66
Falkirk,4341,2,18,9,9,60,39,21,63
Dundee Utd,4341,3,17,11,8,58,36,22,62
Hibernian,4341,4,17,10,9,51,34,17,61
Queen of S't,4341,5,13,9,14,50,50,0,48
Raith,4341,6,11,10,15,39,49,-10,43
Dunfermline,4341,7,9,11,16,41,61,-20,38
Ayr,4341,8,9,11,16,35,55,-20,38
Dumbarton,4341,9,8,11,17,51,65,-14,35
St Mirren,4341,10,8,10,18,38,56,-18,34
Hibernian,4342,1,21,10,5,66,30,36,73
Morton,4342,2,16,12,8,46,39,7,60
Dundee Utd,4342,3,16,8,12,49,41,8,56
Falkirk,4342,4,14,12,10,59,47,12,54
Queen of S't,4342,5,12,11,13,50,53,-3,47
Dunfermline,4342,6,11,12,13,48,45,3,45
Raith,4342,7,10,11,15,34,49,-15,41
Dumbarton,4342,8,8,15,13,47,55,-8,39
St Mirren,4342,9,8,11,17,42,59,-17,35
Ayr,4342,10,7,12,17,33,56,-23,33
Hibernian,4343,1,20,12,4,59,23,36,72
Dundee Utd,4343,2,18,9,9,54,37,17,63
Morton,4343,3,16,11,9,47,34,13,59
Falkirk,4343,4,14,9,13,54,51,3,51
Queen of S't,4343,5,13,8,15,46,52,-6,47
Dunfermline,4343,6,10,13,13,48,46,2,43
Raith,4343,7,11,9,16,38,50,-12,42
St Mirren,4343,8,10,10,16,44,57,-13,40
Dumbarton,4343,9,9,11,16,50,61,-11,38
Ayr,4343,10,8,10,18,32,61,-29,34
Hibernian,4344,1,19,12,5,54,26,28,69
Morton,4344,2,16,12,8,51,39,12,60
Falkirk,4344,3,16,10,10,55,42,13,58
Dundee Utd,4344,4,15,10,11,46,39,7,55
Dunfermline,4344,5,11,14,11,49,48,1,47
Queen of S't,4344,6,11,9,16,45,50,-5,42
Raith,4344,7,11,9,16,38,52,-14,42
Ayr,4344,8,9,13,14,34,51,-17,40
St Mirren,4344,9,9,11,16,44,53,-9,38
Dumbarton,4344,10,7,12,17,45,61,-16,33
Hibernian,4345,1,19,13,4,55,22,33,70
Dundee Utd,4345,2,17,9,10,48,39,9,60
Falkirk,4345,3,16,9,11,58,44,14,57
Morton,4345,4,15,10,11,47,42,5,55
Dunfermline,4345,5,12,12,12,46,48,-2,48
Dumbarton,4345,6,11,11,14,55,54,1,44
Queen of S't,4345,7,11,9,16,44,51,-7,42
St Mirren,4345,8,9,11,16,38,52,-14,38
Raith,4345,9,9,10,17,32,50,-18,37
Ayr,4345,10,7,14,15,31,52,-21,35
Hibernian,4346,1,18,15,3,52,23,29,69
Dundee Utd,4346,2,18,10,8,52,36,16,64
Morton,4346,3,15,12,9,50,38,12,57
Falkirk,4346,4,14,11,11,52,43,9,53
Queen of S't,4346,5,11,13,12,48,51,-3,46
Dumbarton,4346,6,11,11,14,52,57,-5,44
Dunfermline,4346,7,8,15,13,46,50,-4,39
St Mirren,4346,8,9,12,15,40,53,-13,39
Raith,4346,9,8,13,15,38,52,-14,37
Ayr,4346,10,6,12,18,35,62,-27,30
Hibernian,4347,1,20,10,6,58,28,30,70
Morton,4347,2,19,9,8,54,37,17,66
Falkirk,4347,3,16,11,9,59,42,17,59
Dundee Utd,4347,4,16,10,10,53,41,12,58
Queen of S't,4347,5,12,8,16,41,51,-10,44
Dunfermline,4347,6,9,14,13,47,49,-2,41
Dumbarton,4347,7,10,11,15,47,57,-10,41
Ayr,4347,8,9,11,16,38,56,-18,38
Raith,4347,9,9,10,17,36,53,-17,37
St Mirren,4347,10,8,10,18,40,59,-19,34
Hibernian,4348,1,20,12,4,60,25,35,72
Dundee Utd,4348,2,17,10,9,53,40,13,61
Morton,4348,3,17,10,9,49,38,11,61
Falkirk,4348,4,16,10,10,59,46,13,58
Queen of S't,4348,5,11,11,14,45,48,-3,44
Dumbarton,4348,6,11,11,14,51,58,-7,44
Dunfermline,4348,7,10,12,14,45,48,-3,42
Raith,4348,8,9,10,17,36,52,-16,37
Ayr,4348,9,7,14,15,33,55,-22,35
St Mirren,4348,10,6,12,18,35,56,-21,30
Hibernian,4349,1,19,11,6,58,27,31,68
Falkirk,4349,2,17,10,9,56,39,17,61
Morton,4349,3,15,12,9,46,41,5,57
Dundee Utd,4349,4,15,10,11,54,45,9,55
Dunfermline,4349,5,13,12,11,51,43,8,51
Queen of S't,4349,6,10,12,14,41,47,-6,42
St Mirren,4349,7,11,9,16,49,56,-7,42
Dumbarton,4349,8,9,13,14,49,57,-8,40
Raith,4349,9,10,9,17,32,47,-15,39
Ayr,4349,10,7,10,19,31,65,-34,31
Hibernian,4350,1,21,10,5,60,24,36,73
Morton,4350,2,17,10,9,54,39,15,61
Dundee Utd,4350,3,17,9,10,52,37,15,60
Falkirk,4350,4,16,10,10,59,43,16,58
Queen of S't,4350,5,12,9,15,47,54,-7,45
Dunfermline,4350,6,10,11,15,43,51,-8,41
Ayr,4350,7,10,11,15,39,60,-21,41
Raith,4350,8,10,10,16,37,49,-12,40
St Mirren,4350,9,9,10,17,40,51,-11,37
Dumbarton,4350,10,8,10,18,43,66,-23,34
Hibernian,4351,1,17,14,5,54,26,28,65
Morton,4351,2,17,12,7,53,41,12,63
Dundee Utd,4351,3,15,10,11,50,42,8,55
Falkirk,4351,4,14,12,10,57,43,14,54
Raith,4351,5,12,9,15,35,44,-9,45
Queen of S't,4351,6,11,11,14,44,50,-6,44
Dunfermline,4351,7,9,15,12,46,49,-3,42
St Mirren,4351,8,10,11,15,48,58,-10,41
Dumbarton,4351,9,9,13,14,52,60,-8,40
Ayr,4351,10,7,11,18,32,58,-26,32
Hibernian,4352,1,20,11,5,58,25,33,71
Falkirk,4352,2,18,10,8,62,37,25,64
Dundee Utd,4352,3,18,9,9,56,42,14,63
Morton,4352,4,17,11,8,53,43,10,62
Queen of S't,4352,5,11,9,16,40,51,-11,42
Dunfermline,4352,6,10,11,15,50,53,-3,41
Raith,4352,7,10,9,17,35,49,-14,39
Ayr,4352,8,9,11,16,37,56,-19,38
Dumbarton,4352,9,8,11,17,47,63,-16,35
St Mirren,4352,10,7,12,17,37,56,-19,33
Hibernian,4353,1,17,14,5,54,30,24,65
Dundee Utd,4353,2,17,10,9,55,36,19,61
Morton,4353,3,14,12,10,45,38,7,54
Falkirk,4353,4,13,11,12,55,46,9,50
Queen of S't,4353,5,12,11,13,49,49,0,47
Dumbarton,4353,6,12,11,13,52,57,-5,47
Dunfermline,4353,7,10,12,14,47,52,-5,42
Raith,4353,8,11,9,16,37,51,-14,42
St Mirren,4353,9,9,11,16,39,52,-13,38
Ayr,4353,10,8,13,15,31,53,-22,37
Hibernian,4354,1,22,11,3,62,24,38,77
Falkirk,4354,2,16,11,9,56,39,17,59
Dundee Utd,4354,3,15,11,10,50,40,10,56
Morton,4354,4,14,12,10,46,42,4,54
Dunfermline,4354,5,11,12,13,49,54,-5,45
Queen of S't,4354,6,11,10,15,45,52,-7,43
Dumbarton,4354,7,10,12,14,51,53,-2,42
Raith,4354,8,10,9,17,34,47,-13,39
Ayr,4354,9,8,13,15,32,53,-21,37
St Mirren,4354,10,8,9,19,37,58,-21,33
Hibernian,4355,1,18,12,6,52,27,25,66
Morton,4355,2,15,14,7,46,34,12,59
Falkirk,4355,3,16,10,10,57,36,21,58
Queen of S't,4355,4,15,9,12,47,44,3,54
Dundee Utd,4355,5,14,11,11,45,41,4,53
Dumbarton,4355,6,11,10,15,49,53,-4,43
Raith,4355,7,11,10,15,34,48,-14,43
Dunfermline,4355,8,9,14,13,42,44,-2,41
St Mirren,4355,9,8,12,16,41,59,-18,36
Ayr,4355,10,6,12,18,30,57,-27,30
Hibernian,4356,1,21,12,3,57,23,34,75
Dundee Utd,4356,2,17,10,9,53,41,12,61
Falkirk,4356,3,16,11,9,59,43,16,59
Morton,4356,4,15,12,9,44,36,8,57
Queen of S't,4356,5,11,8,17,47,56,-9,41
Raith,4356,6,10,10,16,33,45,-12,40
Ayr,4356,7,9,13,14,36,52,-16,40
Dunfermline,4356,8,9,12,15,42,48,-6,39
Dumbarton,4356,9,8,12,16,50,62,-12,36
St Mirren,4356,10,8,12,16,40,55,-15,36
Hibernian,4357,1,19,12,5,56,28,28,69
Morton,4357,2,16,13,7,51,37,14,61
Dundee Utd,4357,3,15,12,9,47,37,10,57
Falkirk,4357,4,15,10,11,53,39,14,55
Raith,4357,5,12,11,13,40,45,-5,47
Dunfermline,4357,6,10,13,13,42,47,-5,43
Queen of S't,4357,7,10,11,15,41,46,-5,41
Dumbarton,4357,8,9,13,14,46,55,-9,40
Ayr,4357,9,7,15,14,31,51,-20,36
St Mirren,4357,10,6,12,18,38,60,-22,30
Hibernian,4358,1,19,13,4,54,22,32,70
Falkirk,4358,2,16,11,9,60,41,19,59
Morton,4358,3,16,11,9,50,40,10,59
Dundee Utd,4358,4,15,9,12,47,48,-1,54
Dumbarton,4358,5,12,11,13,53,55,-2,47
Queen of S't,4358,6,11,11,14,49,54,-5,44
Raith,4358,7,10,12,14,36,47,-11,42
St Mirren,4358,8,9,10,17,38,54,-16,37
Dunfermline,4358,9,7,15,14,43,50,-7,36
Ayr,4358,10,8,11,17,36,55,-19,35
Hibernian,4359,1,19,11,6,56,25,31,68
Morton,4359,2,18,12,6,51,34,17,66
Dundee Utd,4359,3,18,10,8,56,38,18,64
Falkirk,4359,4,16,10,10,62,43,19,58
Queen of S't,4359,5,12,9,15,47,52,-5,45
Raith,4359,6,12,9,15,40,50,-10,45
Dunfermline,4359,7,8,13,15,47,56,-9,37
Dumbarton,4359,8,9,10,17,46,61,-15,37
St Mirren,4359,9,8,10,18,40,60,-20,34
Ayr,4359,10,7,12,17,33,59,-26,33
Hibernian,4360,1,20,12,4,55,23,32,72
Falkirk,4360,2,17,10,9,62,44,18,61
Morton,4360,3,16,12,8,52,39,13,60
Dundee Utd,4360,4,16,10,10,54,40,14,58
Dunfermline,4360,5,12,13,11,54,48,6,49
Queen of S't,4360,6,12,8,16,45,56,-11,44
Ayr,4360,7,9,11,16,36,56,-20,38
Dumbarton,4360,8,9,10,17,46,58,-12,37
St Mirren,4360,9,9,10,17,41,58,-17,37
Raith,4360,10,8,8,20,32,55,-23,32
Hibernian,4361,1,18,11,7,57,28,29,65
Morton,4361,2,18,11,7,53,37,16,65
Falkirk,4361,3,16,9,11,56,42,14,57
Queen of S't,4361,4,15,9,12,50,48,2,54
Dundee Utd,4361,5,14,8,14,46,45,1,50
Dunfermline,4361,6,11,12,13,47,49,-2,45
Dumbarton,4361,7,11,11,14,55,59,-4,44
Ayr,4361,8,9,13,14,37,53,-16,40
Raith,4361,9,9,8,19,33,51,-18,35
St Mirren,4361,10,8,10,18,38,60,-22,34
Hibernian,4362,1,20,10,6,54,26,28,70
Morton,4362,2,16,10,10,47,37,10,58
Dundee Utd,4362,3,15,8,13,49,43,6,53
Queen of S't,4362,4,14,9,13,53,51,2,51
Falkirk,4362,5,13,11,12,54,48,6,50
Dunfermline,4362,6,12,11,13,49,47,2,47
Raith,4362,7,13,8,15,38,46,-8,47
Dumbarton,4362,8,10,13,13,49,53,-4,43
St Mirren,4362,9,8,11,17,35,55,-20,35
Ayr,4362,10,8,11,17,37,59,-22,35
Hibernian,4363,1,19,14,3,52,23,29,71
Morton,4363,2,16,12,8,48,33,15,60
Falkirk,4363,3,16,11,9,58,41,17,59
Dundee Utd,4363,4,15,11,10,45,35,10,56
Queen of S't,4363,5,11,11,14,42,46,-4,44
Dunfermline,4363,6,10,12,14,47,49,-2,42
Raith,4363,7,10,11,15,35,49,-14,41
Ayr,4363,8,10,10,16,34,52,-18,40
St Mirren,4363,9,8,12,16,36,49,-13,36
Dumbarton,4363,10,8,10,18,45,65,-20,34
Morton,4364,1,19,11,6,55,35,20,68
Hibernian,4364,2,18,12,6,54,27,27,66
Dundee Utd,4364,3,17,8,11,57,42,15,59
Falkirk,4364,4,14,12,10,59,49,10,54
Queen of S't,4364,5,12,9,15,47,52,-5,45
Dunfermline,4364,6,9,15,12,43,49,-6,42
Raith,4364,7,10,10,16,37,50,-13,40
Dumbarton,4364,8,9,12,15,50,60,-10,39
Ayr,4364,9,8,12,16,33,56,-23,36
St Mirren,4364,10,8,11,17,37,52,-15,35
Hibernian,4365,1,20,10,6,55,28,27,70
Morton,4365,2,16,12,8,45,34,11,60
Falkirk,4365,3,16,10,10,60,44,16,58
Dundee Utd,4365,4,15,11,10,51,43,8,56
Queen of S't,4365,5,12,10,14,51,53,-2,46
Dunfermline,4365,6,10,13,13,48,48,0,43
Raith,4365,7,10,10,16,35,51,-16,40
Ayr,4365,8,8,15,13,37,53,-16,39
St Mirren,4365,9,9,10,17,42,53,-11,37
Dumbarton,4365,10,8,11,17,45,62,-17,35
Hibernian,4366,1,18,13,5,56,29,27,67
Dundee Utd,4366,2,18,9,9,50,37,13,63
Morton,4366,3,17,11,8,49,37,12,62
Falkirk,4366,4,17,9,10,60,40,20,60
Raith,4366,5,11,9,16,41,52,-11,42
Dunfermline,4366,6,9,14,13,45,49,-4,41
Queen of S't,4366,7,10,11,15,40,50,-10,41
Ayr,4366,8,10,11,15,38,53,-15,41
Dumbarton,4366,9,7,14,15,45,59,-14,35
St Mirren,4366,10,8,9,19,39,57,-18,33
Hibernian,4367,1,19,11,6,58,27,31,68
Dundee Utd,4367,2,18,10,8,54,34,20,64
Morton,4367,3,17,11,8,54,41,13,62
Falkirk,4367,4,16,10,10,59,46,13,58
Dumbarton,4367,5,11,13,12,51,52,-1,46
Dunfermline,4367,6,11,12,13,49,52,-3,45
Queen of S't,4367,7,11,9,16,43,52,-9,42
Raith,4367,8,8,10,18,33,52,-19,34
St Mirren,4367,9,8,10,18,37,58,-21,34
Ayr,4367,10,7,12,17,35,59,-24,33
Hibernian,4368,1,21,11,4,58,25,33,74
Morton,4368,2,18,12,6,56,34,22,66
Falkirk,4368,3,15,10,11,57,43,14,55
Dundee Utd,4368,4,14,9,13,47,46,1,51
Queen of S't,4368,5,12,10,14,49,51,-2,46
Dumbarton,4368,6,9,13,14,51,60,-9,40
Dunfermline,4368,7,8,15,13,43,50,-7,39
St Mirren,4368,8,9,11,16,38,51,-13,38
Ayr,4368,9,8,13,15,36,55,-19,37
Raith,4368,10,9,10,17,31,51,-20,37
Hibernian,4369,1,19,12,5,60,26,34,69
Morton,4369,2,16,13,7,48,35,13,61
Falkirk,4369,3,15,10,11,55,44,11,55
Dundee Utd,4369,4,14,10,12,43,39,4,52
Queen of S't,4369,5,12,12,12,45,44,1,48
Dunfermline,4369,6,11,12,13,44,47,-3,45
Ayr,4369,7,10,12,14,38,52,-14,42
Raith,4369,8,10,10,16,35,49,-14,40
Dumbarton,4369,9,9,11,16,50,62,-12,38
St Mirren,4369,10,8,10,18,35,55,-20,34
Hibernian,4370,1,19,14,3,53,23,30,71
Falkirk,4370,2,17,9,10,60,41,19,60
Morton,4370,3,16,10,10,49,35,14,58
Dundee Utd,4370,4,15,11,10,44,35,9,56
Dumbarton,4370,5,10,12,14,51,55,-4,42
Queen of S't,4370,6,10,12,14,43,54,-11,42
Raith,4370,7,10,10,16,34,51,-17,40
Dunfermline,4370,8,9,12,15,46,53,-7,39
St Mirren,4370,9,8,13,15,38,51,-13,37
Ayr,4370,10,8,13,15,36,56,-20,37
Hibernian,4371,1,21,11,4,59,26,33,74
Morton,4371,2,18,9,9,57,37,20,63
Falkirk,4371,3,17,10,9,62,44,18,61
Dundee Utd,4371,4,15,8,13,50,44,6,53
Queen of S't,4371,5,13,8,15,51,50,1,47
Dunfermline,4371,6,10,13,13,46,50,-4,43
Raith,4371,7,10,10,16,35,50,-15,40
Dumbarton,4371,8,9,10,17,45,60,-15,37
St Mirren,4371,9,9,10,17,39,57,-18,37
Ayr,4371,10,8,11,17,39,65,-26,35
Hibernian,4372,1,21,11,4,60,24,36,74
Dundee Utd,4372,2,19,8,9,61,37,24,65
Morton,4372,3,16,11,9,48,39,9,59
Falkirk,4372,4,15,10,11,57,43,14,55
Queen of S't,4372,5,11,11,14,49,52,-3,44
Dunfermline,4372,6,9,14,13,46,50,-4,41
Ayr,4372,7,9,11,16,32,52,-20,38
St Mirren,4372,8,9,10,17,39,57,-18,37
Raith,4372,9,9,10,17,34,54,-20,37
Dumbarton,4372,10,8,12,16,47,65,-18,36
Hibernian,4373,1,18,12,6,53,27,26,66
Morton,4373,2,17,11,8,51,38,13,62
Falkirk,4373,3,17,10,9,59,40,19,61
Dundee Utd,4373,4,16,10,10,51,40,11,58
Queen of S't,4373,5,14,9,13,51,48,3,51
Raith,4373,6,10,11,15,39,52,-13,41
Dumbarton,4373,7,9,12,15,45,54,-9,39
St Mirren,4373,8,9,12,15,41,53,-12,39
Dunfermline,4373,9,8,12,16,45,56,-11,36
Ayr,4373,10,6,13,17,34,61,-27,31
Hibernian,4374,1,20,11,5,60,28,32,71
Dundee Utd,4374,2,18,8,10,53,37,16,62
Morton,4374,3,17,10,9,48,39,9,61
Falkirk,4374,4,17,9,10,61,41,20,60
Dunfermline,4374,5,12,11,13,49,51,-2,47
Queen of S't,4374,6,11,10,15,45,50,-5,43
Raith,4374,7,10,9,17,36,50,-14,39
Ayr,4374,8,9,11,16,33,55,-22,38
St Mirren,4374,9,9,9,18,38,54,-16,36
Dumbarton,4374,10,8,10,18,44,62,-18,34
Hibernian,4375,1,18,12,6,53,30,23,66
Falkirk,4375,2,18,10,8,57,37,20,64
Morton,4375,3,16,13,7,51,36,15,61
Dundee Utd,4375,4,17,9,10,51,39,12,60
Dunfermline,4375,5,10,15,11,50,45,5,45
St Mirren,4375,6,11,9,16,43,52,-9,42
Queen of S't,4375,7,10,11,15,44,53,-9,41
Dumbarton,4375,8,8,12,16,48,60,-12,36
Raith,4375,9,8,11,17,32,52,-20,35
Ayr,4375,10,7,12,17,34,59,-25,33
Hibernian,4376,1,19,11,6,57,33,24,68
Morton,4376,2,17,12,7,48,36,12,63
Falkirk,4376,3,16,10,10,61,43,18,58
Dundee Utd,4376,4,13,11,12,45,40,5,50
Dunfermline,4376,5,12,11,13,51,47,4,47
Queen of S't,4376,6,12,9,15,45,53,-8,45
Raith,4376,7,11,10,15,37,47,-10,43
St Mirren,4376,8,10,11,15,42,52,-10,41
Dumbarton,4376,9,8,11,17,45,60,-15,35
Ayr,4376,10,7,14,15,37,57,-20,35
Hibernian,4377,1,18,11,7,56,28,28,65
Morton,4377,2,18,11,7,54,40,14,65
Queen of S't,4377,3,16,8,12,55,47,8,56
Dundee Utd,4377,4,15,8,13,48,44,4,53
Falkirk,4377,5,14,9,13,52,42,10,51
Dunfermline,4377,6,12,12,12,51,50,1,48
St Mirren,4377,7,10,10,16,37,50,-13,40
Raith,4377,8,10,9,17,33,52,-19,39
Dumbarton,4377,9,8,13,15,47,58,-11,37
Ayr,4377,10,7,13,16,37,59,-22,34
Hibernian,4378,1,20,12,4,59,27,32,72
Dundee Utd,4378,2,17,11,8,51,34,17,62
Falkirk,4378,3,16,11,9,58,35,23,59
Morton,4378,4,15,10,11,46,43,3,55
Raith,4378,5,11,11,14,37,48,-11,44
Dumbarton,4378,6,10,11,15,46,60,-14,41
Dunfermline,4378,7,9,13,14,45,48,-3,40
Queen of S't,4378,8,10,10,16,40,49,-9,40
Ayr,4378,9,7,14,15,34,54,-20,35
St Mirren,4378,10,7,13,16,39,57,-18,34
Hibernian,4379,1,18,10,8,54,29,25,64
Dundee Utd,4379,2,18,9,9,57,38,19,63
Morton,4379,3,17,11,8,51,38,13,62
Falkirk,4379,4,16,10,10,58,39,19,58
Queen of S't,4379,5,10,13,13,45,50,-5,43
Dunfermline,4379,6,10,12,14,46,53,-7,42
Dumbarton,4379,7,10,11,15,53,62,-9,41
Raith,4379,8,10,9,17,36,54,-18,39
Ayr,4379,9,9,12,15,33,52,-19,39
St Mirren,4379,10,8,11,17,36,54,-18,35
Hibernian,4380,1,21,12,3,62,24,38,75
Morton,4380,2,17,11,8,50,36,14,62
Falkirk,4380,3,16,11,9,54,41,13,59
Dundee Utd,4380,4,15,11,10,50,40,10,56
Dunfermline,4380,5,10,12,14,48,50,-2,42
Queen of S't,4380,6,9,12,15,44,52,-8,39
Ayr,4380,7,9,12,15,35,57,-22,39
Raith,4380,8,9,11,16,33,49,-16,38
Dumbarton,4380,9,8,13,15,46,56,-10,37
St Mirren,4380,10,7,13,16,39,56,-17,34
Hibernian,4381,1,20,11,5,55,24,31,71
Morton,4381,2,18,11,7,54,41,13,65
Falkirk,4381,3,16,10,10,58,42,16,58
Dundee Utd,4381,4,15,11,10,52,39,13,56
Dunfermline,4381,5,13,11,12,52,44,8,50
Dumbarton,4381,6,11,10,15,48,56,-8,43
Queen of S't,4381,7,10,11,15,39,48,-9,41
Raith,4381,8,8,11,17,31,49,-18,35
Ayr,4381,9,7,13,16,34,55,-21,34
St Mirren,4381,10,8,9,19,38,63,-25,33
Morton,4382,1,18,11,7,48,32,16,65
Hibernian,4382,2,17,12,7,51,30,21,63
Falkirk,4382,3,15,12,9,54,38,16,57
Dundee Utd,4382,4,14,10,12,45,42,3,52
Queen of S't,4382,5,13,9,14,48,48,0,48
Dunfermline,4382,6,11,14,11,46,43,3,47
St Mirren,4382,7,11,10,15,47,52,-5,43
Raith,4382,8,10,10,16,38,50,-12,40
Dumbarton,4382,9,8,11,17,42,59,-17,35
Ayr,4382,10,7,13,16,34,59,-25,34
Hibernian,4383,1,22,10,4,56,25,31,76
Morton,4383,2,19,10,7,50,33,17,67
Falkirk,4383,3,17,10,9,61,42,19,61
Dundee Utd,4383,4,16,9,11,53,44,9,57
Ayr,4383,5,11,12,13,41,50,-9,45
Queen of S't,4383,6,11,9,16,47,53,-6,42
Dunfermline,4383,7,9,12,15,43,49,-6,39
Dumbarton,4383,8,9,10,17,44,57,-13,37
Raith,4383,9,9,10,17,34,50,-16,37
St Mirren,4383,10,6,10,20,33,59,-26,28
Morton,4384,1,19,12,5,56,32,24,69
Hibernian,4384,2,18,12,6,58,29,29,66
Falkirk,4384,3,18,9,9,62,41,21,63
Dundee Utd,4384,4,13,12,11,48,39,9,51
Dumbarton,4384,5,9,14,13,49,59,-10,41
Dunfermline,4384,6,10,11,15,41,52,-11,41
Queen of S't,4384,7,10,10,16,40,51,-11,40
Raith,4384,8,9,12,15,33,46,-13,39
Ayr,4384,9,8,13,15,33,51,-18,37
St Mirren,4384,10,8,11,17,40,60,-20,35
Morton,4385,1,19,9,8,56,37,19,66
Hibernian,4385,2,18,11,7,58,31,27,65
Falkirk,4385,3,14,13,9,60,47,13,55
Dundee Utd,4385,4,14,12,10,51,43,8,54
Dunfermline,4385,5,10,14,12,46,46,0,44
Dumbarton,4385,6,11,11,14,48,54,-6,44
Queen of S't,4385,7,11,10,15,49,58,-9,43
Raith,4385,8,10,10,16,36,49,-13,40
St Mirren,4385,9,9,10,17,42,57,-15,37
Ayr,4385,10,8,12,16,35,59,-24,36
Hibernian,4386,1,20,13,3,59,25,34,73
Morton,4386,2,17,11,8,54,41,13,62
Dundee Utd,4386,3,15,11,10,51,41,10,56
Falkirk,4386,4,14,12,10,57,49,8,54
Queen of S't,4386,5,13,9,14,48,48,0,48
Dunfermline,4386,6,10,12,14,46,46,0,42
St Mirren,4386,7,10,10,16,46,56,-10,40
Raith,4386,8,10,9,17,34,50,-16,39
Ayr,4386,9,9,10,17,38,56,-18,37
Dumbarton,4386,10,8,11,17,44,65,-21,35
Hibernian,4387,1,17,15,4,48,23,25,66
Falkirk,4387,2,17,10,9,68,45,23,61
Morton,4387,3,15,14,7,48,35,13,59
Dundee Utd,4387,4,15,10,11,51,41,10,55
Queen of S't,4387,5,13,11,12,45,43,2,50
Dumbarton,4387,6,11,11,14,50,57,-7,44
Dunfermline,4387,7,8,13,15,43,52,-9,37
Raith,4387,8,9,10,17,35,55,-20,37
St Mirren,4387,9,8,12,16,44,58,-14,36
Ayr,4387,10,8,12,16,35,58,-23,36
Hibernian,4388,1,18,12,6,58,26,32,66
Falkirk,4388,2,18,10,8,63,40,23,64
Dundee Utd,4388,3,18,9,9,55,40,15,63
Morton,4388,4,17,11,8,51,38,13,62
Dunfermline,4388,5,11,11,14,48,50,-2,44
Queen of S't,4388,6,11,9,16,44,52,-8,42
Raith,4388,7,11,8,17,34,51,-17,41
St Mirren,4388,8,9,10,17,42,56,-14,37
Ayr,4388,9,8,12,16,30,51,-21,36
Dumbarton,4388,10,8,10,18,43,64,-21,34
Hibernian,4389,1,21,11,4,61,25,36,74
Morton,4389,2,17,11,8,50,37,13,62
Dundee Utd,4389,3,16,9,11,47,39,8,57
Falkirk,4389,4,15,10,11,58,44,14,55
Ayr,4389,5,11,12,13,42,54,-12,45
Queen of S't,4389,6,12,8,16,43,53,-10,44
Dunfermline,4389,7,10,11,15,51,56,-5,41
Raith,4389,8,11,8,17,39,50,-11,41
Dumbarton,4389,9,9,11,16,49,60,-11,38
St Mirren,4389,10,7,11,18,35,57,-22,32
Hibernian,4390,1,18,12,6,53,27,26,66
Morton,4390,2,18,10,8,53,36,17,64
Falkirk,4390,3,15,12,9,58,41,17,57
Dundee Utd,4390,4,16,9,11,54,38,16,57
Queen of S't,4390,5,12,9,15,46,56,-10,45
Dumbarton,4390,6,10,12,14,53,61,-8,42
St Mirren,4390,7,10,10,16,42,56,-14,40
Raith,4390,8,10,10,16,36,50,-14,40
Dunfermline,4390,9,9,11,16,45,54,-9,38
Ayr,4390,10,9,11,16,35,56,-21,38
Hibernian,4391,1,19,13,4,54,23,31,70
Falkirk,4391,2,17,9,10,56,40,16,60
Dundee Utd,4391,3,17,9,10,51,36,15,60
Morton,4391,4,15,13,8,47,37,10,58
Queen of S't,4391,5,12,9,15,43,47,-4,45
Dumbarton,4391,6,11,10,15,51,60,-9,43
Dunfermline,4391,7,10,11,15,42,47,-5,41
Raith,4391,8,10,11,15,33,47,-14,41
Ayr,4391,9,9,11,16,39,57,-18,38
St Mirren,4391,10,7,10,19,42,64,-22,31
Falkirk,4392,1,19,10,7,64,36,28,67
Hibernian,4392,2,18,12,6,55,26,29,66
Morton,4392,3,17,10,9,54,43,11,61
Dundee Utd,4392,4,14,11,11,49,43,6,53
Dunfermline,4392,5,11,13,12,48,50,-2,46
Queen of S't,4392,6,12,10,14,49,54,-5,46
St Mirren,4392,7,9,11,16,41,54,-13,38
Ayr,4392,8,8,13,15,36,55,-19,37
Raith,4392,9,9,9,18,35,54,-19,36
Dumbarton,4392,10,8,11,17,45,61,-16,35
Hibernian,4393,1,19,12,5,58,27,31,69
Falkirk,4393,2,16,13,7,59,37,22,61
Morton,4393,3,15,13,8,49,38,11,58
Dundee Utd,4393,4,15,11,10,53,43,10,56
Raith,4393,5,12,9,15,38,46,-8,45
Dumbarton,4393,6,10,12,14,53,59,-6,42
Dunfermline,4393,7,8,15,13,46,52,-6,39
Queen of S't,4393,8,10,9,17,41,55,-14,39
St Mirren,4393,9,9,11,16,42,58,-16,38
Ayr,4393,10,7,13,16,34,58,-24,34
Hibernian,4394,1,17,13,6,49,24,25,64
Falkirk,4394,2,17,10,9,58,41,17,61
Morton,4394,3,16,13,7,47,36,11,61
Dundee Utd,4394,4,15,8,13,49,42,7,53
Raith,4394,5,12,9,15,36,44,-8,45
Dunfermline,4394,6,9,15,12,47,48,-1,42
Queen of S't,4394,7,10,11,15,44,53,-9,41
Ayr,4394,8,10,11,15,35,53,-18,41
Dumbarton,4394,9,9,13,14,50,57,-7,40
St Mirren,4394,10,7,13,16,37,54,-17,34
Hibernian,4395,1,20,13,3,61,29,32,73
Morton,4395,2,16,12,8,47,35,12,60
Dundee Utd,4395,3,16,11,9,58,39,19,59
Falkirk,4395,4,14,11,11,53,51,2,53
Dumbarton,4395,5,11,12,13,51,51,0,45
Raith,4395,6,11,10,15,37,47,-10,43
Queen of S't,4395,7,11,9,16,47,55,-8,42
Dunfermline,4395,8,9,14,13,46,47,-1,41
St Mirren,4395,9,9,9,18,43,60,-17,36
Ayr,4395,10,7,11,18,34,63,-29,32
Hibernian,4396,1,19,12,5,54,26,28,69
Morton,4396,2,18,10,8,50,35,15,64
Dundee Utd,4396,3,17,10,9,52,37,15,61
Falkirk,4396,4,15,10,11,59,40,19,55
Raith,4396,5,12,8,16,35,48,-13,44
Queen of S't,4396,6,10,12,14,41,48,-7,42
Dunfermline,4396,7,9,13,14,42,49,-7,40
Dumbarton,4396,8,9,12,15,49,61,-12,39
St Mirren,4396,9,9,10,17,41,56,-15,37
Ayr,4396,10,7,13,16,32,55,-23,34
Hibernian,4397,1,19,11,6,59,28,31,68
Morton,4397,2,19,10,7,58,36,22,67
Falkirk,4397,3,15,10,11,57,44,13,55
Dundee Utd,4397,4,14,10,12,48,43,5,52
Dumbarton,4397,5,11,11,14,51,55,-4,44
Queen of S't,4397,6,11,11,14,43,48,-5,44
Ayr,4397,7,10,12,14,35,56,-21,42
Dunfermline,4397,8,9,13,14,43,50,-7,40
Raith,4397,9,9,12,15,33,49,-16,39
St Mirren,4397,10,8,10,18,44,62,-18,34
Hibernian,4398,1,22,11,3,62,22,40,77
Morton,4398,2,18,10,8,51,34,17,64
Dundee Utd,4398,3,17,8,11,58,46,12,59
Falkirk,4398,4,15,10,11,60,51,9,55
Dunfermline,4398,5,11,11,14,49,49,0,44
Queen of S't,4398,6,12,8,16,45,51,-6,44
Raith,4398,7,11,9,16,36,51,-15,42
Dumbarton,4398,8,9,10,17,49,68,-19,37
St Mirren,4398,9,9,9,18,40,54,-14,36
Ayr,4398,10,8,10,18,35,59,-24,34
Hibernian,4399,1,20,12,4,59,22,37,72
Dundee Utd,4399,2,18,10,8,58,37,21,64
Falkirk,4399,3,17,10,9,59,41,18,61
Morton,4399,4,15,12,9,44,38,6,57
Dunfermline,4399,5,10,13,13,45,50,-5,43
Queen of S't,4399,6,10,10,16,41,49,-8,40
Raith,4399,7,9,12,15,31,45,-14,39
St Mirren,4399,8,9,11,16,43,55,-12,38
Dumbarton,4399,9,8,13,15,45,58,-13,37
Ayr,4399,10,6,13,17,30,60,-30,31
Hibernian,4400,1,20,12,4,54,24,30,72
Morton,4400,2,17,11,8,55,40,15,62
Dundee Utd,4400,3,17,10,9,51,35,16,61
Falkirk,4400,4,15,11,10,58,42,16,56
Queen of S't,4400,5,11,10,15,46,53,-7,43
Dumbarton,4400,6,10,10,16,49,62,-13,40
Raith,4400,7,10,10,16,37,51,-14,40
Dunfermline,4400,8,9,12,15,48,54,-6,39
Ayr,4400,9,9,12,15,35,55,-20,39
St Mirren,4400,10,8,10,18,41,58,-17,34
Hibernian,4401,1,19,12,5,53,25,28,69
Morton,4401,2,17,11,8,48,36,12,62
Dundee Utd,4401,3,16,10,10,50,38,12,58
Falkirk,4401,4,14,11,11,53,43,10,53
Dunfermline,4401,5,10,14,12,48,47,1,44
Queen of S't,4401,6,11,9,16,45,53,-8,42
Raith,4401,7,11,9,16,34,48,-14,42
Dumbarton,4401,8,10,11,15,56,61,-5,41
St Mirren,4401,9,10,9,17,42,53,-11,39
Ayr,4401,10,9,10,17,34,59,-25,37
Hibernian,4402,1,19,14,3,55,22,33,71
Morton,4402,2,18,12,6,49,33,16,66
Dundee Utd,4402,3,17,10,9,55,40,15,61
Falkirk,4402,4,16,10,10,59,42,17,58
Queen of S't,4402,5,10,11,15,43,58,-15,41
Raith,4402,6,10,10,16,40,57,-17,40
Dumbarton,4402,7,8,13,15,50,61,-11,37
Dunfermline,4402,8,8,12,16,41,48,-7,36
St Mirren,4402,9,7,14,15,40,53,-13,35
Ayr,4402,10,7,14,15,39,57,-18,35
Hibernian,4403,1,19,10,7,54,27,27,67
Morton,4403,2,18,11,7,52,36,16,65
Falkirk,4403,3,17,11,8,67,45,22,62
Dundee Utd,4403,4,13,14,9,48,41,7,53
Queen of S't,4403,5,13,9,14,49,50,-1,48
Dumbarton,4403,6,11,11,14,50,56,-6,44
Raith,4403,7,10,11,15,43,53,-10,41
Dunfermline,4403,8,7,14,15,44,56,-12,35
St Mirren,4403,9,8,11,17,36,55,-19,35
Ayr,4403,10,6,14,16,30,54,-24,32
Hibernian,4404,1,17,14,5,53,26,27,65
Falkirk,4404,2,16,11,9,61,44,17,59
Dundee Utd,4404,3,15,12,9,51,37,14,57
Morton,4404,4,14,12,10,45,40,5,54
Dunfermline,4404,5,11,14,11,50,44,6,47
Dumbarton,4404,6,11,12,13,51,55,-4,45
Queen of S't,4404,7,12,9,15,44,49,-5,45
Raith,4404,8,10,9,17,37,52,-15,39
St Mirren,4404,9,9,11,16,38,56,-18,38
Ayr,4404,10,7,12,17,31,58,-27,33
Hibernian,4405,1,21,10,5,57,27,30,73
Morton,4405,2,18,10,8,57,38,19,64
Falkirk,4405,3,16,9,11,60,47,13,57
Dundee Utd,4405,4,16,9,11,52,45,7,57
Queen of S't,4405,5,12,10,14,52,51,1,46
Dunfermline,4405,6,11,13,12,51,51,0,46
Raith,4405,7,11,9,16,40,54,-14,42
Dumbarton,4405,8,8,11,17,50,64,-14,35
Ayr,4405,9,8,11,17,36,59,-23,35
St Mirren,4405,10,8,10,18,41,60,-19,34
Hibernian,4406,1,20,12,4,58,26,32,72
Falkirk,4406,2,15,12,9,56,39,17,57
Morton,4406,3,15,12,9,50,41,9,57
Dundee Utd,4406,4,15,11,10,47,41,6,56
Queen of S't,4406,5,12,10,14,52,51,1,46
Dunfermline,4406,6,9,14,13,43,50,-7,41
Dumbarton,4406,7,9,13,14,47,52,-5,40
Raith,4406,8,10,10,16,38,53,-15,40
Ayr,4406,9,8,13,15,36,56,-20,37
St Mirren,4406,10,9,9,18,44,62,-18,36
Hibernian,4407,1,18,11,7,50,26,24,65
Morton,4407,2,16,12,8,51,35,16,60
Falkirk,4407,3,16,10,10,59,41,18,58
Dundee Utd,4407,4,16,9,11,53,44,9,57
Dunfermline,4407,5,10,14,12,45,49,-4,44
Raith,4407,6,12,8,16,37,49,-12,44
Queen of S't,4407,7,11,10,15,46,54,-8,43
St Mirren,4407,8,10,9,17,40,53,-13,39
Ayr,4407,9,9,12,15,36,53,-17,39
Dumbarton,4407,10,9,11,16,50,63,-13,38
Hibernian,4408,1,20,11,5,59,24,35,71
Falkirk,4408,2,18,9,9,62,42,20,63
Dundee Utd,4408,3,15,10,11,49,38,11,55
Morton,4408,4,14,12,10,45,42,3,54
Queen of S't,4408,5,14,10,12,49,46,3,52
Dunfermline,4408,6,11,12,13,48,48,0,45
Dumbarton,4408,7,10,10,16,46,58,-12,40
Raith,4408,8,10,9,17,37,53,-16,39
Ayr,4408,9,7,13,16,33,54,-21,34
St Mirren,4408,10,8,10,18,38,61,-23,34
Hibernian,4409,1,20,12,4,60,23,37,72
Falkirk,4409,2,16,10,10,58,40,18,58
Morton,4409,3,16,10,10,49,44,5,58
Dundee Utd,4409,4,16,9,11,52,42,10,57
Dunfermline,4409,5,12,12,12,50,48,2,48
Queen of S't,4409,6,11,10,15,43,51,-8,43
Raith,4409,7,11,9,16,39,53,-14,42
Dumbarton,4409,8,9,11,16,49,61,-12,38
Ayr,4409,9,9,11,16,35,53,-18,38
St Mirren,4409,10,8,10,18,41,61,-20,34
Hibernian,4410,1,20,13,3,58,26,32,73
Dundee Utd,4410,2,16,11,9,51,39,12,59
Falkirk,4410,3,15,12,9,59,45,14,57
Morton,4410,4,13,12,11,44,39,5,51
Queen of S't,4410,5,12,11,13,45,45,0,47
Raith,4410,6,12,9,15,40,49,-9,45
Dunfermline,4410,7,9,13,14,41,47,-6,40
Dumbarton,4410,8,9,12,15,47,59,-12,39
Ayr,4410,9,7,15,14,33,53,-20,36
St Mirren,4410,10,8,10,18,41,57,-16,34
Hibernian,4411,1,19,13,4,57,25,32,70
Morton,4411,2,18,12,6,48,31,17,66
Dundee Utd,4411,3,18,9,9,53,37,16,63
Falkirk,4411,4,16,12,8,60,40,20,60
Queen of S't,4411,5,11,10,15,43,49,-6,43
Ayr,4411,6,9,12,15,31,51,-20,39
Raith,4411,7,10,8,18,32,51,-19,38
Dunfermline,4411,8,8,13,15,44,52,-8,37
Dumbarton,4411,9,8,13,15,48,58,-10,37
St Mirren,4411,10,7,10,19,37,59,-22,31
Hibernian,4412,1,21,11,4,64,26,38,74
Dundee Utd,4412,2,19,9,8,57,38,19,66
Morton,4412,3,19,9,8,58,41,17,66
Falkirk,4412,4,15,11,10,59,46,13,56
Queen of S't,4412,5,12,9,15,46,53,-7,45
Dunfermline,4412,6,8,14,14,49,49,0,38
Raith,4412,7,9,11,16,34,56,-22,38
Dumbarton,4412,8,8,12,16,46,61,-15,36
Ayr,4412,9,7,13,16,35,59,-24,34
St Mirren,4412,10,8,9,19,44,63,-19,33
Hibernian,4413,1,20,12,4,58,23,35,72
Dundee Utd,4413,2,17,10,9,51,40,11,61
Falkirk,4413,3,16,10,10,66,48,18,58
Morton,4413,4,15,12,9,46,39,7,57
Dumbarton,4413,5,10,12,14,51,61,-10,42
Raith,4413,6,10,12,14,35,47,-12,42
Queen of S't,4413,7,10,11,15,48,54,-6,41
Dunfermline,4413,8,7,17,12,41,45,-4,38
Ayr,4413,9,8,14,14,35,54,-19,38
St Mirren,4413,10,6,12,18,36,56,-20,30
Hibernian,4414,1,18,12,6,50,26,24,66
Dundee Utd,4414,2,17,9,10,54,37,17,60
Falkirk,4414,3,16,11,9,57,39,18,59
Morton,4414,4,13,12,11,42,39,3,51
Queen of S't,4414,5,13,9,14,46,48,-2,48
Dunfermline,4414,6,10,12,14,46,52,-6,42
Dumbarton,4414,7,10,12,14,49,57,-8,42
Raith,4414,8,11,9,16,35,47,-12,42
St Mirren,4414,9,9,11,16,40,52,-12,38
Ayr,4414,10,9,11,16,34,56,-22,38
Hibernian,4415,1,19,11,6,57,25,32,68
Morton,4415,2,18,12,6,54,33,21,66
Dundee Utd,4415,3,17,9,10,49,38,11,60
Falkirk,4415,4,15,12,9,57,41,16,57
St Mirren,4415,5,11,10,15,46,56,-10,43
Queen of S't,4415,6,11,9,16,46,54,-8,42
Dunfermline,4415,7,8,15,13,43,53,-10,39
Raith,4415,8,8,13,15,34,50,-16,37
Dumbarton,4415,9,8,12,16,49,59,-10,36
Ayr,4415,10,8,11,17,33,59,-26,35
Hibernian,4416,1,19,13,4,54,23,31,70
Dundee Utd,4416,2,18,10,8,50,36,14,64
Morton,4416,3,17,10,9,53,37,16,61
Falkirk,4416,4,13,12,11,53,44,9,51
Dunfermline,4416,5,10,14,12,50,48,2,44
Queen of S't,4416,6,10,11,15,44,53,-9,41
St Mirren,4416,7,10,10,16,47,56,-9,40
Dumbarton,4416,8,9,12,15,47,60,-13,39
Raith,4416,9,10,8,18,31,52,-21,38
Ayr,4416,10,8,12,16,35,55,-20,36
Hibernian,4417,1,20,12,4,56,24,32,72
Morton,4417,2,15,14,7,47,33,14,59
Dundee Utd,4417,3,15,12,9,46,37,9,57
Falkirk,4417,4,14,11,11,57,44,13,53
Dunfermline,4417,5,11,12,13,47,44,3,45
Queen of S't,4417,6,11,9,16,44,51,-7,42
Dumbarton,4417,7,10,10,16,46,57,-11,40
St Mirren,4417,8,9,11,16,41,56,-15,38
Raith,4417,9,9,11,16,33,50,-17,38
Ayr,4417,10,8,14,14,34,55,-21,38
Hibernian,4418,1,18,13,5,53,26,27,67
Falkirk,4418,2,18,10,8,62,41,21,64
Morton,4418,3,17,13,6,53,33,20,64
Dundee Utd,4418,4,15,8,13,50,49,1,53
Queen of S't,4418,5,12,11,13,46,49,-3,47
Dunfermline,4418,6,10,13,13,48,49,-1,43
Raith,4418,7,11,9,16,39,52,-13,42
Dumbarton,4418,8,9,12,15,49,57,-8,39
Ayr,4418,9,9,10,17,34,56,-22,37
St Mirren,4418,10,7,9,20,40,62,-22,30
Hibernian,4419,1,19,12,5,54,28,26,69
Morton,4419,2,15,12,9,50,42,8,57
Falkirk,4419,3,15,11,10,54,42,12,56
Dundee Utd,4419,4,15,11,10,51,40,11,56
Queen of S't,4419,5,13,10,13,47,49,-2,49
Dunfermline,4419,6,9,15,12,45,45,0,42
St Mirren,4419,7,11,9,16,44,53,-9,42
Dumbarton,4419,8,9,12,15,49,59,-10,39
Raith,4419,9,9,10,17,35,52,-17,37
Ayr,4419,10,8,12,16,34,53,-19,36
Hibernian,4420,1,21,11,4,62,26,36,74
Falkirk,4420,2,17,10,9,57,40,17,61
Morton,4420,3,16,13,7,51,36,15,61
Dundee Utd,4420,4,17,8,11,53,42,11,59
Queen of S't,4420,5,14,8,14,49,50,-1,50
Dumbarton,4420,6,9,11,16,49,65,-16,38
Ayr,4420,7,9,11,16,36,55,-19,38
St Mirren,4420,8,9,10,17,44,58,-14,37
Dunfermline,4420,9,7,14,15,44,53,-9,35
Raith,4420,10,8,10,18,31,51,-20,34
Hibernian,4421,1,23,10,3,64,24,40,79
Falkirk,4421,2,14,13,9,53,39,14,55
Morton,4421,3,13,13,10,47,41,6,52
Dundee Utd,4421,4,13,12,11,51,41,10,51
Dunfermline,4421,5,9,16,11,47,50,-3,43
St Mirren,4421,6,10,11,15,43,49,-6,41
Raith,4421,7,10,11,15,34,44,-10,41
Queen of S't,4421,8,9,13,14,45,54,-9,40
Ayr,4421,9,10,10,16,31,59,-28,40
Dumbarton,4421,10,8,13,15,46,60,-14,37
Hibernian,4422,1,19,13,4,59,27,32,70
Falkirk,4422,2,17,11,8,63,36,27,62
Dundee Utd,4422,3,15,11,10,47,39,8,56
Morton,4422,4,14,13,9,44,39,5,55
Queen of S't,4422,5,13,9,14,49,50,-1,48
Raith,4422,6,10,10,16,35,50,-15,40
St Mirren,4422,7,9,12,15,43,52,-9,39
Dunfermline,4422,8,9,11,16,43,54,-11,38
Dumbarton,4422,9,9,11,16,52,68,-16,38
Ayr,4422,10,8,13,15,38,58,-20,37
Hibernian,4423,1,21,11,4,56,25,31,74
Morton,4423,2,16,13,7,52,37,15,61
Dundee Utd,4423,3,16,10,10,53,46,7,58
Falkirk,4423,4,16,9,11,57,44,13,57
Queen of S't,4423,5,13,9,14,52,46,6,48
Dunfermline,4423,6,11,13,12,50,47,3,46
Ayr,4423,7,8,12,16,37,62,-25,36
Dumbarton,4423,8,8,11,17,45,59,-14,35
St Mirren,4423,9,8,11,17,41,56,-15,35
Raith,4423,10,8,11,17,34,55,-21,35
Hibernian,4424,1,17,13,6,50,27,23,64
Morton,4424,2,16,11,9,50,37,13,59
Falkirk,4424,3,15,12,9,58,43,15,57
Dundee Utd,4424,4,15,9,12,47,39,8,54
Queen of S't,4424,5,12,10,14,47,50,-3,46
Dumbarton,4424,6,10,12,14,50,57,-7,42
Raith,4424,7,10,12,14,34,44,-10,42
St Mirren,4424,8,10,11,15,39,51,-12,41
Dunfermline,4424,9,8,15,13,43,48,-5,39
Ayr,4424,10,8,13,15,32,54,-22,37
Hibernian,4425,1,19,11,6,52,27,25,68
Morton,4425,2,19,10,7,60,38,22,67
Falkirk,4425,3,17,10,9,63,40,23,61
Dundee Utd,4425,4,15,10,11,50,42,8,55
Dumbarton,4425,5,12,10,14,60,59,1,46
Queen of S't,4425,6,12,9,15,48,57,-9,45
Raith,4425,7,11,10,15,36,47,-11,43
Dunfermline,4425,8,9,12,15,50,55,-5,39
St Mirren,4425,9,8,9,19,39,64,-25,33
Ayr,4425,10,7,11,18,30,59,-29,32
Hibernian,4426,1,21,12,3,56,23,33,75
Dundee Utd,4426,2,18,9,9,52,34,18,63
Falkirk,4426,3,14,13,9,57,43,14,55
Morton,4426,4,14,11,11,46,41,5,53
Queen of S't,4426,5,11,10,15,48,52,-4,43
Raith,4426,6,11,9,16,40,51,-11,42
Dumbarton,4426,7,10,11,15,49,59,-10,41
Dunfermline,4426,8,9,13,14,46,55,-9,40
St Mirren,4426,9,8,13,15,41,56,-15,37
Ayr,4426,10,8,11,17,36,57,-21,35
Hibernian,4427,1,19,12,5,53,27,26,69
Morton,4427,2,18,10,8,54,37,17,64
Dundee Utd,4427,3,18,8,10,58,40,18,62
Falkirk,4427,4,16,9,11,55,39,16,57
Dunfermline,4427,5,11,12,13,46,47,-1,45
Queen of S't,4427,6,12,9,15,45,49,-4,45
Dumbarton,4427,7,10,12,14,49,59,-10,42
Raith,4427,8,10,9,17,35,51,-16,39
Ayr,4427,9,8,10,18,36,65,-29,34
St Mirren,4427,10,8,9,19,44,61,-17,33
Hibernian,4428,1,20,11,5,62,26,36,71
Dundee Utd,4428,2,18,8,10,55,41,14,62
Falkirk,4428,3,16,11,9,55,37,18,59
Morton,4428,4,15,11,10,51,46,5,56
Dunfermline,4428,5,12,13,11,48,44,4,49
Queen of S't,4428,6,10,11,15,42,51,-9,41
Dumbarton,4428,7,9,13,14,46,54,-8,40
Raith,4428,8,10,9,17,36,52,-16,39
Ayr,4428,9,9,11,16,43,60,-17,38
St Mirren,4428,10,7,10,19,39,66,-27,31
Hibernian,4429,1,21,12,3,63,25,38,75
Falkirk,4429,2,17,11,8,60,40,20,62
Dundee Utd,4429,3,17,8,11,50,38,12,59
Morton,4429,4,16,10,10,50,40,10,58
Queen of S't,4429,5,12,10,14,45,46,-1,46
Dumbarton,4429,6,9,13,14,51,61,-10,40
Raith,4429,7,10,9,17,37,48,-11,39
Dunfermline,4429,8,8,14,14,43,52,-9,38
Ayr,4429,9,8,11,17,37,61,-24,35
St Mirren,4429,10,8,10,18,40,65,-25,34
Hibernian,4430,1,21,11,4,60,24,36,74
Dundee Utd,4430,2,18,9,9,56,39,17,63
Morton,4430,3,16,12,8,49,34,15,60
Falkirk,4430,4,16,9,11,58,45,13,57
Queen of S't,4430,5,13,9,14,48,53,-5,48
Dunfermline,4430,6,11,11,14,49,51,-2,44
Dumbarton,4430,7,10,10,16,47,59,-12,40
St Mirren,4430,8,8,10,18,37,54,-17,34
Raith,4430,9,8,10,18,30,50,-20,34
Ayr,4430,10,7,13,16,32,57,-25,34
Hibernian,4431,1,16,15,5,49,25,24,63
Morton,4431,2,16,14,6,49,33,16,62
Dundee Utd,4431,3,15,12,9,54,42,12,57
Falkirk,4431,4,15,10,11,62,45,17,55
Dunfermline,4431,5,11,15,10,49,44,5,48
Queen of S't,4431,6,12,10,14,47,50,-3,46
Raith,4431,7,12,8,16,34,46,-12,44
St Mirren,4431,8,10,10,16,41,54,-13,40
Dumbarton,4431,9,8,12,16,46,64,-18,36
Ayr,4431,10,6,12,18,34,62,-28,30
Hibernian,4432,1,18,12,6,55,27,28,66
Morton,4432,2,17,11,8,48,36,12,62
Dundee Utd,4432,3,17,9,10,52,39,13,60
Falkirk,4432,4,16,11,9,56,39,17,59
Raith,4432,5,11,11,14,36,46,-10,44
Dunfermline,4432,6,9,12,15,46,53,-7,39
St Mirren,4432,7,9,12,15,42,51,-9,39
Ayr,4432,8,9,12,15,34,56,-22,39
Dumbarton,4432,9,9,11,16,47,58,-11,38
Queen of S't,4432,10,9,11,16,42,53,-11,38
Hibernian,4433,1,20,11,5,57,26,31,71
Falkirk,4433,2,17,10,9,55,38,17,61
Morton,4433,3,16,11,9,52,38,14,59
Dundee Utd,4433,4,14,11,11,53,43,10,53
Dunfermline,4433,5,11,14,11,46,42,4,47
Queen of S't,4433,6,13,8,15,45,50,-5,47
Ayr,4433,7,12,10,14,39,54,-15,46
Raith,4433,8,10,8,18,40,59,-19,38
Dumbarton,4433,9,8,11,17,43,57,-14,35
St Mirren,4433,10,7,10,19,38,61,-23,31
Hibernian,4434,1,20,13,3,63,24,39,73
Morton,4434,2,17,11,8,51,40,11,62
Falkirk,4434,3,16,12,8,58,37,21,60
Dundee Utd,4434,4,15,10,11,51,41,10,55
Dunfermline,4434,5,10,13,13,47,46,1,43
Dumbarton,4434,6,10,12,14,48,57,-9,42
Queen of S't,4434,7,11,8,17,44,60,-16,41
Raith,4434,8,10,10,16,37,47,-10,40
St Mirren,4434,9,8,11,17,41,58,-17,35
Ayr,4434,10,7,12,17,31,61,-30,33
Morton,4435,1,19,11,6,61,35,26,68
Hibernian,4435,2,18,12,6,53,26,27,66
Dundee Utd,4435,3,17,9,10,55,42,13,60
Falkirk,4435,4,15,10,11,57,43,14,55
Queen of S't,4435,5,13,8,15,42,45,-3,47
St Mirren,4435,6,10,11,15,46,56,-10,41
Raith,4435,7,10,11,15,34,47,-13,41
Dunfermline,4435,8,8,13,15,41,52,-11,37
Ayr,4435,9,8,12,16,30,54,-24,36
Dumbarton,4435,10,8,11,17,41,60,-19,35
Hibernian,4436,1,20,12,4,56,25,31,72
Morton,4436,2,16,13,7,48,35,13,61
Falkirk,4436,3,17,9,10,60,39,21,60
Dundee Utd,4436,4,17,9,10,50,37,13,60
Queen of S't,4436,5,12,10,14,42,49,-7,46
Dunfermline,4436,6,10,12,14,44,47,-3,42
Ayr,4436,7,10,11,15,35,51,-16,41
Raith,4436,8,9,10,17,34,51,-17,37
St Mirren,4436,9,9,9,18,38,54,-16,36
Dumbarton,4436,10,7,11,18,40,59,-19,32
Morton,4437,1,20,9,7,55,33,22,69
Hibernian,4437,2,18,11,7,54,28,26,65
Falkirk,4437,3,17,10,9,60,43,17,61
Dundee Utd,4437,4,17,8,11,54,39,15,59
Queen of S't,4437,5,13,9,14,47,49,-2,48
Raith,4437,6,11,9,16,37,50,-13,42
Dunfermline,4437,7,9,12,15,43,53,-10,39
Ayr,4437,8,9,10,17,33,55,-22,37
Dumbarton,4437,9,8,11,17,44,58,-14,35
St Mirren,4437,10,8,11,17,37,56,-19,35
Hibernian,4438,1,21,11,4,58,23,35,74
Falkirk,4438,2,17,10,9,60,41,19,61
Dundee Utd,4438,3,16,10,10,48,38,10,58
Morton,4438,4,15,12,9,51,41,10,57
Queen of S't,4438,5,11,10,15,44,57,-13,43
Ayr,4438,6,10,12,14,37,51,-14,42
Dumbarton,4438,7,9,12,15,45,57,-12,39
Raith,4438,8,10,9,17,35,51,-16,39
Dunfermline,4438,9,8,13,15,41,47,-6,37
St Mirren,4438,10,8,11,17,42,55,-13,35
Hibernian,4439,1,20,11,5,61,26,35,71
Morton,4439,2,18,12,6,53,36,17,66
Falkirk,4439,3,16,10,10,58,41,17,58
Dundee Utd,4439,4,16,9,11,53,38,15,57
Queen of S't,4439,5,12,8,16,46,53,-7,44
Dunfermline,4439,6,10,13,13,41,44,-3,43
St Mirren,4439,7,10,10,16,44,56,-12,40
Raith,4439,8,10,9,17,34,54,-20,39
Dumbarton,4439,9,9,11,16,46,61,-15,38
Ayr,4439,10,7,11,18,34,61,-27,32
Dundee Utd,4440,1,19,9,8,57,36,21,66
Hibernian,4440,2,18,11,7,54,27,27,65
Morton,4440,3,16,12,8,51,38,13,60
Falkirk,4440,4,16,10,10,57,42,15,58
Dunfermline,4440,5,11,12,13,49,52,-3,45
Raith,4440,6,12,9,15,36,46,-10,45
Ayr,4440,7,10,12,14,40,57,-17,42
Queen of S't,4440,8,10,9,17,41,52,-11,39
Dumbarton,4440,9,8,13,15,50,60,-10,37
St Mirren,4440,10,7,9,20,34,59,-25,30
Hibernian,4441,1,21,12,3,58,25,33,75
Morton,4441,2,19,11,6,55,34,21,68
Falkirk,4441,3,16,11,9,57,42,15,59
Dundee Utd,4441,4,14,9,13,47,48,-1,51
Dunfermline,4441,5,10,12,14,46,50,-4,42
Raith,4441,6,11,9,16,38,48,-10,42
Queen of S't,4441,7,10,11,15,43,49,-6,41
Dumbarton,4441,8,9,14,13,49,57,-8,41
St Mirren,4441,9,9,10,17,42,54,-12,37
Ayr,4441,10,6,11,19,30,58,-28,29
Hibernian,4442,1,18,13,5,53,26,27,67
Dundee Utd,4442,2,17,8,11,51,39,12,59
Morton,4442,3,15,13,8,47,36,11,58
Falkirk,4442,4,15,11,10,56,43,13,56
Queen of S't,4442,5,14,10,12,50,47,3,52
Dunfermline,4442,6,10,14,12,45,44,1,44
Raith,4442,7,10,10,16,35,50,-15,40
Ayr,4442,8,9,12,15,32,53,-21,39
Dumbarton,4442,9,8,11,17,44,60,-16,35
St Mirren,4442,10,8,10,18,40,55,-15,34
Hibernian,4443,1,20,13,3,59,23,36,73
Falkirk,4443,2,16,11,9,58,43,15,59
Dundee Utd,4443,3,16,11,9,51,39,12,59
Morton,4443,4,15,12,9,48,40,8,57
Dunfermline,4443,5,10,14,12,44,46,-2,44
Queen of S't,4443,6,11,9,16,45,53,-8,42
Raith,4443,7,10,10,16,36,50,-14,40
St Mirren,4443,8,9,12,15,42,52,-10,39
Dumbarton,4443,9,8,11,17,46,59,-13,35
Ayr,4443,10,7,13,16,34,58,-24,34
Hibernian,4444,1,21,10,5,57,25,32,73
Morton,4444,2,17,11,8,49,34,15,62
Dundee Utd,4444,3,16,9,11,52,42,10,57
Falkirk,4444,4,15,10,11,54,41,13,55
Queen of S't,4444,5,11,11,14,44,49,-5,44
Dunfermline,4444,6,10,12,14,46,51,-5,42
Raith,4444,7,11,9,16,36,48,-12,42
Dumbarton,4444,8,9,13,14,48,56,-8,40
St Mirren,4444,9,9,10,17,37,53,-16,37
Ayr,4444,10,8,11,17,30,54,-24,35
Hibernian,4445,1,22,11,3,57,24,33,77
Falkirk,4445,2,15,12,9,56,39,17,57
Morton,4445,3,13,15,8,46,39,7,54
Dundee Utd,4445,4,13,13,10,48,39,9,52
Dumbarton,4445,5,11,11,14,48,55,-7,44
Queen of S't,4445,6,11,10,15,48,50,-2,43
Ayr,4445,7,9,15,12,38,51,-13,42
Dunfermline,4445,8,9,13,14,47,54,-7,40
Raith,4445,9,9,10,17,31,51,-20,37
St Mirren,4445,10,6,14,16,37,54,-17,32
Hibernian,4446,1,20,10,6,58,26,32,70
Falkirk,4446,2,19,10,7,58,35,23,67
Morton,4446,3,17,13,6,50,35,15,64
Dundee Utd,4446,4,14,10,12,46,42,4,52
Queen of S't,4446,5,11,9,16,43,50,-7,42
Dumbarton,4446,6,9,13,14,48,56,-8,40
Raith,4446,7,9,12,15,32,48,-16,39
Ayr,4446,8,8,14,14,34,51,-17,38
Dunfermline,4446,9,8,12,16,45,54,-9,36
St Mirren,4446,10,8,11,17,37,54,-17,35
Hibernian,4447,1,20,11,5,55,25,30,71
Falkirk,4447,2,16,12,8,57,42,15,60
Morton,4447,3,16,11,9,53,38,15,59
Dundee Utd,4447,4,15,11,10,50,44,6,56
Dunfermline,4447,5,11,12,13,48,47,1,45
Queen of S't,4447,6,11,12,13,44,47,-3,45
Ayr,4447,7,9,12,15,39,57,-18,39
Dumbarton,4447,8,8,14,14,48,55,-7,38
Raith,4447,9,9,11,16,33,48,-15,38
St Mirren,4447,10,7,10,19,37,61,-24,31
Hibernian,4448,1,18,11,7,57,34,23,65
Morton,4448,2,17,11,8,52,36,16,62
Falkirk,4448,3,17,10,9,60,41,19,61
Dundee Utd,4448,4,17,10,9,56,42,14,61
Dumbarton,4448,5,10,12,14,51,57,-6,42
Queen of S't,4448,6,11,9,16,51,58,-7,42
Raith,4448,7,10,10,16,35,50,-15,40
Ayr,4448,8,9,12,15,35,55,-20,39
Dunfermline,4448,9,8,14,14,46,54,-8,38
St Mirren,4448,10,8,11,17,43,59,-16,35
Hibernian,4449,1,21,10,5,56,25,31,73
Dundee Utd,4449,2,18,10,8,62,40,22,64
Morton,4449,3,17,9,10,51,38,13,60
Falkirk,4449,4,14,10,12,57,48,9,52
Dunfermline,4449,5,13,12,11,55,48,7,51
Queen of S't,4449,6,12,9,15,47,53,-6,45
Dumbarton,4449,7,9,11,16,53,67,-14,38
Raith,4449,8,10,8,18,34,50,-16,38
St Mirren,4449,9,8,12,16,39,56,-17,36
Ayr,4449,10,7,11,18,31,60,-29,32
Falkirk,4450,1,19,10,7,66,40,26,67
Hibernian,4450,2,16,15,5,53,28,25,63
Morton,4450,3,16,13,7,50,33,17,61
Dundee Utd,4450,4,17,8,11,52,38,14,59
Queen of S't,4450,5,12,10,14,44,50,-6,46
Dunfermline,4450,6,10,12,14,47,58,-11,42
Ayr,4450,7,9,12,15,35,52,-17,39
Dumbarton,4450,8,9,10,17,49,64,-15,37
Raith,4450,9,9,10,17,38,54,-16,37
St Mirren,4450,10,8,10,18,44,61,-17,34
Hibernian,4451,1,18,14,4,54,23,31,68
Dundee Utd,4451,2,18,9,9,56,39,17,63
Falkirk,4451,3,17,10,9,61,37,24,61
Morton,4451,4,17,9,10,46,40,6,60
Raith,4451,5,12,8,16,36,48,-12,44
Dunfermline,4451,6,9,14,13,43,46,-3,41
Queen of S't,4451,7,10,10,16,40,49,-9,40
Ayr,4451,8,8,13,15,34,55,-21,37
St Mirren,4451,9,8,12,16,38,54,-16,36
Dumbarton,4451,10,8,11,17,43,60,-17,35
Hibernian,4452,1,18,13,5,59,30,29,67
Morton,4452,2,16,13,7,52,37,15,61
Falkirk,4452,3,16,11,9,60,43,17,59
Dundee Utd,4452,4,16,10,10,59,44,15,58
Queen of S't,4452,5,12,10,14,47,49,-2,46
Dunfermline,4452,6,10,12,14,42,50,-8,42
Dumbarton,4452,7,9,13,14,53,65,-12,40
Raith,4452,8,9,11,16,36,52,-16,38
Ayr,4452,9,8,13,15,32,55,-23,37
St Mirren,4452,10,8,10,18,44,59,-15,34
Hibernian,4453,1,19,12,5,59,30,29,69
Morton,4453,2,16,13,7,52,39,13,61
Falkirk,4453,3,14,12,10,56,41,15,54
Dundee Utd,4453,4,13,13,10,46,40,6,52
Queen of S't,4453,5,12,10,14,46,48,-2,46
Raith,4453,6,11,12,13,37,44,-7,45
Dunfermline,4453,7,9,14,13,45,48,-3,41
Dumbarton,4453,8,10,10,16,46,63,-17,40
St Mirren,4453,9,9,10,17,41,55,-14,37
Ayr,4453,10,8,12,16,37,57,-20,36
Hibernian,4454,1,19,13,4,55,25,30,70
Morton,4454,2,18,11,7,51,33,18,65
Falkirk,4454,3,16,9,11,60,45,15,57
Dundee Utd,4454,4,14,12,10,48,40,8,54
Dumbarton,4454,5,12,12,12,55,51,4,48
Queen of S't,4454,6,11,9,16,38,52,-14,42
Dunfermline,4454,7,9,13,14,45,50,-5,40
Raith,4454,8,9,11,16,37,50,-13,38
St Mirren,4454,9,9,10,17,37,58,-21,37
Ayr,4454,10,6,14,16,29,51,-22,32
Hibernian,4455,1,18,13,5,52,23,29,67
Morton,4455,2,16,13,7,50,36,14,61
Falkirk,4455,3,17,9,10,58,46,12,60
Dundee Utd,4455,4,15,8,13,53,46,7,53
Dunfermline,4455,5,10,15,11,48,49,-1,45
Queen of S't,4455,6,12,8,16,45,51,-6,44
Dumbarton,4455,7,10,12,14,53,57,-4,42
Ayr,4455,8,10,12,14,40,56,-16,42
Raith,4455,9,9,10,17,37,54,-17,37
St Mirren,4455,10,8,10,18,42,60,-18,34
Hibernian,4456,1,19,13,4,56,27,29,70
Morton,4456,2,17,12,7,51,33,18,63
Falkirk,4456,3,15,10,11,55,42,13,55
Dundee Utd,4456,4,15,10,11,50,43,7,55
Dumbarton,4456,5,11,11,14,50,57,-7,44
Raith,4456,6,11,9,16,32,47,-15,42
Dunfermline,4456,7,10,11,15,49,53,-4,41
St Mirren,4456,8,10,10,16,41,52,-11,40
Queen of S't,4456,9,10,9,17,41,52,-11,39
Ayr,4456,10,8,13,15,33,52,-19,37
Hibernian,4457,1,21,11,4,61,25,36,74
Dundee Utd,4457,2,18,9,9,53,37,16,63
Falkirk,4457,3,17,10,9,62,44,18,61
Morton,4457,4,17,9,10,51,40,11,60
Queen of S't,4457,5,13,9,14,46,50,-4,48
Dunfermline,4457,6,9,15,12,49,52,-3,42
Raith,4457,7,9,9,18,38,60,-22,36
Dumbarton,4457,8,8,11,17,50,65,-15,35
Ayr,4457,9,8,11,17,33,57,-24,35
St Mirren,4457,10,8,10,18,43,56,-13,34
Hibernian,4458,1,20,10,6,62,25,37,70
Dundee Utd,4458,2,18,8,10,53,44,9,62
Morton,4458,3,17,10,9,54,38,16,61
Falkirk,4458,4,16,11,9,59,41,18,59
Queen of S't,4458,5,11,9,16,46,56,-10,42
Dunfermline,4458,6,10,11,15,47,51,-4,41
Dumbarton,4458,7,9,12,15,49,58,-9,39
Ayr,4458,8,9,12,15,34,53,-19,39
Raith,4458,9,9,11,16,34,55,-21,38
St Mirren,4458,10,8,12,16,37,54,-17,36
Hibernian,4459,1,19,13,4,53,27,26,70
Falkirk,4459,2,16,12,8,61,37,24,60
Morton,4459,3,16,12,8,49,38,11,60
Dundee Utd,4459,4,17,8,11,52,42,10,59
Queen of S't,4459,5,11,10,15,45,50,-5,43
Raith,4459,6,10,11,15,35,51,-16,41
Dunfermline,4459,7,9,13,14,46,49,-3,40
St Mirren,4459,8,10,10,16,44,59,-15,40
Dumbarton,4459,9,8,12,16,45,56,-11,36
Ayr,4459,10,8,11,17,35,56,-21,35
Hibernian,4460,1,18,14,4,54,25,29,68
Morton,4460,2,16,12,8,49,36,13,60
Falkirk,4460,3,15,12,9,57,42,15,57
Dundee Utd,4460,4,15,11,10,51,42,9,56
Dunfermline,4460,5,11,14,11,51,44,7,47
Raith,4460,6,11,10,15,36,50,-14,43
Dumbarton,4460,7,10,11,15,46,56,-10,41
Queen of S't,4460,8,10,10,16,45,53,-8,40
Ayr,4460,9,8,14,14,34,53,-19,38
St Mirren,4460,10,7,10,19,37,59,-22,31
Hibernian,4461,1,18,13,5,54,26,28,67
Dundee Utd,4461,2,18,10,8,56,36,20,64
Morton,4461,3,17,9,10,46,42,4,60
Falkirk,4461,4,16,11,9,62,42,20,59
Queen of S't,4461,5,12,10,14,44,45,-1,46
Dunfermline,4461,6,11,12,13,48,47,1,45
St Mirren,4461,7,9,11,16,39,53,-14,38
Raith,4461,8,9,11,16,36,50,-14,38
Dumbarton,4461,9,8,11,17,46,65,-19,35
Ayr,4461,10,7,12,17,34,59,-25,33
Hibernian,4462,1,18,12,6,57,31,26,66
Dundee Utd,4462,2,16,11,9,51,39,12,59
Morton,4462,3,16,11,9,49,40,9,59
Falkirk,4462,4,14,14,8,59,40,19,56
Dunfermline,4462,5,11,12,13,46,46,0,45
Ayr,4462,6,10,12,14,37,53,-16,42
Raith,4462,7,10,11,15,40,53,-13,41
Dumbarton,4462,8,9,13,14,51,59,-8,40
Queen of S't,4462,9,10,10,16,47,57,-10,40
St Mirren,4462,10,8,10,18,41,60,-19,34
Morton,4463,1,19,12,5,59,31,28,69
Hibernian,4463,2,17,13,6,47,27,20,64
Dundee Utd,4463,3,17,8,11,54,39,15,59
Falkirk,4463,4,15,11,10,58,43,15,56
Queen of S't,4463,5,12,9,15,48,50,-2,45
St Mirren,4463,6,11,10,15,43,52,-9,43
Dumbarton,4463,7,10,10,16,51,62,-11,40
Raith,4463,8,9,11,16,36,51,-15,38
Dunfermline,4463,9,8,13,15,45,57,-12,37
Ayr,4463,10,7,13,16,28,57,-29,34
Hibernian,4464,1,19,12,5,56,26,30,69
Morton,4464,2,17,10,9,48,41,7,61
Falkirk,4464,3,16,11,9,65,45,20,59
Dundee Utd,4464,4,16,10,10,51,41,10,58
Queen of S't,4464,5,13,9,14,49,49,0,48
St Mirren,4464,6,11,9,16,43,54,-11,42
Raith,4464,7,11,9,16,36,53,-17,42
Dumbarton,4464,8,9,11,16,47,55,-8,38
Dunfermline,4464,9,7,14,15,42,52,-10,35
Ayr,4464,10,7,13,16,34,55,-21,34
Hibernian,4465,1,19,12,5,53,28,25,69
Dundee Utd,4465,2,17,10,9,56,38,18,61
Morton,4465,3,16,12,8,47,38,9,60
Falkirk,4465,4,16,10,10,63,42,21,58
Dunfermline,4465,5,11,14,11,51,47,4,47
Queen of S't,4465,6,12,10,14,46,47,-1,46
Raith,4465,7,10,10,16,36,51,-15,40
Dumbarton,4465,8,8,12,16,48,63,-15,36
Ayr,4465,9,7,13,16,32,56,-24,34
St Mirren,4465,10,8,9,19,35,57,-22,33
Hibernian,4466,1,20,10,6,61,29,32,70
Falkirk,4466,2,17,12,7,61,39,22,63
Morton,4466,3,17,12,7,49,37,12,63
Dundee Utd,4466,4,16,10,10,49,39,10,58
Dunfermline,4466,5,11,12,13,49,47,2,45
Dumbarton,4466,6,9,12,15,47,54,-7,39
Ayr,4466,7,9,12,15,37,58,-21,39
Raith,4466,8,9,10,17,35,52,-17,37
Queen of S't,4466,9,9,9,18,41,57,-16,36
St Mirren,4466,10,8,11,17,39,56,-17,35
Hibernian,4467,1,19,13,4,58,27,31,70
Falkirk,4467,2,18,11,7,59,37,22,65
Morton,4467,3,16,11,9,50,36,14,59
Dundee Utd,4467,4,14,11,11,47,43,4,53
Queen of S't,4467,5,12,9,15,49,54,-5,45
Dunfermline,4467,6,10,13,13,49,53,-4,43
Raith,4467,7,10,9,17,36,50,-14,39
Ayr,4467,8,9,12,15,36,56,-20,39
St Mirren,4467,9,9,10,17,40,54,-14,37
Dumbarton,4467,10,7,13,16,46,60,-14,34
Hibernian,4468,1,21,12,3,57,22,35,75
Morton,4468,2,15,11,10,45,37,8,56
Dundee Utd,4468,3,14,13,9,45,38,7,55
Falkirk,4468,4,14,12,10,58,46,12,54
Queen of S't,4468,5,11,12,13,48,50,-2,45
Ayr,4468,6,9,14,13,34,49,-15,41
Dunfermline,4468,7,9,13,14,48,50,-2,40
Dumbarton,4468,8,9,13,14,46,56,-10,40
Raith,4468,9,10,10,16,34,50,-16,40
St Mirren,4468,10,7,12,17,39,56,-17,33
Hibernian,4469,1,21,10,5,62,25,37,73
Morton,4469,2,16,11,9,48,37,11,59
Dundee Utd,4469,3,15,11,10,46,38,8,56
Falkirk,4469,4,15,10,11,58,43,15,55
Queen of S't,4469,5,13,8,15,48,47,1,47
Dumbarton,4469,6,10,12,14,52,55,-3,42
Dunfermline,4469,7,10,12,14,45,49,-4,42
Raith,4469,8,11,8,17,37,55,-18,41
St Mirren,4469,9,10,9,17,37,54,-17,39
Ayr,4469,10,7,13,16,30,60,-30,34
Hibernian,4470,1,21,12,3,59,24,35,75
Dundee Utd,4470,2,17,11,8,58,42,16,62
Falkirk,4470,3,15,12,9,59,42,17,57
Morton,4470,4,14,13,9,45,37,8,55
Queen of S't,4470,5,12,10,14,46,51,-5,46
Raith,4470,6,10,11,15,34,46,-12,41
Dunfermline,4470,7,9,13,14,47,51,-4,40
St Mirren,4470,8,9,11,16,41,56,-15,38
Dumbarton,4470,9,9,10,17,45,58,-13,37
Ayr,4470,10,7,11,18,32,59,-27,32
Hibernian,4471,1,20,13,3,63,28,35,73
Morton,4471,2,16,13,7,54,36,18,61
Falkirk,4471,3,15,10,11,60,44,16,55
Dundee Utd,4471,4,15,9,12,53,45,8,54
Dunfermline,4471,5,11,14,11,53,49,4,47
Raith,4471,6,11,9,16,37,51,-14,42
Ayr,4471,7,10,12,14,34,53,-19,42
St Mirren,4471,8,9,11,16,42,54,-12,38
Dumbarton,4471,9,9,11,16,43,58,-15,38
Queen of S't,4471,10,9,8,19,42,63,-21,35
Hibernian,4472,1,17,12,7,54,31,23,63
Dundee Utd,4472,2,17,9,10,52,35,17,60
Morton,4472,3,16,12,8,46,32,14,60
Falkirk,4472,4,16,11,9,58,38,20,59
Dumbarton,4472,5,11,11,14,49,54,-5,44
Queen of S't,4472,6,12,8,16,42,55,-13,44
Ayr,4472,7,10,11,15,38,55,-17,41
St Mirren,4472,8,10,10,16,43,57,-14,40
Raith,4472,9,10,9,17,33,48,-15,39
Dunfermline,4472,10,7,15,14,38,48,-10,36
Hibernian,4473,1,20,13,3,61,27,34,73
Falkirk,4473,2,18,10,8,63,39,24,64
Dundee Utd,4473,3,17,10,9,50,34,16,61
Morton,4473,4,15,12,9,46,37,9,57
Queen of S't,4473,5,12,8,16,46,51,-5,44
Raith,4473,6,10,10,16,34,50,-16,40
Dunfermline,4473,7,9,12,15,44,53,-9,39
Dumbarton,4473,8,9,11,16,46,60,-14,38
Ayr,4473,9,8,13,15,32,53,-21,37
St Mirren,4473,10,7,11,18,36,54,-18,32
Hibernian,4474,1,20,12,4,58,25,33,72
Morton,4474,2,18,11,7,50,33,17,65
Falkirk,4474,3,18,10,8,62,39,23,64
Dundee Utd,4474,4,15,11,10,50,37,13,56
Raith,4474,5,11,10,15,38,50,-12,43
Ayr,4474,6,10,12,14,34,50,-16,42
Dunfermline,4474,7,9,14,13,48,54,-6,41
Queen of S't,4474,8,10,9,17,43,55,-12,39
Dumbarton,4474,9,8,11,17,44,57,-13,35
St Mirren,4474,10,6,10,20,35,62,-27,28
Hibernian,4475,1,20,13,3,59,21,38,73
Morton,4475,2,19,11,6,56,33,23,68
Falkirk,4475,3,16,11,9,57,41,16,59
Dundee Utd,4475,4,14,13,9,54,39,15,55
Queen of S't,4475,5,13,11,12,51,45,6,50
Dunfermline,4475,6,7,15,14,45,53,-8,36
Dumbarton,4475,7,8,12,16,44,62,-18,36
Ayr,4475,8,8,12,16,40,71,-31,36
Raith,4475,9,9,8,19,36,61,-25,35
St Mirren,4475,10,8,10,18,44,60,-16,34
Morton,4476,1,19,11,6,60,35,25,68
Hibernian,4476,2,18,13,5,58,28,30,67
Falkirk,4476,3,16,11,9,60,43,17,59
Dundee Utd,4476,4,15,8,13,48,42,6,53
Raith,4476,5,12,9,15,39,49,-10,45
Queen of S't,4476,6,11,10,15,45,50,-5,43
Dunfermline,4476,7,9,13,14,43,50,-7,40
Dumbarton,4476,8,9,13,14,50,61,-11,40
Ayr,4476,9,10,10,16,40,60,-20,40
St Mirren,4476,10,7,10,19,39,64,-25,31
Hibernian,4477,1,20,11,5,56,26,30,71
Falkirk,4477,2,19,10,7,65,39,26,67
Morton,4477,3,17,12,7,51,31,20,63
Dundee Utd,4477,4,15,12,9,55,43,12,57
Raith,4477,5,12,9,15,37,43,-6,45
Dunfermline,4477,6,8,14,14,42,50,-8,38
Dumbarton,4477,7,9,11,16,48,59,-11,38
Queen of S't,4477,8,9,10,17,38,59,-21,37
St Mirren,4477,9,8,10,18,38,57,-19,34
Ayr,4477,10,7,13,16,35,58,-23,34
Hibernian,4478,1,19,12,5,59,25,34,69
Dundee Utd,4478,2,17,10,9,55,40,15,61
Morton,4478,3,17,10,9,49,38,11,61
Falkirk,4478,4,16,10,10,59,40,19,58
Dunfermline,4478,5,12,11,13,50,50,0,47
Ayr,4478,6,10,11,15,34,53,-19,41
Dumbarton,4478,7,9,12,15,46,59,-13,39
Raith,4478,8,10,9,17,36,50,-14,39
Queen of S't,4478,9,10,9,17,42,58,-16,39
St Mirren,4478,10,8,10,18,42,59,-17,34
Hibernian,4479,1,18,13,5,55,29,26,67
Falkirk,4479,2,17,10,9,58,43,15,61
Morton,4479,3,16,11,9,49,37,12,59
Dundee Utd,4479,4,16,10,10,51,40,11,58
Dunfermline,4479,5,10,14,12,53,51,2,44
Dumbarton,4479,6,10,13,13,56,58,-2,43
St Mirren,4479,7,10,11,15,41,52,-11,41
Raith,4479,8,10,10,16,33,46,-13,40
Queen of S't,4479,9,9,8,19,44,60,-16,35
Ayr,4479,10,7,14,15,33,57,-24,35
Hibernian,4480,1,21,10,5,57,23,34,73
Morton,4480,2,17,11,8,53,38,15,62
Falkirk,4480,3,16,11,9,59,41,18,59
Dundee Utd,4480,4,16,11,9,50,38,12,59
Dunfermline,4480,5,10,14,12,44,44,0,44
Raith,4480,6,11,9,16,37,46,-9,42
Dumbarton,4480,7,8,14,14,47,58,-11,38
Queen of S't,4480,8,9,11,16,39,52,-13,38
Ayr,4480,9,8,12,16,30,55,-25,36
St Mirren,4480,10,7,11,18,37,58,-21,32
Hibernian,4481,1,20,12,4,58,24,34,72
Morton,4481,2,17,11,8,49,37,12,62
Dundee Utd,4481,3,16,10,10,55,44,11,58
Falkirk,4481,4,14,11,11,53,42,11,53
Raith,4481,5,11,12,13,40,46,-6,45
Dumbarton,4481,6,11,11,14,56,68,-12,44
Dunfermline,4481,7,10,11,15,44,51,-7,41
St Mirren,4481,8,9,10,17,45,55,-10,37
Queen of S't,4481,9,9,10,17,45,57,-12,37
Ayr,4481,10,8,12,16,34,55,-21,36
Hibernian,4482,1,19,14,3,57,25,32,71
Morton,4482,2,18,10,8,54,36,18,64
Falkirk,4482,3,17,12,7,58,35,23,63
Dundee Utd,4482,4,15,10,11,46,43,3,55
Queen of S't,4482,5,10,12,14,42,48,-6,42
Raith,4482,6,9,13,14,39,53,-14,40
Dunfermline,4482,7,8,13,15,48,53,-5,37
Dumbarton,4482,8,8,12,16,46,62,-16,36
Ayr,4482,9,7,15,14,34,56,-22,36
St Mirren,4482,10,8,11,17,44,57,-13,35
Hibernian,4483,1,18,14,4,56,26,30,68
Morton,4483,2,18,13,5,53,36,17,67
Falkirk,4483,3,16,10,10,55,42,13,58
Dundee Utd,4483,4,15,9,12,50,43,7,54
Queen of S't,4483,5,12,9,15,48,50,-2,45
Dunfermline,4483,6,9,14,13,51,54,-3,41
St Mirren,4483,7,10,11,15,43,52,-9,41
Raith,4483,8,10,9,17,35,50,-15,39
Dumbarton,4483,9,8,13,15,46,60,-14,37
Ayr,4483,10,6,14,16,30,54,-24,32
Hibernian,4484,1,20,13,3,57,22,35,73
Falkirk,4484,2,17,9,10,56,38,18,60
Morton,4484,3,16,12,8,55,42,13,60
Dundee Utd,4484,4,15,10,11,51,46,5,55
Dunfermline,4484,5,12,12,12,52,45,7,48
Raith,4484,6,13,8,15,38,45,-7,47
Queen of S't,4484,7,11,8,17,48,56,-8,41
Ayr,4484,8,8,13,15,30,48,-18,37
Dumbarton,4484,9,8,11,17,42,65,-23,35
St Mirren,4484,10,7,10,19,38,60,-22,31
Hibernian,4485,1,18,14,4,60,29,31,68
Morton,4485,2,16,13,7,56,42,14,61
Falkirk,4485,3,16,11,9,60,47,13,59
Dundee Utd,4485,4,16,8,12,54,41,13,56
Queen of S't,4485,5,14,9,13,48,45,3,51
Dunfermline,4485,6,9,14,13,45,51,-6,41
Dumbarton,4485,7,10,11,15,51,62,-11,41
Raith,4485,8,8,12,16,36,53,-17,36
Ayr,4485,9,8,12,16,34,57,-23,36
St Mirren,4485,10,7,12,17,36,53,-17,33
Hibernian,4486,1,20,11,5,60,27,33,71
Falkirk,4486,2,17,11,8,65,43,22,62
Morton,4486,3,14,14,8,46,35,11,56
Dundee Utd,4486,4,16,8,12,48,42,6,56
St Mirren,4486,5,10,12,14,45,54,-9,42
Dunfermline,4486,6,10,11,15,47,50,-3,41
Dumbarton,4486,7,10,11,15,45,58,-13,41
Raith,4486,8,9,12,15,34,50,-16,39
Queen of S't,4486,9,9,11,16,44,54,-10,38
Ayr,4486,10,8,13,15,32,53,-21,37
Hibernian,4487,1,21,10,5,60,26,34,73
Dundee Utd,4487,2,18,9,9,53,36,17,63
Morton,4487,3,15,11,10,48,42,6,56
Falkirk,4487,4,14,9,13,55,49,6,51
Queen of S't,4487,5,13,8,15,48,49,-1,47
Dunfermline,4487,6,11,12,13,49,45,4,45
St Mirren,4487,7,11,9,16,44,52,-8,42
Raith,4487,8,11,9,16,38,53,-15,42
Dumbarton,4487,9,10,10,16,45,58,-13,40
Ayr,4487,10,6,13,17,27,57,-30,31
Hibernian,4488,1,21,12,3,59,24,35,75
Morton,4488,2,16,10,10,45,42,3,58
Dundee Utd,4488,3,16,9,11,52,41,11,57
Falkirk,4488,4,15,11,10,57,42,15,56
Queen of S't,4488,5,11,12,13,47,50,-3,45
Dunfermline,4488,6,10,13,13,46,47,-1,43
Ayr,4488,7,10,12,14,40,52,-12,42
Raith,4488,8,10,9,17,37,54,-17,39
Dumbarton,4488,9,9,11,16,50,63,-13,38
St Mirren,4488,10,7,11,18,40,58,-18,32
Hibernian,4489,1,19,14,3,58,24,34,71
Morton,4489,2,16,14,6,45,32,13,62
Dundee Utd,4489,3,16,9,11,49,38,11,57
Falkirk,4489,4,13,10,13,54,48,6,49
Queen of S't,4489,5,12,8,16,45,53,-8,44
Dunfermline,4489,6,10,13,13,47,46,1,43
Dumbarton,4489,7,10,12,14,54,61,-7,42
Raith,4489,8,10,10,16,32,46,-14,40
Ayr,4489,9,9,13,14,36,52,-16,40
St Mirren,4489,10,7,13,16,36,56,-20,34
Hibernian,4490,1,19,12,5,56,26,30,69
Dundee Utd,4490,2,17,11,8,53,38,15,62
Morton,4490,3,16,12,8,51,34,17,60
Falkirk,4490,4,14,11,11,61,47,14,53
Dunfermline,4490,5,11,14,11,50,47,3,47
Queen of S't,4490,6,10,12,14,44,54,-10,42
Raith,4490,7,10,11,15,38,52,-14,41
Dumbarton,4490,8,8,15,13,52,59,-7,39
St Mirren,4490,9,7,12,17,36,55,-19,33
Ayr,4490,10,6,14,16,35,64,-29,32
Hibernian,4491,1,20,11,5,58,30,28,71
Morton,4491,2,20,9,7,57,37,20,69
Falkirk,4491,3,16,11,9,55,39,16,59
Dundee Utd,4491,4,15,9,12,45,41,4,54
Raith,4491,5,12,10,14,33,41,-8,46
Queen of S't,4491,6,12,9,15,49,51,-2,45
Dunfermline,4491,7,10,12,14,49,53,-4,42
Dumbarton,4491,8,9,10,17,47,60,-13,37
Ayr,4491,9,8,11,17,34,55,-21,35
St Mirren,4491,10,7,10,19,33,53,-20,31
Hibernian,4492,1,21,11,4,63,24,39,74
Morton,4492,2,18,11,7,56,39,17,65
Falkirk,4492,3,16,10,10,62,44,18,58
Dundee Utd,4492,4,15,10,11,47,39,8,55
Dumbarton,4492,5,10,13,13,52,56,-4,43
Queen of S't,4492,6,11,9,16,44,56,-12,42
Dunfermline,4492,7,9,13,14,43,49,-6,40
Raith,4492,8,10,10,16,33,47,-14,40
Ayr,4492,9,8,12,16,32,55,-23,36
St Mirren,4492,10,7,11,18,37,60,-23,32
Hibernian,4493,1,19,11,6,59,30,29,68
Morton,4493,2,18,12,6,50,33,17,66
Falkirk,4493,3,16,9,11,58,42,16,57
Dundee Utd,4493,4,15,11,10,48,38,10,56
Queen of S't,4493,5,12,11,13,46,49,-3,47
Dunfermline,4493,6,10,13,13,46,45,1,43
Raith,4493,7,10,10,16,33,48,-15,40
Dumbarton,4493,8,8,12,16,44,58,-14,36
St Mirren,4493,9,8,11,17,45,64,-19,35
Ayr,4493,10,7,14,15,36,58,-22,35
Hibernian,4494,1,21,12,3,64,25,39,75
Falkirk,4494,2,17,12,7,61,39,22,63
Morton,4494,3,16,12,8,49,37,12,60
Dundee Utd,4494,4,14,10,12,48,42,6,52
Queen of S't,4494,5,12,10,14,47,52,-5,46
Dumbarton,4494,6,10,11,15,49,57,-8,41
Dunfermline,4494,7,9,13,14,45,55,-10,40
Raith,4494,8,9,11,16,34,50,-16,38
Ayr,4494,9,8,12,16,32,54,-22,36
St Mirren,4494,10,7,11,18,41,59,-18,32
Hibernian,4495,1,18,13,5,56,30,26,67
Falkirk,4495,2,17,10,9,53,36,17,61
Dundee Utd,4495,3,16,11,9,48,35,13,59
Morton,4495,4,16,11,9,48,38,10,59
Queen of S't,4495,5,11,10,15,41,48,-7,43
Dunfermline,4495,6,9,15,12,46,48,-2,42
Raith,4495,7,11,9,16,40,52,-12,42
Dumbarton,4495,8,9,11,16,50,57,-7,38
St Mirren,4495,9,9,10,17,42,56,-14,37
Ayr,4495,10,8,12,16,32,56,-24,36
Hibernian,4496,1,21,10,5,60,27,33,73
Morton,4496,2,18,11,7,54,37,17,65
Dundee Utd,4496,3,16,11,9,58,40,18,59
Falkirk,4496,4,16,10,10,56,41,15,58
Queen of S't,4496,5,11,9,16,45,56,-11,42
Ayr,4496,6,9,14,13,36,53,-17,41
Dunfermline,4496,7,9,12,15,45,51,-6,39
Raith,4496,8,10,9,17,33,51,-18,39
Dumbarton,4496,9,8,12,16,47,59,-12,36
St Mirren,4496,10,8,10,18,37,56,-19,34
Hibernian,4497,1,18,12,6,57,31,26,66
Morton,4497,2,16,11,9,54,38,16,59
Falkirk,4497,3,16,10,10,59,44,15,58
Dundee Utd,4497,4,13,11,12,45,43,2,50
Queen of S't,4497,5,13,11,12,47,46,1,50
St Mirren,4497,6,12,10,14,46,53,-7,46
Dunfermline,4497,7,9,14,13,41,45,-4,41
Raith,4497,8,10,10,16,36,53,-17,40
Ayr,4497,9,8,13,15,38,57,-19,37
Dumbarton,4497,10,8,12,16,50,63,-13,36
Hibernian,4498,1,21,11,4,60,26,34,74
Falkirk,4498,2,18,9,9,64,39,25,63
Morton,4498,3,16,10,10,49,41,8,58
Dundee Utd,4498,4,15,11,10,50,43,7,56
Queen of S't,4498,5,11,11,14,43,47,-4,44
Dunfermline,4498,6,10,12,14,45,50,-5,42
Dumbarton,4498,7,9,13,14,50,57,-7,40
Ayr,4498,8,8,14,14,34,53,-19,38
St Mirren,4498,9,8,11,17,42,57,-15,35
Raith,4498,10,8,10,18,34,58,-24,34
Hibernian,4499,1,19,12,5,56,27,29,69
Falkirk,4499,2,18,9,9,57,36,21,63
Dundee Utd,4499,3,16,10,10,54,43,11,58
Morton,4499,4,15,11,10,50,41,9,56
Queen of S't,4499,5,13,9,14,53,49,4,48
Dunfermline,4499,6,11,13,12,51,51,0,46
Raith,4499,7,11,9,16,39,51,-12,42
Dumbarton,4499,8,10,10,16,51,63,-12,40
St Mirren,4499,9,8,9,19,35,59,-24,33
Ayr,4499,10,7,12,17,31,57,-26,33
Hibernian,4500,1,20,12,4,60,25,35,72
Dundee Utd,4500,2,17,10,9,53,39,14,61
Morton,4500,3,16,11,9,46,36,10,59
Falkirk,4500,4,15,11,10,59,47,12,56
Queen of S't,4500,5,13,9,14,50,55,-5,48
Raith,4500,6,11,9,16,37,50,-13,42
Dunfermline,4500,7,8,15,13,48,50,-2,39
Dumbarton,4500,8,9,11,16,48,60,-12,38
St Mirren,4500,9,9,11,16,39,52,-13,38
Ayr,4500,10,7,11,18,31,57,-26,32
Hibernian,4501,1,19,12,5,58,27,31,69
Morton,4501,2,17,13,6,54,35,19,64
Falkirk,4501,3,17,10,9,61,39,22,61
Dundee Utd,4501,4,17,10,9,53,39,14,61
Dunfermline,4501,5,10,11,15,43,50,-7,41
Raith,4501,6,11,8,17,36,52,-16,41
Dumbarton,4501,7,9,12,15,47,58,-11,39
Ayr,4501,8,9,11,16,35,56,-21,38
Queen of S't,4501,9,9,10,17,44,60,-16,37
St Mirren,4501,10,7,13,16,40,55,-15,34
Hibernian,4502,1,19,12,5,57,26,31,69
Falkirk,4502,2,19,10,7,59,35,24,67
Morton,4502,3,16,10,10,51,42,9,58
Dundee Utd,4502,4,15,10,11,52,46,6,55
Dunfermline,4502,5,11,13,12,51,48,3,46
Queen of S't,4502,6,12,9,15,46,52,-6,45
Ayr,4502,7,9,13,14,32,48,-16,40
St Mirren,4502,8,8,12,16,41,58,-17,36
Dumbarton,4502,9,8,11,17,47,60,-13,35
Raith,4502,10,9,8,19,34,55,-21,35
Hibernian,4503,1,18,12,6,60,32,28,66
Dundee Utd,4503,2,17,9,10,54,40,14,60
Morton,4503,3,16,11,9,52,43,9,59
Falkirk,4503,4,15,12,9,61,44,17,57
Ayr,4503,5,12,11,13,41,52,-11,47
Dunfermline,4503,6,10,13,13,47,48,-1,43
Queen of S't,4503,7,10,12,14,45,52,-7,42
Raith,4503,8,10,10,16,37,50,-13,40
St Mirren,4503,9,7,14,15,38,56,-18,35
Dumbarton,4503,10,7,12,17,47,65,-18,33
Hibernian,4504,1,21,12,3,57,22,35,75
Falkirk,4504,2,16,11,9,55,39,16,59
Morton,4504,3,16,11,9,54,42,12,59
Dundee Utd,4504,4,17,8,11,49,41,8,59
Queen of S't,4504,5,12,9,15,44,48,-4,45
Raith,4504,6,11,10,15,37,44,-7,43
Dumbarton,4504,7,10,11,15,51,61,-10,41
Dunfermline,4504,8,8,15,13,47,54,-7,39
St Mirren,4504,9,8,10,18,39,56,-17,34
Ayr,4504,10,7,11,18,31,57,-26,32
Hibernian,4505,1,19,13,4,57,25,32,70
Falkirk,4505,2,17,11,8,60,37,23,62
Morton,4505,3,15,12,9,46,37,9,57
Dundee Utd,4505,4,16,9,11,50,42,8,57
Dunfermline,4505,5,11,13,12,51,50,1,46
Queen of S't,4505,6,11,10,15,43,50,-7,43
Ayr,4505,7,10,10,16,34,54,-20,40
Dumbarton,4505,8,9,10,17,45,58,-13,37
Raith,4505,9,8,12,16,31,47,-16,36
St Mirren,4505,10,8,12,16,39,56,-17,36
Hibernian,4506,1,19,13,4,56,24,32,70
Falkirk,4506,2,16,12,8,57,36,21,60
Morton,4506,3,16,11,9,49,41,8,59
Dundee Utd,4506,4,16,10,10,50,42,8,58
Queen of S't,4506,5,13,9,14,46,52,-6,48
Dunfermline,4506,6,10,13,13,48,45,3,43
St Mirren,4506,7,10,11,15,41,54,-13,41
Raith,4506,8,9,12,15,38,49,-11,39
Dumbarton,4506,9,9,10,17,45,58,-13,37
Ayr,4506,10,6,11,19,28,57,-29,29
Hibernian,4507,1,21,11,4,56,23,33,74
Morton,4507,2,17,12,7,49,36,13,63
Dundee Utd,4507,3,17,10,9,52,38,14,61
Falkirk,4507,4,15,11,10,58,44,14,56
Queen of S't,4507,5,11,12,13,43,47,-4,45
Dunfermline,4507,6,8,17,11,48,51,-3,41
Dumbarton,4507,7,8,13,15,44,53,-9,37
St Mirren,4507,8,9,10,17,41,54,-13,37
Raith,4507,9,8,10,18,35,53,-18,34
Ayr,4507,10,8,10,18,31,58,-27,34
Hibernian,4508,1,19,12,5,56,26,30,69
Dundee Utd,4508,2,18,9,9,53,39,14,63
Morton,4508,3,17,11,8,48,35,13,62
Falkirk,4508,4,17,10,9,59,39,20,61
Queen of S't,4508,5,12,10,14,51,52,-1,46
Dunfermline,4508,6,9,12,15,43,49,-6,39
Ayr,4508,7,8,14,14,36,55,-19,38
Raith,4508,8,8,12,16,32,51,-19,36
Dumbarton,4508,9,8,11,17,43,58,-15,35
St Mirren,4508,10,8,11,17,38,55,-17,35
Morton,4509,1,20,11,5,55,30,25,71
Hibernian,4509,2,16,13,7,53,31,22,61
Dundee Utd,4509,3,16,10,10,48,40,8,58
Falkirk,4509,4,15,12,9,61,43,18,57
Queen of S't,4509,5,11,10,15,43,51,-8,43
Dunfermline,4509,6,10,12,14,43,46,-3,42
Dumbarton,4509,7,10,12,14,49,55,-6,42
Raith,4509,8,10,10,16,37,49,-12,40
Ayr,4509,9,8,13,15,35,57,-22,37
St Mirren,4509,10,7,11,18,38,60,-22,32
Hibernian,4510,1,18,11,7,50,31,19,65
Morton,4510,2,17,13,6,50,33,17,64
Falkirk,4510,3,16,11,9,63,41,22,59
Dundee Utd,4510,4,16,11,9,50,38,12,59
Dunfermline,4510,5,11,15,10,48,43,5,48
Queen of S't,4510,6,12,8,16,45,51,-6,44
St Mirren,4510,7,9,11,16,39,52,-13,38
Raith,4510,8,10,8,18,33,50,-17,38
Ayr,4510,9,8,12,16,32,55,-23,36
Dumbarton,4510,10,7,12,17,47,63,-16,33
Morton,4511,1,19,10,7,54,32,22,67
Hibernian,4511,2,18,11,7,54,31,23,65
Falkirk,4511,3,16,11,9,59,44,15,59
Dundee Utd,4511,4,14,10,12,51,46,5,52
Dunfermline,4511,5,11,14,11,47,43,4,47
Ayr,4511,6,12,11,13,44,51,-7,47
Queen of S't,4511,7,12,8,16,48,53,-5,44
Dumbarton,4511,8,9,11,16,48,60,-12,38
Raith,4511,9,9,11,16,34,51,-17,38
St Mirren,4511,10,6,11,19,37,65,-28,29
Hibernian,4512,1,21,11,4,58,25,33,74
Dundee Utd,4512,2,17,9,10,51,36,15,60
Morton,4512,3,15,14,7,48,35,13,59
Falkirk,4512,4,15,9,12,56,45,11,54
Raith,4512,5,12,9,15,40,47,-7,45
Queen of S't,4512,6,12,9,15,46,56,-10,45
Dunfermline,4512,7,10,13,13,47,46,1,43
Dumbarton,4512,8,9,13,14,52,61,-9,40
Ayr,4512,9,8,12,16,35,59,-24,36
St Mirren,4512,10,6,11,19,37,60,-23,29
Hibernian,4513,1,19,13,4,53,24,29,70
Falkirk,4513,2,17,11,8,59,40,19,62
Morton,4513,3,16,12,8,46,34,12,60
Dundee Utd,4513,4,15,10,11,52,43,9,55
Dunfermline,4513,5,11,14,11,50,47,3,47
Queen of S't,4513,6,10,11,15,45,53,-8,41
Raith,4513,7,11,8,17,37,49,-12,41
St Mirren,4513,8,10,10,16,44,55,-11,40
Ayr,4513,9,8,12,16,39,58,-19,36
Dumbarton,4513,10,7,11,18,46,68,-22,32
Hibernian,4514,1,19,12,5,59,27,32,69
Dundee Utd,4514,2,16,11,9,50,37,13,59
Falkirk,4514,3,16,9,11,60,47,13,57
Morton,4514,4,15,12,9,49,43,6,57
Dumbarton,4514,5,10,12,14,50,57,-7,42
Queen of S't,4514,6,11,9,16,44,53,-9,42
Dunfermline,4514,7,9,13,14,47,54,-7,40
Raith,4514,8,10,10,16,40,54,-14,40
St Mirren,4514,9,9,12,15,43,55,-12,39
Ayr,4514,10,9,12,15,38,53,-15,39
Hibernian,4515,1,18,13,5,51,24,27,67
Morton,4515,2,18,12,6,52,34,18,66
Falkirk,4515,3,16,10,10,60,42,18,58
Dundee Utd,4515,4,15,10,11,49,40,9,55
Queen of S't,4515,5,12,9,15,47,52,-5,45
Dunfermline,4515,6,9,14,13,44,51,-7,41
St Mirren,4515,7,10,10,16,42,54,-12,40
Raith,4515,8,10,9,17,31,46,-15,39
Dumbarton,4515,9,9,11,16,47,61,-14,38
Ayr,4515,10,7,14,15,33,52,-19,35
Morton,4516,1,19,10,7,57,36,21,67
Hibernian,4516,2,17,14,5,51,28,23,65
Dundee Utd,4516,3,18,8,10,53,38,15,62
Falkirk,4516,4,17,9,10,56,39,17,60
Dumbarton,4516,5,10,12,14,50,61,-11,42
Queen of S't,4516,6,10,11,15,42,50,-8,41
Dunfermline,4516,7,9,12,15,45,52,-7,39
Raith,4516,8,10,9,17,39,57,-18,39
St Mirren,4516,9,9,11,16,42,53,-11,38
Ayr,4516,10,7,12,17,36,57,-21,33
Hibernian,4517,1,21,11,4,54,24,30,74
Morton,4517,2,18,10,8,57,37,20,64
Falkirk,4517,3,17,10,9,58,38,20,61
Dundee Utd,4517,4,16,8,12,48,41,7,56
Dunfermline,4517,5,10,13,13,46,47,-1,43
Dumbarton,4517,6,9,13,14,46,55,-9,40
Queen of S't,4517,7,10,9,17,43,54,-11,39
Raith,4517,8,9,11,16,38,55,-17,38
Ayr,4517,9,8,13,15,36,58,-22,37
St Mirren,4517,10,8,10,18,38,55,-17,34
Hibernian,4518,1,18,12,6,56,28,28,66
Falkirk,4518,2,17,10,9,61,41,20,61
Morton,4518,3,15,12,9,46,35,11,57
Dundee Utd,4518,4,14,10,12,49,42,7,52
Queen of S't,4518,5,12,10,14,48,52,-4,46
Dumbarton,4518,6,11,11,14,49,57,-8,44
Raith,4518,7,11,9,16,38,48,-10,42
Dunfermline,4518,8,8,16,12,43,49,-6,40
St Mirren,4518,9,9,11,16,40,54,-14,38
Ayr,4518,10,9,11,16,32,56,-24,38
Hibernian,4519,1,17,14,5,52,26,26,65
Morton,4519,2,17,13,6,52,35,17,64
Falkirk,4519,3,16,10,10,58,40,18,58
Dundee Utd,4519,4,15,10,11,48,42,6,55
St Mirren,4519,5,11,10,15,44,51,-7,43
Queen of S't,4519,6,11,10,15,43,50,-7,43
Dunfermline,4519,7,9,14,13,44,47,-3,41
Raith,4519,8,9,12,15,35,48,-13,39
Dumbarton,4519,9,9,11,16,45,59,-14,38
Ayr,4519,10,8,12,16,34,57,-23,36
Hibernian,4520,1,19,11,6,55,26,29,68
Dundee Utd,4520,2,17,9,10,53,40,13,60
Falkirk,4520,3,16,10,10,62,45,17,58
Morton,4520,4,15,10,11,48,42,6,55
Queen of S't,4520,5,13,8,15,48,53,-5,47
Dunfermline,4520,6,11,11,14,47,50,-3,44
Raith,4520,7,11,10,15,35,49,-14,43
Dumbarton,4520,8,10,10,16,48,56,-8,40
St Mirren,4520,9,8,13,15,44,58,-14,37
Ayr,4520,10,8,12,16,36,57,-21,36
Hibernian,4521,1,21,12,3,56,21,35,75
Morton,4521,2,18,12,6,50,34,16,66
Falkirk,4521,3,15,9,12,52,40,12,54
Dundee Utd,4521,4,14,10,12,48,46,2,52
Dunfermline,4521,5,11,13,12,47,46,1,46
Queen of S't,4521,6,12,8,16,47,53,-6,44
Ayr,4521,7,10,11,15,38,53,-15,41
Raith,4521,8,10,8,18,34,49,-15,38
St Mirren,4521,9,9,10,17,39,56,-17,37
Dumbarton,4521,10,8,11,17,47,60,-13,35
Hibernian,4522,1,18,13,5,55,28,27,67
Morton,4522,2,17,12,7,51,32,19,63
Dundee Utd,4522,3,15,11,10,47,37,10,56
Falkirk,4522,4,14,12,10,57,43,14,54
Queen of S't,4522,5,12,10,14,46,50,-4,46
Raith,4522,6,12,9,15,37,48,-11,45
Dumbarton,4522,7,9,12,15,43,52,-9,39
St Mirren,4522,8,10,9,17,37,53,-16,39
Dunfermline,4522,9,8,14,14,46,53,-7,38
Ayr,4522,10,8,12,16,32,55,-23,36
Hibernian,4523,1,19,12,5,57,27,30,69
Morton,4523,2,17,11,8,52,37,15,62
Falkirk,4523,3,16,11,9,58,40,18,59
Dundee Utd,4523,4,14,13,9,51,40,11,55
Queen of S't,4523,5,12,12,12,49,48,1,48
Raith,4523,6,11,11,14,35,46,-11,44
Dunfermline,4523,7,10,12,14,52,57,-5,42
Dumbarton,4523,8,8,12,16,51,62,-11,36
St Mirren,4523,9,8,11,17,40,60,-20,35
Ayr,4523,10,6,13,17,30,58,-28,31
Morton,4524,1,19,11,6,59,36,23,68
Hibernian,4524,2,18,13,5,56,28,28,67
Dundee Utd,4524,3,16,10,10,53,43,10,58
Falkirk,4524,4,15,11,10,58,44,14,56
Queen of S't,4524,5,12,9,15,47,52,-5,45
Dunfermline,4524,6,10,14,12,47,49,-2,44
Ayr,4524,7,10,11,15,39,55,-16,41
Raith,4524,8,9,11,16,38,53,-15,38
Dumbarton,4524,9,8,10,18,47,64,-17,34
St Mirren,4524,10,7,12,17,40,60,-20,33
Hibernian,4525,1,21,11,4,58,23,35,74
Morton,4525,2,18,10,8,48,37,11,64
Falkirk,4525,3,17,11,8,63,40,23,62
Dundee Utd,4525,4,15,9,12,50,44,6,54
Queen of S't,4525,5,10,12,14,42,49,-7,42
Dunfermline,4525,6,9,14,13,47,50,-3,41
St Mirren,4525,7,9,12,15,41,54,-13,39
Dumbarton,4525,8,8,13,15,46,60,-14,37
Raith,4525,9,9,9,18,33,49,-16,36
Ayr,4525,10,7,13,16,32,54,-22,34
Hibernian,4526,1,19,14,3,53,22,31,71
Dundee Utd,4526,2,16,11,9,50,38,12,59
Falkirk,4526,3,15,11,10,57,42,15,56
Morton,4526,4,14,14,8,46,37,9,56
Raith,4526,5,12,9,15,39,50,-11,45
Dunfermline,4526,6,10,13,13,45,45,0,43
Dumbarton,4526,7,10,13,13,48,52,-4,43
Ayr,4526,8,8,13,15,33,52,-19,37
Queen of S't,4526,9,9,9,18,42,58,-16,36
St Mirren,4526,10,7,13,16,38,55,-17,34
Morton,4527,1,19,11,6,50,34,16,68
Dundee Utd,4527,2,18,8,10,56,34,22,62
Hibernian,4527,3,16,13,7,49,28,21,61
Falkirk,4527,4,14,10,12,53,44,9,52
Raith,4527,5,12,10,14,38,43,-5,46
Queen of S't,4527,6,12,9,15,44,49,-5,45
Dunfermline,4527,7,10,13,13,45,47,-2,43
Dumbarton,4527,8,10,11,15,48,59,-11,41
St Mirren,4527,9,9,10,17,37,54,-17,37
Ayr,4527,10,7,11,18,31,59,-28,32
Hibernian,4528,1,18,13,5,53,27,26,67
Morton,4528,2,19,9,8,56,36,20,66
Dundee Utd,4528,3,15,10,11,49,40,9,55
Falkirk,4528,4,14,11,11,54,45,9,53
Queen of S't,4528,5,13,9,14,47,47,0,48
Dunfermline,4528,6,11,14,11,51,46,5,47
St Mirren,4528,7,10,10,16,39,53,-14,40
Raith,4528,8,9,11,16,33,51,-18,38
Ayr,4528,9,8,12,16,31,52,-21,36
Dumbarton,4528,10,8,11,17,44,60,-16,35
Hibernian,4529,1,20,11,5,59,28,31,71
Falkirk,4529,2,18,11,7,61,38,23,65
Morton,4529,3,18,10,8,54,40,14,64
Dundee Utd,4529,4,14,11,11,49,40,9,53
Dunfermline,4529,5,9,15,12,49,48,1,42
Queen of S't,4529,6,10,12,14,43,49,-6,42
Dumbarton,4529,7,10,10,16,47,61,-14,40
St Mirren,4529,8,9,9,18,45,60,-15,36
Ayr,4529,9,8,12,16,35,56,-21,36
Raith,4529,10,8,11,17,36,58,-22,35
Hibernian,4530,1,21,11,4,60,26,34,74
Morton,4530,2,18,10,8,52,35,17,64
Dundee Utd,4530,3,18,9,9,56,41,15,63
Falkirk,4530,4,14,14,8,55,40,15,56
Queen of S't,4530,5,10,12,14,45,50,-5,42
Dunfermline,4530,6,9,13,14,48,54,-6,40
Raith,4530,7,10,10,16,38,53,-15,40
Dumbarton,4530,8,8,14,14,44,55,-11,38
St Mirren,4530,9,8,11,17,40,55,-15,35
Ayr,4530,10,7,10,19,33,62,-29,31
Hibernian,4531,1,20,10,6,57,26,31,70
Morton,4531,2,17,10,9,48,38,10,61
Falkirk,4531,3,15,12,9,58,45,13,57
Dundee Utd,4531,4,15,11,10,51,43,8,56
Dunfermline,4531,5,10,15,11,54,49,5,45
Queen of S't,4531,6,12,9,15,47,51,-4,45
Raith,4531,7,10,11,15,40,49,-9,41
St Mirren,4531,8,9,10,17,41,54,-13,37
Ayr,4531,9,8,13,15,35,60,-25,37
Dumbarton,4531,10,7,13,16,52,68,-16,34
Morton,4532,1,19,11,6,57,34,23,68
Hibernian,4532,2,19,10,7,58,30,28,67
Dundee Utd,4532,3,16,10,10,50,40,10,58
Falkirk,4532,4,15,11,10,56,42,14,56
Dunfermline,4532,5,11,13,12,47,46,1,46
Queen of S't,4532,6,12,9,15,42,48,-6,45
Dumbarton,4532,7,9,12,15,45,54,-9,39
St Mirren,4532,8,8,12,16,39,57,-18,36
Raith,4532,9,8,11,17,34,53,-19,35
Ayr,4532,10,7,13,16,31,55,-24,34
Hibernian,4533,1,19,12,5,55,27,28,69
Falkirk,4533,2,16,11,9,62,41,21,59
Morton,4533,3,16,11,9,48,36,12,59
Dundee Utd,4533,4,15,8,13,44,43,1,53
Queen of S't,4533,5,14,9,13,45,45,0,51
Dunfermline,4533,6,10,15,11,44,45,-1,45
Dumbarton,4533,7,9,12,15,51,61,-10,39
St Mirren,4533,8,9,11,16,47,59,-12,38
Raith,4533,9,9,9,18,34,50,-16,36
Ayr,4533,10,8,12,16,34,57,-23,36
Hibernian,4534,1,19,13,4,54,23,31,70
Dundee Utd,4534,2,17,10,9,51,37,14,61
Morton,4534,3,16,13,7,48,36,12,61
Falkirk,4534,4,15,11,10,54,41,13,56
Dumbarton,4534,5,10,13,13,50,54,-4,43
Dunfermline,4534,6,10,11,15,44,47,-3,41
Raith,4534,7,10,11,15,38,50,-12,41
Queen of S't,4534,8,9,10,17,39,53,-14,37
Ayr,4534,9,8,12,16,33,55,-22,36
St Mirren,4534,10,7,14,15,40,55,-15,35
Hibernian,4535,1,20,12,4,52,23,29,72
Dundee Utd,4535,2,17,9,10,59,43,16,60
Morton,4535,3,16,11,9,48,37,11,59
Falkirk,4535,4,16,9,11,59,42,17,57
Queen of S't,4535,5,12,9,15,47,54,-7,45
Dunfermline,4535,6,10,13,13,48,48,0,43
Raith,4535,7,10,11,15,36,50,-14,41
St Mirren,4535,8,10,10,16,41,53,-12,40
Dumbarton,4535,9,9,11,16,49,64,-15,38
Ayr,4535,10,7,11,18,38,63,-25,32
Hibernian,4536,1,22,11,3,59,24,35,77
Falkirk,4536,2,18,9,9,65,39,26,63
Dundee Utd,4536,3,17,8,11,51,44,7,59
Morton,4536,4,16,10,10,48,44,4,58
Queen of S't,4536,5,13,8,15,51,53,-2,47
Ayr,4536,6,11,10,15,38,48,-10,43
Raith,4536,7,10,10,16,35,48,-13,40
Dunfermline,4536,8,8,13,15,41,51,-10,37
Dumbarton,4536,9,8,10,18,44,60,-16,34
St Mirren,4536,10,8,9,19,38,59,-21,33
Hibernian,4537,1,19,12,5,55,26,29,69
Morton,4537,2,17,12,7,51,34,17,63
Falkirk,4537,3,17,11,8,65,40,25,62
Dundee Utd,4537,4,16,10,10,52,40,12,58
Queen of S't,4537,5,12,9,15,50,53,-3,45
St Mirren,4537,6,10,9,17,41,58,-17,39
Ayr,4537,7,9,12,15,36,58,-22,39
Dunfermline,4537,8,8,14,14,44,54,-10,38
Dumbarton,4537,9,8,12,16,49,61,-12,36
Raith,4537,10,9,9,18,32,51,-19,36
Morton,4538,1,18,13,5,55,31,24,67
Hibernian,4538,2,17,14,5,59,31,28,65
Falkirk,4538,3,17,9,10,56,41,15,60
Dundee Utd,4538,4,16,10,10,48,37,11,58
Queen of S't,4538,5,13,9,14,48,49,-1,48
St Mirren,4538,6,9,12,15,38,52,-14,39
Raith,4538,7,9,11,16,34,50,-16,38
Ayr,4538,8,8,13,15,32,55,-23,37
Dunfermline,4538,9,8,12,16,46,53,-7,36
Dumbarton,4538,10,8,11,17,46,63,-17,35
Hibernian,4539,1,19,11,6,53,26,27,68
Falkirk,4539,2,19,10,7,65,39,26,67
Morton,4539,3,18,10,8,54,39,15,64
Dundee Utd,4539,4,15,11,10,47,39,8,56
Queen of S't,4539,5,11,11,14,42,47,-5,44
Dunfermline,4539,6,10,12,14,44,48,-4,42
Dumbarton,4539,7,9,12,15,49,61,-12,39
Raith,4539,8,10,8,18,33,50,-17,38
Ayr,4539,9,8,12,16,34,56,-22,36
St Mirren,4539,10,8,9,19,42,58,-16,33
Hibernian,4540,1,20,11,5,54,23,31,71
Morton,4540,2,19,11,6,59,38,21,68
Dundee Utd,4540,3,16,9,11,45,40,5,57
Falkirk,4540,4,15,9,12,58,42,16,54
Raith,4540,5,12,8,16,39,52,-13,44
Queen of S't,4540,6,11,10,15,44,52,-8,43
Dunfermline,4540,7,10,12,14,46,50,-4,42
Ayr,4540,8,9,12,15,39,54,-15,39
Dumbarton,4540,9,8,12,16,46,61,-15,36
St Mirren,4540,10,8,10,18,38,56,-18,34
Hibernian,4541,1,19,13,4,52,25,27,70
Morton,4541,2,16,13,7,48,34,14,61
Dundee Utd,4541,3,17,10,9,52,40,12,61
Falkirk,4541,4,14,10,12,54,42,12,52
Dunfermline,4541,5,11,12,13,46,48,-2,45
Queen of S't,4541,6,11,8,17,44,53,-9,41
Ayr,4541,7,10,11,15,36,51,-15,41
Raith,4541,8,10,10,16,35,50,-15,40
Dumbarton,4541,9,9,11,16,50,59,-9,38
St Mirren,4541,10,8,12,16,40,55,-15,36
Hibernian,4542,1,20,12,4,53,24,29,72
Dundee Utd,4542,2,16,9,11,55,42,13,57
Falkirk,4542,3,15,10,11,57,45,12,55
Morton,4542,4,14,13,9,44,40,4,55
Queen of S't,4542,5,12,12,12,45,45,0,48
Dunfermline,4542,6,11,13,12,47,46,1,46
Raith,4542,7,11,8,17,34,47,-13,41
Ayr,4542,8,9,12,15,36,51,-15,39
Dumbarton,4542,9,9,11,16,49,61,-12,38
St Mirren,4542,10,8,10,18,38,57,-19,34
Hibernian,4543,1,20,11,5,54,27,27,71
Dundee Utd,4543,2,17,8,11,54,41,13,59
Falkirk,4543,3,15,13,8,57,37,20,58
Morton,4543,4,16,10,10,46,37,9,58
Raith,4543,5,11,11,14,34,43,-9,44
Queen of S't,4543,6,11,10,15,42,48,-6,43
Dunfermline,4543,7,8,15,13,42,50,-8,39
St Mirren,4543,8,9,12,15,43,53,-10,39
Dumbarton,4543,9,8,12,16,44,57,-13,36
Ayr,4543,10,8,12,16,34,57,-23,36
Hibernian,4544,1,16,15,5,50,27,23,63
Falkirk,4544,2,16,13,7,60,40,20,61
Dundee Utd,4544,3,17,8,11,53,40,13,59
Morton,4544,4,15,14,7,47,36,11,59
Dunfermline,4544,5,10,13,13,46,49,-3,43
Queen of S't,4544,6,10,12,14,46,52,-6,42
Dumbarton,4544,7,9,12,15,48,57,-9,39
Raith,4544,8,9,12,15,34,48,-14,39
St Mirren,4544,9,9,10,17,41,54,-13,37
Ayr,4544,10,8,13,15,35,57,-22,37
Hibernian,4545,1,21,12,3,59,25,34,75
Morton,4545,2,17,10,9,48,38,10,61
Dundee Utd,4545,3,17,9,10,53,39,14,60
Falkirk,4545,4,15,11,10,56,40,16,56
Queen of S't,4545,5,13,8,15,45,50,-5,47
Dunfermline,4545,6,10,12,14,47,52,-5,42
Raith,4545,7,11,9,16,36,52,-16,42
Ayr,4545,8,8,12,16,36,54,-18,36
St Mirren,4545,9,8,11,17,42,55,-13,35
Dumbarton,4545,10,8,10,18,45,62,-17,34
Hibernian,4546,1,17,12,7,55,31,24,63
Morton,4546,2,17,10,9,51,43,8,61
Falkirk,4546,3,14,13,9,58,44,14,55
Dundee Utd,4546,4,15,9,12,46,40,6,54
Dunfermline,4546,5,11,12,13,50,50,0,45
Queen of S't,4546,6,10,12,14,44,50,-6,42
Raith,4546,7,11,9,16,36,49,-13,42
Ayr,4546,8,10,12,14,36,55,-19,42
Dumbarton,4546,9,9,14,13,50,54,-4,41
St Mirren,4546,10,9,11,16,42,52,-10,38
Hibernian,4547,1,18,14,4,55,28,27,68
Morton,4547,2,19,11,6,54,36,18,68
Dundee Utd,4547,3,17,9,10,55,38,17,60
Falkirk,4547,4,16,10,10,57,40,17,58
Dunfermline,4547,5,11,13,12,52,47,5,46
Queen of S't,4547,6,11,11,14,44,52,-8,44
St Mirren,4547,7,9,11,16,40,53,-13,38
Raith,4547,8,9,11,16,34,55,-21,38
Dumbarton,4547,9,7,11,18,45,63,-18,32
Ayr,4547,10,7,11,18,33,57,-24,32
Hibernian,4548,1,20,10,6,61,29,32,70
Morton,4548,2,19,12,5,58,34,24,69
Falkirk,4548,3,16,10,10,58,39,19,58
Dundee Utd,4548,4,15,12,9,51,39,12,57
Queen of S't,4548,5,12,9,15,43,48,-5,45
Dunfermline,4548,6,10,13,13,51,52,-1,43
Raith,4548,7,10,9,17,35,52,-17,39
St Mirren,4548,8,9,9,18,40,59,-19,36
Ayr,4548,9,7,15,14,36,57,-21,36
Dumbarton,4548,10,7,11,18,42,66,-24,32
Hibernian,4549,1,20,11,5,59,29,30,71
Falkirk,4549,2,17,11,8,58,39,19,62
Dundee Utd,4549,3,17,10,9,52,37,15,61
Morton,4549,4,15,12,9,49,40,9,57
Dunfermline,4549,5,12,13,11,55,52,3,49
Queen of S't,4549,6,12,9,15,51,57,-6,45
Raith,4549,7,11,9,16,40,52,-12,42
St Mirren,4549,8,9,9,18,38,55,-17,36
Dumbarton,4549,9,7,12,17,48,63,-15,33
Ayr,4549,10,6,12,18,34,60,-26,30
Hibernian,4550,1,21,11,4,56,21,35,74
Falkirk,4550,2,16,10,10,61,46,15,58
Dundee Utd,4550,3,15,12,9,45,36,9,57
Morton,4550,4,14,12,10,42,37,5,54
Dunfermline,4550,5,11,15,10,51,45,6,48
Raith,4550,6,10,12,14,35,45,-10,42
Queen of S't,4550,7,10,11,15,40,48,-8,41
Dumbarton,4550,8,9,12,15,47,58,-11,39
Ayr,4550,9,8,11,17,33,57,-24,35
St Mirren,4550,10,7,12,17,37,54,-17,33
Hibernian,4551,1,21,12,3,60,24,36,75
Dundee Utd,4551,2,17,10,9,54,39,15,61
Morton,4551,3,15,10,11,46,39,7,55
Falkirk,4551,4,14,11,11,55,46,9,53
Queen of S't,4551,5,11,10,15,48,53,-5,43
Dumbarton,4551,6,10,11,15,52,57,-5,41
St Mirren,4551,7,9,13,14,40,51,-11,40
Raith,4551,8,10,10,16,36,53,-17,40
Dunfermline,4551,9,9,12,15,44,51,-7,39
Ayr,4551,10,9,11,16,33,55,-22,38
Hibernian,4552,1,19,13,4,59,25,34,70
Morton,4552,2,17,10,9,52,41,11,61
Dundee Utd,4552,3,17,8,11,52,39,13,59
Falkirk,4552,4,15,11,10,59,47,12,56
St Mirren,4552,5,11,11,14,43,51,-8,44
Queen of S't,4552,6,11,10,15,47,48,-1,43
Raith,4552,7,11,10,15,35,48,-13,43
Dumbarton,4552,8,8,12,16,48,60,-12,36
Dunfermline,4552,9,7,15,14,43,55,-12,36
Ayr,4552,10,8,12,16,31,55,-24,36
Hibernian,4553,1,23,10,3,61,20,41,79
Morton,4553,2,17,10,9,59,44,15,61
Falkirk,4553,3,16,9,11,54,40,14,57
Dundee Utd,4553,4,15,9,12,48,43,5,54
Queen of S't,4553,5,13,8,15,48,53,-5,47
Dunfermline,4553,6,11,11,14,48,53,-5,44
Dumbarton,4553,7,10,11,15,49,56,-7,41
Raith,4553,8,9,10,17,36,52,-16,37
Ayr,4553,9,9,10,17,36,57,-21,37
St Mirren,4553,10,8,10,18,41,62,-21,34
Hibernian,4554,1,20,12,4,61,25,36,72
Morton,4554,2,18,10,8,50,34,16,64
Dundee Utd,4554,3,18,9,9,57,37,20,63
Falkirk,4554,4,16,10,10,59,46,13,58
Queen of S't,4554,5,12,9,15,46,53,-7,45
Dunfermline,4554,6,10,13,13,46,45,1,43
Dumbarton,4554,7,10,12,14,46,54,-8,42
Ayr,4554,8,8,12,16,32,54,-22,36
Raith,4554,9,8,10,18,35,56,-21,34
St Mirren,4554,10,6,11,19,35,63,-28,29
Hibernian,4555,1,18,14,4,55,24,31,68
Morton,4555,2,16,13,7,54,39,15,61
Falkirk,4555,3,16,10,10,60,45,15,58
Dundee Utd,4555,4,16,10,10,54,40,14,58
Queen of S't,4555,5,13,9,14,46,51,-5,48
Dunfermline,4555,6,10,15,11,47,46,1,45
Dumbarton,4555,7,8,13,15,46,60,-14,37
Ayr,4555,8,8,13,15,39,55,-16,37
Raith,4555,9,9,9,18,35,57,-22,36
St Mirren,4555,10,8,10,18,42,61,-19,34
Hibernian,4556,1,18,12,6,56,29,27,66
Morton,4556,2,17,13,6,53,36,17,64
Dundee Utd,4556,3,17,8,11,52,39,13,59
Falkirk,4556,4,15,12,9,64,43,21,57
Queen of S't,4556,5,12,8,16,45,53,-8,44
Dunfermline,4556,6,10,13,13,45,49,-4,43
Dumbarton,4556,7,10,10,16,49,58,-9,40
Raith,4556,8,10,9,17,35,52,-17,39
St Mirren,4556,9,9,11,16,40,55,-15,38
Ayr,4556,10,9,10,17,34,59,-25,37
Hibernian,4557,1,21,12,3,64,23,41,75
Falkirk,4557,2,17,11,8,59,39,20,62
Dundee Utd,4557,3,17,9,10,55,39,16,60
Morton,4557,4,16,9,11,46,41,5,57
Queen of S't,4557,5,12,10,14,44,51,-7,46
Dunfermline,4557,6,11,11,14,52,51,1,44
St Mirren,4557,7,10,10,16,45,57,-12,40
Raith,4557,8,10,9,17,34,51,-17,39
Ayr,4557,9,8,10,18,34,61,-27,34
Dumbarton,4557,10,7,11,18,43,63,-20,32
Hibernian,4558,1,16,14,6,50,27,23,62
Falkirk,4558,2,14,13,9,55,38,17,55
Dundee Utd,4558,3,15,10,11,54,42,12,55
Dunfermline,4558,4,13,13,10,52,43,9,52
Morton,4558,5,13,13,10,47,44,3,52
Queen of S't,4558,6,14,9,13,53,51,2,51
Dumbarton,4558,7,9,12,15,47,59,-12,39
Raith,4558,8,10,9,17,37,50,-13,39
Ayr,4558,9,9,12,15,34,57,-23,39
St Mirren,4558,10,9,11,16,42,60,-18,38
Hibernian,4559,1,19,13,4,55,22,33,70
Falkirk,4559,2,17,10,9,58,41,17,61
Morton,4559,3,16,11,9,47,38,9,59
Dundee Utd,4559,4,14,11,11,52,46,6,53
Queen of S't,4559,5,12,9,15,45,50,-5,45
Raith,4559,6,11,9,16,39,48,-9,42
Dunfermline,4559,7,9,13,14,45,52,-7,40
Dumbarton,4559,8,10,10,16,50,61,-11,40
Ayr,4559,9,9,13,14,38,55,-17,40
St Mirren,4559,10,8,11,17,38,54,-16,35
Hibernian,4560,1,19,13,4,52,23,29,70
Morton,4560,2,19,12,5,52,28,24,69
Dundee Utd,4560,3,17,9,10,55,43,12,60
Falkirk,4560,4,14,14,8,54,38,16,56
Raith,4560,5,12,10,14,38,45,-7,46
Dunfermline,4560,6,10,13,13,42,46,-4,43
Queen of S't,4560,7,10,10,16,43,53,-10,40
Dumbarton,4560,8,8,12,16,44,58,-14,36
St Mirren,4560,9,8,9,19,38,55,-17,33
Ayr,4560,10,7,10,19,32,61,-29,31
Hibernian,4561,1,19,11,6,52,26,26,68
Falkirk,4561,2,16,10,10,57,44,13,58
Morton,4561,3,16,10,10,52,41,11,58
Dundee Utd,4561,4,16,9,11,55,40,15,57
Dunfermline,4561,5,11,13,12,46,45,1,46
Raith,4561,6,12,10,14,37,45,-8,46
Queen of S't,4561,7,11,10,15,44,49,-5,43
Dumbarton,4561,8,9,13,14,47,56,-9,40
St Mirren,4561,9,9,9,18,43,59,-16,36
Ayr,4561,10,8,11,17,32,60,-28,35
Hibernian,4562,1,21,11,4,56,22,34,74
Morton,4562,2,18,10,8,53,36,17,64
Falkirk,4562,3,17,9,10,61,42,19,60
Dundee Utd,4562,4,13,9,14,48,49,-1,48
Dunfermline,4562,5,11,12,13,47,48,-1,45
Dumbarton,4562,6,11,12,13,49,53,-4,45
Queen of S't,4562,7,11,9,16,44,52,-8,42
Raith,4562,8,10,9,17,39,52,-13,39
Ayr,4562,9,9,12,15,33,56,-23,39
St Mirren,4562,10,8,9,19,37,57,-20,33
Hibernian,4563,1,18,12,6,55,24,31,66
Morton,4563,2,18,12,6,52,35,17,66
Falkirk,4563,3,16,9,11,57,44,13,57
Dundee Utd,4563,4,15,11,10,49,41,8,56
Queen of S't,4563,5,12,9,15,43,52,-9,45
Dumbarton,4563,6,10,11,15,54,56,-2,41
Dunfermline,4563,7,9,14,13,45,52,-7,41
Raith,4563,8,10,11,15,37,50,-13,41
Ayr,4563,9,9,11,16,34,53,-19,38
St Mirren,4563,10,7,12,17,41,60,-19,33
Hibernian,4564,1,19,12,5,57,26,31,69
Falkirk,4564,2,17,12,7,62,38,24,63
Dundee Utd,4564,3,17,9,10,50,38,12,60
Morton,4564,4,16,11,9,51,38,13,59
Queen of S't,4564,5,12,11,13,48,49,-1,47
Raith,4564,6,10,10,16,37,51,-14,40
Ayr,4564,7,9,12,15,36,56,-20,39
Dunfermline,4564,8,8,12,16,43,54,-11,36
Dumbarton,4564,9,7,14,15,47,60,-13,35
St Mirren,4564,10,8,11,17,41,62,-21,35
Hibernian,4565,1,22,10,4,59,24,35,76
Morton,4565,2,16,11,9,52,42,10,59
Falkirk,4565,3,15,11,10,55,40,15,56
Dundee Utd,4565,4,15,11,10,55,41,14,56
Dunfermline,4565,5,10,15,11,46,46,0,45
Queen of S't,4565,6,11,10,15,43,51,-8,43
Raith,4565,7,10,10,16,38,51,-13,40
Dumbarton,4565,8,9,11,16,43,53,-10,38
St Mirren,4565,9,9,11,16,43,55,-12,38
Ayr,4565,10,7,12,17,30,61,-31,33
Hibernian,4566,1,18,12,6,52,26,26,66
Morton,4566,2,16,13,7,49,34,15,61
Dundee Utd,4566,3,16,9,11,52,43,9,57
Falkirk,4566,4,15,9,12,56,46,10,54
Queen of S't,4566,5,12,8,16,43,50,-7,44
St Mirren,4566,6,11,10,15,43,50,-7,43
Dunfermline,4566,7,9,15,12,48,50,-2,42
Raith,4566,8,10,10,16,37,49,-12,40
Ayr,4566,9,9,13,14,35,52,-17,40
Dumbarton,4566,10,9,11,16,46,61,-15,38
Hibernian,4567,1,19,11,6,54,24,30,68
Morton,4567,2,18,11,7,48,33,15,65
Falkirk,4567,3,16,11,9,56,39,17,59
Dundee Utd,4567,4,16,9,11,49,39,10,57
Queen of S't,4567,5,12,10,14,41,46,-5,46
Raith,4567,6,12,10,14,37,44,-7,46
Dunfermline,4567,7,9,14,13,44,49,-5,41
Dumbarton,4567,8,8,13,15,45,55,-10,37
Ayr,4567,9,7,12,17,30,58,-28,33
St Mirren,4567,10,7,11,18,34,51,-17,32
Hibernian,4568,1,20,11,5,57,24,33,71
Morton,4568,2,17,11,8,47,35,12,62
Falkirk,4568,3,17,10,9,59,43,16,61
Dundee Utd,4568,4,14,8,14,48,46,2,50
Queen of S't,4568,5,11,13,12,47,50,-3,46
Dunfermline,4568,6,11,12,13,48,44,4,45
St Mirren,4568,7,11,9,16,43,52,-9,42
Dumbarton,4568,8,10,11,15,48,57,-9,41
Raith,4568,9,9,11,16,33,49,-16,38
Ayr,4568,10,6,12,18,31,61,-30,30
Morton,4569,1,20,10,6,55,35,20,70
Hibernian,4569,2,18,10,8,58,33,25,64
Dundee Utd,4569,3,14,11,11,48,42,6,53
Falkirk,4569,4,14,10,12,54,45,9,52
Queen of S't,4569,5,14,8,14,49,52,-3,50
Raith,4569,6,12,8,16,38,50,-12,44
Ayr,4569,7,10,11,15,34,48,-14,41
Dunfermline,4569,8,9,13,14,49,54,-5,40
St Mirren,4569,9,10,10,16,45,57,-12,40
Dumbarton,4569,10,7,13,16,45,59,-14,34
Hibernian,4570,1,17,12,7,54,28,26,63
Morton,4570,2,17,11,8,50,35,15,62
Falkirk,4570,3,16,11,9,58,39,19,59
Dundee Utd,4570,4,14,11,11,53,42,11,53
Queen of S't,4570,5,13,10,13,50,47,3,49
Dunfermline,4570,6,12,12,12,48,47,1,48
Raith,4570,7,11,9,16,38,48,-10,42
Dumbarton,4570,8,10,12,14,50,63,-13,42
St Mirren,4570,9,8,10,18,35,62,-27,34
Ayr,4570,10,7,12,17,31,56,-25,33
Hibernian,4571,1,17,15,4,56,29,27,66
Dundee Utd,4571,2,18,9,9,56,40,16,63
Falkirk,4571,3,16,11,9,60,42,18,59
Morton,4571,4,15,14,7,49,40,9,59
Ayr,4571,5,11,11,14,47,58,-11,44
Dunfermline,4571,6,9,15,12,46,47,-1,42
Queen of S't,4571,7,9,12,15,44,55,-11,39
Raith,4571,8,10,9,17,37,50,-13,39
Dumbarton,4571,9,8,12,16,46,61,-15,36
St Mirren,4571,10,8,10,18,39,58,-19,34
Morton,4572,1,18,11,7,50,34,16,65
Hibernian,4572,2,17,13,6,54,28,26,64
Falkirk,4572,3,16,11,9,56,38,18,59
Dundee Utd,4572,4,14,9,13,45,42,3,51
Queen of S't,4572,5,14,8,14,45,48,-3,50
Dunfermline,4572,6,10,15,11,49,47,2,45
Ayr,4572,7,10,11,15,37,53,-16,41
Dumbarton,4572,8,9,12,15,48,57,-9,39
Raith,4572,9,10,8,18,32,49,-17,38
St Mirren,4572,10,8,10,18,37,57,-20,34
Morton,4573,1,20,10,6,57,31,26,70
Hibernian,4573,2,17,13,6,51,31,20,64
Falkirk,4573,3,17,9,10,58,43,15,60
Dundee Utd,4573,4,14,9,13,49,48,1,51
Queen of S't,4573,5,12,10,14,44,47,-3,46
Ayr,4573,6,10,14,12,42,49,-7,44
Raith,4573,7,10,10,16,33,47,-14,40
Dunfermline,4573,8,9,11,16,42,54,-12,38
Dumbarton,4573,9,9,10,17,56,66,-10,37
St Mirren,4573,10,8,12,16,37,53,-16,36
Hibernian,4574,1,20,11,5,58,30,28,71
Falkirk,4574,2,17,11,8,59,36,23,62
Morton,4574,3,17,10,9,55,40,15,61
Dundee Utd,4574,4,15,10,11,47,38,9,55
Queen of S't,4574,5,11,11,14,43,48,-5,44
Dunfermline,4574,6,10,13,13,42,47,-5,43
St Mirren,4574,7,10,10,16,43,55,-12,40
Raith,4574,8,9,10,17,33,52,-19,37
Dumbarton,4574,9,8,12,16,45,57,-12,36
Ayr,4574,10,7,14,15,33,55,-22,35
Falkirk,4575,1,18,11,7,62,38,24,65
Hibernian,4575,2,17,13,6,52,28,24,64
Morton,4575,3,18,10,8,55,39,16,64
Dundee Utd,4575,4,16,10,10,48,39,9,58
Dunfermline,4575,5,10,14,12,48,47,1,44
St Mirren,4575,6,11,11,14,45,54,-9,44
Queen of S't,4575,7,10,10,16,42,50,-8,40
Raith,4575,8,9,9,18,33,53,-20,36
Dumbarton,4575,9,8,11,17,48,61,-13,35
Ayr,4575,10,7,13,16,33,57,-24,34
Morton,4576,1,19,11,6,56,36,20,68
Hibernian,4576,2,17,15,4,53,27,26,66
Falkirk,4576,3,16,11,9,59,41,18,59
Dundee Utd,4576,4,16,8,12,51,40,11,56
Queen of S't,4576,5,11,12,13,47,50,-3,45
Ayr,4576,6,10,11,15,41,63,-22,41
Dunfermline,4576,7,9,13,14,44,50,-6,40
Dumbarton,4576,8,9,13,14,52,60,-8,40
St Mirren,4576,9,8,11,17,42,57,-15,35
Raith,4576,10,8,9,19,34,55,-21,33
Falkirk,4577,1,17,11,8,61,39,22,62
Hibernian,4577,2,17,11,8,51,32,19,62
Dundee Utd,4577,3,15,13,8,47,37,10,58
Morton,4577,4,15,12,9,47,36,11,57
Raith,4577,5,12,9,15,37,49,-12,45
Queen of S't,4577,6,10,11,15,42,49,-7,41
St Mirren,4577,7,9,13,14,43,50,-7,40
Dunfermline,4577,8,8,15,13,47,54,-7,39
Dumbarton,4577,9,9,12,15,47,56,-9,39
Ayr,4577,10,7,15,14,33,53,-20,36
Hibernian,4578,1,21,10,5,65,29,36,73
Morton,4578,2,16,11,9,49,41,8,59
Falkirk,4578,3,16,10,10,56,38,18,58
Dundee Utd,4578,4,16,10,10,51,42,9,58
Dumbarton,4578,5,11,13,12,53,54,-1,46
Dunfermline,4578,6,10,14,12,47,47,0,44
Queen of S't,4578,7,10,10,16,47,54,-7,40
Ayr,4578,8,9,11,16,39,58,-19,38
St Mirren,4578,9,9,9,18,42,63,-21,36
Raith,4578,10,8,10,18,35,58,-23,34
Hibernian,4579,1,20,12,4,59,26,33,72
Falkirk,4579,2,16,11,9,61,42,19,59
Dundee Utd,4579,3,16,9,11,55,43,12,57
Morton,4579,4,14,12,10,47,42,5,54
Dunfermline,4579,5,11,14,11,50,46,4,47
Raith,4579,6,12,8,16,35,46,-11,44
Queen of S't,4579,7,10,10,16,47,55,-8,40
Dumbarton,4579,8,9,13,14,51,63,-12,40
Ayr,4579,9,8,12,16,35,56,-21,36
St Mirren,4579,10,8,11,17,37,58,-21,35
Hibernian,4580,1,20,12,4,56,25,31,72
Morton,4580,2,18,12,6,52,32,20,66
Dundee Utd,4580,3,18,9,9,53,34,19,63
Falkirk,4580,4,17,10,9,58,38,20,61
Queen of S't,4580,5,11,10,15,47,56,-9,43
Dunfermline,4580,6,8,16,12,44,52,-8,40
Raith,4580,7,9,9,18,34,50,-16,36
St Mirren,4580,8,9,9,18,38,55,-17,36
Ayr,4580,9,8,12,16,31,54,-23,36
Dumbarton,4580,10,7,11,18,44,61,-17,32
Hibernian,4581,1,20,13,3,54,24,30,73
Morton,4581,2,16,12,8,46,34,12,60
Falkirk,4581,3,16,11,9,60,39,21,59
Dundee Utd,4581,4,15,10,11,47,41,6,55
Queen of S't,4581,5,12,9,15,49,53,-4,45
Ayr,4581,6,11,11,14,40,52,-12,44
Dumbarton,4581,7,9,13,14,46,55,-9,40
Raith,4581,8,10,8,18,35,52,-17,38
Dunfermline,4581,9,8,12,16,43,55,-12,36
St Mirren,4581,10,8,11,17,37,52,-15,35
Hibernian,4582,1,17,13,6,51,26,25,64
Morton,4582,2,17,10,9,51,35,16,61
Dundee Utd,4582,3,17,10,9,55,42,13,61
Falkirk,4582,4,16,10,10,60,42,18,58
Raith,4582,5,12,10,14,40,49,-9,46
Dunfermline,4582,6,10,15,11,43,42,1,45
Queen of S't,4582,7,11,10,15,43,52,-9,43
St Mirren,4582,8,9,11,16,40,54,-14,38
Dumbarton,4582,9,7,13,16,44,62,-18,34
Ayr,4582,10,7,12,17,41,64,-23,33
Hibernian,4583,1,18,13,5,53,27,26,67
Falkirk,4583,2,18,10,8,63,41,22,64
Morton,4583,3,14,13,9,47,42,5,55
Dunfermline,4583,4,14,11,11,55,45,10,53
Dundee Utd,4583,5,14,11,11,46,40,6,53
Queen of S't,4583,6,11,10,15,43,50,-7,43
Ayr,4583,7,9,13,14,33,56,-23,40
Raith,4583,8,10,9,17,38,48,-10,39
Dumbarton,4583,9,8,12,16,52,65,-13,36
St Mirren,4583,10,8,10,18,41,57,-16,34
Hibernian,4584,1,18,12,6,52,26,26,66
Falkirk,4584,2,16,10,10,56,41,15,58
Morton,4584,3,16,10,10,47,39,8,58
Dundee Utd,4584,4,16,9,11,51,40,11,57
Queen of S't,4584,5,14,9,13,49,50,-1,51
Dunfermline,4584,6,10,13,13,46,47,-1,43
St Mirren,4584,7,11,10,15,44,50,-6,43
Raith,4584,8,10,9,17,33,49,-16,39
Ayr,4584,9,8,13,15,30,51,-21,37
Dumbarton,4584,10,8,11,17,45,60,-15,35
Hibernian,4585,1,18,14,4,53,23,30,68
Morton,4585,2,17,12,7,58,41,17,63
Falkirk,4585,3,17,11,8,59,37,22,62
Dundee Utd,4585,4,15,9,12,51,42,9,54
Queen of S't,4585,5,11,11,14,41,46,-5,44
Dunfermline,4585,6,9,14,13,46,49,-3,41
Ayr,4585,7,10,10,16,35,59,-24,40
St Mirren,4585,8,9,11,16,40,56,-16,38
Dumbarton,4585,9,9,10,17,45,59,-14,37
Raith,4585,10,8,12,16,37,53,-16,36
Hibernian,4586,1,21,11,4,56,25,31,74
Dundee Utd,4586,2,19,8,9,60,39,21,65
Falkirk,4586,3,18,10,8,61,36,25,64
Morton,4586,4,16,10,10,51,38,13,58
Queen of S't,4586,5,11,10,15,44,48,-4,43
Raith,4586,6,11,8,17,36,50,-14,41
Dunfermline,4586,7,9,12,15,44,49,-5,39
St Mirren,4586,8,9,10,17,40,59,-19,37
Dumbarton,4586,9,8,11,17,42,62,-20,35
Ayr,4586,10,7,12,17,36,64,-28,33
Hibernian,4587,1,20,11,5,57,24,33,71
Dundee Utd,4587,2,17,10,9,54,40,14,61
Morton,4587,3,16,11,9,52,39,13,59
Falkirk,4587,4,15,10,11,55,44,11,55
Dunfermline,4587,5,10,13,13,44,48,-4,43
Queen of S't,4587,6,11,9,16,44,51,-7,42
Raith,4587,7,11,9,16,32,46,-14,42
Dumbarton,4587,8,9,14,13,50,57,-7,41
St Mirren,4587,9,10,10,16,42,57,-15,40
Ayr,4587,10,7,11,18,35,59,-24,32
Hibernian,4588,1,22,11,3,61,22,39,77
Dundee Utd,4588,2,17,10,9,57,43,14,61
Morton,4588,3,16,13,7,49,38,11,61
Queen of S't,4588,4,15,9,12,50,44,6,54
Falkirk,4588,5,14,9,13,52,48,4,51
Dunfermline,4588,6,9,12,15,45,48,-3,39
Raith,4588,7,10,9,17,35,53,-18,39
Dumbarton,4588,8,9,11,16,47,62,-15,38
St Mirren,4588,9,9,10,17,45,55,-10,37
Ayr,4588,10,6,12,18,34,62,-28,30
Hibernian,4589,1,18,13,5,54,26,28,67
Morton,4589,2,18,10,8,51,37,14,64
Falkirk,4589,3,15,12,9,59,43,16,57
Dundee Utd,4589,4,15,9,12,49,38,11,54
Queen of S't,4589,5,12,10,14,45,51,-6,46
Dunfermline,4589,6,11,12,13,51,50,1,45
Dumbarton,4589,7,10,11,15,52,59,-7,41
St Mirren,4589,8,10,11,15,46,54,-8,41
Raith,4589,9,9,10,17,35,51,-16,37
Ayr,4589,10,7,12,17,32,65,-33,33
Hibernian,4590,1,20,12,4,58,23,35,72
Falkirk,4590,2,15,13,8,54,38,16,58
Morton,4590,3,14,11,11,46,43,3,53
Dunfermline,4590,4,12,14,10,50,45,5,50
Dundee Utd,4590,5,13,11,12,49,47,2,50
Queen of S't,4590,6,12,10,14,45,47,-2,46
Dumbarton,4590,7,11,11,14,49,54,-5,44
Ayr,4590,8,9,13,14,33,51,-18,40
St Mirren,4590,9,8,11,17,35,51,-16,35
Raith,4590,10,9,8,19,30,50,-20,35
Hibernian,4591,1,18,12,6,59,30,29,66
Morton,4591,2,18,11,7,63,36,27,65
Dundee Utd,4591,3,18,8,10,62,40,22,62
Falkirk,4591,4,17,10,9,62,42,20,61
Dunfermline,4591,5,10,13,13,44,53,-9,43
Raith,4591,6,10,11,15,36,52,-16,41
Dumbarton,4591,7,10,10,16,45,62,-17,40
Queen of S't,4591,8,10,9,17,41,50,-9,39
Ayr,4591,9,9,12,15,33,53,-20,39
St Mirren,4591,10,7,10,19,38,65,-27,31
Hibernian,4592,1,19,12,5,58,24,34,69
Morton,4592,2,19,9,8,52,35,17,66
Falkirk,4592,3,17,10,9,65,42,23,61
Dunfermline,4592,4,13,13,10,53,42,11,52
Dundee Utd,4592,5,13,9,14,46,49,-3,48
Queen of S't,4592,6,11,10,15,45,54,-9,43
Raith,4592,7,10,10,16,33,49,-16,40
Dumbarton,4592,8,9,12,15,46,59,-13,39
St Mirren,4592,9,8,11,17,35,56,-21,35
Ayr,4592,10,7,12,17,33,56,-23,33
Morton,4593,1,18,11,7,57,39,18,65
Hibernian,4593,2,17,13,6,52,29,23,64
Dundee Utd,4593,3,18,8,10,52,39,13,62
Falkirk,4593,4,14,13,9,55,42,13,55
Queen of S't,4593,5,13,9,14,51,49,2,48
Dumbarton,4593,6,11,11,14,51,57,-6,44
Dunfermline,4593,7,10,13,13,46,48,-2,43
Raith,4593,8,9,10,17,32,52,-20,37
St Mirren,4593,9,8,10,18,41,57,-16,34
Ayr,4593,10,8,10,18,34,59,-25,34
Hibernian,4594,1,20,11,5,58,25,33,71
Morton,4594,2,19,10,7,54,37,17,67
Dundee Utd,4594,3,16,9,11,45,40,5,57
Falkirk,4594,4,13,13,10,57,45,12,52
Dumbarton,4594,5,11,12,13,51,55,-4,45
Queen of S't,4594,6,12,9,15,43,47,-4,45
Raith,4594,7,11,10,15,39,51,-12,43
Dunfermline,4594,8,9,12,15,43,49,-6,39
Ayr,4594,9,8,13,15,34,52,-18,37
St Mirren,4594,10,6,11,19,41,64,-23,29
Hibernian,4595,1,18,12,6,48,27,21,66
Morton,4595,2,15,15,6,47,32,15,60
Falkirk,4595,3,16,10,10,59,41,18,58
Dundee Utd,4595,4,16,8,12,48,42,6,56
Queen of S't,4595,5,12,10,14,46,47,-1,46
Dunfermline,4595,6,10,13,13,42,48,-6,43
Dumbarton,4595,7,10,12,14,50,57,-7,42
Ayr,4595,8,8,15,13,36,51,-15,39
Raith,4595,9,9,10,17,32,49,-17,37
St Mirren,4595,10,9,9,18,42,56,-14,36
Hibernian,4596,1,19,12,5,54,24,30,69
Morton,4596,2,18,10,8,55,35,20,64
Falkirk,4596,3,16,10,10,56,40,16,58
Dundee Utd,4596,4,16,9,11,53,44,9,57
Queen of S't,4596,5,12,9,15,45,50,-5,45
Dumbarton,4596,6,10,12,14,50,57,-7,42
Raith,4596,7,11,9,16,34,50,-16,42
Dunfermline,4596,8,10,11,15,47,54,-7,41
Ayr,4596,9,8,13,15,35,53,-18,37
St Mirren,4596,10,7,11,18,37,59,-22,32
Hibernian,4597,1,18,12,6,51,25,26,66
Falkirk,4597,2,16,11,9,57,39,18,59
Morton,4597,3,16,11,9,49,38,11,59
Queen of S't,4597,4,13,11,12,50,49,1,50
Dundee Utd,4597,5,13,10,13,44,43,1,49
Dumbarton,4597,6,11,13,12,52,54,-2,46
Dunfermline,4597,7,10,14,12,46,48,-2,44
St Mirren,4597,8,10,9,17,40,52,-12,39
Raith,4597,9,10,8,18,33,50,-17,38
Ayr,4597,10,8,11,17,34,58,-24,35
Hibernian,4598,1,20,11,5,57,27,30,71
Falkirk,4598,2,17,9,10,66,44,22,60
Morton,4598,3,16,11,9,49,37,12,59
Dundee Utd,4598,4,16,8,12,48,39,9,56
Dunfermline,4598,5,11,13,12,47,44,3,46
Queen of S't,4598,6,11,9,16,45,55,-10,42
Ayr,4598,7,10,11,15,36,53,-17,41
Dumbarton,4598,8,9,11,16,44,56,-12,38
Raith,4598,9,9,11,16,33,55,-22,38
St Mirren,4598,10,9,10,17,39,54,-15,37
Hibernian,4599,1,19,13,4,61,26,35,70
Morton,4599,2,16,14,6,54,39,15,62
Dundee Utd,4599,3,16,10,10,48,39,9,58
Falkirk,4599,4,16,9,11,59,44,15,57
Dumbarton,4599,5,11,11,14,48,53,-5,44
Raith,4599,6,11,9,16,36,48,-12,42
Ayr,4599,7,10,11,15,37,54,-17,41
Dunfermline,4599,8,9,12,15,43,49,-6,39
Queen of S't,4599,9,9,10,17,43,57,-14,37
St Mirren,4599,10,8,11,17,39,59,-20,35
Hibernian,4600,1,20,12,4,55,25,30,72
Morton,4600,2,16,13,7,50,33,17,61
Falkirk,4600,3,15,12,9,60,42,18,57
Dundee Utd,4600,4,15,11,10,51,41,10,56
Queen of S't,4600,5,12,8,16,47,52,-5,44
Dunfermline,4600,6,9,13,14,45,49,-4,40
St Mirren,4600,7,10,10,16,41,51,-10,40
Raith,4600,8,10,10,16,31,48,-17,40
Ayr,4600,9,8,13,15,36,59,-23,37
Dumbarton,4600,10,8,12,16,44,60,-16,36
Hibernian,4601,1,20,11,5,61,25,36,71
Morton,4601,2,18,13,5,53,31,22,67
Falkirk,4601,3,17,10,9,59,39,20,61
Dundee Utd,4601,4,14,11,11,46,41,5,53
Dunfermline,4601,5,9,15,12,45,47,-2,42
Queen of S't,4601,6,11,9,16,42,53,-11,42
Ayr,4601,7,10,11,15,34,54,-20,41
Raith,4601,8,9,11,16,36,51,-15,38
Dumbarton,4601,9,7,13,16,46,61,-15,34
St Mirren,4601,10,7,12,17,36,56,-20,33
Hibernian,4602,1,19,14,3,54,23,31,71
Falkirk,4602,2,16,12,8,62,40,22,60
Morton,4602,3,16,10,10,46,37,9,58
Dundee Utd,4602,4,15,11,10,50,40,10,56
Queen of S't,4602,5,13,9,14,48,50,-2,48
Raith,4602,6,10,10,16,32,48,-16,40
Ayr,4602,7,9,12,15,38,57,-19,39
Dunfermline,4602,8,9,11,16,41,51,-10,38
Dumbarton,4602,9,9,11,16,47,59,-12,38
St Mirren,4602,10,8,12,16,41,54,-13,36
Hibernian,4603,1,19,12,5,54,27,27,69
Falkirk,4603,2,17,11,8,62,37,25,62
Morton,4603,3,17,10,9,50,34,16,61
Dundee Utd,4603,4,14,10,12,44,42,2,52
Queen of S't,4603,5,13,9,14,50,50,0,48
St Mirren,4603,6,11,10,15,41,51,-10,43
Raith,4603,7,10,10,16,34,48,-14,40
Dunfermline,4603,8,9,12,15,42,55,-13,39
Ayr,4603,9,9,11,16,37,55,-18,38
Dumbarton,4603,10,8,11,17,43,58,-15,35
Morton,4604,1,17,12,7,51,35,16,63
Hibernian,4604,2,16,13,7,48,27,21,61
Falkirk,4604,3,16,11,9,56,38,18,59
Dundee Utd,4604,4,15,12,9,47,37,10,57
Dumbarton,4604,5,11,12,13,52,52,0,45
Queen of S't,4604,6,11,11,14,43,50,-7,44
Dunfermline,4604,7,10,13,13,47,52,-5,43
Raith,4604,8,11,9,16,35,46,-11,42
St Mirren,4604,9,8,10,18,36,57,-21,34
Ayr,4604,10,7,13,16,28,49,-21,34
Hibernian,4605,1,18,12,6,56,26,30,66
Morton,4605,2,16,14,6,51,37,14,62
Falkirk,4605,3,16,13,7,61,38,23,61
Dundee Utd,4605,4,13,12,11,46,42,4,51
Queen of S't,4605,5,12,10,14,44,49,-5,46
Dunfermline,4605,6,10,13,13,48,51,-3,43
Dumbarton,4605,7,8,14,14,49,58,-9,38
Ayr,4605,8,8,14,14,33,52,-19,38
Raith,4605,9,8,13,15,34,51,-17,37
St Mirren,4605,10,7,13,16,38,56,-18,34
Hibernian,4606,1,19,12,5,55,25,30,69
Morton,4606,2,16,14,6,48,36,12,62
Dundee Utd,4606,3,16,11,9,50,37,13,59
Falkirk,4606,4,14,10,12,52,45,7,52
Queen of S't,4606,5,12,9,15,46,50,-4,45
Dunfermline,4606,6,10,12,14,50,51,-1,42
Ayr,4606,7,10,11,15,38,53,-15,41
Raith,4606,8,11,8,17,33,49,-16,41
St Mirren,4606,9,10,9,17,42,54,-12,39
Dumbarton,4606,10,8,12,16,48,62,-14,36
Hibernian,4607,1,19,13,4,61,27,34,70
Falkirk,4607,2,17,12,7,61,39,22,63
Morton,4607,3,17,11,8,48,34,14,62
Dundee Utd,4607,4,15,10,11,50,43,7,55
Dunfermline,4607,5,10,13,13,46,46,0,43
St Mirren,4607,6,10,11,15,43,56,-13,41
Ayr,4607,7,8,14,14,36,51,-15,38
Queen of S't,4607,8,10,8,18,40,59,-19,38
Dumbarton,4607,9,9,10,17,46,58,-12,37
Raith,4607,10,9,10,17,34,52,-18,37
Hibernian,4608,1,21,10,5,61,25,36,73
Falkirk,4608,2,17,9,10,60,43,17,60
Morton,4608,3,16,10,10,50,41,9,58
Dundee Utd,4608,4,16,9,11,49,42,7,57
Dumbarton,4608,5,11,11,14,52,57,-5,44
Queen of S't,4608,6,12,8,16,45,57,-12,44
Raith,4608,7,11,8,17,35,47,-12,41
Ayr,4608,8,10,11,15,39,58,-19,41
Dunfermline,4608,9,9,11,16,45,51,-6,38
St Mirren,4608,10,8,11,17,42,57,-15,35
Hibernian,4609,1,19,13,4,57,22,35,70
Morton,4609,2,19,10,7,54,34,20,67
Dundee Utd,4609,3,16,9,11,49,40,9,57
Falkirk,4609,4,14,10,12,54,46,8,52
Dunfermline,4609,5,12,13,11,53,48,5,49
Raith,4609,6,11,10,15,34,46,-12,43
Dumbarton,4609,7,10,10,16,47,60,-13,40
Queen of S't,4609,8,10,9,17,40,52,-12,39
Ayr,4609,9,9,10,17,31,52,-21,37
St Mirren,4609,10,8,10,18,36,55,-19,34
Hibernian,4610,1,21,11,4,59,24,35,74
Falkirk,4610,2,18,10,8,66,42,24,64
Morton,4610,3,18,9,9,47,33,14,63
Dundee Utd,4610,4,14,9,13,45,44,1,51
Queen of S't,4610,5,13,9,14,45,46,-1,48
Dunfermline,4610,6,9,13,14,44,49,-5,40
Dumbarton,4610,7,10,10,16,48,60,-12,40
Ayr,4610,8,9,11,16,33,54,-21,38
Raith,4610,9,9,10,17,32,52,-20,37
St Mirren,4610,10,8,10,18,41,56,-15,34
Hibernian,4611,1,19,12,5,56,26,30,69
Dundee Utd,4611,2,16,9,11,52,43,9,57
Morton,4611,3,15,12,9,48,40,8,57
Falkirk,4611,4,13,14,9,56,44,12,53
Queen of S't,4611,5,13,10,13,52,55,-3,49
Dunfermline,4611,6,10,12,14,48,49,-1,42
Raith,4611,7,10,11,15,38,51,-13,41
Dumbarton,4611,8,9,13,14,47,52,-5,40
St Mirren,4611,9,9,11,16,42,55,-13,38
Ayr,4611,10,7,14,15,33,57,-24,35
Hibernian,4612,1,19,13,4,54,23,31,70
Morton,4612,2,18,12,6,54,35,19,66
Falkirk,4612,3,15,11,10,57,44,13,56
Dundee Utd,4612,4,15,11,10,51,39,12,56
Dumbarton,4612,5,11,12,13,49,52,-3,45
Dunfermline,4612,6,9,15,12,47,53,-6,42
Queen of S't,4612,7,10,10,16,40,49,-9,40
Raith,4612,8,9,10,17,32,50,-18,37
Ayr,4612,9,7,15,14,34,53,-19,36
St Mirren,4612,10,8,9,19,39,59,-20,33
Hibernian,4613,1,18,14,4,53,25,28,68
Falkirk,4613,2,18,11,7,69,41,28,65
Morton,4613,3,17,12,7,51,33,18,63
Dundee Utd,4613,4,18,9,9,52,39,13,63
Dumbarton,4613,5,10,12,14,47,55,-8,42
Raith,4613,6,10,12,14,38,48,-10,42
Queen of S't,4613,7,10,10,16,45,55,-10,40
St Mirren,4613,8,8,10,18,37,56,-19,34
Dunfermline,4613,9,7,12,17,42,60,-18,33
Ayr,4613,10,7,12,17,34,56,-22,33
Hibernian,4614,1,20,12,4,58,26,32,72
Dundee Utd,4614,2,17,9,10,52,39,13,60
Falkirk,4614,3,16,9,11,60,46,14,57
Morton,4614,4,14,13,9,48,40,8,55
Dunfermline,4614,5,10,14,12,49,50,-1,44
Dumbarton,4614,6,11,11,14,52,55,-3,44
Raith,4614,7,11,10,15,38,49,-11,43
Queen of S't,4614,8,11,8,17,45,56,-11,41
St Mirren,4614,9,9,9,18,38,56,-18,36
Ayr,4614,10,8,11,17,34,57,-23,35
Hibernian,4615,1,19,10,7,55,29,26,67
Morton,4615,2,17,11,8,51,34,17,62
Falkirk,4615,3,15,12,9,57,42,15,57
Dundee Utd,4615,4,15,10,11,48,44,4,55
Dunfermline,4615,5,10,15,11,49,46,3,45
Dumbarton,4615,6,11,12,13,49,54,-5,45
Ayr,4615,7,10,12,14,35,50,-15,42
Queen of S't,4615,8,10,11,15,44,52,-8,41
Raith,4615,9,10,9,17,34,48,-14,39
St Mirren,4615,10,7,10,19,36,59,-23,31
Hibernian,4616,1,20,13,3,61,23,38,73
Falkirk,4616,2,18,11,7,61,37,24,65
Dundee Utd,4616,3,17,9,10,52,40,12,60
Morton,4616,4,17,9,10,46,37,9,60
Queen of S't,4616,5,11,10,15,49,60,-11,43
Raith,4616,6,10,11,15,35,47,-12,41
Dumbarton,4616,7,9,13,14,48,59,-11,40
Dunfermline,4616,8,8,14,14,39,47,-8,38
St Mirren,4616,9,8,11,17,46,57,-11,35
Ayr,4616,10,6,11,19,32,62,-30,29
Hibernian,4617,1,19,11,6,55,26,29,68
Morton,4617,2,16,12,8,49,39,10,60
Falkirk,4617,3,16,10,10,56,39,17,58
Dundee Utd,4617,4,15,10,11,45,38,7,55
Dunfermline,4617,5,11,14,11,51,46,5,47
Queen of S't,4617,6,12,10,14,45,49,-4,46
St Mirren,4617,7,11,9,16,47,56,-9,42
Raith,4617,8,9,12,15,32,49,-17,39
Ayr,4617,9,8,12,16,31,54,-23,36
Dumbarton,4617,10,8,10,18,42,57,-15,34
Hibernian,4618,1,19,13,4,55,25,30,70
Morton,4618,2,17,12,7,55,40,15,63
Dundee Utd,4618,3,16,11,9,47,37,10,59
Falkirk,4618,4,14,12,10,58,41,17,54
Raith,4618,5,11,11,14,35,45,-10,44
Queen of S't,4618,6,11,9,16,42,49,-7,42
Dumbarton,4618,7,10,12,14,47,56,-9,42
Dunfermline,4618,8,9,14,13,47,51,-4,41
Ayr,4618,9,8,12,16,35,55,-20,36
St Mirren,4618,10,7,10,19,38,60,-22,31
Hibernian,4619,1,17,14,5,52,25,27,65
Morton,4619,2,16,13,7,50,36,14,61
Dundee Utd,4619,3,17,9,10,55,43,12,60
Falkirk,4619,4,15,10,11,56,41,15,55
Dunfermline,4619,5,10,14,12,45,46,-1,44
Dumbarton,4619,6,11,10,15,52,58,-6,43
Queen of S't,4619,7,10,12,14,47,51,-4,42
Raith,4619,8,8,13,15,35,51,-16,37
Ayr,4619,9,8,13,15,34,60,-26,37
St Mirren,4619,10,8,12,16,41,56,-15,36
Hibernian,4620,1,18,14,4,52,25,27,68
Dundee Utd,4620,2,17,9,10,57,44,13,60
Falkirk,4620,3,16,10,10,60,41,19,58
Morton,4620,4,13,13,10,44,40,4,52
Dunfermline,4620,5,12,14,10,48,42,6,50
Queen of S't,4620,6,12,9,15,46,51,-5,45
Raith,4620,7,10,9,17,35,51,-16,39
Ayr,4620,8,9,11,16,40,55,-15,38
St Mirren,4620,9,8,13,15,42,54,-12,37
Dumbarton,4620,10,8,12,16,42,63,-21,36
Hibernian,4621,1,17,13,6,51,26,25,64
Dundee Utd,4621,2,17,9,10,51,37,14,60
Falkirk,4621,3,16,10,10,59,40,19,58
Morton,4621,4,15,13,8,46,36,10,58
Ayr,4621,5,11,11,14,35,50,-15,44
Queen of S't,4621,6,11,9,16,46,49,-3,42
Dunfermline,4621,7,10,12,14,46,56,-10,42
Dumbarton,4621,8,10,11,15,51,56,-5,41
Raith,4621,9,11,8,17,35,51,-16,41
St Mirren,4621,10,9,10,17,38,57,-19,37
Hibernian,4622,1,17,13,6,46,24,22,64
Morton,4622,2,17,11,8,50,35,15,62
Dundee Utd,4622,3,17,10,9,63,39,24,61
Falkirk,4622,4,16,12,8,63,44,19,60
Queen of S't,4622,5,12,9,15,43,49,-6,45
Dumbarton,4622,6,11,11,14,56,58,-2,44
Raith,4622,7,11,10,15,34,45,-11,43
Dunfermline,4622,8,9,12,15,44,51,-7,39
Ayr,4622,9,8,12,16,31,57,-26,36
St Mirren,4622,10,7,10,19,37,65,-28,31
Hibernian,4623,1,19,11,6,60,31,29,68
Morton,4623,2,18,12,6,55,35,20,66
Dundee Utd,4623,3,16,10,10,50,38,12,58
Falkirk,4623,4,14,10,12,55,46,9,52
Dunfermline,4623,5,11,12,13,51,51,0,45
Raith,4623,6,12,8,16,45,54,-9,44
Ayr,4623,7,9,13,14,34,54,-20,40
Queen of S't,4623,8,10,9,17,41,52,-11,39
St Mirren,4623,9,9,12,15,41,55,-14,39
Dumbarton,4623,10,8,11,17,43,59,-16,35
Morton,4624,1,18,10,8,50,35,15,64
Dundee Utd,4624,2,18,10,8,49,35,14,64
Hibernian,4624,3,16,12,8,47,27,20,60
Falkirk,4624,4,16,10,10,57,40,17,58
Dunfermline,4624,5,12,11,13,51,48,3,47
Raith,4624,6,12,10,14,36,46,-10,46
Dumbarton,4624,7,10,13,13,50,56,-6,43
Queen of S't,4624,8,9,11,16,42,52,-10,38
Ayr,4624,9,7,12,17,31,53,-22,33
St Mirren,4624,10,7,11,18,35,56,-21,32
Hibernian,4625,1,18,15,3,56,24,32,69
Dundee Utd,4625,2,18,8,10,56,37,19,62
Morton,4625,3,17,10,9,51,39,12,61
Falkirk,4625,4,16,10,10,56,41,15,58
Queen of S't,4625,5,11,11,14,42,47,-5,44
St Mirren,4625,6,10,10,16,40,50,-10,40
Raith,4625,7,10,10,16,35,50,-15,40
Dunfermline,4625,8,8,14,14,43,49,-6,38
Dumbarton,4625,9,9,11,16,45,59,-14,38
Ayr,4625,10,7,13,16,30,58,-28,34
Hibernian,4626,1,20,11,5,55,24,31,71
Dundee Utd,4626,2,20,8,8,57,37,20,68
Morton,4626,3,16,11,9,45,38,7,59
Falkirk,4626,4,15,9,12,54,40,14,54
Queen of S't,4626,5,12,9,15,47,49,-2,45
Raith,4626,6,11,9,16,35,49,-14,42
Dunfermline,4626,7,10,11,15,47,50,-3,41
Dumbarton,4626,8,10,11,15,49,59,-10,41
St Mirren,4626,9,10,9,17,40,54,-14,39
Ayr,4626,10,6,12,18,32,61,-29,30
Hibernian,4627,1,21,11,4,62,25,37,74
Dundee Utd,4627,2,17,9,10,50,39,11,60
Falkirk,4627,3,16,11,9,60,40,20,59
Morton,4627,4,15,10,11,46,45,1,55
Dunfermline,4627,5,12,12,12,51,49,2,48
Raith,4627,6,11,10,15,38,47,-9,43
Queen of S't,4627,7,10,11,15,46,56,-10,41
St Mirren,4627,8,9,10,17,42,56,-14,37
Dumbarton,4627,9,8,11,17,45,59,-14,35
Ayr,4627,10,7,13,16,36,60,-24,34
Morton,4628,1,20,10,6,56,31,25,70
Hibernian,4628,2,18,12,6,52,27,25,66
Dundee Utd,4628,3,15,11,10,45,39,6,56
Falkirk,4628,4,15,10,11,57,45,12,55
Dunfermline,4628,5,10,14,12,44,47,-3,44
Queen of S't,4628,6,10,12,14,41,48,-7,42
Raith,4628,7,10,11,15,33,45,-12,41
St Mirren,4628,8,9,11,16,43,56,-13,38
Dumbarton,4628,9,8,11,17,52,62,-10,35
Ayr,4628,10,7,14,15,36,59,-23,35
Hibernian,4629,1,19,11,6,55,25,30,68
Morton,4629,2,19,11,6,55,33,22,68
Falkirk,4629,3,14,10,12,53,45,8,52
Dundee Utd,4629,4,14,10,12,43,39,4,52
Queen of S't,4629,5,13,11,12,42,43,-1,50
Dumbarton,4629,6,10,13,13,47,53,-6,43
Dunfermline,4629,7,10,12,14,47,49,-2,42
St Mirren,4629,8,9,11,16,40,49,-9,38
Ayr,4629,9,9,11,16,33,57,-24,38
Raith,4629,10,9,8,19,33,55,-22,35
Hibernian,4630,1,18,12,6,56,29,27,66
Morton,4630,2,18,11,7,50,36,14,65
Dundee Utd,4630,3,16,11,9,56,37,19,59
Falkirk,4630,4,15,9,12,53,44,9,54
Queen of S't,4630,5,13,8,15,47,50,-3,47
Dunfermline,4630,6,11,12,13,45,46,-1,45
Raith,4630,7,11,9,16,38,47,-9,42
Ayr,4630,8,8,14,14,33,52,-19,38
Dumbarton,4630,9,9,10,17,45,63,-18,37
St Mirren,4630,10,8,10,18,42,61,-19,34
Hibernian,4631,1,19,12,5,58,30,28,69
Dundee Utd,4631,2,18,9,9,53,40,13,63
Falkirk,4631,3,16,11,9,61,44,17,59
Morton,4631,4,15,13,8,51,40,11,58
Queen of S't,4631,5,11,11,14,48,51,-3,44
Dunfermline,4631,6,10,13,13,44,48,-4,43
Raith,4631,7,9,11,16,32,48,-16,38
St Mirren,4631,8,9,10,17,47,59,-12,37
Ayr,4631,9,8,13,15,37,55,-18,37
Dumbarton,4631,10,8,11,17,45,61,-16,35
Hibernian,4632,1,20,13,3,61,24,37,73
Morton,4632,2,16,12,8,53,41,12,60
Dundee Utd,4632,3,16,9,11,51,40,11,57
Falkirk,4632,4,14,11,11,56,47,9,53
Queen of S't,4632,5,12,10,14,46,50,-4,46
St Mirren,4632,6,11,10,15,46,56,-10,43
Dunfermline,4632,7,9,15,12,44,47,-3,42
Dumbarton,4632,8,8,13,15,49,58,-9,37
Ayr,4632,9,9,10,17,34,58,-24,37
Raith,4632,10,9,9,18,33,52,-19,36
Hibernian,4633,1,20,13,3,58,23,35,73
Dundee Utd,4633,2,17,9,10,50,41,9,60
Morton,4633,3,16,11,9,47,36,11,59
Falkirk,4633,4,16,10,10,55,39,16,58
Dunfermline,4633,5,11,13,12,51,46,5,46
Queen of S't,4633,6,11,9,16,42,52,-10,42
St Mirren,4633,7,10,9,17,39,54,-15,39
Dumbarton,4633,8,8,12,16,45,58,-13,36
Raith,4633,9,9,9,18,33,51,-18,36
Ayr,4633,10,7,15,14,34,54,-20,36
Hibernian,4634,1,17,12,7,54,33,21,63
Falkirk,4634,2,16,11,9,56,39,17,59
Dundee Utd,4634,3,15,12,9,50,38,12,57
Morton,4634,4,15,11,10,46,36,10,56
Dunfermline,4634,5,12,11,13,51,51,0,47
Queen of S't,4634,6,12,10,14,47,50,-3,46
Raith,4634,7,11,10,15,35,45,-10,43
Ayr,4634,8,8,14,14,36,51,-15,38
St Mirren,4634,9,8,13,15,44,58,-14,37
Dumbarton,4634,10,9,10,17,48,66,-18,37
Hibernian,4635,1,21,12,3,62,23,39,75
Morton,4635,2,18,9,9,50,36,14,63
Falkirk,4635,3,15,12,9,55,40,15,57
Dundee Utd,4635,4,14,10,12,43,40,3,52
Dunfermline,4635,5,11,12,13,48,50,-2,45
Queen of S't,4635,6,12,9,15,44,49,-5,45
Raith,4635,7,11,10,15,38,47,-9,43
Dumbarton,4635,8,10,11,15,48,55,-7,41
Ayr,4635,9,8,11,17,37,60,-23,35
St Mirren,4635,10,7,10,19,39,64,-25,31
Hibernian,4636,1,18,14,4,56,25,31,68
Falkirk,4636,2,17,11,8,61,37,24,62
Dundee Utd,4636,3,17,9,10,57,40,17,60
Morton,4636,4,16,11,9,48,39,9,59
Queen of S't,4636,5,13,10,13,47,50,-3,49
Dunfermline,4636,6,12,11,13,47,47,0,47
Dumbarton,4636,7,9,12,15,48,57,-9,39
Ayr,4636,8,8,12,16,32,56,-24,36
Raith,4636,9,8,10,18,29,51,-22,34
St Mirren,4636,10,7,10,19,37,60,-23,31
Hibernian,4637,1,20,12,4,60,25,35,72
Morton,4637,2,17,12,7,49,33,16,63
Falkirk,4637,3,16,10,10,57,37,20,58
Dundee Utd,4637,4,15,10,11,48,41,7,55
Dunfermline,4637,5,11,13,12,46,47,-1,46
Raith,4637,6,11,10,15,35,46,-11,43
Dumbarton,4637,7,9,15,12,50,54,-4,42
Queen of S't,4637,8,9,11,16,39,53,-14,38
St Mirren,4637,9,7,11,18,38,59,-21,32
Ayr,4637,10,6,14,16,31,58,-27,32
Hibernian,4638,1,21,11,4,57,21,36,74
Falkirk,4638,2,17,11,8,57,39,18,62
Morton,4638,3,16,13,7,47,34,13,61
Dundee Utd,4638,4,14,9,13,47,42,5,51
Queen of S't,4638,5,11,10,15,43,50,-7,43
Raith,4638,6,11,9,16,36,48,-12,42
Dunfermline,4638,7,9,14,13,43,49,-6,41
Dumbarton,4638,8,9,12,15,49,57,-8,39
St Mirren,4638,9,9,9,18,39,54,-15,36
Ayr,4638,10,8,12,16,31,55,-24,36
Hibernian,4639,1,19,13,4,56,24,32,70
Dundee Utd,4639,2,17,10,9,54,39,15,61
Morton,4639,3,17,10,9,50,41,9,61
Falkirk,4639,4,16,10,10,53,36,17,58
Dunfermline,4639,5,10,13,13,43,45,-2,43
Raith,4639,6,11,8,17,37,49,-12,41
Queen of S't,4639,7,10,10,16,41,50,-9,40
St Mirren,4639,8,10,10,16,46,57,-11,40
Dumbarton,4639,9,9,12,15,46,57,-11,39
Ayr,4639,10,7,12,17,33,61,-28,33
Hibernian,4640,1,20,12,4,62,28,34,72
Morton,4640,2,18,10,8,55,41,14,64
Dundee Utd,4640,3,17,10,9,58,40,18,61
Falkirk,4640,4,15,11,10,57,40,17,56
Dumbarton,4640,5,10,12,14,49,58,-9,42
Dunfermline,4640,6,9,14,13,47,52,-5,41
Queen of S't,4640,7,9,13,14,42,50,-8,40
Raith,4640,8,10,9,17,33,51,-18,39
St Mirren,4640,9,8,12,16,42,58,-16,36
Ayr,4640,10,6,13,17,31,58,-27,31
Hibernian,4641,1,20,11,5,57,24,33,71
Morton,4641,2,17,11,8,46,31,15,62
Falkirk,4641,3,14,13,9,55,41,14,55
Dundee Utd,4641,4,13,10,13,45,43,2,49
Queen of S't,4641,5,13,8,15,44,48,-4,47
Dunfermline,4641,6,11,13,12,45,45,0,46
Ayr,4641,7,10,12,14,33,49,-16,42
Dumbarton,4641,8,10,11,15,44,53,-9,41
Raith,4641,9,10,9,17,33,50,-17,39
St Mirren,4641,10,7,12,17,38,56,-18,33
Hibernian,4642,1,19,12,5,54,23,31,69
Falkirk,4642,2,18,10,8,62,39,23,64
Dundee Utd,4642,3,15,11,10,53,41,12,56
Morton,4642,4,14,12,10,47,41,6,54
Queen of S't,4642,5,11,11,14,44,46,-2,44
Dunfermline,4642,6,10,13,13,45,49,-4,43
Dumbarton,4642,7,10,11,15,48,61,-13,41
Raith,4642,8,9,13,14,35,48,-13,40
Ayr,4642,9,8,13,15,34,57,-23,37
St Mirren,4642,10,7,12,17,36,53,-17,33
Hibernian,4643,1,19,11,6,54,25,29,68
Morton,4643,2,17,13,6,55,39,16,64
Falkirk,4643,3,18,9,9,64,40,24,63
Dundee Utd,4643,4,17,10,9,54,44,10,61
Queen of S't,4643,5,12,9,15,48,52,-4,45
Ayr,4643,6,10,12,14,35,50,-15,42
Raith,4643,7,10,9,17,34,51,-17,39
Dunfermline,4643,8,8,12,16,43,52,-9,36
Dumbarton,4643,9,8,12,16,46,59,-13,36
St Mirren,4643,10,7,11,18,38,59,-21,32
Hibernian,4644,1,21,11,4,58,25,33,74
Dundee Utd,4644,2,19,9,8,55,38,17,66
Falkirk,4644,3,15,9,12,58,42,16,54
Morton,4644,4,14,12,10,45,39,6,54
Dunfermline,4644,5,10,15,11,50,48,2,45
Dumbarton,4644,6,10,12,14,47,56,-9,42
Queen of S't,4644,7,11,8,17,45,53,-8,41
St Mirren,4644,8,10,10,16,39,52,-13,40
Raith,4644,9,10,10,16,32,49,-17,40
Ayr,4644,10,6,12,18,31,58,-27,30
Hibernian,4645,1,17,15,4,57,30,27,66
Dundee Utd,4645,2,16,10,10,51,37,14,58
Falkirk,4645,3,15,12,9,60,46,14,57
Morton,4645,4,15,12,9,49,41,8,57
Dunfermline,4645,5,11,13,12,46,44,2,46
Queen of S't,4645,6,11,12,13,45,49,-4,45
St Mirren,4645,7,12,9,15,46,53,-7,45
Raith,4645,8,10,8,18,34,52,-18,38
Ayr,4645,9,8,13,15,33,55,-22,37
Dumbarton,4645,10,8,10,18,46,60,-14,34
Hibernian,4646,1,23,10,3,61,24,37,79
Morton,4646,2,15,13,8,48,38,10,58
Dundee Utd,4646,3,15,12,9,49,35,14,57
Falkirk,4646,4,15,9,12,55,46,9,54
Dunfermline,4646,5,11,13,12,50,49,1,46
Dumbarton,4646,6,9,13,14,50,57,-7,40
St Mirren,4646,7,9,12,15,42,53,-11,39
Ayr,4646,8,9,11,16,33,51,-18,38
Raith,4646,9,10,8,18,32,53,-21,38
Queen of S't,4646,10,9,9,18,41,55,-14,36
Hibernian,4647,1,21,12,3,57,21,36,75
Morton,4647,2,16,11,9,46,34,12,59
Falkirk,4647,3,16,10,10,61,42,19,58
Dundee Utd,4647,4,15,13,8,56,40,16,58
Dumbarton,4647,5,12,11,13,51,55,-4,47
Dunfermline,4647,6,8,16,12,41,46,-5,40
Queen of S't,4647,7,10,10,16,45,57,-12,40
Raith,4647,8,10,10,16,37,52,-15,40
Ayr,4647,9,7,13,16,36,59,-23,34
St Mirren,4647,10,7,10,19,37,61,-24,31
Hibernian,4648,1,21,11,4,60,28,32,74
Morton,4648,2,18,10,8,51,36,15,64
Falkirk,4648,3,14,10,12,54,42,12,52
Dundee Utd,4648,4,13,10,13,48,46,2,49
Dunfermline,4648,5,11,13,12,43,42,1,46
Dumbarton,4648,6,11,12,13,53,58,-5,45
Queen of S't,4648,7,11,9,16,45,53,-8,42
Ayr,4648,8,9,13,14,40,57,-17,40
St Mirren,4648,9,9,11,16,41,56,-15,38
Raith,4648,10,8,11,17,33,50,-17,35
Hibernian,4649,1,19,11,6,56,26,30,68
Morton,4649,2,18,12,6,52,34,18,66
Dundee Utd,4649,3,16,10,10,52,43,9,58
Falkirk,4649,4,15,10,11,56,43,13,55
Queen of S't,4649,5,12,10,14,50,50,0,46
Dunfermline,4649,6,11,13,12,46,51,-5,46
Ayr,4649,7,9,12,15,35,52,-17,39
Dumbarton,4649,8,8,13,15,49,61,-12,37
St Mirren,4649,9,9,10,17,43,58,-15,37
Raith,4649,10,8,9,19,31,52,-21,33
Hibernian,4650,1,18,12,6,51,25,26,66
Falkirk,4650,2,17,11,8,64,43,21,62
Morton,4650,3,16,12,8,48,37,11,60
Dundee Utd,4650,4,16,11,9,50,40,10,59
Dunfermline,4650,5,11,14,11,47,45,2,47
Queen of S't,4650,6,11,9,16,45,52,-7,42
Ayr,4650,7,10,11,15,34,50,-16,41
Dumbarton,4650,8,9,11,16,52,60,-8,38
St Mirren,4650,9,8,11,17,38,58,-20,35
Raith,4650,10,8,10,18,32,51,-19,34
Hibernian,4651,1,20,12,4,55,24,31,72
Morton,4651,2,19,9,8,56,35,21,66
Falkirk,4651,3,18,11,7,61,35,26,65
Dundee Utd,4651,4,16,10,10,54,39,15,58
Dumbarton,4651,5,11,11,14,50,54,-4,44
Queen of S't,4651,6,11,9,16,44,56,-12,42
Dunfermline,4651,7,9,13,14,44,51,-7,40
Raith,4651,8,9,10,17,34,51,-17,37
Ayr,4651,9,8,11,17,35,60,-25,35
St Mirren,4651,10,6,10,20,35,63,-28,28
Morton,4652,1,21,10,5,56,29,27,73
Hibernian,4652,2,18,13,5,57,27,30,67
Falkirk,4652,3,17,10,9,63,43,20,61
Dundee Utd,4652,4,16,10,10,49,40,9,58
Raith,4652,5,13,8,15,41,47,-6,47
Queen of S't,4652,6,11,10,15,42,51,-9,43
Dumbarton,4652,7,9,11,16,48,54,-6,38
Dunfermline,4652,8,7,13,16,40,55,-15,34
Ayr,4652,9,7,12,17,30,58,-28,33
St Mirren,4652,10,7,11,18,35,57,-22,32
Hibernian,4653,1,17,14,5,53,29,24,65
Morton,4653,2,18,11,7,54,37,17,65
Falkirk,4653,3,18,10,8,59,34,25,64
Dundee Utd,4653,4,18,9,9,56,37,19,63
Dunfermline,4653,5,9,15,12,43,47,-4,42
Queen of S't,4653,6,10,9,17,40,53,-13,39
Raith,4653,7,10,9,17,34,49,-15,39
Ayr,4653,8,8,13,15,32,53,-21,37
Dumbarton,4653,9,8,11,17,47,60,-13,35
St Mirren,4653,10,8,11,17,40,59,-19,35
Hibernian,4654,1,20,11,5,59,23,36,71
Dundee Utd,4654,2,18,8,10,54,39,15,62
Morton,4654,3,16,11,9,48,39,9,59
Falkirk,4654,4,16,10,10,55,39,16,58
Queen of S't,4654,5,13,8,15,46,54,-8,47
Dunfermline,4654,6,10,12,14,44,47,-3,42
Ayr,4654,7,10,11,15,34,52,-18,41
Raith,4654,8,10,8,18,33,49,-16,38
Dumbarton,4654,9,8,12,16,49,64,-15,36
St Mirren,4654,10,9,9,18,42,58,-16,36
Hibernian,4655,1,19,12,5,51,23,28,69
Morton,4655,2,18,13,5,51,32,19,67
Dundee Utd,4655,3,18,9,9,56,34,22,63
Falkirk,4655,4,16,10,10,57,39,18,58
Raith,4655,5,11,11,14,38,48,-10,44
Queen of S't,4655,6,10,11,15,42,48,-6,41
Dumbarton,4655,7,9,11,16,48,65,-17,38
St Mirren,4655,8,9,10,17,38,54,-16,37
Dunfermline,4655,9,8,12,16,41,50,-9,36
Ayr,4655,10,7,11,18,30,59,-29,32
Hibernian,4656,1,21,12,3,62,24,38,75
Morton,4656,2,17,9,10,50,39,11,60
Falkirk,4656,3,15,11,10,61,46,15,56
Dundee Utd,4656,4,15,10,11,51,43,8,55
Queen of S't,4656,5,12,10,14,47,49,-2,46
Dunfermline,4656,6,10,12,14,49,53,-4,42
Dumbarton,4656,7,10,12,14,51,58,-7,42
St Mirren,4656,8,10,9,17,44,58,-14,39
Raith,4656,9,10,8,18,34,58,-24,38
Ayr,4656,10,7,13,16,34,55,-21,34
Hibernian,4657,1,20,11,5,58,23,35,71
Falkirk,4657,2,18,10,8,58,34,24,64
Morton,4657,3,17,11,8,49,39,10,62
Dundee Utd,4657,4,13,13,10,44,39,5,52
Dunfermline,4657,5,11,13,12,50,45,5,46
Queen of S't,4657,6,11,11,14,45,56,-11,44
Dumbarton,4657,7,9,11,16,47,59,-12,38
Raith,4657,8,9,11,16,35,53,-18,38
St Mirren,4657,9,9,10,17,38,52,-14,37
Ayr,4657,10,6,13,17,30,54,-24,31
Hibernian,4658,1,19,12,5,56,28,28,69
Morton,4658,2,17,9,10,48,39,9,60
Falkirk,4658,3,16,9,11,60,45,15,57
Dundee Utd,4658,4,16,9,11,56,42,14,57
Dunfermline,4658,5,11,14,11,53,46,7,47
Queen of S't,4658,6,11,10,15,46,49,-3,43
Raith,4658,7,11,10,15,37,47,-10,43
Ayr,4658,8,10,11,15,33,57,-24,41
St Mirren,4658,9,9,9,18,41,59,-18,36
Dumbarton,4658,10,8,11,17,43,61,-18,35
Hibernian,4659,1,19,11,6,54,27,27,68
Morton,4659,2,18,10,8,53,34,19,64
Falkirk,4659,3,16,11,9,57,40,17,59
Dundee Utd,4659,4,15,10,11,47,44,3,55
Queen of S't,4659,5,11,11,14,51,53,-2,44
St Mirren,4659,6,11,10,15,44,53,-9,43
Dunfermline,4659,7,9,13,14,44,50,-6,40
Dumbarton,4659,8,8,15,13,49,57,-8,39
Raith,4659,9,10,9,17,38,53,-15,39
Ayr,4659,10,7,12,17,32,58,-26,33
Hibernian,4660,1,18,12,6,50,26,24,66
Falkirk,4660,2,18,9,9,59,37,22,63
Morton,4660,3,16,13,7,50,37,13,61
Dundee Utd,4660,4,17,9,10,54,39,15,60
Dunfermline,4660,5,10,15,11,48,47,1,45
St Mirren,4660,6,12,9,15,39,49,-10,45
Ayr,4660,7,9,11,16,37,57,-20,38
Dumbarton,4660,8,8,12,16,46,59,-13,36
Queen of S't,4660,9,9,9,18,40,54,-14,36
Raith,4660,10,9,9,18,32,50,-18,36
Hibernian,4661,1,18,12,6,52,26,26,66
Morton,4661,2,17,11,8,51,38,13,62
Falkirk,4661,3,17,10,9,62,42,20,61
Dundee Utd,4661,4,14,10,12,55,45,10,52
Queen of S't,4661,5,12,11,13,43,47,-4,47
Dunfermline,4661,6,10,14,12,52,49,3,44
Raith,4661,7,11,9,16,35,50,-15,42
Dumbarton,4661,8,9,12,15,49,61,-12,39
Ayr,4661,9,9,12,15,32,52,-20,39
St Mirren,4661,10,8,9,19,38,59,-21,33
Hibernian,4662,1,19,13,4,55,22,33,70
Morton,4662,2,16,13,7,48,35,13,61
Falkirk,4662,3,16,11,9,64,45,19,59
Dundee Utd,4662,4,15,12,9,51,42,9,57
Queen of S't,4662,5,13,8,15,49,49,0,47
Dumbarton,4662,6,9,13,14,48,58,-10,40
Raith,4662,7,10,10,16,33,46,-13,40
Dunfermline,4662,8,8,13,15,45,54,-9,37
St Mirren,4662,9,8,11,17,41,61,-20,35
Ayr,4662,10,6,16,14,32,54,-22,34
Hibernian,4663,1,19,12,5,59,30,29,69
Falkirk,4663,2,17,10,9,62,42,20,61
Morton,4663,3,14,13,9,49,43,6,55
Dundee Utd,4663,4,14,11,11,48,43,5,53
Queen of S't,4663,5,13,8,15,50,53,-3,47
Dunfermline,4663,6,10,13,13,47,49,-2,43
Raith,4663,7,11,8,17,39,52,-13,41
Ayr,4663,8,10,11,15,39,57,-18,41
St Mirren,4663,9,9,11,16,44,51,-7,38
Dumbarton,4663,10,8,13,15,42,59,-17,37
Hibernian,4664,1,17,13,6,51,30,21,64
Morton,4664,2,17,11,8,52,36,16,62
Falkirk,4664,3,15,11,10,55,41,14,56
Dundee Utd,4664,4,16,8,12,48,42,6,56
Queen of S't,4664,5,14,8,14,51,47,4,50
Ayr,4664,6,10,11,15,38,54,-16,41
Dunfermline,4664,7,9,13,14,41,45,-4,40
Dumbarton,4664,8,9,13,14,50,58,-8,40
Raith,4664,9,10,10,16,34,48,-14,40
St Mirren,4664,10,8,12,16,39,58,-19,36
Hibernian,4665,1,18,14,4,51,26,25,68
Morton,4665,2,16,14,6,49,34,15,62
Falkirk,4665,3,15,11,10,57,43,14,56
Dundee Utd,4665,4,15,11,10,50,40,10,56
Queen of S't,4665,5,12,9,15,47,50,-3,45
Raith,4665,6,11,11,14,41,48,-7,44
Dunfermline,4665,7,9,13,14,45,51,-6,40
Ayr,4665,8,9,13,14,40,58,-18,40
St Mirren,4665,9,9,10,17,40,53,-13,37
Dumbarton,4665,10,7,12,17,43,60,-17,33
Morton,4666,1,19,11,6,52,33,19,68
Hibernian,4666,2,18,12,6,52,24,28,66
Falkirk,4666,3,15,12,9,53,37,16,57
Dundee Utd,4666,4,16,9,11,52,42,10,57
Dunfermline,4666,5,10,13,13,47,48,-1,43
Queen of S't,4666,6,11,10,15,44,46,-2,43
Raith,4666,7,11,9,16,34,48,-14,42
St Mirren,4666,8,10,9,17,39,55,-16,39
Dumbarton,4666,9,7,14,15,44,60,-16,35
Ayr,4666,10,8,11,17,30,54,-24,35
Hibernian,4667,1,20,13,3,58,23,35,73
Falkirk,4667,2,15,11,10,56,43,13,56
Dundee Utd,4667,3,15,11,10,47,40,7,56
Morton,4667,4,15,11,10,47,42,5,56
Dunfermline,4667,5,11,13,12,45,42,3,46
Queen of S't,4667,6,11,11,14,45,48,-3,44
Ayr,4667,7,9,14,13,35,49,-14,41
Raith,4667,8,10,10,16,35,49,-14,40
Dumbarton,4667,9,9,11,16,46,59,-13,38
St Mirren,4667,10,8,9,19,38,57,-19,33
Hibernian,4668,1,21,11,4,61,27,34,74
Morton,4668,2,16,13,7,47,35,12,61
Dundee Utd,4668,3,17,9,10,49,35,14,60
Falkirk,4668,4,15,10,11,54,41,13,55
Queen of S't,4668,5,14,8,14,48,48,0,50
Dunfermline,4668,6,10,13,13,43,45,-2,43
Dumbarton,4668,7,9,12,15,51,62,-11,39
Raith,4668,8,10,9,17,37,51,-14,39
St Mirren,4668,9,9,9,18,45,62,-17,36
Ayr,4668,10,7,10,19,34,63,-29,31
Hibernian,4669,1,21,11,4,58,24,34,74
Morton,4669,2,16,12,8,51,41,10,60
Dundee Utd,4669,3,15,9,12,50,42,8,54
Falkirk,4669,4,14,10,12,52,44,8,52
Raith,4669,5,12,10,14,39,47,-8,46
Ayr,4669,6,10,12,14,41,55,-14,42
Dunfermline,4669,7,9,14,13,45,48,-3,41
Queen of S't,4669,8,10,11,15,42,50,-8,41
Dumbarton,4669,9,10,10,16,48,58,-10,40
St Mirren,4669,10,7,13,16,40,57,-17,34
Hibernian,4670,1,18,11,7,55,29,26,65
Morton,4670,2,17,13,6,52,32,20,64
Falkirk,4670,3,17,11,8,57,35,22,62
Dundee Utd,4670,4,15,10,11,54,41,13,55
Dunfermline,4670,5,11,13,12,53,53,0,46
Raith,4670,6,11,10,15,36,49,-13,43
St Mirren,4670,7,11,9,16,46,53,-7,42
Queen of S't,4670,8,10,8,18,41,56,-15,38
Dumbarton,4670,9,8,12,16,45,68,-23,36
Ayr,4670,10,7,13,16,30,53,-23,34
Hibernian,4671,1,19,13,4,57,25,32,70
Morton,4671,2,19,12,5,56,31,25,69
Falkirk,4671,3,16,12,8,59,39,20,60
Dundee Utd,4671,4,17,9,10,53,40,13,60
Raith,4671,5,11,9,16,38,51,-13,42
Dunfermline,4671,6,9,14,13,47,49,-2,41
Queen of S't,4671,7,10,10,16,47,57,-10,40
St Mirren,4671,8,8,11,17,38,55,-17,35
Dumbarton,4671,9,8,11,17,44,64,-20,35
Ayr,4671,10,7,11,18,32,60,-28,32
Hibernian,4672,1,17,13,6,54,32,22,64
Morton,4672,2,17,10,9,55,39,16,61
Falkirk,4672,3,16,11,9,52,35,17,59
Dunfermline,4672,4,12,12,12,47,47,0,48
Dundee Utd,4672,5,13,9,14,42,45,-3,48
Queen of S't,4672,6,12,9,15,45,52,-7,45
Dumbarton,4672,7,11,10,15,54,56,-2,43
Ayr,4672,8,10,12,14,41,57,-16,42
St Mirren,4672,9,10,10,16,43,55,-12,40
Raith,4672,10,9,10,17,33,48,-15,37
Hibernian,4673,1,18,13,5,54,26,28,67
Morton,4673,2,16,13,7,53,37,16,61
Falkirk,4673,3,17,10,9,56,41,15,61
Dundee Utd,4673,4,16,9,11,48,38,10,57
Queen of S't,4673,5,12,8,16,45,51,-6,44
Dumbarton,4673,6,11,10,15,49,55,-6,43
Dunfermline,4673,7,9,15,12,48,50,-2,42
Ayr,4673,8,9,12,15,34,51,-17,39
Raith,4673,9,9,10,17,34,54,-20,37
St Mirren,4673,10,7,12,17,37,55,-18,33
Morton,4674,1,20,10,6,55,36,19,70
Hibernian,4674,2,17,12,7,54,33,21,63
Falkirk,4674,3,16,10,10,58,44,14,58
Dundee Utd,4674,4,14,10,12,50,44,6,52
Queen of S't,4674,5,12,10,14,46,48,-2,46
Dunfermline,4674,6,10,14,12,51,50,1,44
Ayr,4674,7,9,12,15,34,52,-18,39
Raith,4674,8,10,9,17,33,51,-18,39
St Mirren,4674,9,9,10,17,44,55,-11,37
Dumbarton,4674,10,8,13,15,45,57,-12,37
Hibernian,4675,1,20,12,4,55,25,30,72
Morton,4675,2,17,11,8,50,37,13,62
Falkirk,4675,3,16,11,9,61,42,19,59
Dundee Utd,4675,4,16,10,10,48,36,12,58
Dunfermline,4675,5,11,11,14,48,47,1,44
Dumbarton,4675,6,10,11,15,47,60,-13,41
Ayr,4675,7,9,14,13,33,48,-15,41
Queen of S't,4675,8,9,10,17,39,54,-15,37
St Mirren,4675,9,8,11,17,42,56,-14,35
Raith,4675,10,8,11,17,33,51,-18,35
Hibernian,4676,1,19,12,5,57,29,28,69
Morton,4676,2,18,11,7,58,35,23,65
Falkirk,4676,3,15,13,8,61,43,18,58
Dundee Utd,4676,4,15,10,11,48,41,7,55
Queen of S't,4676,5,13,8,15,48,51,-3,47
Raith,4676,6,10,11,15,37,49,-12,41
Dunfermline,4676,7,9,13,14,43,51,-8,40
St Mirren,4676,8,9,11,16,47,57,-10,38
Ayr,4676,9,8,13,15,30,57,-27,37
Dumbarton,4676,10,7,12,17,43,59,-16,33
Hibernian,4677,1,19,13,4,55,25,30,70
Morton,4677,2,18,10,8,52,36,16,64
Falkirk,4677,3,18,9,9,61,36,25,63
Dundee Utd,4677,4,16,9,11,49,40,9,57
Queen of S't,4677,5,11,11,14,45,51,-6,44
Dumbarton,4677,6,10,12,14,50,57,-7,42
Ayr,4677,7,9,12,15,31,49,-18,39
Dunfermline,4677,8,9,11,16,44,53,-9,38
Raith,4677,9,8,12,16,34,51,-17,36
St Mirren,4677,10,7,11,18,37,60,-23,32
Hibernian,4678,1,19,13,4,61,26,35,70
Morton,4678,2,17,10,9,47,40,7,61
Dundee Utd,4678,3,16,11,9,55,39,16,59
Falkirk,4678,4,15,11,10,58,40,18,56
Dunfermline,4678,5,11,12,13,50,49,1,45
Queen of S't,4678,6,10,11,15,42,56,-14,41
Raith,4678,7,11,8,17,36,53,-17,41
Dumbarton,4678,8,8,14,14,47,54,-7,38
Ayr,4678,9,9,11,16,35,58,-23,38
St Mirren,4678,10,7,13,16,39,55,-16,34
Hibernian,4679,1,18,13,5,58,29,29,67
Dundee Utd,4679,2,17,11,8,57,40,17,62
Falkirk,4679,3,16,10,10,60,46,14,58
Morton,4679,4,15,11,10,46,40,6,56
Queen of S't,4679,5,12,11,13,51,53,-2,47
St Mirren,4679,6,10,11,15,44,54,-10,41
Raith,4679,7,10,10,16,36,52,-16,40
Dumbarton,4679,8,9,12,15,47,60,-13,39
Dunfermline,4679,9,8,14,14,42,46,-4,38
Ayr,4679,10,8,11,17,39,60,-21,35
Hibernian,4680,1,17,13,6,59,32,27,64
Morton,4680,2,17,12,7,52,37,15,63
Dundee Utd,4680,3,17,9,10,54,38,16,60
Falkirk,4680,4,16,11,9,63,44,19,59
Dunfermline,4680,5,11,14,11,50,48,2,47
Dumbarton,4680,6,11,11,14,48,56,-8,44
Ayr,4680,7,10,12,14,37,54,-17,42
Raith,4680,8,9,10,17,32,51,-19,37
Queen of S't,4680,9,9,9,18,39,54,-15,36
St Mirren,4680,10,8,9,19,37,57,-20,33
Hibernian,4681,1,19,12,5,54,24,30,69
Falkirk,4681,2,18,11,7,59,36,23,65
Morton,4681,3,17,13,6,52,32,20,64
Dundee Utd,4681,4,13,14,9,44,35,9,53
Dunfermline,4681,5,11,12,13,44,45,-1,45
Queen of S't,4681,6,11,10,15,46,54,-8,43
Ayr,4681,7,8,14,14,29,50,-21,38
Raith,4681,8,9,9,18,34,51,-17,36
Dumbarton,4681,9,7,13,16,44,59,-15,34
St Mirren,4681,10,7,12,17,35,55,-20,33
Hibernian,4682,1,19,13,4,54,24,30,70
Morton,4682,2,17,10,9,52,41,11,61
Falkirk,4682,3,16,10,10,56,38,18,58
Dundee Utd,4682,4,16,10,10,49,39,10,58
Queen of S't,4682,5,13,9,14,47,49,-2,48
Raith,4682,6,12,9,15,36,45,-9,45
Dunfermline,4682,7,10,13,13,48,51,-3,43
Dumbarton,4682,8,10,10,16,53,63,-10,40
Ayr,4682,9,8,11,17,32,55,-23,35
St Mirren,4682,10,7,9,20,38,60,-22,30
Morton,4683,1,19,11,6,55,35,20,68
Hibernian,4683,2,17,13,6,54,27,27,64
Dundee Utd,4683,3,17,9,10,49,41,8,60
Falkirk,4683,4,15,11,10,54,42,12,56
Queen of S't,4683,5,13,8,15,44,52,-8,47
Dunfermline,4683,6,11,11,14,46,49,-3,44
Raith,4683,7,10,10,16,35,49,-14,40
Dumbarton,4683,8,9,11,16,51,58,-7,38
St Mirren,4683,9,9,10,17,43,55,-12,37
Ayr,4683,10,6,14,16,29,52,-23,32
Hibernian,4684,1,20,11,5,62,27,35,71
Morton,4684,2,18,10,8,55,39,16,64
Dundee Utd,4684,3,18,9,9,57,39,18,63
Falkirk,4684,4,16,10,10,57,42,15,58
Queen of S't,4684,5,14,9,13,50,47,3,51
Raith,4684,6,10,10,16,37,52,-15,40
Dunfermline,4684,7,9,12,15,43,51,-8,39
Dumbarton,4684,8,9,11,16,48,65,-17,38
St Mirren,4684,9,8,10,18,37,59,-22,34
Ayr,4684,10,6,12,18,32,57,-25,30
Hibernian,4685,1,19,12,5,55,28,27,69
Morton,4685,2,17,12,7,49,35,14,63
Dundee Utd,4685,3,17,8,11,61,40,21,59
Falkirk,4685,4,13,11,12,55,46,9,50
Dumbarton,4685,5,12,10,14,51,60,-9,46
Queen of S't,4685,6,12,9,15,46,50,-4,45
Dunfermline,4685,7,10,13,13,46,47,-1,43
Raith,4685,8,9,14,13,38,49,-11,41
St Mirren,4685,9,7,13,16,40,61,-21,34
Ayr,4685,10,7,12,17,34,59,-25,33
Hibernian,4686,1,18,11,7,51,27,24,65
Morton,4686,2,17,11,8,50,34,16,62
Dundee Utd,4686,3,16,11,9,54,42,12,59
Falkirk,4686,4,15,10,11,53,40,13,55
Dunfermline,4686,5,11,13,12,46,46,0,46
Queen of S't,4686,6,12,10,14,46,49,-3,46
St Mirren,4686,7,10,11,15,41,51,-10,41
Dumbarton,4686,8,8,13,15,42,55,-13,37
Raith,4686,9,9,10,17,33,51,-18,37
Ayr,4686,10,7,14,15,33,54,-21,35
Hibernian,4687,1,19,12,5,55,28,27,69
Falkirk,4687,2,17,9,10,61,40,21,60
Dundee Utd,4687,3,16,10,10,49,38,11,58
Morton,4687,4,15,11,10,46,37,9,56
Queen of S't,4687,5,13,8,15,49,52,-3,47
Raith,4687,6,11,10,15,39,50,-11,43
Dunfermline,4687,7,10,12,14,45,49,-4,42
Dumbarton,4687,8,9,11,16,49,61,-12,38
St Mirren,4687,9,8,13,15,38,52,-14,37
Ayr,4687,10,8,12,16,36,60,-24,36
Hibernian,4688,1,19,11,6,57,28,29,68
Falkirk,4688,2,18,10,8,62,36,26,64
Dundee Utd,4688,3,15,11,10,47,37,10,56
Morton,4688,4,14,13,9,43,34,9,55
Queen of S't,4688,5,12,10,14,42,48,-6,46
Ayr,4688,6,10,14,12,39,52,-13,44
Raith,4688,7,10,10,16,35,53,-18,40
Dunfermline,4688,8,9,11,16,42,52,-10,38
Dumbarton,4688,9,9,11,16,44,56,-12,38
St Mirren,4688,10,9,9,18,41,56,-15,36
Hibernian,4689,1,19,14,3,54,23,31,71
Morton,4689,2,17,12,7,52,36,16,63
Dundee Utd,4689,3,17,8,11,54,40,14,59
Falkirk,4689,4,15,11,10,54,41,13,56
Dumbarton,4689,5,10,12,14,49,55,-6,42
Dunfermline,4689,6,9,13,14,46,51,-5,40
Queen of S't,4689,7,10,10,16,42,52,-10,40
Ayr,4689,8,8,14,14,36,56,-20,38
Raith,4689,9,9,10,17,33,52,-19,37
St Mirren,4689,10,8,12,16,38,52,-14,36
Hibernian,4690,1,20,12,4,58,26,32,72
Morton,4690,2,19,10,7,58,38,20,67
Falkirk,4690,3,17,11,8,61,36,25,62
Dundee Utd,4690,4,17,9,10,51,41,10,60
Dunfermline,4690,5,11,12,13,50,51,-1,45
Dumbarton,4690,6,9,11,16,48,60,-12,38
Queen of S't,4690,7,10,8,18,40,55,-15,38
Raith,4690,8,10,8,18,34,53,-19,38
Ayr,4690,9,9,10,17,33,54,-21,37
St Mirren,4690,10,7,11,18,41,60,-19,32
Hibernian,4691,1,20,11,5,58,26,32,71
Falkirk,4691,2,15,11,10,54,39,15,56
Morton,4691,3,15,11,10,47,40,7,56
Queen of S't,4691,4,14,10,12,49,48,1,52
Dundee Utd,4691,5,13,12,11,43,39,4,51
Dunfermline,4691,6,10,15,11,45,47,-2,45
Dumbarton,4691,7,9,12,15,50,58,-8,39
Raith,4691,8,10,9,17,38,53,-15,39
Ayr,4691,9,9,12,15,36,56,-20,39
St Mirren,4691,10,9,9,18,42,56,-14,36
Hibernian,4692,1,18,12,6,56,30,26,66
Falkirk,4692,2,18,10,8,63,38,25,64
Morton,4692,3,16,13,7,50,35,15,61
Dundee Utd,4692,4,16,10,10,51,39,12,58
Raith,4692,5,11,9,16,39,48,-9,42
Queen of S't,4692,6,11,9,16,43,53,-10,42
Ayr,4692,7,10,11,15,39,52,-13,41
Dunfermline,4692,8,9,13,14,45,53,-8,40
Dumbarton,4692,9,9,12,15,43,61,-18,39
St Mirren,4692,10,8,9,19,37,57,-20,33
Morton,4693,1,19,11,6,53,33,20,68
Hibernian,4693,2,17,13,6,55,30,25,64
Falkirk,4693,3,15,11,10,58,45,13,56
Dundee Utd,4693,4,15,9,12,52,44,8,54
Queen of S't,4693,5,13,10,13,49,49,0,49
Dunfermline,4693,6,11,12,13,51,49,2,45
Dumbarton,4693,7,9,12,15,48,61,-13,39
Raith,4693,8,9,11,16,33,52,-19,38
Ayr,4693,9,7,14,15,31,51,-20,35
St Mirren,4693,10,7,13,16,37,53,-16,34
Hibernian,4694,1,20,12,4,58,24,34,72
Morton,4694,2,17,12,7,50,35,15,63
Dundee Utd,4694,3,16,10,10,53,40,13,58
Falkirk,4694,4,15,11,10,57,43,14,56
Queen of S't,4694,5,12,9,15,45,48,-3,45
Dunfermline,4694,6,10,12,14,47,50,-3,42
Raith,4694,7,10,10,16,32,48,-16,40
St Mirren,4694,8,8,12,16,43,57,-14,36
Ayr,4694,9,8,12,16,40,62,-22,36
Dumbarton,4694,10,7,14,15,47,65,-18,35
Hibernian,4695,1,19,13,4,61,27,34,70
Falkirk,4695,2,19,10,7,66,39,27,67
Morton,4695,3,15,13,8,46,36,10,58
Dundee Utd,4695,4,14,9,13,47,41,6,51
Queen of S't,4695,5,12,9,15,46,54,-8,45
St Mirren,4695,6,10,10,16,40,55,-15,40
Ayr,4695,7,9,12,15,34,53,-19,39
Dunfermline,4695,8,7,17,12,43,49,-6,38
Dumbarton,4695,9,9,11,16,48,57,-9,38
Raith,4695,10,9,10,17,33,53,-20,37
Hibernian,4696,1,18,11,7,52,26,26,65
Falkirk,4696,2,17,11,8,58,38,20,62
Morton,4696,3,17,11,8,56,40,16,62
Dundee Utd,4696,4,14,10,12,48,46,2,52
Dunfermline,4696,5,12,12,12,48,46,2,48
Dumbarton,4696,6,10,11,15,52,61,-9,41
Queen of S't,4696,7,11,8,17,44,54,-10,41
St Mirren,4696,8,10,10,16,41,55,-14,40
Raith,4696,9,9,12,15,35,48,-13,39
Ayr,4696,10,9,10,17,35,55,-20,37
Hibernian,4697,1,20,11,5,56,25,31,71
Falkirk,4697,2,16,11,9,57,41,16,59
Morton,4697,3,16,11,9,49,35,14,59
Dundee Utd,4697,4,15,11,10,49,41,8,56
Dunfermline,4697,5,11,14,11,46,43,3,47
Raith,4697,6,11,10,15,34,47,-13,43
Queen of S't,4697,7,10,10,16,41,50,-9,40
Ayr,4697,8,9,11,16,34,53,-19,38
St Mirren,4697,9,9,10,17,38,55,-17,37
Dumbarton,4697,10,7,13,16,43,57,-14,34
Hibernian,4698,1,17,12,7,50,28,22,63
Morton,4698,2,17,12,7,51,35,16,63
Falkirk,4698,3,17,9,10,58,44,14,60
Dundee Utd,4698,4,15,11,10,49,38,11,56
Dunfermline,4698,5,11,12,13,45,45,0,45
Dumbarton,4698,6,11,11,14,51,56,-5,44
Queen of S't,4698,7,11,10,15,44,52,-8,43
Raith,4698,8,10,9,17,35,49,-14,39
St Mirren,4698,9,8,12,16,40,55,-15,36
Ayr,4698,10,8,12,16,34,55,-21,36
Hibernian,4699,1,19,13,4,57,24,33,70
Morton,4699,2,18,11,7,50,35,15,65
Dundee Utd,4699,3,15,10,11,49,39,10,55
Falkirk,4699,4,14,12,10,55,42,13,54
Raith,4699,5,11,11,14,35,44,-9,44
Dumbarton,4699,6,11,10,15,53,58,-5,43
Queen of S't,4699,7,11,9,16,46,56,-10,42
Ayr,4699,8,10,11,15,35,55,-20,41
Dunfermline,4699,9,8,14,14,47,54,-7,38
St Mirren,4699,10,8,9,19,37,57,-20,33
Hibernian,4700,1,18,12,6,60,34,26,66
Morton,4700,2,17,13,6,58,39,19,64
Dundee Utd,4700,3,16,10,10,54,41,13,58
Falkirk,4700,4,16,9,11,59,44,15,57
Queen of S't,4700,5,13,8,15,52,53,-1,47
Dunfermline,4700,6,10,13,13,46,55,-9,43
Raith,4700,7,10,12,14,42,51,-9,42
St Mirren,4700,8,9,11,16,41,58,-17,38
Ayr,4700,9,9,11,16,37,56,-19,38
Dumbarton,4700,10,7,11,18,42,60,-18,32
Falkirk,4701,1,19,9,8,62,40,22,66
Hibernian,4701,2,18,11,7,52,25,27,65
Morton,4701,3,17,13,6,49,33,16,64
Dundee Utd,4701,4,18,9,9,56,34,22,63
Queen of S't,4701,5,10,13,13,40,45,-5,43
Dumbarton,4701,6,9,12,15,48,56,-8,39
Dunfermline,4701,7,8,13,15,43,54,-11,37
Raith,4701,8,9,10,17,34,51,-17,37
Ayr,4701,9,8,12,16,31,54,-23,36
St Mirren,4701,10,7,12,17,34,57,-23,33
Hibernian,4702,1,21,10,5,55,25,30,73
Morton,4702,2,17,10,9,48,36,12,61
Dundee Utd,4702,3,15,11,10,51,44,7,56
Falkirk,4702,4,14,13,9,57,42,15,55
Dunfermline,4702,5,11,11,14,47,50,-3,44
Dumbarton,4702,6,10,13,13,48,53,-5,43
Raith,4702,7,11,10,15,36,46,-10,43
Queen of S't,4702,8,10,9,17,44,53,-9,39
Ayr,4702,9,9,12,15,32,51,-19,39
St Mirren,4702,10,7,11,18,41,59,-18,32
Hibernian,4703,1,17,14,5,52,26,26,65
Morton,4703,2,17,12,7,52,35,17,63
Dundee Utd,4703,3,17,9,10,60,43,17,60
Falkirk,4703,4,14,14,8,57,44,13,56
Queen of S't,4703,5,13,10,13,51,47,4,49
Raith,4703,6,11,11,14,32,43,-11,44
Dunfermline,4703,7,10,12,14,48,53,-5,42
Dumbarton,4703,8,8,11,17,45,65,-20,35
Ayr,4703,9,8,11,17,34,58,-24,35
St Mirren,4703,10,8,10,18,39,56,-17,34
Hibernian,4704,1,17,14,5,52,26,26,65
Dundee Utd,4704,2,17,10,9,55,39,16,61
Morton,4704,3,16,12,8,51,40,11,60
Falkirk,4704,4,14,11,11,55,44,11,53
Queen of S't,4704,5,12,10,14,47,51,-4,46
Dunfermline,4704,6,10,15,11,45,46,-1,45
Dumbarton,4704,7,10,11,15,48,57,-9,41
St Mirren,4704,8,9,12,15,40,50,-10,39
Raith,4704,9,9,12,15,38,52,-14,39
Ayr,4704,10,6,13,17,33,59,-26,31
Hibernian,4705,1,19,13,4,53,24,29,70
Dundee Utd,4705,2,19,9,8,57,36,21,66
Falkirk,4705,3,17,12,7,58,35,23,63
Morton,4705,4,15,12,9,45,34,11,57
Queen of S't,4705,5,11,10,15,45,51,-6,43
Dunfermline,4705,6,10,12,14,45,47,-2,42
Raith,4705,7,9,10,17,30,47,-17,37
Dumbarton,4705,8,8,12,16,44,61,-17,36
St Mirren,4705,9,9,9,18,36,56,-20,36
Ayr,4705,10,7,13,16,33,55,-22,34
Hibernian,4706,1,21,11,4,61,26,35,74
Morton,4706,2,19,10,7,49,32,17,67
Falkirk,4706,3,17,10,9,61,41,20,61
Dundee Utd,4706,4,16,11,9,51,36,15,59
Queen of S't,4706,5,12,10,14,45,47,-2,46
St Mirren,4706,6,10,11,15,43,53,-10,41
Raith,4706,7,10,9,17,36,52,-16,39
Dunfermline,4706,8,8,12,16,41,52,-11,36
Dumbarton,4706,9,8,10,18,43,61,-18,34
Ayr,4706,10,7,10,19,28,58,-30,31
Hibernian,4707,1,19,12,5,56,29,27,69
Morton,4707,2,17,10,9,53,41,12,61
Dundee Utd,4707,3,17,9,10,57,43,14,60
Falkirk,4707,4,15,11,10,53,39,14,56
Queen of S't,4707,5,12,12,12,51,50,1,48
Dumbarton,4707,6,11,12,13,53,56,-3,45
Raith,4707,7,11,9,16,35,50,-15,42
Dunfermline,4707,8,9,13,14,45,48,-3,40
St Mirren,4707,9,8,9,19,40,60,-20,33
Ayr,4707,10,7,11,18,34,61,-27,32
Hibernian,4708,1,19,14,3,54,23,31,71
Morton,4708,2,17,12,7,49,35,14,63
Falkirk,4708,3,15,13,8,57,39,18,58
Dundee Utd,4708,4,16,9,11,49,39,10,57
Dumbarton,4708,5,11,11,14,49,52,-3,44
Queen of S't,4708,6,11,10,15,42,49,-7,43
Dunfermline,4708,7,8,13,15,42,52,-10,37
St Mirren,4708,8,8,13,15,40,54,-14,37
Raith,4708,9,9,9,18,31,50,-19,36
Ayr,4708,10,8,12,16,30,50,-20,36
Hibernian,4709,1,20,11,5,57,26,31,71
Dundee Utd,4709,2,17,10,9,54,38,16,61
Morton,4709,3,15,12,9,52,43,9,57
Falkirk,4709,4,15,11,10,57,40,17,56
Queen of S't,4709,5,14,9,13,46,47,-1,51
Dunfermline,4709,6,10,14,12,45,47,-2,44
Dumbarton,4709,7,10,12,14,50,58,-8,42
Raith,4709,8,9,11,16,33,48,-15,38
Ayr,4709,9,7,12,17,32,56,-24,33
St Mirren,4709,10,7,10,19,41,64,-23,31
Hibernian,4710,1,19,11,6,62,30,32,68
Morton,4710,2,17,10,9,50,39,11,61
Falkirk,4710,3,17,9,10,53,38,15,60
Dundee Utd,4710,4,17,8,11,54,40,14,59
Queen of S't,4710,5,14,8,14,46,50,-4,50
Dumbarton,4710,6,11,11,14,54,58,-4,44
Raith,4710,7,10,10,16,32,44,-12,40
Dunfermline,4710,8,8,13,15,44,56,-12,37
Ayr,4710,9,8,12,16,34,56,-22,36
St Mirren,4710,10,8,10,18,38,56,-18,34
Hibernian,4711,1,19,13,4,59,29,30,70
Morton,4711,2,16,12,8,49,38,11,60
Falkirk,4711,3,16,11,9,57,38,19,59
Dundee Utd,4711,4,14,10,12,49,45,4,52
Queen of S't,4711,5,14,8,14,52,52,0,50
Dunfermline,4711,6,9,14,13,47,48,-1,41
Dumbarton,4711,7,9,13,14,47,59,-12,40
Ayr,4711,8,9,13,14,36,53,-17,40
St Mirren,4711,9,8,12,16,40,55,-15,36
Raith,4711,10,9,8,19,35,54,-19,35
Hibernian,4712,1,20,12,4,58,25,33,72
Morton,4712,2,16,11,9,48,36,12,59
Dundee Utd,4712,3,16,9,11,52,41,11,57
Falkirk,4712,4,15,10,11,55,42,13,55
Dunfermline,4712,5,11,12,13,49,54,-5,45
Queen of S't,4712,6,12,8,16,43,49,-6,44
Raith,4712,7,11,10,15,38,47,-9,43
Dumbarton,4712,8,10,12,14,49,61,-12,42
St Mirren,4712,9,9,12,15,38,51,-13,39
Ayr,4712,10,7,10,19,32,56,-24,31
Hibernian,4713,1,19,11,6,54,29,25,68
Morton,4713,2,17,11,8,50,37,13,62
Falkirk,4713,3,16,11,9,60,39,21,59
Dundee Utd,4713,4,14,11,11,50,42,8,53
Queen of S't,4713,5,13,8,15,47,49,-2,47
Dunfermline,4713,6,10,14,12,46,44,2,44
Dumbarton,4713,7,9,12,15,45,55,-10,39
Ayr,4713,8,8,15,13,35,52,-17,39
Raith,4713,9,9,10,17,36,53,-17,37
St Mirren,4713,10,9,9,18,39,62,-23,36
Hibernian,4714,1,20,13,3,57,24,33,73
Dundee Utd,4714,2,19,8,9,55,37,18,65
Morton,4714,3,15,12,9,48,39,9,57
Falkirk,4714,4,15,10,11,58,44,14,55
Dunfermline,4714,5,11,11,14,46,51,-5,44
Queen of S't,4714,6,11,8,17,46,54,-8,41
Dumbarton,4714,7,9,12,15,51,62,-11,39
Raith,4714,8,10,9,17,36,50,-14,39
Ayr,4714,9,9,12,15,34,52,-18,39
St Mirren,4714,10,8,11,17,40,58,-18,35
Morton,4715,1,17,14,5,51,28,23,65
Hibernian,4715,2,16,16,4,48,24,24,64
Falkirk,4715,3,18,10,8,56,36,20,64
Dundee Utd,4715,4,15,10,11,46,39,7,55
Queen of S't,4715,5,12,11,13,45,46,-1,47
Dunfermline,4715,6,10,13,13,48,53,-5,43
Raith,4715,7,9,11,16,35,50,-15,38
St Mirren,4715,8,9,9,18,40,57,-17,36
Ayr,4715,9,7,14,15,32,53,-21,35
Dumbarton,4715,10,8,10,18,46,61,-15,34
Hibernian,4716,1,20,11,5,59,27,32,71
Morton,4716,2,17,12,7,51,37,14,63
Falkirk,4716,3,17,11,8,56,38,18,62
Dundee Utd,4716,4,16,10,10,49,40,9,58
Queen of S't,4716,5,10,11,15,46,51,-5,41
Dumbarton,4716,6,9,14,13,49,55,-6,41
Raith,4716,7,10,10,16,34,47,-13,40
St Mirren,4716,8,8,12,16,42,58,-16,36
Ayr,4716,9,8,12,16,36,59,-23,36
Dunfermline,4716,10,7,13,16,41,51,-10,34
Hibernian,4717,1,18,14,4,56,29,27,68
Dundee Utd,4717,2,18,8,10,55,38,17,62
Morton,4717,3,15,13,8,53,41,12,58
Falkirk,4717,4,14,11,11,55,44,11,53
Dumbarton,4717,5,11,11,14,52,59,-7,44
Queen of S't,4717,6,12,8,16,45,53,-8,44
Dunfermline,4717,7,10,12,14,45,51,-6,42
Ayr,4717,8,10,11,15,41,55,-14,41
Raith,4717,9,9,11,16,33,49,-16,38
St Mirren,4717,10,7,13,16,41,57,-16,34
Hibernian,4718,1,20,12,4,58,27,31,72
Dundee Utd,4718,2,17,10,9,49,36,13,61
Morton,4718,3,16,12,8,53,40,13,60
Falkirk,4718,4,15,12,9,58,42,16,57
Dunfermline,4718,5,10,14,12,46,44,2,44
Dumbarton,4718,6,10,11,15,48,57,-9,41
Raith,4718,7,10,11,15,37,51,-14,41
Queen of S't,4718,8,10,10,16,41,52,-11,40
St Mirren,4718,9,10,9,17,45,53,-8,39
Ayr,4718,10,6,11,19,32,65,-33,29
Hibernian,4719,1,21,11,4,59,22,37,74
Dundee Utd,4719,2,17,8,11,54,40,14,59
Morton,4719,3,15,14,7,50,39,11,59
Falkirk,4719,4,15,11,10,58,46,12,56
Queen of S't,4719,5,11,10,15,43,48,-5,43
Dunfermline,4719,6,9,14,13,43,49,-6,41
Ayr,4719,7,10,10,16,33,54,-21,40
St Mirren,4719,8,9,11,16,41,55,-14,38
Raith,4719,9,9,11,16,37,52,-15,38
Dumbarton,4719,10,8,12,16,46,59,-13,36
Hibernian,4720,1,18,12,6,51,26,25,66
Falkirk,4720,2,17,9,10,62,41,21,60
Dundee Utd,4720,3,17,9,10,49,40,9,60
Morton,4720,4,15,11,10,51,43,8,56
Queen of S't,4720,5,12,11,13,45,52,-7,47
Raith,4720,6,11,11,14,38,45,-7,44
Dumbarton,4720,7,9,13,14,45,56,-11,40
Dunfermline,4720,8,8,14,14,42,48,-6,38
St Mirren,4720,9,9,11,16,45,55,-10,38
Ayr,4720,10,8,11,17,34,56,-22,35
Hibernian,4721,1,18,14,4,54,26,28,68
Dundee Utd,4721,2,17,11,8,54,37,17,62
Falkirk,4721,3,16,11,9,61,43,18,59
Morton,4721,4,14,13,9,47,37,10,55
Dumbarton,4721,5,10,14,12,49,53,-4,44
Dunfermline,4721,6,9,14,13,43,47,-4,41
Queen of S't,4721,7,10,10,16,42,53,-11,40
Raith,4721,8,10,9,17,34,48,-14,39
Ayr,4721,9,8,13,15,32,53,-21,37
St Mirren,4721,10,8,11,17,38,57,-19,35
Hibernian,4722,1,21,12,3,61,23,38,75
Morton,4722,2,16,11,9,45,41,4,59
Dundee Utd,4722,3,15,12,9,50,37,13,57
Falkirk,4722,4,15,10,11,55,44,11,55
Raith,4722,5,12,9,15,41,48,-7,45
Dunfermline,4722,6,9,14,13,46,50,-4,41
Dumbarton,4722,7,10,11,15,51,58,-7,41
Queen of S't,4722,8,10,11,15,43,53,-10,41
St Mirren,4722,9,9,10,17,40,54,-14,37
Ayr,4722,10,6,14,16,31,55,-24,32
Hibernian,4723,1,19,13,4,54,26,28,70
Morton,4723,2,16,14,6,51,37,14,62
Dundee Utd,4723,3,17,10,9,52,36,16,61
Falkirk,4723,4,14,11,11,54,42,12,53
Queen of S't,4723,5,13,10,13,47,47,0,49
Dumbarton,4723,6,11,10,15,53,59,-6,43
Dunfermline,4723,7,9,15,12,43,44,-1,42
St Mirren,4723,8,10,9,17,38,53,-15,39
Raith,4723,9,8,11,17,33,51,-18,35
Ayr,4723,10,6,11,19,31,61,-30,29
Hibernian,4724,1,20,11,5,57,25,32,71
Morton,4724,2,18,10,8,52,35,17,64
Falkirk,4724,3,17,10,9,60,40,20,61
Dundee Utd,4724,4,16,8,12,51,40,11,56
Queen of S't,4724,5,12,9,15,50,55,-5,45
Dumbarton,4724,6,11,10,15,49,57,-8,43
Ayr,4724,7,9,12,15,35,56,-21,39
Raith,4724,8,9,11,16,35,52,-17,38
Dunfermline,4724,9,8,13,15,41,49,-8,37
St Mirren,4724,10,8,10,18,42,63,-21,34
Hibernian,4725,1,19,11,6,57,27,30,68
Morton,4725,2,17,12,7,45,33,12,63
Dundee Utd,4725,3,18,8,10,55,38,17,62
Falkirk,4725,4,16,9,11,57,43,14,57
Dumbarton,4725,5,11,11,14,52,57,-5,44
Dunfermline,4725,6,10,12,14,46,49,-3,42
Queen of S't,4725,7,11,9,16,45,54,-9,42
Raith,4725,8,10,11,15,32,46,-14,41
Ayr,4725,9,8,11,17,33,55,-22,35
St Mirren,4725,10,8,10,18,38,58,-20,34
Hibernian,4726,1,20,10,6,57,27,30,70
Morton,4726,2,17,10,9,51,40,11,61
Dundee Utd,4726,3,16,11,9,49,41,8,59
Falkirk,4726,4,14,10,12,53,44,9,52
Dunfermline,4726,5,13,11,12,53,45,8,50
Queen of S't,4726,6,12,9,15,45,50,-5,45
Dumbarton,4726,7,10,10,16,48,59,-11,40
Raith,4726,8,10,9,17,36,53,-17,39
Ayr,4726,9,9,11,16,37,54,-17,38
St Mirren,4726,10,8,11,17,38,54,-16,35
Morton,4727,1,20,10,6,56,32,24,70
Hibernian,4727,2,18,13,5,54,27,27,67
Dundee Utd,4727,3,17,8,11,54,41,13,59
Falkirk,4727,4,15,11,10,58,42,16,56
Queen of S't,4727,5,15,9,12,47,44,3,54
Dunfermline,4727,6,10,12,14,49,56,-7,42
Ayr,4727,7,10,10,16,35,51,-16,40
Raith,4727,8,9,9,18,32,50,-18,36
St Mirren,4727,9,8,9,19,38,63,-25,33
Dumbarton,4727,10,7,11,18,44,61,-17,32
Hibernian,4728,1,20,12,4,60,26,34,72
Dundee Utd,4728,2,18,9,9,49,36,13,63
Morton,4728,3,16,13,7,54,38,16,61
Falkirk,4728,4,16,10,10,59,40,19,58
Queen of S't,4728,5,14,9,13,46,47,-1,51
Dunfermline,4728,6,8,13,15,43,54,-11,37
Raith,4728,7,9,10,17,32,48,-16,37
Dumbarton,4728,8,8,12,16,46,63,-17,36
St Mirren,4728,9,8,11,17,38,53,-15,35
Ayr,4728,10,7,13,16,30,52,-22,34
Hibernian,4729,1,22,11,3,64,24,40,77
Dundee Utd,4729,2,17,9,10,56,40,16,60
Morton,4729,3,17,9,10,51,41,10,60
Falkirk,4729,4,16,10,10,57,39,18,58
Queen of S't,4729,5,13,11,12,54,50,4,50
Ayr,4729,6,9,11,16,36,61,-25,38
Dumbarton,4729,7,9,10,17,47,62,-15,37
Raith,4729,8,9,10,17,34,50,-16,37
Dunfermline,4729,9,7,14,15,40,53,-13,35
St Mirren,4729,10,8,11,17,40,59,-19,35
Hibernian,4730,1,20,13,3,56,23,33,73
Falkirk,4730,2,18,11,7,63,38,25,65
Dundee Utd,4730,3,17,9,10,51,38,13,60
Morton,4730,4,15,12,9,50,41,9,57
Queen of S't,4730,5,12,9,15,46,53,-7,45
Raith,4730,6,12,9,15,40,50,-10,45
Dunfermline,4730,7,8,14,14,45,51,-6,38
Dumbarton,4730,8,8,12,16,48,60,-12,36
St Mirren,4730,9,7,12,17,38,58,-20,33
Ayr,4730,10,7,11,18,32,57,-25,32
Hibernian,4731,1,17,15,4,56,28,28,66
Dundee Utd,4731,2,18,8,10,54,37,17,62
Morton,4731,3,16,13,7,51,39,12,61
Falkirk,4731,4,16,12,8,57,39,18,60
Dunfermline,4731,5,10,14,12,48,48,0,44
Raith,4731,6,10,10,16,33,49,-16,40
Queen of S't,4731,7,10,9,17,43,52,-9,39
St Mirren,4731,8,9,12,15,39,51,-12,39
Ayr,4731,9,8,13,15,35,57,-22,37
Dumbarton,4731,10,7,12,17,42,58,-16,33
Hibernian,4732,1,17,13,6,56,31,25,64
Dundee Utd,4732,2,15,11,10,56,41,15,56
Falkirk,4732,3,15,11,10,55,43,12,56
Morton,4732,4,15,11,10,47,41,6,56
Raith,4732,5,14,8,14,48,51,-3,50
Queen of S't,4732,6,12,11,13,48,48,0,47
Dunfermline,4732,7,11,11,14,46,52,-6,44
Dumbarton,4732,8,10,12,14,52,59,-7,42
St Mirren,4732,9,8,12,16,39,54,-15,36
Ayr,4732,10,7,12,17,37,64,-27,33
Hibernian,4733,1,19,12,5,52,26,26,69
Morton,4733,2,16,13,7,49,36,13,61
Falkirk,4733,3,15,10,11,53,40,13,55
Dundee Utd,4733,4,15,10,11,46,41,5,55
Dunfermline,4733,5,12,13,11,49,41,8,49
Queen of S't,4733,6,13,9,14,42,45,-3,48
Ayr,4733,7,9,13,14,37,53,-16,40
Raith,4733,8,10,9,17,37,49,-12,39
Dumbarton,4733,9,9,11,16,47,59,-12,38
St Mirren,4733,10,6,12,18,39,61,-22,30
Hibernian,4734,1,17,14,5,50,26,24,65
Morton,4734,2,18,11,7,50,31,19,65
Dundee Utd,4734,3,17,10,9,53,37,16,61
Falkirk,4734,4,16,10,10,59,41,18,58
Queen of S't,4734,5,12,8,16,46,51,-5,44
Ayr,4734,6,10,12,14,37,51,-14,42
Dunfermline,4734,7,8,16,12,43,46,-3,40
Raith,4734,8,10,9,17,32,48,-16,39
Dumbarton,4734,9,9,11,16,46,60,-14,38
St Mirren,4734,10,8,9,19,37,62,-25,33
Hibernian,4735,1,21,11,4,70,25,45,74
Morton,4735,2,16,11,9,47,38,9,59
Dundee Utd,4735,3,16,10,10,49,38,11,58
Falkirk,4735,4,15,11,10,58,43,15,56
Queen of S't,4735,5,12,9,15,45,49,-4,45
Ayr,4735,6,10,13,13,38,55,-17,43
Dumbarton,4735,7,10,12,14,50,59,-9,42
Dunfermline,4735,8,9,12,15,44,54,-10,39
St Mirren,4735,9,7,13,16,40,58,-18,34
Raith,4735,10,8,10,18,30,52,-22,34
Hibernian,4736,1,21,11,4,58,26,32,74
Morton,4736,2,15,12,9,49,40,9,57
Dundee Utd,4736,3,15,10,11,52,43,9,55
Falkirk,4736,4,14,10,12,53,44,9,52
Queen of S't,4736,5,14,8,14,51,50,1,50
Dunfermline,4736,6,10,13,13,49,48,1,43
Raith,4736,7,11,9,16,37,50,-13,42
Dumbarton,4736,8,10,11,15,52,65,-13,41
Ayr,4736,9,10,10,16,38,56,-18,40
St Mirren,4736,10,8,10,18,39,56,-17,34
Hibernian,4737,1,19,13,4,58,27,31,70
Falkirk,4737,2,17,11,8,68,41,27,62
Morton,4737,3,17,10,9,50,41,9,61
Dundee Utd,4737,4,14,9,13,47,44,3,51
Dunfermline,4737,5,12,11,13,50,50,0,47
Dumbarton,4737,6,11,12,13,48,52,-4,45
Ayr,4737,7,9,13,14,35,53,-18,40
Queen of S't,4737,8,10,8,18,42,56,-14,38
St Mirren,4737,9,8,12,16,38,53,-15,36
Raith,4737,10,9,9,18,32,51,-19,36
Hibernian,4738,1,20,11,5,55,26,29,71
Morton,4738,2,17,11,8,49,38,11,62
Falkirk,4738,3,16,11,9,63,38,25,59
Dundee Utd,4738,4,16,10,10,48,36,12,58
Queen of S't,4738,5,12,9,15,46,52,-6,45
Dunfermline,4738,6,9,16,11,47,48,-1,43
Dumbarton,4738,7,9,12,15,49,61,-12,39
St Mirren,4738,8,10,9,17,46,60,-14,39
Raith,4738,9,10,9,17,36,51,-15,39
Ayr,4738,10,7,10,19,29,58,-29,31
Hibernian,4739,1,20,10,6,58,28,30,70
Falkirk,4739,2,18,9,9,62,39,23,63
Morton,4739,3,16,12,8,49,35,14,60
Dundee Utd,4739,4,15,10,11,46,43,3,55
Dumbarton,4739,5,11,11,14,51,56,-5,44
Raith,4739,6,11,10,15,39,49,-10,43
Queen of S't,4739,7,10,9,17,46,55,-9,39
St Mirren,4739,8,10,9,17,44,58,-14,39
Dunfermline,4739,9,8,14,14,43,54,-11,38
Ayr,4739,10,8,12,16,32,53,-21,36
Hibernian,4740,1,20,11,5,57,27,30,71
Falkirk,4740,2,18,11,7,61,36,25,65
Morton,4740,3,17,12,7,48,31,17,63
Dundee Utd,4740,4,15,9,12,51,44,7,54
Queen of S't,4740,5,13,8,15,46,53,-7,47
Dunfermline,4740,6,9,13,14,44,49,-5,40
Dumbarton,4740,7,9,13,14,50,60,-10,40
Raith,4740,8,9,11,16,34,47,-13,38
St Mirren,4740,9,8,10,18,37,57,-20,34
Ayr,4740,10,7,12,17,30,54,-24,33
Hibernian,4741,1,21,11,4,61,26,35,74
Falkirk,4741,2,18,11,7,61,37,24,65
Morton,4741,3,17,10,9,51,39,12,61
Dundee Utd,4741,4,17,9,10,49,39,10,60
Dunfermline,4741,5,10,14,12,47,45,2,44
Queen of S't,4741,6,10,11,15,42,52,-10,41
Raith,4741,7,10,9,17,33,49,-16,39
Dumbarton,4741,8,8,12,16,45,57,-12,36
St Mirren,4741,9,8,11,17,39,55,-16,35
Ayr,4741,10,6,12,18,28,57,-29,30
Hibernian,4742,1,19,11,6,56,31,25,68
Morton,4742,2,18,11,7,51,34,17,65
Falkirk,4742,3,17,10,9,62,38,24,61
Dundee Utd,4742,4,16,9,11,56,41,15,57
Dunfermline,4742,5,10,14,12,46,48,-2,44
Raith,4742,6,11,10,15,36,50,-14,43
Queen of S't,4742,7,10,9,17,44,56,-12,39
Ayr,4742,8,9,12,15,37,56,-19,39
Dumbarton,4742,9,8,13,15,42,54,-12,37
St Mirren,4742,10,8,9,19,35,57,-22,33
Hibernian,4743,1,20,11,5,52,24,28,71
Morton,4743,2,18,11,7,52,37,15,65
Falkirk,4743,3,17,10,9,59,39,20,61
Dundee Utd,4743,4,14,11,11,48,42,6,53
Raith,4743,5,12,8,16,36,51,-15,44
St Mirren,4743,6,11,10,15,47,54,-7,43
Queen of S't,4743,7,10,10,16,42,49,-7,40
Dunfermline,4743,8,9,11,16,48,54,-6,38
Dumbarton,4743,9,8,12,16,51,66,-15,36
Ayr,4743,10,8,12,16,38,57,-19,36
Morton,4744,1,19,11,6,52,33,19,68
Hibernian,4744,2,16,14,6,55,33,22,62
Falkirk,4744,3,16,12,8,59,42,17,60
Dundee Utd,4744,4,14,11,11,45,39,6,53
Queen of S't,4744,5,11,12,13,45,48,-3,45
Dunfermline,4744,6,10,14,12,45,44,1,44
St Mirren,4744,7,11,9,16,42,54,-12,42
Dumbarton,4744,8,8,13,15,47,59,-12,37
Raith,4744,9,9,9,18,34,50,-16,36
Ayr,4744,10,6,15,15,33,55,-22,33
Hibernian,4745,1,19,11,6,53,28,25,68
Falkirk,4745,2,16,12,8,58,40,18,60
Dundee Utd,4745,3,16,11,9,55,39,16,59
Morton,4745,4,15,12,9,50,40,10,57
Queen of S't,4745,5,14,9,13,43,44,-1,51
Dunfermline,4745,6,11,12,13,52,51,1,45
Raith,4745,7,10,10,16,34,48,-14,40
Dumbarton,4745,8,8,12,16,44,57,-13,36
St Mirren,4745,9,7,13,16,35,51,-16,34
Ayr,4745,10,7,12,17,29,55,-26,33
Hibernian,4746,1,17,13,6,52,30,22,64
Dundee Utd,4746,2,18,8,10,52,39,13,62
Falkirk,4746,3,14,13,9,53,40,13,55
Morton,4746,4,14,13,9,49,38,11,55
Dunfermline,4746,5,10,13,13,46,49,-3,43
Raith,4746,6,11,10,15,37,45,-8,43
Queen of S't,4746,7,11,9,16,43,56,-13,42
Dumbarton,4746,8,10,11,15,51,56,-5,41
St Mirren,4746,9,10,11,15,45,56,-11,41
Ayr,4746,10,9,11,16,37,56,-19,38
Hibernian,4747,1,21,11,4,58,24,34,74
Morton,4747,2,16,12,8,45,35,10,60
Dundee Utd,4747,3,14,14,8,53,42,11,56
Falkirk,4747,4,15,9,12,59,46,13,54
Queen of S't,4747,5,12,10,14,45,50,-5,46
St Mirren,4747,6,10,11,15,47,53,-6,41
Dunfermline,4747,7,8,15,13,41,45,-4,39
Dumbarton,4747,8,9,12,15,48,62,-14,39
Ayr,4747,9,8,13,15,38,56,-18,37
Raith,4747,10,9,9,18,30,51,-21,36
Hibernian,4748,1,19,12,5,57,30,27,69
Falkirk,4748,2,18,10,8,63,39,24,64
Dundee Utd,4748,3,17,10,9,51,36,15,61
Morton,4748,4,17,9,10,54,41,13,60
Dunfermline,4748,5,10,12,14,47,49,-2,42
Dumbarton,4748,6,10,11,15,49,60,-11,41
Queen of S't,4748,7,10,10,16,43,53,-10,40
Ayr,4748,8,9,12,15,36,55,-19,39
Raith,4748,9,10,9,17,32,51,-19,39
St Mirren,4748,10,8,9,19,45,63,-18,33
Hibernian,4749,1,19,13,4,59,28,31,70
Dundee Utd,4749,2,17,9,10,51,40,11,60
Falkirk,4749,3,16,11,9,57,41,16,59
Morton,4749,4,14,13,9,50,42,8,55
Queen of S't,4749,5,11,11,14,51,54,-3,44
Dumbarton,4749,6,9,14,13,50,54,-4,41
Raith,4749,7,10,11,15,33,45,-12,41
Ayr,4749,8,9,12,15,36,57,-21,39
Dunfermline,4749,9,8,13,15,45,54,-9,37
St Mirren,4749,10,8,11,17,41,58,-17,35
Hibernian,4750,1,20,13,3,55,24,31,73
Morton,4750,2,17,11,8,58,42,16,62
Falkirk,4750,3,16,10,10,57,39,18,58
Dundee Utd,4750,4,16,10,10,52,43,9,58
Dunfermline,4750,5,12,11,13,53,53,0,47
Queen of S't,4750,6,10,10,16,47,52,-5,40
Raith,4750,7,9,11,16,33,48,-15,38
Ayr,4750,8,8,13,15,36,57,-21,37
Dumbarton,4750,9,8,12,16,47,64,-17,36
St Mirren,4750,10,7,13,16,37,53,-16,34
Morton,4751,1,21,9,6,55,31,24,72
Hibernian,4751,2,19,13,4,56,24,32,70
Dundee Utd,4751,3,16,9,11,48,39,9,57
Falkirk,4751,4,14,12,10,55,41,14,54
Queen of S't,4751,5,11,10,15,43,49,-6,43
Dunfermline,4751,6,9,13,14,43,47,-4,40
Raith,4751,7,10,9,17,34,53,-19,39
Ayr,4751,8,8,14,14,33,54,-21,38
Dumbarton,4751,9,7,14,15,44,57,-13,35
St Mirren,4751,10,7,13,16,33,49,-16,34
Hibernian,4752,1,19,13,4,58,26,32,70
Morton,4752,2,19,12,5,57,34,23,69
Dundee Utd,4752,3,15,12,9,49,38,11,57
Falkirk,4752,4,14,13,9,58,43,15,55
Queen of S't,4752,5,11,9,16,43,56,-13,42
Dunfermline,4752,6,9,14,13,45,49,-4,41
Dumbarton,4752,7,9,12,15,44,55,-11,39
Raith,4752,8,10,9,17,35,50,-15,39
Ayr,4752,9,8,11,17,37,59,-22,35
St Mirren,4752,10,7,13,16,42,58,-16,34
Hibernian,4753,1,20,10,6,59,29,30,70
Falkirk,4753,2,17,12,7,62,41,21,63
Morton,4753,3,17,10,9,49,36,13,61
Dundee Utd,4753,4,15,10,11,47,40,7,55
Queen of S't,4753,5,11,10,15,47,50,-3,43
Dumbarton,4753,6,10,12,14,53,61,-8,42
Raith,4753,7,11,9,16,34,46,-12,42
Dunfermline,4753,8,9,12,15,48,58,-10,39
Ayr,4753,9,9,12,15,35,53,-18,39
St Mirren,4753,10,7,11,18,37,57,-20,32
Hibernian,4754,1,21,10,5,60,23,37,73
Morton,4754,2,18,12,6,49,33,16,66
Dundee Utd,4754,3,16,10,10,47,36,11,58
Falkirk,4754,4,15,11,10,57,47,10,56
Dunfermline,4754,5,10,14,12,45,46,-1,44
Dumbarton,4754,6,11,10,15,46,58,-12,43
Queen of S't,4754,7,10,10,16,42,51,-9,40
Raith,4754,8,9,9,18,36,52,-16,36
St Mirren,4754,9,8,11,17,40,56,-16,35
Ayr,4754,10,7,13,16,33,53,-20,34
Hibernian,4755,1,20,10,6,68,29,39,70
Falkirk,4755,2,18,10,8,62,41,21,64
Morton,4755,3,17,13,6,53,36,17,64
Dundee Utd,4755,4,18,9,9,53,36,17,63
Queen of S't,4755,5,13,8,15,51,55,-4,47
Dunfermline,4755,6,8,14,14,45,54,-9,38
Dumbarton,4755,7,9,11,16,50,62,-12,38
Ayr,4755,8,9,11,16,36,59,-23,38
Raith,4755,9,9,10,17,37,54,-17,37
St Mirren,4755,10,6,10,20,34,63,-29,28
Hibernian,4756,1,19,13,4,62,26,36,70
Morton,4756,2,17,10,9,54,41,13,61
Falkirk,4756,3,14,12,10,55,43,12,54
Dundee Utd,4756,4,14,12,10,46,40,6,54
Dunfermline,4756,5,10,15,11,44,44,0,45
Queen of S't,4756,6,11,11,14,47,55,-8,44
Raith,4756,7,10,11,15,39,49,-10,41
Ayr,4756,8,9,14,13,34,51,-17,41
Dumbarton,4756,9,8,12,16,47,58,-11,36
St Mirren,4756,10,7,12,17,40,61,-21,33
Hibernian,4757,1,19,12,5,54,26,28,69
Falkirk,4757,2,17,11,8,56,35,21,62
Morton,4757,3,15,13,8,51,39,12,58
Dundee Utd,4757,4,14,11,11,47,42,5,53
Queen of S't,4757,5,11,10,15,43,49,-6,43
Dumbarton,4757,6,10,12,14,49,56,-7,42
Dunfermline,4757,7,8,16,12,44,50,-6,40
Raith,4757,8,10,9,17,39,51,-12,39
Ayr,4757,9,9,12,15,33,55,-22,39
St Mirren,4757,10,9,10,17,39,52,-13,37
Hibernian,4758,1,20,12,4,58,28,30,72
Morton,4758,2,16,11,9,48,35,13,59
Falkirk,4758,3,15,13,8,58,39,19,58
Dundee Utd,4758,4,14,12,10,50,40,10,54
Dunfermline,4758,5,10,14,12,42,44,-2,44
Queen of S't,4758,6,11,10,15,45,55,-10,43
Dumbarton,4758,7,10,10,16,49,59,-10,40
Raith,4758,8,10,10,16,35,48,-13,40
Ayr,4758,9,7,15,14,34,53,-19,36
St Mirren,4758,10,7,13,16,39,57,-18,34
Hibernian,4759,1,20,12,4,56,24,32,72
Morton,4759,2,16,12,8,51,37,14,60
Falkirk,4759,3,16,11,9,60,41,19,59
Dundee Utd,4759,4,16,9,11,56,48,8,57
Queen of S't,4759,5,14,8,14,48,48,0,50
Dunfermline,4759,6,10,12,14,48,53,-5,42
Raith,4759,7,11,9,16,35,47,-12,42
St Mirren,4759,8,10,11,15,43,53,-10,41
Dumbarton,4759,9,7,11,18,46,64,-18,32
Ayr,4759,10,7,11,18,32,60,-28,32
Hibernian,4760,1,19,10,7,58,27,31,67
Morton,4760,2,17,12,7,51,37,14,63
Dundee Utd,4760,3,17,10,9,52,39,13,61
Falkirk,4760,4,16,11,9,58,40,18,59
Dumbarton,4760,5,10,13,13,50,57,-7,43
Raith,4760,6,10,10,16,33,49,-16,40
Dunfermline,4760,7,8,15,13,43,47,-4,39
Ayr,4760,8,9,12,15,33,51,-18,39
Queen of S't,4760,9,9,11,16,44,57,-13,38
St Mirren,4760,10,8,10,18,38,56,-18,34
Hibernian,4761,1,19,12,5,54,26,28,69
Dundee Utd,4761,2,15,12,9,51,37,14,57
Falkirk,4761,3,14,13,9,57,41,16,55
Morton,4761,4,14,12,10,51,43,8,54
Dunfermline,4761,5,10,14,12,45,47,-2,44
Queen of S't,4761,6,11,11,14,43,48,-5,44
St Mirren,4761,7,11,10,15,45,52,-7,43
Dumbarton,4761,8,10,11,15,45,56,-11,41
Raith,4761,9,10,9,17,31,49,-18,39
Ayr,4761,10,6,16,14,31,54,-23,34
Hibernian,4762,1,18,13,5,58,29,29,67
Morton,4762,2,17,12,7,55,34,21,63
Dundee Utd,4762,3,17,9,10,54,39,15,60
Falkirk,4762,4,16,10,10,62,43,19,58
Dumbarton,4762,5,10,11,15,49,60,-11,41
Queen of S't,4762,6,11,8,17,42,53,-11,41
Dunfermline,4762,7,9,13,14,45,54,-9,40
St Mirren,4762,8,10,10,16,42,59,-17,40
Raith,4762,9,9,11,16,33,51,-18,38
Ayr,4762,10,8,13,15,36,54,-18,37
Hibernian,4763,1,20,12,4,62,24,38,72
Morton,4763,2,17,10,9,49,38,11,61
Falkirk,4763,3,16,10,10,55,39,16,58
Dundee Utd,4763,4,16,10,10,54,40,14,58
Dunfermline,4763,5,13,11,12,55,47,8,50
Raith,4763,6,10,10,16,33,48,-15,40
Ayr,4763,7,9,13,14,32,49,-17,40
Queen of S't,4763,8,10,9,17,43,54,-11,39
Dumbarton,4763,9,9,10,17,50,69,-19,37
St Mirren,4763,10,7,11,18,35,60,-25,32
Hibernian,4764,1,18,13,5,55,25,30,67
Dundee Utd,4764,2,18,9,9,55,37,18,63
Morton,4764,3,16,13,7,53,36,17,61
Falkirk,4764,4,14,12,10,55,41,14,54
Queen of S't,4764,5,14,8,14,46,47,-1,50
Dunfermline,4764,6,9,13,14,46,50,-4,40
Dumbarton,4764,7,9,12,15,45,59,-14,39
Raith,4764,8,9,10,17,37,54,-17,37
Ayr,4764,9,8,13,15,31,53,-22,37
St Mirren,4764,10,9,9,18,41,62,-21,36
Morton,4765,1,19,11,6,52,34,18,68
Hibernian,4765,2,18,13,5,51,27,24,67
Dundee Utd,4765,3,19,8,9,52,36,16,65
Falkirk,4765,4,18,10,8,61,36,25,64
Queen of S't,4765,5,12,11,13,47,48,-1,47
Raith,4765,6,10,10,16,38,52,-14,40
Dunfermline,4765,7,8,11,17,43,54,-11,35
Ayr,4765,8,8,11,17,35,58,-23,35
St Mirren,4765,9,8,10,18,40,56,-16,34
Dumbarton,4765,10,7,11,18,45,63,-18,32
Hibernian,4766,1,21,12,3,63,24,39,75
Dundee Utd,4766,2,17,9,10,48,39,9,60
Falkirk,4766,3,16,10,10,60,41,19,58
Morton,4766,4,15,11,10,46,40,6,56
Queen of S't,4766,5,12,10,14,45,47,-2,46
Dunfermline,4766,6,9,16,11,46,47,-1,43
Dumbarton,4766,7,9,14,13,44,51,-7,41
St Mirren,4766,8,9,10,17,39,54,-15,37
Raith,4766,9,9,9,18,32,52,-20,36
Ayr,4766,10,6,13,17,26,54,-28,31
Hibernian,4767,1,19,12,5,54,28,26,69
Morton,4767,2,18,11,7,47,31,16,65
Falkirk,4767,3,17,10,9,58,36,22,61
Dundee Utd,4767,4,17,9,10,53,41,12,60
Ayr,4767,5,11,12,13,40,53,-13,45
Queen of S't,4767,6,11,9,16,45,53,-8,42
St Mirren,4767,7,9,13,14,45,55,-10,40
Raith,4767,8,9,9,18,36,53,-17,36
Dunfermline,4767,9,8,11,17,44,56,-12,35
Dumbarton,4767,10,8,10,18,50,66,-16,34
Hibernian,4768,1,19,13,4,56,28,28,70
Morton,4768,2,18,11,7,55,39,16,65
Dundee Utd,4768,3,16,9,11,53,41,12,57
Falkirk,4768,4,15,9,12,55,43,12,54
Queen of S't,4768,5,13,10,13,45,46,-1,49
Ayr,4768,6,10,13,13,38,50,-12,43
Dunfermline,4768,7,10,12,14,47,49,-2,42
Raith,4768,8,9,10,17,31,49,-18,37
Dumbarton,4768,9,8,12,16,43,58,-15,36
St Mirren,4768,10,7,11,18,39,59,-20,32
Hibernian,4769,1,20,13,3,59,27,32,73
Falkirk,4769,2,17,10,9,58,41,17,61
Morton,4769,3,15,13,8,50,41,9,58
Dundee Utd,4769,4,14,12,10,45,37,8,54
Queen of S't,4769,5,10,12,14,40,47,-7,42
St Mirren,4769,6,10,10,16,44,55,-11,40
Raith,4769,7,10,9,17,32,46,-14,39
Ayr,4769,8,8,15,13,35,51,-16,39
Dunfermline,4769,9,8,14,14,44,50,-6,38
Dumbarton,4769,10,9,10,17,49,61,-12,37
Hibernian,4770,1,19,13,4,53,23,30,70
Morton,4770,2,17,11,8,50,36,14,62
Falkirk,4770,3,17,10,9,56,37,19,61
Dundee Utd,4770,4,13,14,9,45,39,6,53
Queen of S't,4770,5,12,11,13,44,47,-3,47
Raith,4770,6,12,8,16,34,47,-13,44
Dunfermline,4770,7,10,13,13,48,49,-1,43
Dumbarton,4770,8,9,10,17,46,56,-10,37
St Mirren,4770,9,8,10,18,37,54,-17,34
Ayr,4770,10,7,12,17,31,56,-25,33
Hibernian,4771,1,20,11,5,63,31,32,71
Falkirk,4771,2,19,9,8,62,37,25,66
Morton,4771,3,15,11,10,48,38,10,56
Dundee Utd,4771,4,15,8,13,48,43,5,53
Queen of S't,4771,5,13,8,15,49,52,-3,47
Dunfermline,4771,6,10,12,14,48,54,-6,42
Ayr,4771,7,10,11,15,39,58,-19,41
Dumbarton,4771,8,10,10,16,53,62,-9,40
Raith,4771,9,9,11,16,36,52,-16,38
St Mirren,4771,10,8,11,17,40,59,-19,35
Morton,4772,1,17,11,8,51,37,14,62
Hibernian,4772,2,16,12,8,48,30,18,60
Dundee Utd,4772,3,15,11,10,47,38,9,56
Falkirk,4772,4,15,10,11,58,41,17,55
Queen of S't,4772,5,13,8,15,50,54,-4,47
Dunfermline,4772,6,10,13,13,45,49,-4,43
Ayr,4772,7,10,12,14,36,53,-17,42
Raith,4772,8,10,11,15,34,46,-12,41
St Mirren,4772,9,9,12,15,41,51,-10,39
Dumbarton,4772,10,9,12,15,47,58,-11,39
Hibernian,4773,1,22,11,3,59,24,35,77
Morton,4773,2,19,10,7,60,33,27,67
Falkirk,4773,3,16,10,10,62,42,20,58
Dundee Utd,4773,4,16,9,11,48,39,9,57
Queen of S't,4773,5,11,9,16,43,51,-8,42
Dunfermline,4773,6,9,14,13,45,51,-6,41
Ayr,4773,7,10,11,15,36,54,-18,41
Raith,4773,8,9,10,17,33,54,-21,37
Dumbarton,4773,9,7,13,16,48,64,-16,34
St Mirren,4773,10,8,9,19,36,58,-22,33
Hibernian,4774,1,18,13,5,54,26,28,67
Morton,4774,2,18,12,6,49,32,17,66
Falkirk,4774,3,17,11,8,57,37,20,62
Dundee Utd,4774,4,16,11,9,48,34,14,59
Dunfermline,4774,5,11,11,14,47,47,0,44
Queen of S't,4774,6,11,10,15,43,50,-7,43
Raith,4774,7,10,11,15,34,46,-12,41
St Mirren,4774,8,9,11,16,40,53,-13,38
Ayr,4774,9,8,10,18,36,62,-26,34
Dumbarton,4774,10,7,10,19,41,62,-21,31
Hibernian,4775,1,17,14,5,54,28,26,65
Morton,4775,2,16,14,6,52,38,14,62
Falkirk,4775,3,16,11,9,56,38,18,59
Dundee Utd,4775,4,17,8,11,56,39,17,59
Queen of S't,4775,5,14,8,14,50,48,2,50
Dumbarton,4775,6,11,11,14,46,53,-7,44
Dunfermline,4775,7,9,13,14,46,52,-6,40
Raith,4775,8,9,10,17,33,50,-17,37
Ayr,4775,9,8,11,17,34,61,-27,35
St Mirren,4775,10,7,12,17,40,60,-20,33
Hibernian,4776,1,18,13,5,51,24,27,67
Morton,4776,2,18,10,8,49,33,16,64
Dundee Utd,4776,3,16,11,9,51,37,14,59
Falkirk,4776,4,14,11,11,54,39,15,53
Queen of S't,4776,5,12,10,14,46,47,-1,46
Dunfermline,4776,6,11,11,14,47,52,-5,44
Dumbarton,4776,7,11,10,15,46,55,-9,43
Raith,4776,8,10,9,17,37,55,-18,39
Ayr,4776,9,8,12,16,34,53,-19,36
St Mirren,4776,10,9,9,18,34,54,-20,36
Hibernian,4777,1,18,12,6,56,31,25,66
Morton,4777,2,16,10,10,46,38,8,58
Falkirk,4777,3,15,12,9,62,44,18,57
Dundee Utd,4777,4,14,11,11,48,38,10,53
Queen of S't,4777,5,13,9,14,47,51,-4,48
Dunfermline,4777,6,10,15,11,48,47,1,45
Ayr,4777,7,10,13,13,34,49,-15,43
St Mirren,4777,8,10,10,16,42,52,-10,40
Raith,4777,9,9,10,17,33,51,-18,37
Dumbarton,4777,10,7,14,15,45,60,-15,35
Hibernian,4778,1,18,13,5,52,25,27,67
Morton,4778,2,15,14,7,48,35,13,59
Dundee Utd,4778,3,16,10,10,49,40,9,58
Falkirk,4778,4,15,10,11,54,39,15,55
Dunfermline,4778,5,12,14,10,47,42,5,50
Queen of S't,4778,6,10,12,14,43,51,-8,42
St Mirren,4778,7,10,9,17,41,54,-13,39
Dumbarton,4778,8,9,11,16,46,54,-8,38
Raith,4778,9,9,10,17,31,49,-18,37
Ayr,4778,10,8,13,15,35,57,-22,37
Hibernian,4779,1,18,14,4,54,27,27,68
Falkirk,4779,2,17,10,9,66,43,23,61
Morton,4779,3,15,13,8,51,38,13,58
Dundee Utd,4779,4,16,10,10,52,43,9,58
Queen of S't,4779,5,11,11,14,44,48,-4,44
Dumbarton,4779,6,10,13,13,51,57,-6,43
Dunfermline,4779,7,8,15,13,42,50,-8,39
Raith,4779,8,9,10,17,31,51,-20,37
St Mirren,4779,9,8,12,16,39,54,-15,36
Ayr,4779,10,8,12,16,36,55,-19,36
Hibernian,4780,1,18,14,4,55,23,32,68
Falkirk,4780,2,17,11,8,59,40,19,62
Morton,4780,3,15,13,8,48,35,13,58
Dundee Utd,4780,4,16,9,11,53,44,9,57
Queen of S't,4780,5,13,8,15,47,54,-7,47
Dunfermline,4780,6,11,13,12,53,49,4,46
Raith,4780,7,9,10,17,33,50,-17,37
St Mirren,4780,8,9,10,17,38,56,-18,37
Dumbarton,4780,9,8,12,16,45,57,-12,36
Ayr,4780,10,7,14,15,33,56,-23,35
Morton,4781,1,19,11,6,52,34,18,68
Hibernian,4781,2,18,12,6,53,30,23,66
Falkirk,4781,3,16,10,10,59,43,16,58
Dundee Utd,4781,4,14,9,13,47,46,1,51
Ayr,4781,5,11,12,13,40,50,-10,45
Dunfermline,4781,6,10,14,12,51,46,5,44
Dumbarton,4781,7,11,10,15,49,57,-8,43
Queen of S't,4781,8,9,13,14,42,49,-7,40
St Mirren,4781,9,9,10,17,44,60,-16,37
Raith,4781,10,8,9,19,32,54,-22,33
Hibernian,4782,1,19,13,4,54,22,32,70
Falkirk,4782,2,17,10,9,56,39,17,61
Morton,4782,3,16,9,11,50,45,5,57
Dundee Utd,4782,4,15,11,10,49,40,9,56
Queen of S't,4782,5,11,13,12,49,51,-2,46
Dunfermline,4782,6,10,13,13,51,48,3,43
Raith,4782,7,11,9,16,37,50,-13,42
Ayr,4782,8,9,13,14,38,55,-17,40
Dumbarton,4782,9,8,11,17,43,60,-17,35
St Mirren,4782,10,8,10,18,38,55,-17,34
Hibernian,4783,1,20,13,3,55,22,33,73
Morton,4783,2,16,11,9,54,40,14,59
Dundee Utd,4783,3,16,10,10,53,39,14,58
Falkirk,4783,4,15,9,12,54,43,11,54
Queen of S't,4783,5,11,10,15,42,50,-8,43
Dumbarton,4783,6,10,12,14,53,58,-5,42
Raith,4783,7,10,11,15,33,49,-16,41
Ayr,4783,8,10,11,15,34,55,-21,41
Dunfermline,4783,9,8,14,14,42,47,-5,38
St Mirren,4783,10,8,11,17,43,60,-17,35
Hibernian,4784,1,18,13,5,50,24,26,67
Morton,4784,2,18,11,7,52,35,17,65
Dundee Utd,4784,3,14,12,10,51,45,6,54
Falkirk,4784,4,14,11,11,55,44,11,53
Queen of S't,4784,5,14,8,14,48,47,1,50
Dunfermline,4784,6,10,13,13,49,49,0,43
Raith,4784,7,11,9,16,33,45,-12,42
St Mirren,4784,8,10,11,15,44,53,-9,41
Dumbarton,4784,9,10,10,16,47,61,-14,40
Ayr,4784,10,6,12,18,28,54,-26,30
Hibernian,4785,1,19,13,4,54,27,27,70
Falkirk,4785,2,15,11,10,59,43,16,56
Morton,4785,3,15,11,10,49,41,8,56
Dundee Utd,4785,4,14,10,12,48,45,3,52
Dumbarton,4785,5,12,11,13,62,58,4,47
Dunfermline,4785,6,11,13,12,46,50,-4,46
Queen of S't,4785,7,12,8,16,47,52,-5,44
Raith,4785,8,10,13,13,37,46,-9,43
St Mirren,4785,9,8,12,16,41,57,-16,36
Ayr,4785,10,7,12,17,35,59,-24,33
Hibernian,4786,1,20,12,4,60,26,34,72
Morton,4786,2,15,14,7,52,37,15,59
Dundee Utd,4786,3,16,11,9,49,40,9,59
Falkirk,4786,4,16,9,11,58,39,19,57
Dunfermline,4786,5,11,12,13,47,50,-3,45
Queen of S't,4786,6,11,11,14,46,52,-6,44
Ayr,4786,7,8,14,14,34,54,-20,38
Raith,4786,8,9,10,17,33,50,-17,37
Dumbarton,4786,9,7,15,14,44,55,-11,36
St Mirren,4786,10,8,10,18,36,56,-20,34
Hibernian,4787,1,18,13,5,55,25,30,67
Falkirk,4787,2,16,9,11,57,41,16,57
Dundee Utd,4787,3,15,10,11,50,42,8,55
Queen of S't,4787,4,14,10,12,50,46,4,52
Morton,4787,5,13,11,12,44,45,-1,50
Raith,4787,6,11,10,15,38,48,-10,43
Dunfermline,4787,7,10,12,14,46,51,-5,42
Dumbarton,4787,8,10,10,16,46,55,-9,40
St Mirren,4787,9,10,10,16,38,52,-14,40
Ayr,4787,10,9,13,14,32,51,-19,40
Hibernian,4788,1,20,11,5,53,23,30,71
Morton,4788,2,17,10,9,53,37,16,61
Falkirk,4788,3,16,10,10,61,46,15,58
Dundee Utd,4788,4,16,10,10,52,40,12,58
Dunfermline,4788,5,12,11,13,47,47,0,47
Dumbarton,4788,6,10,12,14,51,56,-5,42
Raith,4788,7,11,9,16,36,47,-11,42
Ayr,4788,8,10,10,16,35,57,-22,40
Queen of S't,4788,9,10,8,18,42,55,-13,38
St Mirren,4788,10,7,11,18,36,58,-22,32
Hibernian,4789,1,21,12,3,61,25,36,75
Falkirk,4789,2,15,10,11,57,46,11,55
Morton,4789,3,14,13,9,47,44,3,55
Dundee Utd,4789,4,13,11,12,51,46,5,50
Dumbarton,4789,5,12,11,13,58,55,3,47
Dunfermline,4789,6,11,13,12,54,52,2,46
Queen of S't,4789,7,12,9,15,45,53,-8,45
Raith,4789,8,10,10,16,37,50,-13,40
Ayr,4789,9,8,14,14,37,55,-18,38
St Mirren,4789,10,7,11,18,37,58,-21,32
Hibernian,4790,1,21,12,3,65,24,41,75
Falkirk,4790,2,16,11,9,57,38,19,59
Morton,4790,3,14,13,9,55,46,9,55
Dundee Utd,4790,4,15,10,11,49,42,7,55
Queen of S't,4790,5,12,8,16,47,60,-13,44
Ayr,4790,6,10,12,14,40,53,-13,42
Dunfermline,4790,7,9,14,13,50,54,-4,41
Raith,4790,8,10,10,16,36,51,-15,40
St Mirren,4790,9,9,10,17,40,58,-18,37
Dumbarton,4790,10,7,14,15,49,62,-13,35
Hibernian,4791,1,18,12,6,58,32,26,66
Dundee Utd,4791,2,19,8,9,56,39,17,65
Morton,4791,3,16,13,7,54,36,18,61
Falkirk,4791,4,16,10,10,66,48,18,58
Queen of S't,4791,5,13,9,14,49,51,-2,48
Dunfermline,4791,6,11,13,12,45,46,-1,46
Dumbarton,4791,7,10,12,14,50,60,-10,42
Raith,4791,8,9,11,16,35,53,-18,38
St Mirren,4791,9,8,10,18,42,61,-19,34
Ayr,4791,10,6,10,20,32,61,-29,28
Hibernian,4792,1,19,11,6,54,25,29,68
Falkirk,4792,2,17,9,10,61,45,16,60
Morton,4792,3,16,10,10,51,41,10,58
Dundee Utd,4792,4,14,10,12,50,46,4,52
Dunfermline,4792,5,13,11,12,51,45,6,50
Queen of S't,4792,6,13,8,15,47,51,-4,47
Dumbarton,4792,7,11,10,15,49,57,-8,43
St Mirren,4792,8,9,11,16,44,56,-12,38
Raith,4792,9,9,10,17,32,51,-19,37
Ayr,4792,10,8,12,16,39,61,-22,36
Hibernian,4793,1,22,11,3,58,22,36,77
Morton,4793,2,17,10,9,51,37,14,61
Falkirk,4793,3,17,9,10,58,40,18,60
Dundee Utd,4793,4,16,10,10,49,38,11,58
Queen of S't,4793,5,11,10,15,44,53,-9,43
Ayr,4793,6,9,13,14,36,52,-16,40
Raith,4793,7,10,9,17,33,53,-20,39
Dumbarton,4793,8,9,11,16,49,59,-10,38
Dunfermline,4793,9,8,13,15,47,52,-5,37
St Mirren,4793,10,8,10,18,37,56,-19,34
Hibernian,4794,1,21,10,5,56,24,32,73
Falkirk,4794,2,17,12,7,59,38,21,63
Morton,4794,3,17,11,8,53,36,17,62
Dundee Utd,4794,4,16,11,9,50,38,12,59
Queen of S't,4794,5,12,9,15,40,48,-8,45
Raith,4794,6,10,11,15,35,47,-12,41
Ayr,4794,7,10,11,15,40,54,-14,41
Dunfermline,4794,8,8,13,15,43,51,-8,37
Dumbarton,4794,9,7,11,18,45,65,-20,32
St Mirren,4794,10,7,11,18,38,58,-20,32
Hibernian,4795,1,18,14,4,56,28,28,68
Morton,4795,2,18,12,6,53,34,19,66
Dundee Utd,4795,3,16,11,9,53,38,15,59
Falkirk,4795,4,14,13,9,55,41,14,55
Dunfermline,4795,5,10,13,13,49,52,-3,43
Queen of S't,4795,6,10,12,14,42,49,-7,42
Dumbarton,4795,7,10,10,16,47,56,-9,40
Raith,4795,8,10,9,17,35,54,-19,39
Ayr,4795,9,9,10,17,33,57,-24,37
St Mirren,4795,10,7,12,17,42,56,-14,33
Hibernian,4796,1,18,11,7,52,27,25,65
Morton,4796,2,17,10,9,50,42,8,61
Dundee Utd,4796,3,17,8,11,54,40,14,59
Falkirk,4796,4,15,11,10,52,39,13,56
Dunfermline,4796,5,12,11,13,48,47,1,47
Dumbarton,4796,6,11,12,13,54,57,-3,45
Queen of S't,4796,7,11,10,15,46,53,-7,43
Raith,4796,8,9,13,14,37,49,-12,40
St Mirren,4796,9,8,11,17,43,59,-16,35
Ayr,4796,10,7,13,16,34,57,-23,34
Morton,4797,1,19,10,7,54,34,20,67
Hibernian,4797,2,18,12,6,52,28,24,66
Falkirk,4797,3,16,10,10,62,43,19,58
Dundee Utd,4797,4,15,10,11,49,43,6,55
Dunfermline,4797,5,10,14,12,45,46,-1,44
Queen of S't,4797,6,11,10,15,46,52,-6,43
Raith,4797,7,11,10,15,38,48,-10,43
Dumbarton,4797,8,10,11,15,47,57,-10,41
St Mirren,4797,9,9,9,18,43,59,-16,36
Ayr,4797,10,7,12,17,31,57,-26,33
Hibernian,4798,1,20,12,4,55,25,30,72
Morton,4798,2,20,10,6,53,31,22,70
Dundee Utd,4798,3,16,11,9,57,41,16,59
Falkirk,4798,4,13,10,13,54,49,5,49
Queen of S't,4798,5,12,9,15,45,49,-4,45
Dunfermline,4798,6,10,11,15,51,51,0,41
Raith,4798,7,10,9,17,33,49,-16,39
Ayr,4798,8,9,12,15,33,56,-23,39
Dumbarton,4798,9,9,10,17,47,63,-16,37
St Mirren,4798,10,8,12,16,41,55,-14,36
Hibernian,4799,1,19,12,5,56,28,28,69
Morton,4799,2,17,11,8,56,36,20,62
Falkirk,4799,3,15,12,9,61,45,16,57
Dundee Utd,4799,4,15,11,10,46,38,8,56
Raith,4799,5,13,10,13,40,46,-6,49
Queen of S't,4799,6,11,11,14,43,49,-6,44
Dunfermline,4799,7,8,14,14,49,57,-8,38
Dumbarton,4799,8,8,14,14,48,60,-12,38
Ayr,4799,9,8,11,17,33,54,-21,35
St Mirren,4799,10,8,10,18,39,58,-19,34
Hibernian,4800,1,19,12,5,59,27,32,69
Falkirk,4800,2,18,11,7,64,41,23,65
Morton,4800,3,17,13,6,49,34,15,64
Dundee Utd,4800,4,15,9,12,51,45,6,54
Queen of S't,4800,5,12,10,14,48,50,-2,46
Raith,4800,6,10,9,17,36,53,-17,39
Dumbarton,4800,7,9,11,16,50,63,-13,38
Ayr,4800,8,9,11,16,35,56,-21,38
Dunfermline,4800,9,7,16,13,47,53,-6,37
St Mirren,4800,10,8,10,18,41,58,-17,34
Hibernian,4801,1,21,11,4,62,25,37,74
Falkirk,4801,2,19,9,8,64,41,23,66
Morton,4801,3,16,11,9,49,39,10,59
Dundee Utd,4801,4,16,10,10,51,36,15,58
Queen of S't,4801,5,11,11,14,46,52,-6,44
Raith,4801,6,10,10,16,35,48,-13,40
Dunfermline,4801,7,8,15,13,42,46,-4,39
Dumbarton,4801,8,9,10,17,48,62,-14,37
Ayr,4801,9,8,11,17,31,57,-26,35
St Mirren,4801,10,8,10,18,37,59,-22,34
Hibernian,4802,1,22,10,4,60,26,34,76
Morton,4802,2,18,12,6,52,34,18,66
Falkirk,4802,3,17,10,9,57,40,17,61
Dundee Utd,4802,4,17,9,10,51,40,11,60
Queen of S't,4802,5,12,9,15,49,51,-2,45
Dunfermline,4802,6,10,12,14,47,49,-2,42
St Mirren,4802,7,8,12,16,43,57,-14,36
Raith,4802,8,9,8,19,33,54,-21,35
Dumbarton,4802,9,7,12,17,43,62,-19,33
Ayr,4802,10,7,12,17,35,57,-22,33
Hibernian,4803,1,19,12,5,56,28,28,69
Morton,4803,2,19,11,6,59,38,21,68
Falkirk,4803,3,15,12,9,56,38,18,57
Dundee Utd,4803,4,15,11,10,50,44,6,56
Dunfermline,4803,5,10,15,11,50,50,0,45
Queen of S't,4803,6,12,9,15,47,53,-6,45
Raith,4803,7,10,10,16,38,48,-10,40
Ayr,4803,8,8,12,16,37,59,-22,36
St Mirren,4803,9,8,10,18,37,58,-21,34
Dumbarton,4803,10,7,12,17,45,59,-14,33
Hibernian,4804,1,19,14,3,58,26,32,71
Falkirk,4804,2,15,10,11,59,45,14,55
Dundee Utd,4804,3,14,12,10,47,41,6,54
Morton,4804,4,13,14,9,45,40,5,53
Queen of S't,4804,5,12,10,14,49,54,-5,46
St Mirren,4804,6,11,11,14,42,51,-9,44
Raith,4804,7,11,10,15,43,50,-7,43
Dunfermline,4804,8,8,15,13,47,54,-7,39
Dumbarton,4804,9,8,13,15,44,57,-13,37
Ayr,4804,10,8,13,15,39,55,-16,37
Hibernian,4805,1,20,13,3,62,25,37,73
Dundee Utd,4805,2,17,9,10,54,41,13,60
Morton,4805,3,14,13,9,46,41,5,55
Falkirk,4805,4,15,9,12,61,49,12,54
Dunfermline,4805,5,11,13,12,50,50,0,46
Dumbarton,4805,6,11,11,14,50,55,-5,44
Raith,4805,7,11,9,16,42,53,-11,42
Queen of S't,4805,8,11,9,16,46,58,-12,42
St Mirren,4805,9,9,10,17,44,58,-14,37
Ayr,4805,10,7,12,17,34,59,-25,33
Hibernian,4806,1,17,14,5,56,28,28,65
Falkirk,4806,2,16,12,8,68,47,21,60
Morton,4806,3,14,16,6,47,36,11,58
Dundee Utd,4806,4,15,10,11,50,44,6,55
Queen of S't,4806,5,11,10,15,48,55,-7,43
Dunfermline,4806,6,8,17,11,43,45,-2,41
Dumbarton,4806,7,10,11,15,50,57,-7,41
Ayr,4806,8,9,13,14,37,52,-15,40
St Mirren,4806,9,9,11,16,44,55,-11,38
Raith,4806,10,9,10,17,34,58,-24,37
Dundee Utd,4807,1,19,9,8,55,37,18,66
Hibernian,4807,2,18,11,7,53,28,25,65
Morton,4807,3,17,11,8,53,38,15,62
Falkirk,4807,4,14,10,12,57,46,11,52
Queen of S't,4807,5,14,8,14,46,48,-2,50
Raith,4807,6,11,10,15,37,49,-12,43
Dumbarton,4807,7,10,11,15,48,58,-10,41
St Mirren,4807,8,10,10,16,40,53,-13,40
Dunfermline,4807,9,8,13,15,48,54,-6,37
Ayr,4807,10,7,11,18,33,59,-26,32
Morton,4808,1,18,12,6,52,36,16,66
Falkirk,4808,2,18,9,9,59,37,22,63
Hibernian,4808,3,16,12,8,51,31,20,60
Dundee Utd,4808,4,16,10,10,48,39,9,58
Dunfermline,4808,5,11,13,12,48,44,4,46
Queen of S't,4808,6,12,8,16,46,51,-5,44
Raith,4808,7,11,11,14,34,44,-10,44
Dumbarton,4808,8,9,11,16,47,62,-15,38
Ayr,4808,9,8,10,18,33,55,-22,34
St Mirren,4808,10,7,12,17,39,58,-19,33
Hibernian,4809,1,19,12,5,59,37,22,69
Morton,4809,2,18,11,7,60,38,22,65
Falkirk,4809,3,15,13,8,61,40,21,58
Dundee Utd,4809,4,14,9,13,45,41,4,51
Queen of S't,4809,5,12,10,14,45,50,-5,46
Dumbarton,4809,6,11,11,14,49,58,-9,44
Dunfermline,4809,7,10,13,13,49,47,2,43
Raith,4809,8,10,11,15,38,49,-11,41
St Mirren,4809,9,8,10,18,43,62,-19,34
Ayr,4809,10,8,10,18,33,60,-27,34
Hibernian,4810,1,21,12,3,60,25,35,75
Morton,4810,2,16,12,8,54,39,15,60
Dundee Utd,4810,3,17,9,10,47,36,11,60
Falkirk,4810,4,16,11,9,61,44,17,59
Dunfermline,4810,5,10,12,14,43,47,-4,42
Raith,4810,6,11,9,16,38,51,-13,42
Queen of S't,4810,7,10,11,15,46,52,-6,41
Dumbarton,4810,8,9,13,14,49,59,-10,40
Ayr,4810,9,6,16,14,32,52,-20,34
St Mirren,4810,10,6,11,19,36,61,-25,29
Hibernian,4811,1,21,12,3,65,30,35,75
Morton,4811,2,18,11,7,52,34,18,65
Falkirk,4811,3,15,11,10,55,40,15,56
Dundee Utd,4811,4,14,10,12,45,38,7,52
Queen of S't,4811,5,12,8,16,42,49,-7,44
Dunfermline,4811,6,10,12,14,46,49,-3,42
Ayr,4811,7,10,11,15,31,50,-19,41
St Mirren,4811,8,10,10,16,45,57,-12,40
Dumbarton,4811,9,10,10,16,44,58,-14,40
Raith,4811,10,8,9,19,34,54,-20,33
Hibernian,4812,1,18,12,6,49,28,21,66
Morton,4812,2,17,12,7,51,37,14,63
Dundee Utd,4812,3,17,10,9,56,43,13,61
Falkirk,4812,4,17,9,10,55,38,17,60
Raith,4812,5,12,11,13,44,45,-1,47
Dunfermline,4812,6,9,14,13,52,51,1,41
Queen of S't,4812,7,10,9,17,41,54,-13,39
Ayr,4812,8,8,13,15,33,54,-21,37
St Mirren,4812,9,8,12,16,43,57,-14,36
Dumbarton,4812,10,7,12,17,43,60,-17,33
Hibernian,4813,1,18,13,5,54,28,26,67
Falkirk,4813,2,17,10,9,59,41,18,61
Morton,4813,3,17,10,9,53,36,17,61
Dundee Utd,4813,4,15,8,13,44,40,4,53
Dunfermline,4813,5,12,12,12,49,44,5,48
Queen of S't,4813,6,12,8,16,44,52,-8,44
Ayr,4813,7,11,10,15,37,54,-17,43
Raith,4813,8,11,9,16,35,47,-12,42
St Mirren,4813,9,9,10,17,40,56,-16,37
Dumbarton,4813,10,8,10,18,45,62,-17,34
Hibernian,4814,1,18,13,5,49,24,25,67
Falkirk,4814,2,18,10,8,58,38,20,64
Dundee Utd,4814,3,16,11,9,49,40,9,59
Morton,4814,4,13,15,8,47,39,8,54
Queen of S't,4814,5,14,9,13,46,44,2,51
Dunfermline,4814,6,10,13,13,46,48,-2,43
Ayr,4814,7,9,11,16,34,53,-19,38
St Mirren,4814,8,8,12,16,41,55,-14,36
Raith,4814,9,9,9,18,32,49,-17,36
Dumbarton,4814,10,8,11,17,46,58,-12,35
Hibernian,4815,1,17,13,6,53,29,24,64
Morton,4815,2,18,10,8,49,36,13,64
Dundee Utd,4815,3,16,9,11,53,42,11,57
Falkirk,4815,4,14,13,9,58,41,17,55
Queen of S't,4815,5,11,11,14,46,53,-7,44
Dunfermline,4815,6,10,12,14,50,54,-4,42
Dumbarton,4815,7,10,11,15,53,63,-10,41
Ayr,4815,8,10,11,15,36,57,-21,41
Raith,4815,9,10,9,17,35,50,-15,39
St Mirren,4815,10,9,11,16,47,55,-8,38
Hibernian,4816,1,19,12,5,53,26,27,69
Morton,4816,2,18,10,8,51,37,14,64
Falkirk,4816,3,17,11,8,57,37,20,62
Dundee Utd,4816,4,15,10,11,55,46,9,55
Queen of S't,4816,5,12,9,15,46,50,-4,45
Dunfermline,4816,6,10,11,15,48,52,-4,41
St Mirren,4816,7,10,11,15,46,55,-9,41
Raith,4816,8,10,9,17,39,53,-14,39
Ayr,4816,9,9,11,16,34,57,-23,38
Dumbarton,4816,10,8,10,18,50,66,-16,34
Hibernian,4817,1,20,13,3,61,29,32,73
Morton,4817,2,18,12,6,59,36,23,66
Falkirk,4817,3,16,11,9,59,43,16,59
Dundee Utd,4817,4,16,10,10,54,42,12,58
Dunfermline,4817,5,9,14,13,51,54,-3,41
Dumbarton,4817,6,10,11,15,53,61,-8,41
Raith,4817,7,10,10,16,37,51,-14,40
Queen of S't,4817,8,10,9,17,43,54,-11,39
St Mirren,4817,9,8,10,18,41,57,-16,34
Ayr,4817,10,7,12,17,33,64,-31,33
Hibernian,4818,1,19,12,5,57,27,30,69
Morton,4818,2,16,12,8,49,38,11,60
Dundee Utd,4818,3,16,11,9,51,41,10,59
Falkirk,4818,4,15,13,8,60,41,19,58
Raith,4818,5,12,9,15,40,50,-10,45
Dumbarton,4818,6,10,12,14,49,56,-7,42
Queen of S't,4818,7,10,11,15,42,50,-8,41
Dunfermline,4818,8,9,13,14,45,50,-5,40
St Mirren,4818,9,10,10,16,40,54,-14,40
Ayr,4818,10,6,11,19,31,57,-26,29
Hibernian,4819,1,20,12,4,53,23,30,72
Falkirk,4819,2,16,12,8,56,38,18,60
Dundee Utd,4819,3,16,11,9,52,38,14,59
Morton,4819,4,14,13,9,47,37,10,55
Ayr,4819,5,11,12,13,36,52,-16,45
Dunfermline,4819,6,9,15,12,47,50,-3,42
Queen of S't,4819,7,10,9,17,40,52,-12,39
Raith,4819,8,9,11,16,32,49,-17,38
St Mirren,4819,9,9,9,18,45,55,-10,36
Dumbarton,4819,10,8,12,16,44,58,-14,36
Hibernian,4820,1,18,14,4,58,28,30,68
Morton,4820,2,17,12,7,52,39,13,63
Falkirk,4820,3,17,9,10,57,42,15,60
Dundee Utd,4820,4,16,11,9,55,42,13,59
Dunfermline,4820,5,10,13,13,49,51,-2,43
Queen of S't,4820,6,11,10,15,47,52,-5,43
St Mirren,4820,7,10,10,16,45,55,-10,40
Raith,4820,8,10,9,17,38,54,-16,39
Dumbarton,4820,9,8,12,16,44,57,-13,36
Ayr,4820,10,6,14,16,34,59,-25,32
Hibernian,4821,1,18,11,7,59,35,24,65
Falkirk,4821,2,17,10,9,57,40,17,61
Morton,4821,3,16,12,8,48,37,11,60
Dundee Utd,4821,4,14,12,10,52,43,9,54
Dunfermline,4821,5,11,14,11,49,44,5,47
Raith,4821,6,12,10,14,36,46,-10,46
Dumbarton,4821,7,9,13,14,48,55,-7,40
Queen of S't,4821,8,10,9,17,44,54,-10,39
St Mirren,4821,9,8,12,16,43,56,-13,36
Ayr,4821,10,7,13,16,34,60,-26,34
Hibernian,4822,1,20,13,3,60,25,35,73
Falkirk,4822,2,17,9,10,63,41,22,60
Morton,4822,3,16,11,9,55,42,13,59
Dundee Utd,4822,4,14,9,13,46,44,2,51
Dunfermline,4822,5,12,12,12,48,46,2,48
Raith,4822,6,12,8,16,42,50,-8,44
Queen of S't,4822,7,12,8,16,46,56,-10,44
Ayr,4822,8,9,11,16,34,57,-23,38
Dumbarton,4822,9,9,10,17,47,63,-16,37
St Mirren,4822,10,7,13,16,40,57,-17,34
Morton,4823,1,18,11,7,50,35,15,65
Hibernian,4823,2,17,12,7,52,29,23,63
Dundee Utd,4823,3,16,11,9,56,37,19,59
Falkirk,4823,4,14,12,10,52,38,14,54
Queen of S't,4823,5,14,8,14,48,50,-2,50
Raith,4823,6,11,9,16,36,48,-12,42
Dunfermline,4823,7,9,13,14,40,49,-9,40
Dumbarton,4823,8,10,10,16,47,57,-10,40
St Mirren,4823,9,8,12,16,38,52,-14,36
Ayr,4823,10,8,12,16,34,58,-24,36
Hibernian,4824,1,21,12,3,63,24,39,75
Falkirk,4824,2,17,9,10,64,44,20,60
Dundee Utd,4824,3,17,9,10,48,36,12,60
Morton,4824,4,15,15,6,47,35,12,60
Queen of S't,4824,5,11,9,16,42,50,-8,42
Ayr,4824,6,9,13,14,37,51,-14,40
Raith,4824,7,10,10,16,33,50,-17,40
Dumbarton,4824,8,8,12,16,45,58,-13,36
Dunfermline,4824,9,7,14,15,37,51,-14,35
St Mirren,4824,10,8,11,17,40,57,-17,35
Hibernian,4825,1,18,11,7,52,29,23,65
Morton,4825,2,17,12,7,50,33,17,63
Falkirk,4825,3,15,11,10,55,38,17,56
Dundee Utd,4825,4,14,11,11,48,41,7,53
Queen of S't,4825,5,12,9,15,45,52,-7,45
Raith,4825,6,12,9,15,36,44,-8,45
Dumbarton,4825,7,11,10,15,49,57,-8,43
St Mirren,4825,8,11,9,16,44,50,-6,42
Ayr,4825,9,9,11,16,35,57,-22,38
Dunfermline,4825,10,8,13,15,41,54,-13,37
Hibernian,4826,1,16,14,6,54,31,23,62
Dundee Utd,4826,2,16,11,9,51,35,16,59
Morton,4826,3,15,14,7,45,33,12,59
Falkirk,4826,4,15,11,10,61,48,13,56
Dunfermline,4826,5,12,13,11,51,47,4,49
Queen of S't,4826,6,11,10,15,50,58,-8,43
Dumbarton,4826,7,10,11,15,52,60,-8,41
Raith,4826,8,10,11,15,36,49,-13,41
St Mirren,4826,9,9,11,16,42,52,-10,38
Ayr,4826,10,7,12,17,33,62,-29,33
Hibernian,4827,1,19,12,5,58,29,29,69
Morton,4827,2,17,12,7,50,35,15,63
Falkirk,4827,3,16,9,11,61,45,16,57
Dundee Utd,4827,4,14,9,13,45,42,3,51
Queen of S't,4827,5,13,9,14,44,48,-4,48
Dunfermline,4827,6,9,14,13,43,47,-4,41
Raith,4827,7,10,10,16,37,49,-12,40
Ayr,4827,8,9,13,14,36,52,-16,40
Dumbarton,4827,9,9,12,15,45,56,-11,39
St Mirren,4827,10,8,12,16,39,55,-16,36
Morton,4828,1,20,11,5,54,30,24,71
Hibernian,4828,2,17,13,6,56,32,24,64
Falkirk,4828,3,16,11,9,57,39,18,59
Dundee Utd,4828,4,14,11,11,51,45,6,53
Dunfermline,4828,5,10,14,12,49,46,3,44
Raith,4828,6,10,10,16,40,50,-10,40
Queen of S't,4828,7,10,10,16,46,59,-13,40
Ayr,4828,8,9,11,16,37,61,-24,38
St Mirren,4828,9,8,13,15,39,53,-14,37
Dumbarton,4828,10,8,12,16,45,59,-14,36
Hibernian,4829,1,19,11,6,58,32,26,68
Falkirk,4829,2,17,11,8,65,42,23,62
Dundee Utd,4829,3,17,10,9,54,40,14,61
Morton,4829,4,16,9,11,47,40,7,57
Dumbarton,4829,5,12,11,13,49,51,-2,47
Raith,4829,6,12,9,15,37,48,-11,45
Ayr,4829,7,11,11,14,37,50,-13,44
Queen of S't,4829,8,10,9,17,43,56,-13,39
Dunfermline,4829,9,8,12,16,44,53,-9,36
St Mirren,4829,10,7,9,20,38,60,-22,30
Hibernian,4830,1,23,10,3,63,25,38,79
Falkirk,4830,2,16,11,9,59,42,17,59
Dundee Utd,4830,3,15,11,10,50,41,9,56
Morton,4830,4,13,13,10,40,40,0,52
Queen of S't,4830,5,11,11,14,45,47,-2,44
Dunfermline,4830,6,10,13,13,45,47,-2,43
Raith,4830,7,11,9,16,35,48,-13,42
Ayr,4830,8,9,13,14,40,56,-16,40
Dumbarton,4830,9,8,13,15,43,56,-13,37
St Mirren,4830,10,7,10,19,38,56,-18,31
Hibernian,4831,1,20,12,4,59,25,34,72
Morton,4831,2,17,12,7,57,41,16,63
Falkirk,4831,3,17,9,10,59,45,14,60
Dundee Utd,4831,4,13,13,10,46,38,8,52
Dunfermline,4831,5,10,14,12,47,46,1,44
Ayr,4831,6,11,11,14,37,53,-16,44
Queen of S't,4831,7,11,10,15,45,51,-6,43
Raith,4831,8,10,8,18,35,49,-14,38
Dumbarton,4831,9,7,13,16,46,63,-17,34
St Mirren,4831,10,8,10,18,41,61,-20,34
Hibernian,4832,1,20,13,3,59,28,31,73
Morton,4832,2,19,10,7,55,35,20,67
Dundee Utd,4832,3,17,10,9,50,34,16,61
Falkirk,4832,4,15,11,10,57,41,16,56
Dunfermline,4832,5,9,14,13,50,50,0,41
Queen of S't,4832,6,10,11,15,44,52,-8,41
St Mirren,4832,7,9,11,16,42,53,-11,38
Dumbarton,4832,8,8,12,16,46,65,-19,36
Ayr,4832,9,7,14,15,31,55,-24,35
Raith,4832,10,8,10,18,32,53,-21,34
Hibernian,4833,1,21,11,4,56,22,34,74
Dundee Utd,4833,2,19,8,9,58,38,20,65
Falkirk,4833,3,17,10,9,62,40,22,61
Morton,4833,4,14,10,12,47,44,3,52
Dunfermline,4833,5,9,15,12,47,49,-2,42
Raith,4833,6,10,11,15,34,46,-12,41
Queen of S't,4833,7,10,9,17,45,58,-13,39
Dumbarton,4833,8,9,11,16,51,62,-11,38
Ayr,4833,9,9,11,16,33,57,-24,38
St Mirren,4833,10,9,10,17,39,56,-17,37
Hibernian,4834,1,18,13,5,58,27,31,67
Falkirk,4834,2,18,9,9,60,38,22,63
Morton,4834,3,17,11,8,50,40,10,62
Dundee Utd,4834,4,14,12,10,46,37,9,54
Dunfermline,4834,5,13,11,12,51,49,2,50
Ayr,4834,6,9,14,13,36,54,-18,41
Queen of S't,4834,7,10,9,17,43,55,-12,39
Raith,4834,8,9,12,15,34,47,-13,39
Dumbarton,4834,9,8,11,17,45,60,-15,35
St Mirren,4834,10,8,10,18,39,55,-16,34
Hibernian,4835,1,18,12,6,54,26,28,66
Dundee Utd,4835,2,17,8,11,56,38,18,59
Falkirk,4835,3,16,11,9,55,38,17,59
Morton,4835,4,16,11,9,48,37,11,59
Dunfermline,4835,5,12,12,12,47,46,1,48
Queen of S't,4835,6,12,10,14,43,47,-4,46
Dumbarton,4835,7,9,13,14,47,55,-8,40
Ayr,4835,8,9,12,15,34,55,-21,39
Raith,4835,9,9,10,17,31,47,-16,37
St Mirren,4835,10,7,11,18,36,62,-26,32
Hibernian,4836,1,19,11,6,58,28,30,68
Morton,4836,2,17,10,9,51,44,7,61
Falkirk,4836,3,16,11,9,56,36,20,59
Dundee Utd,4836,4,16,9,11,53,41,12,57
Queen of S't,4836,5,13,11,12,52,51,1,50
Raith,4836,6,11,9,16,40,52,-12,42
Dunfermline,4836,7,9,13,14,46,51,-5,40
Dumbarton,4836,8,9,12,15,47,63,-16,39
Ayr,4836,9,8,12,16,33,54,-21,36
St Mirren,4836,10,8,10,18,45,61,-16,34
Hibernian,4837,1,19,14,3,61,27,34,71
Falkirk,4837,2,17,11,8,59,41,18,62
Morton,4837,3,15,13,8,51,40,11,58
Dundee Utd,4837,4,13,11,12,51,47,4,50
Queen of S't,4837,5,12,10,14,50,51,-1,46
Raith,4837,6,11,10,15,37,49,-12,43
Dunfermline,4837,7,10,12,14,49,53,-4,42
St Mirren,4837,8,9,12,15,49,56,-7,39
Ayr,4837,9,8,13,15,33,56,-23,37
Dumbarton,4837,10,7,12,17,44,64,-20,33
Morton,4838,1,21,10,5,61,33,28,73
Hibernian,4838,2,19,12,5,56,29,27,69
Dundee Utd,4838,3,15,10,11,53,44,9,55
Falkirk,4838,4,15,9,12,55,43,12,54
Queen of S't,4838,5,12,8,16,49,56,-7,44
Dunfermline,4838,6,10,13,13,52,54,-2,43
Dumbarton,4838,7,10,12,14,49,57,-8,42
Raith,4838,8,9,11,16,34,49,-15,38
Ayr,4838,9,7,13,16,33,57,-24,34
St Mirren,4838,10,7,12,17,41,61,-20,33
Hibernian,4839,1,18,13,5,49,24,25,67
Morton,4839,2,16,12,8,47,34,13,60
Falkirk,4839,3,16,10,10,59,40,19,58
Dundee Utd,4839,4,15,10,11,49,41,8,55
Dunfermline,4839,5,10,13,13,44,45,-1,43
Queen of S't,4839,6,11,9,16,44,53,-9,42
Raith,4839,7,11,9,16,35,46,-11,42
Ayr,4839,8,9,13,14,37,55,-18,40
Dumbarton,4839,9,9,12,15,45,56,-11,39
St Mirren,4839,10,9,11,16,40,55,-15,38
Hibernian,4840,1,19,13,4,57,25,32,70
Morton,4840,2,18,10,8,56,37,19,64
Falkirk,4840,3,16,12,8,60,40,20,60
Dundee Utd,4840,4,16,10,10,49,41,8,58
Dunfermline,4840,5,11,13,12,46,47,-1,46
Queen of S't,4840,6,11,12,13,40,44,-4,45
Ayr,4840,7,8,14,14,32,50,-18,38
Raith,4840,8,8,11,17,30,53,-23,35
Dumbarton,4840,9,7,12,17,46,63,-17,33
St Mirren,4840,10,7,11,18,41,57,-16,32
Hibernian,4841,1,20,11,5,60,26,34,71
Morton,4841,2,18,10,8,54,39,15,64
Falkirk,4841,3,16,11,9,58,41,17,59
Dundee Utd,4841,4,15,8,13,49,41,8,53
Queen of S't,4841,5,12,9,15,47,55,-8,45
Raith,4841,6,11,9,16,38,50,-12,42
Ayr,4841,7,10,11,15,40,54,-14,41
Dunfermline,4841,8,8,14,14,47,55,-8,38
Dumbarton,4841,9,9,11,16,49,65,-16,38
St Mirren,4841,10,9,10,17,40,56,-16,37
Hibernian,4842,1,18,13,5,58,27,31,67
Morton,4842,2,17,12,7,53,37,16,63
Dundee Utd,4842,3,17,8,11,55,44,11,59
Falkirk,4842,4,15,13,8,56,37,19,58
Dunfermline,4842,5,12,12,12,49,50,-1,48
Queen of S't,4842,6,12,9,15,47,49,-2,45
Ayr,4842,7,11,10,15,36,52,-16,43
Raith,4842,8,9,11,16,33,49,-16,38
Dumbarton,4842,9,7,12,17,46,66,-20,33
St Mirren,4842,10,7,10,19,38,60,-22,31
Hibernian,4843,1,18,13,5,55,30,25,67
Falkirk,4843,2,16,10,10,59,44,15,58
Morton,4843,3,14,14,8,45,36,9,56
Dundee Utd,4843,4,15,11,10,50,43,7,56
Queen of S't,4843,5,13,10,13,48,47,1,49
Dumbarton,4843,6,10,11,15,44,53,-9,41
Ayr,4843,7,10,11,15,40,53,-13,41
Dunfermline,4843,8,9,13,14,44,48,-4,40
Raith,4843,9,10,9,17,34,51,-17,39
St Mirren,4843,10,8,12,16,38,52,-14,36
Hibernian,4844,1,19,10,7,52,27,25,67
Falkirk,4844,2,19,10,7,59,35,24,67
Dundee Utd,4844,3,15,11,10,50,40,10,56
Morton,4844,4,14,12,10,48,42,6,54
Dunfermline,4844,5,13,12,11,51,44,7,51
Raith,4844,6,11,8,17,39,52,-13,41
Queen of S't,4844,7,10,9,17,40,53,-13,39
Dumbarton,4844,8,9,11,16,50,59,-9,38
St Mirren,4844,9,9,11,16,40,53,-13,38
Ayr,4844,10,8,12,16,32,56,-24,36
Hibernian,4845,1,18,12,6,52,29,23,66
Dundee Utd,4845,2,17,11,8,50,33,17,62
Morton,4845,3,17,10,9,51,34,17,61
Falkirk,4845,4,14,10,12,55,45,10,52
Raith,4845,5,12,10,14,44,49,-5,46
Queen of S't,4845,6,12,8,16,50,55,-5,44
Dumbarton,4845,7,11,11,14,48,57,-9,44
Dunfermline,4845,8,10,12,14,48,51,-3,42
St Mirren,4845,9,7,13,16,42,64,-22,34
Ayr,4845,10,7,13,16,35,58,-23,34
Hibernian,4846,1,19,13,4,58,25,33,70
Dundee Utd,4846,2,17,10,9,54,36,18,61
Falkirk,4846,3,16,11,9,60,42,18,59
Morton,4846,4,15,12,9,46,37,9,57
Queen of S't,4846,5,11,11,14,47,54,-7,44
Raith,4846,6,11,11,14,41,51,-10,44
Dunfermline,4846,7,10,13,13,49,50,-1,43
Dumbarton,4846,8,8,11,17,46,61,-15,35
Ayr,4846,9,7,14,15,33,55,-22,35
St Mirren,4846,10,8,10,18,37,60,-23,34
Hibernian,4847,1,20,10,6,57,29,28,70
Morton,4847,2,16,14,6,52,36,16,62
Dundee Utd,4847,3,17,10,9,57,39,18,61
Falkirk,4847,4,17,9,10,62,40,22,60
Queen of S't,4847,5,12,8,16,51,57,-6,44
Dunfermline,4847,6,8,14,14,47,54,-7,38
Dumbarton,4847,7,8,14,14,49,61,-12,38
St Mirren,4847,8,9,11,16,40,57,-17,38
Raith,4847,9,10,8,18,34,55,-21,38
Ayr,4847,10,8,12,16,32,53,-21,36
Hibernian,4848,1,19,13,4,58,26,32,70
Dundee Utd,4848,2,17,10,9,51,38,13,61
Falkirk,4848,3,16,10,10,58,40,18,58
Morton,4848,4,15,12,9,49,39,10,57
Dunfermline,4848,5,11,13,12,46,49,-3,46
Raith,4848,6,10,10,16,37,50,-13,40
Dumbarton,4848,7,9,12,15,47,54,-7,39
Queen of S't,4848,8,10,9,17,39,53,-14,39
Ayr,4848,9,8,14,14,33,50,-17,38
St Mirren,4848,10,7,13,16,39,58,-19,34
Hibernian,4849,1,20,11,5,58,28,30,71
Morton,4849,2,19,11,6,54,33,21,68
Falkirk,4849,3,15,13,8,64,43,21,58
Dundee Utd,4849,4,15,10,11,51,45,6,55
Queen of S't,4849,5,12,9,15,46,52,-6,45
Raith,4849,6,10,11,15,32,46,-14,41
Ayr,4849,7,9,13,14,36,53,-17,40
Dumbarton,4849,8,9,12,15,50,60,-10,39
Dunfermline,4849,9,8,12,16,42,51,-9,36
St Mirren,4849,10,7,10,19,35,57,-22,31
Hibernian,4850,1,20,11,5,60,26,34,71
Falkirk,4850,2,17,11,8,60,40,20,62
Morton,4850,3,16,11,9,48,38,10,59
Dundee Utd,4850,4,15,10,11,47,38,9,55
Dunfermline,4850,5,10,14,12,45,47,-2,44
Raith,4850,6,11,10,15,35,46,-11,43
Queen of S't,4850,7,11,9,16,43,55,-12,42
Dumbarton,4850,8,9,12,15,51,57,-6,39
St Mirren,4850,9,9,11,16,43,57,-14,38
Ayr,4850,10,7,11,18,33,61,-28,32
Hibernian,4851,1,18,12,6,56,29,27,66
Morton,4851,2,17,11,8,51,35,16,62
Dundee Utd,4851,3,16,12,8,55,36,19,60
Falkirk,4851,4,15,13,8,58,42,16,58
Ayr,4851,5,11,12,13,36,50,-14,45
Raith,4851,6,11,9,16,37,47,-10,42
Dunfermline,4851,7,8,16,12,43,49,-6,40
Queen of S't,4851,8,10,10,16,44,51,-7,40
Dumbarton,4851,9,8,12,16,46,63,-17,36
St Mirren,4851,10,7,11,18,37,61,-24,32
Hibernian,4852,1,19,12,5,56,27,29,69
Morton,4852,2,15,13,8,53,38,15,58
Dundee Utd,4852,3,16,10,10,52,39,13,58
Falkirk,4852,4,15,10,11,58,43,15,55
Queen of S't,4852,5,12,11,13,46,47,-1,47
Raith,4852,6,11,9,16,36,51,-15,42
Dumbarton,4852,7,10,10,16,48,62,-14,40
Dunfermline,4852,8,7,18,11,45,48,-3,39
St Mirren,4852,9,9,11,16,42,58,-16,38
Ayr,4852,10,8,12,16,35,58,-23,36
Morton,4853,1,19,10,7,56,34,22,67
Hibernian,4853,2,18,12,6,55,27,28,66
Dundee Utd,4853,3,17,10,9,52,38,14,61
Falkirk,4853,4,15,13,8,56,39,17,58
Raith,4853,5,12,10,14,36,46,-10,46
Dumbarton,4853,6,10,12,14,53,57,-4,42
Queen of S't,4853,7,11,9,16,42,51,-9,42
Dunfermline,4853,8,9,12,15,45,50,-5,39
Ayr,4853,9,8,11,17,32,58,-26,35
St Mirren,4853,10,6,11,19,34,61,-27,29
Hibernian,4854,1,20,12,4,61,24,37,72
Falkirk,4854,2,17,10,9,65,45,20,61
Morton,4854,3,16,11,9,47,40,7,59
Dundee Utd,4854,4,16,9,11,56,44,12,57
Queen of S't,4854,5,15,8,13,49,51,-2,53
Dunfermline,4854,6,9,13,14,48,58,-10,40
Raith,4854,7,10,9,17,37,49,-12,39
Dumbarton,4854,8,8,12,16,43,56,-13,36
Ayr,4854,9,8,12,16,35,56,-21,36
St Mirren,4854,10,7,12,17,38,56,-18,33
Hibernian,4855,1,17,13,6,49,24,25,64
Morton,4855,2,17,11,8,49,33,16,62
Falkirk,4855,3,16,10,10,57,40,17,58
Dundee Utd,4855,4,15,12,9,52,41,11,57
Dunfermline,4855,5,11,13,12,48,46,2,46
Raith,4855,6,12,10,14,41,47,-6,46
Queen of S't,4855,7,12,9,15,42,52,-10,45
Dumbarton,4855,8,9,11,16,45,56,-11,38
Ayr,4855,9,7,14,15,32,56,-24,35
St Mirren,4855,10,7,11,18,38,58,-20,32
Hibernian,4856,1,18,13,5,51,25,26,67
Morton,4856,2,18,11,7,52,34,18,65
Falkirk,4856,3,16,10,10,60,42,18,58
Dundee Utd,4856,4,14,9,13,54,45,9,51
Queen of S't,4856,5,13,11,12,45,44,1,50
Dunfermline,4856,6,10,14,12,51,48,3,44
Raith,4856,7,11,10,15,33,50,-17,43
Ayr,4856,8,8,13,15,34,54,-20,37
St Mirren,4856,9,9,9,18,42,58,-16,36
Dumbarton,4856,10,8,10,18,49,71,-22,34
Morton,4857,1,18,12,6,53,33,20,66
Hibernian,4857,2,17,12,7,52,29,23,63
Dundee Utd,4857,3,17,8,11,47,38,9,59
Falkirk,4857,4,16,10,10,59,41,18,58
Queen of S't,4857,5,10,12,14,40,47,-7,42
Dumbarton,4857,6,9,14,13,48,54,-6,41
Raith,4857,7,10,10,16,34,53,-19,40
Dunfermline,4857,8,8,15,13,45,50,-5,39
Ayr,4857,9,9,12,15,34,53,-19,39
St Mirren,4857,10,8,11,17,39,53,-14,35
Hibernian,4858,1,19,12,5,55,26,29,69
Morton,4858,2,18,12,6,56,35,21,66
Falkirk,4858,3,16,10,10,63,43,20,58
Dundee Utd,4858,4,15,10,11,50,42,8,55
Dunfermline,4858,5,10,15,11,54,51,3,45
Queen of S't,4858,6,12,9,15,44,54,-10,45
Ayr,4858,7,9,13,14,36,53,-17,40
St Mirren,4858,8,9,9,18,40,56,-16,36
Dumbarton,4858,9,7,14,15,48,64,-16,35
Raith,4858,10,9,8,19,35,57,-22,35
Morton,4859,1,20,10,6,55,32,23,70
Hibernian,4859,2,19,12,5,53,26,27,69
Dundee Utd,4859,3,16,10,10,50,36,14,58
Falkirk,4859,4,15,11,10,59,42,17,56
Dunfermline,4859,5,11,13,12,46,44,2,46
Queen of S't,4859,6,12,10,14,44,48,-4,46
Raith,4859,7,10,8,18,38,51,-13,38
Dumbarton,4859,8,9,11,16,45,61,-16,38
St Mirren,4859,9,8,10,18,41,58,-17,34
Ayr,4859,10,6,13,17,28,61,-33,31
Hibernian,4860,1,20,10,6,56,29,27,70
Morton,4860,2,17,12,7,50,32,18,63
Dundee Utd,4860,3,17,11,8,54,34,20,62
Falkirk,4860,4,16,10,10,54,44,10,58
Queen of S't,4860,5,11,11,14,42,49,-7,44
Dunfermline,4860,6,9,14,13,45,45,0,41
Raith,4860,7,10,10,16,36,47,-11,40
Dumbarton,4860,8,9,12,15,45,55,-10,39
St Mirren,4860,9,8,10,18,37,57,-20,34
Ayr,4860,10,8,10,18,30,57,-27,34
Hibernian,4861,1,22,11,3,64,21,43,77
Morton,4861,2,15,12,9,48,39,9,57
Falkirk,4861,3,15,11,10,56,44,12,56
Dundee Utd,4861,4,14,11,11,52,46,6,53
Queen of S't,4861,5,13,9,14,47,51,-4,48
Dunfermline,4861,6,9,15,12,46,50,-4,42
Ayr,4861,7,10,12,14,42,54,-12,42
Raith,4861,8,10,9,17,36,50,-14,39
Dumbarton,4861,9,8,11,17,47,64,-17,35
St Mirren,4861,10,7,13,16,37,56,-19,34
Morton,4862,1,19,10,7,53,33,20,67
Hibernian,4862,2,18,11,7,57,30,27,65
Dundee Utd,4862,3,16,9,11,50,39,11,57
Falkirk,4862,4,13,12,11,57,46,11,51
Queen of S't,4862,5,14,9,13,48,49,-1,51
Dunfermline,4862,6,11,13,12,49,47,2,46
Raith,4862,7,10,11,15,34,47,-13,41
Dumbarton,4862,8,9,10,17,46,63,-17,37
St Mirren,4862,9,9,10,17,42,62,-20,37
Ayr,4862,10,8,11,17,36,56,-20,35
Hibernian,4863,1,18,13,5,53,24,29,67
Morton,4863,2,16,13,7,52,38,14,61
Falkirk,4863,3,16,12,8,58,41,17,60
Dundee Utd,4863,4,14,12,10,48,40,8,54
Raith,4863,5,12,11,13,38,45,-7,47
Dumbarton,4863,6,11,11,14,51,56,-5,44
Queen of S't,4863,7,11,10,15,42,48,-6,43
Dunfermline,4863,8,8,14,14,44,49,-5,38
St Mirren,4863,9,7,13,16,39,56,-17,34
Ayr,4863,10,7,11,18,31,59,-28,32
Hibernian,4864,1,20,10,6,58,26,32,70
Morton,4864,2,18,11,7,53,37,16,65
Falkirk,4864,3,17,9,10,62,44,18,60
Dundee Utd,4864,4,15,11,10,55,42,13,56
Queen of S't,4864,5,13,10,13,47,51,-4,49
Raith,4864,6,11,9,16,37,48,-11,42
Ayr,4864,7,9,12,15,38,57,-19,39
Dunfermline,4864,8,8,13,15,44,52,-8,37
Dumbarton,4864,9,8,12,16,49,62,-13,36
St Mirren,4864,10,8,9,19,40,64,-24,33
Hibernian,4865,1,22,10,4,63,25,38,76
Falkirk,4865,2,16,11,9,61,41,20,59
Dundee Utd,4865,3,16,11,9,52,37,15,59
Morton,4865,4,16,11,9,44,36,8,59
Dumbarton,4865,5,11,10,15,48,55,-7,43
Dunfermline,4865,6,9,15,12,44,50,-6,42
Queen of S't,4865,7,11,9,16,42,51,-9,42
Raith,4865,8,10,9,17,31,47,-16,39
St Mirren,4865,9,9,9,18,40,58,-18,36
Ayr,4865,10,7,11,18,31,56,-25,32
Hibernian,4866,1,19,12,5,62,30,32,69
Falkirk,4866,2,17,11,8,59,38,21,62
Morton,4866,3,17,9,10,48,42,6,60
Dundee Utd,4866,4,16,10,10,53,42,11,58
Raith,4866,5,11,11,14,40,48,-8,44
Queen of S't,4866,6,11,8,17,49,61,-12,41
Ayr,4866,7,9,12,15,44,59,-15,39
Dunfermline,4866,8,8,14,14,42,50,-8,38
Dumbarton,4866,9,9,11,16,48,61,-13,38
St Mirren,4866,10,9,10,17,41,55,-14,37
Hibernian,4867,1,22,11,3,59,23,36,77
Dundee Utd,4867,2,18,10,8,53,39,14,64
Morton,4867,3,15,13,8,49,37,12,58
Falkirk,4867,4,15,11,10,56,40,16,56
Dunfermline,4867,5,10,12,14,47,49,-2,42
Queen of S't,4867,6,11,9,16,45,54,-9,42
Raith,4867,7,10,10,16,34,49,-15,40
Dumbarton,4867,8,9,12,15,48,59,-11,39
Ayr,4867,9,7,13,16,33,55,-22,34
St Mirren,4867,10,7,11,18,36,55,-19,32
Hibernian,4868,1,20,12,4,61,25,36,72
Dundee Utd,4868,2,18,10,8,56,35,21,64
Falkirk,4868,3,17,10,9,63,39,24,61
Morton,4868,4,14,13,9,50,43,7,55
Dunfermline,4868,5,10,12,14,48,53,-5,42
Queen of S't,4868,6,11,9,16,43,53,-10,42
Dumbarton,4868,7,10,12,14,50,61,-11,42
Raith,4868,8,11,9,16,37,51,-14,42
Ayr,4868,9,7,12,17,33,59,-26,33
St Mirren,4868,10,7,11,18,40,62,-22,32
Hibernian,4869,1,20,12,4,57,24,33,72
Morton,4869,2,18,10,8,52,37,15,64
Dundee Utd,4869,3,17,10,9,59,41,18,61
Falkirk,4869,4,16,11,9,58,40,18,59
Queen of S't,4869,5,12,9,15,49,53,-4,45
Dunfermline,4869,6,9,14,13,44,50,-6,41
Raith,4869,7,9,11,16,35,52,-17,38
Dumbarton,4869,8,9,10,17,50,64,-14,37
St Mirren,4869,9,7,13,16,40,56,-16,34
Ayr,4869,10,8,10,18,37,64,-27,34
Hibernian,4870,1,19,13,4,59,25,34,70
Morton,4870,2,16,11,9,44,35,9,59
Dundee Utd,4870,3,15,10,11,46,40,6,55
Falkirk,4870,4,14,10,12,53,46,7,52
Raith,4870,5,12,9,15,36,45,-9,45
Ayr,4870,6,11,12,13,38,49,-11,45
Dunfermline,4870,7,10,12,14,47,49,-2,42
Dumbarton,4870,8,10,12,14,48,55,-7,42
Queen of S't,4870,9,11,9,16,42,51,-9,42
St Mirren,4870,10,8,10,18,38,56,-18,34
Hibernian,4871,1,18,13,5,56,27,29,67
Falkirk,4871,2,18,9,9,62,37,25,63
Dundee Utd,4871,3,18,8,10,57,43,14,62
Morton,4871,4,15,12,9,50,41,9,57
Dunfermline,4871,5,11,12,13,50,49,1,45
Ayr,4871,6,10,12,14,39,53,-14,42
Raith,4871,7,10,11,15,35,52,-17,41
Queen of S't,4871,8,10,10,16,44,55,-11,40
Dumbarton,4871,9,9,11,16,49,61,-12,38
St Mirren,4871,10,6,12,18,37,61,-24,30
Hibernian,4872,1,20,13,3,59,27,32,73
Morton,4872,2,17,9,10,56,43,13,60
Dundee Utd,4872,3,15,12,9,53,41,12,57
Falkirk,4872,4,14,14,8,56,39,17,56
Dunfermline,4872,5,10,15,11,47,48,-1,45
Queen of S't,4872,6,11,12,13,48,52,-4,45
Ayr,4872,7,9,11,16,35,57,-22,38
Dumbarton,4872,8,8,12,16,44,58,-14,36
St Mirren,4872,9,9,9,18,41,55,-14,36
Raith,4872,10,8,11,17,35,54,-19,35
Hibernian,4873,1,19,10,7,51,24,27,67
Falkirk,4873,2,17,11,8,62,40,22,62
Morton,4873,3,17,11,8,49,34,15,62
Dundee Utd,4873,4,12,13,11,43,42,1,49
Dunfermline,4873,5,12,12,12,48,46,2,48
St Mirren,4873,6,11,9,16,44,55,-11,42
Queen of S't,4873,7,10,11,15,47,55,-8,41
Ayr,4873,8,9,13,14,37,54,-17,40
Raith,4873,9,9,11,16,37,52,-15,38
Dumbarton,4873,10,8,11,17,46,62,-16,35
Hibernian,4874,1,19,12,5,56,27,29,69
Morton,4874,2,18,11,7,52,32,20,65
Falkirk,4874,3,17,10,9,57,42,15,61
Dundee Utd,4874,4,16,8,12,51,43,8,56
Queen of S't,4874,5,11,9,16,43,49,-6,42
Dumbarton,4874,6,10,10,16,49,59,-10,40
Raith,4874,7,10,10,16,34,48,-14,40
Ayr,4874,8,10,10,16,35,54,-19,40
Dunfermline,4874,9,7,16,13,42,50,-8,37
St Mirren,4874,10,9,10,17,44,59,-15,37
Hibernian,4875,1,18,14,4,53,25,28,68
Dundee Utd,4875,2,17,10,9,50,36,14,61
Morton,4875,3,16,10,10,51,37,14,58
Falkirk,4875,4,15,11,10,58,42,16,56
Queen of S't,4875,5,11,13,12,48,48,0,46
Dunfermline,4875,6,10,12,14,46,50,-4,42
Dumbarton,4875,7,9,11,16,49,61,-12,38
Raith,4875,8,9,11,16,37,52,-15,38
St Mirren,4875,9,9,11,16,39,61,-22,38
Ayr,4875,10,8,13,15,30,49,-19,37
Hibernian,4876,1,19,11,6,52,26,26,68
Dundee Utd,4876,2,16,9,11,56,46,10,57
Morton,4876,3,15,12,9,47,41,6,57
Falkirk,4876,4,15,10,11,52,41,11,55
Dunfermline,4876,5,12,12,12,51,47,4,48
St Mirren,4876,6,12,9,15,46,50,-4,45
Queen of S't,4876,7,12,8,16,44,48,-4,44
Dumbarton,4876,8,10,11,15,48,59,-11,41
Raith,4876,9,10,9,17,34,50,-16,39
Ayr,4876,10,7,13,16,31,53,-22,34
Hibernian,4877,1,18,15,3,57,27,30,69
Falkirk,4877,2,16,11,9,59,39,20,59
Morton,4877,3,15,14,7,50,38,12,59
Dundee Utd,4877,4,16,9,11,47,41,6,57
Dunfermline,4877,5,10,16,10,49,47,2,46
Queen of S't,4877,6,12,8,16,48,50,-2,44
Raith,4877,7,11,11,14,35,44,-9,44
Dumbarton,4877,8,8,12,16,46,64,-18,36
St Mirren,4877,9,8,10,18,44,60,-16,34
Ayr,4877,10,8,10,18,34,59,-25,34
Hibernian,4878,1,17,13,6,49,24,25,64
Dundee Utd,4878,2,18,8,10,54,38,16,62
Falkirk,4878,3,16,11,9,55,41,14,59
Morton,4878,4,15,12,9,45,32,13,57
Dunfermline,4878,5,10,15,11,44,42,2,45
Queen of S't,4878,6,12,9,15,45,51,-6,45
Raith,4878,7,9,12,15,34,50,-16,39
Dumbarton,4878,8,9,11,16,43,57,-14,38
St Mirren,4878,9,9,10,17,39,54,-15,37
Ayr,4878,10,8,13,15,37,56,-19,37
Hibernian,4879,1,18,11,7,53,27,26,65
Morton,4879,2,16,13,7,49,35,14,61
Falkirk,4879,3,15,9,12,57,46,11,54
Dundee Utd,4879,4,14,12,10,49,42,7,54
Dunfermline,4879,5,12,12,12,48,46,2,48
Queen of S't,4879,6,12,10,14,45,51,-6,46
St Mirren,4879,7,11,10,15,44,52,-8,43
Dumbarton,4879,8,9,12,15,48,56,-8,39
Ayr,4879,9,8,14,14,35,53,-18,38
Raith,4879,10,9,9,18,33,53,-20,36
Hibernian,4880,1,19,12,5,60,30,30,69
Morton,4880,2,17,13,6,55,36,19,64
Falkirk,4880,3,15,12,9,56,39,17,57
Dundee Utd,4880,4,15,9,12,50,44,6,54
Dunfermline,4880,5,12,12,12,50,48,2,48
Dumbarton,4880,6,11,10,15,49,57,-8,43
Queen of S't,4880,7,11,10,15,43,53,-10,43
St Mirren,4880,8,10,10,16,44,53,-9,40
Raith,4880,9,8,10,18,30,50,-20,34
Ayr,4880,10,7,12,17,31,58,-27,33
Hibernian,4881,1,21,12,3,60,25,35,75
Dundee Utd,4881,2,18,9,9,55,37,18,63
Falkirk,4881,3,15,11,10,57,45,12,56
Morton,4881,4,13,12,11,45,44,1,51
Queen of S't,4881,5,13,8,15,46,51,-5,47
Raith,4881,6,11,11,14,40,46,-6,44
Dunfermline,4881,7,10,13,13,50,51,-1,43
St Mirren,4881,8,9,11,16,42,55,-13,38
Dumbarton,4881,9,8,10,18,49,69,-20,34
Ayr,4881,10,7,13,16,32,53,-21,34
Hibernian,4882,1,17,12,7,56,29,27,63
Dundee Utd,4882,2,17,10,9,54,38,16,61
Morton,4882,3,17,10,9,52,41,11,61
Falkirk,4882,4,16,12,8,59,39,20,60
Queen of S't,4882,5,13,9,14,45,46,-1,48
Dunfermline,4882,6,10,14,12,47,51,-4,44
Ayr,4882,7,10,11,15,36,55,-19,41
St Mirren,4882,8,9,10,17,41,59,-18,37
Dumbarton,4882,9,8,12,16,46,58,-12,36
Raith,4882,10,8,10,18,33,53,-20,34
Hibernian,4883,1,20,12,4,55,25,30,72
Morton,4883,2,16,11,9,53,41,12,59
Falkirk,4883,3,16,10,10,55,41,14,58
Dundee Utd,4883,4,16,8,12,50,41,9,56
Raith,4883,5,13,9,14,37,43,-6,48
Queen of S't,4883,6,11,9,16,45,51,-6,42
Dunfermline,4883,7,9,13,14,47,51,-4,40
Dumbarton,4883,8,9,11,16,44,59,-15,38
Ayr,4883,9,9,11,16,35,56,-21,38
St Mirren,4883,10,9,10,17,41,54,-13,37
Hibernian,4884,1,20,12,4,63,27,36,72
Morton,4884,2,18,11,7,55,40,15,65
Falkirk,4884,3,16,10,10,55,38,17,58
Dundee Utd,4884,4,15,10,11,50,42,8,55
Queen of S't,4884,5,12,11,13,45,46,-1,47
Raith,4884,6,11,11,14,40,48,-8,44
Dumbarton,4884,7,9,11,16,44,56,-12,38
Dunfermline,4884,8,8,13,15,47,56,-9,37
Ayr,4884,9,8,11,17,31,52,-21,35
St Mirren,4884,10,8,10,18,38,63,-25,34
Hibernian,4885,1,21,12,3,58,21,37,75
Falkirk,4885,2,16,12,8,58,40,18,60
Morton,4885,3,16,11,9,48,40,8,59
Dundee Utd,4885,4,14,13,9,47,40,7,55
Queen of S't,4885,5,11,11,14,43,47,-4,44
Raith,4885,6,11,11,14,36,46,-10,44
Dumbarton,4885,7,9,13,14,49,54,-5,40
Dunfermline,4885,8,8,13,15,44,50,-6,37
Ayr,4885,9,7,13,16,32,54,-22,34
St Mirren,4885,10,7,11,18,37,60,-23,32
Hibernian,4886,1,19,11,6,53,29,24,68
Morton,4886,2,19,10,7,52,35,17,67
Dundee Utd,4886,3,19,8,9,53,35,18,65
Falkirk,4886,4,16,11,9,64,42,22,59
Queen of S't,4886,5,11,11,14,45,50,-5,44
Raith,4886,6,11,9,16,37,49,-12,42
Dunfermline,4886,7,9,13,14,49,52,-3,40
St Mirren,4886,8,9,11,16,40,55,-15,38
Dumbarton,4886,9,7,11,18,42,60,-18,32
Ayr,4886,10,6,13,17,30,58,-28,31
Morton,4887,1,18,10,8,50,34,16,64
Falkirk,4887,2,18,9,9,63,38,25,63
Hibernian,4887,3,17,12,7,50,29,21,63
Dundee Utd,4887,4,14,11,11,45,41,4,53
Queen of S't,4887,5,13,10,13,45,47,-2,49
Dunfermline,4887,6,10,13,13,47,47,0,43
Raith,4887,7,11,10,15,33,48,-15,43
Ayr,4887,8,7,16,13,31,50,-19,37
St Mirren,4887,9,8,11,17,42,58,-16,35
Dumbarton,4887,10,7,12,17,46,60,-14,33
Hibernian,4888,1,17,14,5,55,28,27,65
Dundee Utd,4888,2,17,9,10,54,37,17,60
Falkirk,4888,3,14,12,10,58,46,12,54
Morton,4888,4,13,14,9,46,46,0,53
Raith,4888,5,11,11,14,39,48,-9,44
Queen of S't,4888,6,11,10,15,45,53,-8,43
Dunfermline,4888,7,8,18,10,46,47,-1,42
Dumbarton,4888,8,9,13,14,50,58,-8,40
St Mirren,4888,9,9,12,15,42,51,-9,39
Ayr,4888,10,8,13,15,34,55,-21,37
Hibernian,4889,1,17,13,6,52,30,22,64
Morton,4889,2,17,11,8,50,39,11,62
Dundee Utd,4889,3,17,10,9,58,41,17,61
Falkirk,4889,4,15,13,8,60,41,19,58
Queen of S't,4889,5,13,8,15,48,49,-1,47
Dunfermline,4889,6,9,14,13,41,46,-5,41
St Mirren,4889,7,10,11,15,40,49,-9,41
Dumbarton,4889,8,9,11,16,50,65,-15,38
Raith,4889,9,9,9,18,34,51,-17,36
Ayr,4889,10,7,14,15,33,55,-22,35
Hibernian,4890,1,19,12,5,60,29,31,69
Morton,4890,2,16,12,8,52,39,13,60
Dundee Utd,4890,3,16,11,9,56,39,17,59
Falkirk,4890,4,13,14,9,56,43,13,53
Queen of S't,4890,5,13,10,13,44,44,0,49
Raith,4890,6,10,11,15,38,48,-10,41
Dunfermline,4890,7,8,15,13,43,51,-8,39
St Mirren,4890,8,9,11,16,44,58,-14,38
Ayr,4890,9,8,14,14,37,57,-20,38
Dumbarton,4890,10,7,12,17,43,65,-22,33
Hibernian,4891,1,18,13,5,52,25,27,67
Morton,4891,2,17,11,8,52,37,15,62
Dundee Utd,4891,3,17,10,9,55,38,17,61
Falkirk,4891,4,16,9,11,55,44,11,57
Dunfermline,4891,5,11,13,12,45,48,-3,46
Queen of S't,4891,6,11,12,13,46,47,-1,45
Raith,4891,7,9,12,15,34,45,-11,39
Ayr,4891,8,9,10,17,33,59,-26,37
St Mirren,4891,9,9,9,18,42,58,-16,36
Dumbarton,4891,10,8,11,17,49,62,-13,35
Hibernian,4892,1,19,12,5,57,28,29,69
Morton,4892,2,17,11,8,50,33,17,62
Dundee Utd,4892,3,16,11,9,50,39,11,59
Falkirk,4892,4,15,11,10,57,41,16,56
Dunfermline,4892,5,12,13,11,47,43,4,49
Queen of S't,4892,6,13,9,14,48,47,1,48
Raith,4892,7,10,9,17,36,52,-16,39
St Mirren,4892,8,9,10,17,41,55,-14,37
Dumbarton,4892,9,8,11,17,45,61,-16,35
Ayr,4892,10,6,13,17,33,65,-32,31
Hibernian,4893,1,20,11,5,59,25,34,71
Morton,4893,2,16,10,10,46,40,6,58
Dundee Utd,4893,3,16,9,11,58,47,11,57
Falkirk,4893,4,14,12,10,56,42,14,54
Queen of S't,4893,5,14,8,14,49,53,-4,50
Dunfermline,4893,6,11,13,12,48,46,2,46
Raith,4893,7,10,11,15,33,46,-13,41
St Mirren,4893,8,9,10,17,45,57,-12,37
Dumbarton,4893,9,8,13,15,49,62,-13,37
Ayr,4893,10,8,11,17,32,57,-25,35
Hibernian,4894,1,19,13,4,57,31,26,70
Morton,4894,2,15,14,7,49,36,13,59
Falkirk,4894,3,15,12,9,60,44,16,57
Dundee Utd,4894,4,15,10,11,51,42,9,55
Queen of S't,4894,5,12,11,13,51,51,0,47
Dunfermline,4894,6,10,14,12,47,46,1,44
St Mirren,4894,7,10,9,17,38,52,-14,39
Raith,4894,8,9,12,15,35,49,-14,39
Dumbarton,4894,9,9,11,16,50,64,-14,38
Ayr,4894,10,6,14,16,33,56,-23,32
Hibernian,4895,1,22,10,4,60,22,38,76
Morton,4895,2,16,10,10,53,42,11,58
Dundee Utd,4895,3,15,9,12,50,43,7,54
Falkirk,4895,4,14,10,12,54,47,7,52
Dumbarton,4895,5,12,11,13,56,54,2,47
Queen of S't,4895,6,13,8,15,47,53,-6,47
Dunfermline,4895,7,11,12,13,46,50,-4,45
Ayr,4895,8,9,13,14,39,54,-15,40
Raith,4895,9,9,10,17,37,52,-15,37
St Mirren,4895,10,7,11,18,43,68,-25,32
Hibernian,4896,1,21,11,4,57,24,33,74
Morton,4896,2,17,11,8,51,33,18,62
Falkirk,4896,3,16,9,11,54,43,11,57
Dundee Utd,4896,4,16,8,12,52,42,10,56
Queen of S't,4896,5,16,8,12,50,45,5,56
Dumbarton,4896,6,10,11,15,49,62,-13,41
Raith,4896,7,10,9,17,36,52,-16,39
Dunfermline,4896,8,8,12,16,42,49,-7,36
St Mirren,4896,9,8,10,18,40,60,-20,34
Ayr,4896,10,7,13,16,35,56,-21,34
Hibernian,4897,1,20,12,4,52,23,29,72
Morton,4897,2,17,10,9,59,40,19,61
Falkirk,4897,3,16,9,11,58,42,16,57
Dundee Utd,4897,4,15,11,10,51,42,9,56
Dunfermline,4897,5,11,12,13,44,44,0,45
Queen of S't,4897,6,12,8,16,43,53,-10,44
Dumbarton,4897,7,10,11,15,50,56,-6,41
Raith,4897,8,10,11,15,34,48,-14,41
St Mirren,4897,9,9,10,17,42,58,-16,37
Ayr,4897,10,7,12,17,31,58,-27,33
Hibernian,4898,1,18,11,7,49,27,22,65
Dundee Utd,4898,2,18,10,8,50,37,13,64
Morton,4898,3,16,11,9,49,38,11,59
Falkirk,4898,4,15,11,10,61,45,16,56
Raith,4898,5,13,10,13,41,45,-4,49
Dunfermline,4898,6,11,13,12,51,49,2,46
Queen of S't,4898,7,10,10,16,43,51,-8,40
St Mirren,4898,8,8,12,16,40,52,-12,36
Dumbarton,4898,9,8,11,17,43,62,-19,35
Ayr,4898,10,7,13,16,32,53,-21,34
Hibernian,4899,1,18,12,6,58,27,31,66
Falkirk,4899,2,17,11,8,60,40,20,62
Dundee Utd,4899,3,17,9,10,52,39,13,60
Morton,4899,4,16,12,8,48,35,13,60
Dumbarton,4899,5,12,10,14,52,54,-2,46
Queen of S't,4899,6,11,11,14,47,52,-5,44
Dunfermline,4899,7,9,13,14,45,56,-11,40
Raith,4899,8,10,8,18,36,52,-16,38
Ayr,4899,9,9,11,16,33,53,-20,38
St Mirren,4899,10,8,9,19,39,62,-23,33
Hibernian,4900,1,17,13,6,51,25,26,64
Dundee Utd,4900,2,18,9,9,53,41,12,63
Morton,4900,3,17,11,8,53,40,13,62
Falkirk,4900,4,15,13,8,57,38,19,58
Raith,4900,5,11,10,15,40,50,-10,43
St Mirren,4900,6,9,12,15,41,52,-11,39
Dumbarton,4900,7,9,12,15,46,59,-13,39
Ayr,4900,8,9,12,15,38,54,-16,39
Queen of S't,4900,9,9,11,16,41,51,-10,38
Dunfermline,4900,10,8,13,15,42,52,-10,37
Hibernian,4901,1,20,10,6,56,26,30,70
Morton,4901,2,17,11,8,48,37,11,62
Falkirk,4901,3,15,12,9,60,43,17,57
Dundee Utd,4901,4,16,9,11,47,39,8,57
Raith,4901,5,11,10,15,36,47,-11,43
Dunfermline,4901,6,10,12,14,44,48,-4,42
Queen of S't,4901,7,11,9,16,45,55,-10,42
Dumbarton,4901,8,10,11,15,52,58,-6,41
St Mirren,4901,9,9,11,16,42,56,-14,38
Ayr,4901,10,7,13,16,31,52,-21,34
Falkirk,4902,1,18,11,7,63,37,26,65
Hibernian,4902,2,17,13,6,49,25,24,64
Dundee Utd,4902,3,17,10,9,56,42,14,61
Morton,4902,4,16,11,9,47,35,12,59
Dunfermline,4902,5,10,14,12,46,48,-2,44
Queen of S't,4902,6,12,8,16,43,50,-7,44
Dumbarton,4902,7,9,11,16,51,65,-14,38
St Mirren,4902,8,9,10,17,43,59,-16,37
Ayr,4902,9,8,13,15,36,54,-18,37
Raith,4902,10,8,11,17,31,50,-19,35
Hibernian,4903,1,19,11,6,55,27,28,68
Morton,4903,2,19,10,7,54,37,17,67
Dundee Utd,4903,3,16,9,11,52,41,11,57
Falkirk,4903,4,15,11,10,54,39,15,56
Queen of S't,4903,5,13,9,14,47,49,-2,48
Dumbarton,4903,6,9,12,15,50,59,-9,39
Ayr,4903,7,9,12,15,41,61,-20,39
Dunfermline,4903,8,8,14,14,45,52,-7,38
St Mirren,4903,9,9,10,17,37,55,-18,37
Raith,4903,10,8,12,16,33,48,-15,36
Hibernian,4904,1,20,12,4,59,26,33,72
Falkirk,4904,2,16,12,8,57,38,19,60
Morton,4904,3,16,12,8,48,37,11,60
Dundee Utd,4904,4,16,10,10,48,37,11,58
Dunfermline,4904,5,11,12,13,50,53,-3,45
Queen of S't,4904,6,11,10,15,48,52,-4,43
Dumbarton,4904,7,10,11,15,48,59,-11,41
St Mirren,4904,8,9,10,17,44,58,-14,37
Raith,4904,9,9,10,17,35,52,-17,37
Ayr,4904,10,6,13,17,32,57,-25,31
Hibernian,4905,1,17,14,5,53,26,27,65
Falkirk,4905,2,17,12,7,57,36,21,63
Morton,4905,3,16,12,8,47,35,12,60
Dundee Utd,4905,4,16,11,9,49,36,13,59
Raith,4905,5,10,12,14,35,44,-9,42
Dumbarton,4905,6,10,11,15,50,54,-4,41
Ayr,4905,7,9,13,14,33,53,-20,40
Queen of S't,4905,8,9,12,15,40,49,-9,39
St Mirren,4905,9,8,12,16,37,52,-15,36
Dunfermline,4905,10,7,13,16,40,56,-16,34
Hibernian,4906,1,20,12,4,57,25,32,72
Morton,4906,2,16,11,9,49,38,11,59
Dundee Utd,4906,3,16,10,10,56,40,16,58
Falkirk,4906,4,14,11,11,61,49,12,53
Dunfermline,4906,5,11,12,13,50,50,0,45
Dumbarton,4906,6,11,12,13,53,59,-6,45
Raith,4906,7,12,9,15,42,53,-11,45
Queen of S't,4906,8,12,8,16,45,55,-10,44
St Mirren,4906,9,8,11,17,40,58,-18,35
Ayr,4906,10,7,10,19,33,59,-26,31
Morton,4907,1,19,11,6,53,32,21,68
Hibernian,4907,2,18,13,5,55,24,31,67
Falkirk,4907,3,18,9,9,62,42,20,63
Dundee Utd,4907,4,17,8,11,49,37,12,59
Dunfermline,4907,5,9,14,13,47,49,-2,41
Queen of S't,4907,6,10,11,15,43,51,-8,41
Dumbarton,4907,7,9,12,15,49,58,-9,39
Raith,4907,8,8,12,16,35,52,-17,36
Ayr,4907,9,8,12,16,35,59,-24,36
St Mirren,4907,10,8,10,18,39,63,-24,34
Hibernian,4908,1,19,13,4,53,24,29,70
Falkirk,4908,2,16,11,9,62,43,19,59
Morton,4908,3,15,14,7,49,37,12,59
Dundee Utd,4908,4,15,11,10,52,38,14,56
Dunfermline,4908,5,11,12,13,53,50,3,45
Queen of S't,4908,6,12,9,15,45,52,-7,45
Raith,4908,7,10,11,15,38,50,-12,41
Ayr,4908,8,9,13,14,35,55,-20,40
Dumbarton,4908,9,9,11,16,51,62,-11,38
St Mirren,4908,10,6,11,19,37,64,-27,29
Hibernian,4909,1,18,14,4,60,27,33,68
Falkirk,4909,2,17,12,7,66,38,28,63
Morton,4909,3,16,13,7,46,34,12,61
Dundee Utd,4909,4,15,10,11,49,39,10,55
Dunfermline,4909,5,10,14,12,46,48,-2,44
Queen of S't,4909,6,11,10,15,43,53,-10,43
Dumbarton,4909,7,10,10,16,48,62,-14,40
Ayr,4909,8,8,13,15,35,52,-17,37
Raith,4909,9,9,10,17,33,52,-19,37
St Mirren,4909,10,8,10,18,38,59,-21,34
Hibernian,4910,1,20,12,4,60,25,35,72
Falkirk,4910,2,17,10,9,58,37,21,61
Morton,4910,3,16,13,7,50,35,15,61
Dundee Utd,4910,4,16,10,10,49,40,9,58
Queen of S't,4910,5,12,9,15,45,48,-3,45
Dumbarton,4910,6,9,13,14,48,57,-9,40
Dunfermline,4910,7,8,15,13,45,51,-6,39
Ayr,4910,8,8,14,14,38,55,-17,38
Raith,4910,9,9,10,17,40,58,-18,37
St Mirren,4910,10,6,12,18,36,63,-27,30
Hibernian,4911,1,20,12,4,56,26,30,72
Morton,4911,2,19,11,6,54,34,20,68
Falkirk,4911,3,15,11,10,55,39,16,56
Dundee Utd,4911,4,14,10,12,49,46,3,52
Queen of S't,4911,5,13,9,14,49,48,1,48
St Mirren,4911,6,10,9,17,45,57,-12,39
Raith,4911,7,10,9,17,32,47,-15,39
Dunfermline,4911,8,8,13,15,41,50,-9,37
Dumbarton,4911,9,8,13,15,47,62,-15,37
Ayr,4911,10,8,13,15,38,57,-19,37
Hibernian,4912,1,19,13,4,56,27,29,70
Morton,4912,2,18,11,7,54,38,16,65
Falkirk,4912,3,17,12,7,64,39,25,63
Dundee Utd,4912,4,16,10,10,52,39,13,58
Queen of S't,4912,5,10,12,14,43,49,-6,42
Dunfermline,4912,6,8,15,13,43,48,-5,39
Dumbarton,4912,7,9,11,16,47,63,-16,38
St Mirren,4912,8,8,11,17,42,59,-17,35
Raith,4912,9,8,11,17,31,49,-18,35
Ayr,4912,10,7,14,15,31,52,-21,35
Hibernian,4913,1,22,11,3,66,27,39,77
Morton,4913,2,17,11,8,54,35,19,62
Falkirk,4913,3,15,12,9,60,40,20,57
Dundee Utd,4913,4,14,12,10,44,40,4,54
Dunfermline,4913,5,11,13,12,46,45,1,46
Dumbarton,4913,6,10,14,12,52,53,-1,44
Queen of S't,4913,7,10,10,16,41,54,-13,40
Ayr,4913,8,8,12,16,33,59,-26,36
Raith,4913,9,8,10,18,31,51,-20,34
St Mirren,4913,10,7,11,18,42,65,-23,32
Hibernian,4914,1,20,12,4,59,27,32,72
Falkirk,4914,2,16,13,7,64,38,26,61
Morton,4914,3,15,11,10,47,39,8,56
Dundee Utd,4914,4,15,9,12,53,42,11,54
Dunfermline,4914,5,11,14,11,48,48,0,47
Raith,4914,6,12,8,16,38,50,-12,44
Queen of S't,4914,7,11,10,15,45,51,-6,43
Dumbarton,4914,8,8,12,16,48,64,-16,36
Ayr,4914,9,8,12,16,30,53,-23,36
St Mirren,4914,10,8,11,17,38,58,-20,35
Morton,4915,1,20,9,7,58,32,26,69
Hibernian,4915,2,19,11,6,55,28,27,68
Falkirk,4915,3,17,10,9,59,37,22,61
Dundee Utd,4915,4,17,10,9,46,33,13,61
Queen of S't,4915,5,11,11,14,46,52,-6,44
Dunfermline,4915,6,9,12,15,44,53,-9,39
Raith,4915,7,10,9,17,34,47,-13,39
Dumbarton,4915,8,8,13,15,43,56,-13,37
Ayr,4915,9,7,14,15,29,53,-24,35
St Mirren,4915,10,8,9,19,36,59,-23,33
Hibernian,4916,1,17,14,5,54,27,27,65
Falkirk,4916,2,17,11,8,60,40,20,62
Morton,4916,3,15,13,8,47,38,9,58
Dundee Utd,4916,4,15,9,12,53,41,12,54
Queen of S't,4916,5,14,8,14,47,49,-2,50
Dumbarton,4916,6,10,13,13,48,54,-6,43
Ayr,4916,7,10,12,14,37,54,-17,42
Dunfermline,4916,8,9,12,15,42,52,-10,39
Raith,4916,9,9,11,16,34,46,-12,38
St Mirren,4916,10,8,9,19,37,58,-21,33
Hibernian,4917,1,21,10,5,59,23,36,73
Morton,4917,2,16,11,9,49,40,9,59
Falkirk,4917,3,15,10,11,58,45,13,55
Dundee Utd,4917,4,15,10,11,50,43,7,55
Dunfermline,4917,5,13,11,12,54,52,2,50
Dumbarton,4917,6,11,11,14,47,52,-5,44
Queen of S't,4917,7,11,9,16,43,52,-9,42
Raith,4917,8,9,11,16,33,50,-17,38
Ayr,4917,9,9,11,16,36,55,-19,38
St Mirren,4917,10,8,10,18,38,55,-17,34
Hibernian,4918,1,19,12,5,57,29,28,69
Morton,4918,2,18,11,7,51,34,17,65
Falkirk,4918,3,18,10,8,66,40,26,64
Dundee Utd,4918,4,16,10,10,49,39,10,58
Queen of S't,4918,5,11,12,13,47,48,-1,45
Dunfermline,4918,6,8,14,14,46,53,-7,38
Ayr,4918,7,8,14,14,31,53,-22,38
St Mirren,4918,8,9,10,17,43,55,-12,37
Raith,4918,9,9,8,19,34,57,-23,35
Dumbarton,4918,10,7,13,16,40,56,-16,34
Hibernian,4919,1,21,11,4,58,21,37,74
Morton,4919,2,20,10,6,56,33,23,70
Falkirk,4919,3,16,12,8,54,39,15,60
Dundee Utd,4919,4,14,8,14,46,44,2,50
Ayr,4919,5,11,11,14,39,57,-18,44
Queen of S't,4919,6,11,10,15,46,49,-3,43
Dunfermline,4919,7,9,13,14,42,49,-7,40
Dumbarton,4919,8,9,12,15,46,56,-10,39
Raith,4919,9,9,10,17,34,49,-15,37
St Mirren,4919,10,6,11,19,37,61,-24,29
Hibernian,4920,1,19,13,4,54,24,30,70
Morton,4920,2,17,10,9,50,41,9,61
Dundee Utd,4920,3,16,10,10,51,39,12,58
Falkirk,4920,4,15,11,10,58,45,13,56
Dunfermline,4920,5,11,13,12,50,48,2,46
Raith,4920,6,10,10,16,34,48,-14,40
Dumbarton,4920,7,9,12,15,48,57,-9,39
Queen of S't,4920,8,10,9,17,43,54,-11,39
Ayr,4920,9,8,14,14,34,51,-17,38
St Mirren,4920,10,8,12,16,39,54,-15,36
Hibernian,4921,1,21,12,3,58,23,35,75
Morton,4921,2,17,10,9,48,35,13,61
Dundee Utd,4921,3,15,11,10,51,40,11,56
Falkirk,4921,4,14,12,10,57,43,14,54
Dunfermline,4921,5,11,11,14,49,51,-2,44
Queen of S't,4921,6,11,10,15,41,50,-9,43
Raith,4921,7,11,10,15,37,49,-12,43
Dumbarton,4921,8,9,13,14,53,60,-7,40
Ayr,4921,9,8,12,16,35,54,-19,36
St Mirren,4921,10,7,11,18,38,62,-24,32
Hibernian,4922,1,22,10,4,62,25,37,76
Dundee Utd,4922,2,17,10,9,55,39,16,61
Falkirk,4922,3,16,11,9,57,39,18,59
Morton,4922,4,15,10,11,50,42,8,55
Queen of S't,4922,5,12,11,13,48,50,-2,47
Dunfermline,4922,6,12,11,13,46,48,-2,47
Raith,4922,7,10,10,16,32,47,-15,40
Ayr,4922,8,8,13,15,37,58,-21,37
Dumbarton,4922,9,7,12,17,46,63,-17,33
St Mirren,4922,10,7,10,19,35,57,-22,31
Hibernian,4923,1,19,12,5,56,27,29,69
Morton,4923,2,18,11,7,53,36,17,65
Falkirk,4923,3,16,11,9,57,42,15,59
Dundee Utd,4923,4,15,11,10,52,42,10,56
Dunfermline,4923,5,11,13,12,50,48,2,46
Queen of S't,4923,6,12,8,16,45,55,-10,44
St Mirren,4923,7,9,11,16,41,52,-11,38
Raith,4923,8,10,8,18,32,50,-18,38
Dumbarton,4923,9,8,12,16,47,58,-11,36
Ayr,4923,10,7,13,16,34,57,-23,34
Hibernian,4924,1,20,11,5,58,27,31,71
Morton,4924,2,18,11,7,54,37,17,65
Falkirk,4924,3,16,9,11,66,45,21,57
Dundee Utd,4924,4,15,10,11,47,37,10,55
Queen of S't,4924,5,11,9,16,44,55,-11,42
St Mirren,4924,6,11,9,16,46,58,-12,42
Dunfermline,4924,7,9,13,14,43,50,-7,40
Raith,4924,8,10,10,16,38,51,-13,40
Ayr,4924,9,9,13,14,34,51,-17,40
Dumbarton,4924,10,8,11,17,43,62,-19,35
Hibernian,4925,1,20,11,5,57,27,30,71
Morton,4925,2,16,10,10,53,44,9,58
Falkirk,4925,3,15,12,9,61,46,15,57
Dundee Utd,4925,4,13,13,10,47,41,6,52
Dunfermline,4925,5,12,12,12,54,49,5,48
Queen of S't,4925,6,11,12,13,44,48,-4,45
Raith,4925,7,11,10,15,36,47,-11,43
Dumbarton,4925,8,9,13,14,48,58,-10,40
St Mirren,4925,9,7,13,16,42,59,-17,34
Ayr,4925,10,6,14,16,31,54,-23,32
Hibernian,4926,1,17,14,5,51,25,26,65
Falkirk,4926,2,17,9,10,60,40,20,60
Morton,4926,3,15,14,7,47,33,14,59
Dundee Utd,4926,4,15,10,11,49,42,7,55
Queen of S't,4926,5,13,8,15,47,52,-5,47
Dumbarton,4926,6,10,12,14,49,55,-6,42
Dunfermline,4926,7,9,14,13,45,52,-7,41
Raith,4926,8,10,10,16,35,47,-12,40
St Mirren,4926,9,10,9,17,43,53,-10,39
Ayr,4926,10,8,12,16,32,59,-27,36
Hibernian,4927,1,18,14,4,53,25,28,68
Morton,4927,2,18,11,7,50,33,17,65
Dundee Utd,4927,3,17,8,11,54,38,16,59
Falkirk,4927,4,15,11,10,57,43,14,56
Dunfermline,4927,5,12,13,11,47,43,4,49
Queen of S't,4927,6,11,9,16,41,51,-10,42
Raith,4927,7,9,11,16,35,49,-14,38
Dumbarton,4927,8,9,10,17,47,59,-12,37
Ayr,4927,9,8,13,15,33,57,-24,37
St Mirren,4927,10,7,12,17,36,55,-19,33
Hibernian,4928,1,21,10,5,56,23,33,73
Morton,4928,2,17,10,9,46,36,10,61
Falkirk,4928,3,16,9,11,61,47,14,57
Dundee Utd,4928,4,16,9,11,55,47,8,57
Queen of S't,4928,5,13,9,14,47,48,-1,48
Dunfermline,4928,6,11,11,14,43,45,-2,44
Ayr,4928,7,10,12,14,41,55,-14,42
Raith,4928,8,11,9,16,37,51,-14,42
Dumbarton,4928,9,9,10,17,47,59,-12,37
St Mirren,4928,10,6,11,19,39,61,-22,29
Hibernian,4929,1,20,12,4,64,22,42,72
Dundee Utd,4929,2,17,11,8,53,37,16,62
Morton,4929,3,15,13,8,47,41,6,58
Falkirk,4929,4,15,11,10,58,47,11,56
Queen of S't,4929,5,11,11,14,49,52,-3,44
Dunfermline,4929,6,10,13,13,49,56,-7,43
Dumbarton,4929,7,10,11,15,53,56,-3,41
Raith,4929,8,10,9,17,34,49,-15,39
Ayr,4929,9,8,12,16,31,53,-22,36
St Mirren,4929,10,8,9,19,40,65,-25,33
Hibernian,4930,1,20,11,5,57,27,30,71
Morton,4930,2,18,9,9,47,34,13,63
Falkirk,4930,3,17,11,8,61,41,20,62
Dundee Utd,4930,4,16,9,11,52,40,12,57
Queen of S't,4930,5,12,10,14,48,53,-5,46
Dunfermline,4930,6,10,12,14,48,48,0,42
Ayr,4930,7,10,10,16,35,56,-21,40
Dumbarton,4930,8,9,12,15,51,59,-8,39
St Mirren,4930,9,8,11,17,39,53,-14,35
Raith,4930,10,8,9,19,30,57,-27,33
Hibernian,4931,1,20,13,3,58,26,32,73
Dundee Utd,4931,2,17,9,10,57,38,19,60
Morton,4931,3,14,13,9,46,36,10,55
Falkirk,4931,4,15,9,12,55,41,14,54
Dunfermline,4931,5,12,13,11,47,43,4,49
Queen of S't,4931,6,12,8,16,42,51,-9,44
Raith,4931,7,10,11,15,38,48,-10,41
Dumbarton,4931,8,10,10,16,50,62,-12,40
St Mirren,4931,9,9,10,17,41,60,-19,37
Ayr,4931,10,6,14,16,35,64,-29,32
Morton,4932,1,19,10,7,56,37,19,67
Hibernian,4932,2,18,12,6,56,28,28,66
Dundee Utd,4932,3,17,11,8,52,36,16,62
Falkirk,4932,4,14,13,9,58,45,13,55
Dunfermline,4932,5,11,13,12,53,51,2,46
Raith,4932,6,9,13,14,35,49,-14,40
Dumbarton,4932,7,9,12,15,49,58,-9,39
Queen of S't,4932,8,9,12,15,43,52,-9,39
St Mirren,4932,9,8,10,18,37,58,-21,34
Ayr,4932,10,7,12,17,33,58,-25,33
Hibernian,4933,1,20,10,6,63,29,34,70
Falkirk,4933,2,18,10,8,60,38,22,64
Morton,4933,3,17,11,8,54,42,12,62
Dundee Utd,4933,4,16,10,10,52,40,12,58
Dunfermline,4933,5,10,14,12,48,49,-1,44
Raith,4933,6,11,10,15,35,46,-11,43
Queen of S't,4933,7,10,11,15,46,53,-7,41
Dumbarton,4933,8,8,12,16,48,65,-17,36
St Mirren,4933,9,8,10,18,40,60,-20,34
Ayr,4933,10,7,12,17,33,57,-24,33
Hibernian,4934,1,19,11,6,54,29,25,68
Falkirk,4934,2,17,11,8,61,38,23,62
Dundee Utd,4934,3,14,12,10,45,39,6,54
Morton,4934,3,14,12,10,45,39,6,54
Queen of S't,4934,5,14,10,12,52,48,4,52
Ayr,4934,6,10,11,15,39,55,-16,41
Dunfermline,4934,7,9,13,14,44,50,-6,40
Dumbarton,4934,8,10,10,16,48,56,-8,40
St Mirren,4934,9,9,10,17,42,57,-15,37
Raith,4934,10,9,10,17,32,51,-19,37
Hibernian,4935,1,19,12,5,57,29,28,69
Dundee Utd,4935,2,18,9,9,58,37,21,63
Morton,4935,3,17,10,9,50,38,12,61
Falkirk,4935,4,16,9,11,60,44,16,57
Queen of S't,4935,5,14,8,14,57,54,3,50
Raith,4935,6,13,8,15,38,48,-10,47
Dumbarton,4935,7,11,10,15,50,61,-11,43
Dunfermline,4935,8,8,12,16,51,61,-10,36
St Mirren,4935,9,8,10,18,42,62,-20,34
Ayr,4935,10,6,12,18,30,59,-29,30
Hibernian,4936,1,21,11,4,67,25,42,74
Morton,4936,2,17,11,8,49,40,9,62
Dundee Utd,4936,3,15,12,9,49,36,13,57
Falkirk,4936,4,15,9,12,53,44,9,54
Queen of S't,4936,5,13,9,14,44,49,-5,48
Dunfermline,4936,6,10,13,13,45,47,-2,43
Raith,4936,7,11,10,15,39,46,-7,43
Dumbarton,4936,8,9,11,16,43,57,-14,38
Ayr,4936,9,8,12,16,33,56,-23,36
St Mirren,4936,10,7,10,19,37,59,-22,31
Hibernian,4937,1,20,11,5,60,26,34,71
Morton,4937,2,19,11,6,56,32,24,68
Falkirk,4937,3,14,13,9,60,47,13,55
Dundee Utd,4937,4,15,9,12,51,44,7,54
Queen of S't,4937,5,12,9,15,46,50,-4,45
Dumbarton,4937,6,11,11,14,51,60,-9,44
Dunfermline,4937,7,10,13,13,48,52,-4,43
Raith,4937,8,9,11,16,37,54,-17,38
Ayr,4937,9,9,11,16,32,53,-21,38
St Mirren,4937,10,6,11,19,39,62,-23,29
Hibernian,4938,1,17,15,4,55,27,28,66
Morton,4938,2,17,10,9,52,40,12,61
Falkirk,4938,3,15,11,10,56,42,14,56
Dundee Utd,4938,4,14,12,10,48,38,10,54
Queen of S't,4938,5,14,9,13,50,49,1,51
Dunfermline,4938,6,10,14,12,43,45,-2,44
Raith,4938,7,10,10,16,35,48,-13,40
Ayr,4938,8,8,14,14,37,57,-20,38
St Mirren,4938,9,8,12,16,38,55,-17,36
Dumbarton,4938,10,8,11,17,45,58,-13,35
Hibernian,4939,1,17,15,4,52,25,27,66
Falkirk,4939,2,18,9,9,63,42,21,63
Morton,4939,3,17,12,7,50,35,15,63
Dundee Utd,4939,4,17,10,9,55,38,17,61
Queen of S't,4939,5,12,10,14,48,50,-2,46
Dunfermline,4939,6,9,15,12,47,48,-1,42
Ayr,4939,7,8,13,15,36,59,-23,37
St Mirren,4939,8,9,9,18,43,59,-16,36
Raith,4939,9,9,9,18,35,57,-22,36
Dumbarton,4939,10,8,10,18,42,58,-16,34
Hibernian,4940,1,20,12,4,59,24,35,72
Falkirk,4940,2,18,9,9,61,39,22,63
Morton,4940,3,16,13,7,51,38,13,61
Dundee Utd,4940,4,16,12,8,53,40,13,60
Dunfermline,4940,5,10,13,13,45,48,-3,43
Queen of S't,4940,6,10,12,14,46,55,-9,42
Raith,4940,7,8,12,16,34,51,-17,36
St Mirren,4940,8,9,9,18,42,60,-18,36
Dumbarton,4940,9,8,10,18,50,63,-13,34
Ayr,4940,10,6,16,14,32,55,-23,34
Hibernian,4941,1,19,14,3,49,19,30,71
Morton,4941,2,16,13,7,49,33,16,61
Falkirk,4941,3,16,11,9,55,39,16,59
Dundee Utd,4941,4,14,12,10,49,39,10,54
Queen of S't,4941,5,13,9,14,49,47,2,48
Dunfermline,4941,6,9,15,12,41,46,-5,42
Ayr,4941,7,9,11,16,36,56,-20,38
Dumbarton,4941,8,9,10,17,45,58,-13,37
Raith,4941,9,8,12,16,33,52,-19,36
St Mirren,4941,10,8,11,17,39,56,-17,35
Hibernian,4942,1,21,10,5,64,28,36,73
Falkirk,4942,2,17,9,10,66,47,19,60
Dundee Utd,4942,3,16,11,9,48,42,6,59
Morton,4942,4,16,10,10,51,37,14,58
Dunfermline,4942,5,12,12,12,54,49,5,48
Dumbarton,4942,6,10,11,15,52,62,-10,41
Raith,4942,7,10,10,16,37,52,-15,40
Queen of S't,4942,8,10,8,18,50,61,-11,38
Ayr,4942,9,9,11,16,29,52,-23,38
St Mirren,4942,10,8,10,18,40,61,-21,34
Hibernian,4943,1,22,11,3,61,25,36,77
Morton,4943,2,16,10,10,50,41,9,58
Dundee Utd,4943,3,16,9,11,49,40,9,57
Falkirk,4943,4,14,11,11,55,47,8,53
Ayr,4943,5,12,11,13,40,50,-10,47
Queen of S't,4943,6,12,8,16,46,50,-4,44
Dumbarton,4943,7,10,12,14,51,55,-4,42
Dunfermline,4943,8,9,12,15,47,55,-8,39
Raith,4943,9,9,11,16,35,53,-18,38
St Mirren,4943,10,7,11,18,37,55,-18,32
Hibernian,4944,1,18,12,6,53,27,26,66
Morton,4944,2,16,13,7,45,31,14,61
Dundee Utd,4944,3,16,11,9,50,37,13,59
Falkirk,4944,4,16,10,10,58,43,15,58
Raith,4944,5,12,9,15,39,46,-7,45
Dunfermline,4944,6,10,12,14,43,50,-7,42
Queen of S't,4944,7,11,9,16,44,52,-8,42
Dumbarton,4944,8,9,12,15,48,57,-9,39
Ayr,4944,9,9,11,16,32,53,-21,38
St Mirren,4944,10,8,11,17,37,53,-16,35
Hibernian,4945,1,21,11,4,63,25,38,74
Morton,4945,2,17,11,8,50,34,16,62
Falkirk,4945,3,16,11,9,59,38,21,59
Dundee Utd,4945,4,16,11,9,55,44,11,59
Queen of S't,4945,5,11,10,15,49,55,-6,43
Raith,4945,6,11,10,15,39,55,-16,43
Dunfermline,4945,7,9,14,13,45,49,-4,41
Dumbarton,4945,8,9,11,16,45,60,-15,38
St Mirren,4945,9,8,12,16,41,54,-13,36
Ayr,4945,10,6,11,19,32,64,-32,29
Hibernian,4946,1,21,12,3,60,25,35,75
Morton,4946,2,18,10,8,49,36,13,64
Falkirk,4946,3,16,11,9,58,40,18,59
Dundee Utd,4946,4,15,9,12,51,43,8,54
Dumbarton,4946,5,12,11,13,54,56,-2,47
Dunfermline,4946,6,10,13,13,52,51,1,43
Ayr,4946,7,10,11,15,40,55,-15,41
Queen of S't,4946,8,10,10,16,42,50,-8,40
Raith,4946,9,9,8,19,36,59,-23,35
St Mirren,4946,10,7,9,20,38,65,-27,30
Morton,4947,1,19,11,6,60,38,22,68
Hibernian,4947,2,16,12,8,51,31,20,60
Dundee Utd,4947,3,17,8,11,55,39,16,59
Falkirk,4947,4,16,10,10,56,42,14,58
Dunfermline,4947,5,13,12,11,51,44,7,51
Ayr,4947,6,10,11,15,38,58,-20,41
Queen of S't,4947,7,10,9,17,44,53,-9,39
St Mirren,4947,8,10,9,17,43,58,-15,39
Raith,4947,9,9,11,16,36,50,-14,38
Dumbarton,4947,10,8,11,17,46,67,-21,35
Hibernian,4948,1,19,13,4,56,25,31,70
Falkirk,4948,2,15,13,8,57,39,18,58
Morton,4948,3,15,13,8,50,39,11,58
Dundee Utd,4948,4,15,13,8,46,35,11,58
Queen of S't,4948,5,13,10,13,50,51,-1,49
Dunfermline,4948,6,11,11,14,44,48,-4,44
Dumbarton,4948,7,9,12,15,48,57,-9,39
St Mirren,4948,8,8,11,17,39,57,-18,35
Ayr,4948,9,7,14,15,30,51,-21,35
Raith,4948,10,8,10,18,32,50,-18,34
Hibernian,4949,1,19,13,4,57,26,31,70
Morton,4949,2,19,10,7,52,34,18,67
Falkirk,4949,3,17,11,8,60,38,22,62
Dundee Utd,4949,4,17,8,11,53,41,12,59
Ayr,4949,5,11,10,15,39,57,-18,43
Queen of S't,4949,6,11,9,16,42,50,-8,42
Dunfermline,4949,7,9,12,15,43,48,-5,39
Raith,4949,8,9,11,16,36,53,-17,38
Dumbarton,4949,9,8,11,17,47,60,-13,35
St Mirren,4949,10,7,11,18,36,58,-22,32
Hibernian,4950,1,18,12,6,54,28,26,66
Falkirk,4950,2,17,10,9,61,41,20,61
Dundee Utd,4950,3,17,10,9,54,40,14,61
Morton,4950,4,15,12,9,50,41,9,57
Dunfermline,4950,5,10,11,15,49,51,-2,41
Queen of S't,4950,6,10,11,15,43,52,-9,41
Raith,4950,7,10,11,15,34,47,-13,41
Dumbarton,4950,8,9,12,15,51,63,-12,39
St Mirren,4950,9,9,11,16,46,61,-15,38
Ayr,4950,10,8,14,14,34,52,-18,38
Hibernian,4951,1,22,11,3,58,24,34,77
Falkirk,4951,2,17,11,8,58,40,18,62
Dundee Utd,4951,3,17,10,9,62,41,21,61
Morton,4951,4,14,11,11,48,43,5,53
Dunfermline,4951,5,9,14,13,44,48,-4,41
Queen of S't,4951,6,10,11,15,45,52,-7,41
Dumbarton,4951,7,9,13,14,46,57,-11,40
Raith,4951,8,10,10,16,32,46,-14,40
Ayr,4951,9,7,13,16,33,58,-25,34
St Mirren,4951,10,7,12,17,38,55,-17,33
Hibernian,4952,1,20,12,4,57,22,35,72
Dundee Utd,4952,2,18,10,8,55,39,16,64
Morton,4952,3,15,13,8,45,35,10,58
Falkirk,4952,4,14,12,10,56,46,10,54
Dunfermline,4952,5,11,13,12,46,45,1,46
Queen of S't,4952,6,9,13,14,41,51,-10,40
St Mirren,4952,7,10,9,17,38,51,-13,39
Dumbarton,4952,8,8,14,14,49,57,-8,38
Raith,4952,9,9,10,17,33,51,-18,37
Ayr,4952,10,7,12,17,34,57,-23,33
Hibernian,4953,1,19,13,4,58,25,33,70
Morton,4953,2,16,12,8,48,37,11,60
Dundee Utd,4953,3,16,11,9,46,35,11,59
Falkirk,4953,4,13,13,10,54,43,11,52
Dunfermline,4953,5,11,14,11,50,47,3,47
Raith,4953,6,11,9,16,37,52,-15,42
Queen of S't,4953,7,10,11,15,44,49,-5,41
Dumbarton,4953,8,8,13,15,49,62,-13,37
Ayr,4953,9,7,15,14,30,49,-19,36
St Mirren,4953,10,8,11,17,40,57,-17,35
Hibernian,4954,1,18,13,5,55,25,30,67
Morton,4954,2,16,13,7,52,38,14,61
Dundee Utd,4954,3,17,9,10,56,44,12,60
Falkirk,4954,4,15,11,10,54,40,14,56
Dunfermline,4954,5,11,13,12,45,43,2,46
Queen of S't,4954,6,12,10,14,42,49,-7,46
Dumbarton,4954,7,9,13,14,48,55,-7,40
Ayr,4954,8,9,11,16,33,55,-22,38
Raith,4954,9,9,10,17,33,49,-16,37
St Mirren,4954,10,7,11,18,37,57,-20,32
Hibernian,4955,1,20,12,4,60,27,33,72
Morton,4955,2,19,11,6,58,38,20,68
Falkirk,4955,3,18,11,7,60,38,22,65
Dundee Utd,4955,4,17,8,11,61,46,15,59
Queen of S't,4955,5,12,8,16,48,54,-6,44
Dunfermline,4955,6,8,15,13,50,54,-4,39
Raith,4955,7,10,9,17,38,53,-15,39
Dumbarton,4955,8,9,11,16,51,61,-10,38
Ayr,4955,9,7,11,18,33,66,-33,32
St Mirren,4955,10,7,10,19,41,63,-22,31
Hibernian,4956,1,22,10,4,55,23,32,76
Morton,4956,2,18,10,8,50,35,15,64
Falkirk,4956,3,16,10,10,56,39,17,58
Dundee Utd,4956,4,15,12,9,53,41,12,57
Dumbarton,4956,5,12,10,14,49,54,-5,46
Raith,4956,6,12,9,15,35,46,-11,45
Queen of S't,4956,7,10,11,15,43,49,-6,41
St Mirren,4956,8,8,10,18,42,58,-16,34
Dunfermline,4956,9,7,12,17,39,51,-12,33
Ayr,4956,10,7,12,17,33,59,-26,33
Morton,4957,1,18,11,7,56,37,19,65
Dundee Utd,4957,2,18,9,9,54,40,14,63
Hibernian,4957,3,16,13,7,51,31,20,61
Falkirk,4957,4,16,10,10,59,45,14,58
Queen of S't,4957,5,12,9,15,47,50,-3,45
Dunfermline,4957,6,10,12,14,46,48,-2,42
Ayr,4957,7,10,11,15,42,58,-16,41
Dumbarton,4957,8,10,10,16,49,61,-12,40
Raith,4957,9,9,11,16,34,49,-15,38
St Mirren,4957,10,8,10,18,39,58,-19,34
Falkirk,4958,1,18,10,8,65,42,23,64
Hibernian,4958,2,17,12,7,52,30,22,63
Morton,4958,3,16,11,9,51,42,9,59
Dundee Utd,4958,4,15,12,9,51,43,8,57
Queen of S't,4958,5,14,9,13,45,47,-2,51
Raith,4958,6,12,9,15,40,47,-7,45
Dunfermline,4958,7,10,12,14,49,50,-1,42
Ayr,4958,8,8,12,16,37,57,-20,36
Dumbarton,4958,9,8,11,17,49,64,-15,35
St Mirren,4958,10,8,10,18,41,58,-17,34
Hibernian,4959,1,20,11,5,61,31,30,71
Dundee Utd,4959,2,18,9,9,55,38,17,63
Falkirk,4959,3,16,10,10,65,42,23,58
Morton,4959,4,15,13,8,49,42,7,58
Raith,4959,5,11,10,15,41,54,-13,43
Queen of S't,4959,6,10,11,15,43,54,-11,41
Ayr,4959,7,9,13,14,35,53,-18,40
Dunfermline,4959,8,8,15,13,49,49,0,39
Dumbarton,4959,9,9,11,16,44,57,-13,38
St Mirren,4959,10,8,9,19,38,60,-22,33
Hibernian,4960,1,19,13,4,58,27,31,70
Falkirk,4960,2,16,11,9,56,40,16,59
Dunfermline,4960,3,14,11,11,51,44,7,53
Morton,4960,4,14,10,12,46,41,5,52
Dundee Utd,4960,5,13,11,12,47,43,4,50
Dumbarton,4960,6,11,12,13,51,53,-2,45
Raith,4960,7,10,10,16,35,49,-14,40
Queen of S't,4960,8,9,12,15,42,54,-12,39
St Mirren,4960,9,8,13,15,39,53,-14,37
Ayr,4960,10,7,15,14,36,57,-21,36
Hibernian,4961,1,20,13,3,56,22,34,73
Morton,4961,2,15,14,7,51,35,16,59
Dundee Utd,4961,3,16,10,10,61,41,20,58
Falkirk,4961,4,15,11,10,55,40,15,56
Queen of S't,4961,5,11,10,15,45,51,-6,43
St Mirren,4961,6,11,10,15,46,54,-8,43
Dumbarton,4961,7,9,12,15,48,61,-13,39
Raith,4961,8,9,11,16,38,54,-16,38
Ayr,4961,9,9,11,16,34,60,-26,38
Dunfermline,4961,10,8,12,16,42,58,-16,36
Hibernian,4962,1,19,13,4,56,24,32,70
Dundee Utd,4962,2,20,8,8,57,33,24,68
Morton,4962,3,17,11,8,48,39,9,62
Falkirk,4962,4,15,11,10,58,41,17,56
Dunfermline,4962,5,9,14,13,50,54,-4,41
Raith,4962,6,10,10,16,36,49,-13,40
Queen of S't,4962,7,10,9,17,39,56,-17,39
Dumbarton,4962,8,8,14,14,49,58,-9,38
St Mirren,4962,9,9,10,17,43,56,-13,37
Ayr,4962,10,7,12,17,31,57,-26,33
Hibernian,4963,1,21,10,5,56,23,33,73
Dundee Utd,4963,2,17,9,10,56,40,16,60
Falkirk,4963,3,15,11,10,58,40,18,56
Morton,4963,4,14,12,10,49,41,8,54
Raith,4963,5,13,9,14,37,41,-4,48
Dunfermline,4963,6,10,13,13,51,52,-1,43
Queen of S't,4963,7,11,10,15,43,51,-8,43
St Mirren,4963,8,9,10,17,36,59,-23,37
Ayr,4963,9,9,10,17,34,57,-23,37
Dumbarton,4963,10,8,12,16,48,64,-16,36
Hibernian,4964,1,20,12,4,57,23,34,72
Morton,4964,2,18,11,7,51,34,17,65
Falkirk,4964,3,16,10,10,58,38,20,58
Dundee Utd,4964,4,15,9,12,45,39,6,54
Queen of S't,4964,5,13,8,15,44,51,-7,47
Dumbarton,4964,6,10,12,14,47,54,-7,42
Ayr,4964,7,9,12,15,35,53,-18,39
Raith,4964,8,10,8,18,34,55,-21,38
St Mirren,4964,9,9,10,17,39,53,-14,37
Dunfermline,4964,10,8,12,16,39,49,-10,36
Hibernian,4965,1,19,13,4,60,27,33,70
Dundee Utd,4965,2,17,10,9,59,41,18,61
Falkirk,4965,3,16,12,8,60,41,19,60
Morton,4965,4,14,13,9,48,41,7,55
Dunfermline,4965,5,10,14,12,47,50,-3,44
Queen of S't,4965,6,10,11,15,42,52,-10,41
Raith,4965,7,10,11,15,34,47,-13,41
Dumbarton,4965,8,9,12,15,48,57,-9,39
Ayr,4965,9,8,13,15,39,60,-21,37
St Mirren,4965,10,6,13,17,39,60,-21,31
Hibernian,4966,1,20,11,5,58,31,27,71
Falkirk,4966,2,18,9,9,70,38,32,63
Dundee Utd,4966,3,18,9,9,55,46,9,63
Morton,4966,4,15,12,9,47,38,9,57
Queen of S't,4966,5,12,8,16,46,51,-5,44
Dumbarton,4966,6,11,10,15,50,60,-10,43
Dunfermline,4966,7,9,13,14,44,49,-5,40
Raith,4966,8,9,10,17,34,50,-16,37
St Mirren,4966,9,9,9,18,44,62,-18,36
Ayr,4966,10,8,11,17,39,62,-23,35
Hibernian,4967,1,20,13,3,55,23,32,73
Morton,4967,2,16,13,7,50,35,15,61
Falkirk,4967,3,15,9,12,61,49,12,54
Dundee Utd,4967,4,15,9,12,51,45,6,54
Queen of S't,4967,5,14,10,12,51,48,3,52
Dunfermline,4967,6,10,15,11,47,44,3,45
Ayr,4967,7,9,12,15,37,56,-19,39
St Mirren,4967,8,9,11,16,42,53,-11,38
Raith,4967,9,8,10,18,34,57,-23,34
Dumbarton,4967,10,7,12,17,49,67,-18,33
Hibernian,4968,1,19,12,5,53,25,28,69
Morton,4968,2,18,10,8,52,34,18,64
Falkirk,4968,3,16,11,9,58,40,18,59
Dundee Utd,4968,4,16,11,9,51,38,13,59
Dunfermline,4968,5,12,13,11,50,48,2,49
Raith,4968,6,11,9,16,39,53,-14,42
Queen of S't,4968,7,10,9,17,44,52,-8,39
Dumbarton,4968,8,8,12,16,45,59,-14,36
Ayr,4968,9,7,13,16,32,53,-21,34
St Mirren,4968,10,7,12,17,38,60,-22,33
Hibernian,4969,1,19,11,6,54,29,25,68
Morton,4969,2,18,11,7,52,35,17,65
Falkirk,4969,3,16,11,9,66,40,26,59
Dundee Utd,4969,4,15,9,12,52,43,9,54
Dunfermline,4969,5,11,14,11,50,49,1,47
Queen of S't,4969,6,12,8,16,43,51,-8,44
Ayr,4969,7,11,10,15,39,57,-18,43
Raith,4969,8,10,10,16,37,50,-13,40
Dumbarton,4969,9,8,11,17,48,68,-20,35
St Mirren,4969,10,8,9,19,43,62,-19,33
Hibernian,4970,1,20,12,4,59,26,33,72
Morton,4970,2,17,13,6,58,39,19,64
Falkirk,4970,3,15,9,12,57,47,10,54
Dundee Utd,4970,4,13,12,11,49,45,4,51
Dumbarton,4970,5,11,13,12,56,57,-1,46
Dunfermline,4970,6,10,13,13,46,49,-3,43
Ayr,4970,7,9,13,14,34,52,-18,40
Queen of S't,4970,8,10,9,17,42,52,-10,39
Raith,4970,9,9,11,16,34,49,-15,38
St Mirren,4970,10,8,11,17,44,63,-19,35
Hibernian,4971,1,21,10,5,65,27,38,73
Morton,4971,2,18,10,8,55,38,17,64
Falkirk,4971,3,17,9,10,65,44,21,60
Dundee Utd,4971,4,16,11,9,54,38,16,59
Dunfermline,4971,5,11,13,12,47,47,0,46
Dumbarton,4971,6,11,11,14,51,62,-11,44
Queen of S't,4971,7,10,10,16,41,52,-11,40
Raith,4971,8,10,8,18,33,55,-22,38
St Mirren,4971,9,7,11,18,41,59,-18,32
Ayr,4971,10,6,13,17,31,61,-30,31
Hibernian,4972,1,19,11,6,56,29,27,68
Falkirk,4972,2,18,10,8,63,39,24,64
Morton,4972,3,16,11,9,48,35,13,59
Dundee Utd,4972,4,16,8,12,47,40,7,56
Queen of S't,4972,5,13,9,14,50,51,-1,48
Dunfermline,4972,6,10,12,14,43,49,-6,42
Raith,4972,7,10,11,15,37,47,-10,41
St Mirren,4972,8,9,11,16,41,55,-14,38
Ayr,4972,9,8,12,16,32,56,-24,36
Dumbarton,4972,10,8,11,17,48,64,-16,35
Hibernian,4973,1,19,12,5,55,25,30,69
Falkirk,4973,2,17,10,9,61,43,18,61
Morton,4973,3,16,11,9,48,39,9,59
Dundee Utd,4973,4,15,11,10,44,40,4,56
Dunfermline,4973,5,13,13,10,50,44,6,52
Queen of S't,4973,6,12,9,15,49,51,-2,45
Raith,4973,7,11,8,17,38,52,-14,41
St Mirren,4973,8,9,10,17,44,57,-13,37
Dumbarton,4973,9,8,10,18,47,61,-14,34
Ayr,4973,10,8,10,18,30,54,-24,34
Hibernian,4974,1,17,14,5,49,24,25,65
Dundee Utd,4974,2,16,10,10,54,43,11,58
Falkirk,4974,3,14,13,9,56,41,15,55
Morton,4974,4,13,13,10,44,39,5,52
Queen of S't,4974,5,12,11,13,47,49,-2,47
Dunfermline,4974,6,10,15,11,51,50,1,45
St Mirren,4974,7,11,9,16,40,53,-13,42
Dumbarton,4974,8,10,11,15,49,59,-10,41
Raith,4974,9,10,11,15,40,51,-11,41
Ayr,4974,10,8,11,17,34,55,-21,35
Hibernian,4975,1,20,13,3,58,25,33,73
Morton,4975,2,18,9,9,49,35,14,63
Dundee Utd,4975,3,18,8,10,57,37,20,62
Falkirk,4975,4,15,12,9,55,40,15,57
Queen of S't,4975,5,11,11,14,43,47,-4,44
Dunfermline,4975,6,9,14,13,42,48,-6,41
Dumbarton,4975,7,10,11,15,47,55,-8,41
Raith,4975,8,10,8,18,31,50,-19,38
St Mirren,4975,9,8,10,18,37,57,-20,34
Ayr,4975,10,8,10,18,32,57,-25,34
Hibernian,4976,1,18,13,5,56,29,27,67
Morton,4976,2,19,9,8,56,40,16,66
Falkirk,4976,3,17,10,9,64,37,27,61
Dundee Utd,4976,4,15,10,11,50,43,7,55
Dunfermline,4976,5,12,12,12,45,45,0,48
Queen of S't,4976,6,11,10,15,46,55,-9,43
Ayr,4976,7,10,11,15,37,55,-18,41
Raith,4976,8,9,10,17,34,49,-15,37
St Mirren,4976,9,8,11,17,39,59,-20,35
Dumbarton,4976,10,8,10,18,44,59,-15,34
Hibernian,4977,1,20,12,4,57,24,33,72
Morton,4977,2,17,9,10,50,41,9,60
Falkirk,4977,3,16,10,10,56,39,17,58
Dundee Utd,4977,4,16,10,10,49,41,8,58
Dunfermline,4977,5,11,12,13,47,47,0,45
Queen of S't,4977,6,11,10,15,41,49,-8,43
Raith,4977,7,10,11,15,37,49,-12,41
St Mirren,4977,8,9,12,15,44,55,-11,39
Ayr,4977,9,8,12,16,33,55,-22,36
Dumbarton,4977,10,7,12,17,45,59,-14,33
Hibernian,4978,1,21,11,4,56,24,32,74
Morton,4978,2,17,12,7,51,37,14,63
Falkirk,4978,3,17,9,10,61,42,19,60
Dundee Utd,4978,4,16,9,11,52,41,11,57
Dunfermline,4978,5,12,12,12,48,47,1,48
Queen of S't,4978,6,11,8,17,42,52,-10,41
Raith,4978,7,11,8,17,36,51,-15,41
Dumbarton,4978,8,8,12,16,47,61,-14,36
Ayr,4978,9,8,11,17,37,57,-20,35
St Mirren,4978,10,7,12,17,39,57,-18,33
Hibernian,4979,1,21,11,4,57,22,35,74
Morton,4979,2,18,10,8,50,35,15,64
Falkirk,4979,3,15,12,9,52,38,14,57
Dundee Utd,4979,4,15,9,12,46,39,7,54
Dunfermline,4979,5,11,12,13,46,47,-1,45
Queen of S't,4979,6,11,10,15,42,53,-11,43
Dumbarton,4979,7,10,12,14,50,56,-6,42
Raith,4979,8,9,10,17,33,46,-13,37
Ayr,4979,9,9,10,17,32,55,-23,37
St Mirren,4979,10,7,12,17,35,52,-17,33
Hibernian,4980,1,18,13,5,51,25,26,67
Falkirk,4980,2,17,11,8,61,39,22,62
Morton,4980,3,17,10,9,44,32,12,61
Dundee Utd,4980,4,16,10,10,52,41,11,58
Dunfermline,4980,5,10,14,12,44,44,0,44
Raith,4980,6,11,9,16,36,46,-10,42
Queen of S't,4980,7,10,11,15,45,50,-5,41
Ayr,4980,8,9,12,15,38,56,-18,39
Dumbarton,4980,9,9,11,16,46,63,-17,38
St Mirren,4980,10,7,11,18,38,59,-21,32
Hibernian,4981,1,20,12,4,60,26,34,72
Morton,4981,2,17,11,8,54,45,9,62
Falkirk,4981,3,15,13,8,58,40,18,58
Dundee Utd,4981,4,16,9,11,54,43,11,57
Queen of S't,4981,5,12,9,15,43,53,-10,45
St Mirren,4981,6,10,11,15,45,57,-12,41
Ayr,4981,7,9,12,15,38,53,-15,39
Dumbarton,4981,8,9,11,16,47,56,-9,38
Dunfermline,4981,9,8,13,15,47,54,-7,37
Raith,4981,10,8,11,17,35,54,-19,35
Hibernian,4982,1,19,13,4,63,33,30,70
Falkirk,4982,2,17,11,8,63,39,24,62
Dundee Utd,4982,3,15,11,10,52,39,13,56
Morton,4982,4,14,14,8,47,39,8,56
Dunfermline,4982,5,13,13,10,50,42,8,52
Dumbarton,4982,6,10,10,16,49,60,-11,40
Raith,4982,7,10,10,16,35,52,-17,40
Queen of S't,4982,8,10,8,18,42,57,-15,38
St Mirren,4982,9,9,10,17,37,54,-17,37
Ayr,4982,10,8,10,18,35,58,-23,34
Hibernian,4983,1,20,12,4,57,23,34,72
Dundee Utd,4983,2,17,9,10,50,39,11,60
Falkirk,4983,3,16,11,9,58,38,20,59
Morton,4983,4,16,10,10,48,42,6,58
Queen of S't,4983,5,12,9,15,42,52,-10,45
Dunfermline,4983,6,10,12,14,45,46,-1,42
Dumbarton,4983,7,9,13,14,47,55,-8,40
Ayr,4983,8,9,12,15,37,54,-17,39
St Mirren,4983,9,8,12,16,39,55,-16,36
Raith,4983,10,8,10,18,32,51,-19,34
Hibernian,4984,1,18,12,6,54,30,24,66
Morton,4984,2,17,13,6,51,35,16,64
Falkirk,4984,3,16,11,9,58,35,23,59
Dundee Utd,4984,4,14,10,12,49,45,4,52
Queen of S't,4984,5,13,10,13,48,47,1,49
Dunfermline,4984,6,9,14,13,45,47,-2,41
Dumbarton,4984,7,9,14,13,50,56,-6,41
Ayr,4984,8,9,12,15,32,53,-21,39
Raith,4984,9,9,10,17,33,52,-19,37
St Mirren,4984,10,8,10,18,41,61,-20,34
Hibernian,4985,1,21,10,5,61,27,34,73
Morton,4985,2,16,12,8,51,38,13,60
Falkirk,4985,3,15,12,9,58,41,17,57
Dundee Utd,4985,4,15,10,11,52,43,9,55
Queen of S't,4985,5,12,9,15,45,49,-4,45
Dunfermline,4985,6,9,16,11,46,48,-2,43
Raith,4985,7,11,10,15,37,49,-12,43
Dumbarton,4985,8,9,12,15,49,59,-10,39
St Mirren,4985,9,9,9,18,43,60,-17,36
Ayr,4985,10,8,10,18,33,61,-28,34
Hibernian,4986,1,20,12,4,61,27,34,72
Falkirk,4986,2,16,10,10,58,39,19,58
Dundee Utd,4986,3,15,12,9,51,41,10,57
Morton,4986,4,14,13,9,48,41,7,55
Dunfermline,4986,5,11,14,11,52,52,0,47
Ayr,4986,6,9,14,13,38,53,-15,41
Dumbarton,4986,7,9,13,14,53,60,-7,40
Queen of S't,4986,8,10,10,16,46,59,-13,40
Raith,4986,9,9,9,18,33,52,-19,36
St Mirren,4986,10,8,11,17,41,57,-16,35
Hibernian,4987,1,18,15,3,54,22,32,69
Morton,4987,2,16,12,8,54,37,17,60
Falkirk,4987,3,15,13,8,62,40,22,58
Dundee Utd,4987,4,16,10,10,52,48,4,58
Raith,4987,5,11,10,15,37,50,-13,43
Queen of S't,4987,6,10,11,15,46,53,-7,41
Dunfermline,4987,7,8,16,12,47,53,-6,40
St Mirren,4987,8,10,10,16,43,55,-12,40
Dumbarton,4987,9,8,13,15,49,62,-13,37
Ayr,4987,10,7,12,17,32,56,-24,33
Hibernian,4988,1,21,11,4,56,22,34,74
Morton,4988,2,16,12,8,47,35,12,60
Falkirk,4988,3,15,11,10,58,42,16,56
Dundee Utd,4988,4,15,11,10,47,40,7,56
Dunfermline,4988,5,11,14,11,47,44,3,47
Queen of S't,4988,6,10,12,14,44,50,-6,42
Raith,4988,7,9,12,15,34,49,-15,39
St Mirren,4988,8,9,10,17,43,55,-12,37
Dumbarton,4988,9,8,13,15,46,60,-14,37
Ayr,4988,10,6,14,16,30,55,-25,32
Hibernian,4989,1,19,11,6,55,26,29,68
Morton,4989,2,17,11,8,51,39,12,62
Dundee Utd,4989,3,16,11,9,55,41,14,59
Falkirk,4989,4,14,11,11,51,43,8,53
Queen of S't,4989,5,14,8,14,48,47,1,50
Dumbarton,4989,6,10,12,14,49,54,-5,42
Raith,4989,7,11,9,16,31,45,-14,42
St Mirren,4989,8,10,9,17,40,54,-14,39
Dunfermline,4989,9,8,14,14,44,50,-6,38
Ayr,4989,10,7,12,17,31,56,-25,33
Hibernian,4990,1,21,11,4,58,23,35,74
Morton,4990,2,17,12,7,50,34,16,63
Dundee Utd,4990,3,16,10,10,50,39,11,58
Falkirk,4990,4,15,11,10,57,43,14,56
Queen of S't,4990,5,12,9,15,44,47,-3,45
Dumbarton,4990,6,10,12,14,47,54,-7,42
Raith,4990,7,11,9,16,34,49,-15,42
Dunfermline,4990,8,8,12,16,38,50,-12,36
St Mirren,4990,9,8,12,16,38,54,-16,36
Ayr,4990,10,7,12,17,31,54,-23,33
Hibernian,4991,1,21,12,3,61,26,35,75
Dundee Utd,4991,2,17,11,8,53,36,17,62
Falkirk,4991,3,15,10,11,57,43,14,55
Morton,4991,4,15,10,11,46,38,8,55
Queen of S't,4991,5,11,10,15,42,49,-7,43
Dunfermline,4991,6,10,12,14,48,51,-3,42
Ayr,4991,7,9,13,14,36,54,-18,40
Raith,4991,8,10,9,17,34,55,-21,39
Dumbarton,4991,9,9,11,16,48,58,-10,38
St Mirren,4991,10,7,14,15,39,54,-15,35
Morton,4992,1,18,13,5,52,33,19,67
Hibernian,4992,2,15,15,6,48,26,22,60
Falkirk,4992,3,16,12,8,58,43,15,60
Dundee Utd,4992,4,15,12,9,56,40,16,57
Raith,4992,5,12,10,14,45,50,-5,46
Queen of S't,4992,6,10,13,13,47,52,-5,43
Dunfermline,4992,7,9,12,15,45,54,-9,39
Ayr,4992,8,8,13,15,35,57,-22,37
St Mirren,4992,9,7,14,15,41,56,-15,35
Dumbarton,4992,10,8,10,18,44,60,-16,34
Hibernian,4993,1,20,11,5,60,31,29,71
Falkirk,4993,2,16,11,9,56,39,17,59
Dundee Utd,4993,3,15,11,10,50,39,11,56
Morton,4993,4,13,15,8,44,37,7,54
Dunfermline,4993,5,11,14,11,49,44,5,47
Queen of S't,4993,6,12,10,14,46,50,-4,46
Raith,4993,7,9,12,15,35,48,-13,39
Ayr,4993,8,8,14,14,35,56,-21,38
Dumbarton,4993,9,8,12,16,50,58,-8,36
St Mirren,4993,10,7,12,17,37,60,-23,33
Hibernian,4994,1,19,12,5,55,28,27,69
Falkirk,4994,2,18,10,8,62,39,23,64
Morton,4994,3,16,12,8,48,37,11,60
Dundee Utd,4994,4,16,8,12,50,40,10,56
Dunfermline,4994,5,11,12,13,48,47,1,45
Queen of S't,4994,6,11,8,17,44,53,-9,41
Ayr,4994,7,10,11,15,34,51,-17,41
Raith,4994,8,10,9,17,36,52,-16,39
St Mirren,4994,9,9,10,17,42,56,-14,37
Dumbarton,4994,10,9,10,17,45,61,-16,37
Hibernian,4995,1,19,12,5,57,25,32,69
Dundee Utd,4995,2,18,9,9,57,41,16,63
Morton,4995,3,16,11,9,51,38,13,59
Falkirk,4995,4,16,10,10,58,45,13,58
Dunfermline,4995,5,11,12,13,46,45,1,45
St Mirren,4995,6,10,11,15,43,54,-11,41
Raith,4995,7,11,8,17,36,47,-11,41
Queen of S't,4995,8,10,10,16,41,52,-11,40
Dumbarton,4995,9,9,10,17,46,61,-15,37
Ayr,4995,10,8,11,17,30,57,-27,35
Hibernian,4996,1,19,13,4,60,25,35,70
Morton,4996,2,17,12,7,57,39,18,63
Falkirk,4996,3,17,10,9,59,39,20,61
Dundee Utd,4996,4,15,9,12,50,44,6,54
Raith,4996,5,11,10,15,38,49,-11,43
Queen of S't,4996,6,10,11,15,42,54,-12,41
Ayr,4996,7,9,13,14,44,55,-11,40
Dunfermline,4996,8,8,14,14,48,54,-6,38
Dumbarton,4996,9,9,11,16,47,65,-18,38
St Mirren,4996,10,8,11,17,40,61,-21,35
Morton,4997,1,19,11,6,56,35,21,68
Hibernian,4997,2,19,10,7,55,30,25,67
Falkirk,4997,3,15,12,9,59,43,16,57
Dundee Utd,4997,4,14,10,12,49,45,4,52
Queen of S't,4997,5,12,9,15,49,50,-1,45
Raith,4997,6,12,9,15,38,50,-12,45
Dumbarton,4997,7,9,12,15,51,55,-4,39
Dunfermline,4997,8,9,12,15,46,60,-14,39
St Mirren,4997,9,9,11,16,45,56,-11,38
Ayr,4997,10,8,12,16,36,60,-24,36
Hibernian,4998,1,18,12,6,51,25,26,66
Morton,4998,2,17,11,8,48,33,15,62
Falkirk,4998,3,16,13,7,63,42,21,61
Dundee Utd,4998,4,16,10,10,51,39,12,58
Queen of S't,4998,5,12,10,14,52,54,-2,46
Dunfermline,4998,6,11,11,14,46,50,-4,44
Dumbarton,4998,7,9,12,15,49,60,-11,39
Raith,4998,8,10,9,17,39,51,-12,39
Ayr,4998,9,8,13,15,36,57,-21,37
St Mirren,4998,10,8,9,19,40,64,-24,33
Hibernian,4999,1,19,11,6,55,30,25,68
Falkirk,4999,2,19,9,8,67,39,28,66
Morton,4999,3,16,13,7,52,37,15,61
Dundee Utd,4999,4,16,10,10,50,40,10,58
Dunfermline,4999,5,10,13,13,48,47,1,43
Queen of S't,4999,6,10,11,15,42,55,-13,41
Dumbarton,4999,7,9,12,15,49,60,-11,39
Raith,4999,8,9,12,15,42,56,-14,39
Ayr,4999,9,8,12,16,39,59,-20,36
St Mirren,4999,10,7,11,18,38,59,-21,32
Hibernian,5000,1,18,13,5,58,31,27,67
Dundee Utd,5000,2,18,9,9,55,36,19,63
Morton,5000,3,16,12,8,49,35,14,60
Falkirk,5000,4,16,10,10,60,43,17,58
Dunfermline,5000,5,11,14,11,48,48,0,47
Queen of S't,5000,6,12,8,16,45,54,-9,44
St Mirren,5000,7,9,11,16,40,54,-14,38
Raith,5000,8,10,8,18,33,51,-18,38
Dumbarton,5000,9,8,12,16,47,60,-13,36
Ayr,5000,10,8,11,17,33,56,-23,35
Hibernian,5001,1,20,11,5,59,28,31,71
Morton,5001,2,17,12,7,53,40,13,63
Dundee Utd,5001,3,17,10,9,54,40,14,61
Falkirk,5001,4,17,9,10,58,41,17,60
Dumbarton,5001,5,11,11,14,47,54,-7,44
Dunfermline,5001,6,9,13,14,44,49,-5,40
Queen of S't,5001,7,10,8,18,41,53,-12,38
Ayr,5001,8,7,16,13,33,51,-18,37
Raith,5001,9,9,9,18,34,49,-15,36
St Mirren,5001,10,8,11,17,36,54,-18,35
Hibernian,5002,1,21,10,5,61,31,30,73
Dundee Utd,5002,2,17,8,11,51,43,8,59
Morton,5002,3,16,10,10,52,42,10,58
Falkirk,5002,4,16,9,11,56,45,11,57
Dunfermline,5002,5,11,12,13,51,48,3,45
Queen of S't,5002,6,11,10,15,44,53,-9,43
Raith,5002,7,11,9,16,39,50,-11,42
St Mirren,5002,8,10,10,16,43,51,-8,40
Ayr,5002,9,9,12,15,36,55,-19,39
Dumbarton,5002,10,8,10,18,45,60,-15,34
Morton,5003,1,20,10,6,55,33,22,70
Hibernian,5003,2,18,10,8,53,32,21,64
Falkirk,5003,3,17,10,9,59,38,21,61
Dundee Utd,5003,4,16,8,12,47,43,4,56
Queen of S't,5003,5,13,8,15,48,50,-2,47
Dunfermline,5003,6,11,12,13,45,43,2,45
Raith,5003,7,11,9,16,33,49,-16,42
St Mirren,5003,8,9,10,17,44,60,-16,37
Dumbarton,5003,9,8,11,17,47,60,-13,35
Ayr,5003,10,8,10,18,36,59,-23,34
Hibernian,5004,1,19,12,5,53,25,28,69
Morton,5004,2,17,12,7,49,34,15,63
Falkirk,5004,3,15,12,9,54,39,15,57
Dundee Utd,5004,4,16,9,11,51,39,12,57
Raith,5004,5,12,9,15,41,51,-10,45
Dunfermline,5004,6,11,11,14,50,50,0,44
Queen of S't,5004,7,11,10,15,42,51,-9,43
Dumbarton,5004,8,9,13,14,47,54,-7,40
Ayr,5004,9,7,13,16,30,51,-21,34
St Mirren,5004,10,6,13,17,35,58,-23,31
Hibernian,5005,1,21,11,4,54,21,33,74
Dundee Utd,5005,2,16,10,10,52,42,10,58
Morton,5005,3,16,10,10,44,36,8,58
Falkirk,5005,4,15,10,11,57,43,14,55
Queen of S't,5005,5,12,10,14,44,48,-4,46
Dunfermline,5005,6,10,12,14,47,51,-4,42
Dumbarton,5005,7,10,12,14,49,56,-7,42
Ayr,5005,8,10,11,15,39,53,-14,41
Raith,5005,9,10,11,15,36,50,-14,41
St Mirren,5005,10,7,9,20,35,57,-22,30
Hibernian,5006,1,16,14,6,47,24,23,62
Falkirk,5006,2,16,11,9,58,42,16,59
Morton,5006,3,16,11,9,48,37,11,59
Dundee Utd,5006,4,16,9,11,50,40,10,57
Queen of S't,5006,5,11,12,13,48,52,-4,45
Ayr,5006,6,10,14,12,36,48,-12,44
Dunfermline,5006,7,10,12,14,46,46,0,42
Dumbarton,5006,8,9,12,15,49,61,-12,39
Raith,5006,9,9,11,16,36,53,-17,38
St Mirren,5006,10,7,14,15,38,53,-15,35
Hibernian,5007,1,18,11,7,58,28,30,65
Morton,5007,2,17,10,9,49,39,10,61
Falkirk,5007,3,17,9,10,61,41,20,60
Dundee Utd,5007,4,16,10,10,50,39,11,58
Dunfermline,5007,5,11,12,13,45,47,-2,45
Queen of S't,5007,6,12,9,15,47,50,-3,45
Ayr,5007,7,10,11,15,36,59,-23,41
Dumbarton,5007,8,9,13,14,51,58,-7,40
St Mirren,5007,9,9,11,16,39,53,-14,38
Raith,5007,10,9,8,19,34,56,-22,35
Hibernian,5008,1,21,12,3,58,22,36,75
Morton,5008,2,18,10,8,56,38,18,64
Falkirk,5008,3,17,12,7,60,38,22,63
Dundee Utd,5008,4,15,10,11,47,46,1,55
Queen of S't,5008,5,13,10,13,54,50,4,49
Dumbarton,5008,6,10,11,15,48,61,-13,41
Raith,5008,7,10,10,16,36,50,-14,40
St Mirren,5008,8,9,9,18,41,56,-15,36
Dunfermline,5008,9,7,14,15,43,52,-9,35
Ayr,5008,10,6,10,20,30,60,-30,28
Hibernian,5009,1,20,11,5,58,25,33,71
Dundee Utd,5009,2,18,9,9,53,36,17,63
Morton,5009,3,17,11,8,49,37,12,62
Falkirk,5009,4,14,12,10,57,47,10,54
Dunfermline,5009,5,9,14,13,45,46,-1,41
Dumbarton,5009,6,9,14,13,46,53,-7,41
Queen of S't,5009,7,10,11,15,42,54,-12,41
Raith,5009,8,10,11,15,35,47,-12,41
St Mirren,5009,9,8,10,18,42,59,-17,34
Ayr,5009,10,7,13,16,31,54,-23,34
Hibernian,5010,1,18,13,5,52,27,25,67
Morton,5010,2,16,14,6,47,34,13,62
Falkirk,5010,3,16,10,10,60,41,19,58
Dundee Utd,5010,4,15,11,10,50,42,8,56
Dunfermline,5010,5,10,15,11,51,48,3,45
Queen of S't,5010,6,11,10,15,42,49,-7,43
Dumbarton,5010,7,9,12,15,43,55,-12,39
Ayr,5010,8,8,14,14,35,52,-17,38
St Mirren,5010,9,8,13,15,39,51,-12,37
Raith,5010,10,8,10,18,34,54,-20,34
Hibernian,5011,1,19,13,4,57,29,28,70
Morton,5011,2,15,12,9,46,38,8,57
Falkirk,5011,3,15,11,10,59,42,17,56
Dundee Utd,5011,4,14,11,11,46,43,3,53
Queen of S't,5011,5,14,8,14,53,49,4,50
Dunfermline,5011,6,10,15,11,50,48,2,45
Dumbarton,5011,7,10,11,15,51,62,-11,41
Ayr,5011,8,9,13,14,38,53,-15,40
Raith,5011,9,10,8,18,33,50,-17,38
St Mirren,5011,10,8,10,18,37,56,-19,34
Hibernian,5012,1,19,13,4,54,23,31,70
Morton,5012,2,17,12,7,54,40,14,63
Dundee Utd,5012,3,17,9,10,54,39,15,60
Falkirk,5012,4,15,11,10,58,42,16,56
Queen of S't,5012,5,12,10,14,46,53,-7,46
Dunfermline,5012,6,9,14,13,52,55,-3,41
Dumbarton,5012,7,9,11,16,52,66,-14,38
St Mirren,5012,8,9,10,17,44,58,-14,37
Ayr,5012,9,8,12,16,38,57,-19,36
Raith,5012,10,8,12,16,33,52,-19,36
Hibernian,5013,1,18,12,6,56,28,28,66
Dundee Utd,5013,2,18,9,9,49,36,13,63
Morton,5013,3,16,11,9,47,40,7,59
Falkirk,5013,4,14,11,11,55,44,11,53
Queen of S't,5013,5,12,10,14,49,51,-2,46
Dunfermline,5013,6,11,12,13,47,45,2,45
Dumbarton,5013,7,10,12,14,48,57,-9,42
Raith,5013,8,10,10,16,39,54,-15,40
Ayr,5013,9,9,12,15,38,55,-17,39
St Mirren,5013,10,7,11,18,38,56,-18,32
Hibernian,5014,1,18,12,6,56,28,28,66
Dundee Utd,5014,2,17,10,9,53,39,14,61
Morton,5014,3,17,10,9,49,35,14,61
Falkirk,5014,4,14,12,10,58,48,10,54
Queen of S't,5014,5,13,9,14,44,48,-4,48
Dunfermline,5014,6,8,16,12,44,47,-3,40
Raith,5014,7,10,10,16,35,46,-11,40
Dumbarton,5014,8,9,12,15,48,60,-12,39
St Mirren,5014,9,9,11,16,43,56,-13,38
Ayr,5014,10,8,12,16,31,54,-23,36
Hibernian,5015,1,17,15,4,52,26,26,66
Falkirk,5015,2,16,12,8,58,40,18,60
Morton,5015,3,16,12,8,52,38,14,60
Dundee Utd,5015,4,17,9,10,50,38,12,60
Dunfermline,5015,5,11,12,13,46,45,1,45
Raith,5015,6,11,10,15,36,48,-12,43
Queen of S't,5015,7,11,9,16,45,50,-5,42
Ayr,5015,8,8,13,15,32,53,-21,37
Dumbarton,5015,9,8,12,16,44,60,-16,36
St Mirren,5015,10,6,14,16,39,56,-17,32
Morton,5016,1,20,10,6,56,33,23,70
Hibernian,5016,2,19,11,6,56,26,30,68
Dundee Utd,5016,3,18,9,9,59,39,20,63
Falkirk,5016,4,16,10,10,60,43,17,58
Queen of S't,5016,5,13,10,13,45,49,-4,49
Dunfermline,5016,6,9,12,15,43,50,-7,39
Raith,5016,7,9,11,16,34,48,-14,38
Dumbarton,5016,8,9,11,16,46,62,-16,38
St Mirren,5016,9,8,9,19,36,59,-23,33
Ayr,5016,10,6,13,17,35,61,-26,31
Hibernian,5017,1,19,11,6,54,26,28,68
Morton,5017,2,18,11,7,55,37,18,65
Falkirk,5017,3,15,12,9,56,41,15,57
Dundee Utd,5017,4,15,11,10,49,42,7,56
Queen of S't,5017,5,12,8,16,46,50,-4,44
Dunfermline,5017,6,10,13,13,49,50,-1,43
Dumbarton,5017,7,9,13,14,47,57,-10,40
Raith,5017,8,10,10,16,38,53,-15,40
Ayr,5017,9,8,12,16,37,57,-20,36
St Mirren,5017,10,7,13,16,36,54,-18,34
Hibernian,5018,1,19,12,5,52,25,27,69
Morton,5018,2,17,11,8,49,33,16,62
Falkirk,5018,3,16,12,8,59,39,20,60
Dundee Utd,5018,4,15,10,11,45,39,6,55
Queen of S't,5018,5,12,9,15,43,46,-3,45
Dunfermline,5018,6,10,12,14,45,51,-6,42
St Mirren,5018,7,10,10,16,40,54,-14,40
Raith,5018,8,10,9,17,32,45,-13,39
Ayr,5018,9,9,11,16,31,51,-20,38
Dumbarton,5018,10,8,12,16,42,55,-13,36
Hibernian,5019,1,16,17,3,49,23,26,65
Morton,5019,2,15,13,8,51,37,14,58
Falkirk,5019,3,14,13,9,56,42,14,55
Dundee Utd,5019,4,14,11,11,49,45,4,53
Queen of S't,5019,5,13,8,15,50,55,-5,47
Dumbarton,5019,6,11,11,14,51,56,-5,44
Dunfermline,5019,7,8,17,11,47,49,-2,41
St Mirren,5019,8,9,13,14,45,54,-9,40
Ayr,5019,9,8,14,14,36,55,-19,38
Raith,5019,10,8,11,17,35,53,-18,35
Falkirk,5020,1,19,10,7,66,37,29,67
Hibernian,5020,2,17,12,7,50,28,22,63
Morton,5020,3,16,14,6,54,37,17,62
Dundee Utd,5020,4,13,10,13,46,45,1,49
Queen of S't,5020,5,12,10,14,46,50,-4,46
Raith,5020,6,10,11,15,40,53,-13,41
Ayr,5020,7,10,11,15,39,56,-17,41
Dunfermline,5020,8,9,13,14,47,53,-6,40
St Mirren,5020,9,9,11,16,45,60,-15,38
Dumbarton,5020,10,8,12,16,45,59,-14,36
Hibernian,5021,1,19,11,6,57,31,26,68
Morton,5021,2,18,11,7,53,35,18,65
Falkirk,5021,3,16,10,10,58,43,15,58
Dundee Utd,5021,4,16,10,10,53,43,10,58
Dunfermline,5021,5,11,11,14,47,50,-3,44
Queen of S't,5021,6,12,8,16,44,51,-7,44
Dumbarton,5021,7,9,11,16,53,61,-8,38
Raith,5021,8,9,11,16,37,53,-16,38
Ayr,5021,9,9,11,16,41,61,-20,38
St Mirren,5021,10,9,10,17,44,59,-15,37
Hibernian,5022,1,21,10,5,52,22,30,73
Morton,5022,2,17,10,9,53,37,16,61
Falkirk,5022,3,16,10,10,61,41,20,58
Dundee Utd,5022,4,15,11,10,47,43,4,56
Queen of S't,5022,5,13,10,13,49,50,-1,49
Dunfermline,5022,6,10,12,14,46,49,-3,42
Raith,5022,7,10,10,16,34,49,-15,40
Ayr,5022,8,8,14,14,33,51,-18,38
St Mirren,5022,9,8,11,17,42,58,-16,35
Dumbarton,5022,10,8,10,18,44,61,-17,34
Falkirk,5023,1,18,10,8,65,37,28,64
Hibernian,5023,2,17,10,9,54,32,22,61
Morton,5023,3,17,10,9,54,40,14,61
Dundee Utd,5023,4,16,12,8,55,38,17,60
Dunfermline,5023,5,11,11,14,50,56,-6,44
Queen of S't,5023,6,11,9,16,45,54,-9,42
Dumbarton,5023,7,10,10,16,50,59,-9,40
Ayr,5023,8,9,13,14,36,51,-15,40
St Mirren,5023,9,9,11,16,41,61,-20,38
Raith,5023,10,10,8,18,36,58,-22,38
Hibernian,5024,1,19,12,5,54,23,31,69
Morton,5024,2,19,11,6,53,33,20,68
Dundee Utd,5024,3,17,8,11,56,38,18,59
Falkirk,5024,4,16,9,11,58,45,13,57
Queen of S't,5024,5,14,9,13,50,47,3,51
Raith,5024,6,11,8,17,32,47,-15,41
St Mirren,5024,7,10,10,16,40,52,-12,40
Dunfermline,5024,8,8,13,15,41,52,-11,37
Dumbarton,5024,9,8,10,18,44,62,-18,34
Ayr,5024,10,8,10,18,31,60,-29,34
Hibernian,5025,1,19,11,6,58,26,32,68
Falkirk,5025,2,18,9,9,59,41,18,63
Morton,5025,3,15,13,8,46,36,10,58
Dundee Utd,5025,4,15,10,11,50,40,10,55
Queen of S't,5025,5,12,11,13,45,46,-1,47
Raith,5025,6,12,9,15,35,50,-15,45
Dunfermline,5025,7,8,16,12,42,46,-4,40
Ayr,5025,8,8,13,15,32,54,-22,37
St Mirren,5025,9,8,11,17,42,52,-10,35
Dumbarton,5025,10,7,13,16,43,61,-18,34
Morton,5026,1,19,12,5,53,33,20,69
Hibernian,5026,2,17,14,5,53,28,25,65
Falkirk,5026,3,16,11,9,58,40,18,59
Dundee Utd,5026,4,14,12,10,49,41,8,54
St Mirren,5026,5,11,10,15,50,59,-9,43
Raith,5026,6,11,10,15,36,48,-12,43
Queen of S't,5026,7,10,10,16,42,49,-7,40
Dunfermline,5026,8,8,14,14,43,49,-6,38
Dumbarton,5026,9,9,10,17,47,59,-12,37
Ayr,5026,10,7,13,16,32,57,-25,34
Falkirk,5027,1,19,10,7,65,37,28,67
Hibernian,5027,2,18,12,6,54,31,23,66
Morton,5027,3,18,12,6,57,36,21,66
Dundee Utd,5027,4,13,10,13,46,46,0,49
Queen of S't,5027,5,12,10,14,44,48,-4,46
Dunfermline,5027,6,9,15,12,48,50,-2,42
Ayr,5027,7,10,12,14,42,54,-12,42
St Mirren,5027,8,9,9,18,42,59,-17,36
Raith,5027,9,9,9,18,35,55,-20,36
Dumbarton,5027,10,7,13,16,46,63,-17,34
Hibernian,5028,1,18,12,6,56,30,26,66
Falkirk,5028,2,16,11,9,58,41,17,59
Morton,5028,3,15,10,11,49,46,3,55
Dundee Utd,5028,4,14,12,10,47,41,6,54
Queen of S't,5028,5,13,9,14,50,48,2,48
Raith,5028,6,11,12,13,35,41,-6,45
Dumbarton,5028,7,11,12,13,48,55,-7,45
Dunfermline,5028,8,10,12,14,47,48,-1,42
Ayr,5028,9,7,14,15,32,55,-23,35
St Mirren,5028,10,8,10,18,39,56,-17,34
Hibernian,5029,1,21,10,5,57,26,31,73
Falkirk,5029,2,15,13,8,53,38,15,58
Dundee Utd,5029,3,16,10,10,51,41,10,58
Morton,5029,4,15,12,9,48,38,10,57
Queen of S't,5029,5,12,11,13,47,48,-1,47
Ayr,5029,6,9,13,14,35,52,-17,40
Raith,5029,7,9,12,15,31,45,-14,39
Dunfermline,5029,8,7,16,13,41,48,-7,37
Dumbarton,5029,9,8,11,17,44,57,-13,35
St Mirren,5029,10,7,14,15,36,50,-14,35
Hibernian,5030,1,19,12,5,59,26,33,69
Morton,5030,2,17,11,8,51,38,13,62
Dundee Utd,5030,3,17,10,9,53,41,12,61
Falkirk,5030,4,16,10,10,61,39,22,58
Dunfermline,5030,5,10,15,11,49,47,2,45
Queen of S't,5030,6,12,8,16,48,58,-10,44
Raith,5030,7,10,10,16,34,48,-14,40
St Mirren,5030,8,9,11,16,45,55,-10,38
Dumbarton,5030,9,8,11,17,48,68,-20,35
Ayr,5030,10,7,12,17,33,61,-28,33
Hibernian,5031,1,19,11,6,57,33,24,68
Morton,5031,2,18,10,8,54,35,19,64
Dundee Utd,5031,3,15,11,10,49,40,9,56
Falkirk,5031,4,14,12,10,58,44,14,54
Queen of S't,5031,5,12,9,15,47,51,-4,45
Dunfermline,5031,6,9,15,12,45,47,-2,42
Raith,5031,7,11,9,16,36,48,-12,42
Dumbarton,5031,8,9,13,14,47,54,-7,40
St Mirren,5031,9,8,13,15,38,53,-15,37
Ayr,5031,10,7,13,16,31,57,-26,34
Hibernian,5032,1,19,13,4,58,25,33,70
Falkirk,5032,2,17,10,9,56,37,19,61
Dundee Utd,5032,3,16,10,10,47,35,12,58
Morton,5032,4,15,12,9,47,41,6,57
Dunfermline,5032,5,11,14,11,49,47,2,47
Raith,5032,6,11,10,15,35,46,-11,43
Dumbarton,5032,7,9,13,14,46,53,-7,40
Queen of S't,5032,8,9,10,17,39,50,-11,37
Ayr,5032,9,9,10,17,32,59,-27,37
St Mirren,5032,10,7,12,17,43,59,-16,33
Hibernian,5033,1,18,11,7,51,29,22,65
Falkirk,5033,2,18,10,8,60,37,23,64
Morton,5033,3,17,11,8,51,39,12,62
Dundee Utd,5033,4,17,8,11,57,37,20,59
Dumbarton,5033,5,12,10,14,54,57,-3,46
Queen of S't,5033,6,12,10,14,47,52,-5,46
Raith,5033,7,12,9,15,36,46,-10,45
Dunfermline,5033,8,8,14,14,47,55,-8,38
St Mirren,5033,9,8,9,19,38,56,-18,33
Ayr,5033,10,7,10,19,29,62,-33,31
Falkirk,5034,1,17,11,8,62,41,21,62
Hibernian,5034,2,17,11,8,52,34,18,62
Dundee Utd,5034,3,17,10,9,54,41,13,61
Morton,5034,4,15,12,9,51,41,10,57
Queen of S't,5034,5,13,9,14,50,47,3,48
Raith,5034,6,12,8,16,34,44,-10,44
Dunfermline,5034,7,10,13,13,46,51,-5,43
Ayr,5034,8,9,13,14,31,48,-17,40
Dumbarton,5034,9,7,14,15,47,60,-13,35
St Mirren,5034,10,7,11,18,39,59,-20,32
Hibernian,5035,1,21,12,3,60,24,36,75
Morton,5035,2,15,13,8,53,42,11,58
Dundee Utd,5035,3,15,12,9,52,39,13,57
Falkirk,5035,4,14,13,9,55,43,12,55
Queen of S't,5035,5,13,9,14,44,49,-5,48
Raith,5035,6,10,11,15,41,52,-11,41
Dunfermline,5035,7,8,15,13,46,51,-5,39
Dumbarton,5035,8,9,12,15,48,56,-8,39
St Mirren,5035,9,8,11,17,38,56,-18,35
Ayr,5035,10,7,12,17,29,54,-25,33
Hibernian,5036,1,21,11,4,56,24,32,74
Morton,5036,2,18,12,6,53,33,20,66
Dundee Utd,5036,3,18,9,9,52,37,15,63
Falkirk,5036,4,16,10,10,58,41,17,58
Queen of S't,5036,5,11,10,15,43,48,-5,43
Dunfermline,5036,6,9,13,14,43,48,-5,40
Raith,5036,7,10,10,16,32,48,-16,40
Ayr,5036,8,9,11,16,39,53,-14,38
Dumbarton,5036,9,8,11,17,46,68,-22,35
St Mirren,5036,10,7,9,20,36,58,-22,30
Hibernian,5037,1,21,10,5,60,25,35,73
Morton,5037,2,18,11,7,55,34,21,65
Dundee Utd,5037,3,17,11,8,56,36,20,62
Falkirk,5037,4,15,12,9,54,36,18,57
Dunfermline,5037,5,10,13,13,47,55,-8,43
Queen of S't,5037,6,11,9,16,47,55,-8,42
St Mirren,5037,7,9,11,16,39,51,-12,38
Raith,5037,8,9,9,18,32,55,-23,36
Dumbarton,5037,9,7,13,16,41,58,-17,34
Ayr,5037,10,7,13,16,31,57,-26,34
Hibernian,5038,1,19,13,4,56,27,29,70
Dundee Utd,5038,2,18,8,10,56,37,19,62
Morton,5038,3,17,10,9,49,37,12,61
Falkirk,5038,4,15,10,11,56,42,14,55
Dunfermline,5038,5,12,11,13,48,44,4,47
Queen of S't,5038,6,12,10,14,45,51,-6,46
Ayr,5038,7,9,11,16,31,53,-22,38
Dumbarton,5038,8,9,10,17,47,63,-16,37
St Mirren,5038,9,9,10,17,40,56,-16,37
Raith,5038,10,9,9,18,29,47,-18,36
Hibernian,5039,1,20,12,4,55,25,30,72
Morton,5039,2,17,11,8,51,36,15,62
Falkirk,5039,3,17,10,9,57,38,19,61
Dundee Utd,5039,4,17,10,9,57,43,14,61
Dunfermline,5039,5,11,11,14,46,47,-1,44
Queen of S't,5039,6,12,8,16,44,54,-10,44
Raith,5039,7,11,9,16,34,45,-11,42
Dumbarton,5039,8,8,11,17,49,62,-13,35
St Mirren,5039,9,8,11,17,40,58,-18,35
Ayr,5039,10,6,13,17,32,57,-25,31
Hibernian,5040,1,19,12,5,56,25,31,69
Morton,5040,2,16,13,7,49,37,12,61
Falkirk,5040,3,16,9,11,56,45,11,57
Dundee Utd,5040,4,15,10,11,52,43,9,55
Dunfermline,5040,5,10,13,13,47,46,1,43
Ayr,5040,6,10,13,13,40,52,-12,43
Raith,5040,7,11,9,16,34,52,-18,42
Queen of S't,5040,8,10,11,15,40,50,-10,41
St Mirren,5040,9,10,10,16,48,57,-9,40
Dumbarton,5040,10,8,10,18,48,63,-15,34
Morton,5041,1,18,12,6,55,35,20,66
Hibernian,5041,2,17,12,7,53,28,25,63
Dundee Utd,5041,3,16,11,9,53,39,14,59
Falkirk,5041,4,15,11,10,58,45,13,56
Raith,5041,5,11,10,15,37,46,-9,43
Dunfermline,5041,6,9,14,13,47,53,-6,41
Dumbarton,5041,7,10,11,15,49,57,-8,41
Ayr,5041,8,9,14,13,37,55,-18,41
Queen of S't,5041,9,10,10,16,44,55,-11,40
St Mirren,5041,10,7,11,18,36,56,-20,32
Hibernian,5042,1,18,13,5,54,28,26,67
Falkirk,5042,2,18,9,9,64,42,22,63
Morton,5042,3,16,13,7,54,36,18,61
Dundee Utd,5042,4,14,9,13,49,47,2,51
Queen of S't,5042,5,12,10,14,47,53,-6,46
Dumbarton,5042,6,11,11,14,51,57,-6,44
Dunfermline,5042,7,10,12,14,50,55,-5,42
St Mirren,5042,8,10,9,17,42,57,-15,39
Raith,5042,9,9,10,17,36,52,-16,37
Ayr,5042,10,8,12,16,37,57,-20,36
Hibernian,5043,1,19,13,4,55,26,29,70
Morton,5043,2,18,12,6,54,35,19,66
Falkirk,5043,3,16,13,7,62,42,20,61
Dundee Utd,5043,4,16,10,10,46,37,9,58
Queen of S't,5043,5,12,10,14,49,52,-3,46
Raith,5043,6,10,11,15,37,49,-12,41
Dunfermline,5043,7,9,13,14,46,52,-6,40
St Mirren,5043,8,9,9,18,42,61,-19,36
Ayr,5043,9,8,10,18,32,54,-22,34
Dumbarton,5043,10,7,11,18,47,62,-15,32
Morton,5044,1,19,11,6,50,34,16,68
Hibernian,5044,2,18,13,5,54,25,29,67
Falkirk,5044,3,15,13,8,57,35,22,58
Dundee Utd,5044,4,15,10,11,43,40,3,55
Dumbarton,5044,5,10,14,12,49,51,-2,44
Queen of S't,5044,6,11,10,15,46,53,-7,43
Dunfermline,5044,7,9,13,14,41,47,-6,40
Raith,5044,8,9,11,16,31,47,-16,38
Ayr,5044,9,8,11,17,34,57,-23,35
St Mirren,5044,10,8,10,18,36,52,-16,34
Hibernian,5045,1,18,13,5,53,25,28,67
Falkirk,5045,2,18,10,8,62,40,22,64
Morton,5045,3,15,12,9,48,37,11,57
Dundee Utd,5045,4,15,10,11,49,41,8,55
Dunfermline,5045,5,12,12,12,47,45,2,48
St Mirren,5045,6,10,11,15,45,55,-10,41
Queen of S't,5045,7,11,8,17,43,55,-12,41
Dumbarton,5045,8,9,13,14,47,56,-9,40
Raith,5045,9,10,9,17,34,50,-16,39
Ayr,5045,10,7,12,17,32,56,-24,33
Hibernian,5046,1,17,14,5,53,27,26,65
Morton,5046,2,18,11,7,51,35,16,65
Dundee Utd,5046,3,17,10,9,54,36,18,61
Falkirk,5046,4,14,14,8,57,40,17,56
Dunfermline,5046,5,11,12,13,51,54,-3,45
Queen of S't,5046,6,10,10,16,42,55,-13,40
Dumbarton,5046,7,9,11,16,48,60,-12,38
Ayr,5046,8,8,14,14,34,55,-21,38
Raith,5046,9,9,10,17,38,51,-13,37
St Mirren,5046,10,9,10,17,39,54,-15,37
Hibernian,5047,1,19,12,5,59,30,29,69
Dundee Utd,5047,2,19,8,9,50,36,14,65
Morton,5047,3,17,11,8,50,38,12,62
Falkirk,5047,4,13,15,8,55,41,14,54
Queen of S't,5047,5,12,9,15,44,50,-6,45
Dunfermline,5047,6,10,12,14,46,49,-3,42
Raith,5047,7,10,10,16,35,45,-10,40
St Mirren,5047,8,10,10,16,41,54,-13,40
Dumbarton,5047,9,8,11,17,47,60,-13,35
Ayr,5047,10,8,10,18,32,56,-24,34
Hibernian,5048,1,21,11,4,57,25,32,74
Dundee Utd,5048,2,17,10,9,55,40,15,61
Morton,5048,3,16,12,8,49,39,10,60
Falkirk,5048,4,15,10,11,58,51,7,55
Dunfermline,5048,5,12,12,12,56,48,8,48
Queen of S't,5048,6,12,8,16,44,51,-7,44
Raith,5048,7,9,10,17,35,50,-15,37
Ayr,5048,8,9,10,17,35,57,-22,37
Dumbarton,5048,9,8,12,16,51,61,-10,36
St Mirren,5048,10,9,9,18,36,54,-18,36
Hibernian,5049,1,17,14,5,49,24,25,65
Morton,5049,2,17,12,7,49,34,15,63
Dundee Utd,5049,3,17,10,9,55,43,12,61
Falkirk,5049,4,15,11,10,57,39,18,56
Raith,5049,5,10,13,13,34,43,-9,43
Dunfermline,5049,6,10,12,14,43,47,-4,42
Queen of S't,5049,7,11,9,16,43,50,-7,42
St Mirren,5049,8,10,11,15,43,53,-10,41
Dumbarton,5049,9,9,12,15,45,57,-12,39
Ayr,5049,10,6,12,18,30,58,-28,30
Hibernian,5050,1,20,13,3,55,22,33,73
Morton,5050,2,15,12,9,49,41,8,57
Dundee Utd,5050,3,15,10,11,54,41,13,55
Falkirk,5050,4,14,11,11,54,44,10,53
Ayr,5050,5,11,13,12,36,46,-10,46
Queen of S't,5050,6,12,8,16,47,53,-6,44
Raith,5050,7,11,10,15,35,46,-11,43
Dunfermline,5050,8,10,12,14,46,53,-7,42
St Mirren,5050,9,9,9,18,42,59,-17,36
Dumbarton,5050,10,7,14,15,47,60,-13,35
Hibernian,5051,1,18,13,5,58,26,32,67
Morton,5051,2,18,9,9,53,42,11,63
Falkirk,5051,3,16,12,8,57,38,19,60
Dundee Utd,5051,4,14,9,13,47,41,6,51
Dunfermline,5051,5,13,11,12,56,49,7,50
Dumbarton,5051,6,11,11,14,52,58,-6,44
Queen of S't,5051,7,10,11,15,43,55,-12,41
Raith,5051,8,9,11,16,33,53,-20,38
Ayr,5051,9,9,11,16,33,54,-21,38
St Mirren,5051,10,8,10,18,40,56,-16,34
Hibernian,5052,1,18,12,6,59,28,31,66
Falkirk,5052,2,17,10,9,60,37,23,61
Dundee Utd,5052,3,17,9,10,52,39,13,60
Morton,5052,4,15,12,9,52,39,13,57
Dunfermline,5052,5,13,12,11,51,45,6,51
Queen of S't,5052,6,11,8,17,42,56,-14,41
Raith,5052,7,10,11,15,34,49,-15,41
Ayr,5052,8,9,12,15,36,56,-20,39
St Mirren,5052,9,8,12,16,40,59,-19,36
Dumbarton,5052,10,7,12,17,45,63,-18,33
Hibernian,5053,1,19,13,4,54,23,31,70
Morton,5053,2,18,13,5,56,33,23,67
Falkirk,5053,3,17,9,10,70,45,25,60
Dundee Utd,5053,4,15,9,12,52,47,5,54
Queen of S't,5053,5,12,10,14,50,56,-6,46
Dumbarton,5053,6,11,11,14,55,58,-3,44
Dunfermline,5053,7,9,12,15,47,54,-7,39
St Mirren,5053,8,9,10,17,39,59,-20,37
Raith,5053,9,9,9,18,35,57,-22,36
Ayr,5053,10,8,10,18,29,55,-26,34
Hibernian,5054,1,18,11,7,56,25,31,65
Falkirk,5054,2,18,11,7,62,38,24,65
Dundee Utd,5054,3,18,9,9,56,41,15,63
Morton,5054,4,15,14,7,44,35,9,59
Raith,5054,5,13,8,15,38,49,-11,47
Queen of S't,5054,6,11,9,16,46,55,-9,42
Dunfermline,5054,7,8,14,14,43,52,-9,38
St Mirren,5054,8,9,10,17,38,52,-14,37
Dumbarton,5054,9,8,11,17,50,62,-12,35
Ayr,5054,10,8,11,17,33,57,-24,35
Hibernian,5055,1,20,12,4,56,24,32,72
Morton,5055,2,16,12,8,49,35,14,60
Falkirk,5055,3,15,12,9,61,45,16,57
Dundee Utd,5055,4,14,12,10,49,39,10,54
Dunfermline,5055,5,12,13,11,50,49,1,49
Queen of S't,5055,6,11,10,15,43,51,-8,43
Raith,5055,7,11,9,16,39,53,-14,42
Dumbarton,5055,8,8,13,15,49,61,-12,37
Ayr,5055,9,7,13,16,34,57,-23,34
St Mirren,5055,10,7,12,17,37,53,-16,33
Hibernian,5056,1,19,12,5,59,26,33,69
Morton,5056,2,18,9,9,53,42,11,63
Falkirk,5056,3,17,11,8,61,39,22,62
Dundee Utd,5056,4,18,8,10,51,37,14,62
Queen of S't,5056,5,12,8,16,47,56,-9,44
Raith,5056,6,11,9,16,38,53,-15,42
Dunfermline,5056,7,9,12,15,48,51,-3,39
Ayr,5056,8,9,12,15,37,53,-16,39
Dumbarton,5056,9,8,11,17,47,65,-18,35
St Mirren,5056,10,8,10,18,41,60,-19,34
Hibernian,5057,1,20,10,6,56,31,25,70
Morton,5057,2,17,13,6,53,34,19,64
Dundee Utd,5057,3,15,11,10,53,40,13,56
Falkirk,5057,4,14,11,11,55,45,10,53
Dunfermline,5057,5,9,15,12,46,47,-1,42
Ayr,5057,6,10,12,14,40,56,-16,42
Queen of S't,5057,7,9,12,15,41,50,-9,39
Dumbarton,5057,8,9,12,15,50,63,-13,39
Raith,5057,9,9,12,15,33,48,-15,39
St Mirren,5057,10,9,10,17,40,53,-13,37
Hibernian,5058,1,19,13,4,60,26,34,70
Morton,5058,2,17,13,6,52,36,16,64
Dundee Utd,5058,3,16,9,11,52,42,10,57
Falkirk,5058,4,14,12,10,57,42,15,54
Raith,5058,5,10,12,14,36,49,-13,42
Ayr,5058,6,10,12,14,39,55,-16,42
Dunfermline,5058,7,10,11,15,49,55,-6,41
Queen of S't,5058,8,11,8,17,43,56,-13,41
Dumbarton,5058,9,8,15,13,49,57,-8,39
St Mirren,5058,10,7,11,18,39,58,-19,32
Morton,5059,1,18,12,6,54,35,19,66
Hibernian,5059,2,17,11,8,55,30,25,62
Falkirk,5059,3,17,10,9,58,37,21,61
Dundee Utd,5059,4,15,11,10,50,40,10,56
St Mirren,5059,5,12,10,14,46,51,-5,46
Raith,5059,6,12,8,16,39,47,-8,44
Dunfermline,5059,7,10,12,14,46,53,-7,42
Dumbarton,5059,8,9,11,16,48,59,-11,38
Queen of S't,5059,9,10,8,18,41,60,-19,38
Ayr,5059,10,8,11,17,34,59,-25,35
Hibernian,5060,1,19,14,3,56,25,31,71
Morton,5060,2,18,11,7,53,38,15,65
Falkirk,5060,3,15,11,10,59,44,15,56
Dundee Utd,5060,4,14,10,12,50,45,5,52
Queen of S't,5060,5,13,9,14,48,51,-3,48
Raith,5060,6,12,10,14,40,46,-6,46
Dunfermline,5060,7,9,14,13,49,53,-4,41
Dumbarton,5060,8,8,13,15,43,52,-9,37
Ayr,5060,9,7,13,16,33,56,-23,34
St Mirren,5060,10,6,13,17,38,59,-21,31
Hibernian,5061,1,20,12,4,63,25,38,72
Dundee Utd,5061,2,17,10,9,54,38,16,61
Morton,5061,3,16,11,9,46,39,7,59
Falkirk,5061,4,15,9,12,57,47,10,54
Dunfermline,5061,5,11,13,12,46,46,0,46
Dumbarton,5061,6,10,12,14,50,58,-8,42
Queen of S't,5061,7,10,11,15,45,55,-10,41
Raith,5061,8,10,9,17,38,52,-14,39
Ayr,5061,9,8,12,16,32,54,-22,36
St Mirren,5061,10,8,11,17,38,55,-17,35
Hibernian,5062,1,20,12,4,59,28,31,72
Morton,5062,2,17,10,9,48,37,11,61
Dundee Utd,5062,3,15,10,11,46,39,7,55
Falkirk,5062,4,13,13,10,51,42,9,52
Dumbarton,5062,5,11,12,13,51,55,-4,45
Queen of S't,5062,6,11,11,14,44,50,-6,44
Raith,5062,7,11,10,15,37,48,-11,43
Dunfermline,5062,8,10,12,14,48,47,1,42
Ayr,5062,9,8,14,14,35,52,-17,38
St Mirren,5062,10,7,10,19,39,60,-21,31
Hibernian,5063,1,19,13,4,54,23,31,70
Dundee Utd,5063,2,17,9,10,50,37,13,60
Morton,5063,3,16,12,8,53,42,11,60
Falkirk,5063,4,16,10,10,56,39,17,58
Queen of S't,5063,5,16,8,12,51,46,5,56
Dunfermline,5063,6,9,13,14,46,52,-6,40
Raith,5063,7,10,9,17,33,50,-17,39
Ayr,5063,8,8,13,15,34,52,-18,37
Dumbarton,5063,9,8,11,17,49,67,-18,35
St Mirren,5063,10,7,10,19,38,56,-18,31
Hibernian,5064,1,19,12,5,57,25,32,69
Falkirk,5064,2,17,11,8,61,40,21,62
Morton,5064,3,17,11,8,51,35,16,62
Dundee Utd,5064,4,15,10,11,49,39,10,55
Dunfermline,5064,5,10,13,13,48,54,-6,43
Queen of S't,5064,6,11,10,15,46,55,-9,43
Ayr,5064,7,10,13,13,42,55,-13,43
Raith,5064,8,10,10,16,36,48,-12,40
Dumbarton,5064,9,9,10,17,48,62,-14,37
St Mirren,5064,10,7,10,19,36,61,-25,31
Hibernian,5065,1,21,12,3,61,22,39,75
Morton,5065,2,15,14,7,45,34,11,59
Falkirk,5065,3,14,13,9,55,41,14,55
Dundee Utd,5065,4,13,10,13,44,42,2,49
Queen of S't,5065,5,13,9,14,45,48,-3,48
Dunfermline,5065,6,10,14,12,45,48,-3,44
Raith,5065,7,11,10,15,37,48,-11,43
Dumbarton,5065,8,9,14,13,49,56,-7,41
St Mirren,5065,9,8,12,16,40,54,-14,36
Ayr,5065,10,7,10,19,31,59,-28,31
Hibernian,5066,1,21,12,3,56,22,34,75
Falkirk,5066,2,15,12,9,57,41,16,57
Dundee Utd,5066,3,15,12,9,49,39,10,57
Morton,5066,4,15,12,9,47,38,9,57
Dumbarton,5066,5,11,11,14,51,58,-7,44
Queen of S't,5066,6,11,9,16,46,52,-6,42
Dunfermline,5066,7,8,14,14,44,51,-7,38
St Mirren,5066,8,9,11,16,42,53,-11,38
Raith,5066,9,9,10,17,35,51,-16,37
Ayr,5066,10,8,13,15,38,60,-22,37
Hibernian,5067,1,18,15,3,55,25,30,69
Morton,5067,2,16,12,8,48,36,12,60
Falkirk,5067,3,16,10,10,62,41,21,58
Dundee Utd,5067,4,16,10,10,50,39,11,58
Queen of S't,5067,5,12,9,15,48,59,-11,45
Dunfermline,5067,6,10,14,12,51,51,0,44
Dumbarton,5067,7,9,14,13,50,57,-7,41
St Mirren,5067,8,9,11,16,41,53,-12,38
Raith,5067,9,9,9,18,33,56,-23,36
Ayr,5067,10,7,12,17,39,60,-21,33
Hibernian,5068,1,18,12,6,55,29,26,66
Morton,5068,2,16,15,5,56,37,19,63
Dundee Utd,5068,3,17,11,8,56,38,18,62
Falkirk,5068,4,16,10,10,61,41,20,58
Dunfermline,5068,5,9,15,12,42,45,-3,42
Queen of S't,5068,6,10,10,16,43,55,-12,40
Dumbarton,5068,7,9,12,15,46,57,-11,39
St Mirren,5068,8,9,12,15,39,52,-13,39
Ayr,5068,9,9,11,16,34,55,-21,38
Raith,5068,10,8,10,18,31,54,-23,34
Hibernian,5069,1,18,12,6,57,27,30,66
Falkirk,5069,2,17,11,8,64,40,24,62
Dundee Utd,5069,3,17,11,8,54,39,15,62
Morton,5069,4,16,10,10,48,41,7,58
Dunfermline,5069,5,11,12,13,55,55,0,45
Queen of S't,5069,6,11,10,15,47,56,-9,43
Raith,5069,7,11,8,17,35,55,-20,41
Dumbarton,5069,8,9,11,16,49,60,-11,38
St Mirren,5069,9,9,9,18,43,57,-14,36
Ayr,5069,10,8,12,16,33,55,-22,36
Hibernian,5070,1,20,11,5,53,26,27,71
Dundee Utd,5070,2,17,10,9,50,37,13,61
Morton,5070,3,15,13,8,47,36,11,58
Falkirk,5070,4,15,10,11,54,40,14,55
Queen of S't,5070,5,13,9,14,49,50,-1,48
Dunfermline,5070,6,11,13,12,51,46,5,46
Raith,5070,7,11,10,15,37,46,-9,43
St Mirren,5070,8,9,10,17,42,55,-13,37
Ayr,5070,9,8,11,17,33,60,-27,35
Dumbarton,5070,10,7,11,18,45,65,-20,32
Hibernian,5071,1,20,11,5,58,29,29,71
Morton,5071,2,19,12,5,58,32,26,69
Dundee Utd,5071,3,16,10,10,54,42,12,58
Falkirk,5071,4,15,11,10,57,43,14,56
Queen of S't,5071,5,11,11,14,43,48,-5,44
Dunfermline,5071,6,10,13,13,45,48,-3,43
Raith,5071,7,10,9,17,37,54,-17,39
Ayr,5071,8,9,11,16,35,56,-21,38
Dumbarton,5071,9,8,12,16,49,61,-12,36
St Mirren,5071,10,7,10,19,37,60,-23,31
Hibernian,5072,1,20,11,5,65,30,35,71
Dundee Utd,5072,2,18,9,9,55,39,16,63
Morton,5072,3,16,11,9,50,41,9,59
Falkirk,5072,4,15,9,12,56,47,9,54
Queen of S't,5072,5,13,8,15,49,51,-2,47
Dunfermline,5072,6,10,13,13,52,52,0,43
Raith,5072,7,11,10,15,39,50,-11,43
Dumbarton,5072,8,10,12,14,48,57,-9,42
St Mirren,5072,9,7,12,17,38,57,-19,33
Ayr,5072,10,7,11,18,33,61,-28,32
Hibernian,5073,1,20,12,4,58,23,35,72
Morton,5073,2,18,10,8,54,35,19,64
Falkirk,5073,3,15,11,10,59,47,12,56
Dundee Utd,5073,4,13,12,11,47,41,6,51
Dunfermline,5073,5,11,14,11,50,44,6,47
Queen of S't,5073,6,11,10,15,45,54,-9,43
Raith,5073,7,10,11,15,37,48,-11,41
St Mirren,5073,8,10,9,17,43,61,-18,39
Dumbarton,5073,9,8,12,16,48,64,-16,36
Ayr,5073,10,6,15,15,30,54,-24,33
Hibernian,5074,1,18,14,4,54,23,31,68
Morton,5074,2,16,14,6,48,34,14,62
Dundee Utd,5074,3,16,10,10,50,40,10,58
Falkirk,5074,4,15,11,10,59,44,15,56
Raith,5074,5,11,12,13,37,46,-9,45
Dumbarton,5074,6,10,11,15,50,56,-6,41
Queen of S't,5074,7,10,10,16,39,49,-10,40
Dunfermline,5074,8,9,12,15,42,50,-8,39
Ayr,5074,9,9,12,15,35,54,-19,39
St Mirren,5074,10,7,12,17,41,59,-18,33
Hibernian,5075,1,19,10,7,55,28,27,67
Morton,5075,2,18,10,8,55,37,18,64
Falkirk,5075,3,16,11,9,62,46,16,59
Dundee Utd,5075,4,14,11,11,50,44,6,53
Queen of S't,5075,5,13,9,14,43,47,-4,48
Dunfermline,5075,6,10,13,13,48,55,-7,43
Raith,5075,7,11,10,15,38,49,-11,43
St Mirren,5075,8,9,11,16,45,57,-12,38
Dumbarton,5075,9,8,12,16,47,55,-8,36
Ayr,5075,10,7,13,16,32,57,-25,34
Hibernian,5076,1,17,13,6,54,28,26,64
Falkirk,5076,2,16,10,10,61,43,18,58
Dundee Utd,5076,3,16,10,10,48,39,9,58
Morton,5076,4,15,12,9,49,40,9,57
Queen of S't,5076,5,12,10,14,44,50,-6,46
Dunfermline,5076,6,9,16,11,46,45,1,43
Dumbarton,5076,7,10,11,15,49,59,-10,41
Raith,5076,8,9,12,15,32,45,-13,39
Ayr,5076,9,8,14,14,34,52,-18,38
St Mirren,5076,10,8,12,16,37,53,-16,36
Hibernian,5077,1,20,11,5,58,29,29,71
Morton,5077,2,17,11,8,48,35,13,62
Falkirk,5077,3,17,10,9,60,43,17,61
Dundee Utd,5077,4,17,9,10,53,43,10,60
Ayr,5077,5,11,11,14,39,52,-13,44
Queen of S't,5077,6,11,8,17,42,51,-9,41
Dumbarton,5077,7,10,10,16,50,58,-8,40
Dunfermline,5077,8,9,12,15,44,49,-5,39
Raith,5077,9,10,9,17,34,49,-15,39
St Mirren,5077,10,7,11,18,36,55,-19,32
Hibernian,5078,1,18,12,6,53,25,28,66
Morton,5078,2,18,10,8,55,38,17,64
Falkirk,5078,3,16,13,7,59,38,21,61
Dundee Utd,5078,4,15,11,10,49,40,9,56
Queen of S't,5078,5,11,11,14,44,49,-5,44
Dumbarton,5078,6,10,13,13,51,55,-4,43
Dunfermline,5078,7,9,14,13,45,50,-5,41
Ayr,5078,8,8,13,15,33,54,-21,37
St Mirren,5078,9,9,9,18,43,62,-19,36
Raith,5078,10,8,10,18,31,52,-21,34
Hibernian,5079,1,19,12,5,61,26,35,69
Falkirk,5079,2,18,10,8,61,39,22,64
Morton,5079,3,17,11,8,51,43,8,62
Dundee Utd,5079,4,15,10,11,48,41,7,55
Queen of S't,5079,5,11,10,15,42,51,-9,43
Raith,5079,6,10,12,14,35,44,-9,42
Dumbarton,5079,7,10,11,15,48,53,-5,41
Dunfermline,5079,8,8,13,15,46,54,-8,37
Ayr,5079,9,8,13,15,34,55,-21,37
St Mirren,5079,10,7,12,17,35,55,-20,33
Hibernian,5080,1,23,10,3,58,21,37,79
Dundee Utd,5080,2,17,9,10,55,44,11,60
Morton,5080,3,16,11,9,45,34,11,59
Falkirk,5080,4,14,10,12,56,45,11,52
Queen of S't,5080,5,14,8,14,48,47,1,50
Dunfermline,5080,6,10,13,13,42,45,-3,43
Raith,5080,7,10,11,15,35,45,-10,41
Dumbarton,5080,8,9,10,17,47,60,-13,37
Ayr,5080,9,8,10,18,32,59,-27,34
St Mirren,5080,10,7,12,17,39,57,-18,33
Hibernian,5081,1,18,12,6,54,28,26,66
Morton,5081,2,17,11,8,52,39,13,62
Falkirk,5081,3,17,10,9,59,40,19,61
Dundee Utd,5081,4,15,10,11,49,39,10,55
Queen of S't,5081,5,13,9,14,47,53,-6,48
Dunfermline,5081,6,11,12,13,52,49,3,45
Dumbarton,5081,7,9,13,14,49,60,-11,40
Raith,5081,8,10,10,16,34,47,-13,40
St Mirren,5081,9,8,10,18,37,56,-19,34
Ayr,5081,10,7,13,16,34,56,-22,34
Hibernian,5082,1,18,14,4,57,26,31,68
Morton,5082,2,18,11,7,54,36,18,65
Dundee Utd,5082,3,15,10,11,51,45,6,55
Falkirk,5082,4,14,11,11,55,43,12,53
Dunfermline,5082,5,10,14,12,48,50,-2,44
Queen of S't,5082,6,10,13,13,40,45,-5,43
St Mirren,5082,7,11,9,16,46,57,-11,42
Raith,5082,8,10,11,15,34,47,-13,41
Dumbarton,5082,9,8,13,15,43,53,-10,37
Ayr,5082,10,7,12,17,34,60,-26,33
Hibernian,5083,1,19,12,5,50,23,27,69
Falkirk,5083,2,17,11,8,58,36,22,62
Morton,5083,3,17,11,8,47,33,14,62
Dundee Utd,5083,4,16,10,10,47,42,5,58
Queen of S't,5083,5,13,9,14,52,47,5,48
Dunfermline,5083,6,10,13,13,44,49,-5,43
Raith,5083,7,9,11,16,33,49,-16,38
Dumbarton,5083,8,8,13,15,47,57,-10,37
Ayr,5083,9,8,13,15,34,52,-18,37
St Mirren,5083,10,6,11,19,35,59,-24,29
Hibernian,5084,1,19,12,5,56,28,28,69
Dundee Utd,5084,2,18,8,10,55,36,19,62
Morton,5084,3,17,10,9,49,37,12,61
Falkirk,5084,4,16,11,9,55,37,18,59
Dumbarton,5084,5,10,12,14,47,54,-7,42
Queen of S't,5084,6,11,9,16,43,51,-8,42
Dunfermline,5084,7,10,11,15,44,53,-9,41
Raith,5084,8,10,9,17,31,46,-15,39
Ayr,5084,9,8,13,15,36,53,-17,37
St Mirren,5084,10,9,9,18,38,59,-21,36
Hibernian,5085,1,20,12,4,63,27,36,72
Dundee Utd,5085,2,18,10,8,51,36,15,64
Falkirk,5085,3,16,11,9,61,44,17,59
Morton,5085,4,13,13,10,43,37,6,52
Dunfermline,5085,5,12,12,12,53,45,8,48
Queen of S't,5085,6,12,8,16,46,52,-6,44
Raith,5085,7,9,11,16,33,53,-20,38
Dumbarton,5085,8,8,13,15,47,58,-11,37
St Mirren,5085,9,9,10,17,44,64,-20,37
Ayr,5085,10,6,14,16,33,58,-25,32
Hibernian,5086,1,22,11,3,61,23,38,77
Falkirk,5086,2,16,9,11,60,49,11,57
Dundee Utd,5086,3,16,9,11,53,42,11,57
Morton,5086,4,14,14,8,48,37,11,56
Dunfermline,5086,5,11,13,12,51,52,-1,46
Queen of S't,5086,6,12,10,14,48,52,-4,46
Dumbarton,5086,7,9,11,16,48,59,-11,38
Raith,5086,8,9,10,17,34,52,-18,37
Ayr,5086,9,9,10,17,36,58,-22,37
St Mirren,5086,10,8,11,17,42,57,-15,35
Hibernian,5087,1,23,10,3,67,22,45,79
Falkirk,5087,2,17,10,9,63,43,20,61
Dundee Utd,5087,3,15,12,9,51,41,10,57
Morton,5087,4,14,11,11,46,45,1,53
Dunfermline,5087,5,9,15,12,45,47,-2,42
Dumbarton,5087,6,10,11,15,47,55,-8,41
St Mirren,5087,7,10,10,16,40,56,-16,40
Queen of S't,5087,8,9,10,17,43,57,-14,37
Ayr,5087,9,8,13,15,37,54,-17,37
Raith,5087,10,9,10,17,31,50,-19,37
Hibernian,5088,1,19,11,6,58,28,30,68
Morton,5088,2,17,13,6,52,36,16,64
Falkirk,5088,3,17,11,8,67,42,25,62
Dundee Utd,5088,4,16,10,10,50,38,12,58
Dunfermline,5088,5,11,13,12,49,46,3,46
Queen of S't,5088,6,11,9,16,45,60,-15,42
Raith,5088,7,10,9,17,37,54,-17,39
Ayr,5088,8,9,11,16,38,55,-17,38
Dumbarton,5088,9,8,12,16,48,64,-16,36
St Mirren,5088,10,8,9,19,36,57,-21,33
Hibernian,5089,1,18,11,7,50,30,20,65
Falkirk,5089,2,16,11,9,59,41,18,59
Morton,5089,3,15,14,7,49,35,14,59
Dundee Utd,5089,4,16,9,11,51,42,9,57
Dumbarton,5089,5,11,12,13,52,56,-4,45
Raith,5089,6,11,11,14,38,45,-7,44
Dunfermline,5089,7,9,15,12,47,47,0,42
Queen of S't,5089,8,10,11,15,44,53,-9,41
St Mirren,5089,9,8,12,16,40,56,-16,36
Ayr,5089,10,7,12,17,30,55,-25,33
Hibernian,5090,1,21,12,3,61,21,40,75
Falkirk,5090,2,18,9,9,60,39,21,63
Morton,5090,3,16,13,7,50,36,14,61
Dundee Utd,5090,4,14,11,11,46,41,5,53
Queen of S't,5090,5,12,9,15,43,53,-10,45
Dumbarton,5090,6,10,11,15,52,61,-9,41
Raith,5090,7,10,10,16,35,45,-10,40
Dunfermline,5090,8,9,12,15,43,49,-6,39
St Mirren,5090,9,9,12,15,39,51,-12,39
Ayr,5090,10,6,11,19,30,63,-33,29
Morton,5091,1,19,11,6,48,30,18,68
Hibernian,5091,2,17,12,7,51,29,22,63
Falkirk,5091,3,15,10,11,56,39,17,55
Dundee Utd,5091,4,15,10,11,45,39,6,55
Queen of S't,5091,5,11,13,12,45,47,-2,46
Dunfermline,5091,6,11,12,13,40,44,-4,45
St Mirren,5091,7,10,11,15,40,51,-11,41
Raith,5091,8,10,10,16,38,52,-14,40
Dumbarton,5091,9,9,11,16,49,59,-10,38
Ayr,5091,10,7,12,17,33,55,-22,33
Hibernian,5092,1,19,11,6,56,28,28,68
Morton,5092,2,16,11,9,53,39,14,59
Dundee Utd,5092,3,16,9,11,52,43,9,57
Falkirk,5092,4,15,10,11,58,48,10,55
Queen of S't,5092,5,12,10,14,47,53,-6,46
Dunfermline,5092,6,11,11,14,50,52,-2,44
Dumbarton,5092,7,10,13,13,53,56,-3,43
Raith,5092,8,11,10,15,38,50,-12,43
St Mirren,5092,9,10,9,17,39,51,-12,39
Ayr,5092,10,8,10,18,33,59,-26,34
Hibernian,5093,1,22,10,4,64,27,37,76
Dundee Utd,5093,2,18,9,9,56,38,18,63
Morton,5093,3,15,11,10,51,41,10,56
Falkirk,5093,4,15,9,12,55,47,8,54
Dunfermline,5093,5,12,11,13,49,48,1,47
Queen of S't,5093,6,12,9,15,43,46,-3,45
Raith,5093,7,10,10,16,35,50,-15,40
Dumbarton,5093,8,9,11,16,47,60,-13,38
Ayr,5093,9,8,13,15,36,57,-21,37
St Mirren,5093,10,7,11,18,41,63,-22,32
Hibernian,5094,1,20,12,4,54,23,31,72
Morton,5094,2,16,12,8,49,38,11,60
Falkirk,5094,3,15,12,9,56,40,16,57
Dundee Utd,5094,4,15,10,11,54,43,11,55
Raith,5094,5,12,11,13,41,46,-5,47
Queen of S't,5094,6,11,9,16,43,52,-9,42
Dunfermline,5094,7,9,14,13,45,48,-3,41
Dumbarton,5094,8,8,13,15,45,55,-10,37
Ayr,5094,9,8,13,15,31,52,-21,37
St Mirren,5094,10,7,12,17,38,59,-21,33
Hibernian,5095,1,19,11,6,57,29,28,68
Dundee Utd,5095,2,20,8,8,56,35,21,68
Falkirk,5095,3,15,9,12,54,43,11,54
Morton,5095,4,14,11,11,49,46,3,53
Raith,5095,5,13,9,14,41,49,-8,48
Queen of S't,5095,6,12,10,14,48,49,-1,46
Ayr,5095,7,9,12,15,35,52,-17,39
Dunfermline,5095,8,8,13,15,44,49,-5,37
Dumbarton,5095,9,8,13,15,44,58,-14,37
St Mirren,5095,10,9,10,17,44,62,-18,37
Morton,5096,1,19,12,5,53,35,18,69
Falkirk,5096,2,18,10,8,64,36,28,64
Dundee Utd,5096,3,18,8,10,64,39,25,62
Hibernian,5096,4,16,14,6,49,30,19,62
Dunfermline,5096,5,9,14,13,45,51,-6,41
Queen of S't,5096,6,10,11,15,43,53,-10,41
Raith,5096,7,10,9,17,33,49,-16,39
Ayr,5096,8,9,10,17,37,59,-22,37
St Mirren,5096,9,8,12,16,41,56,-15,36
Dumbarton,5096,10,7,12,17,43,64,-21,33
Hibernian,5097,1,17,13,6,51,26,25,64
Falkirk,5097,2,18,9,9,64,39,25,63
Morton,5097,3,15,14,7,45,34,11,59
Dundee Utd,5097,4,16,10,10,48,36,12,58
Queen of S't,5097,5,13,8,15,46,49,-3,47
Dunfermline,5097,6,10,13,13,42,47,-5,43
Raith,5097,7,10,10,16,35,48,-13,40
Ayr,5097,8,9,13,14,31,49,-18,40
Dumbarton,5097,9,8,12,16,45,63,-18,36
St Mirren,5097,10,7,12,17,39,55,-16,33
Hibernian,5098,1,18,13,5,51,26,25,67
Morton,5098,2,17,13,6,55,37,18,64
Falkirk,5098,3,17,11,8,58,40,18,62
Dundee Utd,5098,4,15,9,12,52,46,6,54
Dunfermline,5098,5,10,15,11,52,47,5,45
Ayr,5098,6,10,13,13,39,52,-13,43
Raith,5098,7,9,13,14,34,46,-12,40
Queen of S't,5098,8,10,8,18,40,52,-12,38
Dumbarton,5098,9,8,12,16,50,63,-13,36
St Mirren,5098,10,7,11,18,39,61,-22,32
Hibernian,5099,1,19,12,5,50,23,27,69
Falkirk,5099,2,17,10,9,57,40,17,61
Dundee Utd,5099,3,16,11,9,48,38,10,59
Morton,5099,4,14,13,9,50,41,9,55
Ayr,5099,5,10,12,14,40,55,-15,42
Dunfermline,5099,6,9,14,13,45,49,-4,41
Dumbarton,5099,7,10,11,15,49,58,-9,41
Raith,5099,8,10,11,15,37,48,-11,41
Queen of S't,5099,9,10,8,18,44,55,-11,38
St Mirren,5099,10,9,10,17,40,53,-13,37
Hibernian,5100,1,19,12,5,57,27,30,69
Morton,5100,2,18,10,8,51,41,10,64
Falkirk,5100,3,17,9,10,62,45,17,60
Dundee Utd,5100,4,17,9,10,50,38,12,60
Queen of S't,5100,5,12,9,15,46,45,1,45
Dunfermline,5100,6,11,12,13,48,50,-2,45
Raith,5100,7,10,9,17,37,50,-13,39
Ayr,5100,8,8,14,14,35,53,-18,38
St Mirren,5100,9,8,10,18,44,61,-17,34
Dumbarton,5100,10,8,10,18,44,64,-20,34
Hibernian,5101,1,19,11,6,57,29,28,68
Morton,5101,2,17,11,8,48,34,14,62
Falkirk,5101,3,16,10,10,58,36,22,58
Dundee Utd,5101,4,16,9,11,50,37,13,57
Queen of S't,5101,5,14,8,14,45,48,-3,50
Dunfermline,5101,6,10,14,12,47,52,-5,44
Ayr,5101,7,10,12,14,36,51,-15,42
Raith,5101,8,10,10,16,37,55,-18,40
Dumbarton,5101,9,7,12,17,45,59,-14,33
St Mirren,5101,10,7,11,18,36,58,-22,32
Hibernian,5102,1,21,11,4,63,25,38,74
Dundee Utd,5102,2,16,11,9,51,40,11,59
Falkirk,5102,3,15,11,10,56,42,14,56
Morton,5102,4,14,11,11,46,46,0,53
Raith,5102,5,12,10,14,41,49,-8,46
Dunfermline,5102,6,9,14,13,47,55,-8,41
Dumbarton,5102,7,9,13,14,48,54,-6,40
Queen of S't,5102,8,10,10,16,47,55,-8,40
Ayr,5102,9,8,15,13,37,53,-16,39
St Mirren,5102,10,7,12,17,41,58,-17,33
Hibernian,5103,1,20,11,5,57,26,31,71
Dundee Utd,5103,2,17,10,9,52,40,12,61
Falkirk,5103,3,16,10,10,61,45,16,58
Morton,5103,4,15,11,10,52,40,12,56
Dunfermline,5103,5,12,13,11,52,45,7,49
Queen of S't,5103,6,11,9,16,42,49,-7,42
Raith,5103,7,11,8,17,36,55,-19,41
Dumbarton,5103,8,9,12,15,50,61,-11,39
St Mirren,5103,9,8,11,17,39,57,-18,35
Ayr,5103,10,8,11,17,33,56,-23,35
Morton,5104,1,19,10,7,54,33,21,67
Hibernian,5104,2,18,10,8,52,32,20,64
Falkirk,5104,3,17,10,9,61,35,26,61
Dundee Utd,5104,4,17,10,9,56,37,19,61
Queen of S't,5104,5,12,9,15,49,56,-7,45
Dunfermline,5104,6,10,12,14,49,55,-6,42
Raith,5104,7,10,9,17,35,47,-12,39
St Mirren,5104,8,9,11,16,39,57,-18,38
Ayr,5104,9,8,12,16,32,56,-24,36
Dumbarton,5104,10,8,11,17,46,65,-19,35
Hibernian,5105,1,18,11,7,58,29,29,65
Morton,5105,2,18,10,8,48,33,15,64
Dundee Utd,5105,3,17,9,10,54,40,14,60
Falkirk,5105,4,16,11,9,60,40,20,59
Dunfermline,5105,5,12,13,11,50,46,4,49
Queen of S't,5105,6,10,12,14,43,51,-8,42
Raith,5105,7,10,11,15,34,46,-12,41
Dumbarton,5105,8,8,13,15,45,59,-14,37
Ayr,5105,9,7,14,15,29,52,-23,35
St Mirren,5105,10,7,10,19,33,58,-25,31
Hibernian,5106,1,19,14,3,54,24,30,71
Morton,5106,2,17,12,7,53,36,17,63
Falkirk,5106,3,15,11,10,54,40,14,56
Dundee Utd,5106,4,15,11,10,48,42,6,56
Queen of S't,5106,5,12,10,14,48,49,-1,46
Raith,5106,6,10,11,15,37,46,-9,41
Dunfermline,5106,7,9,13,14,44,51,-7,40
Ayr,5106,8,8,13,15,34,53,-19,37
Dumbarton,5106,9,8,12,16,44,58,-14,36
St Mirren,5106,10,7,13,16,36,53,-17,34
Hibernian,5107,1,21,11,4,60,24,36,74
Morton,5107,2,19,9,8,54,36,18,66
Dundee Utd,5107,3,18,9,9,53,39,14,63
Falkirk,5107,4,16,10,10,60,40,20,58
Queen of S't,5107,5,11,11,14,42,51,-9,44
Dunfermline,5107,6,9,12,15,47,55,-8,39
Raith,5107,7,10,9,17,36,50,-14,39
Ayr,5107,8,9,11,16,38,59,-21,38
St Mirren,5107,9,9,9,18,41,57,-16,36
Dumbarton,5107,10,7,11,18,43,63,-20,32
Hibernian,5108,1,19,12,5,55,26,29,69
Morton,5108,2,16,12,8,47,40,7,60
Dundee Utd,5108,3,17,8,11,49,38,11,59
Falkirk,5108,4,16,10,10,61,44,17,58
Dunfermline,5108,5,12,12,12,51,44,7,48
Queen of S't,5108,6,12,9,15,44,49,-5,45
St Mirren,5108,7,10,10,16,43,56,-13,40
Raith,5108,8,10,9,17,35,51,-16,39
Dumbarton,5108,9,9,11,16,51,63,-12,38
Ayr,5108,10,7,11,18,33,58,-25,32
Hibernian,5109,1,20,10,6,54,27,27,70
Falkirk,5109,2,19,9,8,67,42,25,66
Dundee Utd,5109,3,18,8,10,54,40,14,62
Morton,5109,4,17,10,9,51,38,13,61
Queen of S't,5109,5,12,9,15,44,47,-3,45
Dumbarton,5109,6,11,11,14,53,58,-5,44
Dunfermline,5109,7,9,11,16,47,57,-10,38
St Mirren,5109,8,9,11,16,43,58,-15,38
Raith,5109,9,9,9,18,33,50,-17,36
Ayr,5109,10,7,10,19,32,61,-29,31
Hibernian,5110,1,20,12,4,55,24,31,72
Morton,5110,2,17,11,8,48,34,14,62
Dundee Utd,5110,3,16,11,9,47,37,10,59
Falkirk,5110,4,15,12,9,56,38,18,57
Dunfermline,5110,5,10,13,13,46,46,0,43
Dumbarton,5110,6,10,10,16,46,59,-13,40
Ayr,5110,7,9,13,14,34,49,-15,40
St Mirren,5110,8,9,10,17,41,53,-12,37
Queen of S't,5110,9,9,10,17,37,53,-16,37
Raith,5110,10,9,10,17,32,49,-17,37
Hibernian,5111,1,21,11,4,60,25,35,74
Dundee Utd,5111,2,17,11,8,53,35,18,62
Morton,5111,3,17,11,8,49,34,15,62
Falkirk,5111,4,13,12,11,55,45,10,51
Raith,5111,5,12,10,14,36,45,-9,46
Dunfermline,5111,6,10,15,11,45,44,1,45
Queen of S't,5111,7,9,11,16,41,51,-10,38
Dumbarton,5111,8,8,13,15,47,61,-14,37
Ayr,5111,9,7,13,16,32,55,-23,34
St Mirren,5111,10,8,9,19,40,63,-23,33
Morton,5112,1,20,10,6,61,34,27,70
Hibernian,5112,2,19,11,6,53,29,24,68
Falkirk,5112,3,18,9,9,64,40,24,63
Dundee Utd,5112,4,17,9,10,60,42,18,60
Queen of S't,5112,5,11,11,14,49,55,-6,44
Raith,5112,6,11,8,17,36,49,-13,41
Dunfermline,5112,7,9,12,15,42,51,-9,39
Dumbarton,5112,8,9,11,16,48,66,-18,38
St Mirren,5112,9,9,9,18,36,52,-16,36
Ayr,5112,10,6,12,18,32,63,-31,30
Hibernian,5113,1,19,14,3,63,30,33,71
Dundee Utd,5113,2,17,8,11,49,41,8,59
Falkirk,5113,3,16,10,10,59,43,16,58
Morton,5113,4,15,12,9,50,39,11,57
Queen of S't,5113,5,12,9,15,46,48,-2,45
Dunfermline,5113,6,9,15,12,44,49,-5,42
Ayr,5113,7,10,12,14,38,53,-15,42
Raith,5113,8,8,14,14,32,46,-14,38
Dumbarton,5113,9,8,12,16,45,61,-16,36
St Mirren,5113,10,7,12,17,40,56,-16,33
Hibernian,5114,1,18,12,6,54,29,25,66
Morton,5114,2,16,13,7,51,38,13,61
Falkirk,5114,3,15,13,8,62,39,23,58
Dundee Utd,5114,4,16,10,10,50,40,10,58
Raith,5114,5,11,10,15,38,48,-10,43
St Mirren,5114,6,11,9,16,43,55,-12,42
Queen of S't,5114,7,11,8,17,45,57,-12,41
Dumbarton,5114,8,9,12,15,48,60,-12,39
Ayr,5114,9,9,12,15,38,55,-17,39
Dunfermline,5114,10,8,13,15,43,51,-8,37
Hibernian,5115,1,17,12,7,49,26,23,63
Dundee Utd,5115,2,18,9,9,52,37,15,63
Falkirk,5115,3,17,10,9,58,39,19,61
Morton,5115,4,16,12,8,48,34,14,60
Dumbarton,5115,5,12,10,14,49,55,-6,46
Ayr,5115,6,11,10,15,37,52,-15,43
Raith,5115,7,11,8,17,33,45,-12,41
Dunfermline,5115,8,9,13,14,42,48,-6,40
Queen of S't,5115,9,10,9,17,41,55,-14,39
St Mirren,5115,10,8,9,19,36,54,-18,33
Hibernian,5116,1,20,11,5,57,23,34,71
Dundee Utd,5116,2,17,10,9,57,41,16,61
Morton,5116,3,17,10,9,54,43,11,61
Falkirk,5116,4,16,12,8,62,42,20,60
Queen of S't,5116,5,12,11,13,48,49,-1,47
Dunfermline,5116,6,9,14,13,48,49,-1,41
Raith,5116,7,10,9,17,34,54,-20,39
Dumbarton,5116,8,9,11,16,51,62,-11,38
Ayr,5116,9,8,12,16,31,55,-24,36
St Mirren,5116,10,7,10,19,38,62,-24,31
Hibernian,5117,1,20,12,4,55,23,32,72
Morton,5117,2,17,11,8,50,38,12,62
Falkirk,5117,3,15,13,8,57,39,18,58
Dundee Utd,5117,4,16,10,10,50,40,10,58
Queen of S't,5117,5,12,10,14,49,50,-1,46
Raith,5117,6,11,10,15,36,45,-9,43
Dunfermline,5117,7,10,12,14,47,51,-4,42
Ayr,5117,8,9,10,17,34,57,-23,37
Dumbarton,5117,9,8,12,16,44,56,-12,36
St Mirren,5117,10,6,12,18,36,59,-23,30
Morton,5118,1,18,12,6,53,38,15,66
Hibernian,5118,2,17,14,5,51,25,26,65
Falkirk,5118,3,15,13,8,57,41,16,58
Dundee Utd,5118,4,15,10,11,46,39,7,55
Queen of S't,5118,5,11,11,14,41,46,-5,44
Dunfermline,5118,6,10,12,14,49,47,2,42
Raith,5118,7,10,11,15,33,47,-14,41
Ayr,5118,8,10,10,16,36,55,-19,40
Dumbarton,5118,9,8,12,16,45,59,-14,36
St Mirren,5118,10,8,11,17,39,53,-14,35
Hibernian,5119,1,19,13,4,53,22,31,70
Falkirk,5119,2,16,11,9,61,40,21,59
Morton,5119,3,14,13,9,44,36,8,55
Dundee Utd,5119,4,14,11,11,48,47,1,53
Raith,5119,5,11,11,14,41,50,-9,44
Queen of S't,5119,6,11,10,15,43,50,-7,43
Dunfermline,5119,7,9,15,12,50,52,-2,42
St Mirren,5119,8,10,10,16,42,56,-14,40
Ayr,5119,9,9,11,16,34,53,-19,38
Dumbarton,5119,10,8,13,15,45,55,-10,37
Hibernian,5120,1,19,13,4,57,28,29,70
Dundee Utd,5120,2,16,10,10,51,40,11,58
Falkirk,5120,3,15,12,9,57,40,17,57
Morton,5120,4,14,10,12,46,44,2,52
Dunfermline,5120,5,11,13,12,49,47,2,46
Dumbarton,5120,6,11,11,14,48,55,-7,44
Queen of S't,5120,7,11,10,15,43,50,-7,43
Raith,5120,8,11,10,15,37,49,-12,43
St Mirren,5120,9,9,11,16,42,54,-12,38
Ayr,5120,10,7,12,17,33,56,-23,33
Hibernian,5121,1,18,13,5,52,27,25,67
Falkirk,5121,2,18,11,7,61,38,23,65
Dundee Utd,5121,3,16,11,9,56,41,15,59
Morton,5121,4,16,10,10,48,40,8,58
Dunfermline,5121,5,11,14,11,51,45,6,47
Queen of S't,5121,6,11,9,16,45,53,-8,42
Raith,5121,7,10,9,17,37,50,-13,39
Dumbarton,5121,8,9,11,16,51,64,-13,38
Ayr,5121,9,9,10,17,37,61,-24,37
St Mirren,5121,10,8,10,18,39,58,-19,34
Hibernian,5122,1,19,12,5,54,30,24,69
Falkirk,5122,2,17,11,8,54,35,19,62
Morton,5122,3,16,13,7,49,35,14,61
Dundee Utd,5122,4,15,11,10,47,37,10,56
Queen of S't,5122,5,12,10,14,48,47,1,46
Dunfermline,5122,6,10,13,13,48,52,-4,43
Dumbarton,5122,7,9,12,15,50,60,-10,39
Raith,5122,8,9,10,17,33,49,-16,37
Ayr,5122,9,7,15,14,34,54,-20,36
St Mirren,5122,10,8,9,19,38,56,-18,33
Morton,5123,1,18,12,6,50,32,18,66
Hibernian,5123,2,18,10,8,53,27,26,64
Falkirk,5123,3,18,9,9,58,39,19,63
Dundee Utd,5123,4,15,9,12,47,39,8,54
Queen of S't,5123,5,12,9,15,42,47,-5,45
Ayr,5123,6,11,11,14,39,51,-12,44
Dunfermline,5123,7,9,15,12,47,47,0,42
Raith,5123,8,10,9,17,34,48,-14,39
St Mirren,5123,9,9,9,18,40,62,-22,36
Dumbarton,5123,10,8,11,17,46,64,-18,35
Hibernian,5124,1,18,11,7,54,29,25,65
Falkirk,5124,2,16,13,7,58,37,21,61
Morton,5124,3,16,12,8,47,34,13,60
Dundee Utd,5124,4,16,10,10,57,40,17,58
Dunfermline,5124,5,9,14,13,40,47,-7,41
Queen of S't,5124,6,10,11,15,41,52,-11,41
Ayr,5124,7,10,11,15,35,54,-19,41
St Mirren,5124,8,9,13,14,44,53,-9,40
Raith,5124,9,10,10,16,33,47,-14,40
Dumbarton,5124,10,7,13,16,45,61,-16,34
Hibernian,5125,1,20,12,4,63,29,34,72
Morton,5125,2,17,11,8,59,37,22,62
Dundee Utd,5125,3,16,9,11,52,42,10,57
Falkirk,5125,4,14,12,10,58,47,11,54
Dunfermline,5125,5,11,14,11,54,49,5,47
Ayr,5125,6,11,11,14,40,53,-13,44
Queen of S't,5125,7,11,10,15,45,53,-8,43
Dumbarton,5125,8,9,11,16,47,61,-14,38
Raith,5125,9,9,9,18,33,60,-27,36
St Mirren,5125,10,7,11,18,38,58,-20,32
Hibernian,5126,1,19,13,4,61,29,32,70
Morton,5126,2,16,11,9,49,41,8,59
Falkirk,5126,3,15,12,9,56,40,16,57
Dundee Utd,5126,4,15,11,10,49,40,9,56
Queen of S't,5126,5,12,11,13,45,47,-2,47
Dumbarton,5126,6,11,10,15,46,52,-6,43
St Mirren,5126,7,10,11,15,40,52,-12,41
Dunfermline,5126,8,9,12,15,44,47,-3,39
Raith,5126,9,10,9,17,31,47,-16,39
Ayr,5126,10,8,10,18,32,58,-26,34
Hibernian,5127,1,17,12,7,48,26,22,63
Falkirk,5127,2,17,10,9,60,38,22,61
Morton,5127,3,15,14,7,52,38,14,59
Dundee Utd,5127,4,14,11,11,46,40,6,53
Dumbarton,5127,5,11,11,14,51,58,-7,44
Queen of S't,5127,6,11,10,15,44,51,-7,43
Raith,5127,7,11,10,15,38,48,-10,43
Dunfermline,5127,8,9,14,13,43,49,-6,41
Ayr,5127,9,9,14,13,38,54,-16,41
St Mirren,5127,10,7,12,17,42,60,-18,33
Hibernian,5128,1,19,11,6,58,28,30,68
Dundee Utd,5128,2,18,10,8,53,35,18,64
Falkirk,5128,3,17,11,8,66,39,27,62
Morton,5128,4,16,14,6,51,37,14,62
Queen of S't,5128,5,10,12,14,40,46,-6,42
Raith,5128,6,10,11,15,35,49,-14,41
Dunfermline,5128,7,9,13,14,44,49,-5,40
Ayr,5128,8,8,14,14,35,52,-17,38
Dumbarton,5128,9,7,13,16,48,67,-19,34
St Mirren,5128,10,6,11,19,37,65,-28,29
Hibernian,5129,1,17,14,5,51,28,23,65
Falkirk,5129,2,17,10,9,63,37,26,61
Dundee Utd,5129,3,15,12,9,54,41,13,57
Morton,5129,4,14,13,9,51,46,5,55
Queen of S't,5129,5,11,11,14,44,50,-6,44
Dunfermline,5129,6,10,12,14,49,53,-4,42
Dumbarton,5129,7,10,11,15,49,56,-7,41
Ayr,5129,8,9,13,14,38,57,-19,40
Raith,5129,9,9,11,16,34,49,-15,38
St Mirren,5129,10,9,11,16,39,55,-16,38
Hibernian,5130,1,21,12,3,55,23,32,75
Falkirk,5130,2,18,10,8,69,40,29,64
Morton,5130,3,16,12,8,50,37,13,60
Dundee Utd,5130,4,16,9,11,52,38,14,57
Queen of S't,5130,5,11,11,14,45,52,-7,44
Raith,5130,6,10,11,15,37,48,-11,41
Dumbarton,5130,7,9,12,15,49,64,-15,39
Dunfermline,5130,8,8,12,16,42,53,-11,36
St Mirren,5130,9,8,11,17,35,52,-17,35
Ayr,5130,10,7,12,17,33,60,-27,33
Hibernian,5131,1,20,11,5,60,25,35,71
Morton,5131,2,16,12,8,44,36,8,60
Falkirk,5131,3,16,10,10,58,43,15,58
Dundee Utd,5131,4,16,10,10,51,38,13,58
Dunfermline,5131,5,11,14,11,44,43,1,47
Raith,5131,6,10,11,15,36,48,-12,41
Ayr,5131,7,9,12,15,37,55,-18,39
Queen of S't,5131,8,9,11,16,42,53,-11,38
St Mirren,5131,9,9,10,17,42,58,-16,37
Dumbarton,5131,10,7,13,16,45,60,-15,34
Hibernian,5132,1,19,12,5,53,26,27,69
Morton,5132,2,15,14,7,49,38,11,59
Falkirk,5132,3,16,10,10,56,39,17,58
Dundee Utd,5132,4,15,11,10,48,38,10,56
Dunfermline,5132,5,12,13,11,52,43,9,49
Queen of S't,5132,6,12,9,15,49,54,-5,45
Dumbarton,5132,7,9,12,15,48,61,-13,39
St Mirren,5132,8,8,13,15,39,50,-11,37
Raith,5132,9,8,11,17,32,53,-21,35
Ayr,5132,10,7,13,16,32,56,-24,34
Hibernian,5133,1,18,14,4,57,28,29,68
Morton,5133,2,19,10,7,55,35,20,67
Falkirk,5133,3,15,12,9,55,45,10,57
Dundee Utd,5133,4,15,11,10,53,39,14,56
Queen of S't,5133,5,12,10,14,44,49,-5,46
Dunfermline,5133,6,9,14,13,48,52,-4,41
Dumbarton,5133,7,9,13,14,50,58,-8,40
Raith,5133,8,9,11,16,38,52,-14,38
Ayr,5133,9,6,16,14,32,53,-21,34
St Mirren,5133,10,7,11,18,36,57,-21,32
Hibernian,5134,1,22,10,4,70,30,40,76
Falkirk,5134,2,17,10,9,63,44,19,61
Morton,5134,3,16,12,8,50,36,14,60
Dundee Utd,5134,4,16,9,11,45,38,7,57
Dunfermline,5134,5,11,13,12,47,49,-2,46
Queen of S't,5134,6,11,10,15,47,52,-5,43
Raith,5134,7,10,9,17,36,51,-15,39
Dumbarton,5134,8,9,10,17,47,60,-13,37
Ayr,5134,9,8,12,16,33,57,-24,36
St Mirren,5134,10,7,11,18,42,63,-21,32
Hibernian,5135,1,20,12,4,65,27,38,72
Dundee Utd,5135,2,17,10,9,52,39,13,61
Falkirk,5135,3,16,9,11,58,41,17,57
Morton,5135,4,15,12,9,49,40,9,57
Dunfermline,5135,5,10,15,11,48,45,3,45
Queen of S't,5135,6,11,9,16,48,53,-5,42
Ayr,5135,7,10,11,15,37,54,-17,41
Raith,5135,8,10,9,17,38,57,-19,39
St Mirren,5135,9,9,9,18,37,56,-19,36
Dumbarton,5135,10,8,12,16,43,63,-20,36
Hibernian,5136,1,19,11,6,57,27,30,68
Dundee Utd,5136,2,17,10,9,55,38,17,61
Falkirk,5136,3,15,10,11,57,42,15,55
Dunfermline,5136,4,13,11,12,48,48,0,50
Morton,5136,5,13,11,12,45,45,0,50
Queen of S't,5136,6,12,9,15,47,54,-7,45
Ayr,5136,7,10,12,14,35,50,-15,42
Raith,5136,8,11,8,17,35,48,-13,41
Dumbarton,5136,9,10,10,16,49,61,-12,40
St Mirren,5136,10,9,10,17,40,55,-15,37
Hibernian,5137,1,17,15,4,53,25,28,66
Morton,5137,2,17,12,7,54,38,16,63
Falkirk,5137,3,17,10,9,58,38,20,61
Dundee Utd,5137,4,17,9,10,51,36,15,60
Queen of S't,5137,5,13,10,13,47,49,-2,49
Raith,5137,6,10,11,15,36,50,-14,41
Dumbarton,5137,7,9,12,15,50,63,-13,39
Dunfermline,5137,8,8,14,14,48,53,-5,38
St Mirren,5137,9,9,10,17,46,58,-12,37
Ayr,5137,10,6,11,19,33,66,-33,29
Hibernian,5138,1,21,11,4,59,28,31,74
Dundee Utd,5138,2,16,12,8,51,38,13,60
Morton,5138,3,16,12,8,51,40,11,60
Falkirk,5138,4,14,13,9,52,36,16,55
Dumbarton,5138,5,12,10,14,51,54,-3,46
Raith,5138,6,10,11,15,38,48,-10,41
Queen of S't,5138,7,9,13,14,40,47,-7,40
Dunfermline,5138,8,8,14,14,45,52,-7,38
St Mirren,5138,9,8,12,16,37,52,-15,36
Ayr,5138,10,6,12,18,28,57,-29,30
Morton,5139,1,19,11,6,54,32,22,68
Hibernian,5139,2,18,11,7,57,30,27,65
Falkirk,5139,3,17,9,10,62,42,20,60
Dundee Utd,5139,4,15,11,10,47,37,10,56
Raith,5139,5,12,9,15,38,48,-10,45
Dunfermline,5139,6,9,13,14,43,50,-7,40
Queen of S't,5139,7,9,13,14,45,54,-9,40
Ayr,5139,8,9,12,15,35,56,-21,39
Dumbarton,5139,9,9,10,17,45,58,-13,37
St Mirren,5139,10,9,9,18,42,61,-19,36
Hibernian,5140,1,17,15,4,59,29,30,66
Falkirk,5140,2,17,10,9,63,44,19,61
Dundee Utd,5140,3,17,10,9,51,38,13,61
Morton,5140,4,15,12,9,51,38,13,57
Dunfermline,5140,5,11,14,11,49,45,4,47
St Mirren,5140,6,10,11,15,41,53,-12,41
Queen of S't,5140,7,10,10,16,46,52,-6,40
Raith,5140,8,10,9,17,35,53,-18,39
Dumbarton,5140,9,9,10,17,48,66,-18,37
Ayr,5140,10,8,11,17,34,59,-25,35
Hibernian,5141,1,21,11,4,54,24,30,74
Morton,5141,2,16,13,7,49,35,14,61
Falkirk,5141,3,16,11,9,59,39,20,59
Dundee Utd,5141,4,16,10,10,54,42,12,58
Queen of S't,5141,5,12,10,14,47,48,-1,46
Dunfermline,5141,6,9,15,12,47,47,0,42
Raith,5141,7,10,12,14,38,48,-10,42
Dumbarton,5141,8,8,12,16,45,62,-17,36
St Mirren,5141,9,7,11,18,34,58,-24,32
Ayr,5141,10,6,13,17,32,56,-24,31
Hibernian,5142,1,18,14,4,58,29,29,68
Morton,5142,2,19,9,8,52,39,13,66
Falkirk,5142,3,16,11,9,56,37,19,59
Dundee Utd,5142,4,16,10,10,51,37,14,58
Dunfermline,5142,5,11,13,12,51,49,2,46
Queen of S't,5142,6,11,8,17,43,53,-10,41
Raith,5142,7,10,10,16,38,52,-14,40
Dumbarton,5142,8,9,10,17,48,64,-16,37
Ayr,5142,9,8,12,16,29,49,-20,36
St Mirren,5142,10,8,11,17,41,58,-17,35
Hibernian,5143,1,21,11,4,58,25,33,74
Morton,5143,2,17,11,8,53,39,14,62
Falkirk,5143,3,16,10,10,60,42,18,58
Dundee Utd,5143,4,16,10,10,52,40,12,58
Queen of S't,5143,5,12,9,15,45,53,-8,45
Dumbarton,5143,6,10,12,14,50,56,-6,42
Dunfermline,5143,7,9,14,13,48,52,-4,41
Raith,5143,8,10,8,18,33,52,-19,38
Ayr,5143,9,8,12,16,35,54,-19,36
St Mirren,5143,10,8,9,19,42,63,-21,33
Hibernian,5144,1,20,10,6,59,29,30,70
Morton,5144,2,19,10,7,52,36,16,67
Dundee Utd,5144,3,17,8,11,59,45,14,59
Falkirk,5144,4,15,12,9,60,44,16,57
Dunfermline,5144,5,10,12,14,51,54,-3,42
Queen of S't,5144,6,10,11,15,42,52,-10,41
St Mirren,5144,7,9,12,15,39,51,-12,39
Raith,5144,8,10,9,17,33,49,-16,39
Dumbarton,5144,9,8,12,16,48,61,-13,36
Ayr,5144,10,8,12,16,36,58,-22,36
Hibernian,5145,1,19,14,3,57,25,32,71
Dundee Utd,5145,2,16,10,10,52,36,16,58
Morton,5145,3,15,13,8,46,36,10,58
Falkirk,5145,4,15,11,10,60,41,19,56
Raith,5145,5,12,10,14,35,43,-8,46
Dunfermline,5145,6,10,14,12,44,46,-2,44
Queen of S't,5145,7,11,10,15,43,51,-8,43
Dumbarton,5145,8,8,12,16,45,58,-13,36
St Mirren,5145,9,8,11,17,35,55,-20,35
Ayr,5145,10,7,13,16,35,61,-26,34
Hibernian,5146,1,21,11,4,56,28,28,74
Falkirk,5146,2,16,13,7,62,38,24,61
Morton,5146,3,15,11,10,46,40,6,56
Dundee Utd,5146,4,12,12,12,44,43,1,48
Dunfermline,5146,5,11,13,12,51,49,2,46
Ayr,5146,6,10,13,13,37,52,-15,43
Queen of S't,5146,7,11,9,16,44,53,-9,42
Dumbarton,5146,8,10,11,15,46,53,-7,41
Raith,5146,9,9,11,16,35,49,-14,38
St Mirren,5146,10,7,12,17,43,59,-16,33
Hibernian,5147,1,19,13,4,55,26,29,70
Morton,5147,2,18,12,6,53,36,17,66
Falkirk,5147,3,17,10,9,62,38,24,61
Dundee Utd,5147,4,17,9,10,57,40,17,60
Queen of S't,5147,5,12,8,16,46,55,-9,44
Dumbarton,5147,6,9,12,15,49,62,-13,39
Dunfermline,5147,7,8,13,15,43,51,-8,37
St Mirren,5147,8,9,10,17,40,56,-16,37
Raith,5147,9,9,10,17,34,54,-20,37
Ayr,5147,10,8,11,17,35,56,-21,35
Hibernian,5148,1,20,10,6,59,26,33,70
Morton,5148,2,17,12,7,52,38,14,63
Dundee Utd,5148,3,15,12,9,51,40,11,57
Falkirk,5148,4,15,10,11,53,44,9,55
Queen of S't,5148,5,12,11,13,46,48,-2,47
Dunfermline,5148,6,11,13,12,49,46,3,46
Dumbarton,5148,7,8,14,14,48,58,-10,38
Ayr,5148,8,8,14,14,36,55,-19,38
Raith,5148,9,9,10,17,39,59,-20,37
St Mirren,5148,10,7,10,19,39,58,-19,31
Hibernian,5149,1,19,12,5,57,27,30,69
Morton,5149,2,17,11,8,51,36,15,62
Falkirk,5149,3,16,10,10,59,42,17,58
Dundee Utd,5149,4,15,10,11,47,43,4,55
Dunfermline,5149,5,10,13,13,43,46,-3,43
Queen of S't,5149,6,10,11,15,45,52,-7,41
Raith,5149,7,10,11,15,34,46,-12,41
Ayr,5149,8,9,13,14,35,55,-20,40
Dumbarton,5149,9,8,14,14,46,56,-10,38
St Mirren,5149,10,8,11,17,44,58,-14,35
Hibernian,5150,1,20,12,4,55,25,30,72
Morton,5150,2,16,11,9,42,35,7,59
Falkirk,5150,3,15,13,8,57,40,17,58
Dundee Utd,5150,4,15,11,10,46,37,9,56
Queen of S't,5150,5,11,10,15,43,50,-7,43
Dunfermline,5150,6,9,15,12,44,43,1,42
Raith,5150,7,10,9,17,35,50,-15,39
St Mirren,5150,8,9,11,16,41,56,-15,38
Dumbarton,5150,9,8,13,15,48,55,-7,37
Ayr,5150,10,8,13,15,34,54,-20,37
Hibernian,5151,1,18,12,6,51,25,26,66
Morton,5151,2,17,12,7,52,35,17,63
Falkirk,5151,3,16,11,9,61,36,25,59
Dundee Utd,5151,4,16,11,9,52,38,14,59
Queen of S't,5151,5,12,10,14,47,55,-8,46
Raith,5151,6,12,10,14,38,47,-9,46
Dunfermline,5151,7,8,13,15,43,52,-9,37
St Mirren,5151,8,9,9,18,37,56,-19,36
Dumbarton,5151,9,7,14,15,43,58,-15,35
Ayr,5151,10,7,14,15,32,54,-22,35
Hibernian,5152,1,20,11,5,57,25,32,71
Dundee Utd,5152,2,18,8,10,54,37,17,62
Morton,5152,3,17,11,8,53,41,12,62
Falkirk,5152,4,16,9,11,58,44,14,57
Queen of S't,5152,5,11,11,14,46,52,-6,44
St Mirren,5152,6,9,11,16,40,53,-13,38
Raith,5152,7,9,11,16,34,51,-17,38
Ayr,5152,8,9,11,16,35,54,-19,38
Dunfermline,5152,9,7,16,13,42,48,-6,37
Dumbarton,5152,10,8,13,15,43,57,-14,37
Hibernian,5153,1,20,11,5,63,30,33,71
Morton,5153,2,16,12,8,47,38,9,60
Dundee Utd,5153,3,16,9,11,54,40,14,57
Falkirk,5153,4,15,11,10,60,45,15,56
Queen of S't,5153,5,12,11,13,52,51,1,47
Ayr,5153,6,10,12,14,39,54,-15,42
Dumbarton,5153,7,9,11,16,48,60,-12,38
St Mirren,5153,8,9,11,16,40,53,-13,38
Raith,5153,9,9,11,16,35,49,-14,38
Dunfermline,5153,10,8,13,15,44,62,-18,37
Hibernian,5154,1,19,11,6,56,28,28,68
Morton,5154,2,18,11,7,53,34,19,65
Falkirk,5154,3,18,9,9,63,41,22,63
Dundee Utd,5154,4,15,10,11,47,40,7,55
Dunfermline,5154,5,11,12,13,43,46,-3,45
Ayr,5154,6,10,12,14,36,55,-19,42
Dumbarton,5154,7,9,12,15,49,59,-10,39
Queen of S't,5154,8,10,8,18,42,55,-13,38
St Mirren,5154,9,9,10,17,39,54,-15,37
Raith,5154,10,9,9,18,33,49,-16,36
Hibernian,5155,1,18,14,4,54,25,29,68
Dundee Utd,5155,2,17,8,11,51,40,11,59
Morton,5155,3,15,13,8,51,36,15,58
Falkirk,5155,4,14,13,9,51,38,13,55
Queen of S't,5155,5,12,9,15,44,50,-6,45
Dunfermline,5155,6,10,14,12,47,49,-2,44
St Mirren,5155,7,10,10,16,43,52,-9,40
Raith,5155,8,9,13,14,35,47,-12,40
Dumbarton,5155,9,9,11,16,46,59,-13,38
Ayr,5155,10,7,13,16,30,56,-26,34
Dundee Utd,5156,1,19,9,8,56,36,20,66
Hibernian,5156,2,16,13,7,51,29,22,61
Morton,5156,3,16,11,9,48,39,9,59
Falkirk,5156,4,15,11,10,56,42,14,56
Dunfermline,5156,5,10,14,12,51,51,0,44
Dumbarton,5156,6,11,11,14,49,53,-4,44
Raith,5156,7,11,11,14,34,43,-9,44
Queen of S't,5156,8,10,10,16,45,55,-10,40
St Mirren,5156,9,9,10,17,41,57,-16,37
Ayr,5156,10,6,14,16,33,59,-26,32
Hibernian,5157,1,18,13,5,54,26,28,67
Morton,5157,2,18,12,6,51,30,21,66
Dundee Utd,5157,3,16,10,10,47,37,10,58
Falkirk,5157,4,15,12,9,57,40,17,57
Dumbarton,5157,5,12,10,14,52,54,-2,46
Queen of S't,5157,6,11,12,13,45,48,-3,45
Raith,5157,7,9,11,16,33,47,-14,38
Dunfermline,5157,8,8,12,16,43,55,-12,36
St Mirren,5157,9,9,9,18,40,60,-20,36
Ayr,5157,10,7,13,16,30,55,-25,34
Morton,5158,1,20,10,6,50,29,21,70
Hibernian,5158,2,17,13,6,49,28,21,64
Dundee Utd,5158,3,16,9,11,50,43,7,57
Falkirk,5158,4,13,13,10,54,42,12,52
Queen of S't,5158,5,14,9,13,48,47,1,51
Dunfermline,5158,6,11,12,13,46,46,0,45
St Mirren,5158,7,10,10,16,41,51,-10,40
Ayr,5158,8,8,14,14,34,49,-15,38
Raith,5158,9,9,8,19,33,55,-22,35
Dumbarton,5158,10,7,12,17,44,59,-15,33
Hibernian,5159,1,19,13,4,56,25,31,70
Morton,5159,2,17,12,7,58,40,18,63
Falkirk,5159,3,17,10,9,62,45,17,61
Dundee Utd,5159,4,16,10,10,51,41,10,58
Queen of S't,5159,5,12,10,14,41,45,-4,46
Dunfermline,5159,6,10,12,14,46,52,-6,42
Raith,5159,7,10,9,17,37,50,-13,39
Dumbarton,5159,8,8,13,15,48,60,-12,37
Ayr,5159,9,8,12,16,34,54,-20,36
St Mirren,5159,10,8,9,19,41,62,-21,33
Hibernian,5160,1,20,11,5,57,27,30,71
Morton,5160,2,17,10,9,51,36,15,61
Falkirk,5160,3,16,10,10,57,47,10,58
Dundee Utd,5160,4,13,12,11,49,48,1,51
Queen of S't,5160,5,12,10,14,45,49,-4,46
Dunfermline,5160,6,11,12,13,51,47,4,45
Dumbarton,5160,7,11,11,14,52,54,-2,44
St Mirren,5160,8,9,10,17,41,54,-13,37
Raith,5160,9,9,10,17,30,49,-19,37
Ayr,5160,10,8,12,16,35,57,-22,36
Hibernian,5161,1,18,13,5,54,27,27,67
Morton,5161,2,18,11,7,55,36,19,65
Falkirk,5161,3,15,12,9,60,40,20,57
Dundee Utd,5161,4,15,12,9,53,39,14,57
Ayr,5161,5,10,12,14,35,52,-17,42
Raith,5161,6,11,8,17,36,51,-15,41
Dunfermline,5161,7,9,13,14,44,49,-5,40
Queen of S't,5161,8,10,10,16,42,55,-13,40
St Mirren,5161,9,10,10,16,41,54,-13,40
Dumbarton,5161,10,7,13,16,43,60,-17,34
Hibernian,5162,1,19,12,5,55,27,28,69
Morton,5162,2,18,13,5,55,35,20,67
Dundee Utd,5162,3,16,9,11,49,38,11,57
Falkirk,5162,4,15,11,10,54,39,15,56
Raith,5162,5,11,11,14,35,45,-10,44
Queen of S't,5162,6,11,9,16,44,52,-8,42
St Mirren,5162,7,9,12,15,43,53,-10,39
Dunfermline,5162,8,8,14,14,42,50,-8,38
Dumbarton,5162,9,8,12,16,46,61,-15,36
Ayr,5162,10,7,13,16,36,59,-23,34
Dundee Utd,5163,1,19,9,8,61,35,26,66
Hibernian,5163,2,18,12,6,59,33,26,66
Morton,5163,3,15,12,9,52,43,9,57
Falkirk,5163,4,15,11,10,57,42,15,56
Queen of S't,5163,5,10,13,13,45,51,-6,43
Dunfermline,5163,6,9,15,12,46,53,-7,42
Ayr,5163,7,9,13,14,36,52,-16,40
Raith,5163,8,9,11,16,36,53,-17,38
Dumbarton,5163,9,8,13,15,46,60,-14,37
St Mirren,5163,10,9,9,18,40,56,-16,36
Hibernian,5164,1,19,11,6,57,28,29,68
Morton,5164,2,19,9,8,54,36,18,66
Dundee Utd,5164,3,16,9,11,50,42,8,57
Falkirk,5164,4,15,9,12,54,41,13,54
Queen of S't,5164,5,13,9,14,46,47,-1,48
St Mirren,5164,6,11,9,16,42,51,-9,42
Ayr,5164,7,10,12,14,35,53,-18,42
Dunfermline,5164,8,10,11,15,44,53,-9,41
Dumbarton,5164,9,9,11,16,49,61,-12,38
Raith,5164,10,9,8,19,34,53,-19,35
Hibernian,5165,1,19,12,5,60,27,33,69
Morton,5165,2,18,9,9,56,42,14,63
Falkirk,5165,3,17,9,10,59,41,18,60
Dundee Utd,5165,4,15,10,11,51,45,6,55
Ayr,5165,5,13,10,13,43,49,-6,49
Dunfermline,5165,6,11,13,12,51,53,-2,46
Raith,5165,7,11,8,17,34,49,-15,41
Queen of S't,5165,8,10,10,16,42,53,-11,40
Dumbarton,5165,9,9,10,17,47,61,-14,37
St Mirren,5165,10,7,9,20,38,61,-23,30
Hibernian,5166,1,18,13,5,50,25,25,67
Morton,5166,2,19,10,7,55,37,18,67
Falkirk,5166,3,16,11,9,61,40,21,59
Dundee Utd,5166,4,17,8,11,54,45,9,59
Queen of S't,5166,5,11,13,12,46,45,1,46
Dunfermline,5166,6,9,14,13,45,50,-5,41
Raith,5166,7,9,13,14,35,47,-12,40
Ayr,5166,8,9,11,16,36,55,-19,38
St Mirren,5166,9,8,10,18,40,57,-17,34
Dumbarton,5166,10,7,11,18,43,64,-21,32
Morton,5167,1,18,10,8,53,36,17,64
Hibernian,5167,2,16,11,9,51,31,20,59
Falkirk,5167,3,16,9,11,57,46,11,57
Dundee Utd,5167,4,16,9,11,50,39,11,57
Dunfermline,5167,5,12,12,12,53,50,3,48
Queen of S't,5167,6,13,9,14,49,50,-1,48
Ayr,5167,7,10,11,15,32,52,-20,41
Raith,5167,8,10,10,16,35,50,-15,40
Dumbarton,5167,9,9,11,16,47,57,-10,38
St Mirren,5167,10,8,12,16,39,55,-16,36
Morton,5168,1,18,12,6,52,36,16,66
Hibernian,5168,2,16,15,5,51,26,25,63
Dundee Utd,5168,3,18,9,9,59,41,18,63
Falkirk,5168,4,15,11,10,57,43,14,56
Queen of S't,5168,5,11,10,15,46,53,-7,43
Raith,5168,6,10,12,14,35,46,-11,42
Dunfermline,5168,7,8,16,12,46,49,-3,40
Dumbarton,5168,8,9,13,14,50,56,-6,40
St Mirren,5168,9,7,12,17,35,54,-19,33
Ayr,5168,10,7,12,17,30,57,-27,33
Hibernian,5169,1,20,11,5,56,26,30,71
Morton,5169,2,18,10,8,50,40,10,64
Dundee Utd,5169,3,16,8,12,50,39,11,56
Falkirk,5169,4,15,10,11,60,42,18,55
Queen of S't,5169,5,13,9,14,47,52,-5,48
Dunfermline,5169,6,11,12,13,49,45,4,45
Dumbarton,5169,7,10,11,15,51,58,-7,41
St Mirren,5169,8,9,10,17,41,57,-16,37
Ayr,5169,9,8,13,15,33,53,-20,37
Raith,5169,10,9,8,19,35,60,-25,35
Hibernian,5170,1,17,12,7,50,28,22,63
Falkirk,5170,2,18,9,9,57,37,20,63
Morton,5170,3,16,12,8,51,36,15,60
Dundee Utd,5170,4,14,9,13,51,44,7,51
Dumbarton,5170,5,12,11,13,50,54,-4,47
Queen of S't,5170,6,12,9,15,45,52,-7,45
Dunfermline,5170,7,10,14,12,43,44,-1,44
Raith,5170,8,11,10,15,37,49,-12,43
St Mirren,5170,9,8,12,16,41,60,-19,36
Ayr,5170,10,8,10,18,34,55,-21,34
Hibernian,5171,1,19,13,4,57,26,31,70
Dundee Utd,5171,2,17,10,9,59,41,18,61
Morton,5171,3,16,12,8,48,37,11,60
Falkirk,5171,4,16,10,10,59,46,13,58
Raith,5171,5,12,9,15,36,45,-9,45
Queen of S't,5171,6,11,9,16,44,50,-6,42
Dunfermline,5171,7,9,12,15,44,53,-9,39
Dumbarton,5171,8,9,11,16,47,63,-16,38
Ayr,5171,9,9,11,16,37,57,-20,38
St Mirren,5171,10,9,9,18,42,55,-13,36
Hibernian,5172,1,19,13,4,58,25,33,70
Dundee Utd,5172,2,17,9,10,53,42,11,60
Morton,5172,3,15,9,12,46,41,5,54
Falkirk,5172,4,14,11,11,55,44,11,53
Dunfermline,5172,5,14,11,11,55,48,7,53
Raith,5172,6,12,9,15,35,46,-11,45
Queen of S't,5172,7,11,10,15,49,54,-5,43
Dumbarton,5172,8,9,11,16,48,64,-16,38
St Mirren,5172,9,9,10,17,40,56,-16,37
Ayr,5172,10,8,11,17,36,55,-19,35
Hibernian,5173,1,20,12,4,55,25,30,72
Morton,5173,2,18,10,8,54,38,16,64
Dundee Utd,5173,3,18,9,9,56,40,16,63
Falkirk,5173,4,14,12,10,54,41,13,54
Dunfermline,5173,5,11,12,13,50,50,0,45
Raith,5173,6,11,10,15,37,46,-9,43
Queen of S't,5173,7,10,12,14,44,50,-6,42
Dumbarton,5173,8,8,12,16,51,65,-14,36
Ayr,5173,9,7,14,15,35,56,-21,35
St Mirren,5173,10,7,9,20,38,63,-25,30
Hibernian,5174,1,19,10,7,55,29,26,67
Morton,5174,2,18,11,7,51,32,19,65
Falkirk,5174,3,17,9,10,61,43,18,60
Dundee Utd,5174,4,16,12,8,53,37,16,60
Dunfermline,5174,5,11,13,12,45,44,1,46
Queen of S't,5174,6,11,11,14,44,49,-5,44
Raith,5174,7,10,10,16,35,49,-14,40
Dumbarton,5174,8,9,11,16,46,58,-12,38
St Mirren,5174,9,8,10,18,39,61,-22,34
Ayr,5174,10,6,13,17,33,60,-27,31
Hibernian,5175,1,18,12,6,56,29,27,66
Falkirk,5175,2,18,11,7,68,39,29,65
Morton,5175,3,16,11,9,52,43,9,59
Dundee Utd,5175,4,14,9,13,48,52,-4,51
Dunfermline,5175,5,10,14,12,48,46,2,44
Queen of S't,5175,6,12,8,16,46,56,-10,44
Raith,5175,7,11,10,15,41,51,-10,43
Ayr,5175,8,9,14,13,36,50,-14,41
Dumbarton,5175,9,9,12,15,53,62,-9,39
St Mirren,5175,10,7,11,18,38,58,-20,32
Hibernian,5176,1,19,13,4,54,27,27,70
Dundee Utd,5176,2,18,8,10,57,38,19,62
Morton,5176,3,16,14,6,48,32,16,62
Falkirk,5176,4,15,10,11,54,42,12,55
Dunfermline,5176,5,12,11,13,50,46,4,47
Queen of S't,5176,6,12,9,15,42,48,-6,45
Raith,5176,7,9,12,15,34,47,-13,39
Ayr,5176,8,8,14,14,33,50,-17,38
Dumbarton,5176,9,8,11,17,42,60,-18,35
St Mirren,5176,10,7,10,19,35,59,-24,31
Hibernian,5177,1,21,10,5,60,26,34,73
Falkirk,5177,2,16,10,10,60,44,16,58
Dundee Utd,5177,3,16,8,12,46,37,9,56
Morton,5177,4,14,11,11,50,44,6,53
Dunfermline,5177,5,12,13,11,50,49,1,49
Queen of S't,5177,6,12,9,15,48,51,-3,45
Raith,5177,7,12,9,15,40,50,-10,45
Ayr,5177,8,9,11,16,35,56,-21,38
Dumbarton,5177,9,9,10,17,47,61,-14,37
St Mirren,5177,10,8,11,17,40,58,-18,35
Hibernian,5178,1,21,10,5,57,26,31,73
Falkirk,5178,2,16,10,10,58,39,19,58
Morton,5178,3,15,13,8,52,39,13,58
Dundee Utd,5178,4,15,13,8,49,39,10,58
Queen of S't,5178,5,12,9,15,42,48,-6,45
Dunfermline,5178,6,9,12,15,45,51,-6,39
Dumbarton,5178,7,9,12,15,48,59,-11,39
Raith,5178,8,10,9,17,35,51,-16,39
Ayr,5178,9,8,14,14,33,54,-21,38
St Mirren,5178,10,9,10,17,43,56,-13,37
Hibernian,5179,1,19,13,4,55,27,28,70
Morton,5179,2,18,11,7,50,32,18,65
Dundee Utd,5179,3,17,9,10,53,39,14,60
Falkirk,5179,4,15,13,8,58,41,17,58
Dunfermline,5179,5,9,16,11,43,44,-1,43
Queen of S't,5179,6,10,10,16,47,58,-11,40
Dumbarton,5179,7,9,11,16,42,53,-11,38
Raith,5179,8,9,10,17,33,47,-14,37
Ayr,5179,9,9,10,17,34,56,-22,37
St Mirren,5179,10,8,11,17,35,53,-18,35
Hibernian,5180,1,19,11,6,60,29,31,68
Morton,5180,2,19,9,8,54,38,16,66
Dundee Utd,5180,3,17,9,10,51,35,16,60
Falkirk,5180,4,15,11,10,55,44,11,56
Dunfermline,5180,5,12,12,12,49,48,1,48
Queen of S't,5180,6,11,10,15,40,49,-9,43
Dumbarton,5180,7,10,11,15,49,54,-5,41
Raith,5180,8,10,8,18,36,55,-19,38
Ayr,5180,9,8,12,16,34,54,-20,36
St Mirren,5180,10,7,11,18,33,55,-22,32
Hibernian,5181,1,19,12,5,58,29,29,69
Morton,5181,2,19,9,8,50,37,13,66
Falkirk,5181,3,17,10,9,60,42,18,61
Dundee Utd,5181,4,16,10,10,55,45,10,58
Queen of S't,5181,5,12,8,16,49,54,-5,44
Dunfermline,5181,6,9,14,13,46,47,-1,41
St Mirren,5181,7,10,10,16,37,50,-13,40
Dumbarton,5181,8,9,10,17,47,61,-14,37
Raith,5181,9,9,10,17,33,47,-14,37
Ayr,5181,10,8,11,17,37,60,-23,35
Hibernian,5182,1,19,12,5,58,26,32,69
Morton,5182,2,17,13,6,53,35,18,64
Falkirk,5182,3,16,13,7,64,39,25,61
Dundee Utd,5182,4,17,9,10,54,38,16,60
Queen of S't,5182,5,13,9,14,51,60,-9,48
Dunfermline,5182,6,9,15,12,47,49,-2,42
Raith,5182,7,10,9,17,35,51,-16,39
Dumbarton,5182,8,8,13,15,47,60,-13,37
Ayr,5182,9,7,11,18,35,60,-25,32
St Mirren,5182,10,7,10,19,35,61,-26,31
Hibernian,5183,1,19,12,5,58,27,31,69
Morton,5183,2,18,10,8,54,39,15,64
Falkirk,5183,3,16,10,10,62,41,21,58
Dundee Utd,5183,4,14,12,10,50,43,7,54
Queen of S't,5183,5,11,11,14,46,53,-7,44
Dunfermline,5183,6,9,16,11,47,47,0,43
Raith,5183,7,10,10,16,34,51,-17,40
Dumbarton,5183,8,9,12,15,51,59,-8,39
Ayr,5183,9,9,12,15,38,56,-18,39
St Mirren,5183,10,8,9,19,40,64,-24,33
Hibernian,5184,1,21,10,5,53,23,30,73
Dundee Utd,5184,2,18,10,8,54,40,14,64
Morton,5184,3,17,11,8,52,33,19,62
Falkirk,5184,4,16,9,11,57,46,11,57
Queen of S't,5184,5,11,9,16,46,53,-7,42
Raith,5184,6,11,9,16,35,46,-11,42
Dunfermline,5184,7,9,14,13,44,46,-2,41
Dumbarton,5184,8,10,10,16,54,61,-7,40
Ayr,5184,9,8,11,17,34,60,-26,35
St Mirren,5184,10,8,9,19,40,61,-21,33
Morton,5185,1,20,11,5,60,38,22,71
Hibernian,5185,2,18,12,6,57,29,28,66
Dundee Utd,5185,3,16,9,11,51,39,12,57
Falkirk,5185,4,15,10,11,59,48,11,55
Queen of S't,5185,5,14,8,14,49,49,0,50
Raith,5185,6,11,10,15,34,45,-11,43
Dunfermline,5185,7,9,15,12,45,48,-3,42
Ayr,5185,8,8,11,17,34,54,-20,35
Dumbarton,5185,9,8,10,18,45,62,-17,34
St Mirren,5185,10,8,10,18,38,60,-22,34
Hibernian,5186,1,20,12,4,60,28,32,72
Dundee Utd,5186,2,17,9,10,51,38,13,60
Morton,5186,3,15,13,8,49,40,9,58
Falkirk,5186,4,15,12,9,56,38,18,57
Queen of S't,5186,5,12,10,14,46,52,-6,46
Ayr,5186,6,10,12,14,38,52,-14,42
Raith,5186,7,11,9,16,37,51,-14,42
Dumbarton,5186,8,9,11,16,48,60,-12,38
Dunfermline,5186,9,8,12,16,40,47,-7,36
St Mirren,5186,10,7,12,17,38,57,-19,33
Hibernian,5187,1,19,11,6,57,27,30,68
Morton,5187,2,18,12,6,49,31,18,66
Falkirk,5187,3,17,10,9,62,40,22,61
Dundee Utd,5187,4,13,10,13,46,46,0,49
Queen of S't,5187,5,11,10,15,44,54,-10,43
Dunfermline,5187,6,10,12,14,46,49,-3,42
St Mirren,5187,7,11,9,16,44,54,-10,42
Dumbarton,5187,8,9,13,14,51,61,-10,40
Raith,5187,9,10,9,17,32,52,-20,39
Ayr,5187,10,8,12,16,36,53,-17,36
Hibernian,5188,1,19,11,6,54,28,26,68
Falkirk,5188,2,16,11,9,64,45,19,59
Morton,5188,3,15,12,9,47,36,11,57
Dundee Utd,5188,4,14,11,11,49,44,5,53
Queen of S't,5188,5,12,10,14,47,47,0,46
Dunfermline,5188,6,11,12,13,48,50,-2,45
Raith,5188,7,10,10,16,35,51,-16,40
Ayr,5188,8,10,10,16,36,55,-19,40
St Mirren,5188,9,9,12,15,46,57,-11,39
Dumbarton,5188,10,8,13,15,48,61,-13,37
Hibernian,5189,1,18,13,5,56,28,28,67
Morton,5189,2,17,12,7,51,38,13,63
Falkirk,5189,3,16,11,9,57,38,19,59
Dundee Utd,5189,4,15,10,11,52,45,7,55
Dunfermline,5189,5,10,13,13,44,46,-2,43
Queen of S't,5189,6,10,12,14,43,48,-5,42
Dumbarton,5189,7,9,13,14,47,58,-11,40
Ayr,5189,8,8,15,13,35,51,-16,39
Raith,5189,9,9,11,16,32,47,-15,38
St Mirren,5189,10,7,12,17,41,59,-18,33
Morton,5190,1,19,9,8,49,36,13,66
Hibernian,5190,2,17,13,6,53,27,26,64
Falkirk,5190,3,17,11,8,59,35,24,62
Dundee Utd,5190,4,16,9,11,51,39,12,57
Queen of S't,5190,5,12,10,14,40,49,-9,46
Dunfermline,5190,6,10,12,14,47,49,-2,42
Dumbarton,5190,7,9,11,16,45,56,-11,38
Raith,5190,8,9,11,16,32,47,-15,38
Ayr,5190,9,8,13,15,35,56,-21,37
St Mirren,5190,10,8,11,17,40,57,-17,35
Hibernian,5191,1,19,12,5,54,29,25,69
Morton,5191,2,18,11,7,56,38,18,65
Falkirk,5191,3,17,9,10,60,40,20,60
Dundee Utd,5191,4,16,10,10,52,42,10,58
Dunfermline,5191,5,11,12,13,50,50,0,45
Raith,5191,6,11,8,17,41,50,-9,41
Queen of S't,5191,7,10,10,16,43,53,-10,40
Ayr,5191,8,9,12,15,39,55,-16,39
St Mirren,5191,9,9,9,18,40,62,-22,36
Dumbarton,5191,10,8,11,17,42,58,-16,35
Morton,5192,1,20,11,5,59,32,27,71
Hibernian,5192,2,18,11,7,54,29,25,65
Dundee Utd,5192,3,15,11,10,53,44,9,56
Falkirk,5192,4,13,14,9,52,39,13,53
Queen of S't,5192,5,11,12,13,44,50,-6,45
Dunfermline,5192,6,10,14,12,45,45,0,44
Ayr,5192,7,10,12,14,43,54,-11,42
Dumbarton,5192,8,8,12,16,50,67,-17,36
Raith,5192,9,8,11,17,33,51,-18,35
St Mirren,5192,10,7,12,17,35,57,-22,33
Hibernian,5193,1,20,11,5,55,29,26,71
Dundee Utd,5193,2,17,10,9,50,36,14,61
Morton,5193,3,16,11,9,48,39,9,59
Falkirk,5193,4,14,14,8,58,41,17,56
Raith,5193,5,11,10,15,40,51,-11,43
Dumbarton,5193,6,10,11,15,53,63,-10,41
Queen of S't,5193,7,9,12,15,40,48,-8,39
Dunfermline,5193,8,8,14,14,47,49,-2,38
St Mirren,5193,9,9,10,17,45,59,-14,37
Ayr,5193,10,8,13,15,36,57,-21,37
Morton,5194,1,19,10,7,52,35,17,67
Hibernian,5194,2,17,12,7,53,32,21,63
Falkirk,5194,3,16,11,9,60,43,17,59
Dundee Utd,5194,4,16,9,11,49,41,8,57
Queen of S't,5194,5,12,11,13,50,50,0,47
Dunfermline,5194,6,8,15,13,44,51,-7,39
Dumbarton,5194,7,9,12,15,47,57,-10,39
Ayr,5194,8,9,12,15,34,53,-19,39
Raith,5194,9,10,8,18,35,49,-14,38
St Mirren,5194,10,8,12,16,37,50,-13,36
Hibernian,5195,1,19,10,7,56,27,29,67
Falkirk,5195,2,17,11,8,59,36,23,62
Morton,5195,3,16,10,10,47,38,9,58
Dundee Utd,5195,4,15,12,9,49,39,10,57
Dunfermline,5195,5,12,13,11,47,44,3,49
Queen of S't,5195,6,11,10,15,42,51,-9,43
Dumbarton,5195,7,9,13,14,48,57,-9,40
Ayr,5195,8,9,11,16,39,58,-19,38
St Mirren,5195,9,9,9,18,40,56,-16,36
Raith,5195,10,9,9,18,34,55,-21,36
Hibernian,5196,1,21,11,4,59,23,36,74
Dundee Utd,5196,2,17,10,9,55,38,17,61
Falkirk,5196,3,15,11,10,62,45,17,56
Morton,5196,4,15,9,12,45,45,0,54
Dunfermline,5196,5,11,15,10,51,46,5,48
Queen of S't,5196,6,10,11,15,42,50,-8,41
Dumbarton,5196,7,9,13,14,49,59,-10,40
Raith,5196,8,9,10,17,34,53,-19,37
St Mirren,5196,9,9,10,17,45,65,-20,37
Ayr,5196,10,8,12,16,36,54,-18,36
Hibernian,5197,1,19,13,4,59,30,29,70
Morton,5197,2,17,11,8,54,39,15,62
Dundee Utd,5197,3,18,8,10,52,38,14,62
Falkirk,5197,4,14,11,11,57,44,13,53
Queen of S't,5197,5,11,12,13,48,51,-3,45
Dunfermline,5197,6,10,12,14,46,49,-3,42
St Mirren,5197,7,9,12,15,44,55,-11,39
Ayr,5197,8,9,12,15,34,55,-21,39
Raith,5197,9,9,10,17,39,58,-19,37
Dumbarton,5197,10,8,11,17,44,58,-14,35
Hibernian,5198,1,21,12,3,60,24,36,75
Falkirk,5198,2,16,10,10,60,46,14,58
Dundee Utd,5198,3,15,12,9,52,37,15,57
Morton,5198,4,14,14,8,50,40,10,56
Queen of S't,5198,5,14,8,14,50,49,1,50
Dunfermline,5198,6,9,13,14,46,53,-7,40
Dumbarton,5198,7,8,13,15,49,64,-15,37
Raith,5198,8,9,10,17,36,55,-19,37
St Mirren,5198,9,8,12,16,44,58,-14,36
Ayr,5198,10,7,14,15,30,51,-21,35
Hibernian,5199,1,20,12,4,54,24,30,72
Falkirk,5199,2,17,9,10,58,42,16,60
Dundee Utd,5199,3,16,11,9,51,38,13,59
Morton,5199,4,15,12,9,51,42,9,57
Queen of S't,5199,5,12,9,15,46,48,-2,45
Raith,5199,6,12,9,15,36,48,-12,45
Dunfermline,5199,7,9,13,14,46,49,-3,40
St Mirren,5199,8,8,12,16,41,53,-12,36
Ayr,5199,9,8,12,16,33,56,-23,36
Dumbarton,5199,10,7,13,16,48,64,-16,34
Hibernian,5200,1,21,12,3,55,23,32,75
Falkirk,5200,2,16,12,8,60,38,22,60
Morton,5200,3,16,11,9,49,37,12,59
Dundee Utd,5200,4,16,9,11,55,42,13,57
Dunfermline,5200,5,11,12,13,49,47,2,45
Queen of S't,5200,6,12,9,15,49,53,-4,45
Ayr,5200,7,10,10,16,36,56,-20,40
Raith,5200,8,10,8,18,34,52,-18,38
Dumbarton,5200,9,8,12,16,49,66,-17,36
St Mirren,5200,10,8,9,19,37,59,-22,33
Hibernian,5201,1,19,13,4,56,25,31,70
Morton,5201,2,17,12,7,55,40,15,63
Dundee Utd,5201,3,15,9,12,54,47,7,54
Falkirk,5201,4,14,11,11,55,40,15,53
Queen of S't,5201,5,13,10,13,49,50,-1,49
Dunfermline,5201,6,11,12,13,49,50,-1,45
Ayr,5201,7,10,12,14,39,56,-17,42
Dumbarton,5201,8,9,11,16,47,60,-13,38
Raith,5201,9,9,11,16,38,53,-15,38
St Mirren,5201,10,7,11,18,38,59,-21,32
Hibernian,5202,1,20,13,3,56,23,33,73
Falkirk,5202,2,18,10,8,64,40,24,64
Dundee Utd,5202,3,17,10,9,54,35,19,61
Morton,5202,4,15,12,9,49,41,8,57
Dunfermline,5202,5,10,11,15,51,54,-3,41
Queen of S't,5202,6,11,8,17,44,56,-12,41
St Mirren,5202,7,10,9,17,39,58,-19,39
Ayr,5202,8,9,11,16,35,52,-17,38
Dumbarton,5202,9,9,10,17,49,63,-14,37
Raith,5202,10,9,10,17,33,52,-19,37
Hibernian,5203,1,21,11,4,59,24,35,74
Morton,5203,2,19,11,6,50,30,20,68
Dundee Utd,5203,3,16,12,8,56,38,18,60
Falkirk,5203,4,16,10,10,59,46,13,58
Queen of S't,5203,5,12,11,13,43,46,-3,47
Dumbarton,5203,6,10,12,14,51,56,-5,42
Raith,5203,7,9,9,18,36,52,-16,36
Dunfermline,5203,8,8,11,17,41,54,-13,35
St Mirren,5203,9,7,12,17,41,59,-18,33
Ayr,5203,10,7,11,18,31,62,-31,32
Hibernian,5204,1,20,13,3,58,24,34,73
Dundee Utd,5204,2,17,9,10,51,38,13,60
Morton,5204,3,16,10,10,52,40,12,58
Falkirk,5204,4,15,12,9,58,39,19,57
Dunfermline,5204,5,11,13,12,48,49,-1,46
Queen of S't,5204,6,11,11,14,50,53,-3,44
Raith,5204,7,11,9,16,38,48,-10,42
Ayr,5204,8,10,11,15,35,54,-19,41
St Mirren,5204,9,8,10,18,38,62,-24,34
Dumbarton,5204,10,7,10,19,45,66,-21,31
Hibernian,5205,1,19,11,6,55,28,27,68
Morton,5205,2,18,12,6,57,38,19,66
Dundee Utd,5205,3,18,10,8,52,34,18,64
Falkirk,5205,4,15,9,12,56,43,13,54
Queen of S't,5205,5,12,9,15,46,53,-7,45
Dunfermline,5205,6,11,11,14,44,47,-3,44
Raith,5205,7,10,9,17,34,49,-15,39
Dumbarton,5205,8,8,13,15,51,61,-10,37
Ayr,5205,9,8,13,15,34,54,-20,37
St Mirren,5205,10,7,11,18,37,59,-22,32
Hibernian,5206,1,19,11,6,52,26,26,68
Dundee Utd,5206,2,16,12,8,52,36,16,60
Morton,5206,3,16,12,8,50,36,14,60
Falkirk,5206,4,16,10,10,55,40,15,58
Dunfermline,5206,5,10,13,13,43,44,-1,43
St Mirren,5206,6,11,10,15,44,50,-6,43
Raith,5206,7,11,8,17,36,50,-14,41
Queen of S't,5206,8,11,8,17,41,57,-16,41
Dumbarton,5206,9,9,10,17,45,57,-12,37
Ayr,5206,10,8,12,16,36,58,-22,36
Hibernian,5207,1,20,11,5,56,27,29,71
Falkirk,5207,2,17,10,9,58,43,15,61
Morton,5207,3,17,10,9,53,38,15,61
Dundee Utd,5207,4,17,9,10,53,37,16,60
Queen of S't,5207,5,15,8,13,51,44,7,53
Ayr,5207,6,11,10,15,41,58,-17,43
Dunfermline,5207,7,10,12,14,46,52,-6,42
Raith,5207,8,9,9,18,35,54,-19,36
Dumbarton,5207,9,8,11,17,45,62,-17,35
St Mirren,5207,10,6,10,20,36,59,-23,28
Hibernian,5208,1,19,12,5,52,24,28,69
Falkirk,5208,2,18,11,7,61,35,26,65
Dundee Utd,5208,3,17,9,10,60,41,19,60
Morton,5208,4,15,11,10,50,41,9,56
St Mirren,5208,5,11,11,14,46,52,-6,44
Queen of S't,5208,6,12,8,16,45,55,-10,44
Dunfermline,5208,7,9,13,14,43,47,-4,40
Raith,5208,8,10,10,16,33,48,-15,40
Dumbarton,5208,9,9,11,16,50,66,-16,38
Ayr,5208,10,6,12,18,30,61,-31,30
Hibernian,5209,1,18,12,6,53,29,24,66
Falkirk,5209,2,16,9,11,62,46,16,57
Morton,5209,3,15,10,11,51,45,6,55
Dundee Utd,5209,4,14,10,12,49,46,3,52
Dunfermline,5209,5,11,13,12,47,46,1,46
Queen of S't,5209,6,12,9,15,47,52,-5,45
Dumbarton,5209,7,10,12,14,48,56,-8,42
St Mirren,5209,8,10,12,14,44,52,-8,42
Ayr,5209,9,10,12,14,40,52,-12,42
Raith,5209,10,9,11,16,33,50,-17,38
Hibernian,5210,1,19,12,5,55,25,30,69
Falkirk,5210,2,19,10,7,61,36,25,67
Morton,5210,3,17,12,7,48,33,15,63
Dundee Utd,5210,4,15,9,12,47,43,4,54
Queen of S't,5210,5,12,10,14,44,50,-6,46
Dunfermline,5210,6,10,12,14,45,47,-2,42
Raith,5210,7,10,10,16,38,50,-12,40
Dumbarton,5210,8,9,12,15,47,56,-9,39
St Mirren,5210,9,7,12,17,38,55,-17,33
Ayr,5210,10,7,11,18,31,59,-28,32
Hibernian,5211,1,19,13,4,57,24,33,70
Morton,5211,2,17,12,7,53,37,16,63
Dundee Utd,5211,3,16,11,9,55,39,16,59
Falkirk,5211,4,16,10,10,58,39,19,58
Dumbarton,5211,5,11,10,15,50,61,-11,43
Queen of S't,5211,6,10,12,14,45,52,-7,42
St Mirren,5211,7,10,11,15,45,52,-7,41
Raith,5211,8,9,10,17,34,53,-19,37
Dunfermline,5211,9,7,14,15,41,57,-16,35
Ayr,5211,10,7,13,16,32,56,-24,34
Hibernian,5212,1,17,13,6,55,30,25,64
Falkirk,5212,2,18,9,9,66,42,24,63
Dundee Utd,5212,3,17,10,9,50,35,15,61
Morton,5212,4,16,11,9,49,39,10,59
Dunfermline,5212,5,11,13,12,46,46,0,46
Queen of S't,5212,6,12,9,15,47,55,-8,45
Raith,5212,7,11,10,15,42,52,-10,43
Ayr,5212,8,9,10,17,34,59,-25,37
Dumbarton,5212,9,8,12,16,46,60,-14,36
St Mirren,5212,10,7,11,18,44,61,-17,32
Hibernian,5213,1,22,10,4,62,26,36,76
Morton,5213,2,17,11,8,49,37,12,62
Falkirk,5213,3,15,11,10,54,41,13,56
Dundee Utd,5213,4,14,13,9,47,39,8,55
Raith,5213,5,12,10,14,37,45,-8,46
Dunfermline,5213,6,9,15,12,45,47,-2,42
Queen of S't,5213,7,10,11,15,42,52,-10,41
Dumbarton,5213,8,8,13,15,48,58,-10,37
St Mirren,5213,9,8,11,17,38,54,-16,35
Ayr,5213,10,7,11,18,35,58,-23,32
Hibernian,5214,1,19,12,5,58,28,30,69
Dundee Utd,5214,2,18,10,8,59,42,17,64
Falkirk,5214,3,16,12,8,62,42,20,60
Morton,5214,4,16,11,9,52,41,11,59
Dunfermline,5214,5,12,13,11,47,46,1,49
Queen of S't,5214,6,11,11,14,45,51,-6,44
Raith,5214,7,9,12,15,36,48,-12,39
Dumbarton,5214,8,7,12,17,45,60,-15,33
Ayr,5214,9,7,12,17,35,62,-27,33
St Mirren,5214,10,7,11,18,38,57,-19,32
Hibernian,5215,1,20,12,4,60,26,34,72
Morton,5215,2,18,12,6,59,36,23,66
Falkirk,5215,3,15,10,11,56,45,11,55
Dundee Utd,5215,4,15,9,12,47,45,2,54
Dunfermline,5215,5,11,11,14,44,50,-6,44
Queen of S't,5215,6,11,10,15,47,49,-2,43
St Mirren,5215,7,9,13,14,43,51,-8,40
Dumbarton,5215,8,9,12,15,48,61,-13,39
Raith,5215,9,10,8,18,33,51,-18,38
Ayr,5215,10,7,13,16,35,58,-23,34
Hibernian,5216,1,19,14,3,54,23,31,71
Morton,5216,2,17,12,7,48,34,14,63
Dundee Utd,5216,3,14,11,11,51,44,7,53
Falkirk,5216,4,13,11,12,54,46,8,50
Queen of S't,5216,5,11,12,13,44,48,-4,45
St Mirren,5216,6,10,11,15,44,52,-8,41
Raith,5216,7,10,11,15,34,48,-14,41
Dunfermline,5216,8,9,13,14,45,48,-3,40
Ayr,5216,9,9,13,14,39,54,-15,40
Dumbarton,5216,10,8,12,16,44,60,-16,36
Hibernian,5217,1,19,12,5,56,31,25,69
Morton,5217,2,19,11,6,55,35,20,68
Falkirk,5217,3,15,11,10,52,39,13,56
Dundee Utd,5217,4,15,11,10,52,44,8,56
Queen of S't,5217,5,12,9,15,47,50,-3,45
Raith,5217,6,10,11,15,36,46,-10,41
Ayr,5217,7,9,13,14,37,54,-17,40
Dumbarton,5217,8,9,11,16,45,52,-7,38
Dunfermline,5217,9,8,12,16,40,50,-10,36
St Mirren,5217,10,7,13,16,38,57,-19,34
Hibernian,5218,1,19,13,4,58,24,34,70
Morton,5218,2,17,11,8,47,33,14,62
Falkirk,5218,3,16,11,9,59,42,17,59
Dundee Utd,5218,4,16,8,12,50,41,9,56
Queen of S't,5218,5,12,11,13,45,47,-2,47
Dunfermline,5218,6,10,13,13,44,47,-3,43
Raith,5218,7,10,9,17,32,49,-17,39
St Mirren,5218,8,9,11,16,41,57,-16,38
Dumbarton,5218,9,8,12,16,43,58,-15,36
Ayr,5218,10,8,11,17,37,58,-21,35
Hibernian,5219,1,21,12,3,54,21,33,75
Morton,5219,2,17,11,8,50,35,15,62
Falkirk,5219,3,16,12,8,65,42,23,60
Dundee Utd,5219,4,14,11,11,51,42,9,53
Queen of S't,5219,5,12,8,16,42,53,-11,44
Raith,5219,6,10,11,15,39,50,-11,41
Ayr,5219,7,9,13,14,36,55,-19,40
Dumbarton,5219,8,9,11,16,47,57,-10,38
Dunfermline,5219,9,7,15,14,43,54,-11,36
St Mirren,5219,10,7,12,17,38,56,-18,33
Hibernian,5220,1,20,13,3,58,24,34,73
Morton,5220,2,18,9,9,53,35,18,63
Dundee Utd,5220,3,16,8,12,49,40,9,56
Falkirk,5220,4,15,9,12,58,42,16,54
Queen of S't,5220,5,14,9,13,47,46,1,51
Raith,5220,6,11,9,16,38,52,-14,42
Dunfermline,5220,7,10,11,15,44,52,-8,41
St Mirren,5220,8,10,10,16,39,54,-15,40
Dumbarton,5220,9,9,10,17,45,60,-15,37
Ayr,5220,10,7,12,17,30,56,-26,33
Hibernian,5221,1,18,11,7,55,29,26,65
Morton,5221,2,17,10,9,48,39,9,61
Falkirk,5221,3,15,10,11,63,47,16,55
Dundee Utd,5221,4,14,11,11,45,38,7,53
Dunfermline,5221,5,11,15,10,49,44,5,48
St Mirren,5221,6,11,10,15,42,50,-8,43
Queen of S't,5221,7,11,9,16,47,56,-9,42
Dumbarton,5221,8,10,11,15,45,56,-11,41
Raith,5221,9,10,10,16,37,51,-14,40
Ayr,5221,10,9,11,16,37,58,-21,38
Hibernian,5222,1,20,13,3,52,21,31,73
Morton,5222,2,17,12,7,48,35,13,63
Falkirk,5222,3,16,11,9,59,37,22,59
Dundee Utd,5222,4,16,10,10,49,39,10,58
Queen of S't,5222,5,12,10,14,44,49,-5,46
Dunfermline,5222,6,9,14,13,45,50,-5,41
Dumbarton,5222,7,9,12,15,46,56,-10,39
St Mirren,5222,8,9,11,16,41,54,-13,38
Ayr,5222,9,8,10,18,30,54,-24,34
Raith,5222,10,8,9,19,34,53,-19,33
Hibernian,5223,1,19,12,5,51,23,28,69
Morton,5223,2,16,12,8,48,34,14,60
Dundee Utd,5223,3,16,10,10,51,43,8,58
Falkirk,5223,4,15,11,10,62,47,15,56
Queen of S't,5223,5,15,9,12,50,47,3,54
Dunfermline,5223,6,10,13,13,48,47,1,43
Dumbarton,5223,7,8,13,15,49,61,-12,37
Ayr,5223,8,8,12,16,35,58,-23,36
Raith,5223,9,9,9,18,32,55,-23,36
St Mirren,5223,10,8,11,17,47,58,-11,35
Hibernian,5224,1,20,13,3,62,29,33,73
Morton,5224,2,18,11,7,61,38,23,65
Dundee Utd,5224,3,15,10,11,45,41,4,55
Falkirk,5224,4,13,13,10,55,42,13,52
Dunfermline,5224,5,10,15,11,46,45,1,45
Queen of S't,5224,6,11,9,16,47,53,-6,42
Ayr,5224,7,9,13,14,38,55,-17,40
Dumbarton,5224,8,8,13,15,49,62,-13,37
St Mirren,5224,9,9,10,17,42,59,-17,37
Raith,5224,10,9,9,18,33,54,-21,36
Hibernian,5225,1,18,12,6,53,26,27,66
Dundee Utd,5225,2,18,8,10,55,35,20,62
Morton,5225,3,15,12,9,48,40,8,57
Falkirk,5225,4,15,10,11,54,45,9,55
Raith,5225,5,13,9,14,44,51,-7,48
Dunfermline,5225,6,11,13,12,46,47,-1,46
Queen of S't,5225,7,12,9,15,44,49,-5,45
Dumbarton,5225,8,10,12,14,49,53,-4,42
St Mirren,5225,9,8,10,18,37,56,-19,34
Ayr,5225,10,7,11,18,31,59,-28,32
Falkirk,5226,1,18,10,8,60,37,23,64
Hibernian,5226,2,17,12,7,52,29,23,63
Morton,5226,3,16,14,6,47,32,15,62
Dundee Utd,5226,4,15,12,9,51,38,13,57
Queen of S't,5226,5,11,11,14,44,51,-7,44
Ayr,5226,6,11,10,15,35,53,-18,43
Dumbarton,5226,7,8,15,13,46,54,-8,39
Dunfermline,5226,8,8,13,15,41,51,-10,37
Raith,5226,9,9,10,17,35,51,-16,37
St Mirren,5226,10,7,13,16,37,52,-15,34
Hibernian,5227,1,20,10,6,59,30,29,70
Falkirk,5227,2,20,9,7,65,41,24,69
Morton,5227,3,18,10,8,56,38,18,64
Dundee Utd,5227,4,17,10,9,51,38,13,61
Queen of S't,5227,5,11,9,16,49,56,-7,42
Dunfermline,5227,6,10,11,15,44,51,-7,41
Ayr,5227,7,8,13,15,34,52,-18,37
Raith,5227,8,9,9,18,33,53,-20,36
Dumbarton,5227,9,7,13,16,46,61,-15,34
St Mirren,5227,10,7,12,17,42,59,-17,33
Hibernian,5228,1,19,11,6,54,23,31,68
Morton,5228,2,18,9,9,57,38,19,63
Falkirk,5228,3,15,10,11,54,41,13,55
Dundee Utd,5228,4,15,8,13,48,45,3,53
Dunfermline,5228,5,11,13,12,47,47,0,46
Raith,5228,6,12,9,15,40,51,-11,45
Ayr,5228,7,11,10,15,38,53,-15,43
Queen of S't,5228,8,10,10,16,42,55,-13,40
Dumbarton,5228,9,9,12,15,48,58,-10,39
St Mirren,5228,10,9,10,17,36,53,-17,37
Hibernian,5229,1,18,14,4,52,24,28,68
Morton,5229,2,18,12,6,52,32,20,66
Falkirk,5229,3,16,12,8,60,40,20,60
Dundee Utd,5229,4,14,11,11,45,41,4,53
Queen of S't,5229,5,11,11,14,41,46,-5,44
Raith,5229,6,10,11,15,37,51,-14,41
Ayr,5229,7,10,11,15,36,51,-15,41
Dunfermline,5229,8,7,16,13,45,52,-7,37
Dumbarton,5229,9,8,12,16,47,60,-13,36
St Mirren,5229,10,8,10,18,40,58,-18,34
Hibernian,5230,1,18,13,5,54,27,27,67
Falkirk,5230,2,17,11,8,57,37,20,62
Dundee Utd,5230,3,17,10,9,54,40,14,61
Morton,5230,4,14,11,11,45,39,6,53
Queen of S't,5230,5,12,11,13,47,50,-3,47
Dumbarton,5230,6,10,12,14,49,56,-7,42
Raith,5230,7,11,9,16,38,54,-16,42
Dunfermline,5230,8,10,11,15,48,48,0,41
Ayr,5230,9,8,12,16,35,56,-21,36
St Mirren,5230,10,7,12,17,36,56,-20,33
Hibernian,5231,1,20,12,4,61,26,35,72
Morton,5231,2,16,12,8,51,39,12,60
Falkirk,5231,3,16,11,9,57,39,18,59
Dundee Utd,5231,4,17,8,11,51,40,11,59
Queen of S't,5231,5,11,10,15,41,48,-7,43
Dunfermline,5231,6,10,11,15,48,52,-4,41
Dumbarton,5231,7,10,11,15,48,57,-9,41
Raith,5231,8,10,8,18,32,52,-20,38
St Mirren,5231,9,9,10,17,42,58,-16,37
Ayr,5231,10,8,13,15,32,52,-20,37
Hibernian,5232,1,20,12,4,57,26,31,72
Falkirk,5232,2,17,12,7,63,40,23,63
Morton,5232,3,17,10,9,52,35,17,61
Dundee Utd,5232,4,16,10,10,54,44,10,58
Queen of S't,5232,5,13,9,14,44,49,-5,48
Dumbarton,5232,6,10,11,15,56,56,0,41
Dunfermline,5232,7,8,13,15,42,57,-15,37
Raith,5232,8,9,9,18,30,48,-18,36
St Mirren,5232,9,8,11,17,40,58,-18,35
Ayr,5232,10,7,13,16,35,60,-25,34
Hibernian,5233,1,20,12,4,57,24,33,72
Morton,5233,2,18,10,8,59,38,21,64
Falkirk,5233,3,17,10,9,61,38,23,61
Dundee Utd,5233,4,15,10,11,54,49,5,55
Queen of S't,5233,5,11,9,16,43,52,-9,42
Dunfermline,5233,6,9,14,13,44,48,-4,41
Raith,5233,7,9,12,15,36,54,-18,39
Ayr,5233,8,9,12,15,36,55,-19,39
St Mirren,5233,9,9,10,17,44,62,-18,37
Dumbarton,5233,10,8,11,17,45,59,-14,35
Hibernian,5234,1,19,12,5,55,29,26,69
Morton,5234,2,18,12,6,58,37,21,66
Falkirk,5234,3,17,11,8,61,39,22,62
Dundee Utd,5234,4,15,10,11,51,42,9,55
Queen of S't,5234,5,13,9,14,43,50,-7,48
Dunfermline,5234,6,10,13,13,49,50,-1,43
St Mirren,5234,7,9,10,17,40,53,-13,37
Raith,5234,8,9,10,17,34,49,-15,37
Dumbarton,5234,9,7,13,16,43,59,-16,34
Ayr,5234,10,7,12,17,36,62,-26,33
Hibernian,5235,1,20,12,4,57,25,32,72
Morton,5235,2,19,10,7,59,36,23,67
Falkirk,5235,3,16,10,10,58,41,17,58
Dundee Utd,5235,4,16,10,10,56,46,10,58
Queen of S't,5235,5,11,10,15,45,49,-4,43
St Mirren,5235,6,11,10,15,43,53,-10,43
Raith,5235,7,10,9,17,32,50,-18,39
Dunfermline,5235,8,8,13,15,40,51,-11,37
Dumbarton,5235,9,8,12,16,48,61,-13,36
Ayr,5235,10,6,14,16,32,58,-26,32
Hibernian,5236,1,20,12,4,58,28,30,72
Dundee Utd,5236,2,18,8,10,52,37,15,62
Morton,5236,3,17,9,10,53,45,8,60
Falkirk,5236,4,15,9,12,60,42,18,54
Dunfermline,5236,5,12,12,12,52,47,5,48
Queen of S't,5236,6,12,9,15,47,54,-7,45
St Mirren,5236,7,11,9,16,44,50,-6,42
Dumbarton,5236,8,9,10,17,45,66,-21,37
Ayr,5236,9,8,12,16,31,52,-21,36
Raith,5236,10,9,8,19,34,55,-21,35
Hibernian,5237,1,21,12,3,58,24,34,75
Morton,5237,2,18,11,7,52,32,20,65
Falkirk,5237,3,17,10,9,57,40,17,61
Dundee Utd,5237,4,14,9,13,50,47,3,51
Queen of S't,5237,5,12,12,12,50,48,2,48
Dunfermline,5237,6,10,12,14,47,48,-1,42
St Mirren,5237,7,9,11,16,42,54,-12,38
Ayr,5237,8,9,10,17,38,64,-26,37
Dumbarton,5237,9,8,11,17,44,62,-18,35
Raith,5237,10,9,8,19,35,54,-19,35
Hibernian,5238,1,21,12,3,58,24,34,75
Dundee Utd,5238,2,18,10,8,57,34,23,64
Morton,5238,3,16,13,7,53,36,17,61
Falkirk,5238,4,15,10,11,56,43,13,55
Queen of S't,5238,5,12,11,13,45,48,-3,47
Dumbarton,5238,6,10,10,16,46,58,-12,40
Raith,5238,7,10,9,17,34,50,-16,39
Dunfermline,5238,8,8,14,14,42,48,-6,38
St Mirren,5238,9,8,10,18,39,61,-22,34
Ayr,5238,10,7,11,18,28,56,-28,32
Hibernian,5239,1,22,11,3,59,26,33,77
Dundee Utd,5239,2,17,10,9,51,38,13,61
Morton,5239,3,16,11,9,46,35,11,59
Falkirk,5239,4,16,10,10,53,39,14,58
Queen of S't,5239,5,13,9,14,50,52,-2,48
Raith,5239,6,11,10,15,35,45,-10,43
Dumbarton,5239,7,9,12,15,44,53,-9,39
Dunfermline,5239,8,8,13,15,42,50,-8,37
Ayr,5239,9,7,13,16,33,55,-22,34
St Mirren,5239,10,7,9,20,39,59,-20,30
Hibernian,5240,1,18,13,5,56,29,27,67
Falkirk,5240,2,16,12,8,60,38,22,60
Morton,5240,3,15,14,7,52,41,11,59
Dundee Utd,5240,4,14,10,12,47,41,6,52
Queen of S't,5240,5,14,9,13,45,46,-1,51
Dunfermline,5240,6,10,14,12,47,46,1,44
Dumbarton,5240,7,9,11,16,47,62,-15,38
Raith,5240,8,9,11,16,36,53,-17,38
Ayr,5240,9,9,10,17,33,56,-23,37
St Mirren,5240,10,8,12,16,44,55,-11,36
Hibernian,5241,1,19,11,6,52,28,24,68
Morton,5241,2,19,10,7,55,34,21,67
Dundee Utd,5241,3,18,9,9,55,40,15,63
Falkirk,5241,4,17,11,8,57,36,21,62
Dunfermline,5241,5,10,12,14,45,50,-5,42
Queen of S't,5241,6,10,11,15,44,50,-6,41
Ayr,5241,7,10,11,15,37,53,-16,41
Dumbarton,5241,8,9,12,15,47,57,-10,39
Raith,5241,9,8,10,18,32,54,-22,34
St Mirren,5241,10,6,11,19,34,56,-22,29
Hibernian,5242,1,18,12,6,53,28,25,66
Morton,5242,2,18,11,7,52,36,16,65
Falkirk,5242,3,17,10,9,62,39,23,61
Dundee Utd,5242,4,14,9,13,47,43,4,51
Queen of S't,5242,5,12,9,15,46,50,-4,45
Dumbarton,5242,6,11,10,15,48,57,-9,43
Raith,5242,7,10,11,15,35,47,-12,41
Dunfermline,5242,8,9,13,14,44,52,-8,40
Ayr,5242,9,10,10,16,39,53,-14,40
St Mirren,5242,10,8,11,17,38,59,-21,35
Hibernian,5243,1,22,10,4,61,26,35,76
Morton,5243,2,19,9,8,53,36,17,66
Dundee Utd,5243,3,17,8,11,47,39,8,59
Falkirk,5243,4,14,13,9,56,42,14,55
Dunfermline,5243,5,11,11,14,48,49,-1,44
Dumbarton,5243,6,10,11,15,48,55,-7,41
Queen of S't,5243,7,10,9,17,41,56,-15,39
Ayr,5243,8,9,11,16,36,54,-18,38
St Mirren,5243,9,9,10,17,43,56,-13,37
Raith,5243,10,8,10,18,33,53,-20,34
Hibernian,5244,1,20,12,4,60,25,35,72
Falkirk,5244,2,16,11,9,58,42,16,59
Morton,5244,3,16,11,9,48,37,11,59
Dundee Utd,5244,4,16,10,10,51,40,11,58
Queen of S't,5244,5,11,10,15,42,53,-11,43
Ayr,5244,6,10,11,15,37,53,-16,41
Dunfermline,5244,7,9,13,14,45,51,-6,40
Dumbarton,5244,8,9,13,14,45,56,-11,40
Raith,5244,9,9,10,17,35,49,-14,37
St Mirren,5244,10,9,9,18,40,55,-15,36
Morton,5245,1,20,11,5,60,34,26,71
Hibernian,5245,2,19,13,4,63,25,38,70
Falkirk,5245,3,15,12,9,58,39,19,57
Dundee Utd,5245,4,15,11,10,48,37,11,56
Raith,5245,5,12,9,15,39,46,-7,45
Queen of S't,5245,6,10,12,14,41,51,-10,42
Dunfermline,5245,7,9,13,14,43,53,-10,40
Dumbarton,5245,8,8,13,15,47,57,-10,37
Ayr,5245,9,8,11,17,28,57,-29,35
St Mirren,5245,10,7,9,20,34,62,-28,30
Hibernian,5246,1,19,12,5,67,32,35,69
Falkirk,5246,2,17,11,8,61,39,22,62
Dundee Utd,5246,3,17,10,9,57,36,21,61
Morton,5246,4,16,13,7,49,35,14,61
Dunfermline,5246,5,10,15,11,44,42,2,45
Raith,5246,6,11,9,16,35,52,-17,42
Queen of S't,5246,7,10,10,16,45,55,-10,40
Dumbarton,5246,8,8,12,16,48,64,-16,36
St Mirren,5246,9,8,10,18,45,66,-21,34
Ayr,5246,10,7,12,17,34,64,-30,33
Hibernian,5247,1,18,11,7,52,31,21,65
Morton,5247,2,17,10,9,50,39,11,61
Falkirk,5247,3,15,12,9,53,41,12,57
Dundee Utd,5247,4,15,11,10,51,39,12,56
Dunfermline,5247,5,11,12,13,53,47,6,45
Dumbarton,5247,6,10,13,13,50,56,-6,43
St Mirren,5247,7,11,10,15,41,49,-8,43
Ayr,5247,8,10,11,15,37,56,-19,41
Raith,5247,9,10,8,18,36,52,-16,38
Queen of S't,5247,10,9,10,17,46,59,-13,37
Hibernian,5248,1,18,14,4,59,28,31,68
Morton,5248,2,16,13,7,54,35,19,61
Dundee Utd,5248,3,16,10,10,55,46,9,58
Falkirk,5248,4,15,11,10,56,41,15,56
Dunfermline,5248,5,11,14,11,44,44,0,47
Raith,5248,6,11,10,15,34,47,-13,43
Ayr,5248,7,10,12,14,36,52,-16,42
Dumbarton,5248,8,8,14,14,45,54,-9,38
Queen of S't,5248,9,10,8,18,45,56,-11,38
St Mirren,5248,10,7,10,19,37,62,-25,31
Hibernian,5249,1,20,12,4,51,22,29,72
Dundee Utd,5249,2,17,9,10,54,40,14,60
Morton,5249,3,16,11,9,50,34,16,59
Falkirk,5249,4,15,10,11,56,45,11,55
Dunfermline,5249,5,10,14,12,47,47,0,44
Raith,5249,6,11,8,17,37,50,-13,41
Queen of S't,5249,7,10,10,16,44,52,-8,40
St Mirren,5249,8,10,9,17,39,52,-13,39
Dumbarton,5249,9,9,12,15,46,60,-14,39
Ayr,5249,10,9,11,16,32,54,-22,38
Hibernian,5250,1,19,14,3,56,26,30,71
Morton,5250,2,16,12,8,51,35,16,60
Dundee Utd,5250,3,16,9,11,47,40,7,57
Falkirk,5250,4,15,10,11,58,41,17,55
Queen of S't,5250,5,13,8,15,53,55,-2,47
Dunfermline,5250,6,10,15,11,47,49,-2,45
Dumbarton,5250,7,10,12,14,52,58,-6,42
St Mirren,5250,8,9,11,16,38,51,-13,38
Ayr,5250,9,8,11,17,33,57,-24,35
Raith,5250,10,8,10,18,31,54,-23,34
Hibernian,5251,1,17,13,6,53,31,22,64
Dundee Utd,5251,2,18,10,8,53,35,18,64
Falkirk,5251,3,17,11,8,62,39,23,62
Morton,5251,4,16,14,6,52,34,18,62
Queen of S't,5251,5,11,10,15,43,50,-7,43
Dumbarton,5251,6,10,12,14,49,57,-8,42
Ayr,5251,7,9,12,15,39,58,-19,39
Dunfermline,5251,8,9,11,16,41,54,-13,38
Raith,5251,9,8,11,17,32,49,-17,35
St Mirren,5251,10,7,12,17,39,56,-17,33
Hibernian,5252,1,20,13,3,62,26,36,73
Falkirk,5252,2,19,9,8,64,42,22,66
Morton,5252,3,17,9,10,47,38,9,60
Dundee Utd,5252,4,15,8,13,49,45,4,53
Queen of S't,5252,5,12,9,15,47,55,-8,45
Dunfermline,5252,6,10,12,14,44,47,-3,42
Ayr,5252,7,9,12,15,41,53,-12,39
Raith,5252,8,10,9,17,33,52,-19,39
St Mirren,5252,9,9,10,17,47,58,-11,37
Dumbarton,5252,10,8,11,17,47,65,-18,35
Hibernian,5253,1,21,11,4,59,25,34,74
Falkirk,5253,2,17,10,9,61,47,14,61
Morton,5253,3,14,15,7,48,36,12,57
Dundee Utd,5253,4,15,10,11,55,45,10,55
Queen of S't,5253,5,13,8,15,49,53,-4,47
Dunfermline,5253,6,11,13,12,48,48,0,46
St Mirren,5253,7,9,11,16,40,51,-11,38
Dumbarton,5253,8,8,12,16,49,61,-12,36
Ayr,5253,9,8,12,16,34,56,-22,36
Raith,5253,10,8,10,18,32,53,-21,34
Hibernian,5254,1,18,13,5,56,29,27,67
Falkirk,5254,2,17,12,7,60,38,22,63
Morton,5254,3,16,12,8,51,38,13,60
Dundee Utd,5254,4,16,10,10,51,40,11,58
Queen of S't,5254,5,12,9,15,46,51,-5,45
Dunfermline,5254,6,10,14,12,50,52,-2,44
Dumbarton,5254,7,9,12,15,45,54,-9,39
Raith,5254,8,10,9,17,32,47,-15,39
St Mirren,5254,9,9,9,18,35,54,-19,36
Ayr,5254,10,7,12,17,32,55,-23,33
Hibernian,5255,1,19,13,4,54,24,30,70
Morton,5255,2,15,11,10,46,40,6,56
Falkirk,5255,3,14,13,9,56,41,15,55
Dundee Utd,5255,4,14,12,10,45,37,8,54
Queen of S't,5255,5,13,10,13,47,45,2,49
Dumbarton,5255,6,11,11,14,51,55,-4,44
Raith,5255,7,10,10,16,35,50,-15,40
St Mirren,5255,8,9,12,15,41,54,-13,39
Dunfermline,5255,9,8,14,14,41,49,-8,38
Ayr,5255,10,8,12,16,33,54,-21,36
Dundee Utd,5256,1,19,9,8,58,39,19,66
Hibernian,5256,2,18,10,8,52,28,24,64
Morton,5256,3,17,11,8,49,35,14,62
Falkirk,5256,4,16,10,10,58,42,16,58
Queen of S't,5256,5,13,8,15,48,50,-2,47
Dunfermline,5256,6,11,11,14,47,53,-6,44
Raith,5256,7,11,8,17,36,50,-14,41
Dumbarton,5256,8,9,11,16,45,58,-13,38
St Mirren,5256,9,9,9,18,39,55,-16,36
Ayr,5256,10,8,11,17,36,58,-22,35
Hibernian,5257,1,19,12,5,61,26,35,69
Morton,5257,2,18,12,6,55,39,16,66
Dundee Utd,5257,3,17,9,10,56,39,17,60
Falkirk,5257,4,15,10,11,57,50,7,55
Queen of S't,5257,5,12,9,15,48,53,-5,45
Dunfermline,5257,6,9,13,14,47,49,-2,40
Raith,5257,7,10,10,16,36,54,-18,40
Dumbarton,5257,8,9,11,16,47,59,-12,38
Ayr,5257,9,8,13,15,38,60,-22,37
St Mirren,5257,10,8,11,17,41,57,-16,35
Hibernian,5258,1,19,11,6,56,28,28,68
Dundee Utd,5258,2,17,9,10,55,40,15,60
Morton,5258,3,15,12,9,50,39,11,57
Falkirk,5258,4,15,10,11,55,43,12,55
Dunfermline,5258,5,14,11,11,51,41,10,53
Queen of S't,5258,6,12,9,15,41,48,-7,45
Raith,5258,7,11,9,16,38,50,-12,42
Ayr,5258,8,9,12,15,36,53,-17,39
Dumbarton,5258,9,7,13,16,46,61,-15,34
St Mirren,5258,10,8,10,18,40,65,-25,34
Hibernian,5259,1,20,12,4,55,24,31,72
Falkirk,5259,2,17,9,10,62,40,22,60
Morton,5259,3,16,12,8,53,40,13,60
Dundee Utd,5259,4,14,12,10,48,40,8,54
Dunfermline,5259,5,10,14,12,44,44,0,44
Queen of S't,5259,6,11,10,15,47,56,-9,43
Raith,5259,7,10,10,16,36,49,-13,40
St Mirren,5259,8,9,12,15,44,54,-10,39
Dumbarton,5259,9,9,11,16,46,61,-15,38
Ayr,5259,10,7,12,17,30,57,-27,33
Hibernian,5260,1,21,11,4,62,22,40,74
Falkirk,5260,2,18,10,8,59,39,20,64
Morton,5260,3,15,11,10,49,42,7,56
Dundee Utd,5260,4,14,10,12,49,45,4,52
Dunfermline,5260,5,12,12,12,50,45,5,48
Queen of S't,5260,6,11,10,15,44,52,-8,43
Raith,5260,7,11,9,16,35,49,-14,42
Dumbarton,5260,8,10,10,16,50,62,-12,40
St Mirren,5260,9,9,9,18,40,56,-16,36
Ayr,5260,10,7,12,17,32,58,-26,33
Hibernian,5261,1,18,11,7,48,24,24,65
Falkirk,5261,2,17,10,9,58,41,17,61
Dundee Utd,5261,3,17,9,10,57,44,13,60
Morton,5261,4,15,12,9,48,39,9,57
Queen of S't,5261,5,13,9,14,50,51,-1,48
Raith,5261,6,11,10,15,41,49,-8,43
Dunfermline,5261,7,9,15,12,45,47,-2,42
Ayr,5261,8,9,12,15,35,57,-22,39
Dumbarton,5261,9,8,12,16,46,61,-15,36
St Mirren,5261,10,8,10,18,40,55,-15,34
Hibernian,5262,1,18,13,5,57,27,30,67
Falkirk,5262,2,18,10,8,61,40,21,64
Morton,5262,3,17,12,7,53,39,14,63
Dundee Utd,5262,4,13,10,13,43,42,1,49
Dunfermline,5262,5,11,14,11,50,45,5,47
Queen of S't,5262,6,11,9,16,46,53,-7,42
Dumbarton,5262,7,10,12,14,50,58,-8,42
Ayr,5262,8,10,12,14,33,52,-19,42
Raith,5262,9,9,9,18,33,51,-18,36
St Mirren,5262,10,7,11,18,35,54,-19,32
Hibernian,5263,1,17,13,6,51,26,25,64
Morton,5263,2,16,14,6,51,34,17,62
Dundee Utd,5263,3,17,9,10,52,40,12,60
Falkirk,5263,4,16,10,10,60,43,17,58
Queen of S't,5263,5,14,9,13,46,46,0,51
Raith,5263,6,9,12,15,34,49,-15,39
Ayr,5263,7,9,11,16,34,53,-19,38
Dunfermline,5263,8,8,13,15,44,54,-10,37
Dumbarton,5263,9,8,13,15,45,56,-11,37
St Mirren,5263,10,9,10,17,40,56,-16,37
Hibernian,5264,1,22,11,3,59,26,33,77
Dundee Utd,5264,2,16,10,10,50,40,10,58
Morton,5264,3,15,12,9,51,36,15,57
Falkirk,5264,4,15,11,10,59,44,15,56
Dunfermline,5264,5,10,13,13,46,51,-5,43
Queen of S't,5264,6,10,12,14,44,49,-5,42
Raith,5264,7,10,11,15,38,51,-13,41
Ayr,5264,8,7,16,13,35,53,-18,37
St Mirren,5264,9,8,11,17,44,60,-16,35
Dumbarton,5264,10,7,13,16,43,59,-16,34
Hibernian,5265,1,20,12,4,57,25,32,72
Morton,5265,2,17,12,7,51,34,17,63
Dundee Utd,5265,3,18,8,10,61,43,18,62
Falkirk,5265,4,16,12,8,54,38,16,60
Queen of S't,5265,5,14,9,13,53,46,7,51
Dunfermline,5265,6,10,13,13,47,54,-7,43
Dumbarton,5265,7,8,12,16,45,58,-13,36
Raith,5265,8,9,9,18,32,48,-16,36
St Mirren,5265,9,8,10,18,36,57,-21,34
Ayr,5265,10,6,11,19,30,63,-33,29
Morton,5266,1,19,11,6,52,32,20,68
Hibernian,5266,2,17,13,6,54,28,26,64
Falkirk,5266,3,18,10,8,61,38,23,64
Dundee Utd,5266,4,15,11,10,54,39,15,56
Queen of S't,5266,5,11,10,15,42,50,-8,43
Dunfermline,5266,6,9,14,13,42,47,-5,41
Dumbarton,5266,7,10,11,15,48,55,-7,41
Raith,5266,8,10,9,17,34,50,-16,39
Ayr,5266,9,8,11,17,34,62,-28,35
St Mirren,5266,10,8,10,18,37,57,-20,34
Hibernian,5267,1,19,12,5,51,28,23,69
Morton,5267,2,17,11,8,51,33,18,62
Falkirk,5267,3,14,12,10,56,41,15,54
Dundee Utd,5267,4,14,12,10,51,42,9,54
Dumbarton,5267,5,13,11,12,53,53,0,50
Queen of S't,5267,6,12,9,15,48,51,-3,45
Raith,5267,7,11,9,16,37,49,-12,42
Ayr,5267,8,9,13,14,42,56,-14,40
Dunfermline,5267,9,9,11,16,39,51,-12,38
St Mirren,5267,10,6,12,18,33,57,-24,30
Hibernian,5268,1,17,14,5,52,29,23,65
Falkirk,5268,2,18,9,9,65,46,19,63
Dundee Utd,5268,3,17,10,9,55,44,11,61
Morton,5268,4,16,12,8,52,36,16,60
Dunfermline,5268,5,11,12,13,47,45,2,45
Dumbarton,5268,6,10,12,14,49,54,-5,42
Queen of S't,5268,7,10,11,15,44,54,-10,41
Raith,5268,8,9,10,17,38,54,-16,37
Ayr,5268,9,8,13,15,36,55,-19,37
St Mirren,5268,10,7,11,18,37,58,-21,32
Hibernian,5269,1,19,11,6,56,30,26,68
Falkirk,5269,2,17,10,9,57,38,19,61
Dundee Utd,5269,3,17,9,10,58,40,18,60
Morton,5269,4,16,11,9,48,38,10,59
Dunfermline,5269,5,11,12,13,47,47,0,45
Queen of S't,5269,6,12,8,16,47,51,-4,44
Raith,5269,7,12,8,16,35,47,-12,44
Dumbarton,5269,8,8,14,14,48,60,-12,38
Ayr,5269,9,8,14,14,39,60,-21,38
St Mirren,5269,10,6,11,19,35,59,-24,29
Hibernian,5270,1,20,11,5,57,26,31,71
Morton,5270,2,17,10,9,50,38,12,61
Falkirk,5270,3,16,12,8,57,39,18,60
Dundee Utd,5270,4,16,10,10,57,43,14,58
Dunfermline,5270,5,12,11,13,49,49,0,47
Dumbarton,5270,6,11,10,15,52,57,-5,43
Queen of S't,5270,7,10,10,16,41,52,-11,40
Raith,5270,8,10,9,17,34,50,-16,39
St Mirren,5270,9,9,11,16,42,54,-12,38
Ayr,5270,10,6,12,18,31,62,-31,30
Hibernian,5271,1,18,13,5,53,26,27,67
Dundee Utd,5271,2,16,11,9,52,35,17,59
Morton,5271,3,15,13,8,50,38,12,58
Falkirk,5271,4,15,12,9,55,38,17,57
Dunfermline,5271,5,11,13,12,42,44,-2,46
Queen of S't,5271,6,11,10,15,42,48,-6,43
Dumbarton,5271,7,10,12,14,43,51,-8,42
Raith,5271,8,10,9,17,35,50,-15,39
Ayr,5271,9,7,15,14,32,54,-22,36
St Mirren,5271,10,8,10,18,38,58,-20,34
Hibernian,5272,1,19,13,4,52,23,29,70
Morton,5272,2,17,12,7,56,36,20,63
Dundee Utd,5272,3,17,9,10,50,37,13,60
Falkirk,5272,4,16,11,9,57,38,19,59
Queen of S't,5272,5,11,9,16,45,54,-9,42
Raith,5272,6,11,9,16,36,49,-13,42
Dunfermline,5272,7,9,14,13,43,50,-7,41
Ayr,5272,8,8,13,15,33,54,-21,37
Dumbarton,5272,9,8,11,17,44,59,-15,35
St Mirren,5272,10,8,11,17,42,58,-16,35
Hibernian,5273,1,20,10,6,56,27,29,70
Morton,5273,2,17,11,8,49,33,16,62
Dundee Utd,5273,3,16,12,8,52,37,15,60
Falkirk,5273,4,15,12,9,55,40,15,57
Dunfermline,5273,5,10,12,14,46,51,-5,42
Queen of S't,5273,6,10,12,14,49,56,-7,42
Ayr,5273,7,9,12,15,36,53,-17,39
St Mirren,5273,8,8,13,15,39,52,-13,37
Raith,5273,9,9,10,17,36,56,-20,37
Dumbarton,5273,10,8,12,16,43,56,-13,36
Hibernian,5274,1,22,10,4,64,26,38,76
Dundee Utd,5274,2,18,9,9,54,38,16,63
Morton,5274,3,16,9,11,54,48,6,57
Falkirk,5274,4,15,11,10,61,43,18,56
Queen of S't,5274,5,11,10,15,45,51,-6,43
Dumbarton,5274,6,10,11,15,51,62,-11,41
St Mirren,5274,7,10,10,16,45,57,-12,40
Raith,5274,8,10,8,18,38,54,-16,38
Ayr,5274,9,9,11,16,36,56,-20,38
Dunfermline,5274,10,8,13,15,47,60,-13,37
Hibernian,5275,1,19,13,4,57,26,31,70
Falkirk,5275,2,17,11,8,61,40,21,62
Morton,5275,3,16,12,8,48,34,14,60
Dundee Utd,5275,4,15,10,11,53,42,11,55
Queen of S't,5275,5,11,11,14,46,53,-7,44
Raith,5275,6,11,8,17,38,50,-12,41
Dumbarton,5275,7,10,10,16,49,59,-10,40
Dunfermline,5275,8,9,12,15,44,51,-7,39
Ayr,5275,9,9,12,15,33,55,-22,39
St Mirren,5275,10,9,9,18,38,57,-19,36
Morton,5276,1,21,9,6,56,35,21,72
Hibernian,5276,2,19,12,5,55,26,29,69
Falkirk,5276,3,16,10,10,55,39,16,58
Dundee Utd,5276,4,12,13,11,41,43,-2,49
Queen of S't,5276,5,12,9,15,46,47,-1,45
Ayr,5276,6,9,14,13,35,52,-17,41
Dunfermline,5276,7,8,16,12,44,45,-1,40
Raith,5276,8,10,9,17,33,49,-16,39
Dumbarton,5276,9,8,12,16,46,58,-12,36
St Mirren,5276,10,8,10,18,39,56,-17,34
Hibernian,5277,1,19,12,5,61,29,32,69
Morton,5277,2,17,11,8,57,42,15,62
Falkirk,5277,3,17,10,9,60,41,19,61
Dundee Utd,5277,4,13,12,11,47,43,4,51
Queen of S't,5277,5,12,10,14,44,50,-6,46
Dunfermline,5277,6,9,15,12,45,48,-3,42
St Mirren,5277,7,10,11,15,47,58,-11,41
Ayr,5277,8,9,13,14,34,51,-17,40
Raith,5277,9,8,12,16,34,49,-15,36
Dumbarton,5277,10,7,12,17,48,66,-18,33
Morton,5278,1,17,13,6,50,34,16,64
Hibernian,5278,2,17,12,7,53,28,25,63
Falkirk,5278,3,16,12,8,59,39,20,60
Dundee Utd,5278,4,16,9,11,48,40,8,57
Dumbarton,5278,5,12,11,13,52,55,-3,47
Dunfermline,5278,6,10,13,13,48,48,0,43
Raith,5278,7,11,10,15,35,44,-9,43
Queen of S't,5278,8,10,10,16,40,53,-13,40
Ayr,5278,9,8,11,17,36,57,-21,35
St Mirren,5278,10,7,11,18,39,62,-23,32
Hibernian,5279,1,18,14,4,59,28,31,68
Morton,5279,2,16,11,9,54,43,11,59
Falkirk,5279,3,13,14,9,56,43,13,53
Dundee Utd,5279,4,15,8,13,45,42,3,53
Dunfermline,5279,5,11,14,11,49,46,3,47
Queen of S't,5279,6,12,11,13,44,48,-4,47
Raith,5279,7,11,10,15,35,47,-12,43
Dumbarton,5279,8,9,11,16,47,56,-9,38
Ayr,5279,9,9,11,16,34,53,-19,38
St Mirren,5279,10,8,12,16,38,55,-17,36
Hibernian,5280,1,19,11,6,56,28,28,68
Falkirk,5280,2,17,11,8,62,40,22,62
Dundee Utd,5280,3,17,9,10,56,42,14,60
Morton,5280,4,16,11,9,52,39,13,59
Queen of S't,5280,5,13,9,14,49,49,0,48
Dumbarton,5280,6,11,12,13,50,52,-2,45
Raith,5280,7,11,9,16,35,50,-15,42
Dunfermline,5280,8,8,11,17,45,56,-11,35
St Mirren,5280,9,8,11,17,41,59,-18,35
Ayr,5280,10,8,10,18,31,62,-31,34
Hibernian,5281,1,20,12,4,63,27,36,72
Falkirk,5281,2,17,11,8,61,39,22,62
Morton,5281,3,16,13,7,47,31,16,61
Dundee Utd,5281,4,16,10,10,52,40,12,58
Queen of S't,5281,5,11,10,15,43,49,-6,43
Dunfermline,5281,6,10,11,15,45,56,-11,41
Dumbarton,5281,7,9,13,14,47,56,-9,40
St Mirren,5281,8,9,10,17,44,55,-11,37
Ayr,5281,9,8,12,16,32,56,-24,36
Raith,5281,10,8,10,18,29,54,-25,34
Hibernian,5282,1,19,11,6,54,31,23,68
Morton,5282,2,17,12,7,50,33,17,63
Falkirk,5282,3,16,11,9,56,42,14,59
Dundee Utd,5282,4,16,11,9,51,37,14,59
Dunfermline,5282,5,11,13,12,51,46,5,46
Ayr,5282,6,10,12,14,38,51,-13,42
Queen of S't,5282,7,11,8,17,47,57,-10,41
Dumbarton,5282,8,8,13,15,50,64,-14,37
Raith,5282,9,9,9,18,32,50,-18,36
St Mirren,5282,10,8,10,18,40,58,-18,34
Hibernian,5283,1,20,12,4,61,27,34,72
Morton,5283,2,17,12,7,50,33,17,63
Dundee Utd,5283,3,17,9,10,49,37,12,60
Falkirk,5283,4,16,11,9,59,41,18,59
Raith,5283,5,11,10,15,39,50,-11,43
Queen of S't,5283,6,10,11,15,46,52,-6,41
Dumbarton,5283,7,9,12,15,49,58,-9,39
Dunfermline,5283,8,8,13,15,42,54,-12,37
Ayr,5283,9,8,12,16,32,57,-25,36
St Mirren,5283,10,7,12,17,36,54,-18,33
Hibernian,5284,1,20,12,4,61,26,35,72
Morton,5284,2,16,12,8,51,37,14,60
Falkirk,5284,3,15,12,9,61,43,18,57
Dundee Utd,5284,4,16,9,11,52,41,11,57
Dumbarton,5284,5,11,12,13,51,53,-2,45
Queen of S't,5284,6,12,8,16,46,58,-12,44
Dunfermline,5284,7,9,14,13,45,49,-4,41
Ayr,5284,8,9,12,15,35,56,-21,39
Raith,5284,9,9,9,18,31,56,-25,36
St Mirren,5284,10,8,10,18,45,59,-14,34
Hibernian,5285,1,19,12,5,54,26,28,69
Falkirk,5285,2,17,9,10,57,39,18,60
Morton,5285,3,15,14,7,48,39,9,59
Dundee Utd,5285,4,15,11,10,47,40,7,56
Dunfermline,5285,5,11,12,13,49,50,-1,45
Dumbarton,5285,6,10,11,15,52,58,-6,41
Queen of S't,5285,7,10,11,15,45,52,-7,41
St Mirren,5285,8,10,11,15,42,52,-10,41
Raith,5285,9,9,10,17,37,51,-14,37
Ayr,5285,10,7,13,16,29,53,-24,34
Morton,5286,1,19,12,5,58,32,26,69
Hibernian,5286,2,17,13,6,51,27,24,64
Dundee Utd,5286,3,16,9,11,47,41,6,57
Falkirk,5286,4,14,11,11,53,41,12,53
Ayr,5286,5,12,10,14,41,49,-8,46
Queen of S't,5286,6,12,9,15,45,48,-3,45
Dunfermline,5286,7,10,13,13,44,48,-4,43
Raith,5286,8,9,11,16,33,48,-15,38
Dumbarton,5286,9,9,10,17,44,65,-21,37
St Mirren,5286,10,8,10,18,39,56,-17,34
Hibernian,5287,1,20,12,4,59,26,33,72
Morton,5287,2,19,10,7,53,34,19,67
Falkirk,5287,3,16,12,8,60,40,20,60
Dundee Utd,5287,4,14,11,11,53,45,8,53
Dunfermline,5287,5,10,15,11,45,45,0,45
Queen of S't,5287,6,10,11,15,44,51,-7,41
Raith,5287,7,10,10,16,39,53,-14,40
Dumbarton,5287,8,9,11,16,49,59,-10,38
Ayr,5287,9,8,11,17,33,60,-27,35
St Mirren,5287,10,7,11,18,39,61,-22,32
Hibernian,5288,1,21,11,4,60,21,39,74
Morton,5288,2,17,11,8,49,36,13,62
Dundee Utd,5288,3,16,10,10,50,39,11,58
Falkirk,5288,4,14,12,10,55,45,10,54
Queen of S't,5288,5,13,9,14,45,48,-3,48
Dumbarton,5288,6,11,11,14,50,56,-6,44
Dunfermline,5288,7,9,13,14,42,49,-7,40
Raith,5288,8,9,11,16,33,49,-16,38
Ayr,5288,9,8,11,17,34,56,-22,35
St Mirren,5288,10,7,11,18,41,60,-19,32
Hibernian,5289,1,20,12,4,56,23,33,72
Morton,5289,2,18,12,6,56,36,20,66
Dundee Utd,5289,3,18,8,10,50,35,15,62
Falkirk,5289,4,15,10,11,54,41,13,55
Dunfermline,5289,5,10,13,13,46,49,-3,43
Dumbarton,5289,6,10,10,16,48,57,-9,40
Queen of S't,5289,7,10,9,17,45,55,-10,39
St Mirren,5289,8,9,11,16,37,52,-15,38
Raith,5289,9,9,10,17,31,51,-20,37
Ayr,5289,10,8,11,17,34,58,-24,35
Hibernian,5290,1,19,12,5,54,27,27,69
Morton,5290,2,19,11,6,51,34,17,68
Dundee Utd,5290,3,16,9,11,52,42,10,57
Falkirk,5290,4,14,13,9,54,39,15,55
Dunfermline,5290,5,11,12,13,51,46,5,45
Raith,5290,6,11,9,16,37,50,-13,42
Queen of S't,5290,7,11,8,17,43,52,-9,41
St Mirren,5290,8,9,11,16,37,52,-15,38
Ayr,5290,9,9,10,17,34,56,-22,37
Dumbarton,5290,10,8,11,17,47,62,-15,35
Hibernian,5291,1,21,12,3,56,24,32,75
Morton,5291,2,17,10,9,47,34,13,61
Dundee Utd,5291,3,17,9,10,49,39,10,60
Falkirk,5291,4,15,10,11,56,43,13,55
Queen of S't,5291,5,12,10,14,45,49,-4,46
Dunfermline,5291,6,9,13,14,42,46,-4,40
Dumbarton,5291,7,10,10,16,50,61,-11,40
Ayr,5291,8,9,11,16,37,52,-15,38
St Mirren,5291,9,9,10,17,43,58,-15,37
Raith,5291,10,9,9,18,31,50,-19,36
Hibernian,5292,1,18,12,6,49,23,26,66
Dundee Utd,5292,2,18,10,8,58,35,23,64
Morton,5292,3,18,10,8,51,34,17,64
Falkirk,5292,4,17,11,8,65,40,25,62
Dumbarton,5292,5,11,11,14,51,60,-9,44
Dunfermline,5292,6,10,12,14,41,46,-5,42
Queen of S't,5292,7,11,9,16,40,50,-10,42
St Mirren,5292,8,10,9,17,43,60,-17,39
Raith,5292,9,10,8,18,33,51,-18,38
Ayr,5292,10,6,10,20,31,63,-32,28
Hibernian,5293,1,21,12,3,58,25,33,75
Morton,5293,2,17,12,7,56,34,22,63
Dundee Utd,5293,3,17,9,10,57,42,15,60
Falkirk,5293,4,15,11,10,60,46,14,56
Queen of S't,5293,5,15,8,13,54,44,10,53
Raith,5293,6,11,10,15,37,50,-13,43
Ayr,5293,7,8,11,17,34,60,-26,35
Dumbarton,5293,8,7,13,16,46,61,-15,34
Dunfermline,5293,9,7,13,16,40,57,-17,34
St Mirren,5293,10,6,13,17,37,60,-23,31
Hibernian,5294,1,19,13,4,57,24,33,70
Morton,5294,2,16,13,7,46,33,13,61
Falkirk,5294,3,15,11,10,54,40,14,56
Dundee Utd,5294,4,15,10,11,52,40,12,55
Queen of S't,5294,5,11,10,15,44,50,-6,43
Dunfermline,5294,6,10,12,14,48,48,0,42
Raith,5294,7,9,14,13,32,43,-11,41
Ayr,5294,8,9,14,13,34,53,-19,41
Dumbarton,5294,9,8,12,16,47,61,-14,36
St Mirren,5294,10,7,13,16,40,62,-22,34
Hibernian,5295,1,20,12,4,66,28,38,72
Morton,5295,2,16,13,7,49,36,13,61
Falkirk,5295,3,16,10,10,58,39,19,58
Dundee Utd,5295,4,14,12,10,50,44,6,54
Queen of S't,5295,5,13,8,15,50,53,-3,47
Ayr,5295,6,11,12,13,42,51,-9,45
Dunfermline,5295,7,9,13,14,43,53,-10,40
Raith,5295,8,10,10,16,37,53,-16,40
St Mirren,5295,9,8,12,16,40,57,-17,36
Dumbarton,5295,10,7,10,19,41,62,-21,31
Hibernian,5296,1,20,12,4,58,25,33,72
Morton,5296,2,17,11,8,56,39,17,62
Falkirk,5296,3,16,12,8,60,37,23,60
Dundee Utd,5296,4,16,10,10,53,42,11,58
Dunfermline,5296,5,8,16,12,46,51,-5,40
Dumbarton,5296,6,10,10,16,48,59,-11,40
Raith,5296,7,10,10,16,34,45,-11,40
Queen of S't,5296,8,10,9,17,43,58,-15,39
Ayr,5296,9,9,12,15,36,57,-21,39
St Mirren,5296,10,8,10,18,38,59,-21,34
Hibernian,5297,1,20,11,5,54,25,29,71
Dundee Utd,5297,2,18,9,9,54,38,16,63
Falkirk,5297,3,15,12,9,54,39,15,57
Morton,5297,4,16,9,11,47,41,6,57
Raith,5297,5,13,9,14,39,47,-8,48
Dunfermline,5297,6,11,14,11,50,48,2,47
Queen of S't,5297,7,11,11,14,48,52,-4,44
Dumbarton,5297,8,8,10,18,47,61,-14,34
St Mirren,5297,9,8,9,19,40,59,-19,33
Ayr,5297,10,7,12,17,33,56,-23,33
Hibernian,5298,1,18,13,5,57,31,26,67
Morton,5298,2,16,12,8,51,37,14,60
Dundee Utd,5298,3,17,9,10,51,39,12,60
Falkirk,5298,4,14,12,10,57,44,13,54
Dunfermline,5298,5,12,12,12,51,48,3,48
Queen of S't,5298,6,11,9,16,43,51,-8,42
Raith,5298,7,9,13,14,41,51,-10,40
St Mirren,5298,8,10,10,16,44,55,-11,40
Ayr,5298,9,9,12,15,39,53,-14,39
Dumbarton,5298,10,7,12,17,41,66,-25,33
Hibernian,5299,1,17,14,5,53,29,24,65
Morton,5299,2,16,13,7,52,37,15,61
Falkirk,5299,3,15,11,10,57,44,13,56
Dundee Utd,5299,4,13,11,12,47,46,1,50
Queen of S't,5299,5,13,9,14,50,47,3,48
Dunfermline,5299,6,11,12,13,54,45,9,45
Raith,5299,7,11,10,15,38,52,-14,43
Dumbarton,5299,8,10,12,14,47,56,-9,42
St Mirren,5299,9,9,10,17,40,58,-18,37
Ayr,5299,10,8,12,16,34,58,-24,36
Hibernian,5300,1,20,11,5,54,26,28,71
Morton,5300,2,18,11,7,61,40,21,65
Falkirk,5300,3,15,10,11,55,41,14,55
Dundee Utd,5300,4,14,10,12,46,42,4,52
Dunfermline,5300,5,12,12,12,51,47,4,48
Queen of S't,5300,6,11,10,15,46,52,-6,43
Raith,5300,7,11,8,17,37,52,-15,41
Dumbarton,5300,8,10,10,16,50,59,-9,40
Ayr,5300,9,9,12,15,37,57,-20,39
St Mirren,5300,10,8,10,18,42,63,-21,34
Hibernian,5301,1,20,12,4,57,24,33,72
Morton,5301,2,16,12,8,47,37,10,60
Falkirk,5301,3,15,12,9,58,43,15,57
Dundee Utd,5301,4,13,11,12,52,49,3,50
Queen of S't,5301,5,12,9,15,49,51,-2,45
Ayr,5301,6,11,11,14,41,54,-13,44
Dunfermline,5301,7,9,16,11,48,49,-1,43
Dumbarton,5301,8,9,12,15,48,59,-11,39
Raith,5301,9,9,10,17,38,55,-17,37
St Mirren,5301,10,7,13,16,40,57,-17,34
Morton,5302,1,18,11,7,55,40,15,65
Hibernian,5302,2,16,14,6,50,28,22,62
Falkirk,5302,3,17,11,8,58,39,19,62
Dundee Utd,5302,4,16,11,9,51,36,15,59
Dunfermline,5302,5,11,14,11,58,49,9,47
Queen of S't,5302,6,11,9,16,43,51,-8,42
Ayr,5302,7,10,11,15,36,59,-23,41
St Mirren,5302,8,9,11,16,41,56,-15,38
Raith,5302,9,9,8,19,35,55,-20,35
Dumbarton,5302,10,8,10,18,48,62,-14,34
Hibernian,5303,1,19,12,5,53,26,27,69
Morton,5303,2,18,10,8,52,35,17,64
Falkirk,5303,3,17,12,7,62,38,24,63
Dundee Utd,5303,4,18,9,9,53,38,15,63
Queen of S't,5303,5,11,8,17,43,55,-12,41
Dumbarton,5303,6,9,12,15,46,55,-9,39
Raith,5303,7,10,8,18,40,56,-16,38
Dunfermline,5303,8,8,13,15,45,54,-9,37
St Mirren,5303,9,9,10,17,40,55,-15,37
Ayr,5303,10,8,12,16,34,56,-22,36
Morton,5304,1,19,11,6,54,31,23,68
Hibernian,5304,2,17,14,5,55,25,30,65
Dundee Utd,5304,3,17,9,10,55,42,13,60
Falkirk,5304,4,16,10,10,59,48,11,58
Dunfermline,5304,5,11,12,13,49,49,0,45
Queen of S't,5304,6,11,10,15,46,54,-8,43
Raith,5304,7,10,11,15,36,50,-14,41
Ayr,5304,8,9,12,15,35,51,-16,39
Dumbarton,5304,9,8,10,18,45,61,-16,34
St Mirren,5304,10,8,9,19,36,59,-23,33
Morton,5305,1,17,12,7,51,35,16,63
Hibernian,5305,2,16,14,6,50,31,19,62
Dundee Utd,5305,3,16,9,11,52,41,11,57
Falkirk,5305,4,15,11,10,54,43,11,56
Dunfermline,5305,5,10,14,12,46,46,0,44
Queen of S't,5305,6,11,9,16,42,47,-5,42
Ayr,5305,7,10,11,15,33,56,-23,41
St Mirren,5305,8,10,10,16,44,51,-7,40
Dumbarton,5305,9,10,10,16,46,55,-9,40
Raith,5305,10,10,10,16,35,48,-13,40
Hibernian,5306,1,21,11,4,58,25,33,74
Falkirk,5306,2,17,10,9,58,39,19,61
Dundee Utd,5306,3,17,9,10,51,36,15,60
Morton,5306,4,15,11,10,45,39,6,56
Queen of S't,5306,5,13,8,15,43,46,-3,47
Raith,5306,6,11,9,16,37,47,-10,42
Dunfermline,5306,7,9,13,14,47,55,-8,40
Dumbarton,5306,8,9,10,17,49,60,-11,37
Ayr,5306,9,8,13,15,32,53,-21,37
St Mirren,5306,10,8,10,18,42,62,-20,34
Hibernian,5307,1,18,14,4,56,27,29,68
Falkirk,5307,2,15,13,8,55,37,18,58
Morton,5307,3,15,12,9,48,42,6,57
Dundee Utd,5307,4,13,13,10,46,40,6,52
Queen of S't,5307,5,13,10,13,47,48,-1,49
Raith,5307,6,11,11,14,39,48,-9,44
Dunfermline,5307,7,8,14,14,44,50,-6,38
Dumbarton,5307,8,9,11,16,45,56,-11,38
Ayr,5307,9,8,14,14,37,53,-16,38
St Mirren,5307,10,8,12,16,36,52,-16,36
Hibernian,5308,1,21,10,5,57,24,33,73
Morton,5308,2,16,9,11,45,37,8,57
Dundee Utd,5308,3,16,9,11,48,41,7,57
Falkirk,5308,4,15,11,10,58,45,13,56
Dunfermline,5308,5,12,12,12,49,47,2,48
Queen of S't,5308,6,12,9,15,50,55,-5,45
Raith,5308,7,11,10,15,37,48,-11,43
Ayr,5308,8,9,12,15,35,52,-17,39
Dumbarton,5308,9,9,11,16,49,57,-8,38
St Mirren,5308,10,7,11,18,35,57,-22,32
Hibernian,5309,1,19,11,6,53,26,27,68
Falkirk,5309,2,16,12,8,64,45,19,60
Morton,5309,3,15,12,9,43,35,8,57
Dundee Utd,5309,4,15,10,11,48,41,7,55
Dunfermline,5309,5,12,13,11,51,44,7,49
Queen of S't,5309,6,12,10,14,49,53,-4,46
Ayr,5309,7,9,14,13,36,52,-16,41
Raith,5309,8,9,11,16,34,49,-15,38
Dumbarton,5309,9,9,10,17,47,60,-13,37
St Mirren,5309,10,8,9,19,39,59,-20,33
Hibernian,5310,1,19,12,5,58,27,31,69
Morton,5310,2,18,9,9,54,36,18,63
Falkirk,5310,3,17,10,9,62,41,21,61
Dundee Utd,5310,4,16,10,10,51,43,8,58
Queen of S't,5310,5,12,10,14,45,48,-3,46
Ayr,5310,6,10,12,14,41,56,-15,42
Dumbarton,5310,7,10,10,16,46,59,-13,40
Dunfermline,5310,8,9,11,16,43,52,-9,38
Raith,5310,9,10,8,18,35,53,-18,38
St Mirren,5310,10,8,10,18,39,59,-20,34
Hibernian,5311,1,19,12,5,54,27,27,69
Morton,5311,2,17,11,8,54,38,16,62
Dundee Utd,5311,3,16,11,9,55,41,14,59
Falkirk,5311,4,15,11,10,57,43,14,56
Dumbarton,5311,5,12,12,12,55,54,1,48
Dunfermline,5311,6,10,12,14,48,49,-1,42
Queen of S't,5311,7,10,11,15,44,52,-8,41
Raith,5311,8,9,10,17,33,50,-17,37
Ayr,5311,9,8,13,15,37,61,-24,37
St Mirren,5311,10,6,13,17,36,58,-22,31
Hibernian,5312,1,18,13,5,58,28,30,67
Morton,5312,2,17,12,7,52,37,15,63
Falkirk,5312,3,16,10,10,56,47,9,58
Dundee Utd,5312,4,16,9,11,51,40,11,57
Raith,5312,5,11,10,15,38,47,-9,43
Ayr,5312,6,10,12,14,37,53,-16,42
Queen of S't,5312,7,11,8,17,45,51,-6,41
Dunfermline,5312,8,9,13,14,44,51,-7,40
Dumbarton,5312,9,9,11,16,47,61,-14,38
St Mirren,5312,10,8,12,16,41,54,-13,36
Hibernian,5313,1,19,13,4,57,27,30,70
Falkirk,5313,2,17,11,8,59,39,20,62
Morton,5313,3,16,12,8,50,38,12,60
Dundee Utd,5313,4,15,10,11,49,43,6,55
Queen of S't,5313,5,12,9,15,48,51,-3,45
Dunfermline,5313,6,9,15,12,47,49,-2,42
Ayr,5313,7,9,12,15,34,55,-21,39
St Mirren,5313,8,9,11,16,43,53,-10,38
Raith,5313,9,9,11,16,36,50,-14,38
Dumbarton,5313,10,7,12,17,48,66,-18,33
Hibernian,5314,1,18,13,5,54,27,27,67
Morton,5314,2,17,10,9,51,38,13,61
Falkirk,5314,3,15,13,8,61,41,20,58
Dundee Utd,5314,4,16,10,10,49,43,6,58
Dunfermline,5314,5,10,14,12,48,46,2,44
Raith,5314,6,11,10,15,35,51,-16,43
Queen of S't,5314,7,10,12,14,45,52,-7,42
Dumbarton,5314,8,9,13,14,49,58,-9,40
St Mirren,5314,9,8,12,16,41,54,-13,36
Ayr,5314,10,7,11,18,35,58,-23,32
Hibernian,5315,1,19,12,5,56,25,31,69
Dundee Utd,5315,2,18,8,10,58,37,21,62
Morton,5315,3,16,10,10,46,42,4,58
Falkirk,5315,4,14,12,10,54,41,13,54
Queen of S't,5315,5,12,10,14,48,50,-2,46
Raith,5315,6,12,9,15,39,46,-7,45
Dunfermline,5315,7,9,15,12,43,45,-2,42
Dumbarton,5315,8,8,13,15,46,58,-12,37
Ayr,5315,9,8,13,15,34,57,-23,37
St Mirren,5315,10,7,12,17,43,66,-23,33
Hibernian,5316,1,19,12,5,56,29,27,69
Dundee Utd,5316,2,18,10,8,50,35,15,64
Morton,5316,3,17,11,8,51,36,15,62
Falkirk,5316,4,16,10,10,56,41,15,58
Dunfermline,5316,5,10,12,14,46,46,0,42
Raith,5316,6,11,8,17,35,49,-14,41
Ayr,5316,7,10,11,15,34,50,-16,41
Queen of S't,5316,8,9,11,16,40,51,-11,38
Dumbarton,5316,9,8,13,15,47,59,-12,37
St Mirren,5316,10,7,12,17,39,58,-19,33
Hibernian,5317,1,18,13,5,52,25,27,67
Morton,5317,2,18,13,5,53,34,19,67
Falkirk,5317,3,18,10,8,58,37,21,64
Dundee Utd,5317,4,18,9,9,62,40,22,63
Queen of S't,5317,5,12,10,14,48,50,-2,46
Dumbarton,5317,6,9,11,16,45,57,-12,38
Ayr,5317,7,9,11,16,35,58,-23,38
Raith,5317,8,9,9,18,36,57,-21,36
St Mirren,5317,9,8,10,18,38,56,-18,34
Dunfermline,5317,10,7,12,17,41,54,-13,33
Hibernian,5318,1,18,13,5,53,27,26,67
Morton,5318,2,18,9,9,59,44,15,63
Falkirk,5318,3,17,11,8,59,36,23,62
Dundee Utd,5318,4,16,10,10,50,40,10,58
Ayr,5318,5,11,10,15,41,57,-16,43
Dunfermline,5318,6,10,12,14,48,50,-2,42
Queen of S't,5318,7,10,12,14,41,47,-6,42
Dumbarton,5318,8,9,12,15,47,58,-11,39
Raith,5318,9,8,11,17,37,56,-19,35
St Mirren,5318,10,8,10,18,43,63,-20,34
Hibernian,5319,1,20,11,5,57,28,29,71
Morton,5319,2,18,11,7,58,39,19,65
Falkirk,5319,3,16,12,8,60,42,18,60
Dundee Utd,5319,4,17,9,10,53,42,11,60
Queen of S't,5319,5,11,11,14,48,53,-5,44
Raith,5319,6,12,8,16,39,52,-13,44
Dumbarton,5319,7,9,12,15,52,61,-9,39
Ayr,5319,8,8,12,16,32,56,-24,36
St Mirren,5319,9,8,10,18,42,57,-15,34
Dunfermline,5319,10,7,12,17,41,52,-11,33
Hibernian,5320,1,21,12,3,60,26,34,75
Morton,5320,2,16,12,8,51,36,15,60
Falkirk,5320,3,15,11,10,57,41,16,56
Dundee Utd,5320,4,15,11,10,49,39,10,56
Raith,5320,5,11,11,14,38,46,-8,44
Dunfermline,5320,6,7,19,10,46,48,-2,40
Ayr,5320,7,9,12,15,36,55,-19,39
Queen of S't,5320,8,9,11,16,44,57,-13,38
Dumbarton,5320,9,8,12,16,44,57,-13,36
St Mirren,5320,10,9,9,18,42,62,-20,36
Hibernian,5321,1,20,12,4,54,23,31,72
Falkirk,5321,2,17,10,9,67,45,22,61
Morton,5321,3,16,11,9,49,37,12,59
Dundee Utd,5321,4,16,9,11,53,40,13,57
Queen of S't,5321,5,13,9,14,50,51,-1,48
Dunfermline,5321,6,9,14,13,47,53,-6,41
Dumbarton,5321,7,10,11,15,48,59,-11,41
Raith,5321,8,9,11,16,36,52,-16,38
Ayr,5321,9,8,12,16,36,62,-26,36
St Mirren,5321,10,7,11,18,41,59,-18,32
Hibernian,5322,1,18,13,5,53,28,25,67
Dundee Utd,5322,2,18,10,8,56,39,17,64
Morton,5322,3,16,10,10,48,38,10,58
Falkirk,5322,4,13,12,11,53,42,11,51
Raith,5322,5,12,11,13,39,44,-5,47
Queen of S't,5322,6,11,10,15,47,53,-6,43
Dunfermline,5322,7,8,15,13,45,47,-2,39
Dumbarton,5322,8,9,12,15,50,62,-12,39
Ayr,5322,9,8,13,15,34,57,-23,37
St Mirren,5322,10,8,12,16,42,57,-15,36
Hibernian,5323,1,18,12,6,61,33,28,66
Morton,5323,2,18,12,6,54,35,19,66
Falkirk,5323,3,15,11,10,56,44,12,56
Dundee Utd,5323,4,15,10,11,51,44,7,55
Raith,5323,5,14,8,14,40,44,-4,50
Queen of S't,5323,6,11,10,15,45,50,-5,43
Dunfermline,5323,7,9,12,15,48,54,-6,39
St Mirren,5323,8,9,11,16,46,61,-15,38
Dumbarton,5323,9,8,13,15,46,58,-12,37
Ayr,5323,10,8,11,17,40,64,-24,35
Hibernian,5324,1,20,13,3,55,23,32,73
Morton,5324,2,17,12,7,45,32,13,63
Falkirk,5324,3,17,10,9,60,40,20,61
Dundee Utd,5324,4,13,11,12,43,39,4,50
Queen of S't,5324,5,12,10,14,43,48,-5,46
Raith,5324,6,11,10,15,37,48,-11,43
Ayr,5324,7,10,11,15,39,55,-16,41
Dumbarton,5324,8,9,12,15,44,55,-11,39
Dunfermline,5324,9,8,14,14,42,47,-5,38
St Mirren,5324,10,6,11,19,35,56,-21,29
Hibernian,5325,1,20,13,3,56,23,33,73
Falkirk,5325,2,16,11,9,58,41,17,59
Dundee Utd,5325,3,16,11,9,52,35,17,59
Morton,5325,4,15,14,7,48,35,13,59
Queen of S't,5325,5,14,8,14,46,48,-2,50
Dunfermline,5325,6,11,12,13,43,47,-4,45
St Mirren,5325,7,9,11,16,41,56,-15,38
Raith,5325,8,9,10,17,34,50,-16,37
Dumbarton,5325,9,8,11,17,43,56,-13,35
Ayr,5325,10,6,11,19,28,58,-30,29
Hibernian,5326,1,19,12,5,54,26,28,69
Morton,5326,2,18,10,8,51,35,16,64
Falkirk,5326,3,15,10,11,63,47,16,55
Dundee Utd,5326,4,14,12,10,49,41,8,54
Queen of S't,5326,5,12,10,14,49,48,1,46
Dunfermline,5326,6,10,15,11,47,48,-1,45
Raith,5326,7,11,10,15,37,47,-10,43
St Mirren,5326,8,9,10,17,41,58,-17,37
Dumbarton,5326,9,8,12,16,46,62,-16,36
Ayr,5326,10,7,13,16,29,54,-25,34
Hibernian,5327,1,18,12,6,54,29,25,66
Morton,5327,2,16,11,9,49,40,9,59
Dundee Utd,5327,3,15,12,9,51,40,11,57
Falkirk,5327,4,15,10,11,55,41,14,55
Dunfermline,5327,5,12,12,12,46,44,2,48
Queen of S't,5327,6,12,10,14,45,47,-2,46
Dumbarton,5327,7,10,10,16,48,58,-10,40
Raith,5327,8,10,10,16,34,49,-15,40
St Mirren,5327,9,9,10,17,43,57,-14,37
Ayr,5327,10,8,13,15,34,54,-20,37
Morton,5328,1,18,9,9,50,35,15,63
Falkirk,5328,2,17,10,9,62,38,24,61
Hibernian,5328,3,16,11,9,55,36,19,59
Dundee Utd,5328,4,16,8,12,49,39,10,56
Queen of S't,5328,5,12,9,15,45,52,-7,45
Dunfermline,5328,6,10,13,13,46,47,-1,43
St Mirren,5328,7,11,10,15,43,53,-10,43
Dumbarton,5328,8,10,12,14,51,59,-8,42
Ayr,5328,9,10,12,14,33,51,-18,42
Raith,5328,10,9,8,19,29,53,-24,35
Hibernian,5329,1,17,13,6,55,27,28,64
Dundee Utd,5329,2,17,10,9,53,39,14,61
Morton,5329,3,16,11,9,53,42,11,59
Falkirk,5329,4,13,15,8,56,42,14,54
Queen of S't,5329,5,11,13,12,46,47,-1,46
Dunfermline,5329,6,10,14,12,46,47,-1,44
Ayr,5329,7,10,12,14,34,52,-18,42
St Mirren,5329,8,9,11,16,41,54,-13,38
Raith,5329,9,8,13,15,31,48,-17,37
Dumbarton,5329,10,7,12,17,47,64,-17,33
Hibernian,5330,1,18,12,6,56,27,29,66
Falkirk,5330,2,17,10,9,61,42,19,61
Morton,5330,3,16,12,8,50,37,13,60
Dundee Utd,5330,4,15,11,10,47,38,9,56
Dunfermline,5330,5,11,13,12,49,49,0,46
Queen of S't,5330,6,11,11,14,40,46,-6,44
Raith,5330,7,11,9,16,36,47,-11,42
Dumbarton,5330,8,10,11,15,48,56,-8,41
Ayr,5330,9,7,14,15,31,51,-20,35
St Mirren,5330,10,7,11,18,38,63,-25,32
Hibernian,5331,1,19,10,7,53,25,28,67
Falkirk,5331,2,19,10,7,63,37,26,67
Morton,5331,3,18,12,6,52,32,20,66
Dundee Utd,5331,4,15,10,11,50,44,6,55
Queen of S't,5331,5,12,10,14,52,54,-2,46
Raith,5331,6,10,10,16,39,54,-15,40
Dunfermline,5331,7,9,12,15,44,54,-10,39
Dumbarton,5331,8,8,13,15,49,64,-15,37
Ayr,5331,9,8,12,16,34,54,-20,36
St Mirren,5331,10,7,11,18,40,58,-18,32
Hibernian,5332,1,17,15,4,51,24,27,66
Morton,5332,2,18,12,6,53,32,21,66
Dundee Utd,5332,3,19,8,9,57,39,18,65
Falkirk,5332,4,14,10,12,55,49,6,52
Queen of S't,5332,5,13,9,14,51,50,1,48
Raith,5332,6,11,10,15,40,51,-11,43
Dunfermline,5332,7,9,13,14,42,46,-4,40
Dumbarton,5332,8,9,11,16,53,66,-13,38
St Mirren,5332,9,8,11,17,42,58,-16,35
Ayr,5332,10,7,11,18,32,61,-29,32
Hibernian,5333,1,17,15,4,52,25,27,66
Morton,5333,2,16,11,9,47,35,12,59
Falkirk,5333,3,15,12,9,63,46,17,57
Dundee Utd,5333,4,14,12,10,50,41,9,54
Queen of S't,5333,5,12,11,13,45,48,-3,47
Dunfermline,5333,6,10,13,13,45,46,-1,43
Dumbarton,5333,7,11,10,15,50,60,-10,43
St Mirren,5333,8,10,11,15,42,51,-9,41
Raith,5333,9,9,10,17,36,53,-17,37
Ayr,5333,10,8,11,17,35,60,-25,35
Hibernian,5334,1,21,11,4,58,26,32,74
Morton,5334,2,16,10,10,48,37,11,58
Dundee Utd,5334,3,15,12,9,49,38,11,57
Falkirk,5334,4,14,14,8,60,41,19,56
Queen of S't,5334,5,12,9,15,46,55,-9,45
Dunfermline,5334,6,10,13,13,48,45,3,43
St Mirren,5334,7,11,9,16,39,54,-15,42
Raith,5334,8,11,8,17,36,50,-14,41
Ayr,5334,9,9,11,16,39,57,-18,38
Dumbarton,5334,10,7,11,18,42,62,-20,32
Morton,5335,1,18,12,6,52,33,19,66
Falkirk,5335,2,18,10,8,58,39,19,64
Hibernian,5335,3,16,14,6,51,29,22,62
Dundee Utd,5335,4,14,8,14,45,41,4,50
Dunfermline,5335,5,11,13,12,48,45,3,46
Queen of S't,5335,6,11,12,13,45,49,-4,45
Raith,5335,7,10,10,16,35,48,-13,40
Ayr,5335,8,9,12,15,39,54,-15,39
St Mirren,5335,9,9,10,17,40,56,-16,37
Dumbarton,5335,10,8,11,17,42,61,-19,35
Hibernian,5336,1,19,12,5,55,30,25,69
Morton,5336,2,16,14,6,51,35,16,62
Dundee Utd,5336,3,15,10,11,53,42,11,55
Falkirk,5336,4,14,11,11,58,45,13,53
Dunfermline,5336,5,12,13,11,49,44,5,49
Queen of S't,5336,6,13,9,14,49,48,1,48
Dumbarton,5336,7,10,10,16,49,57,-8,40
St Mirren,5336,8,9,10,17,46,62,-16,37
Raith,5336,9,8,11,17,33,54,-21,35
Ayr,5336,10,7,14,15,33,59,-26,35
Hibernian,5337,1,21,11,4,61,24,37,74
Morton,5337,2,17,10,9,52,40,12,61
Dundee Utd,5337,3,17,9,10,53,38,15,60
Falkirk,5337,4,16,10,10,61,44,17,58
Raith,5337,5,14,8,14,41,46,-5,50
Queen of S't,5337,6,11,10,15,49,52,-3,43
Dunfermline,5337,7,9,13,14,44,51,-7,40
Dumbarton,5337,8,8,12,16,45,58,-13,36
Ayr,5337,9,8,10,18,31,64,-33,34
St Mirren,5337,10,7,11,18,36,56,-20,32
Morton,5338,1,21,10,5,55,30,25,73
Hibernian,5338,2,18,12,6,55,27,28,66
Dundee Utd,5338,3,17,9,10,47,37,10,60
Falkirk,5338,4,16,10,10,55,38,17,58
Queen of S't,5338,5,13,8,15,43,47,-4,47
Raith,5338,6,10,11,15,35,47,-12,41
Dumbarton,5338,7,9,12,15,50,59,-9,39
Dunfermline,5338,8,7,14,15,44,56,-12,35
St Mirren,5338,9,7,12,17,41,59,-18,33
Ayr,5338,10,7,12,17,32,57,-25,33
Hibernian,5339,1,18,14,4,58,30,28,68
Morton,5339,2,16,14,6,55,38,17,62
Falkirk,5339,3,15,12,9,54,37,17,57
Dundee Utd,5339,4,15,9,12,48,43,5,54
Queen of S't,5339,5,13,8,15,49,52,-3,47
Dumbarton,5339,6,10,13,13,50,53,-3,43
Ayr,5339,7,9,13,14,36,55,-19,40
Dunfermline,5339,8,8,15,13,46,52,-6,39
Raith,5339,9,9,9,18,34,50,-16,36
St Mirren,5339,10,9,9,18,40,60,-20,36
Hibernian,5340,1,19,13,4,58,25,33,70
Morton,5340,2,17,12,7,49,34,15,63
Falkirk,5340,3,17,11,8,60,40,20,62
Dundee Utd,5340,4,17,10,9,56,42,14,61
Raith,5340,5,10,10,16,32,46,-14,40
Dunfermline,5340,6,8,15,13,45,48,-3,39
Queen of S't,5340,7,10,9,17,43,55,-12,39
Dumbarton,5340,8,9,11,16,56,68,-12,38
Ayr,5340,9,8,13,15,39,60,-21,37
St Mirren,5340,10,8,10,18,40,60,-20,34
Hibernian,5341,1,18,13,5,56,30,26,67
Morton,5341,2,15,13,8,48,35,13,58
Falkirk,5341,3,14,13,9,59,43,16,55
Dundee Utd,5341,4,14,12,10,51,45,6,54
Queen of S't,5341,5,14,10,12,47,45,2,52
Dunfermline,5341,6,10,14,12,47,47,0,44
Dumbarton,5341,7,9,13,14,51,60,-9,40
Raith,5341,8,9,11,16,32,47,-15,38
Ayr,5341,9,9,11,16,36,57,-21,38
St Mirren,5341,10,7,12,17,41,59,-18,33
Morton,5342,1,19,11,6,54,33,21,68
Hibernian,5342,2,15,16,5,53,32,21,61
Falkirk,5342,3,15,11,10,59,42,17,56
Dundee Utd,5342,4,14,10,12,48,44,4,52
Raith,5342,5,13,10,13,38,42,-4,49
Dunfermline,5342,6,10,13,13,48,51,-3,43
Queen of S't,5342,7,11,9,16,44,53,-9,42
Dumbarton,5342,8,9,13,14,49,56,-7,40
Ayr,5342,9,7,14,15,34,56,-22,35
St Mirren,5342,10,7,13,16,38,56,-18,34
Hibernian,5343,1,19,12,5,51,23,28,69
Morton,5343,2,19,10,7,51,34,17,67
Falkirk,5343,3,16,11,9,58,39,19,59
Dundee Utd,5343,4,13,12,11,44,40,4,51
Queen of S't,5343,5,12,9,15,45,49,-4,45
Raith,5343,6,11,11,14,39,47,-8,44
Dumbarton,5343,7,10,11,15,50,56,-6,41
Dunfermline,5343,8,8,13,15,44,51,-7,37
Ayr,5343,9,8,13,15,32,49,-17,37
St Mirren,5343,10,8,10,18,36,62,-26,34
Hibernian,5344,1,21,11,4,59,25,34,74
Dundee Utd,5344,2,17,9,10,51,40,11,60
Morton,5344,3,16,10,10,43,37,6,58
Falkirk,5344,4,15,11,10,56,40,16,56
Raith,5344,5,12,9,15,37,45,-8,45
Dumbarton,5344,6,10,13,13,52,53,-1,43
Dunfermline,5344,7,9,13,14,42,48,-6,40
Queen of S't,5344,8,10,10,16,40,54,-14,40
Ayr,5344,9,9,11,16,34,54,-20,38
St Mirren,5344,10,7,11,18,41,59,-18,32
Hibernian,5345,1,19,13,4,57,27,30,70
Dundee Utd,5345,2,17,8,11,51,40,11,59
Morton,5345,3,16,9,11,48,43,5,57
Falkirk,5345,4,15,11,10,60,41,19,56
Dumbarton,5345,5,13,11,12,50,50,0,50
Dunfermline,5345,6,11,11,14,46,49,-3,44
Queen of S't,5345,7,11,10,15,43,50,-7,43
Raith,5345,8,9,11,16,34,52,-18,38
Ayr,5345,9,8,13,15,34,53,-19,37
St Mirren,5345,10,6,13,17,38,56,-18,31
Hibernian,5346,1,18,12,6,55,23,32,66
Morton,5346,2,17,12,7,48,32,16,63
Falkirk,5346,3,17,10,9,60,41,19,61
Dundee Utd,5346,4,16,11,9,54,41,13,59
Dunfermline,5346,5,11,13,12,50,48,2,46
Queen of S't,5346,6,11,10,15,43,50,-7,43
Ayr,5346,7,9,13,14,35,52,-17,40
Dumbarton,5346,8,9,11,16,46,65,-19,38
Raith,5346,9,9,10,17,32,49,-17,37
St Mirren,5346,10,7,10,19,39,61,-22,31
Hibernian,5347,1,20,12,4,58,26,32,72
Morton,5347,2,18,12,6,56,35,21,66
Falkirk,5347,3,16,9,11,61,41,20,57
Dundee Utd,5347,4,15,10,11,47,41,6,55
Queen of S't,5347,5,12,10,14,46,49,-3,46
Dunfermline,5347,6,10,13,13,47,49,-2,43
Ayr,5347,7,10,11,15,39,55,-16,41
Dumbarton,5347,8,9,11,16,48,63,-15,38
Raith,5347,9,9,9,18,33,52,-19,36
St Mirren,5347,10,7,11,18,40,64,-24,32
Hibernian,5348,1,19,12,5,55,25,30,69
Morton,5348,2,18,10,8,53,37,16,64
Falkirk,5348,3,16,10,10,55,41,14,58
Dundee Utd,5348,4,16,9,11,50,40,10,57
Queen of S't,5348,5,14,8,14,50,49,1,50
Ayr,5348,6,11,12,13,37,49,-12,45
Dunfermline,5348,7,11,11,14,48,47,1,44
St Mirren,5348,8,8,13,15,37,52,-15,37
Raith,5348,9,8,9,19,32,55,-23,33
Dumbarton,5348,10,7,10,19,41,63,-22,31
Morton,5349,1,19,12,5,52,33,19,69
Hibernian,5349,2,17,13,6,52,28,24,64
Falkirk,5349,3,15,13,8,56,36,20,58
Dundee Utd,5349,4,16,10,10,52,40,12,58
Queen of S't,5349,5,11,10,15,48,53,-5,43
Raith,5349,6,11,9,16,37,53,-16,42
Dunfermline,5349,7,9,14,13,46,48,-2,41
Dumbarton,5349,8,8,13,15,48,63,-15,37
Ayr,5349,9,8,13,15,36,54,-18,37
St Mirren,5349,10,7,11,18,40,59,-19,32
Hibernian,5350,1,19,12,5,59,30,29,69
Morton,5350,2,19,11,6,58,40,18,68
Dundee Utd,5350,3,17,10,9,57,43,14,61
Falkirk,5350,4,15,11,10,56,42,14,56
Dunfermline,5350,5,12,12,12,51,49,2,48
Queen of S't,5350,6,11,9,16,42,49,-7,42
Raith,5350,7,10,10,16,35,48,-13,40
Dumbarton,5350,8,8,12,16,50,60,-10,36
St Mirren,5350,9,8,12,16,36,52,-16,36
Ayr,5350,10,6,11,19,28,59,-31,29
Hibernian,5351,1,19,13,4,63,31,32,70
Morton,5351,2,18,10,8,52,36,16,64
Falkirk,5351,3,16,10,10,58,44,14,58
Dundee Utd,5351,4,14,11,11,49,43,6,53
Dumbarton,5351,5,11,13,12,53,53,0,46
Queen of S't,5351,6,10,11,15,47,56,-9,41
Dunfermline,5351,7,8,16,12,54,51,3,40
St Mirren,5351,8,10,10,16,41,57,-16,40
Raith,5351,9,8,11,17,36,62,-26,35
Ayr,5351,10,7,13,16,37,57,-20,34
Hibernian,5352,1,18,13,5,51,23,28,67
Falkirk,5352,2,18,10,8,66,39,27,64
Dundee Utd,5352,3,18,9,9,57,39,18,63
Morton,5352,4,15,13,8,49,37,12,58
Raith,5352,5,12,9,15,37,45,-8,45
Queen of S't,5352,6,11,10,15,39,48,-9,43
St Mirren,5352,7,10,10,16,41,56,-15,40
Dunfermline,5352,8,8,13,15,38,48,-10,37
Dumbarton,5352,9,8,12,16,48,61,-13,36
Ayr,5352,10,7,11,18,33,63,-30,32
Morton,5353,1,18,11,7,51,34,17,65
Falkirk,5353,2,17,10,9,57,40,17,61
Hibernian,5353,3,16,12,8,53,34,19,60
Dundee Utd,5353,4,16,10,10,50,38,12,58
Dunfermline,5353,5,10,15,11,49,46,3,45
Raith,5353,6,12,9,15,36,45,-9,45
Queen of S't,5353,7,12,8,16,44,49,-5,44
St Mirren,5353,8,9,11,16,43,56,-13,38
Dumbarton,5353,9,8,11,17,45,63,-18,35
Ayr,5353,10,8,11,17,35,58,-23,35
Hibernian,5354,1,19,12,5,59,30,29,69
Morton,5354,2,19,11,6,57,37,20,68
Falkirk,5354,3,17,10,9,57,40,17,61
Dundee Utd,5354,4,14,10,12,46,42,4,52
Queen of S't,5354,5,12,9,15,45,49,-4,45
Dunfermline,5354,6,9,14,13,45,50,-5,41
Dumbarton,5354,7,10,11,15,48,57,-9,41
Raith,5354,8,10,10,16,35,48,-13,40
St Mirren,5354,9,8,12,16,40,54,-14,36
Ayr,5354,10,6,13,17,32,57,-25,31
Hibernian,5355,1,18,14,4,54,24,30,68
Dundee Utd,5355,2,16,10,10,54,44,10,58
Morton,5355,3,15,11,10,46,40,6,56
Falkirk,5355,4,13,14,9,56,42,14,53
Dunfermline,5355,5,11,14,11,52,47,5,47
Raith,5355,6,12,8,16,37,46,-9,44
Queen of S't,5355,7,11,10,15,43,50,-7,43
Ayr,5355,8,11,10,15,42,57,-15,43
Dumbarton,5355,9,9,11,16,51,65,-14,38
St Mirren,5355,10,8,10,18,39,59,-20,34
Hibernian,5356,1,20,11,5,57,25,32,71
Falkirk,5356,2,16,11,9,58,38,20,59
Morton,5356,3,16,11,9,46,35,11,59
Dundee Utd,5356,4,15,9,12,50,46,4,54
Dunfermline,5356,5,11,11,14,45,44,1,44
St Mirren,5356,6,11,10,15,43,49,-6,43
Dumbarton,5356,7,11,10,15,49,61,-12,43
Raith,5356,8,10,10,16,31,45,-14,40
Queen of S't,5356,9,10,8,18,41,57,-16,38
Ayr,5356,10,9,11,16,34,54,-20,38
Hibernian,5357,1,18,13,5,51,26,25,67
Falkirk,5357,2,17,11,8,65,43,22,62
Morton,5357,3,17,10,9,49,33,16,61
Dundee Utd,5357,4,17,10,9,50,35,15,61
Queen of S't,5357,5,12,8,16,45,50,-5,44
Dunfermline,5357,6,10,12,14,45,52,-7,42
Ayr,5357,7,10,11,15,38,53,-15,41
Dumbarton,5357,8,9,11,16,51,62,-11,38
Raith,5357,9,9,9,18,32,52,-20,36
St Mirren,5357,10,8,11,17,37,57,-20,35
Hibernian,5358,1,20,12,4,59,25,34,72
Falkirk,5358,2,17,11,8,60,38,22,62
Morton,5358,3,16,10,10,51,39,12,58
Dundee Utd,5358,4,15,10,11,52,43,9,55
Queen of S't,5358,5,13,8,15,43,53,-10,47
Dunfermline,5358,6,11,11,14,47,51,-4,44
Raith,5358,7,10,11,15,36,46,-10,41
Dumbarton,5358,8,10,10,16,46,60,-14,40
Ayr,5358,9,8,11,17,37,57,-20,35
St Mirren,5358,10,8,10,18,37,56,-19,34
Morton,5359,1,18,12,6,49,34,15,66
Hibernian,5359,2,17,14,5,52,23,29,65
Dundee Utd,5359,3,17,10,9,56,39,17,61
Falkirk,5359,4,15,14,7,55,37,18,59
Queen of S't,5359,5,10,12,14,43,52,-9,42
Dunfermline,5359,6,9,13,14,46,50,-4,40
Dumbarton,5359,7,9,13,14,48,56,-8,40
Raith,5359,8,10,10,16,39,52,-13,40
Ayr,5359,9,7,13,16,35,57,-22,34
St Mirren,5359,10,7,11,18,42,65,-23,32
Hibernian,5360,1,17,11,8,51,29,22,62
Dundee Utd,5360,2,17,9,10,51,39,12,60
Morton,5360,3,15,12,9,51,42,9,57
Falkirk,5360,4,15,10,11,55,42,13,55
Dunfermline,5360,5,11,13,12,49,50,-1,46
Queen of S't,5360,6,12,9,15,43,51,-8,45
Ayr,5360,7,11,10,15,40,52,-12,43
Dumbarton,5360,8,9,14,13,49,55,-6,41
Raith,5360,9,10,9,17,37,50,-13,39
St Mirren,5360,10,9,11,16,41,57,-16,38
Hibernian,5361,1,19,13,4,56,27,29,70
Morton,5361,2,17,12,7,50,33,17,63
Dundee Utd,5361,3,16,10,10,50,39,11,58
Falkirk,5361,4,15,11,10,61,45,16,56
Queen of S't,5361,5,12,9,15,46,46,0,45
Dunfermline,5361,6,10,14,12,49,52,-3,44
Raith,5361,7,10,9,17,36,54,-18,39
Dumbarton,5361,8,9,11,16,48,61,-13,38
St Mirren,5361,9,8,11,17,41,60,-19,35
Ayr,5361,10,7,14,15,33,53,-20,35
Hibernian,5362,1,20,11,5,58,29,29,71
Morton,5362,2,18,11,7,56,35,21,65
Falkirk,5362,3,15,11,10,58,45,13,56
Dundee Utd,5362,4,15,9,12,53,45,8,54
Queen of S't,5362,5,12,10,14,49,51,-2,46
Dunfermline,5362,6,9,15,12,45,48,-3,42
Dumbarton,5362,7,9,11,16,44,58,-14,38
Ayr,5362,8,9,11,16,36,59,-23,38
Raith,5362,9,8,13,15,33,47,-14,37
St Mirren,5362,10,8,12,16,44,59,-15,36
Hibernian,5363,1,19,13,4,52,24,28,70
Falkirk,5363,2,16,12,8,57,37,20,60
Morton,5363,3,16,12,8,52,37,15,60
Dundee Utd,5363,4,15,12,9,50,40,10,57
Raith,5363,5,13,8,15,41,46,-5,47
Queen of S't,5363,6,12,10,14,46,50,-4,46
Dunfermline,5363,7,9,13,14,47,50,-3,40
Ayr,5363,8,8,12,16,33,55,-22,36
Dumbarton,5363,9,8,10,18,42,60,-18,34
St Mirren,5363,10,8,10,18,38,59,-21,34
Hibernian,5364,1,19,13,4,53,22,31,70
Morton,5364,2,18,11,7,54,36,18,65
Falkirk,5364,3,16,10,10,60,43,17,58
Dundee Utd,5364,4,15,11,10,52,46,6,56
Queen of S't,5364,5,11,11,14,47,50,-3,44
Raith,5364,6,11,9,16,36,46,-10,42
Dumbarton,5364,7,9,13,14,52,59,-7,40
Dunfermline,5364,8,8,14,14,42,49,-7,38
Ayr,5364,9,8,13,15,36,56,-20,37
St Mirren,5364,10,7,11,18,35,60,-25,32
Hibernian,5365,1,19,13,4,54,23,31,70
Dundee Utd,5365,2,17,9,10,54,39,15,60
Morton,5365,3,16,10,10,48,40,8,58
Falkirk,5365,4,15,11,10,55,45,10,56
Dunfermline,5365,5,12,13,11,48,45,3,49
Queen of S't,5365,6,12,10,14,46,46,0,46
Dumbarton,5365,7,10,11,15,47,53,-6,41
St Mirren,5365,8,9,10,17,38,56,-18,37
Raith,5365,9,8,11,17,37,55,-18,35
Ayr,5365,10,7,12,17,32,57,-25,33
Hibernian,5366,1,19,11,6,61,31,30,68
Morton,5366,2,18,10,8,53,37,16,64
Falkirk,5366,3,17,10,9,68,49,19,61
Dundee Utd,5366,4,16,9,11,50,42,8,57
Queen of S't,5366,5,11,11,14,45,54,-9,44
Dunfermline,5366,6,10,13,13,49,53,-4,43
Raith,5366,7,10,10,16,44,55,-11,40
Ayr,5366,8,8,15,13,40,54,-14,39
Dumbarton,5366,9,8,12,16,46,58,-12,36
St Mirren,5366,10,7,11,18,41,64,-23,32
Morton,5367,1,18,13,5,51,32,19,67
Hibernian,5367,2,17,13,6,56,28,28,64
Falkirk,5367,3,16,10,10,60,44,16,58
Dundee Utd,5367,4,16,10,10,54,44,10,58
Queen of S't,5367,5,12,9,15,47,50,-3,45
Ayr,5367,6,9,13,14,35,53,-18,40
St Mirren,5367,7,9,12,15,44,57,-13,39
Dunfermline,5367,8,9,11,16,42,52,-10,38
Dumbarton,5367,9,9,11,16,50,61,-11,38
Raith,5367,10,10,8,18,35,53,-18,38
Hibernian,5368,1,18,12,6,59,29,30,66
Morton,5368,2,15,14,7,51,38,13,59
Falkirk,5368,3,15,11,10,57,43,14,56
Dundee Utd,5368,4,14,13,9,51,42,9,55
Queen of S't,5368,5,15,9,12,53,47,6,54
Dunfermline,5368,6,10,14,12,47,48,-1,44
Dumbarton,5368,7,10,11,15,54,62,-8,41
St Mirren,5368,8,8,13,15,39,53,-14,37
Raith,5368,9,8,11,17,32,51,-19,35
Ayr,5368,10,7,12,17,32,62,-30,33
Hibernian,5369,1,19,14,3,56,24,32,71
Morton,5369,2,17,12,7,49,33,16,63
Falkirk,5369,3,16,10,10,57,41,16,58
Dundee Utd,5369,4,16,10,10,48,39,9,58
Queen of S't,5369,5,14,8,14,45,46,-1,50
St Mirren,5369,6,10,12,14,43,51,-8,42
Dunfermline,5369,7,9,12,15,44,49,-5,39
Dumbarton,5369,8,8,11,17,43,58,-15,35
Raith,5369,9,8,11,17,30,49,-19,35
Ayr,5369,10,7,12,17,33,58,-25,33
Morton,5370,1,19,11,6,51,30,21,68
Hibernian,5370,2,17,15,4,55,27,28,66
Dundee Utd,5370,3,18,8,10,53,41,12,62
Falkirk,5370,4,16,11,9,59,42,17,59
Dunfermline,5370,5,10,14,12,46,47,-1,44
Queen of S't,5370,6,10,11,15,42,51,-9,41
Raith,5370,7,9,10,17,35,50,-15,37
St Mirren,5370,8,9,9,18,44,59,-15,36
Ayr,5370,9,8,12,16,32,56,-24,36
Dumbarton,5370,10,8,11,17,47,61,-14,35
Hibernian,5371,1,19,12,5,52,22,30,69
Morton,5371,2,17,11,8,53,36,17,62
Dundee Utd,5371,3,17,8,11,53,41,12,59
Falkirk,5371,4,15,10,11,55,45,10,55
Queen of S't,5371,5,11,10,15,45,51,-6,43
St Mirren,5371,6,11,10,15,44,51,-7,43
Dunfermline,5371,7,10,12,14,47,51,-4,42
Raith,5371,8,11,9,16,38,49,-11,42
Ayr,5371,9,9,11,16,36,56,-20,38
Dumbarton,5371,10,7,13,16,46,67,-21,34
Hibernian,5372,1,22,11,3,63,22,41,77
Morton,5372,2,16,11,9,49,37,12,59
Dundee Utd,5372,3,15,10,11,46,43,3,55
Falkirk,5372,4,14,12,10,55,39,16,54
Queen of S't,5372,5,12,11,13,43,48,-5,47
Dunfermline,5372,6,10,12,14,48,49,-1,42
St Mirren,5372,7,10,10,16,39,53,-14,40
Raith,5372,8,9,11,16,30,48,-18,38
Dumbarton,5372,9,9,10,17,45,60,-15,37
Ayr,5372,10,8,12,16,33,52,-19,36
Hibernian,5373,1,21,11,4,62,22,40,74
Falkirk,5373,2,17,11,8,60,40,20,62
Morton,5373,3,15,14,7,53,41,12,59
Dundee Utd,5373,4,14,10,12,47,41,6,52
Dunfermline,5373,5,11,13,12,46,45,1,46
Raith,5373,6,10,11,15,36,49,-13,41
Queen of S't,5373,7,10,10,16,39,53,-14,40
Dumbarton,5373,8,9,12,15,45,57,-12,39
St Mirren,5373,9,8,11,17,42,57,-15,35
Ayr,5373,10,8,11,17,32,57,-25,35
Hibernian,5374,1,20,12,4,56,26,30,72
Falkirk,5374,2,18,9,9,62,42,20,63
Morton,5374,3,16,13,7,50,33,17,61
Dundee Utd,5374,4,13,13,10,52,42,10,52
Queen of S't,5374,5,13,10,13,50,48,2,49
Dumbarton,5374,6,9,13,14,49,55,-6,40
Dunfermline,5374,7,9,13,14,47,58,-11,40
Raith,5374,8,10,8,18,32,50,-18,38
Ayr,5374,9,7,14,15,35,58,-23,35
St Mirren,5374,10,7,11,18,37,58,-21,32
Hibernian,5375,1,21,11,4,57,23,34,74
Morton,5375,2,16,12,8,50,36,14,60
Falkirk,5375,3,16,11,9,58,43,15,59
Dundee Utd,5375,4,13,11,12,46,48,-2,50
Queen of S't,5375,5,11,11,14,44,47,-3,44
Dumbarton,5375,6,10,14,12,48,52,-4,44
Dunfermline,5375,7,10,12,14,49,49,0,42
St Mirren,5375,8,9,10,17,40,53,-13,37
Ayr,5375,9,8,13,15,35,56,-21,37
Raith,5375,10,9,9,18,36,56,-20,36
Morton,5376,1,20,10,6,65,36,29,70
Hibernian,5376,2,17,12,7,55,29,26,63
Falkirk,5376,3,17,10,9,64,40,24,61
Dundee Utd,5376,4,14,12,10,48,41,7,54
Dunfermline,5376,5,11,13,12,48,52,-4,46
Queen of S't,5376,6,12,8,16,45,54,-9,44
Raith,5376,7,11,10,15,38,50,-12,43
Dumbarton,5376,8,9,12,15,49,60,-11,39
St Mirren,5376,9,8,11,17,41,62,-21,35
Ayr,5376,10,7,10,19,32,61,-29,31
Hibernian,5377,1,18,13,5,55,26,29,67
Morton,5377,2,18,12,6,55,36,19,66
Falkirk,5377,3,15,14,7,61,42,19,59
Dundee Utd,5377,4,15,10,11,50,45,5,55
Raith,5377,5,12,8,16,43,50,-7,44
Dumbarton,5377,6,10,13,13,51,59,-8,43
Dunfermline,5377,7,10,11,15,46,50,-4,41
Ayr,5377,8,9,12,15,40,58,-18,39
Queen of S't,5377,9,9,9,18,41,57,-16,36
St Mirren,5377,10,8,10,18,43,62,-19,34
Hibernian,5378,1,20,11,5,56,27,29,71
Dundee Utd,5378,2,17,9,10,55,45,10,60
Falkirk,5378,3,15,10,11,60,47,13,55
Morton,5378,4,14,12,10,51,41,10,54
Dunfermline,5378,5,13,13,10,54,45,9,52
Raith,5378,6,10,10,16,39,53,-14,40
Dumbarton,5378,7,9,12,15,48,58,-10,39
St Mirren,5378,8,10,9,17,43,57,-14,39
Ayr,5378,9,9,12,15,39,56,-17,39
Queen of S't,5378,10,10,8,18,42,58,-16,38
Hibernian,5379,1,20,12,4,61,24,37,72
Dundee Utd,5379,2,18,8,10,50,36,14,62
Falkirk,5379,3,17,10,9,61,39,22,61
Morton,5379,4,14,14,8,44,34,10,56
Dunfermline,5379,5,9,16,11,45,46,-1,43
Queen of S't,5379,6,11,9,16,43,53,-10,42
Dumbarton,5379,7,10,11,15,49,57,-8,41
Ayr,5379,8,9,11,16,35,53,-18,38
St Mirren,5379,9,8,11,17,39,61,-22,35
Raith,5379,10,8,10,18,30,54,-24,34
Hibernian,5380,1,19,13,4,54,25,29,70
Morton,5380,2,17,11,8,53,37,16,62
Falkirk,5380,3,16,11,9,58,40,18,59
Dundee Utd,5380,4,15,11,10,55,43,12,56
Queen of S't,5380,5,13,9,14,46,46,0,48
Ayr,5380,6,12,12,12,40,48,-8,48
Dunfermline,5380,7,7,16,13,43,49,-6,37
St Mirren,5380,8,8,11,17,40,59,-19,35
Raith,5380,9,8,10,18,35,54,-19,34
Dumbarton,5380,10,8,10,18,42,65,-23,34
Hibernian,5381,1,17,11,8,53,34,19,62
Falkirk,5381,2,17,10,9,62,39,23,61
Morton,5381,3,15,12,9,54,42,12,57
Dundee Utd,5381,4,14,10,12,43,40,3,52
Queen of S't,5381,5,12,9,15,41,49,-8,45
Raith,5381,6,11,11,14,35,46,-11,44
Ayr,5381,7,10,13,13,43,54,-11,43
Dumbarton,5381,8,10,11,15,46,57,-11,41
Dunfermline,5381,9,9,13,14,49,53,-4,40
St Mirren,5381,10,10,10,16,41,53,-12,40
Hibernian,5382,1,19,11,6,56,26,30,68
Dundee Utd,5382,2,19,9,8,54,37,17,66
Morton,5382,3,17,10,9,52,41,11,61
Falkirk,5382,4,15,13,8,56,37,19,58
Dunfermline,5382,5,10,15,11,45,46,-1,45
Queen of S't,5382,6,11,10,15,42,48,-6,43
Dumbarton,5382,7,10,12,14,49,54,-5,42
Raith,5382,8,9,11,16,34,51,-17,38
St Mirren,5382,9,8,10,18,41,60,-19,34
Ayr,5382,10,6,11,19,29,58,-29,29
Hibernian,5383,1,18,13,5,56,28,28,67
Morton,5383,2,18,12,6,53,33,20,66
Dundee Utd,5383,3,17,8,11,60,45,15,59
Falkirk,5383,4,14,11,11,56,48,8,53
Queen of S't,5383,5,12,11,13,53,54,-1,47
Ayr,5383,6,11,10,15,35,56,-21,43
Dunfermline,5383,7,10,12,14,50,53,-3,42
Dumbarton,5383,8,8,13,15,52,64,-12,37
Raith,5383,9,9,10,17,38,52,-14,37
St Mirren,5383,10,8,10,18,41,61,-20,34
Hibernian,5384,1,20,12,4,53,24,29,72
Morton,5384,2,17,12,7,51,33,18,63
Falkirk,5384,3,16,11,9,59,43,16,59
Dundee Utd,5384,4,15,10,11,50,42,8,55
Queen of S't,5384,5,14,8,14,50,48,2,50
Dunfermline,5384,6,10,12,14,43,49,-6,42
St Mirren,5384,7,9,11,16,44,57,-13,38
Raith,5384,8,9,11,16,32,48,-16,38
Ayr,5384,9,8,12,16,32,54,-22,36
Dumbarton,5384,10,7,11,18,44,60,-16,32
Hibernian,5385,1,21,11,4,59,25,34,74
Falkirk,5385,2,18,9,9,66,42,24,63
Morton,5385,3,16,12,8,44,32,12,60
Dundee Utd,5385,4,15,10,11,52,42,10,55
Dunfermline,5385,5,10,13,13,47,51,-4,43
Dumbarton,5385,6,9,13,14,48,61,-13,40
Queen of S't,5385,7,10,10,16,47,61,-14,40
Ayr,5385,8,9,13,14,41,55,-14,40
Raith,5385,9,10,9,17,36,48,-12,39
St Mirren,5385,10,7,10,19,37,60,-23,31
Hibernian,5386,1,19,13,4,54,25,29,70
Falkirk,5386,2,18,11,7,65,37,28,65
Morton,5386,3,17,10,9,49,37,12,61
Dundee Utd,5386,4,17,9,10,55,39,16,60
Dunfermline,5386,5,11,13,12,47,44,3,46
Raith,5386,6,12,8,16,41,47,-6,44
Queen of S't,5386,7,10,10,16,41,57,-16,40
Dumbarton,5386,8,8,11,17,48,67,-19,35
Ayr,5386,9,8,11,17,34,61,-27,35
St Mirren,5386,10,7,10,19,39,59,-20,31
Hibernian,5387,1,21,11,4,60,27,33,74
Morton,5387,2,19,10,7,57,38,19,67
Dundee Utd,5387,3,17,9,10,52,37,15,60
Falkirk,5387,4,15,12,9,59,41,18,57
Queen of S't,5387,5,11,8,17,47,57,-10,41
Raith,5387,6,10,9,17,36,53,-17,39
Dunfermline,5387,7,8,14,14,48,55,-7,38
Dumbarton,5387,8,9,11,16,47,59,-12,38
St Mirren,5387,9,9,11,16,41,57,-16,38
Ayr,5387,10,8,11,17,37,60,-23,35
Hibernian,5388,1,21,12,3,55,20,35,75
Falkirk,5388,2,16,11,9,59,42,17,59
Morton,5388,3,16,11,9,46,37,9,59
Dundee Utd,5388,4,15,11,10,46,35,11,56
Dunfermline,5388,5,10,12,14,42,48,-6,42
Queen of S't,5388,6,11,9,16,43,50,-7,42
St Mirren,5388,7,10,9,17,41,54,-13,39
Dumbarton,5388,8,9,11,16,47,57,-10,38
Ayr,5388,9,8,14,14,31,52,-21,38
Raith,5388,10,9,10,17,34,49,-15,37
Hibernian,5389,1,20,12,4,62,27,35,72
Morton,5389,2,16,12,8,49,38,11,60
Dundee Utd,5389,3,16,11,9,52,38,14,59
Falkirk,5389,4,15,13,8,60,39,21,58
Queen of S't,5389,5,12,9,15,45,54,-9,45
St Mirren,5389,6,10,12,14,50,56,-6,42
Raith,5389,7,11,9,16,36,50,-14,42
Dunfermline,5389,8,8,14,14,45,52,-7,38
Dumbarton,5389,9,7,14,15,46,61,-15,35
Ayr,5389,10,6,12,18,33,63,-30,30
Hibernian,5390,1,19,13,4,54,25,29,70
Falkirk,5390,2,18,9,9,62,38,24,63
Dundee Utd,5390,3,17,9,10,55,40,15,60
Morton,5390,4,15,12,9,59,48,11,57
Dunfermline,5390,5,12,13,11,55,53,2,49
Queen of S't,5390,6,11,10,15,45,51,-6,43
Raith,5390,7,10,11,15,38,48,-10,41
Ayr,5390,8,8,13,15,34,54,-20,37
Dumbarton,5390,9,7,13,16,47,62,-15,34
St Mirren,5390,10,6,11,19,36,66,-30,29
Hibernian,5391,1,21,11,4,59,24,35,74
Morton,5391,2,17,11,8,53,38,15,62
Dundee Utd,5391,3,17,10,9,52,34,18,61
Falkirk,5391,4,16,10,10,61,44,17,58
Dumbarton,5391,5,11,11,14,48,59,-11,44
Dunfermline,5391,6,10,13,13,48,49,-1,43
Queen of S't,5391,7,10,10,16,40,52,-12,40
Raith,5391,8,9,10,17,31,51,-20,37
Ayr,5391,9,8,12,16,36,55,-19,36
St Mirren,5391,10,7,10,19,38,60,-22,31
Hibernian,5392,1,19,13,4,60,29,31,70
Dundee Utd,5392,2,17,10,9,55,38,17,61
Morton,5392,3,16,11,9,51,38,13,59
Falkirk,5392,4,15,11,10,54,43,11,56
Queen of S't,5392,5,13,11,12,45,46,-1,50
Dunfermline,5392,6,10,13,13,46,49,-3,43
Dumbarton,5392,7,9,12,15,46,55,-9,39
Raith,5392,8,10,9,17,34,49,-15,39
St Mirren,5392,9,8,11,17,40,58,-18,35
Ayr,5392,10,6,13,17,33,59,-26,31
Hibernian,5393,1,18,13,5,59,30,29,67
Morton,5393,2,18,10,8,49,34,15,64
Falkirk,5393,3,17,11,8,58,39,19,62
Dundee Utd,5393,4,16,10,10,48,36,12,58
Queen of S't,5393,5,13,8,15,44,51,-7,47
Dunfermline,5393,6,10,11,15,43,52,-9,41
Raith,5393,7,10,10,16,39,49,-10,40
Dumbarton,5393,8,9,11,16,46,55,-9,38
Ayr,5393,9,9,11,16,33,53,-20,38
St Mirren,5393,10,7,11,18,38,58,-20,32
Hibernian,5394,1,21,11,4,57,26,31,74
Dundee Utd,5394,2,17,10,9,50,37,13,61
Falkirk,5394,3,16,11,9,58,38,20,59
Morton,5394,4,16,10,10,49,39,10,58
Dunfermline,5394,5,10,12,14,46,52,-6,42
Raith,5394,6,11,9,16,38,51,-13,42
St Mirren,5394,7,10,10,16,39,51,-12,40
Dumbarton,5394,8,9,11,16,49,57,-8,38
Ayr,5394,9,8,13,15,31,51,-20,37
Queen of S't,5394,10,9,9,18,40,55,-15,36
Hibernian,5395,1,19,12,5,59,28,31,69
Morton,5395,2,16,14,6,49,34,15,62
Falkirk,5395,3,16,10,10,61,47,14,58
Dundee Utd,5395,4,16,10,10,50,38,12,58
Dunfermline,5395,5,11,12,13,51,50,1,45
Queen of S't,5395,6,12,8,16,48,54,-6,44
Raith,5395,7,10,10,16,38,53,-15,40
Ayr,5395,8,9,12,15,39,55,-16,39
Dumbarton,5395,9,8,12,16,51,67,-16,36
St Mirren,5395,10,7,12,17,39,59,-20,33
Morton,5396,1,19,10,7,53,36,17,67
Hibernian,5396,2,17,13,6,52,28,24,64
Dundee Utd,5396,3,16,10,10,50,37,13,58
Falkirk,5396,4,15,10,11,56,44,12,55
Raith,5396,5,13,9,14,39,47,-8,48
Queen of S't,5396,6,12,10,14,43,48,-5,46
Dunfermline,5396,7,9,13,14,42,47,-5,40
St Mirren,5396,8,9,11,16,45,52,-7,38
Dumbarton,5396,9,8,12,16,44,59,-15,36
Ayr,5396,10,7,12,17,29,55,-26,33
Hibernian,5397,1,19,12,5,57,26,31,69
Falkirk,5397,2,18,10,8,63,39,24,64
Morton,5397,3,16,11,9,46,35,11,59
Dundee Utd,5397,4,16,10,10,52,44,8,58
Queen of S't,5397,5,13,8,15,48,50,-2,47
Dumbarton,5397,6,11,10,15,53,57,-4,43
Raith,5397,7,10,10,16,36,52,-16,40
Ayr,5397,8,9,12,15,36,53,-17,39
Dunfermline,5397,9,8,13,15,39,49,-10,37
St Mirren,5397,10,7,10,19,38,63,-25,31
Hibernian,5398,1,19,13,4,62,27,35,70
Falkirk,5398,2,18,10,8,61,41,20,64
Morton,5398,3,16,11,9,55,40,15,59
Dundee Utd,5398,4,16,10,10,51,41,10,58
Queen of S't,5398,5,12,9,15,49,52,-3,45
Dunfermline,5398,6,9,13,14,44,56,-12,40
St Mirren,5398,7,10,10,16,43,55,-12,40
Ayr,5398,8,9,12,15,37,54,-17,39
Raith,5398,9,9,10,17,33,51,-18,37
Dumbarton,5398,10,7,12,17,43,61,-18,33
Hibernian,5399,1,19,13,4,59,27,32,70
Falkirk,5399,2,18,9,9,65,39,26,63
Morton,5399,3,17,11,8,45,35,10,62
Dundee Utd,5399,4,14,11,11,50,42,8,53
Dumbarton,5399,5,11,12,13,50,54,-4,45
Dunfermline,5399,6,9,14,13,43,47,-4,41
Ayr,5399,7,9,12,15,36,54,-18,39
Queen of S't,5399,8,10,8,18,42,54,-12,38
Raith,5399,9,10,8,18,34,52,-18,38
St Mirren,5399,10,8,12,16,40,60,-20,36
Hibernian,5400,1,18,14,4,55,27,28,68
Morton,5400,2,17,11,8,52,36,16,62
Falkirk,5400,3,16,11,9,57,39,18,59
Dundee Utd,5400,4,14,10,12,45,45,0,52
Dunfermline,5400,5,11,13,12,48,46,2,46
Ayr,5400,6,11,11,14,35,48,-13,44
Queen of S't,5400,7,11,10,15,40,46,-6,43
Dumbarton,5400,8,9,11,16,45,56,-11,38
St Mirren,5400,9,9,10,17,38,54,-16,37
Raith,5400,10,9,9,18,30,48,-18,36
Hibernian,5401,1,21,10,5,59,25,34,73
Morton,5401,2,16,13,7,47,34,13,61
Dundee Utd,5401,3,14,13,9,52,41,11,55
Falkirk,5401,4,13,12,11,53,46,7,51
Dumbarton,5401,5,11,11,14,50,54,-4,44
Queen of S't,5401,6,11,10,15,41,50,-9,43
Raith,5401,7,11,8,17,38,51,-13,41
Ayr,5401,8,9,14,13,37,52,-15,41
Dunfermline,5401,9,9,12,15,41,49,-8,39
St Mirren,5401,10,7,13,16,36,52,-16,34
Hibernian,5402,1,20,12,4,58,24,34,72
Morton,5402,2,17,10,9,51,40,11,61
Dundee Utd,5402,3,16,8,12,50,38,12,56
Falkirk,5402,4,14,11,11,54,45,9,53
Dunfermline,5402,5,11,13,12,43,46,-3,46
Dumbarton,5402,6,11,11,14,52,55,-3,44
Queen of S't,5402,7,11,11,14,45,51,-6,44
Raith,5402,8,9,11,16,34,49,-15,38
Ayr,5402,9,9,11,16,33,52,-19,38
St Mirren,5402,10,7,12,17,39,59,-20,33
Hibernian,5403,1,18,12,6,53,27,26,66
Morton,5403,2,17,11,8,51,34,17,62
Falkirk,5403,3,17,10,9,67,42,25,61
Dundee Utd,5403,4,15,10,11,52,50,2,55
Dunfermline,5403,5,10,14,12,51,49,2,44
Queen of S't,5403,6,11,10,15,43,54,-11,43
Ayr,5403,7,10,13,13,42,53,-11,43
Raith,5403,8,10,9,17,34,52,-18,39
Dumbarton,5403,9,8,13,15,50,60,-10,37
St Mirren,5403,10,8,10,18,39,61,-22,34
Hibernian,5404,1,18,11,7,57,30,27,65
Morton,5404,2,16,11,9,47,37,10,59
Falkirk,5404,3,16,10,10,59,45,14,58
Dundee Utd,5404,4,15,11,10,52,45,7,56
Queen of S't,5404,5,13,10,13,48,50,-2,49
Dunfermline,5404,6,11,13,12,48,46,2,46
St Mirren,5404,7,11,9,16,45,56,-11,42
Dumbarton,5404,8,9,11,16,48,60,-12,38
Raith,5404,9,9,10,17,38,55,-17,37
Ayr,5404,10,8,12,16,38,56,-18,36
Hibernian,5405,1,19,12,5,55,28,27,69
Dundee Utd,5405,2,19,8,9,53,34,19,65
Falkirk,5405,3,18,10,8,62,38,24,64
Morton,5405,4,16,14,6,49,33,16,62
Dunfermline,5405,5,11,13,12,55,45,10,46
Queen of S't,5405,6,10,9,17,40,56,-16,39
Raith,5405,7,9,10,17,30,52,-22,37
Ayr,5405,8,8,12,16,32,53,-21,36
St Mirren,5405,9,8,10,18,39,56,-17,34
Dumbarton,5405,10,7,12,17,46,66,-20,33
Hibernian,5406,1,19,11,6,54,25,29,68
Morton,5406,2,16,12,8,48,37,11,60
Falkirk,5406,3,16,11,9,58,40,18,59
Dundee Utd,5406,4,17,8,11,53,43,10,59
Queen of S't,5406,5,13,9,14,50,48,2,48
Dumbarton,5406,6,11,10,15,51,59,-8,43
Ayr,5406,7,11,10,15,38,52,-14,43
Raith,5406,8,10,10,16,32,46,-14,40
Dunfermline,5406,9,8,15,13,42,50,-8,39
St Mirren,5406,10,6,10,20,36,62,-26,28
Hibernian,5407,1,18,13,5,56,26,30,67
Falkirk,5407,2,16,11,9,60,38,22,59
Morton,5407,3,14,15,7,44,32,12,57
Dundee Utd,5407,4,14,12,10,49,38,11,54
Dumbarton,5407,5,11,10,15,55,64,-9,43
Raith,5407,6,11,10,15,36,50,-14,43
Ayr,5407,7,10,12,14,36,53,-17,42
Dunfermline,5407,8,9,14,13,48,52,-4,41
Queen of S't,5407,9,10,10,16,46,56,-10,40
St Mirren,5407,10,9,9,18,41,62,-21,36
Hibernian,5408,1,20,11,5,58,30,28,71
Morton,5408,2,17,10,9,52,41,11,61
Dundee Utd,5408,3,17,9,10,47,37,10,60
Falkirk,5408,4,14,11,11,57,47,10,53
Raith,5408,5,12,9,15,42,51,-9,45
Dumbarton,5408,6,10,12,14,52,55,-3,42
Dunfermline,5408,7,10,11,15,45,51,-6,41
Queen of S't,5408,8,11,8,17,43,51,-8,41
St Mirren,5408,9,9,11,16,43,56,-13,38
Ayr,5408,10,8,12,16,35,55,-20,36
Dundee Utd,5409,1,18,10,8,54,36,18,64
Hibernian,5409,2,17,12,7,53,27,26,63
Falkirk,5409,3,16,12,8,62,40,22,60
Morton,5409,4,14,13,9,44,41,3,55
Dunfermline,5409,5,12,12,12,51,47,4,48
Dumbarton,5409,6,9,14,13,47,54,-7,41
Raith,5409,7,10,11,15,36,46,-10,41
Queen of S't,5409,8,11,8,17,41,56,-15,41
Ayr,5409,9,9,11,16,32,55,-23,38
St Mirren,5409,10,7,11,18,34,52,-18,32
Hibernian,5410,1,22,10,4,55,22,33,76
Falkirk,5410,2,18,9,9,58,40,18,63
Dundee Utd,5410,3,18,9,9,55,37,18,63
Morton,5410,4,16,13,7,46,33,13,61
Queen of S't,5410,5,12,9,15,44,48,-4,45
Dunfermline,5410,6,9,13,14,48,47,1,40
Raith,5410,7,9,10,17,30,48,-18,37
Ayr,5410,8,8,12,16,32,54,-22,36
St Mirren,5410,9,7,12,17,36,53,-17,33
Dumbarton,5410,10,7,11,18,41,63,-22,32
Hibernian,5411,1,20,11,5,64,26,38,71
Falkirk,5411,2,17,11,8,62,42,20,62
Morton,5411,3,14,14,8,46,43,3,56
Dundee Utd,5411,4,15,10,11,45,39,6,55
Ayr,5411,5,12,10,14,39,49,-10,46
Queen of S't,5411,6,11,11,14,42,47,-5,44
Dumbarton,5411,7,10,13,13,48,50,-2,43
Raith,5411,8,10,10,16,36,51,-15,40
Dunfermline,5411,9,7,14,15,44,57,-13,35
St Mirren,5411,10,6,12,18,36,58,-22,30
Hibernian,5412,1,20,12,4,60,24,36,72
Morton,5412,2,17,12,7,48,36,12,63
Falkirk,5412,3,15,12,9,58,41,17,57
Dundee Utd,5412,4,13,12,11,48,44,4,51
Raith,5412,5,13,9,14,41,49,-8,48
Dunfermline,5412,6,9,14,13,48,51,-3,41
Queen of S't,5412,7,10,11,15,43,51,-8,41
Ayr,5412,8,9,12,15,40,58,-18,39
Dumbarton,5412,9,8,13,15,50,62,-12,37
St Mirren,5412,10,8,9,19,42,62,-20,33
Hibernian,5413,1,19,13,4,56,25,31,70
Morton,5413,2,16,10,10,47,36,11,58
Dundee Utd,5413,3,15,11,10,50,38,12,56
Falkirk,5413,4,14,13,9,54,40,14,55
Queen of S't,5413,5,12,11,13,43,45,-2,47
Dunfermline,5413,6,10,14,12,43,42,1,44
Dumbarton,5413,7,11,11,14,47,57,-10,44
Ayr,5413,8,9,12,15,34,52,-18,39
Raith,5413,9,9,10,17,36,52,-16,37
St Mirren,5413,10,8,9,19,39,62,-23,33
Hibernian,5414,1,20,13,3,59,24,35,73
Morton,5414,2,17,12,7,49,33,16,63
Falkirk,5414,3,14,12,10,55,43,12,54
Dundee Utd,5414,4,14,12,10,46,39,7,54
Dunfermline,5414,5,11,13,12,48,47,1,46
St Mirren,5414,6,10,12,14,45,51,-6,42
Queen of S't,5414,7,10,9,17,46,59,-13,39
Raith,5414,8,9,12,15,35,51,-16,39
Ayr,5414,9,9,12,15,35,53,-18,39
Dumbarton,5414,10,7,11,18,43,61,-18,32
Hibernian,5415,1,18,13,5,56,26,30,67
Morton,5415,2,17,11,8,46,32,14,62
Dundee Utd,5415,3,16,9,11,51,39,12,57
Falkirk,5415,4,14,11,11,56,49,7,53
Queen of S't,5415,5,12,11,13,53,49,4,47
Ayr,5415,6,10,12,14,39,55,-16,42
Dumbarton,5415,7,10,11,15,50,63,-13,41
St Mirren,5415,8,10,9,17,42,60,-18,39
Raith,5415,9,10,9,17,35,53,-18,39
Dunfermline,5415,10,8,14,14,49,51,-2,38
Hibernian,5416,1,18,13,5,53,29,24,67
Dundee Utd,5416,2,18,10,8,54,37,17,64
Falkirk,5416,3,17,12,7,58,35,23,63
Morton,5416,4,15,11,10,46,38,8,56
Queen of S't,5416,5,13,10,13,53,51,2,49
Dunfermline,5416,6,10,13,13,43,47,-4,43
Raith,5416,7,11,8,17,41,53,-12,41
St Mirren,5416,8,8,11,17,39,57,-18,35
Dumbarton,5416,9,8,10,18,43,61,-18,34
Ayr,5416,10,8,10,18,33,55,-22,34
Hibernian,5417,1,20,11,5,53,25,28,71
Morton,5417,2,18,9,9,51,37,14,63
Falkirk,5417,3,15,11,10,57,40,17,56
Dundee Utd,5417,4,15,11,10,48,40,8,56
Queen of S't,5417,5,12,10,14,44,48,-4,46
Dunfermline,5417,6,10,12,14,46,47,-1,42
St Mirren,5417,7,10,10,16,45,53,-8,40
Dumbarton,5417,8,9,12,15,46,60,-14,39
Raith,5417,9,10,9,17,35,51,-16,39
Ayr,5417,10,7,13,16,34,58,-24,34
Hibernian,5418,1,20,11,5,57,27,30,71
Morton,5418,2,16,13,7,55,38,17,61
Falkirk,5418,3,16,10,10,55,40,15,58
Dundee Utd,5418,4,15,8,13,50,39,11,53
Queen of S't,5418,5,12,8,16,48,54,-6,44
Dunfermline,5418,6,10,13,13,45,50,-5,43
Dumbarton,5418,7,11,10,15,48,59,-11,43
St Mirren,5418,8,11,9,16,43,55,-12,42
Raith,5418,9,10,10,16,35,49,-14,40
Ayr,5418,10,8,10,18,35,60,-25,34
Hibernian,5419,1,19,13,4,55,27,28,70
Dundee Utd,5419,2,17,9,10,50,41,9,60
Falkirk,5419,3,16,10,10,57,40,17,58
Morton,5419,4,15,12,9,46,40,6,57
Queen of S't,5419,5,12,11,13,47,46,1,47
Dunfermline,5419,6,11,12,13,51,49,2,45
Raith,5419,7,11,9,16,38,49,-11,42
Dumbarton,5419,8,9,12,15,48,60,-12,39
St Mirren,5419,9,8,11,17,39,54,-15,35
Ayr,5419,10,6,13,17,32,57,-25,31
Hibernian,5420,1,20,11,5,57,30,27,71
Falkirk,5420,2,18,9,9,58,36,22,63
Dundee Utd,5420,3,18,8,10,56,40,16,62
Morton,5420,4,15,12,9,49,38,11,57
Dunfermline,5420,5,10,12,14,47,50,-3,42
Dumbarton,5420,6,10,12,14,47,56,-9,42
Queen of S't,5420,7,11,9,16,43,52,-9,42
St Mirren,5420,8,9,11,16,43,58,-15,38
Raith,5420,9,9,10,17,37,50,-13,37
Ayr,5420,10,8,10,18,35,62,-27,34
Hibernian,5421,1,18,13,5,55,25,30,67
Falkirk,5421,2,16,11,9,59,42,17,59
Morton,5421,3,16,11,9,51,43,8,59
Dundee Utd,5421,4,16,8,12,50,38,12,56
Dunfermline,5421,5,11,11,14,49,51,-2,44
Dumbarton,5421,6,10,14,12,47,52,-5,44
Queen of S't,5421,7,11,9,16,44,52,-8,42
Ayr,5421,8,10,12,14,33,48,-15,42
Raith,5421,9,9,11,16,35,49,-14,38
St Mirren,5421,10,8,10,18,35,58,-23,34
Hibernian,5422,1,19,12,5,56,25,31,69
Morton,5422,2,18,10,8,56,42,14,64
Falkirk,5422,3,16,10,10,59,41,18,58
Dundee Utd,5422,4,14,10,12,51,46,5,52
Queen of S't,5422,5,13,9,14,50,52,-2,48
Dunfermline,5422,6,10,13,13,44,48,-4,43
Raith,5422,7,10,12,14,34,45,-11,42
Dumbarton,5422,8,9,11,16,54,69,-15,38
Ayr,5422,9,8,13,15,34,53,-19,37
St Mirren,5422,10,8,10,18,37,54,-17,34
Hibernian,5423,1,18,13,5,52,25,27,67
Morton,5423,2,18,12,6,53,32,21,66
Falkirk,5423,3,15,11,10,51,39,12,56
Dundee Utd,5423,4,13,12,11,44,39,5,51
Raith,5423,5,12,9,15,33,45,-12,45
Dunfermline,5423,6,9,15,12,42,45,-3,42
St Mirren,5423,7,10,10,16,44,57,-13,40
Dumbarton,5423,8,9,12,15,47,55,-8,39
Queen of S't,5423,9,10,8,18,39,51,-12,38
Ayr,5423,10,8,14,14,36,53,-17,38
Hibernian,5424,1,20,12,4,56,27,29,72
Morton,5424,2,17,10,9,50,35,15,61
Dundee Utd,5424,3,16,10,10,54,42,12,58
Falkirk,5424,4,15,11,10,63,46,17,56
Raith,5424,5,13,9,14,42,46,-4,48
Dunfermline,5424,6,10,11,15,43,48,-5,41
Queen of S't,5424,7,10,11,15,47,55,-8,41
Dumbarton,5424,8,9,12,15,43,56,-13,39
Ayr,5424,9,8,12,16,32,53,-21,36
St Mirren,5424,10,8,10,18,38,60,-22,34
Hibernian,5425,1,18,13,5,56,27,29,67
Dundee Utd,5425,2,17,10,9,58,41,17,61
Falkirk,5425,3,16,12,8,59,41,18,60
Morton,5425,4,14,13,9,46,40,6,55
Raith,5425,5,12,9,15,36,47,-11,45
Dumbarton,5425,6,9,14,13,47,58,-11,41
Ayr,5425,7,10,11,15,36,54,-18,41
Queen of S't,5425,8,10,10,16,42,50,-8,40
Dunfermline,5425,9,8,14,14,45,50,-5,38
St Mirren,5425,10,6,14,16,35,52,-17,32
Hibernian,5426,1,22,10,4,62,21,41,76
Falkirk,5426,2,17,9,10,61,45,16,60
Morton,5426,3,16,12,8,52,36,16,60
Dundee Utd,5426,4,16,9,11,51,43,8,57
Queen of S't,5426,5,11,11,14,43,52,-9,44
Raith,5426,6,11,11,14,39,48,-9,44
Dumbarton,5426,7,10,12,14,48,53,-5,42
Dunfermline,5426,8,8,13,15,44,52,-8,37
St Mirren,5426,9,8,10,18,37,56,-19,34
Ayr,5426,10,7,11,18,31,62,-31,32
Hibernian,5427,1,19,11,6,57,25,32,68
Morton,5427,2,16,12,8,49,42,7,60
Dundee Utd,5427,3,17,8,11,54,41,13,59
Falkirk,5427,4,15,10,11,59,44,15,55
Dunfermline,5427,5,11,14,11,52,45,7,47
Raith,5427,6,12,9,15,37,44,-7,45
Dumbarton,5427,7,10,13,13,50,56,-6,43
Ayr,5427,8,9,13,14,33,50,-17,40
Queen of S't,5427,9,10,9,17,41,55,-14,39
St Mirren,5427,10,7,9,20,36,66,-30,30
Hibernian,5428,1,18,12,6,49,27,22,66
Morton,5428,2,18,10,8,54,36,18,64
Falkirk,5428,3,15,10,11,56,40,16,55
Dundee Utd,5428,4,15,10,11,45,39,6,55
Queen of S't,5428,5,11,12,13,46,49,-3,45
Dunfermline,5428,6,10,14,12,43,44,-1,44
Dumbarton,5428,7,10,12,14,46,54,-8,42
Ayr,5428,8,9,12,15,35,53,-18,39
Raith,5428,9,9,11,16,34,50,-16,38
St Mirren,5428,10,8,11,17,39,55,-16,35
Hibernian,5429,1,20,13,3,60,25,35,73
Morton,5429,2,17,11,8,50,37,13,62
Falkirk,5429,3,17,10,9,55,38,17,61
Dundee Utd,5429,4,15,10,11,50,40,10,55
Queen of S't,5429,5,11,9,16,43,51,-8,42
Raith,5429,6,10,12,14,35,47,-12,42
Dunfermline,5429,7,9,14,13,44,46,-2,41
Ayr,5429,8,8,13,15,34,53,-19,37
Dumbarton,5429,9,8,12,16,45,58,-13,36
St Mirren,5429,10,8,10,18,41,62,-21,34
Hibernian,5430,1,19,12,5,60,29,31,69
Falkirk,5430,2,16,11,9,59,40,19,59
Morton,5430,3,16,11,9,54,39,15,59
Dundee Utd,5430,4,16,8,12,50,42,8,56
Queen of S't,5430,5,13,9,14,45,49,-4,48
Dunfermline,5430,6,10,15,11,48,51,-3,45
Dumbarton,5430,7,9,12,15,48,58,-10,39
Raith,5430,8,9,11,16,33,48,-15,38
Ayr,5430,9,8,12,16,35,59,-24,36
St Mirren,5430,10,8,11,17,40,57,-17,35
Hibernian,5431,1,18,14,4,58,27,31,68
Morton,5431,2,16,12,8,51,39,12,60
Falkirk,5431,3,14,12,10,56,45,11,54
Dundee Utd,5431,4,14,10,12,49,43,6,52
Dunfermline,5431,5,13,12,11,51,45,6,51
Queen of S't,5431,6,11,9,16,46,51,-5,42
St Mirren,5431,7,10,11,15,41,52,-11,41
Ayr,5431,8,9,13,14,35,54,-19,40
Raith,5431,9,10,9,17,36,51,-15,39
Dumbarton,5431,10,9,10,17,45,61,-16,37
Hibernian,5432,1,20,12,4,62,26,36,72
Falkirk,5432,2,18,9,9,59,39,20,63
Dundee Utd,5432,3,16,9,11,58,41,17,57
Morton,5432,4,16,9,11,47,44,3,57
Queen of S't,5432,5,13,9,14,47,50,-3,48
Dunfermline,5432,6,11,13,12,45,45,0,46
Raith,5432,7,10,9,17,33,46,-13,39
Ayr,5432,8,8,13,15,37,56,-19,37
Dumbarton,5432,9,8,12,16,46,58,-12,36
St Mirren,5432,10,8,9,19,35,64,-29,33
Hibernian,5433,1,19,10,7,58,34,24,67
Morton,5433,2,17,11,8,51,36,15,62
Falkirk,5433,3,16,10,10,58,43,15,58
Dundee Utd,5433,4,14,9,13,49,43,6,51
Queen of S't,5433,5,13,11,12,46,45,1,50
Dunfermline,5433,6,10,13,13,45,50,-5,43
Dumbarton,5433,7,11,10,15,50,59,-9,43
Raith,5433,8,10,11,15,41,51,-10,41
Ayr,5433,9,9,13,14,36,54,-18,40
St Mirren,5433,10,7,10,19,43,62,-19,31
Hibernian,5434,1,19,13,4,58,26,32,70
Dundee Utd,5434,2,18,10,8,58,37,21,64
Morton,5434,3,16,11,9,47,34,13,59
Falkirk,5434,4,15,11,10,54,41,13,56
Queen of S't,5434,5,11,11,14,47,54,-7,44
Ayr,5434,6,10,13,13,35,55,-20,43
Dunfermline,5434,7,9,15,12,50,52,-2,42
Dumbarton,5434,8,9,10,17,48,61,-13,37
St Mirren,5434,9,8,10,18,36,53,-17,34
Raith,5434,10,8,10,18,34,54,-20,34
Hibernian,5435,1,20,12,4,55,26,29,72
Falkirk,5435,2,17,11,8,63,40,23,62
Morton,5435,3,15,12,9,49,37,12,57
Dundee Utd,5435,4,15,10,11,50,43,7,55
Ayr,5435,5,12,10,14,34,50,-16,46
Raith,5435,6,12,9,15,36,47,-11,45
Dunfermline,5435,7,9,14,13,47,47,0,41
Dumbarton,5435,8,9,10,17,46,57,-11,37
Queen of S't,5435,9,9,9,18,42,58,-16,36
St Mirren,5435,10,8,11,17,41,58,-17,35
Hibernian,5436,1,20,12,4,62,26,36,72
Morton,5436,2,16,13,7,51,39,12,61
Dundee Utd,5436,3,14,13,9,49,41,8,55
Falkirk,5436,4,13,13,10,51,39,12,52
Dunfermline,5436,5,10,15,11,45,45,0,45
Dumbarton,5436,6,10,11,15,47,57,-10,41
Ayr,5436,7,10,11,15,38,55,-17,41
Queen of S't,5436,8,9,13,14,44,51,-7,40
Raith,5436,9,10,9,17,34,50,-16,39
St Mirren,5436,10,7,12,17,37,55,-18,33
Hibernian,5437,1,18,13,5,54,27,27,67
Morton,5437,2,17,10,9,50,38,12,61
Falkirk,5437,3,16,12,8,59,39,20,60
Dundee Utd,5437,4,15,12,9,49,39,10,57
Queen of S't,5437,5,13,9,14,45,49,-4,48
Ayr,5437,6,10,12,14,37,51,-14,42
Raith,5437,7,11,9,16,35,49,-14,42
Dunfermline,5437,8,9,11,16,41,48,-7,38
St Mirren,5437,9,8,12,16,40,53,-13,36
Dumbarton,5437,10,8,10,18,45,62,-17,34
Hibernian,5438,1,19,11,6,56,26,30,68
Morton,5438,2,18,11,7,55,37,18,65
Falkirk,5438,3,16,11,9,59,41,18,59
Dundee Utd,5438,4,15,11,10,49,41,8,56
Dunfermline,5438,5,11,14,11,49,49,0,47
Raith,5438,6,12,9,15,36,45,-9,45
Queen of S't,5438,7,12,8,16,45,49,-4,44
Dumbarton,5438,8,8,12,16,48,62,-14,36
St Mirren,5438,9,7,12,17,38,59,-21,33
Ayr,5438,10,6,13,17,32,58,-26,31
Hibernian,5439,1,20,11,5,63,27,36,71
Falkirk,5439,2,19,9,8,63,42,21,66
Morton,5439,3,16,12,8,48,37,11,60
Dundee Utd,5439,4,17,8,11,51,36,15,59
Ayr,5439,5,12,10,14,39,51,-12,46
Raith,5439,6,12,9,15,40,47,-7,45
Queen of S't,5439,7,12,8,16,45,52,-7,44
Dumbarton,5439,8,9,10,17,51,63,-12,37
Dunfermline,5439,9,7,13,16,40,58,-18,34
St Mirren,5439,10,6,10,20,39,66,-27,28
Hibernian,5440,1,18,12,6,48,25,23,66
Morton,5440,2,17,11,8,49,35,14,62
Falkirk,5440,3,16,11,9,56,38,18,59
Dundee Utd,5440,4,14,11,11,50,40,10,53
Dunfermline,5440,5,12,11,13,53,51,2,47
Queen of S't,5440,6,11,11,14,44,49,-5,44
Raith,5440,7,10,11,15,37,47,-10,41
St Mirren,5440,8,10,10,16,44,53,-9,40
Ayr,5440,9,9,10,17,33,61,-28,37
Dumbarton,5440,10,8,12,16,48,63,-15,36
Hibernian,5441,1,19,13,4,60,31,29,70
Morton,5441,2,16,12,8,56,40,16,60
Falkirk,5441,3,16,11,9,58,41,17,59
Dundee Utd,5441,4,16,9,11,52,45,7,57
Dumbarton,5441,5,11,12,13,52,57,-5,45
Dunfermline,5441,6,9,14,13,47,49,-2,41
Queen of S't,5441,7,10,10,16,45,55,-10,40
Ayr,5441,8,8,14,14,36,56,-20,38
Raith,5441,9,9,9,18,35,52,-17,36
St Mirren,5441,10,7,14,15,42,57,-15,35
Hibernian,5442,1,21,10,5,56,23,33,73
Morton,5442,2,17,13,6,52,37,15,64
Falkirk,5442,3,16,9,11,56,41,15,57
Dundee Utd,5442,4,15,8,13,46,42,4,53
Queen of S't,5442,5,11,10,15,48,53,-5,43
Dumbarton,5442,6,10,12,14,53,60,-7,42
Raith,5442,7,10,10,16,36,51,-15,40
St Mirren,5442,8,10,9,17,45,57,-12,39
Dunfermline,5442,9,8,14,14,44,52,-8,38
Ayr,5442,10,9,11,16,36,56,-20,38
Hibernian,5443,1,19,10,7,54,27,27,67
Falkirk,5443,2,18,10,8,57,38,19,64
Dundee Utd,5443,3,17,11,8,53,37,16,62
Morton,5443,4,17,10,9,50,36,14,61
Dunfermline,5443,5,11,13,12,47,45,2,46
Raith,5443,6,10,11,15,33,46,-13,41
Ayr,5443,7,9,13,14,38,54,-16,40
Queen of S't,5443,8,9,11,16,41,51,-10,38
Dumbarton,5443,9,9,11,16,47,61,-14,38
St Mirren,5443,10,6,10,20,33,58,-25,28
Hibernian,5444,1,19,13,4,56,26,30,70
Falkirk,5444,2,18,9,9,61,40,21,63
Dundee Utd,5444,3,16,10,10,52,42,10,58
Morton,5444,4,14,10,12,45,44,1,52
Dunfermline,5444,5,11,13,12,47,47,0,46
St Mirren,5444,6,10,11,15,41,52,-11,41
Queen of S't,5444,7,9,12,15,49,58,-9,39
Raith,5444,8,10,9,17,36,51,-15,39
Ayr,5444,9,9,12,15,34,52,-18,39
Dumbarton,5444,10,9,11,16,52,61,-9,38
Hibernian,5445,1,17,15,4,54,26,28,66
Morton,5445,2,16,12,8,49,40,9,60
Falkirk,5445,3,15,10,11,50,37,13,55
Dundee Utd,5445,4,14,11,11,47,40,7,53
Raith,5445,5,12,9,15,37,44,-7,45
Queen of S't,5445,6,12,8,16,41,53,-12,44
St Mirren,5445,7,11,9,16,38,51,-13,42
Dunfermline,5445,8,9,13,14,40,44,-4,40
Ayr,5445,9,9,13,14,40,55,-15,40
Dumbarton,5445,10,9,12,15,46,52,-6,39
Hibernian,5446,1,21,10,5,62,27,35,73
Falkirk,5446,2,17,10,9,63,42,21,61
Morton,5446,3,16,10,10,49,40,9,58
Dundee Utd,5446,4,16,9,11,57,45,12,57
Queen of S't,5446,5,12,9,15,46,52,-6,45
Dunfermline,5446,6,11,12,13,43,49,-6,45
Ayr,5446,7,10,11,15,39,55,-16,41
St Mirren,5446,8,9,10,17,44,56,-12,37
Dumbarton,5446,9,9,10,17,49,65,-16,37
Raith,5446,10,9,9,18,36,57,-21,36
Hibernian,5447,1,17,12,7,55,29,26,63
Falkirk,5447,2,17,10,9,58,38,20,61
Morton,5447,3,16,12,8,52,40,12,60
Dundee Utd,5447,4,16,11,9,52,40,12,59
Queen of S't,5447,5,11,10,15,42,49,-7,43
Dunfermline,5447,6,9,15,12,48,52,-4,42
St Mirren,5447,7,11,9,16,44,57,-13,42
Ayr,5447,8,9,13,14,33,53,-20,40
Raith,5447,9,9,10,17,36,47,-11,37
Dumbarton,5447,10,8,12,16,46,61,-15,36
Hibernian,5448,1,21,12,3,61,26,35,75
Morton,5448,2,18,11,7,50,34,16,65
Dundee Utd,5448,3,17,9,10,53,42,11,60
Falkirk,5448,4,14,10,12,54,46,8,52
Queen of S't,5448,5,12,11,13,48,48,0,47
Raith,5448,6,11,9,16,37,48,-11,42
Dunfermline,5448,7,9,12,15,43,51,-8,39
Dumbarton,5448,8,9,11,16,45,56,-11,38
St Mirren,5448,9,9,10,17,37,53,-16,37
Ayr,5448,10,7,11,18,32,56,-24,32
Hibernian,5449,1,17,13,6,57,30,27,64
Morton,5449,2,17,12,7,50,37,13,63
Falkirk,5449,3,15,13,8,59,44,15,58
Dundee Utd,5449,4,13,11,12,47,43,4,50
Dunfermline,5449,5,10,14,12,48,47,1,44
Dumbarton,5449,6,11,11,14,50,53,-3,44
Queen of S't,5449,7,10,11,15,44,53,-9,41
St Mirren,5449,8,10,10,16,41,53,-12,40
Ayr,5449,9,8,15,13,34,51,-17,39
Raith,5449,10,8,12,16,33,52,-19,36
Hibernian,5450,1,19,13,4,56,24,32,70
Morton,5450,2,18,11,7,54,33,21,65
Falkirk,5450,3,16,11,9,59,42,17,59
Dundee Utd,5450,4,16,9,11,56,45,11,57
Dunfermline,5450,5,11,12,13,45,47,-2,45
Queen of S't,5450,6,11,10,15,47,55,-8,43
St Mirren,5450,7,9,13,14,39,48,-9,40
Ayr,5450,8,8,12,16,37,56,-19,36
Raith,5450,9,8,12,16,31,51,-20,36
Dumbarton,5450,10,7,11,18,41,64,-23,32
Morton,5451,1,18,12,6,53,34,19,66
Falkirk,5451,2,18,10,8,61,38,23,64
Hibernian,5451,3,17,13,6,50,27,23,64
Dundee Utd,5451,4,15,13,8,47,36,11,58
Queen of S't,5451,5,12,10,14,47,49,-2,46
Dunfermline,5451,6,10,12,14,44,49,-5,42
Raith,5451,7,9,13,14,36,49,-13,40
Ayr,5451,8,8,12,16,35,52,-17,36
St Mirren,5451,9,8,10,18,36,54,-18,34
Dumbarton,5451,10,7,11,18,41,62,-21,32
Hibernian,5452,1,18,12,6,53,25,28,66
Falkirk,5452,2,17,9,10,55,40,15,60
Dundee Utd,5452,3,17,8,11,55,41,14,59
Morton,5452,4,16,11,9,45,38,7,59
Dunfermline,5452,5,11,12,13,47,47,0,45
Ayr,5452,6,11,12,13,35,48,-13,45
Queen of S't,5452,7,12,8,16,41,48,-7,44
Dumbarton,5452,8,10,10,16,47,59,-12,40
St Mirren,5452,9,9,10,17,41,53,-12,37
Raith,5452,10,8,10,18,30,50,-20,34
Hibernian,5453,1,20,12,4,58,25,33,72
Falkirk,5453,2,17,11,8,62,41,21,62
Morton,5453,3,17,10,9,50,40,10,61
Dundee Utd,5453,4,16,9,11,50,40,10,57
Queen of S't,5453,5,12,9,15,49,53,-4,45
Dunfermline,5453,6,9,15,12,45,48,-3,42
Raith,5453,7,11,9,16,38,51,-13,42
Dumbarton,5453,8,9,10,17,45,60,-15,37
Ayr,5453,9,9,10,17,36,56,-20,37
St Mirren,5453,10,8,9,19,38,57,-19,33
Hibernian,5454,1,19,13,4,54,25,29,70
Dundee Utd,5454,2,19,9,8,56,37,19,66
Morton,5454,3,17,10,9,49,36,13,61
Falkirk,5454,4,17,9,10,63,40,23,60
Dumbarton,5454,5,10,12,14,50,57,-7,42
Raith,5454,6,11,9,16,36,46,-10,42
Queen of S't,5454,7,11,9,16,46,57,-11,42
Dunfermline,5454,8,8,12,16,46,61,-15,36
St Mirren,5454,9,8,10,18,35,55,-20,34
Ayr,5454,10,7,13,16,34,55,-21,34
Hibernian,5455,1,20,12,4,56,24,32,72
Morton,5455,2,17,13,6,52,35,17,64
Falkirk,5455,3,15,11,10,58,42,16,56
Dundee Utd,5455,4,15,11,10,47,37,10,56
Raith,5455,5,12,8,16,38,46,-8,44
Dunfermline,5455,6,10,13,13,42,43,-1,43
Queen of S't,5455,7,11,10,15,42,50,-8,43
Dumbarton,5455,8,9,11,16,46,59,-13,38
St Mirren,5455,9,8,10,18,39,58,-19,34
Ayr,5455,10,7,13,16,33,59,-26,34
Hibernian,5456,1,16,13,7,53,32,21,61
Falkirk,5456,2,16,12,8,57,37,20,60
Morton,5456,3,16,11,9,47,37,10,59
Dundee Utd,5456,4,14,11,11,50,43,7,53
Queen of S't,5456,5,11,12,13,46,50,-4,45
Raith,5456,6,12,9,15,40,47,-7,45
Dunfermline,5456,7,10,13,13,44,48,-4,43
Dumbarton,5456,8,10,12,14,50,57,-7,42
Ayr,5456,9,9,12,15,38,57,-19,39
St Mirren,5456,10,9,9,18,43,60,-17,36
Hibernian,5457,1,22,10,4,69,27,42,76
Morton,5457,2,19,10,7,58,42,16,67
Falkirk,5457,3,16,10,10,56,39,17,58
Dundee Utd,5457,4,15,9,12,53,43,10,54
Queen of S't,5457,5,11,8,17,44,55,-11,41
Dumbarton,5457,6,10,11,15,47,60,-13,41
Ayr,5457,7,10,11,15,36,56,-20,41
Raith,5457,8,10,9,17,37,55,-18,39
Dunfermline,5457,9,8,13,15,39,50,-11,37
St Mirren,5457,10,8,11,17,43,55,-12,35
Hibernian,5458,1,18,14,4,57,26,31,68
Morton,5458,2,16,13,7,51,37,14,61
Falkirk,5458,3,15,10,11,59,41,18,55
Dundee Utd,5458,4,13,13,10,49,44,5,52
Dunfermline,5458,5,11,12,13,49,50,-1,45
Queen of S't,5458,6,12,9,15,44,52,-8,45
Dumbarton,5458,7,10,12,14,50,57,-7,42
Ayr,5458,8,8,15,13,35,51,-16,39
St Mirren,5458,9,9,11,16,42,55,-13,38
Raith,5458,10,9,9,18,30,53,-23,36
Hibernian,5459,1,22,11,3,61,25,36,77
Falkirk,5459,2,16,11,9,57,41,16,59
Morton,5459,3,16,10,10,54,45,9,58
Dundee Utd,5459,4,15,11,10,49,40,9,56
Dunfermline,5459,5,13,12,11,54,47,7,51
Raith,5459,6,12,8,16,36,45,-9,44
Queen of S't,5459,7,12,8,16,45,55,-10,44
St Mirren,5459,8,9,10,17,43,56,-13,37
Dumbarton,5459,9,7,12,17,45,60,-15,33
Ayr,5459,10,6,11,19,30,60,-30,29
Hibernian,5460,1,20,10,6,58,24,34,70
Morton,5460,2,18,11,7,50,36,14,65
Falkirk,5460,3,16,11,9,57,41,16,59
Dundee Utd,5460,4,16,8,12,50,39,11,56
Dunfermline,5460,5,12,12,12,46,46,0,48
Queen of S't,5460,6,12,10,14,52,50,2,46
St Mirren,5460,7,9,11,16,39,53,-14,38
Ayr,5460,8,8,12,16,34,57,-23,36
Raith,5460,9,9,9,18,30,54,-24,36
Dumbarton,5460,10,7,12,17,43,59,-16,33
Hibernian,5461,1,21,12,3,61,22,39,75
Falkirk,5461,2,18,9,9,60,40,20,63
Morton,5461,3,16,11,9,45,40,5,59
Dundee Utd,5461,4,14,10,12,50,44,6,52
Dunfermline,5461,5,11,13,12,51,49,2,46
Ayr,5461,6,10,12,14,36,49,-13,42
Queen of S't,5461,7,10,11,15,43,51,-8,41
Dumbarton,5461,8,9,11,16,50,62,-12,38
Raith,5461,9,8,11,17,31,49,-18,35
St Mirren,5461,10,8,10,18,38,59,-21,34
Hibernian,5462,1,18,12,6,51,24,27,66
Morton,5462,2,17,11,8,48,37,11,62
Falkirk,5462,3,16,11,9,60,39,21,59
Dundee Utd,5462,4,14,10,12,45,42,3,52
Dunfermline,5462,5,13,11,12,46,44,2,50
Queen of S't,5462,6,13,9,14,51,49,2,48
St Mirren,5462,7,10,11,15,45,53,-8,41
Ayr,5462,8,10,11,15,38,54,-16,41
Raith,5462,9,9,8,19,34,57,-23,35
Dumbarton,5462,10,7,12,17,42,61,-19,33
Falkirk,5463,1,18,11,7,59,37,22,65
Hibernian,5463,2,18,10,8,55,32,23,64
Morton,5463,3,15,11,10,47,40,7,56
Dundee Utd,5463,4,14,10,12,52,42,10,52
Queen of S't,5463,5,13,9,14,48,51,-3,48
Dunfermline,5463,6,10,12,14,49,52,-3,42
St Mirren,5463,7,10,12,14,44,54,-10,42
Raith,5463,8,10,11,15,36,48,-12,41
Ayr,5463,9,9,14,13,38,53,-15,41
Dumbarton,5463,10,8,10,18,44,63,-19,34
Hibernian,5464,1,19,12,5,58,27,31,69
Dundee Utd,5464,2,19,8,9,56,37,19,65
Falkirk,5464,3,16,9,11,59,46,13,57
Morton,5464,4,13,13,10,46,44,2,52
Dunfermline,5464,5,11,13,12,44,45,-1,46
Queen of S't,5464,6,11,10,15,44,49,-5,43
Dumbarton,5464,7,10,11,15,52,62,-10,41
Ayr,5464,8,9,12,15,43,58,-15,39
St Mirren,5464,9,10,9,17,38,53,-15,39
Raith,5464,10,8,11,17,32,51,-19,35
Morton,5465,1,18,12,6,56,36,20,66
Hibernian,5465,2,16,13,7,54,30,24,61
Falkirk,5465,3,16,11,9,60,43,17,59
Dundee Utd,5465,4,13,13,10,51,43,8,52
Raith,5465,5,12,11,13,44,46,-2,47
Ayr,5465,6,11,10,15,40,58,-18,43
Queen of S't,5465,7,10,12,14,44,51,-7,42
Dunfermline,5465,8,9,13,14,45,52,-7,40
Dumbarton,5465,9,9,11,16,47,60,-13,38
St Mirren,5465,10,8,10,18,38,60,-22,34
Hibernian,5466,1,20,11,5,60,24,36,71
Morton,5466,2,18,9,9,53,39,14,63
Dundee Utd,5466,3,17,9,10,53,39,14,60
Falkirk,5466,4,16,11,9,58,43,15,59
Dunfermline,5466,5,10,14,12,45,50,-5,44
Queen of S't,5466,6,11,9,16,45,55,-10,42
Raith,5466,7,10,9,17,36,50,-14,39
St Mirren,5466,8,10,9,17,39,54,-15,39
Ayr,5466,9,9,12,15,33,51,-18,39
Dumbarton,5466,10,7,11,18,44,61,-17,32
Morton,5467,1,18,12,6,55,39,16,66
Hibernian,5467,2,17,14,5,55,30,25,65
Falkirk,5467,3,14,13,9,55,40,15,55
Dundee Utd,5467,4,14,11,11,44,39,5,53
Queen of S't,5467,5,13,10,13,46,46,0,49
Dumbarton,5467,6,9,14,13,45,52,-7,41
Raith,5467,7,10,11,15,38,47,-9,41
Dunfermline,5467,8,9,13,14,44,48,-4,40
St Mirren,5467,9,9,11,16,39,53,-14,38
Ayr,5467,10,6,13,17,29,56,-27,31
Hibernian,5468,1,22,10,4,60,27,33,76
Dundee Utd,5468,2,19,9,8,54,34,20,66
Morton,5468,3,16,11,9,52,38,14,59
Falkirk,5468,4,15,10,11,57,40,17,55
Dumbarton,5468,5,10,12,14,50,56,-6,42
St Mirren,5468,6,11,9,16,43,58,-15,42
Queen of S't,5468,7,10,11,15,45,55,-10,41
Dunfermline,5468,8,9,12,15,45,54,-9,39
Raith,5468,9,9,9,18,32,50,-18,36
Ayr,5468,10,6,13,17,29,55,-26,31
Hibernian,5469,1,20,10,6,60,25,35,70
Falkirk,5469,2,19,9,8,62,38,24,66
Morton,5469,3,17,11,8,50,37,13,62
Dundee Utd,5469,4,15,11,10,49,43,6,56
Dunfermline,5469,5,10,13,13,46,46,0,43
Queen of S't,5469,6,11,10,15,43,50,-7,43
Ayr,5469,7,10,12,14,38,56,-18,42
Raith,5469,8,9,9,18,33,49,-16,36
Dumbarton,5469,9,8,12,16,42,60,-18,36
St Mirren,5469,10,8,9,19,41,60,-19,33
Hibernian,5470,1,21,11,4,62,26,36,74
Falkirk,5470,2,16,12,8,58,38,20,60
Dundee Utd,5470,3,16,9,11,48,36,12,57
Morton,5470,4,16,9,11,50,41,9,57
Dunfermline,5470,5,11,13,12,49,49,0,46
Queen of S't,5470,6,11,10,15,48,54,-6,43
Dumbarton,5470,7,10,12,14,45,56,-11,42
Raith,5470,8,10,9,17,34,53,-19,39
Ayr,5470,9,9,11,16,36,54,-18,38
St Mirren,5470,10,7,10,19,36,59,-23,31
Hibernian,5471,1,20,11,5,57,24,33,71
Morton,5471,2,16,11,9,51,43,8,59
Falkirk,5471,3,15,12,9,59,40,19,57
Dundee Utd,5471,4,15,9,12,49,43,6,54
Queen of S't,5471,5,14,9,13,51,47,4,51
Dumbarton,5471,6,10,12,14,51,56,-5,42
Dunfermline,5471,7,10,12,14,48,54,-6,42
Ayr,5471,8,10,11,15,42,60,-18,41
Raith,5471,9,9,10,17,33,51,-18,37
St Mirren,5471,10,7,11,18,40,63,-23,32
Morton,5472,1,19,11,6,59,36,23,68
Hibernian,5472,2,19,10,7,63,32,31,67
Dundee Utd,5472,3,15,11,10,50,42,8,56
Falkirk,5472,4,15,10,11,54,42,12,55
Queen of S't,5472,5,14,8,14,51,47,4,50
Dunfermline,5472,6,10,12,14,45,52,-7,42
Dumbarton,5472,7,10,11,15,48,61,-13,41
St Mirren,5472,8,9,11,16,41,57,-16,38
Ayr,5472,9,8,12,16,32,54,-22,36
Raith,5472,10,8,10,18,33,53,-20,34
Hibernian,5473,1,20,13,3,57,22,35,73
Morton,5473,2,18,11,7,54,31,23,65
Falkirk,5473,3,16,10,10,59,46,13,58
Dundee Utd,5473,4,16,9,11,55,44,11,57
Dumbarton,5473,5,12,11,13,51,53,-2,47
Dunfermline,5473,6,10,13,13,46,47,-1,43
Queen of S't,5473,7,10,10,16,44,51,-7,40
Ayr,5473,8,9,11,16,36,58,-22,38
Raith,5473,9,8,9,19,31,59,-28,33
St Mirren,5473,10,6,13,17,39,61,-22,31
Hibernian,5474,1,19,12,5,54,26,28,69
Morton,5474,2,18,12,6,57,36,21,66
Falkirk,5474,3,17,10,9,59,40,19,61
Dundee Utd,5474,4,17,9,10,55,42,13,60
Queen of S't,5474,5,10,11,15,43,55,-12,41
Dunfermline,5474,6,9,13,14,47,51,-4,40
Dumbarton,5474,7,10,10,16,48,59,-11,40
Raith,5474,8,10,9,17,38,50,-12,39
Ayr,5474,9,9,11,16,40,59,-19,38
St Mirren,5474,10,8,9,19,37,60,-23,33
Hibernian,5475,1,19,11,6,60,29,31,68
Morton,5475,2,17,11,8,49,38,11,62
Falkirk,5475,3,16,11,9,53,37,16,59
Dundee Utd,5475,4,17,8,11,52,37,15,59
Queen of S't,5475,5,13,8,15,45,48,-3,47
Dunfermline,5475,6,10,15,11,46,47,-1,45
Raith,5475,7,11,10,15,39,48,-9,43
St Mirren,5475,8,10,10,16,37,52,-15,40
Dumbarton,5475,9,8,12,16,47,61,-14,36
Ayr,5475,10,6,10,20,30,61,-31,28
Hibernian,5476,1,17,15,4,58,30,28,66
Morton,5476,2,18,12,6,57,36,21,66
Falkirk,5476,3,16,12,8,63,41,22,60
Dundee Utd,5476,4,16,10,10,52,41,11,58
Dunfermline,5476,5,11,14,11,50,48,2,47
Queen of S't,5476,6,10,12,14,47,54,-7,42
Dumbarton,5476,7,8,13,15,45,54,-9,37
Raith,5476,8,9,10,17,32,54,-22,37
St Mirren,5476,9,7,12,17,39,58,-19,33
Ayr,5476,10,7,12,17,29,56,-27,33
Hibernian,5477,1,20,12,4,57,27,30,72
Morton,5477,2,18,11,7,57,38,19,65
Falkirk,5477,3,14,12,10,57,44,13,54
Dundee Utd,5477,4,15,8,13,47,42,5,53
Queen of S't,5477,5,12,9,15,47,55,-8,45
Dunfermline,5477,6,9,15,12,47,51,-4,42
Raith,5477,7,10,11,15,36,47,-11,41
Dumbarton,5477,8,10,10,16,51,61,-10,40
St Mirren,5477,9,10,10,16,47,57,-10,40
Ayr,5477,10,7,12,17,33,57,-24,33
Hibernian,5478,1,19,13,4,53,24,29,70
Falkirk,5478,2,18,10,8,57,35,22,64
Morton,5478,3,17,12,7,52,38,14,63
Dundee Utd,5478,4,13,11,12,45,44,1,50
Queen of S't,5478,5,11,10,15,44,48,-4,43
Dumbarton,5478,6,10,12,14,48,53,-5,42
Dunfermline,5478,7,9,13,14,45,51,-6,40
Raith,5478,8,10,9,17,34,50,-16,39
Ayr,5478,9,8,13,15,33,54,-21,37
St Mirren,5478,10,8,11,17,43,57,-14,35
Hibernian,5479,1,20,12,4,59,25,34,72
Morton,5479,2,16,13,7,46,32,14,61
Falkirk,5479,3,16,12,8,62,40,22,60
Dundee Utd,5479,4,16,11,9,48,37,11,59
Queen of S't,5479,5,10,10,16,40,52,-12,40
St Mirren,5479,6,9,12,15,47,58,-11,39
Ayr,5479,7,9,12,15,34,50,-16,39
Raith,5479,8,9,11,16,32,53,-21,38
Dunfermline,5479,9,8,13,15,45,53,-8,37
Dumbarton,5479,10,8,12,16,48,61,-13,36
Hibernian,5480,1,20,12,4,59,26,33,72
Morton,5480,2,19,10,7,57,32,25,67
Dundee Utd,5480,3,16,11,9,46,39,7,59
Falkirk,5480,4,14,11,11,58,45,13,53
Dunfermline,5480,5,11,13,12,48,50,-2,46
Dumbarton,5480,6,10,11,15,51,59,-8,41
Raith,5480,7,9,12,15,37,53,-16,39
Ayr,5480,8,8,14,14,33,51,-18,38
Queen of S't,5480,9,9,9,18,41,54,-13,36
St Mirren,5480,10,6,13,17,35,56,-21,31
Hibernian,5481,1,19,12,5,58,29,29,69
Falkirk,5481,2,18,10,8,61,40,21,64
Morton,5481,3,17,11,8,53,37,16,62
Dundee Utd,5481,4,17,8,11,53,44,9,59
Raith,5481,5,11,11,14,42,48,-6,44
Dunfermline,5481,6,10,13,13,44,48,-4,43
Queen of S't,5481,7,11,9,16,43,52,-9,42
Dumbarton,5481,8,7,14,15,47,61,-14,35
St Mirren,5481,9,8,10,18,42,60,-18,34
Ayr,5481,10,6,14,16,31,55,-24,32
Hibernian,5482,1,19,13,4,54,24,30,70
Falkirk,5482,2,14,14,8,55,39,16,56
Morton,5482,3,15,11,10,47,42,5,56
Dundee Utd,5482,4,14,10,12,49,42,7,52
Raith,5482,5,12,11,13,41,43,-2,47
Queen of S't,5482,6,11,12,13,47,51,-4,45
Dumbarton,5482,7,11,11,14,51,58,-7,44
Dunfermline,5482,8,10,13,13,44,45,-1,43
St Mirren,5482,9,8,12,16,39,53,-14,36
Ayr,5482,10,6,13,17,32,62,-30,31
Hibernian,5483,1,21,10,5,55,26,29,73
Morton,5483,2,17,9,10,53,42,11,60
Falkirk,5483,3,15,11,10,53,38,15,56
Dundee Utd,5483,4,15,10,11,50,47,3,55
Dunfermline,5483,5,12,12,12,46,41,5,48
Queen of S't,5483,6,11,10,15,42,47,-5,43
Dumbarton,5483,7,11,10,15,51,57,-6,43
St Mirren,5483,8,9,11,16,47,57,-10,38
Raith,5483,9,10,8,18,33,52,-19,38
Ayr,5483,10,8,11,17,39,62,-23,35
Hibernian,5484,1,18,13,5,56,29,27,67
Morton,5484,2,18,11,7,54,36,18,65
Falkirk,5484,3,15,12,9,59,43,16,57
Dundee Utd,5484,4,16,8,12,52,41,11,56
Queen of S't,5484,5,11,12,13,42,47,-5,45
Raith,5484,6,10,10,16,34,49,-15,40
Dunfermline,5484,7,9,12,15,47,56,-9,39
Dumbarton,5484,8,9,12,15,46,60,-14,39
St Mirren,5484,9,9,11,16,38,52,-14,38
Ayr,5484,10,9,11,16,36,51,-15,38
Hibernian,5485,1,17,14,5,53,28,25,65
Morton,5485,2,17,13,6,54,37,17,64
Falkirk,5485,3,14,13,9,56,41,15,55
Dundee Utd,5485,4,15,10,11,52,42,10,55
Queen of S't,5485,5,11,11,14,44,50,-6,44
Raith,5485,6,11,11,14,37,46,-9,44
Dunfermline,5485,7,8,18,10,49,50,-1,42
Dumbarton,5485,8,9,13,14,48,58,-10,40
Ayr,5485,9,8,11,17,34,60,-26,35
St Mirren,5485,10,8,10,18,44,59,-15,34
Hibernian,5486,1,20,13,3,59,27,32,73
Falkirk,5486,2,16,12,8,62,44,18,60
Dundee Utd,5486,3,16,9,11,52,44,8,57
Morton,5486,4,14,11,11,48,46,2,53
Queen of S't,5486,5,13,10,13,53,52,1,49
Raith,5486,6,10,10,16,37,52,-15,40
Dunfermline,5486,7,9,12,15,44,52,-8,39
St Mirren,5486,8,9,11,16,42,51,-9,38
Dumbarton,5486,9,9,11,16,53,63,-10,38
Ayr,5486,10,9,11,16,34,53,-19,38
Hibernian,5487,1,18,12,6,54,27,27,66
Falkirk,5487,2,16,10,10,56,41,15,58
Morton,5487,3,16,10,10,49,39,10,58
Dundee Utd,5487,4,15,9,12,49,45,4,54
Dunfermline,5487,5,13,12,11,48,44,4,51
Dumbarton,5487,6,10,12,14,51,58,-7,42
Queen of S't,5487,7,10,11,15,42,50,-8,41
Raith,5487,8,10,11,15,33,46,-13,41
Ayr,5487,9,8,14,14,36,51,-15,38
St Mirren,5487,10,9,9,18,41,58,-17,36
Hibernian,5488,1,18,12,6,62,34,28,66
Morton,5488,2,16,13,7,50,42,8,61
Falkirk,5488,3,16,11,9,57,38,19,59
Dundee Utd,5488,4,15,13,8,52,38,14,58
Queen of S't,5488,5,12,9,15,43,51,-8,45
Dumbarton,5488,6,10,12,14,51,56,-5,42
Ayr,5488,7,10,11,15,38,54,-16,41
Dunfermline,5488,8,9,11,16,46,53,-7,38
St Mirren,5488,9,9,11,16,44,58,-14,38
Raith,5488,10,9,9,18,36,55,-19,36
Hibernian,5489,1,22,11,3,61,23,38,77
Falkirk,5489,2,17,11,8,64,38,26,62
Morton,5489,3,16,10,10,53,41,12,58
Dundee Utd,5489,4,16,9,11,52,44,8,57
Dunfermline,5489,5,11,12,13,47,48,-1,45
Queen of S't,5489,6,10,12,14,46,51,-5,42
Raith,5489,7,10,9,17,37,55,-18,39
St Mirren,5489,8,9,10,17,41,61,-20,37
Ayr,5489,9,8,12,16,35,57,-22,36
Dumbarton,5489,10,8,10,18,42,60,-18,34
Hibernian,5490,1,18,12,6,49,26,23,66
Morton,5490,2,16,13,7,47,34,13,61
Falkirk,5490,3,16,11,9,58,39,19,59
Dundee Utd,5490,4,16,10,10,49,39,10,58
Queen of S't,5490,5,15,8,13,52,45,7,53
Raith,5490,6,12,8,16,36,49,-13,44
Dumbarton,5490,7,9,13,14,48,58,-10,40
Dunfermline,5490,8,7,15,14,41,50,-9,36
St Mirren,5490,9,9,9,18,41,57,-16,36
Ayr,5490,10,7,11,18,31,55,-24,32
Hibernian,5491,1,21,11,4,62,26,36,74
Morton,5491,2,16,11,9,54,37,17,59
Dundee Utd,5491,3,16,9,11,51,44,7,57
Falkirk,5491,4,14,13,9,59,42,17,55
Queen of S't,5491,5,11,11,14,47,53,-6,44
Dunfermline,5491,6,10,13,13,49,53,-4,43
Raith,5491,7,10,11,15,38,53,-15,41
Dumbarton,5491,8,8,13,15,47,61,-14,37
St Mirren,5491,9,9,10,17,42,58,-16,37
Ayr,5491,10,7,14,15,37,59,-22,35
Hibernian,5492,1,20,13,3,57,23,34,73
Morton,5492,2,16,14,6,49,33,16,62
Falkirk,5492,3,15,10,11,58,46,12,55
Dundee Utd,5492,4,15,9,12,52,43,9,54
Dumbarton,5492,5,11,11,14,52,55,-3,44
Queen of S't,5492,6,11,10,15,43,48,-5,43
Dunfermline,5492,7,9,14,13,42,49,-7,41
Raith,5492,8,9,11,16,33,52,-19,38
St Mirren,5492,9,9,10,17,42,56,-14,37
Ayr,5492,10,8,12,16,33,56,-23,36
Hibernian,5493,1,20,10,6,56,24,32,70
Morton,5493,2,16,11,9,49,40,9,59
Falkirk,5493,3,15,13,8,58,40,18,58
Dundee Utd,5493,4,14,10,12,47,43,4,52
Dunfermline,5493,5,13,11,12,49,43,6,50
Queen of S't,5493,6,10,11,15,43,51,-8,41
Dumbarton,5493,7,9,12,15,52,63,-11,39
St Mirren,5493,8,9,12,15,44,55,-11,39
Ayr,5493,9,9,12,15,35,56,-21,39
Raith,5493,10,8,12,16,31,49,-18,36
Hibernian,5494,1,17,13,6,52,27,25,64
Morton,5494,2,17,11,8,48,36,12,62
Falkirk,5494,3,16,10,10,56,40,16,58
Dundee Utd,5494,4,15,11,10,50,43,7,56
Dunfermline,5494,5,12,12,12,48,44,4,48
Queen of S't,5494,6,11,10,15,43,50,-7,43
Dumbarton,5494,7,10,10,16,48,58,-10,40
Ayr,5494,8,9,12,15,41,57,-16,39
Raith,5494,9,10,9,17,35,51,-16,39
St Mirren,5494,10,8,12,16,39,54,-15,36
Hibernian,5495,1,22,11,3,60,23,37,77
Falkirk,5495,2,17,10,9,61,39,22,61
Morton,5495,3,16,12,8,50,36,14,60
Dundee Utd,5495,4,16,10,10,47,37,10,58
Queen of S't,5495,5,13,9,14,49,48,1,48
St Mirren,5495,6,10,10,16,41,54,-13,40
Raith,5495,7,10,10,16,34,48,-14,40
Dumbarton,5495,8,8,12,16,43,60,-17,36
Dunfermline,5495,9,7,13,16,44,59,-15,34
Ayr,5495,10,7,11,18,30,55,-25,32
Hibernian,5496,1,22,10,4,57,20,37,76
Falkirk,5496,2,18,10,8,62,37,25,64
Morton,5496,3,16,11,9,48,39,9,59
Dundee Utd,5496,4,15,11,10,54,45,9,56
Dunfermline,5496,5,10,14,12,46,49,-3,44
Raith,5496,6,11,10,15,38,47,-9,43
Dumbarton,5496,7,10,10,16,47,58,-11,40
Queen of S't,5496,8,9,10,17,43,56,-13,37
Ayr,5496,9,8,11,17,31,55,-24,35
St Mirren,5496,10,7,11,18,35,55,-20,32
Hibernian,5497,1,19,14,3,56,25,31,71
Falkirk,5497,2,15,14,7,56,37,19,59
Morton,5497,3,15,13,8,48,38,10,58
Dundee Utd,5497,4,13,11,12,45,43,2,50
Queen of S't,5497,5,12,11,13,46,49,-3,47
Dunfermline,5497,6,10,14,12,45,46,-1,44
St Mirren,5497,7,9,11,16,45,55,-10,38
Dumbarton,5497,8,9,11,16,47,58,-11,38
Raith,5497,9,9,11,16,34,51,-17,38
Ayr,5497,10,8,12,16,34,54,-20,36
Falkirk,5498,1,17,12,7,70,47,23,63
Morton,5498,2,17,12,7,52,37,15,63
Hibernian,5498,3,16,14,6,51,29,22,62
Dundee Utd,5498,4,15,10,11,52,44,8,55
Queen of S't,5498,5,11,12,13,45,47,-2,45
Dumbarton,5498,6,9,13,14,53,59,-6,40
Dunfermline,5498,7,8,15,13,50,55,-5,39
Raith,5498,8,10,9,17,34,51,-17,39
Ayr,5498,9,7,16,13,34,52,-18,37
St Mirren,5498,10,9,9,18,40,60,-20,36
Hibernian,5499,1,20,13,3,56,21,35,73
Falkirk,5499,2,17,10,9,59,40,19,61
Dundee Utd,5499,3,17,9,10,56,38,18,60
Morton,5499,4,15,14,7,47,35,12,59
Queen of S't,5499,5,12,9,15,44,52,-8,45
Raith,5499,6,10,10,16,34,48,-14,40
Dumbarton,5499,7,8,15,13,49,59,-10,39
Dunfermline,5499,8,7,16,13,39,44,-5,37
Ayr,5499,9,7,14,15,29,53,-24,35
St Mirren,5499,10,7,10,19,37,60,-23,31
Hibernian,5500,1,22,11,3,61,24,37,77
Falkirk,5500,2,17,10,9,58,40,18,61
Morton,5500,3,17,10,9,51,37,14,61
Dundee Utd,5500,4,16,9,11,51,41,10,57
Queen of S't,5500,5,11,9,16,46,50,-4,42
Dunfermline,5500,6,10,12,14,48,55,-7,42
St Mirren,5500,7,10,10,16,43,55,-12,40
Dumbarton,5500,8,8,14,14,46,55,-9,38
Raith,5500,9,10,8,18,35,53,-18,38
Ayr,5500,10,6,13,17,34,63,-29,31
Hibernian,5501,1,20,12,4,57,25,32,72
Morton,5501,2,19,10,7,53,35,18,67
Falkirk,5501,3,18,9,9,60,39,21,63
Dundee Utd,5501,4,16,8,12,53,46,7,56
Queen of S't,5501,5,12,9,15,43,46,-3,45
Dumbarton,5501,6,10,11,15,46,58,-12,41
Dunfermline,5501,7,9,12,15,47,53,-6,39
Raith,5501,8,10,8,18,34,52,-18,38
St Mirren,5501,9,9,10,17,40,52,-12,37
Ayr,5501,10,7,11,18,33,60,-27,32
Hibernian,5502,1,20,12,4,60,25,35,72
Morton,5502,2,17,10,9,52,39,13,61
Falkirk,5502,3,16,10,10,55,41,14,58
Dundee Utd,5502,4,15,9,12,48,42,6,54
Dunfermline,5502,5,12,12,12,48,46,2,48
Dumbarton,5502,6,10,11,15,46,55,-9,41
Raith,5502,7,11,8,17,37,50,-13,41
Ayr,5502,8,10,11,15,38,53,-15,41
Queen of S't,5502,9,10,10,16,40,53,-13,40
St Mirren,5502,10,8,9,19,42,62,-20,33
Hibernian,5503,1,20,12,4,58,24,34,72
Falkirk,5503,2,17,11,8,60,37,23,62
Dundee Utd,5503,3,18,8,10,54,39,15,62
Morton,5503,4,16,11,9,53,41,12,59
Raith,5503,5,13,8,15,46,49,-3,47
Dumbarton,5503,6,11,10,15,53,62,-9,43
Queen of S't,5503,7,10,9,17,40,58,-18,39
Ayr,5503,8,9,10,17,38,59,-21,37
St Mirren,5503,9,8,11,17,38,55,-17,35
Dunfermline,5503,10,7,12,17,41,57,-16,33
Hibernian,5504,1,20,12,4,56,24,32,72
Dundee Utd,5504,2,17,9,10,49,35,14,60
Falkirk,5504,3,16,10,10,61,41,20,58
Morton,5504,4,15,13,8,49,42,7,58
Dunfermline,5504,5,11,13,12,49,48,1,46
Queen of S't,5504,6,12,9,15,46,53,-7,45
Raith,5504,7,11,8,17,36,47,-11,41
St Mirren,5504,8,10,9,17,44,53,-9,39
Dumbarton,5504,9,7,13,16,44,62,-18,34
Ayr,5504,10,6,14,16,31,60,-29,32
Hibernian,5505,1,19,13,4,54,24,30,70
Morton,5505,2,15,12,9,44,35,9,57
Falkirk,5505,3,14,12,10,53,39,14,54
Dundee Utd,5505,4,13,11,12,45,41,4,50
Queen of S't,5505,5,13,10,13,45,46,-1,49
Dumbarton,5505,6,12,11,13,50,52,-2,47
Dunfermline,5505,7,10,12,14,45,47,-2,42
St Mirren,5505,8,10,10,16,44,55,-11,40
Ayr,5505,9,8,13,15,33,56,-23,37
Raith,5505,10,8,12,16,32,50,-18,36
Hibernian,5506,1,19,13,4,56,22,34,70
Dundee Utd,5506,2,18,8,10,60,40,20,62
Morton,5506,3,16,10,10,48,39,9,58
Falkirk,5506,4,14,11,11,54,44,10,53
Dunfermline,5506,5,10,14,12,45,47,-2,44
Queen of S't,5506,6,10,11,15,45,54,-9,41
Raith,5506,7,10,11,15,36,49,-13,41
Ayr,5506,8,9,13,14,37,56,-19,40
Dumbarton,5506,9,8,13,15,46,61,-15,37
St Mirren,5506,10,8,12,16,42,57,-15,36
Hibernian,5507,1,19,13,4,52,23,29,70
Morton,5507,2,18,11,7,52,32,20,65
Dundee Utd,5507,3,16,9,11,54,39,15,57
Falkirk,5507,4,13,14,9,54,43,11,53
Dunfermline,5507,5,11,13,12,42,44,-2,46
Queen of S't,5507,6,11,9,16,42,52,-10,42
Ayr,5507,7,9,12,15,33,51,-18,39
St Mirren,5507,8,9,11,16,41,53,-12,38
Raith,5507,9,9,11,16,33,49,-16,38
Dumbarton,5507,10,7,13,16,44,61,-17,34
Hibernian,5508,1,18,12,6,58,28,30,66
Falkirk,5508,2,17,10,9,60,42,18,61
Morton,5508,3,17,10,9,49,35,14,61
Dundee Utd,5508,4,14,10,12,45,40,5,52
Queen of S't,5508,5,12,10,14,43,52,-9,46
Dunfermline,5508,6,10,13,13,45,47,-2,43
Ayr,5508,7,10,12,14,36,53,-17,42
Raith,5508,8,9,12,15,36,49,-13,39
St Mirren,5508,9,9,11,16,40,54,-14,38
Dumbarton,5508,10,8,12,16,46,58,-12,36
Hibernian,5509,1,19,13,4,65,25,40,70
Dundee Utd,5509,2,17,9,10,53,38,15,60
Falkirk,5509,3,16,10,10,57,42,15,58
Morton,5509,4,14,13,9,51,44,7,55
Queen of S't,5509,5,12,9,15,43,59,-16,45
St Mirren,5509,6,11,11,14,43,49,-6,44
Dunfermline,5509,7,10,12,14,45,54,-9,42
Raith,5509,8,9,10,17,36,51,-15,37
Ayr,5509,9,8,13,15,31,53,-22,37
Dumbarton,5509,10,8,12,16,50,59,-9,36
Hibernian,5510,1,17,13,6,58,29,29,64
Morton,5510,2,17,11,8,48,35,13,62
Falkirk,5510,3,16,11,9,61,43,18,59
Dundee Utd,5510,4,16,11,9,52,35,17,59
Dunfermline,5510,5,10,14,12,42,44,-2,44
Raith,5510,6,11,11,14,34,44,-10,44
Queen of S't,5510,7,10,11,15,45,56,-11,41
Dumbarton,5510,8,8,13,15,47,61,-14,37
St Mirren,5510,9,9,9,18,38,55,-17,36
Ayr,5510,10,7,14,15,36,59,-23,35
Hibernian,5511,1,19,12,5,59,28,31,69
Morton,5511,2,17,12,7,58,44,14,63
Dundee Utd,5511,3,17,8,11,53,38,15,59
Falkirk,5511,4,15,13,8,56,39,17,58
Queen of S't,5511,5,12,9,15,45,53,-8,45
Dumbarton,5511,6,10,12,14,48,55,-7,42
Raith,5511,7,9,11,16,36,50,-14,38
Ayr,5511,8,8,14,14,35,55,-20,38
Dunfermline,5511,9,8,13,15,42,52,-10,37
St Mirren,5511,10,6,14,16,38,56,-18,32
Hibernian,5512,1,19,14,3,57,24,33,71
Morton,5512,2,16,15,5,52,32,20,63
Dundee Utd,5512,3,17,10,9,51,36,15,61
Falkirk,5512,4,15,9,12,58,49,9,54
Queen of S't,5512,5,12,10,14,47,50,-3,46
Dunfermline,5512,6,9,15,12,47,50,-3,42
Raith,5512,7,10,11,15,35,49,-14,41
Dumbarton,5512,8,9,13,14,50,60,-10,40
St Mirren,5512,9,8,10,18,44,61,-17,34
Ayr,5512,10,6,11,19,28,58,-30,29
Morton,5513,1,20,11,5,56,36,20,71
Hibernian,5513,2,18,11,7,55,30,25,65
Falkirk,5513,3,17,9,10,56,40,16,60
Dundee Utd,5513,4,16,9,11,52,42,10,57
Queen of S't,5513,5,13,8,15,50,52,-2,47
Dunfermline,5513,6,10,12,14,52,52,0,42
St Mirren,5513,7,11,9,16,44,53,-9,42
Ayr,5513,8,9,11,16,37,58,-21,38
Raith,5513,9,9,8,19,32,52,-20,35
Dumbarton,5513,10,7,12,17,48,67,-19,33
Hibernian,5514,1,18,14,4,57,26,31,68
Falkirk,5514,2,18,11,7,58,36,22,65
Morton,5514,3,16,11,9,54,39,15,59
Dundee Utd,5514,4,13,12,11,42,37,5,51
Dunfermline,5514,5,12,12,12,51,49,2,48
Queen of S't,5514,6,13,9,14,44,47,-3,48
St Mirren,5514,7,11,9,16,42,53,-11,42
Dumbarton,5514,8,9,11,16,45,55,-10,38
Raith,5514,9,8,10,18,31,51,-20,34
Ayr,5514,10,7,11,18,28,59,-31,32
Hibernian,5515,1,18,13,5,58,29,29,67
Falkirk,5515,2,16,10,10,57,40,17,58
Morton,5515,3,16,10,10,45,42,3,58
Dundee Utd,5515,4,15,11,10,47,37,10,56
Raith,5515,5,13,9,14,43,45,-2,48
Dunfermline,5515,6,10,14,12,47,45,2,44
Queen of S't,5515,7,11,10,15,46,56,-10,43
Dumbarton,5515,8,10,12,14,51,58,-7,42
Ayr,5515,9,8,13,15,36,54,-18,37
St Mirren,5515,10,7,10,19,36,60,-24,31
Hibernian,5516,1,19,14,3,57,24,33,71
Falkirk,5516,2,16,10,10,59,41,18,58
Morton,5516,3,13,13,10,47,42,5,52
Dundee Utd,5516,4,14,8,14,44,42,2,50
Raith,5516,5,12,10,14,37,46,-9,46
Dunfermline,5516,6,11,12,13,47,47,0,45
Queen of S't,5516,7,12,9,15,42,51,-9,45
St Mirren,5516,8,11,10,15,38,48,-10,43
Dumbarton,5516,9,10,12,14,48,55,-7,42
Ayr,5516,10,7,12,17,31,54,-23,33
Hibernian,5517,1,20,13,3,58,25,33,73
Morton,5517,2,15,12,9,49,39,10,57
Dundee Utd,5517,3,15,10,11,47,37,10,55
Queen of S't,5517,4,14,10,12,47,44,3,52
Falkirk,5517,5,14,9,13,53,44,9,51
Dumbarton,5517,6,13,11,12,55,53,2,50
Dunfermline,5517,7,9,13,14,47,57,-10,40
Raith,5517,8,9,10,17,33,50,-17,37
St Mirren,5517,9,9,9,18,40,56,-16,36
Ayr,5517,10,7,13,16,29,53,-24,34
Hibernian,5518,1,21,11,4,58,26,32,74
Dundee Utd,5518,2,17,8,11,45,37,8,59
Falkirk,5518,3,15,10,11,54,40,14,55
Morton,5518,4,14,10,12,44,40,4,52
Queen of S't,5518,5,12,12,12,43,43,0,48
Dunfermline,5518,6,10,14,12,43,45,-2,44
Dumbarton,5518,7,10,13,13,46,52,-6,43
Ayr,5518,8,9,12,15,36,52,-16,39
Raith,5518,9,9,10,17,35,52,-17,37
St Mirren,5518,10,7,12,17,40,57,-17,33
Hibernian,5519,1,17,12,7,56,32,24,63
Morton,5519,2,17,11,8,55,37,18,62
Falkirk,5519,3,15,12,9,58,43,15,57
Dundee Utd,5519,4,16,9,11,52,40,12,57
Queen of S't,5519,5,13,10,13,50,49,1,49
St Mirren,5519,6,10,11,15,42,51,-9,41
Ayr,5519,7,10,11,15,37,57,-20,41
Dunfermline,5519,8,9,12,15,42,52,-10,39
Raith,5519,9,10,9,17,33,52,-19,39
Dumbarton,5519,10,9,11,16,48,60,-12,38
Hibernian,5520,1,21,11,4,59,24,35,74
Falkirk,5520,2,17,9,10,57,37,20,60
Dundee Utd,5520,3,16,11,9,50,38,12,59
Morton,5520,4,16,10,10,49,42,7,58
Queen of S't,5520,5,12,11,13,43,48,-5,47
Dunfermline,5520,6,10,12,14,50,53,-3,42
Raith,5520,7,10,9,17,34,49,-15,39
Dumbarton,5520,8,9,10,17,43,54,-11,37
St Mirren,5520,9,9,10,17,38,54,-16,37
Ayr,5520,10,7,13,16,28,52,-24,34
Hibernian,5521,1,19,12,5,52,23,29,69
Morton,5521,2,17,11,8,49,32,17,62
Falkirk,5521,3,15,13,8,56,40,16,58
Dundee Utd,5521,4,13,10,13,44,43,1,49
Queen of S't,5521,5,12,10,14,48,50,-2,46
Dunfermline,5521,6,11,12,13,49,53,-4,45
Dumbarton,5521,7,10,12,14,49,52,-3,42
Ayr,5521,8,9,12,15,33,52,-19,39
Raith,5521,9,10,8,18,35,50,-15,38
St Mirren,5521,10,8,12,16,38,58,-20,36
Hibernian,5522,1,20,11,5,59,25,34,71
Dundee Utd,5522,2,18,10,8,58,37,21,64
Morton,5522,3,17,11,8,48,35,13,62
Falkirk,5522,4,15,11,10,54,42,12,56
Dumbarton,5522,5,11,10,15,48,59,-11,43
St Mirren,5522,6,10,10,16,45,56,-11,40
Dunfermline,5522,7,9,12,15,43,51,-8,39
Queen of S't,5522,8,10,9,17,41,50,-9,39
Raith,5522,9,9,10,17,32,50,-18,37
Ayr,5522,10,8,12,16,33,56,-23,36
Hibernian,5523,1,20,10,6,55,26,29,70
Morton,5523,2,19,11,6,53,31,22,68
Falkirk,5523,3,17,9,10,60,43,17,60
Dundee Utd,5523,4,17,8,11,52,41,11,59
Queen of S't,5523,5,13,8,15,45,50,-5,47
Dumbarton,5523,6,10,11,15,48,57,-9,41
Dunfermline,5523,7,9,12,15,44,50,-6,39
Ayr,5523,8,9,10,17,33,56,-23,37
St Mirren,5523,9,9,9,18,40,58,-18,36
Raith,5523,10,9,8,19,33,51,-18,35
Hibernian,5524,1,19,14,3,59,27,32,71
Dundee Utd,5524,2,17,11,8,54,38,16,62
Falkirk,5524,3,15,12,9,51,35,16,57
Morton,5524,4,14,12,10,43,40,3,54
Queen of S't,5524,5,12,11,13,43,46,-3,47
Dumbarton,5524,6,10,11,15,49,56,-7,41
Dunfermline,5524,7,9,13,14,45,51,-6,40
Ayr,5524,8,9,13,14,39,54,-15,40
Raith,5524,9,9,11,16,31,45,-14,38
St Mirren,5524,10,7,10,19,38,60,-22,31
Hibernian,5525,1,19,12,5,53,23,30,69
Morton,5525,2,17,12,7,53,34,19,63
Dundee Utd,5525,3,17,10,9,58,41,17,61
Falkirk,5525,4,14,12,10,53,41,12,54
Queen of S't,5525,5,14,9,13,46,46,0,51
Dunfermline,5525,6,10,12,14,43,53,-10,42
Dumbarton,5525,7,8,13,15,50,59,-9,37
Raith,5525,8,9,10,17,34,50,-16,37
Ayr,5525,9,8,12,16,35,56,-21,36
St Mirren,5525,10,8,10,18,38,60,-22,34
Hibernian,5526,1,19,12,5,57,26,31,69
Morton,5526,2,18,11,7,54,36,18,65
Dundee Utd,5526,3,17,9,10,52,39,13,60
Falkirk,5526,4,15,9,12,56,48,8,54
Dunfermline,5526,5,11,13,12,48,48,0,46
Queen of S't,5526,6,11,10,15,46,52,-6,43
Raith,5526,7,10,11,15,37,49,-12,41
Ayr,5526,8,8,14,14,33,51,-18,38
Dumbarton,5526,9,8,12,16,45,61,-16,36
St Mirren,5526,10,7,11,18,38,56,-18,32
Hibernian,5527,1,19,11,6,61,30,31,68
Morton,5527,2,17,11,8,50,40,10,62
Dundee Utd,5527,3,16,9,11,48,39,9,57
Falkirk,5527,4,15,11,10,60,45,15,56
Dunfermline,5527,5,14,11,11,53,47,6,53
Queen of S't,5527,6,11,11,14,46,52,-6,44
St Mirren,5527,7,9,11,16,44,57,-13,38
Raith,5527,8,9,11,16,36,51,-15,38
Dumbarton,5527,9,8,13,15,47,59,-12,37
Ayr,5527,10,6,13,17,34,59,-25,31
Morton,5528,1,19,11,6,56,37,19,68
Hibernian,5528,2,17,12,7,54,28,26,63
Falkirk,5528,3,17,11,8,59,38,21,62
Dundee Utd,5528,4,14,12,10,53,43,10,54
Queen of S't,5528,5,12,9,15,47,55,-8,45
Raith,5528,6,11,10,15,38,48,-10,43
St Mirren,5528,7,9,11,16,43,57,-14,38
Dunfermline,5528,8,8,13,15,47,53,-6,37
Dumbarton,5528,9,9,10,17,44,63,-19,37
Ayr,5528,10,8,13,15,36,55,-19,37
Hibernian,5529,1,19,12,5,52,24,28,69
Morton,5529,2,17,11,8,50,36,14,62
Falkirk,5529,3,16,11,9,58,38,20,59
Dundee Utd,5529,4,16,10,10,48,39,9,58
Queen of S't,5529,5,12,9,15,44,50,-6,45
Dunfermline,5529,6,10,12,14,46,50,-4,42
Dumbarton,5529,7,10,10,16,47,57,-10,40
Raith,5529,8,10,8,18,33,52,-19,38
Ayr,5529,9,8,13,15,32,51,-19,37
St Mirren,5529,10,8,12,16,39,52,-13,36
Hibernian,5530,1,21,12,3,59,26,33,75
Falkirk,5530,2,16,10,10,57,43,14,58
Morton,5530,3,14,12,10,46,39,7,54
Queen of S't,5530,4,15,9,12,47,43,4,54
Dundee Utd,5530,5,14,9,13,43,40,3,51
Dunfermline,5530,6,10,13,13,47,51,-4,43
Raith,5530,7,10,11,15,36,45,-9,41
Dumbarton,5530,8,10,10,16,49,59,-10,40
St Mirren,5530,9,8,11,17,39,56,-17,35
Ayr,5530,10,7,13,16,32,53,-21,34
Hibernian,5531,1,21,11,4,60,26,34,74
Morton,5531,2,18,11,7,55,39,16,65
Dundee Utd,5531,3,18,9,9,54,39,15,63
Falkirk,5531,4,15,11,10,56,39,17,56
Dunfermline,5531,5,11,12,13,51,47,4,45
Queen of S't,5531,6,10,10,16,42,53,-11,40
Raith,5531,7,9,10,17,35,49,-14,37
Dumbarton,5531,8,8,12,16,49,66,-17,36
St Mirren,5531,9,9,9,18,45,63,-18,36
Ayr,5531,10,7,13,16,33,59,-26,34
Hibernian,5532,1,20,11,5,57,27,30,71
Dundee Utd,5532,2,19,9,8,58,36,22,66
Falkirk,5532,3,17,9,10,56,43,13,60
Morton,5532,4,16,11,9,47,39,8,59
Queen of S't,5532,5,13,10,13,47,47,0,49
Dunfermline,5532,6,9,13,14,42,48,-6,40
Ayr,5532,7,9,11,16,37,52,-15,38
Dumbarton,5532,8,8,12,16,48,62,-14,36
Raith,5532,9,8,10,18,31,48,-17,34
St Mirren,5532,10,8,10,18,36,57,-21,34
Hibernian,5533,1,20,13,3,56,24,32,73
Morton,5533,2,17,13,6,48,33,15,64
Falkirk,5533,3,16,11,9,57,39,18,59
Dundee Utd,5533,4,15,11,10,52,40,12,56
Queen of S't,5533,5,10,12,14,44,50,-6,42
Ayr,5533,6,10,12,14,37,49,-12,42
Dunfermline,5533,7,9,14,13,50,54,-4,41
Raith,5533,8,9,10,17,35,51,-16,37
St Mirren,5533,9,8,10,18,37,56,-19,34
Dumbarton,5533,10,7,12,17,45,65,-20,33
Hibernian,5534,1,21,11,4,59,25,34,74
Morton,5534,2,17,11,8,47,36,11,62
Falkirk,5534,3,17,9,10,62,42,20,60
Dundee Utd,5534,4,16,9,11,47,38,9,57
Dumbarton,5534,5,11,11,14,52,57,-5,44
Queen of S't,5534,6,10,11,15,46,50,-4,41
Raith,5534,7,10,9,17,34,55,-21,39
Ayr,5534,8,9,12,15,34,57,-23,39
Dunfermline,5534,9,8,12,16,47,54,-7,36
St Mirren,5534,10,9,9,18,39,53,-14,36
Hibernian,5535,1,18,14,4,58,29,29,68
Dundee Utd,5535,2,19,8,9,52,34,18,65
Falkirk,5535,3,16,12,8,59,40,19,60
Morton,5535,4,16,10,10,49,35,14,58
Queen of S't,5535,5,13,10,13,47,46,1,49
Dumbarton,5535,6,11,10,15,50,55,-5,43
Dunfermline,5535,7,9,13,14,46,54,-8,40
Raith,5535,8,9,10,17,30,51,-21,37
Ayr,5535,9,8,10,18,32,55,-23,34
St Mirren,5535,10,8,9,19,38,62,-24,33
Hibernian,5536,1,17,12,7,57,32,25,63
Morton,5536,2,17,11,8,47,33,14,62
Falkirk,5536,3,16,10,10,56,39,17,58
Dundee Utd,5536,4,16,10,10,52,40,12,58
Dumbarton,5536,5,12,11,13,49,52,-3,47
Dunfermline,5536,6,10,14,12,44,46,-2,44
Queen of S't,5536,7,11,10,15,45,55,-10,43
Raith,5536,8,10,12,14,38,47,-9,42
Ayr,5536,9,7,13,16,37,62,-25,34
St Mirren,5536,10,6,13,17,38,57,-19,31
Hibernian,5537,1,19,13,4,56,27,29,70
Morton,5537,2,15,11,10,50,38,12,56
Falkirk,5537,3,14,10,12,53,43,10,52
Dundee Utd,5537,4,13,13,10,44,40,4,52
Queen of S't,5537,5,12,11,13,45,49,-4,47
Dunfermline,5537,6,11,13,12,47,46,1,46
St Mirren,5537,7,11,10,15,44,53,-9,43
Raith,5537,8,11,10,15,38,48,-10,43
Ayr,5537,9,9,11,16,36,57,-21,38
Dumbarton,5537,10,8,12,16,46,58,-12,36
Hibernian,5538,1,18,13,5,52,26,26,67
Morton,5538,2,16,12,8,50,34,16,60
Falkirk,5538,3,16,10,10,60,45,15,58
Dundee Utd,5538,4,16,10,10,50,38,12,58
Queen of S't,5538,5,13,9,14,48,49,-1,48
Dunfermline,5538,6,11,12,13,51,50,1,45
Ayr,5538,7,9,14,13,35,50,-15,41
St Mirren,5538,8,10,10,16,43,54,-11,40
Raith,5538,9,8,11,17,33,55,-22,35
Dumbarton,5538,10,7,11,18,46,67,-21,32
Hibernian,5539,1,20,11,5,54,25,29,71
Morton,5539,2,17,12,7,49,33,16,63
Falkirk,5539,3,17,10,9,63,42,21,61
Dundee Utd,5539,4,14,11,11,47,42,5,53
Dunfermline,5539,5,10,13,13,42,46,-4,43
Queen of S't,5539,6,10,11,15,41,51,-10,41
Dumbarton,5539,7,9,12,15,46,57,-11,39
Raith,5539,8,9,11,16,33,47,-14,38
St Mirren,5539,9,9,10,17,41,54,-13,37
Ayr,5539,10,8,13,15,34,53,-19,37
Hibernian,5540,1,20,13,3,55,23,32,73
Falkirk,5540,2,16,11,9,61,42,19,59
Morton,5540,3,15,12,9,46,36,10,57
Dundee Utd,5540,4,14,13,9,49,39,10,55
Queen of S't,5540,5,11,11,14,43,50,-7,44
Dunfermline,5540,6,9,16,11,49,49,0,43
Raith,5540,7,10,10,16,37,53,-16,40
Dumbarton,5540,8,8,14,14,49,59,-10,38
Ayr,5540,9,8,12,16,34,55,-21,36
St Mirren,5540,10,8,10,18,40,57,-17,34
Hibernian,5541,1,21,10,5,59,26,33,73
Dundee Utd,5541,2,17,9,10,55,39,16,60
Morton,5541,3,16,11,9,47,34,13,59
Falkirk,5541,4,15,10,11,53,42,11,55
Queen of S't,5541,5,12,9,15,45,47,-2,45
Dunfermline,5541,6,10,12,14,49,57,-8,42
Ayr,5541,7,10,12,14,34,51,-17,42
Dumbarton,5541,8,9,12,15,44,56,-12,39
Raith,5541,9,9,10,17,31,49,-18,37
St Mirren,5541,10,9,9,18,37,53,-16,36
Hibernian,5542,1,20,11,5,58,28,30,71
Falkirk,5542,2,15,10,11,56,42,14,55
Dundee Utd,5542,3,15,10,11,49,44,5,55
Morton,5542,4,14,10,12,46,40,6,52
Raith,5542,5,13,9,14,38,44,-6,48
Dumbarton,5542,6,11,12,13,49,52,-3,45
Queen of S't,5542,7,11,11,14,41,46,-5,44
Dunfermline,5542,8,9,14,13,44,48,-4,41
Ayr,5542,9,8,13,15,32,49,-17,37
St Mirren,5542,10,9,10,17,40,60,-20,37
Hibernian,5543,1,22,11,3,63,22,41,77
Falkirk,5543,2,15,11,10,55,38,17,56
Morton,5543,3,15,11,10,46,42,4,56
Dundee Utd,5543,4,15,10,11,54,44,10,55
Queen of S't,5543,5,13,9,14,45,49,-4,48
Dumbarton,5543,6,11,11,14,50,55,-5,44
Ayr,5543,7,10,12,14,38,57,-19,42
Dunfermline,5543,8,9,14,13,46,50,-4,41
Raith,5543,9,10,9,17,34,49,-15,39
St Mirren,5543,10,6,10,20,38,63,-25,28
Hibernian,5544,1,21,12,3,62,25,37,75
Falkirk,5544,2,18,9,9,58,41,17,63
Morton,5544,3,15,11,10,48,42,6,56
Dundee Utd,5544,4,15,9,12,51,43,8,54
Dunfermline,5544,5,11,14,11,46,44,2,47
Raith,5544,6,11,10,15,38,48,-10,43
Dumbarton,5544,7,10,12,14,52,60,-8,42
Ayr,5544,8,8,13,15,32,52,-20,37
Queen of S't,5544,9,9,8,19,41,57,-16,35
St Mirren,5544,10,7,12,17,39,55,-16,33
Hibernian,5545,1,18,14,4,57,26,31,68
Morton,5545,2,16,13,7,46,34,12,61
Falkirk,5545,3,15,12,9,62,44,18,57
Dundee Utd,5545,4,14,11,11,42,36,6,53
Queen of S't,5545,5,12,10,14,49,56,-7,46
Dunfermline,5545,6,11,12,13,50,47,3,45
St Mirren,5545,7,10,10,16,42,53,-11,40
Raith,5545,8,10,10,16,38,55,-17,40
Dumbarton,5545,9,9,12,15,50,61,-11,39
Ayr,5545,10,6,14,16,34,58,-24,32
Hibernian,5546,1,21,11,4,58,26,32,74
Morton,5546,2,18,11,7,59,38,21,65
Falkirk,5546,3,17,9,10,61,41,20,60
Dundee Utd,5546,4,15,11,10,51,42,9,56
Queen of S't,5546,5,12,10,14,45,48,-3,46
Dunfermline,5546,6,8,15,13,45,48,-3,39
Dumbarton,5546,7,9,12,15,44,61,-17,39
Raith,5546,8,9,10,17,34,53,-19,37
Ayr,5546,9,8,12,16,35,56,-21,36
St Mirren,5546,10,7,11,18,43,62,-19,32
Hibernian,5547,1,22,11,3,60,23,37,77
Falkirk,5547,2,14,12,10,58,47,11,54
Morton,5547,3,14,12,10,44,37,7,54
Dundee Utd,5547,4,13,11,12,45,43,2,50
Dunfermline,5547,5,12,13,11,50,45,5,49
Dumbarton,5547,6,11,11,14,48,55,-7,44
Queen of S't,5547,7,11,10,15,43,49,-6,43
Raith,5547,8,9,12,15,33,49,-16,39
St Mirren,5547,9,9,11,16,42,54,-12,38
Ayr,5547,10,7,13,16,31,52,-21,34
Hibernian,5548,1,22,11,3,58,23,35,77
Falkirk,5548,2,18,9,9,61,41,20,63
Morton,5548,3,16,11,9,47,37,10,59
Dundee Utd,5548,4,16,9,11,54,40,14,57
Queen of S't,5548,5,12,9,15,46,47,-1,45
Ayr,5548,6,10,12,14,39,55,-16,42
Dunfermline,5548,7,8,15,13,44,49,-5,39
Dumbarton,5548,8,7,14,15,52,67,-15,35
St Mirren,5548,9,8,11,17,45,61,-16,35
Raith,5548,10,8,9,19,32,58,-26,33
Hibernian,5549,1,18,14,4,57,29,28,68
Morton,5549,2,17,11,8,53,40,13,62
Falkirk,5549,3,15,11,10,55,43,12,56
Dundee Utd,5549,4,15,10,11,49,39,10,55
Queen of S't,5549,5,11,11,14,48,49,-1,44
Dunfermline,5549,6,10,14,12,45,47,-2,44
Raith,5549,7,11,10,15,39,48,-9,43
Dumbarton,5549,8,9,12,15,51,61,-10,39
St Mirren,5549,9,8,13,15,42,55,-13,37
Ayr,5549,10,7,12,17,30,58,-28,33
Hibernian,5550,1,21,12,3,59,21,38,75
Falkirk,5550,2,17,11,8,61,39,22,62
Dundee Utd,5550,3,16,9,11,54,45,9,57
Morton,5550,4,14,13,9,51,42,9,55
Queen of S't,5550,5,11,10,15,48,54,-6,43
Raith,5550,6,10,10,16,37,50,-13,40
Dunfermline,5550,7,8,15,13,44,55,-11,39
Dumbarton,5550,8,8,14,14,45,54,-9,38
Ayr,5550,9,9,11,16,38,62,-24,38
St Mirren,5550,10,9,9,18,45,60,-15,36
Hibernian,5551,1,19,11,6,53,26,27,68
Morton,5551,2,18,12,6,54,32,22,66
Falkirk,5551,3,15,12,9,54,39,15,57
Dundee Utd,5551,4,15,9,12,48,40,8,54
Raith,5551,5,12,9,15,36,44,-8,45
Queen of S't,5551,6,11,11,14,45,52,-7,44
Dunfermline,5551,7,9,14,13,46,52,-6,41
St Mirren,5551,8,9,11,16,40,55,-15,38
Ayr,5551,9,8,12,16,34,56,-22,36
Dumbarton,5551,10,8,11,17,45,59,-14,35
Morton,5552,1,20,10,6,55,34,21,70
Hibernian,5552,2,19,12,5,54,25,29,69
Falkirk,5552,3,17,10,9,58,44,14,61
Dundee Utd,5552,4,14,10,12,49,40,9,52
Dunfermline,5552,5,11,12,13,46,47,-1,45
Queen of S't,5552,6,11,9,16,43,50,-7,42
Raith,5552,7,9,11,16,33,48,-15,38
Ayr,5552,8,8,14,14,38,58,-20,38
Dumbarton,5552,9,8,11,17,49,64,-15,35
St Mirren,5552,10,8,11,17,42,57,-15,35
Hibernian,5553,1,21,12,3,61,25,36,75
Falkirk,5553,2,18,11,7,64,39,25,65
Morton,5553,3,15,11,10,48,42,6,56
Dundee Utd,5553,4,15,10,11,51,41,10,55
Queen of S't,5553,5,13,9,14,47,48,-1,48
Dunfermline,5553,6,9,14,13,49,52,-3,41
Dumbarton,5553,7,9,12,15,49,55,-6,39
St Mirren,5553,8,9,11,16,39,55,-16,38
Raith,5553,9,9,10,17,31,49,-18,37
Ayr,5553,10,7,10,19,30,63,-33,31
Hibernian,5554,1,18,12,6,55,27,28,66
Morton,5554,2,18,11,7,51,38,13,65
Falkirk,5554,3,17,9,10,62,42,20,60
Dundee Utd,5554,4,16,8,12,49,44,5,56
Dunfermline,5554,5,11,13,12,48,44,4,46
Queen of S't,5554,6,11,9,16,45,55,-10,42
Ayr,5554,7,10,11,15,37,53,-16,41
Dumbarton,5554,8,8,13,15,47,56,-9,37
Raith,5554,9,9,10,17,35,55,-20,37
St Mirren,5554,10,8,12,16,41,56,-15,36
Hibernian,5555,1,20,12,4,58,24,34,72
Morton,5555,2,17,10,9,51,38,13,61
Falkirk,5555,3,17,9,10,64,40,24,60
Dundee Utd,5555,4,16,11,9,54,41,13,59
Dunfermline,5555,5,10,13,13,45,49,-4,43
Dumbarton,5555,6,10,11,15,50,56,-6,41
Queen of S't,5555,7,10,11,15,40,54,-14,41
St Mirren,5555,8,10,9,17,42,59,-17,39
Raith,5555,9,9,10,17,33,49,-16,37
Ayr,5555,10,7,12,17,32,59,-27,33
Hibernian,5556,1,20,12,4,60,26,34,72
Dundee Utd,5556,2,18,10,8,54,33,21,64
Morton,5556,3,18,10,8,49,32,17,64
Falkirk,5556,4,17,10,9,61,41,20,61
Queen of S't,5556,5,12,10,14,47,52,-5,46
Dunfermline,5556,6,9,13,14,48,52,-4,40
Raith,5556,7,10,8,18,34,53,-19,38
Dumbarton,5556,8,8,11,17,46,62,-16,35
St Mirren,5556,9,8,10,18,41,60,-19,34
Ayr,5556,10,7,12,17,31,60,-29,33
Hibernian,5557,1,19,12,5,54,28,26,69
Morton,5557,2,19,10,7,53,35,18,67
Dundee Utd,5557,3,19,9,8,56,38,18,66
Falkirk,5557,4,16,10,10,57,41,16,58
Queen of S't,5557,5,11,8,17,45,54,-9,41
Raith,5557,6,10,9,17,34,48,-14,39
St Mirren,5557,7,9,11,16,43,57,-14,38
Ayr,5557,8,9,11,16,36,55,-19,38
Dunfermline,5557,9,8,12,16,45,54,-9,36
Dumbarton,5557,10,8,12,16,49,62,-13,36
Morton,5558,1,19,10,7,51,34,17,67
Hibernian,5558,2,18,12,6,52,27,25,66
Falkirk,5558,3,16,10,10,56,44,12,58
Dundee Utd,5558,4,15,10,11,52,42,10,55
Queen of S't,5558,5,14,9,13,50,49,1,51
Dunfermline,5558,6,10,12,14,45,47,-2,42
Raith,5558,7,11,9,16,39,49,-10,42
Ayr,5558,8,9,11,16,34,57,-23,38
St Mirren,5558,9,8,11,17,38,55,-17,35
Dumbarton,5558,10,8,10,18,48,61,-13,34
Hibernian,5559,1,18,11,7,52,25,27,65
Morton,5559,2,17,12,7,50,36,14,63
Dundee Utd,5559,3,17,11,8,54,36,18,62
Falkirk,5559,4,16,12,8,56,36,20,60
Dunfermline,5559,5,9,14,13,45,50,-5,41
Ayr,5559,6,10,11,15,39,48,-9,41
Queen of S't,5559,7,10,10,16,39,50,-11,40
Raith,5559,8,10,10,16,33,49,-16,40
Dumbarton,5559,9,9,12,15,45,58,-13,39
St Mirren,5559,10,6,13,17,38,63,-25,31
Hibernian,5560,1,18,14,4,54,28,26,68
Falkirk,5560,2,17,12,7,58,37,21,63
Morton,5560,3,16,9,11,52,44,8,57
Dundee Utd,5560,4,15,10,11,50,41,9,55
Ayr,5560,5,11,12,13,40,54,-14,45
Queen of S't,5560,6,11,11,14,45,49,-4,44
Dumbarton,5560,7,9,13,14,49,57,-8,40
Raith,5560,8,9,12,15,32,46,-14,39
Dunfermline,5560,9,8,14,14,46,54,-8,38
St Mirren,5560,10,8,9,19,41,57,-16,33
Morton,5561,1,19,11,6,54,34,20,68
Hibernian,5561,2,17,13,6,53,30,23,64
Falkirk,5561,3,17,9,10,59,42,17,60
Dundee Utd,5561,4,15,11,10,48,38,10,56
Dunfermline,5561,5,11,11,14,47,50,-3,44
Queen of S't,5561,6,11,9,16,47,52,-5,42
St Mirren,5561,7,10,11,15,45,52,-7,41
Ayr,5561,8,10,10,16,36,61,-25,40
Dumbarton,5561,9,9,11,16,49,60,-11,38
Raith,5561,10,9,8,19,38,57,-19,35
Hibernian,5562,1,17,14,5,50,29,21,65
Falkirk,5562,2,17,11,8,59,36,23,62
Morton,5562,3,17,11,8,55,40,15,62
Dundee Utd,5562,4,15,11,10,53,40,13,56
St Mirren,5562,5,10,11,15,43,53,-10,41
Queen of S't,5562,6,10,10,16,48,52,-4,40
Raith,5562,7,10,10,16,34,53,-19,40
Dunfermline,5562,8,9,12,15,45,53,-8,39
Ayr,5562,9,8,15,13,34,49,-15,39
Dumbarton,5562,10,9,11,16,43,59,-16,38
Hibernian,5563,1,20,12,4,54,25,29,72
Dundee Utd,5563,2,17,9,10,48,37,11,60
Falkirk,5563,3,16,11,9,59,38,21,59
Morton,5563,4,16,10,10,50,38,12,58
Queen of S't,5563,5,12,10,14,43,49,-6,46
Dunfermline,5563,6,10,13,13,44,46,-2,43
Dumbarton,5563,7,10,11,15,45,55,-10,41
St Mirren,5563,8,10,9,17,41,54,-13,39
Raith,5563,9,9,9,18,35,52,-17,36
Ayr,5563,10,7,12,17,30,55,-25,33
Morton,5564,1,17,13,6,49,33,16,64
Hibernian,5564,2,17,12,7,52,31,21,63
Falkirk,5564,3,17,11,8,56,37,19,62
Dundee Utd,5564,4,15,12,9,50,38,12,57
Queen of S't,5564,5,12,10,14,48,48,0,46
Dunfermline,5564,6,10,11,15,45,50,-5,41
Dumbarton,5564,7,10,11,15,48,58,-10,41
Raith,5564,8,10,9,17,38,50,-12,39
St Mirren,5564,9,8,13,15,38,52,-14,37
Ayr,5564,10,7,12,17,33,60,-27,33
Hibernian,5565,1,17,14,5,53,28,25,65
Falkirk,5565,2,16,12,8,58,38,20,60
Dundee Utd,5565,3,16,10,10,54,43,11,58
Morton,5565,4,14,14,8,47,39,8,56
Dunfermline,5565,5,10,14,12,52,50,2,44
Queen of S't,5565,6,10,12,14,49,55,-6,42
Dumbarton,5565,7,10,12,14,47,56,-9,42
Raith,5565,8,10,11,15,37,51,-14,41
St Mirren,5565,9,9,10,17,40,55,-15,37
Ayr,5565,10,6,15,15,32,54,-22,33
Hibernian,5566,1,20,11,5,57,26,31,71
Falkirk,5566,2,19,10,7,63,36,27,67
Morton,5566,3,15,12,9,47,38,9,57
Dundee Utd,5566,4,14,11,11,42,38,4,53
Dunfermline,5566,5,12,11,13,50,46,4,47
Queen of S't,5566,6,11,10,15,42,52,-10,43
Ayr,5566,7,10,12,14,36,50,-14,42
Raith,5566,8,10,9,17,35,53,-18,39
St Mirren,5566,9,8,10,18,37,54,-17,34
Dumbarton,5566,10,7,12,17,44,60,-16,33
Hibernian,5567,1,18,13,5,55,27,28,67
Falkirk,5567,2,16,12,8,60,38,22,60
Morton,5567,3,16,12,8,48,34,14,60
Dundee Utd,5567,4,15,9,12,44,43,1,54
Dunfermline,5567,5,11,13,12,46,45,1,46
Queen of S't,5567,6,12,8,16,44,51,-7,44
Dumbarton,5567,7,9,13,14,46,56,-10,40
Raith,5567,8,9,11,16,33,51,-18,38
Ayr,5567,9,9,11,16,34,55,-21,38
St Mirren,5567,10,8,12,16,41,51,-10,36
Hibernian,5568,1,18,14,4,54,26,28,68
Morton,5568,2,18,12,6,54,34,20,66
Falkirk,5568,3,16,12,8,65,44,21,60
Dundee Utd,5568,4,17,9,10,54,39,15,60
Queen of S't,5568,5,12,10,14,43,48,-5,46
Raith,5568,6,11,10,15,39,48,-9,43
Dunfermline,5568,7,9,13,14,43,48,-5,40
Dumbarton,5568,8,9,11,16,45,58,-13,38
St Mirren,5568,9,8,10,18,39,62,-23,34
Ayr,5568,10,6,11,19,31,60,-29,29
Hibernian,5569,1,19,12,5,61,28,33,69
Morton,5569,2,19,10,7,59,36,23,67
Dundee Utd,5569,3,18,8,10,53,41,12,62
Falkirk,5569,4,16,11,9,59,42,17,59
St Mirren,5569,5,10,11,15,42,50,-8,41
Dumbarton,5569,6,10,11,15,49,59,-10,41
Queen of S't,5569,7,11,8,17,41,56,-15,41
Raith,5569,8,9,10,17,33,52,-19,37
Ayr,5569,9,9,10,17,33,53,-20,37
Dunfermline,5569,10,7,13,16,41,54,-13,34
Hibernian,5570,1,18,14,4,53,23,30,68
Morton,5570,2,17,11,8,49,35,14,62
Dundee Utd,5570,3,16,10,10,50,41,9,58
Falkirk,5570,4,13,13,10,57,47,10,52
Queen of S't,5570,5,13,10,13,46,47,-1,49
Raith,5570,6,12,9,15,39,48,-9,45
Dunfermline,5570,7,9,14,13,52,54,-2,41
St Mirren,5570,8,10,10,16,47,54,-7,40
Dumbarton,5570,9,8,11,17,48,63,-15,35
Ayr,5570,10,7,12,17,32,61,-29,33
Hibernian,5571,1,20,12,4,57,24,33,72
Morton,5571,2,17,9,10,50,38,12,60
Falkirk,5571,3,16,11,9,57,42,15,59
Dundee Utd,5571,4,15,11,10,47,37,10,56
Raith,5571,5,13,8,15,41,47,-6,47
Dunfermline,5571,6,10,12,14,48,46,2,42
Dumbarton,5571,7,10,12,14,47,54,-7,42
Queen of S't,5571,8,10,11,15,43,55,-12,41
Ayr,5571,9,7,13,16,29,54,-25,34
St Mirren,5571,10,8,9,19,37,59,-22,33
Hibernian,5572,1,20,13,3,54,24,30,73
Dundee Utd,5572,2,17,10,9,59,42,17,61
Morton,5572,3,14,14,8,47,38,9,56
Falkirk,5572,4,15,10,11,56,43,13,55
Queen of S't,5572,5,12,11,13,46,47,-1,47
Raith,5572,6,11,8,17,34,48,-14,41
Dumbarton,5572,7,9,13,14,51,59,-8,40
Dunfermline,5572,8,8,14,14,44,50,-6,38
St Mirren,5572,9,9,10,17,42,58,-16,37
Ayr,5572,10,8,11,17,33,57,-24,35
Morton,5573,1,17,12,7,56,37,19,63
Dundee Utd,5573,2,18,9,9,51,39,12,63
Hibernian,5573,3,16,14,6,54,30,24,62
Falkirk,5573,4,15,12,9,55,40,15,57
Dunfermline,5573,5,11,11,14,43,48,-5,44
Queen of S't,5573,6,11,10,15,44,50,-6,43
Dumbarton,5573,7,10,11,15,46,55,-9,41
St Mirren,5573,8,9,12,15,45,58,-13,39
Raith,5573,9,9,11,16,38,53,-15,38
Ayr,5573,10,6,14,16,31,53,-22,32
Hibernian,5574,1,21,11,4,59,28,31,74
Morton,5574,2,17,10,9,53,41,12,61
Dundee Utd,5574,3,16,8,12,48,41,7,56
Falkirk,5574,4,14,12,10,59,45,14,54
Queen of S't,5574,5,12,9,15,51,51,0,45
Dunfermline,5574,6,9,15,12,47,49,-2,42
Raith,5574,7,9,12,15,37,49,-12,39
St Mirren,5574,8,9,11,16,41,56,-15,38
Ayr,5574,9,9,11,16,35,56,-21,38
Dumbarton,5574,10,8,13,15,48,62,-14,37
Hibernian,5575,1,19,13,4,55,27,28,70
Morton,5575,2,18,10,8,54,37,17,64
Falkirk,5575,3,15,12,9,57,42,15,57
Dundee Utd,5575,4,15,10,11,54,41,13,55
Dunfermline,5575,5,11,12,13,47,52,-5,45
Queen of S't,5575,6,11,10,15,43,47,-4,43
Raith,5575,7,11,9,16,40,50,-10,42
Dumbarton,5575,8,8,13,15,46,59,-13,37
St Mirren,5575,9,8,11,17,42,59,-17,35
Ayr,5575,10,7,14,15,32,56,-24,35
Hibernian,5576,1,19,13,4,59,28,31,70
Falkirk,5576,2,16,13,7,59,39,20,61
Morton,5576,3,16,13,7,46,35,11,61
Dundee Utd,5576,4,14,12,10,44,39,5,54
Raith,5576,5,12,10,14,37,46,-9,46
Dumbarton,5576,6,10,13,13,52,55,-3,43
Queen of S't,5576,7,11,8,17,42,50,-8,41
Dunfermline,5576,8,8,13,15,46,52,-6,37
Ayr,5576,9,7,15,14,28,48,-20,36
St Mirren,5576,10,6,12,18,32,53,-21,30
Hibernian,5577,1,19,11,6,57,26,31,68
Morton,5577,2,18,10,8,51,40,11,64
Falkirk,5577,3,17,12,7,62,37,25,63
Dundee Utd,5577,4,15,10,11,51,40,11,55
Queen of S't,5577,5,13,10,13,50,51,-1,49
Dunfermline,5577,6,10,12,14,43,49,-6,42
Ayr,5577,7,9,12,15,37,55,-18,39
St Mirren,5577,8,9,11,16,46,57,-11,38
Raith,5577,9,9,8,19,36,58,-22,35
Dumbarton,5577,10,8,10,18,45,65,-20,34
Hibernian,5578,1,19,12,5,57,28,29,69
Morton,5578,2,17,12,7,53,38,15,63
Falkirk,5578,3,15,11,10,52,42,10,56
Dundee Utd,5578,4,14,13,9,50,38,12,55
Queen of S't,5578,5,13,9,14,45,47,-2,48
Dunfermline,5578,6,10,12,14,51,52,-1,42
St Mirren,5578,7,8,13,15,38,51,-13,37
Dumbarton,5578,8,8,13,15,43,57,-14,37
Raith,5578,9,9,10,17,31,47,-16,37
Ayr,5578,10,7,15,14,29,49,-20,36
Hibernian,5579,1,19,13,4,56,26,30,70
Morton,5579,2,15,13,8,48,38,10,58
Falkirk,5579,3,16,9,11,60,44,16,57
Dundee Utd,5579,4,16,9,11,53,45,8,57
Dumbarton,5579,5,11,12,13,51,54,-3,45
Dunfermline,5579,6,9,16,11,44,43,1,43
Queen of S't,5579,7,10,10,16,46,56,-10,40
St Mirren,5579,8,10,9,17,42,58,-16,39
Raith,5579,9,9,11,16,32,48,-16,38
Ayr,5579,10,7,14,15,35,55,-20,35
Hibernian,5580,1,17,13,6,57,31,26,64
Morton,5580,2,17,10,9,53,39,14,61
Falkirk,5580,3,15,13,8,59,42,17,58
Dundee Utd,5580,4,13,12,11,46,45,1,51
Queen of S't,5580,5,12,11,13,49,51,-2,47
Dunfermline,5580,6,10,13,13,43,47,-4,43
Raith,5580,7,10,12,14,36,46,-10,42
St Mirren,5580,8,9,12,15,42,56,-14,39
Ayr,5580,9,8,14,14,38,55,-17,38
Dumbarton,5580,10,8,12,16,46,57,-11,36
Hibernian,5581,1,19,12,5,54,27,27,69
Morton,5581,2,17,11,8,52,36,16,62
Falkirk,5581,3,16,12,8,60,39,21,60
Dundee Utd,5581,4,17,9,10,57,42,15,60
Dunfermline,5581,5,10,13,13,48,51,-3,43
Dumbarton,5581,6,10,12,14,49,56,-7,42
Raith,5581,7,10,11,15,39,52,-13,41
Queen of S't,5581,8,10,9,17,44,55,-11,39
Ayr,5581,9,8,13,15,39,59,-20,37
St Mirren,5581,10,6,12,18,38,63,-25,30
Hibernian,5582,1,20,10,6,63,28,35,70
Morton,5582,2,18,11,7,49,34,15,65
Dundee Utd,5582,3,16,9,11,49,40,9,57
Falkirk,5582,4,14,11,11,54,44,10,53
Dunfermline,5582,5,12,13,11,47,42,5,49
Queen of S't,5582,6,11,11,14,49,52,-3,44
St Mirren,5582,7,10,10,16,42,56,-14,40
Dumbarton,5582,8,9,11,16,51,62,-11,38
Raith,5582,9,8,11,17,33,52,-19,35
Ayr,5582,10,7,13,16,33,60,-27,34
Hibernian,5583,1,19,11,6,56,28,28,68
Morton,5583,2,18,9,9,52,35,17,63
Falkirk,5583,3,17,10,9,58,40,18,61
Dundee Utd,5583,4,14,12,10,52,47,5,54
Dunfermline,5583,5,12,12,12,48,46,2,48
Raith,5583,6,10,11,15,36,47,-11,41
Queen of S't,5583,7,9,12,15,45,55,-10,39
Dumbarton,5583,8,9,12,15,51,62,-11,39
Ayr,5583,9,8,12,16,37,59,-22,36
St Mirren,5583,10,8,11,17,42,58,-16,35
Hibernian,5584,1,18,12,6,54,25,29,66
Morton,5584,2,18,12,6,50,32,18,66
Falkirk,5584,3,15,11,10,53,41,12,56
Dundee Utd,5584,4,14,10,12,51,42,9,52
Queen of S't,5584,5,13,10,13,48,48,0,49
Dunfermline,5584,6,11,13,12,47,45,2,46
Raith,5584,7,10,11,15,33,46,-13,41
Dumbarton,5584,8,10,10,16,47,63,-16,40
Ayr,5584,9,8,12,16,33,55,-22,36
St Mirren,5584,10,7,11,18,36,55,-19,32
Hibernian,5585,1,20,13,3,61,23,38,73
Morton,5585,2,18,12,6,54,35,19,66
Falkirk,5585,3,18,9,9,63,40,23,63
Dundee Utd,5585,4,17,10,9,55,43,12,61
Queen of S't,5585,5,10,11,15,42,51,-9,41
Dunfermline,5585,6,9,13,14,42,49,-7,40
St Mirren,5585,7,9,9,18,40,57,-17,36
Dumbarton,5585,8,8,11,17,46,61,-15,35
Ayr,5585,9,7,14,15,31,52,-21,35
Raith,5585,10,9,8,19,35,58,-23,35
Hibernian,5586,1,19,13,4,57,28,29,70
Falkirk,5586,2,19,9,8,63,36,27,66
Morton,5586,3,15,14,7,49,38,11,59
Dundee Utd,5586,4,16,10,10,51,36,15,58
Dunfermline,5586,5,10,14,12,46,46,0,44
Queen of S't,5586,6,11,10,15,42,47,-5,43
St Mirren,5586,7,9,11,16,46,55,-9,38
Ayr,5586,8,8,12,16,30,55,-25,36
Dumbarton,5586,9,8,11,17,43,65,-22,35
Raith,5586,10,8,10,18,29,50,-21,34
Hibernian,5587,1,20,11,5,60,27,33,71
Morton,5587,2,17,10,9,51,37,14,61
Falkirk,5587,3,17,9,10,57,41,16,60
Dundee Utd,5587,4,16,9,11,51,41,10,57
Dunfermline,5587,5,11,12,13,47,49,-2,45
Queen of S't,5587,6,12,8,16,49,55,-6,44
Ayr,5587,7,9,12,15,36,54,-18,39
St Mirren,5587,8,9,11,16,41,54,-13,38
Dumbarton,5587,9,9,10,17,45,59,-14,37
Raith,5587,10,9,10,17,37,57,-20,37
Hibernian,5588,1,20,11,5,57,26,31,71
Morton,5588,2,17,12,7,52,38,14,63
Dundee Utd,5588,3,18,8,10,55,39,16,62
Falkirk,5588,4,16,10,10,58,41,17,58
Dunfermline,5588,5,11,12,13,45,49,-4,45
Dumbarton,5588,6,10,12,14,50,54,-4,42
Raith,5588,7,11,9,16,39,50,-11,42
Queen of S't,5588,8,10,8,18,42,55,-13,38
St Mirren,5588,9,8,10,18,39,61,-22,34
Ayr,5588,10,7,12,17,32,56,-24,33
Hibernian,5589,1,19,13,4,56,24,32,70
Falkirk,5589,2,17,12,7,62,40,22,63
Morton,5589,3,15,12,9,47,41,6,57
Dundee Utd,5589,4,15,9,12,48,42,6,54
Dunfermline,5589,5,10,15,11,47,46,1,45
Queen of S't,5589,6,11,9,16,41,50,-9,42
Ayr,5589,7,10,11,15,35,52,-17,41
Dumbarton,5589,8,9,11,16,48,55,-7,38
St Mirren,5589,9,9,11,16,41,54,-13,38
Raith,5589,10,9,9,18,34,55,-21,36
Hibernian,5590,1,18,12,6,57,31,26,66
Morton,5590,2,17,13,6,59,40,19,64
Falkirk,5590,3,15,11,10,57,44,13,56
Dundee Utd,5590,4,15,9,12,48,39,9,54
Queen of S't,5590,5,14,9,13,44,45,-1,51
Dumbarton,5590,6,10,12,14,52,57,-5,42
Raith,5590,7,10,11,15,33,48,-15,41
Ayr,5590,8,9,13,14,36,54,-18,40
Dunfermline,5590,9,8,13,15,43,50,-7,37
St Mirren,5590,10,7,11,18,38,59,-21,32
Hibernian,5591,1,22,10,4,66,28,38,76
Dundee Utd,5591,2,18,9,9,59,39,20,63
Falkirk,5591,3,17,9,10,60,42,18,60
Morton,5591,4,15,13,8,52,42,10,58
Dunfermline,5591,5,11,12,13,48,47,1,45
Queen of S't,5591,6,12,9,15,43,49,-6,45
Dumbarton,5591,7,8,13,15,44,60,-16,37
Raith,5591,8,8,11,17,31,51,-20,35
Ayr,5591,9,7,13,16,33,59,-26,34
St Mirren,5591,10,7,11,18,39,58,-19,32
Hibernian,5592,1,18,12,6,52,28,24,66
Morton,5592,2,18,10,8,51,37,14,64
Falkirk,5592,3,17,10,9,58,39,19,61
Dundee Utd,5592,4,17,9,10,54,37,17,60
Queen of S't,5592,5,12,10,14,47,48,-1,46
Raith,5592,6,12,9,15,39,48,-9,45
Dunfermline,5592,7,10,13,13,49,52,-3,43
St Mirren,5592,8,8,11,17,39,56,-17,35
Dumbarton,5592,9,7,13,16,48,66,-18,34
Ayr,5592,10,7,11,18,33,59,-26,32
Hibernian,5593,1,22,10,4,58,25,33,76
Morton,5593,2,16,12,8,48,39,9,60
Dundee Utd,5593,3,16,9,11,56,41,15,57
Falkirk,5593,4,15,11,10,55,41,14,56
Queen of S't,5593,5,13,11,12,50,49,1,50
Dunfermline,5593,6,9,14,13,46,51,-5,41
Raith,5593,7,10,10,16,39,51,-12,40
St Mirren,5593,8,9,9,18,36,54,-18,36
Ayr,5593,9,8,11,17,35,57,-22,35
Dumbarton,5593,10,7,13,16,46,61,-15,34
Hibernian,5594,1,21,11,4,55,22,33,74
Morton,5594,2,15,14,7,48,38,10,59
Dundee Utd,5594,3,15,11,10,46,37,9,56
Falkirk,5594,4,15,10,11,56,45,11,55
Queen of S't,5594,5,13,9,14,45,48,-3,48
Dunfermline,5594,6,10,12,14,47,52,-5,42
St Mirren,5594,7,10,10,16,45,56,-11,40
Dumbarton,5594,8,8,13,15,48,58,-10,37
Ayr,5594,9,8,13,15,35,54,-19,37
Raith,5594,10,9,9,18,35,50,-15,36
Hibernian,5595,1,18,12,6,52,26,26,66
Morton,5595,2,17,12,7,49,35,14,63
Falkirk,5595,3,17,10,9,58,42,16,61
Dundee Utd,5595,4,16,9,11,57,44,13,57
Dunfermline,5595,5,12,12,12,47,43,4,48
Queen of S't,5595,6,12,9,15,45,51,-6,45
Raith,5595,7,10,10,16,37,49,-12,40
Ayr,5595,8,8,14,14,34,52,-18,38
Dumbarton,5595,9,8,11,17,45,62,-17,35
St Mirren,5595,10,8,9,19,41,61,-20,33
Hibernian,5596,1,18,14,4,55,27,28,68
Morton,5596,2,16,12,8,56,41,15,60
Falkirk,5596,3,15,11,10,55,43,12,56
Dundee Utd,5596,4,15,9,12,52,46,6,54
Queen of S't,5596,5,13,10,13,49,48,1,49
Dunfermline,5596,6,12,12,12,49,48,1,48
Dumbarton,5596,7,9,13,14,48,59,-11,40
Raith,5596,8,9,10,17,36,50,-14,37
St Mirren,5596,9,8,12,16,41,56,-15,36
Ayr,5596,10,8,11,17,33,56,-23,35
Morton,5597,1,19,10,7,58,37,21,67
Hibernian,5597,2,18,12,6,54,32,22,66
Falkirk,5597,3,15,10,11,55,46,9,55
Dundee Utd,5597,4,15,10,11,47,39,8,55
Raith,5597,5,12,10,14,41,47,-6,46
Queen of S't,5597,6,11,12,13,43,49,-6,45
Ayr,5597,7,11,12,13,37,48,-11,45
Dunfermline,5597,8,10,12,14,47,48,-1,42
Dumbarton,5597,9,8,12,16,45,56,-11,36
St Mirren,5597,10,6,10,20,34,59,-25,28
Hibernian,5598,1,18,12,6,56,26,30,66
Morton,5598,2,16,11,9,50,41,9,59
Falkirk,5598,3,14,12,10,57,40,17,54
Dundee Utd,5598,4,13,11,12,43,42,1,50
Queen of S't,5598,5,13,9,14,47,49,-2,48
Dunfermline,5598,6,11,12,13,48,47,1,45
Ayr,5598,7,11,11,14,38,54,-16,44
Dumbarton,5598,8,10,11,15,49,56,-7,41
St Mirren,5598,9,9,12,15,38,53,-15,39
Raith,5598,10,10,9,17,33,51,-18,39
Hibernian,5599,1,17,14,5,55,28,27,65
Falkirk,5599,2,18,9,9,60,37,23,63
Dundee Utd,5599,3,17,9,10,52,38,14,60
Morton,5599,4,16,12,8,48,38,10,60
Queen of S't,5599,5,12,10,14,44,50,-6,46
St Mirren,5599,6,11,9,16,43,54,-11,42
Raith,5599,7,10,9,17,36,51,-15,39
Ayr,5599,8,9,11,16,38,58,-20,38
Dumbarton,5599,9,8,13,15,46,59,-13,37
Dunfermline,5599,10,7,14,15,43,52,-9,35
Hibernian,5600,1,19,13,4,58,24,34,70
Dundee Utd,5600,2,17,11,8,55,38,17,62
Falkirk,5600,3,17,10,9,58,41,17,61
Morton,5600,4,14,14,8,49,42,7,56
Queen of S't,5600,5,11,10,15,43,51,-8,43
Dunfermline,5600,6,9,15,12,48,49,-1,42
Ayr,5600,7,8,15,13,36,51,-15,39
Raith,5600,8,9,11,16,37,52,-15,38
Dumbarton,5600,9,7,14,15,44,59,-15,35
St Mirren,5600,10,7,11,18,35,56,-21,32
Hibernian,5601,1,19,14,3,54,23,31,71
Morton,5601,2,19,11,6,57,33,24,68
Dundee Utd,5601,3,19,8,9,53,36,17,65
Falkirk,5601,4,14,11,11,55,45,10,53
Dunfermline,5601,5,9,14,13,47,51,-4,41
Queen of S't,5601,6,11,8,17,47,57,-10,41
Raith,5601,7,10,11,15,36,48,-12,41
Dumbarton,5601,8,9,11,16,49,59,-10,38
Ayr,5601,9,7,13,16,34,60,-26,34
St Mirren,5601,10,7,11,18,36,56,-20,32
Hibernian,5602,1,20,12,4,63,23,40,72
Falkirk,5602,2,15,11,10,54,46,8,56
Dundee Utd,5602,3,15,10,11,48,39,9,55
Morton,5602,4,14,12,10,43,42,1,54
Queen of S't,5602,5,15,8,13,52,48,4,53
Dunfermline,5602,6,9,13,14,42,49,-7,40
St Mirren,5602,7,9,12,15,40,54,-14,39
Ayr,5602,8,9,12,15,33,53,-20,39
Dumbarton,5602,9,9,11,16,46,55,-9,38
Raith,5602,10,9,11,16,37,49,-12,38
Hibernian,5603,1,19,12,5,58,30,28,69
Morton,5603,2,19,11,6,61,34,27,68
Falkirk,5603,3,17,10,9,59,43,16,61
Dundee Utd,5603,4,17,9,10,57,40,17,60
Queen of S't,5603,5,14,10,12,47,44,3,52
Dunfermline,5603,6,10,13,13,49,50,-1,43
St Mirren,5603,7,9,9,18,45,60,-15,36
Raith,5603,8,9,9,18,31,54,-23,36
Dumbarton,5603,9,8,10,18,44,65,-21,34
Ayr,5603,10,6,11,19,29,60,-31,29
Hibernian,5604,1,18,13,5,56,30,26,67
Morton,5604,2,15,15,6,48,35,13,60
Falkirk,5604,3,16,11,9,62,43,19,59
Dundee Utd,5604,4,14,10,12,45,41,4,52
Queen of S't,5604,5,11,10,15,46,53,-7,43
Raith,5604,6,11,9,16,39,50,-11,42
Dunfermline,5604,7,9,14,13,47,51,-4,41
Ayr,5604,8,9,14,13,36,51,-15,41
St Mirren,5604,9,10,10,16,42,55,-13,40
Dumbarton,5604,10,8,12,16,47,59,-12,36
Hibernian,5605,1,21,12,3,57,22,35,75
Morton,5605,2,17,13,6,52,30,22,64
Falkirk,5605,3,16,9,11,60,44,16,57
Dundee Utd,5605,4,15,10,11,45,40,5,55
Queen of S't,5605,5,11,10,15,47,53,-6,43
Dumbarton,5605,6,10,12,14,53,58,-5,42
Dunfermline,5605,7,10,12,14,41,49,-8,42
St Mirren,5605,8,9,11,16,41,55,-14,38
Raith,5605,9,8,11,17,31,51,-20,35
Ayr,5605,10,8,10,18,32,57,-25,34
Hibernian,5606,1,21,11,4,58,23,35,74
Dundee Utd,5606,2,17,10,9,58,36,22,61
Falkirk,5606,3,16,12,8,59,41,18,60
Morton,5606,4,15,11,10,50,40,10,56
Queen of S't,5606,5,11,11,14,43,48,-5,44
Dunfermline,5606,6,10,13,13,48,51,-3,43
Raith,5606,7,11,10,15,41,51,-10,43
Dumbarton,5606,8,8,12,16,50,62,-12,36
St Mirren,5606,9,8,11,17,38,62,-24,35
Ayr,5606,10,6,13,17,35,66,-31,31
Hibernian,5607,1,21,10,5,64,27,37,73
Morton,5607,2,18,10,8,50,36,14,64
Falkirk,5607,3,16,11,9,61,45,16,59
Dundee Utd,5607,4,14,11,11,50,43,7,53
Dunfermline,5607,5,11,13,12,54,53,1,46
Dumbarton,5607,6,9,13,14,49,55,-6,40
Queen of S't,5607,7,9,11,16,41,55,-14,38
Raith,5607,8,9,10,17,34,52,-18,37
St Mirren,5607,9,8,12,16,39,56,-17,36
Ayr,5607,10,7,15,14,32,52,-20,36
Hibernian,5608,1,20,13,3,60,22,38,73
Dundee Utd,5608,2,18,8,10,58,42,16,62
Morton,5608,3,15,12,9,48,43,5,57
Falkirk,5608,4,14,13,9,55,42,13,55
Queen of S't,5608,5,12,10,14,46,54,-8,46
Dunfermline,5608,6,11,11,14,49,52,-3,44
Dumbarton,5608,7,9,12,15,50,56,-6,39
Raith,5608,8,9,11,16,33,49,-16,38
St Mirren,5608,9,9,10,17,43,59,-16,37
Ayr,5608,10,6,14,16,32,55,-23,32
Hibernian,5609,1,20,10,6,56,27,29,70
Falkirk,5609,2,17,12,7,63,37,26,63
Dundee Utd,5609,3,15,11,10,48,40,8,56
Morton,5609,4,15,11,10,49,44,5,56
Queen of S't,5609,5,13,10,13,46,46,0,49
Dunfermline,5609,6,10,12,14,50,55,-5,42
Dumbarton,5609,7,10,12,14,48,55,-7,42
Raith,5609,8,10,8,18,32,53,-21,38
St Mirren,5609,9,8,11,17,42,55,-13,35
Ayr,5609,10,8,11,17,36,58,-22,35
Hibernian,5610,1,19,12,5,56,27,29,69
Falkirk,5610,2,17,11,8,61,41,20,62
Morton,5610,3,16,12,8,49,39,10,60
Dundee Utd,5610,4,14,11,11,46,43,3,53
Queen of S't,5610,5,12,9,15,53,54,-1,45
Ayr,5610,6,11,11,14,33,49,-16,44
Dunfermline,5610,7,9,16,11,49,48,1,43
Raith,5610,8,11,8,17,39,50,-11,41
St Mirren,5610,9,8,11,17,40,56,-16,35
Dumbarton,5610,10,7,11,18,43,62,-19,32
Hibernian,5611,1,19,11,6,51,24,27,68
Morton,5611,2,17,12,7,51,35,16,63
Falkirk,5611,3,17,10,9,60,39,21,61
Dundee Utd,5611,4,16,10,10,51,38,13,58
Dumbarton,5611,5,12,11,13,48,53,-5,47
Dunfermline,5611,6,10,11,15,46,52,-6,41
Queen of S't,5611,7,10,11,15,44,54,-10,41
Ayr,5611,8,9,12,15,33,51,-18,39
Raith,5611,9,9,10,17,35,52,-17,37
St Mirren,5611,10,7,10,19,37,58,-21,31
Hibernian,5612,1,18,12,6,53,26,27,66
Morton,5612,2,17,12,7,51,33,18,63
Falkirk,5612,3,17,10,9,63,36,27,61
Dundee Utd,5612,4,17,10,9,53,38,15,61
Dunfermline,5612,5,9,15,12,39,41,-2,42
Raith,5612,6,10,10,16,37,51,-14,40
Ayr,5612,7,10,10,16,35,53,-18,40
Dumbarton,5612,8,9,12,15,44,56,-12,39
Queen of S't,5612,9,10,9,17,42,55,-13,39
St Mirren,5612,10,8,10,18,39,67,-28,34
Hibernian,5613,1,18,14,4,51,24,27,68
Falkirk,5613,2,19,9,8,61,39,22,66
Morton,5613,3,16,14,6,48,33,15,62
Dundee Utd,5613,4,14,10,12,46,42,4,52
Queen of S't,5613,5,10,11,15,43,50,-7,41
Raith,5613,6,10,11,15,33,46,-13,41
Dunfermline,5613,7,9,13,14,43,47,-4,40
Dumbarton,5613,8,9,11,16,49,60,-11,38
Ayr,5613,9,8,13,15,35,56,-21,37
St Mirren,5613,10,8,12,16,41,53,-12,36
Hibernian,5614,1,20,11,5,58,24,34,71
Falkirk,5614,2,19,9,8,63,37,26,66
Morton,5614,3,17,11,8,50,38,12,62
Dundee Utd,5614,4,15,9,12,51,44,7,54
Queen of S't,5614,5,12,10,14,48,46,2,46
Raith,5614,6,11,8,17,33,50,-17,41
Ayr,5614,7,9,12,15,32,52,-20,39
St Mirren,5614,8,9,11,16,43,60,-17,38
Dumbarton,5614,9,8,12,16,47,62,-15,36
Dunfermline,5614,10,7,13,16,41,53,-12,34
Hibernian,5615,1,20,10,6,59,26,33,70
Morton,5615,2,17,11,8,52,38,14,62
Falkirk,5615,3,16,10,10,61,43,18,58
Dundee Utd,5615,4,16,10,10,47,36,11,58
Queen of S't,5615,5,12,10,14,44,48,-4,46
Ayr,5615,6,11,12,13,36,50,-14,45
Dunfermline,5615,7,9,13,14,45,50,-5,40
Raith,5615,8,10,9,17,35,54,-19,39
St Mirren,5615,9,8,11,17,37,53,-16,35
Dumbarton,5615,10,7,12,17,40,58,-18,33
Hibernian,5616,1,20,11,5,57,25,32,71
Morton,5616,2,19,10,7,53,34,19,67
Dundee Utd,5616,3,15,11,10,53,42,11,56
Falkirk,5616,4,15,10,11,60,47,13,55
Queen of S't,5616,5,12,8,16,45,52,-7,44
Raith,5616,6,10,12,14,35,46,-11,42
Dumbarton,5616,7,10,11,15,52,59,-7,41
St Mirren,5616,8,9,12,15,40,57,-17,39
Dunfermline,5616,9,8,12,16,44,53,-9,36
Ayr,5616,10,7,13,16,31,55,-24,34
Hibernian,5617,1,18,12,6,56,27,29,66
Dundee Utd,5617,2,17,9,10,54,40,14,60
Morton,5617,3,15,13,8,48,38,10,58
Falkirk,5617,4,15,9,12,53,46,7,54
Queen of S't,5617,5,14,8,14,47,51,-4,50
Dunfermline,5617,6,11,12,13,49,48,1,45
Raith,5617,7,11,10,15,37,47,-10,43
St Mirren,5617,8,10,11,15,45,51,-6,41
Dumbarton,5617,9,9,10,17,51,66,-15,37
Ayr,5617,10,7,12,17,29,55,-26,33
Hibernian,5618,1,20,12,4,60,25,35,72
Morton,5618,2,17,13,6,51,40,11,64
Falkirk,5618,3,16,10,10,56,41,15,58
Dundee Utd,5618,4,16,10,10,51,39,12,58
Queen of S't,5618,5,11,10,15,46,51,-5,43
Dunfermline,5618,6,9,13,14,43,49,-6,40
Raith,5618,7,10,10,16,34,48,-14,40
Dumbarton,5618,8,9,12,15,47,58,-11,39
Ayr,5618,9,8,13,15,34,53,-19,37
St Mirren,5618,10,7,11,18,40,58,-18,32
Hibernian,5619,1,19,12,5,56,25,31,69
Morton,5619,2,16,14,6,53,36,17,62
Falkirk,5619,3,15,12,9,53,39,14,57
Dundee Utd,5619,4,13,11,12,46,45,1,50
Dunfermline,5619,5,10,13,13,50,52,-2,43
Queen of S't,5619,6,11,10,15,43,49,-6,43
Raith,5619,7,11,10,15,35,48,-13,43
Dumbarton,5619,8,10,12,14,48,52,-4,42
St Mirren,5619,9,9,10,17,40,54,-14,37
Ayr,5619,10,8,12,16,35,59,-24,36
Hibernian,5620,1,17,13,6,49,27,22,64
Morton,5620,2,18,10,8,55,36,19,64
Dundee Utd,5620,3,17,10,9,49,38,11,61
Falkirk,5620,4,16,10,10,61,44,17,58
Queen of S't,5620,5,12,10,14,52,51,1,46
Raith,5620,6,11,10,15,36,48,-12,43
Dunfermline,5620,7,10,12,14,48,51,-3,42
St Mirren,5620,8,8,12,16,44,57,-13,36
Ayr,5620,9,8,12,16,32,57,-25,36
Dumbarton,5620,10,8,11,17,43,60,-17,35
Hibernian,5621,1,21,11,4,61,25,36,74
Dundee Utd,5621,2,16,10,10,52,40,12,58
Morton,5621,3,15,12,9,53,41,12,57
Falkirk,5621,4,15,11,10,58,42,16,56
Queen of S't,5621,5,12,9,15,45,50,-5,45
Dunfermline,5621,6,9,13,14,42,53,-11,40
Raith,5621,7,10,10,16,35,48,-13,40
Ayr,5621,8,9,12,15,35,56,-21,39
St Mirren,5621,9,9,11,16,40,57,-17,38
Dumbarton,5621,10,8,13,15,50,59,-9,37
Hibernian,5622,1,16,15,5,53,27,26,63
Falkirk,5622,2,16,11,9,59,42,17,59
Dundee Utd,5622,3,16,11,9,55,39,16,59
Morton,5622,4,15,10,11,48,43,5,55
Queen of S't,5622,5,14,10,12,51,49,2,52
Dunfermline,5622,6,12,12,12,51,47,4,48
Dumbarton,5622,7,9,11,16,52,64,-12,38
St Mirren,5622,8,8,13,15,43,57,-14,37
Raith,5622,9,9,10,17,37,52,-15,37
Ayr,5622,10,7,13,16,30,59,-29,34
Morton,5623,1,19,10,7,52,30,22,67
Hibernian,5623,2,17,12,7,49,26,23,63
Falkirk,5623,3,16,10,10,58,41,17,58
Dundee Utd,5623,4,15,10,11,54,45,9,55
Dunfermline,5623,5,11,13,12,49,49,0,46
Raith,5623,6,12,9,15,35,44,-9,45
Queen of S't,5623,7,12,8,16,50,54,-4,44
St Mirren,5623,8,11,10,15,42,52,-10,43
Ayr,5623,9,8,11,17,32,61,-29,35
Dumbarton,5623,10,7,11,18,42,61,-19,32
Hibernian,5624,1,19,13,4,56,25,31,70
Dundee Utd,5624,2,19,9,8,58,32,26,66
Falkirk,5624,3,18,10,8,64,39,25,64
Morton,5624,4,16,11,9,49,44,5,59
Queen of S't,5624,5,11,11,14,43,50,-7,44
Dunfermline,5624,6,9,13,14,43,49,-6,40
Dumbarton,5624,7,9,11,16,54,65,-11,38
Ayr,5624,8,9,10,17,33,57,-24,37
St Mirren,5624,9,8,10,18,39,56,-17,34
Raith,5624,10,8,10,18,30,52,-22,34
Hibernian,5625,1,20,11,5,57,23,34,71
Morton,5625,2,19,10,7,50,33,17,67
Falkirk,5625,3,15,10,11,55,45,10,55
Dundee Utd,5625,4,14,12,10,51,41,10,54
Queen of S't,5625,5,13,10,13,45,47,-2,49
Dunfermline,5625,6,9,13,14,47,50,-3,40
Raith,5625,7,10,9,17,35,51,-16,39
Ayr,5625,8,9,11,16,35,56,-21,38
Dumbarton,5625,9,8,13,15,49,59,-10,37
St Mirren,5625,10,8,11,17,38,57,-19,35
Hibernian,5626,1,20,11,5,52,23,29,71
Morton,5626,2,17,10,9,50,35,15,61
Dundee Utd,5626,3,17,9,10,48,39,9,60
Falkirk,5626,4,16,11,9,60,40,20,59
Queen of S't,5626,5,12,10,14,48,48,0,46
Dunfermline,5626,6,11,11,14,44,49,-5,44
Ayr,5626,7,9,12,15,37,53,-16,39
Dumbarton,5626,8,9,11,16,46,58,-12,38
Raith,5626,9,8,11,17,33,52,-19,35
St Mirren,5626,10,7,12,17,38,59,-21,33
Morton,5627,1,21,10,5,54,29,25,73
Hibernian,5627,2,18,13,5,53,26,27,67
Dundee Utd,5627,3,17,10,9,58,39,19,61
Falkirk,5627,4,17,9,10,56,43,13,60
Dunfermline,5627,5,10,12,14,46,50,-4,42
Raith,5627,6,11,8,17,39,50,-11,41
Queen of S't,5627,7,10,10,16,46,54,-8,40
Dumbarton,5627,8,9,12,15,47,59,-12,39
St Mirren,5627,9,7,11,18,39,56,-17,32
Ayr,5627,10,7,11,18,33,65,-32,32
Hibernian,5628,1,19,14,3,56,26,30,71
Falkirk,5628,2,16,13,7,64,43,21,61
Morton,5628,3,16,11,9,49,41,8,59
Dundee Utd,5628,4,15,9,12,55,46,9,54
Dunfermline,5628,5,11,15,10,49,45,4,48
Queen of S't,5628,6,11,12,13,48,49,-1,45
Dumbarton,5628,7,9,12,15,50,60,-10,39
Ayr,5628,8,8,12,16,35,56,-21,36
Raith,5628,9,8,11,17,36,55,-19,35
St Mirren,5628,10,7,11,18,35,56,-21,32
Hibernian,5629,1,22,11,3,58,23,35,77
Morton,5629,2,17,11,8,52,40,12,62
Dundee Utd,5629,3,16,12,8,56,39,17,60
Falkirk,5629,4,15,10,11,55,39,16,55
Queen of S't,5629,5,11,10,15,43,46,-3,43
Dunfermline,5629,6,10,12,14,49,54,-5,42
Dumbarton,5629,7,9,12,15,47,58,-11,39
Raith,5629,8,10,8,18,35,53,-18,38
St Mirren,5629,9,9,10,17,38,57,-19,37
Ayr,5629,10,8,10,18,37,61,-24,34
Hibernian,5630,1,20,13,3,55,23,32,73
Falkirk,5630,2,18,9,9,61,38,23,63
Morton,5630,3,16,14,6,51,33,18,62
Dundee Utd,5630,4,15,9,12,47,42,5,54
Ayr,5630,5,11,12,13,37,50,-13,45
Queen of S't,5630,6,11,10,15,44,50,-6,43
Dunfermline,5630,7,9,14,13,42,43,-1,41
Raith,5630,8,8,11,17,31,53,-22,35
St Mirren,5630,9,8,10,18,38,57,-19,34
Dumbarton,5630,10,7,12,17,46,63,-17,33
Hibernian,5631,1,20,11,5,52,24,28,71
Morton,5631,2,17,11,8,58,37,21,62
Falkirk,5631,3,16,13,7,62,40,22,61
Dundee Utd,5631,4,14,11,11,48,49,-1,53
Queen of S't,5631,5,13,10,13,49,47,2,49
Raith,5631,6,9,13,14,35,47,-12,40
Dunfermline,5631,7,8,15,13,41,48,-7,39
Dumbarton,5631,8,8,13,15,47,61,-14,37
Ayr,5631,9,7,14,15,34,51,-17,35
St Mirren,5631,10,7,11,18,38,60,-22,32
Morton,5632,1,19,11,6,49,31,18,68
Hibernian,5632,2,18,11,7,52,30,22,65
Falkirk,5632,3,17,11,8,63,42,21,62
Dundee Utd,5632,4,15,11,10,48,39,9,56
Queen of S't,5632,5,11,10,15,45,47,-2,43
Raith,5632,6,10,10,16,33,49,-16,40
St Mirren,5632,7,9,12,15,46,57,-11,39
Ayr,5632,8,9,12,15,33,52,-19,39
Dunfermline,5632,9,8,14,14,43,46,-3,38
Dumbarton,5632,10,7,12,17,42,61,-19,33
Hibernian,5633,1,20,12,4,62,26,36,72
Morton,5633,2,19,10,7,56,39,17,67
Dundee Utd,5633,3,16,10,10,53,43,10,58
Falkirk,5633,4,16,9,11,56,45,11,57
Dunfermline,5633,5,11,12,13,50,49,1,45
Queen of S't,5633,6,11,10,15,47,54,-7,43
Ayr,5633,7,10,12,14,37,53,-16,42
Dumbarton,5633,8,9,11,16,53,61,-8,38
Raith,5633,9,9,10,17,36,53,-17,37
St Mirren,5633,10,6,10,20,33,60,-27,28
Hibernian,5634,1,19,12,5,60,28,32,69
Falkirk,5634,2,17,11,8,62,41,21,62
Morton,5634,3,17,11,8,52,37,15,62
Dundee Utd,5634,4,14,12,10,45,39,6,54
Dunfermline,5634,5,11,13,12,47,46,1,46
Queen of S't,5634,6,12,10,14,45,50,-5,46
Dumbarton,5634,7,10,11,15,52,61,-9,41
Raith,5634,8,9,9,18,34,54,-20,36
Ayr,5634,9,8,11,17,36,59,-23,35
St Mirren,5634,10,8,10,18,39,57,-18,34
Hibernian,5635,1,21,10,5,60,23,37,73
Morton,5635,2,16,12,8,55,42,13,60
Falkirk,5635,3,16,11,9,57,42,15,59
Dundee Utd,5635,4,15,12,9,52,41,11,57
Queen of S't,5635,5,13,9,14,54,53,1,48
Dunfermline,5635,6,9,14,13,49,53,-4,41
St Mirren,5635,7,9,11,16,40,53,-13,38
Raith,5635,8,10,8,18,33,55,-22,38
Ayr,5635,9,9,10,17,34,55,-21,37
Dumbarton,5635,10,8,11,17,46,63,-17,35
Hibernian,5636,1,18,13,5,58,28,30,67
Falkirk,5636,2,16,12,8,60,40,20,60
Dundee Utd,5636,3,15,11,10,49,40,9,56
Morton,5636,4,14,13,9,50,42,8,55
Dunfermline,5636,5,12,12,12,52,46,6,48
Dumbarton,5636,6,11,11,14,57,57,0,44
Queen of S't,5636,7,10,11,15,44,54,-10,41
St Mirren,5636,8,9,11,16,40,53,-13,38
Raith,5636,9,10,8,18,37,57,-20,38
Ayr,5636,10,8,12,16,32,62,-30,36
Hibernian,5637,1,22,11,3,64,22,42,77
Falkirk,5637,2,18,10,8,62,39,23,64
Dundee Utd,5637,3,16,10,10,55,42,13,58
Morton,5637,4,15,13,8,47,38,9,58
Queen of S't,5637,5,11,10,15,47,52,-5,43
Dunfermline,5637,6,9,13,14,43,48,-5,40
Dumbarton,5637,7,9,12,15,48,59,-11,39
Raith,5637,8,9,11,16,35,50,-15,38
Ayr,5637,9,7,13,16,31,59,-28,34
St Mirren,5637,10,7,11,18,35,58,-23,32
Hibernian,5638,1,20,13,3,59,24,35,73
Morton,5638,2,18,10,8,52,36,16,64
Dundee Utd,5638,3,15,12,9,55,42,13,57
Falkirk,5638,4,15,10,11,57,45,12,55
Queen of S't,5638,5,12,11,13,44,46,-2,47
Raith,5638,6,12,9,15,39,47,-8,45
Dunfermline,5638,7,9,14,13,46,49,-3,41
St Mirren,5638,8,9,10,17,39,58,-19,37
Dumbarton,5638,9,8,10,18,42,63,-21,34
Ayr,5638,10,7,11,18,37,60,-23,32
Hibernian,5639,1,19,13,4,54,24,30,70
Falkirk,5639,2,18,10,8,60,42,18,64
Morton,5639,3,14,14,8,46,36,10,56
Dundee Utd,5639,4,15,10,11,50,43,7,55
Queen of S't,5639,5,12,9,15,46,52,-6,45
Dunfermline,5639,6,9,16,11,49,51,-2,43
Raith,5639,7,10,10,16,36,47,-11,40
St Mirren,5639,8,10,9,17,42,56,-14,39
Dumbarton,5639,9,8,12,16,50,61,-11,36
Ayr,5639,10,7,13,16,30,51,-21,34
Hibernian,5640,1,21,12,3,61,24,37,75
Morton,5640,2,18,13,5,53,33,20,67
Dundee Utd,5640,3,16,10,10,54,40,14,58
Falkirk,5640,4,13,11,12,52,43,9,50
Raith,5640,5,11,10,15,38,46,-8,43
Dunfermline,5640,6,9,13,14,42,47,-5,40
Queen of S't,5640,7,10,10,16,38,52,-14,40
Dumbarton,5640,8,8,13,15,45,59,-14,37
St Mirren,5640,9,9,10,17,40,57,-17,37
Ayr,5640,10,8,12,16,33,55,-22,36
Hibernian,5641,1,18,13,5,50,22,28,67
Falkirk,5641,2,18,9,9,62,40,22,63
Morton,5641,3,15,14,7,48,36,12,59
Dundee Utd,5641,4,16,9,11,48,39,9,57
Queen of S't,5641,5,12,8,16,46,57,-11,44
Dunfermline,5641,6,9,13,14,47,51,-4,40
Ayr,5641,7,10,10,16,37,52,-15,40
Raith,5641,8,10,10,16,36,52,-16,40
Dumbarton,5641,9,9,12,15,48,58,-10,39
St Mirren,5641,10,8,12,16,37,52,-15,36
Hibernian,5642,1,18,13,5,56,26,30,67
Morton,5642,2,17,12,7,53,37,16,63
Falkirk,5642,3,15,11,10,58,45,13,56
Dundee Utd,5642,4,15,10,11,49,43,6,55
Dunfermline,5642,5,11,12,13,48,48,0,45
Raith,5642,6,11,11,14,37,48,-11,44
Queen of S't,5642,7,11,9,16,48,54,-6,42
Ayr,5642,8,9,13,14,33,50,-17,40
Dumbarton,5642,9,8,13,15,47,58,-11,37
St Mirren,5642,10,8,10,18,39,59,-20,34
Hibernian,5643,1,22,11,3,59,23,36,77
Falkirk,5643,2,16,10,10,55,39,16,58
Morton,5643,3,16,10,10,46,37,9,58
Dundee Utd,5643,4,15,10,11,47,38,9,55
Ayr,5643,5,10,13,13,36,51,-15,43
Dunfermline,5643,6,10,12,14,43,46,-3,42
Dumbarton,5643,7,10,11,15,50,59,-9,41
Queen of S't,5643,8,11,8,17,44,55,-11,41
Raith,5643,9,8,12,16,34,49,-15,36
St Mirren,5643,10,8,11,17,40,57,-17,35
Hibernian,5644,1,20,11,5,58,26,32,71
Morton,5644,2,19,10,7,54,34,20,67
Falkirk,5644,3,15,11,10,57,45,12,56
Dundee Utd,5644,4,15,11,10,45,37,8,56
Queen of S't,5644,5,14,8,14,47,47,0,50
Raith,5644,6,11,9,16,39,47,-8,42
Dunfermline,5644,7,9,14,13,47,50,-3,41
Dumbarton,5644,8,9,10,17,44,61,-17,37
Ayr,5644,9,8,12,16,32,52,-20,36
St Mirren,5644,10,7,10,19,33,57,-24,31
Hibernian,5645,1,20,13,3,56,24,32,73
Falkirk,5645,2,17,11,8,61,39,22,62
Morton,5645,3,15,10,11,49,43,6,55
Dundee Utd,5645,4,15,9,12,47,39,8,54
Queen of S't,5645,5,12,9,15,45,50,-5,45
Dunfermline,5645,6,10,13,13,46,48,-2,43
Ayr,5645,7,9,13,14,38,55,-17,40
Raith,5645,8,10,9,17,33,50,-17,39
Dumbarton,5645,9,9,11,16,46,59,-13,38
St Mirren,5645,10,9,10,17,43,57,-14,37
Hibernian,5646,1,21,10,5,62,22,40,73
Morton,5646,2,18,9,9,48,37,11,63
Dundee Utd,5646,3,16,10,10,51,40,11,58
Falkirk,5646,4,15,11,10,55,39,16,56
Dunfermline,5646,5,13,11,12,49,47,2,50
Queen of S't,5646,6,10,12,14,44,52,-8,42
St Mirren,5646,7,9,10,17,41,56,-15,37
Ayr,5646,8,8,13,15,33,57,-24,37
Dumbarton,5646,9,8,12,16,43,55,-12,36
Raith,5646,10,8,10,18,36,57,-21,34
Hibernian,5647,1,19,11,6,61,27,34,68
Morton,5647,2,19,10,7,57,37,20,67
Dundee Utd,5647,3,16,9,11,53,45,8,57
Falkirk,5647,4,15,11,10,53,40,13,56
Dunfermline,5647,5,11,13,12,47,45,2,46
Queen of S't,5647,6,11,8,17,43,55,-12,41
Ayr,5647,7,10,11,15,37,54,-17,41
St Mirren,5647,8,9,11,16,39,56,-17,38
Dumbarton,5647,9,8,13,15,46,59,-13,37
Raith,5647,10,8,11,17,33,51,-18,35
Falkirk,5648,1,17,12,7,60,37,23,63
Morton,5648,2,18,9,9,55,40,15,63
Hibernian,5648,3,17,11,8,49,29,20,62
Dundee Utd,5648,4,16,11,9,52,39,13,59
Dunfermline,5648,5,11,13,12,46,45,1,46
Queen of S't,5648,6,11,11,14,43,49,-6,44
St Mirren,5648,7,9,11,16,43,56,-13,38
Raith,5648,8,9,10,17,32,48,-16,37
Dumbarton,5648,9,8,12,16,46,62,-16,36
Ayr,5648,10,8,12,16,36,57,-21,36
Hibernian,5649,1,19,12,5,53,23,30,69
Morton,5649,2,18,12,6,52,31,21,66
Falkirk,5649,3,16,11,9,61,45,16,59
Dundee Utd,5649,4,16,10,10,49,37,12,58
Queen of S't,5649,5,12,8,16,43,51,-8,44
Raith,5649,6,11,9,16,35,48,-13,42
Dunfermline,5649,7,9,13,14,45,52,-7,40
Dumbarton,5649,8,9,11,16,50,62,-12,38
Ayr,5649,9,8,12,16,32,54,-22,36
St Mirren,5649,10,8,10,18,39,56,-17,34
Hibernian,5650,1,21,11,4,58,23,35,74
Morton,5650,2,19,11,6,54,35,19,68
Falkirk,5650,3,16,10,10,57,43,14,58
Dundee Utd,5650,4,15,10,11,53,44,9,55
Queen of S't,5650,5,13,9,14,47,53,-6,48
Raith,5650,6,10,11,15,37,46,-9,41
Dunfermline,5650,7,9,13,14,48,53,-5,40
Dumbarton,5650,8,9,10,17,50,62,-12,37
St Mirren,5650,9,8,11,17,39,54,-15,35
Ayr,5650,10,7,10,19,31,61,-30,31
Hibernian,5651,1,20,11,5,56,29,27,71
Dundee Utd,5651,2,17,8,11,52,40,12,59
Morton,5651,3,16,10,10,51,44,7,58
Falkirk,5651,4,15,11,10,59,44,15,56
Dunfermline,5651,5,12,11,13,49,46,3,47
Raith,5651,6,11,9,16,36,48,-12,42
Queen of S't,5651,7,11,8,17,43,50,-7,41
Dumbarton,5651,8,10,10,16,48,59,-11,40
Ayr,5651,9,10,10,16,36,53,-17,40
St Mirren,5651,10,9,10,17,38,55,-17,37
Hibernian,5652,1,19,11,6,52,25,27,68
Morton,5652,2,17,11,8,45,32,13,62
Falkirk,5652,3,17,10,9,58,38,20,61
Dundee Utd,5652,4,15,10,11,50,44,6,55
Queen of S't,5652,5,13,9,14,49,49,0,48
Dunfermline,5652,6,9,13,14,43,54,-11,40
Raith,5652,7,10,10,16,33,48,-15,40
Dumbarton,5652,8,9,12,15,51,59,-8,39
St Mirren,5652,9,10,9,17,45,56,-11,39
Ayr,5652,10,8,11,17,35,56,-21,35
Hibernian,5653,1,18,14,4,56,26,30,68
Morton,5653,2,16,12,8,52,39,13,60
Falkirk,5653,3,16,11,9,60,41,19,59
Dundee Utd,5653,4,16,11,9,58,41,17,59
Queen of S't,5653,5,12,10,14,48,48,0,46
Raith,5653,6,11,9,16,39,50,-11,42
Dunfermline,5653,7,9,13,14,43,53,-10,40
Ayr,5653,8,8,13,15,36,59,-23,37
St Mirren,5653,9,8,12,16,44,59,-15,36
Dumbarton,5653,10,8,11,17,48,68,-20,35
Hibernian,5654,1,19,13,4,52,23,29,70
Morton,5654,2,15,14,7,49,35,14,59
Falkirk,5654,3,16,10,10,60,44,16,58
Dundee Utd,5654,4,13,12,11,49,41,8,51
Queen of S't,5654,5,11,9,16,44,51,-7,42
Dumbarton,5654,6,10,12,14,51,62,-11,42
Raith,5654,7,11,8,17,34,45,-11,41
Ayr,5654,8,9,14,13,37,53,-16,41
Dunfermline,5654,9,8,15,13,42,49,-7,39
St Mirren,5654,10,9,11,16,42,57,-15,38
Hibernian,5655,1,19,12,5,55,28,27,69
Falkirk,5655,2,17,12,7,59,36,23,63
Morton,5655,3,16,15,5,52,34,18,63
Dundee Utd,5655,4,15,11,10,48,39,9,56
Queen of S't,5655,5,12,8,16,46,52,-6,44
Dumbarton,5655,6,10,12,14,49,55,-6,42
Raith,5655,7,10,10,16,35,49,-14,40
Dunfermline,5655,8,8,14,14,41,51,-10,38
Ayr,5655,9,8,12,16,34,54,-20,36
St Mirren,5655,10,6,12,18,38,59,-21,30
Hibernian,5656,1,20,11,5,56,26,30,71
Morton,5656,2,17,10,9,51,35,16,61
Dundee Utd,5656,3,16,9,11,47,39,8,57
Falkirk,5656,4,14,10,12,53,42,11,52
Dumbarton,5656,5,12,10,14,50,53,-3,46
Queen of S't,5656,6,12,10,14,44,48,-4,46
Dunfermline,5656,7,10,12,14,47,51,-4,42
Raith,5656,8,11,9,16,39,50,-11,42
St Mirren,5656,9,10,10,16,39,53,-14,40
Ayr,5656,10,6,13,17,30,59,-29,31
Hibernian,5657,1,19,12,5,53,24,29,69
Morton,5657,2,17,12,7,47,32,15,63
Falkirk,5657,3,15,11,10,54,39,15,56
Dundee Utd,5657,4,15,10,11,51,41,10,55
Dunfermline,5657,5,11,13,12,47,50,-3,46
Dumbarton,5657,6,10,12,14,48,54,-6,42
Queen of S't,5657,7,10,11,15,44,52,-8,41
Ayr,5657,8,8,14,14,33,53,-20,38
St Mirren,5657,9,9,10,17,39,53,-14,37
Raith,5657,10,9,9,18,37,55,-18,36
Morton,5658,1,19,12,5,53,34,19,69
Hibernian,5658,2,18,12,6,59,27,32,66
Falkirk,5658,3,17,11,8,55,36,19,62
Dundee Utd,5658,4,15,12,9,48,39,9,57
Queen of S't,5658,5,13,9,14,49,47,2,48
Dunfermline,5658,6,10,11,15,47,52,-5,41
Raith,5658,7,10,11,15,38,54,-16,41
Dumbarton,5658,8,8,11,17,46,62,-16,35
St Mirren,5658,9,8,10,18,40,59,-19,34
Ayr,5658,10,7,11,18,31,56,-25,32
Hibernian,5659,1,19,12,5,58,26,32,69
Morton,5659,2,17,11,8,52,37,15,62
Falkirk,5659,3,16,11,9,56,40,16,59
Dundee Utd,5659,4,16,11,9,47,36,11,59
Queen of S't,5659,5,11,11,14,45,49,-4,44
Dunfermline,5659,6,9,14,13,43,50,-7,41
Raith,5659,7,11,8,17,36,52,-16,41
Dumbarton,5659,8,9,11,16,48,59,-11,38
Ayr,5659,9,8,12,16,34,57,-23,36
St Mirren,5659,10,8,11,17,42,55,-13,35
Hibernian,5660,1,18,12,6,52,28,24,66
Falkirk,5660,2,17,9,10,59,40,19,60
Morton,5660,3,16,12,8,53,43,10,60
Dundee Utd,5660,4,15,10,11,50,39,11,55
Dunfermline,5660,5,11,14,11,48,46,2,47
Dumbarton,5660,6,10,12,14,52,58,-6,42
Queen of S't,5660,7,10,11,15,44,52,-8,41
Ayr,5660,8,9,12,15,34,54,-20,39
St Mirren,5660,9,9,11,16,41,56,-15,38
Raith,5660,10,9,9,18,36,53,-17,36
Hibernian,5661,1,21,10,5,54,24,30,73
Morton,5661,2,15,14,7,47,34,13,59
Falkirk,5661,3,15,10,11,57,44,13,55
Dundee Utd,5661,4,15,10,11,52,45,7,55
Ayr,5661,5,11,12,13,40,54,-14,45
Queen of S't,5661,6,12,8,16,44,53,-9,44
Dunfermline,5661,7,9,13,14,44,48,-4,40
Dumbarton,5661,8,9,12,15,49,57,-8,39
Raith,5661,9,10,9,17,33,50,-17,39
St Mirren,5661,10,8,12,16,43,54,-11,36
Hibernian,5662,1,18,13,5,58,26,32,67
Morton,5662,2,16,14,6,50,39,11,62
Dundee Utd,5662,3,17,9,10,54,38,16,60
Falkirk,5662,4,16,11,9,56,38,18,59
Queen of S't,5662,5,12,9,15,43,52,-9,45
Dumbarton,5662,6,10,12,14,50,53,-3,42
Raith,5662,7,11,9,16,37,47,-10,42
Dunfermline,5662,8,9,12,15,46,52,-6,39
St Mirren,5662,9,8,12,16,41,61,-20,36
Ayr,5662,10,6,13,17,34,63,-29,31
Morton,5663,1,20,11,5,57,34,23,71
Hibernian,5663,2,17,11,8,54,30,24,62
Falkirk,5663,3,15,12,9,54,43,11,57
Dundee Utd,5663,4,15,9,12,47,38,9,54
Raith,5663,5,12,10,14,37,48,-11,46
Dunfermline,5663,6,11,12,13,49,44,5,45
Dumbarton,5663,7,9,12,15,47,60,-13,39
Queen of S't,5663,8,10,8,18,39,49,-10,38
Ayr,5663,9,9,11,16,34,55,-21,38
St Mirren,5663,10,8,12,16,36,53,-17,36
Hibernian,5664,1,19,11,6,51,27,24,68
Falkirk,5664,2,18,9,9,64,41,23,63
Morton,5664,3,15,10,11,49,35,14,55
Dundee Utd,5664,4,15,10,11,51,41,10,55
Raith,5664,5,13,8,15,35,43,-8,47
Queen of S't,5664,6,12,8,16,41,49,-8,44
Dumbarton,5664,7,10,13,13,49,54,-5,43
Dunfermline,5664,8,9,13,14,45,55,-10,40
St Mirren,5664,9,9,11,16,40,56,-16,38
Ayr,5664,10,7,13,16,32,56,-24,34
Hibernian,5665,1,19,13,4,63,25,38,70
Morton,5665,2,17,12,7,50,36,14,63
Falkirk,5665,3,15,12,9,56,41,15,57
Queen of S't,5665,4,13,11,12,49,48,1,50
Dundee Utd,5665,5,13,10,13,45,44,1,49
Dunfermline,5665,6,10,14,12,46,46,0,44
Dumbarton,5665,7,10,12,14,48,54,-6,42
Ayr,5665,8,8,12,16,37,59,-22,36
Raith,5665,9,9,9,18,36,59,-23,36
St Mirren,5665,10,8,11,17,37,55,-18,35
Hibernian,5666,1,20,13,3,61,21,40,73
Dundee Utd,5666,2,17,11,8,49,35,14,62
Morton,5666,3,16,13,7,51,40,11,61
Falkirk,5666,4,15,10,11,59,43,16,55
Dunfermline,5666,5,10,14,12,45,47,-2,44
Queen of S't,5666,6,11,9,16,47,55,-8,42
Raith,5666,7,9,12,15,36,49,-13,39
Dumbarton,5666,8,8,12,16,46,61,-15,36
Ayr,5666,9,8,12,16,35,56,-21,36
St Mirren,5666,10,8,10,18,39,61,-22,34
Morton,5667,1,19,11,6,55,34,21,68
Hibernian,5667,2,18,12,6,58,27,31,66
Falkirk,5667,3,17,11,8,64,40,24,62
Dundee Utd,5667,4,16,10,10,52,44,8,58
Queen of S't,5667,5,13,10,13,47,49,-2,49
Dumbarton,5667,6,10,10,16,50,61,-11,40
Dunfermline,5667,7,9,11,16,44,54,-10,38
Raith,5667,8,9,11,16,33,52,-19,38
St Mirren,5667,9,8,10,18,38,57,-19,34
Ayr,5667,10,8,10,18,33,56,-23,34
Hibernian,5668,1,18,14,4,53,23,30,68
Falkirk,5668,2,16,12,8,60,38,22,60
Morton,5668,3,16,12,8,46,31,15,60
Dundee Utd,5668,4,16,8,12,52,43,9,56
Queen of S't,5668,5,11,11,14,43,51,-8,44
Raith,5668,6,11,11,14,39,47,-8,44
Dumbarton,5668,7,10,10,16,49,63,-14,40
St Mirren,5668,8,10,9,17,46,57,-11,39
Dunfermline,5668,9,8,14,14,41,50,-9,38
Ayr,5668,10,8,11,17,33,59,-26,35
Morton,5669,1,18,12,6,55,37,18,66
Hibernian,5669,2,17,13,6,53,27,26,64
Falkirk,5669,3,17,10,9,62,38,24,61
Dundee Utd,5669,4,16,10,10,50,39,11,58
Dunfermline,5669,5,10,14,12,43,47,-4,44
Queen of S't,5669,6,11,9,16,47,56,-9,42
Raith,5669,7,11,9,16,40,52,-12,42
Dumbarton,5669,8,9,12,15,47,58,-11,39
Ayr,5669,9,9,12,15,36,54,-18,39
St Mirren,5669,10,7,9,20,37,62,-25,30
Hibernian,5670,1,19,14,3,63,27,36,71
Morton,5670,2,17,12,7,52,36,16,63
Falkirk,5670,3,15,11,10,61,43,18,56
Dundee Utd,5670,4,15,10,11,50,42,8,55
Queen of S't,5670,5,13,8,15,45,54,-9,47
Dunfermline,5670,6,9,13,14,45,50,-5,40
St Mirren,5670,7,10,10,16,42,57,-15,40
Raith,5670,8,10,10,16,35,52,-17,40
Ayr,5670,9,8,13,15,36,52,-16,37
Dumbarton,5670,10,8,11,17,45,61,-16,35
Hibernian,5671,1,19,13,4,62,31,31,70
Morton,5671,2,15,14,7,49,37,12,59
Dundee Utd,5671,3,16,11,9,49,38,11,59
Falkirk,5671,4,16,10,10,60,41,19,58
Queen of S't,5671,5,13,9,14,47,49,-2,48
Dunfermline,5671,6,11,12,13,50,52,-2,45
Raith,5671,7,11,8,17,35,52,-17,41
Ayr,5671,8,7,14,15,34,55,-21,35
Dumbarton,5671,9,7,13,16,45,60,-15,34
St Mirren,5671,10,7,12,17,42,58,-16,33
Hibernian,5672,1,17,13,6,50,27,23,64
Dundee Utd,5672,2,18,8,10,59,41,18,62
Morton,5672,3,16,13,7,51,40,11,61
Falkirk,5672,4,14,11,11,54,43,11,53
Queen of S't,5672,5,12,9,15,50,54,-4,45
Raith,5672,6,11,12,13,40,46,-6,45
Dunfermline,5672,7,10,14,12,47,47,0,44
Dumbarton,5672,8,10,11,15,49,64,-15,41
Ayr,5672,9,9,11,16,37,57,-20,38
St Mirren,5672,10,7,10,19,41,59,-18,31
Hibernian,5673,1,19,12,5,56,31,25,69
Morton,5673,2,18,10,8,58,40,18,64
Dundee Utd,5673,3,17,9,10,54,40,14,60
Falkirk,5673,4,16,10,10,57,41,16,58
Queen of S't,5673,5,11,12,13,48,51,-3,45
Dunfermline,5673,6,9,12,15,46,52,-6,39
Dumbarton,5673,7,9,12,15,47,58,-11,39
Raith,5673,8,9,11,16,33,50,-17,38
Ayr,5673,9,8,14,14,40,59,-19,38
St Mirren,5673,10,8,10,18,38,55,-17,34
Hibernian,5674,1,19,12,5,52,25,27,69
Dundee Utd,5674,2,18,9,9,53,37,16,63
Morton,5674,3,15,15,6,49,34,15,60
Falkirk,5674,4,14,13,9,55,40,15,55
Dunfermline,5674,5,10,13,13,47,49,-2,43
Queen of S't,5674,6,11,9,16,42,48,-6,42
Raith,5674,7,10,10,16,35,49,-14,40
Dumbarton,5674,8,9,12,15,46,55,-9,39
St Mirren,5674,9,9,10,17,39,57,-18,37
Ayr,5674,10,8,11,17,37,61,-24,35
Hibernian,5675,1,19,11,6,58,29,29,68
Morton,5675,2,18,10,8,48,33,15,64
Falkirk,5675,3,15,10,11,57,47,10,55
Dundee Utd,5675,4,15,10,11,51,45,6,55
Dunfermline,5675,5,11,13,12,51,49,2,46
Dumbarton,5675,6,11,12,13,57,58,-1,45
Queen of S't,5675,7,11,10,15,50,54,-4,43
Raith,5675,8,11,9,16,34,50,-16,42
Ayr,5675,9,10,10,16,36,55,-19,40
St Mirren,5675,10,7,9,20,36,58,-22,30
Hibernian,5676,1,18,13,5,56,30,26,67
Falkirk,5676,2,18,10,8,64,40,24,64
Dundee Utd,5676,3,18,9,9,52,38,14,63
Morton,5676,4,15,11,10,47,45,2,56
Raith,5676,5,12,10,14,38,44,-6,46
Dunfermline,5676,6,10,13,13,51,50,1,43
Queen of S't,5676,7,11,10,15,44,48,-4,43
St Mirren,5676,8,9,11,16,38,53,-15,38
Dumbarton,5676,9,9,10,17,47,62,-15,37
Ayr,5676,10,6,11,19,30,57,-27,29
Hibernian,5677,1,20,10,6,54,31,23,70
Morton,5677,2,18,10,8,54,35,19,64
Falkirk,5677,3,17,10,9,64,41,23,61
Dundee Utd,5677,4,16,10,10,55,41,14,58
Queen of S't,5677,5,11,10,15,48,54,-6,43
Dunfermline,5677,6,9,14,13,45,51,-6,41
Ayr,5677,7,10,10,16,35,55,-20,40
Raith,5677,8,10,9,17,40,54,-14,39
St Mirren,5677,9,9,10,17,44,56,-12,37
Dumbarton,5677,10,8,11,17,43,64,-21,35
Hibernian,5678,1,17,13,6,51,26,25,64
Morton,5678,2,17,11,8,52,40,12,62
Dundee Utd,5678,3,15,11,10,54,45,9,56
Falkirk,5678,4,14,13,9,56,43,13,55
Queen of S't,5678,5,14,8,14,49,51,-2,50
Raith,5678,6,12,9,15,41,48,-7,45
Dunfermline,5678,7,10,12,14,47,48,-1,42
Dumbarton,5678,8,9,11,16,49,59,-10,38
St Mirren,5678,9,9,10,17,40,60,-20,37
Ayr,5678,10,8,12,16,39,58,-19,36
Hibernian,5679,1,18,12,6,54,27,27,66
Falkirk,5679,2,17,10,9,62,41,21,61
Dundee Utd,5679,3,16,9,11,48,36,12,57
Morton,5679,4,15,10,11,52,42,10,55
Dunfermline,5679,5,12,11,13,51,50,1,47
Queen of S't,5679,6,12,9,15,44,50,-6,45
Raith,5679,7,11,8,17,34,53,-19,41
Ayr,5679,8,10,11,15,32,57,-25,41
Dumbarton,5679,9,9,13,14,51,58,-7,40
St Mirren,5679,10,9,9,18,42,56,-14,36
Hibernian,5680,1,19,13,4,55,24,31,70
Dundee Utd,5680,2,19,9,8,55,35,20,66
Morton,5680,3,15,11,10,47,43,4,56
Falkirk,5680,4,14,12,10,56,40,16,54
Queen of S't,5680,5,12,10,14,43,47,-4,46
Dumbarton,5680,6,10,11,15,52,58,-6,41
Dunfermline,5680,7,9,13,14,46,53,-7,40
Raith,5680,8,10,10,16,34,48,-14,40
Ayr,5680,9,8,12,16,36,59,-23,36
St Mirren,5680,10,8,11,17,42,59,-17,35
Hibernian,5681,1,19,11,6,58,25,33,68
Morton,5681,2,17,13,6,51,36,15,64
Dundee Utd,5681,3,18,9,9,54,36,18,63
Falkirk,5681,4,15,11,10,56,41,15,56
Dunfermline,5681,5,11,12,13,45,46,-1,45
Queen of S't,5681,6,11,9,16,41,47,-6,42
Raith,5681,7,9,12,15,34,51,-17,39
Ayr,5681,8,9,11,16,32,54,-22,38
Dumbarton,5681,9,8,12,16,46,59,-13,36
St Mirren,5681,10,7,12,17,36,58,-22,33
Morton,5682,1,19,11,6,49,30,19,68
Hibernian,5682,2,18,11,7,54,28,26,65
Falkirk,5682,3,16,11,9,57,37,20,59
Dundee Utd,5682,4,15,11,10,51,41,10,56
Dunfermline,5682,5,10,14,12,49,51,-2,44
Queen of S't,5682,6,11,11,14,46,51,-5,44
Dumbarton,5682,7,10,11,15,50,57,-7,41
Raith,5682,8,10,11,15,36,48,-12,41
St Mirren,5682,9,8,10,18,36,56,-20,34
Ayr,5682,10,6,13,17,27,56,-29,31
Hibernian,5683,1,22,11,3,58,23,35,77
Morton,5683,2,16,12,8,45,31,14,60
Falkirk,5683,3,16,11,9,63,42,21,59
Dundee Utd,5683,4,14,10,12,45,40,5,52
Dunfermline,5683,5,11,12,13,49,49,0,45
Queen of S't,5683,6,11,9,16,46,56,-10,42
Raith,5683,7,10,10,16,39,51,-12,40
St Mirren,5683,8,10,9,17,37,55,-18,39
Dumbarton,5683,9,9,11,16,48,60,-12,38
Ayr,5683,10,8,11,17,33,56,-23,35
Hibernian,5684,1,18,13,5,54,27,27,67
Falkirk,5684,2,16,12,8,60,41,19,60
Morton,5684,3,15,11,10,51,40,11,56
Dundee Utd,5684,4,15,11,10,49,42,7,56
Queen of S't,5684,5,12,10,14,45,50,-5,46
Raith,5684,6,10,13,13,39,45,-6,43
Dunfermline,5684,7,9,14,13,46,49,-3,41
Ayr,5684,8,9,13,14,35,51,-16,40
Dumbarton,5684,9,8,14,14,47,57,-10,38
St Mirren,5684,10,7,11,18,40,64,-24,32
Morton,5685,1,20,10,6,54,33,21,70
Hibernian,5685,2,17,13,6,52,28,24,64
Dundee Utd,5685,3,14,10,12,52,41,11,52
Falkirk,5685,4,13,13,10,56,47,9,52
Dunfermline,5685,5,13,12,11,51,47,4,51
Queen of S't,5685,6,11,11,14,45,49,-4,44
Ayr,5685,7,9,12,15,36,55,-19,39
St Mirren,5685,8,9,11,16,44,56,-12,38
Raith,5685,9,9,10,17,37,53,-16,37
Dumbarton,5685,10,9,10,17,47,65,-18,37
Hibernian,5686,1,18,13,5,53,25,28,67
Dundee Utd,5686,2,18,8,10,51,39,12,62
Morton,5686,3,16,13,7,49,36,13,61
Falkirk,5686,4,16,10,10,55,41,14,58
Raith,5686,5,12,10,14,38,46,-8,46
Dunfermline,5686,6,9,13,14,46,50,-4,40
Queen of S't,5686,7,10,10,16,42,52,-10,40
Dumbarton,5686,8,9,12,15,52,61,-9,39
Ayr,5686,9,9,11,16,36,55,-19,38
St Mirren,5686,10,7,12,17,35,52,-17,33
Hibernian,5687,1,19,12,5,60,32,28,69
Falkirk,5687,2,17,11,8,61,39,22,62
Morton,5687,3,15,13,8,45,37,8,58
Dundee Utd,5687,4,15,10,11,50,39,11,55
Queen of S't,5687,5,10,13,13,49,51,-2,43
Raith,5687,6,11,10,15,37,51,-14,43
Dumbarton,5687,7,10,12,14,49,55,-6,42
Dunfermline,5687,8,9,14,13,48,50,-2,41
St Mirren,5687,9,8,10,18,40,59,-19,34
Ayr,5687,10,7,13,16,36,62,-26,34
Hibernian,5688,1,16,14,6,47,25,22,62
Falkirk,5688,2,17,11,8,56,36,20,62
Morton,5688,3,16,13,7,50,36,14,61
Dundee Utd,5688,4,16,11,9,52,41,11,59
Queen of S't,5688,5,12,11,13,49,49,0,47
Dunfermline,5688,6,10,14,12,42,44,-2,44
Raith,5688,7,10,12,14,35,43,-8,42
Ayr,5688,8,9,13,14,34,53,-19,40
Dumbarton,5688,9,7,12,17,43,60,-17,33
St Mirren,5688,10,7,9,20,34,55,-21,30
Hibernian,5689,1,18,13,5,54,27,27,67
Falkirk,5689,2,17,10,9,60,40,20,61
Morton,5689,3,16,11,9,48,35,13,59
Dundee Utd,5689,4,16,9,11,53,45,8,57
Dunfermline,5689,5,12,13,11,50,45,5,49
Queen of S't,5689,6,11,11,14,45,49,-4,44
Raith,5689,7,10,11,15,33,48,-15,41
Dumbarton,5689,8,9,11,16,46,55,-9,38
Ayr,5689,9,8,13,15,36,55,-19,37
St Mirren,5689,10,7,10,19,36,62,-26,31
Hibernian,5690,1,18,12,6,51,26,25,66
Morton,5690,2,16,13,7,51,39,12,61
Falkirk,5690,3,15,11,10,52,40,12,56
Dundee Utd,5690,4,15,9,12,50,42,8,54
Dunfermline,5690,5,12,11,13,47,45,2,47
Queen of S't,5690,6,12,9,15,48,51,-3,45
St Mirren,5690,7,11,10,15,44,52,-8,43
Dumbarton,5690,8,9,12,15,47,62,-15,39
Ayr,5690,9,9,11,16,36,53,-17,38
Raith,5690,10,8,12,16,32,48,-16,36
Hibernian,5691,1,18,14,4,58,30,28,68
Dundee Utd,5691,2,17,9,10,50,40,10,60
Falkirk,5691,3,16,11,9,61,46,15,59
Morton,5691,4,16,11,9,49,39,10,59
Dunfermline,5691,5,11,12,13,50,48,2,45
Raith,5691,6,10,13,13,36,46,-10,43
Ayr,5691,7,9,13,14,38,52,-14,40
Dumbarton,5691,8,9,12,15,47,55,-8,39
Queen of S't,5691,9,9,12,15,44,54,-10,39
St Mirren,5691,10,6,11,19,33,56,-23,29
Hibernian,5692,1,20,11,5,52,26,26,71
Morton,5692,2,17,12,7,49,34,15,63
Dundee Utd,5692,3,17,10,9,52,36,16,61
Falkirk,5692,4,15,12,9,57,40,17,57
Dunfermline,5692,5,10,13,13,44,48,-4,43
Queen of S't,5692,6,11,9,16,49,53,-4,42
Ayr,5692,7,9,12,15,34,51,-17,39
Raith,5692,8,9,11,16,36,50,-14,38
St Mirren,5692,9,8,11,17,38,56,-18,35
Dumbarton,5692,10,7,13,16,43,60,-17,34
Morton,5693,1,18,12,6,49,31,18,66
Hibernian,5693,2,17,14,5,54,28,26,65
Dundee Utd,5693,3,16,10,10,54,37,17,58
Falkirk,5693,4,16,10,10,58,42,16,58
Dunfermline,5693,5,10,13,13,48,52,-4,43
Raith,5693,6,11,10,15,39,48,-9,43
Queen of S't,5693,7,10,10,16,42,53,-11,40
Dumbarton,5693,8,9,12,15,49,59,-10,39
Ayr,5693,9,9,11,16,35,59,-24,38
St Mirren,5693,10,8,10,18,38,57,-19,34
Hibernian,5694,1,19,11,6,55,26,29,68
Dundee Utd,5694,2,18,8,10,55,40,15,62
Morton,5694,3,16,11,9,48,35,13,59
Falkirk,5694,4,14,11,11,52,43,9,53
Dunfermline,5694,5,12,12,12,49,45,4,48
Dumbarton,5694,6,11,12,13,51,54,-3,45
Queen of S't,5694,7,12,9,15,47,53,-6,45
Raith,5694,8,11,8,17,38,50,-12,41
St Mirren,5694,9,9,10,17,39,58,-19,37
Ayr,5694,10,7,10,19,33,63,-30,31
Hibernian,5695,1,18,13,5,58,31,27,67
Morton,5695,2,19,10,7,52,34,18,67
Falkirk,5695,3,16,11,9,61,39,22,59
Dundee Utd,5695,4,13,11,12,46,43,3,50
Queen of S't,5695,5,10,12,14,42,47,-5,42
Dumbarton,5695,6,10,12,14,48,56,-8,42
Dunfermline,5695,7,9,14,13,46,49,-3,41
St Mirren,5695,8,10,11,15,46,58,-12,41
Raith,5695,9,9,11,16,33,53,-20,38
Ayr,5695,10,8,11,17,30,52,-22,35
Hibernian,5696,1,21,11,4,59,23,36,74
Falkirk,5696,2,16,11,9,59,39,20,59
Morton,5696,3,15,12,9,47,38,9,57
Dundee Utd,5696,4,15,10,11,48,41,7,55
Dunfermline,5696,5,11,15,10,49,45,4,48
Dumbarton,5696,6,11,10,15,49,57,-8,43
Queen of S't,5696,7,11,8,17,45,56,-11,41
Raith,5696,8,10,10,16,37,49,-12,40
St Mirren,5696,9,9,11,16,42,58,-16,38
Ayr,5696,10,7,10,19,32,61,-29,31
Morton,5697,1,20,9,7,60,37,23,69
Falkirk,5697,2,18,11,7,63,37,26,65
Hibernian,5697,3,17,13,6,57,32,25,64
Dundee Utd,5697,4,15,9,12,49,43,6,54
Queen of S't,5697,5,11,10,15,45,49,-4,43
Dunfermline,5697,6,10,12,14,48,53,-5,42
Raith,5697,7,10,11,15,39,52,-13,41
Dumbarton,5697,8,9,12,15,49,54,-5,39
St Mirren,5697,9,9,10,17,40,59,-19,37
Ayr,5697,10,7,11,18,28,62,-34,32
Hibernian,5698,1,19,13,4,57,24,33,70
Dundee Utd,5698,2,17,9,10,48,36,12,60
Falkirk,5698,3,15,11,10,58,42,16,56
Morton,5698,4,15,9,12,50,43,7,54
Queen of S't,5698,5,11,10,15,40,51,-11,43
St Mirren,5698,6,10,11,15,41,54,-13,41
Dumbarton,5698,7,9,13,14,49,56,-7,40
Dunfermline,5698,8,9,13,14,42,50,-8,40
Raith,5698,9,9,13,14,38,50,-12,40
Ayr,5698,10,9,12,15,38,55,-17,39
Hibernian,5699,1,18,11,7,51,26,25,65
Morton,5699,2,17,11,8,48,37,11,62
Falkirk,5699,3,17,9,10,64,44,20,60
Dundee Utd,5699,4,16,10,10,57,43,14,58
Dunfermline,5699,5,10,14,12,52,54,-2,44
Queen of S't,5699,6,11,10,15,45,53,-8,43
Raith,5699,7,11,10,15,39,50,-11,43
Dumbarton,5699,8,9,12,15,51,62,-11,39
Ayr,5699,9,8,12,16,32,54,-22,36
St Mirren,5699,10,8,11,17,43,59,-16,35
Hibernian,5700,1,19,14,3,56,22,34,71
Morton,5700,2,16,11,9,54,43,11,59
Falkirk,5700,3,15,11,10,56,43,13,56
Dundee Utd,5700,4,15,9,12,53,42,11,54
Queen of S't,5700,5,12,8,16,48,57,-9,44
Dunfermline,5700,6,10,13,13,45,51,-6,43
Dumbarton,5700,7,10,11,15,46,56,-10,41
St Mirren,5700,8,10,10,16,39,54,-15,40
Raith,5700,9,9,11,16,40,51,-11,38
Ayr,5700,10,8,14,14,37,55,-18,38
Hibernian,5701,1,20,11,5,54,25,29,71
Morton,5701,2,16,13,7,49,39,10,61
Dundee Utd,5701,3,16,9,11,60,43,17,57
Falkirk,5701,4,15,11,10,55,42,13,56
Queen of S't,5701,5,13,8,15,45,51,-6,47
Dunfermline,5701,6,10,13,13,50,51,-1,43
St Mirren,5701,7,9,12,15,47,57,-10,39
Raith,5701,8,10,9,17,40,56,-16,39
Dumbarton,5701,9,9,10,17,52,67,-15,37
Ayr,5701,10,7,14,15,36,57,-21,35
Hibernian,5702,1,18,14,4,56,24,32,68
Falkirk,5702,2,18,10,8,65,37,28,64
Morton,5702,3,17,12,7,57,38,19,63
Dundee Utd,5702,4,14,9,13,48,44,4,51
Queen of S't,5702,5,13,10,13,47,46,1,49
Dunfermline,5702,6,11,13,12,45,48,-3,46
Raith,5702,7,10,8,18,37,55,-18,38
St Mirren,5702,8,9,9,18,45,66,-21,36
Ayr,5702,9,8,12,16,34,60,-26,36
Dumbarton,5702,10,8,11,17,46,62,-16,35
Hibernian,5703,1,17,11,8,54,34,20,62
Falkirk,5703,2,17,10,9,59,38,21,61
Morton,5703,3,16,12,8,49,38,11,60
Dundee Utd,5703,4,16,10,10,49,39,10,58
Queen of S't,5703,5,13,8,15,50,55,-5,47
Dunfermline,5703,6,10,14,12,47,48,-1,44
St Mirren,5703,7,11,10,15,45,53,-8,43
Dumbarton,5703,8,10,10,16,50,62,-12,40
Raith,5703,9,10,9,17,34,47,-13,39
Ayr,5703,10,8,10,18,33,56,-23,34
Hibernian,5704,1,21,11,4,59,27,32,74
Dundee Utd,5704,2,16,12,8,51,36,15,60
Falkirk,5704,3,16,11,9,60,42,18,59
Morton,5704,4,16,11,9,49,38,11,59
Dumbarton,5704,5,12,10,14,49,56,-7,46
Queen of S't,5704,6,11,9,16,43,50,-7,42
Dunfermline,5704,7,9,12,15,45,50,-5,39
Ayr,5704,8,9,11,16,35,56,-21,38
St Mirren,5704,9,8,11,17,39,53,-14,35
Raith,5704,10,8,10,18,29,51,-22,34
Morton,5705,1,19,10,7,54,36,18,67
Dundee Utd,5705,2,19,9,8,55,36,19,66
Hibernian,5705,3,17,14,5,51,25,26,65
Falkirk,5705,4,15,11,10,59,42,17,56
Queen of S't,5705,5,11,12,13,48,52,-4,45
Dunfermline,5705,6,9,13,14,42,49,-7,40
Dumbarton,5705,7,10,10,16,48,57,-9,40
St Mirren,5705,8,9,11,16,41,56,-15,38
Raith,5705,9,9,9,18,33,51,-18,36
Ayr,5705,10,7,11,18,34,61,-27,32
Hibernian,5706,1,21,10,5,60,25,35,73
Morton,5706,2,18,9,9,51,38,13,63
Dundee Utd,5706,3,16,10,10,51,37,14,58
Falkirk,5706,4,15,11,10,58,44,14,56
Queen of S't,5706,5,14,9,13,53,50,3,51
Dumbarton,5706,6,10,13,13,46,53,-7,43
Dunfermline,5706,7,10,12,14,42,46,-4,42
Raith,5706,8,9,9,18,32,49,-17,36
St Mirren,5706,9,8,9,19,36,59,-23,33
Ayr,5706,10,6,14,16,33,61,-28,32
Hibernian,5707,1,20,11,5,61,28,33,71
Morton,5707,2,20,11,5,53,31,22,71
Falkirk,5707,3,17,10,9,59,36,23,61
Dundee Utd,5707,4,15,9,12,47,42,5,54
Queen of S't,5707,5,11,10,15,48,52,-4,43
Dunfermline,5707,6,9,13,14,45,51,-6,40
St Mirren,5707,7,10,9,17,45,59,-14,39
Raith,5707,8,9,11,16,37,54,-17,38
Dumbarton,5707,9,8,11,17,46,64,-18,35
Ayr,5707,10,8,11,17,33,57,-24,35
Hibernian,5708,1,20,12,4,56,25,31,72
Morton,5708,2,18,9,9,53,38,15,63
Falkirk,5708,3,17,11,8,63,38,25,62
Dundee Utd,5708,4,16,10,10,50,38,12,58
Queen of S't,5708,5,10,12,14,42,50,-8,42
Dumbarton,5708,6,10,11,15,48,56,-8,41
Dunfermline,5708,7,8,16,12,42,47,-5,40
Raith,5708,8,10,10,16,35,53,-18,40
Ayr,5708,9,8,10,18,31,54,-23,34
St Mirren,5708,10,8,9,19,41,62,-21,33
Hibernian,5709,1,18,12,6,57,29,28,66
Falkirk,5709,2,17,10,9,65,44,21,61
Dundee Utd,5709,3,17,10,9,54,37,17,61
Morton,5709,4,14,14,8,47,37,10,56
Dumbarton,5709,5,12,10,14,54,58,-4,46
Dunfermline,5709,6,10,13,13,45,50,-5,43
Raith,5709,7,10,11,15,38,49,-11,41
St Mirren,5709,8,9,12,15,41,53,-12,39
Queen of S't,5709,9,10,8,18,41,54,-13,38
Ayr,5709,10,7,12,17,32,63,-31,33
Hibernian,5710,1,21,12,3,62,22,40,75
Morton,5710,2,16,12,8,50,38,12,60
Dundee Utd,5710,3,16,11,9,55,38,17,59
Falkirk,5710,4,16,11,9,54,39,15,59
Queen of S't,5710,5,13,10,13,46,46,0,49
Dunfermline,5710,6,10,11,15,42,53,-11,41
Raith,5710,7,9,10,17,34,47,-13,37
Dumbarton,5710,8,8,12,16,45,58,-13,36
St Mirren,5710,9,8,10,18,39,57,-18,34
Ayr,5710,10,7,13,16,31,60,-29,34
Hibernian,5711,1,18,15,3,53,22,31,69
Falkirk,5711,2,18,10,8,59,44,15,64
Morton,5711,3,16,12,8,49,39,10,60
Dundee Utd,5711,4,16,9,11,57,41,16,57
Dunfermline,5711,5,11,12,13,52,49,3,45
Queen of S't,5711,6,11,10,15,44,54,-10,43
Ayr,5711,7,10,12,14,39,49,-10,42
Dumbarton,5711,8,10,10,16,51,61,-10,40
Raith,5711,9,9,11,16,33,50,-17,38
St Mirren,5711,10,6,9,21,35,63,-28,27
Hibernian,5712,1,21,12,3,60,25,35,75
Morton,5712,2,16,11,9,47,37,10,59
Falkirk,5712,3,16,9,11,56,39,17,57
Dundee Utd,5712,4,14,10,12,43,38,5,52
Dunfermline,5712,5,12,12,12,48,44,4,48
Raith,5712,6,12,9,15,35,46,-11,45
Queen of S't,5712,7,11,9,16,42,52,-10,42
St Mirren,5712,8,9,10,17,41,53,-12,37
Dumbarton,5712,9,9,10,17,46,63,-17,37
Ayr,5712,10,8,12,16,33,54,-21,36
Hibernian,5713,1,18,13,5,57,30,27,67
Falkirk,5713,2,17,10,9,62,42,20,61
Morton,5713,3,16,12,8,53,41,12,60
Dundee Utd,5713,4,16,9,11,52,42,10,57
Raith,5713,5,12,8,16,41,47,-6,44
Queen of S't,5713,6,10,11,15,43,52,-9,41
Dumbarton,5713,7,9,13,14,48,57,-9,40
Dunfermline,5713,8,9,12,15,49,58,-9,39
Ayr,5713,9,9,12,15,36,53,-17,39
St Mirren,5713,10,9,10,17,41,60,-19,37
Hibernian,5714,1,19,13,4,54,21,33,70
Morton,5714,2,18,10,8,53,37,16,64
Dundee Utd,5714,3,17,9,10,54,42,12,60
Falkirk,5714,4,15,10,11,56,42,14,55
Queen of S't,5714,5,13,8,15,49,54,-5,47
Raith,5714,6,11,10,15,38,50,-12,43
Dunfermline,5714,7,8,15,13,42,47,-5,39
Dumbarton,5714,8,8,12,16,45,58,-13,36
St Mirren,5714,9,8,12,16,41,58,-17,36
Ayr,5714,10,7,13,16,31,54,-23,34
Morton,5715,1,19,10,7,51,32,19,67
Falkirk,5715,2,17,10,9,59,42,17,61
Dundee Utd,5715,3,17,10,9,52,38,14,61
Hibernian,5715,4,16,12,8,50,32,18,60
Queen of S't,5715,5,11,11,14,43,50,-7,44
Dumbarton,5715,6,10,11,15,51,59,-8,41
Dunfermline,5715,7,8,16,12,46,48,-2,40
Raith,5715,8,9,13,14,32,44,-12,40
St Mirren,5715,9,9,10,17,42,57,-15,37
Ayr,5715,10,6,13,17,33,57,-24,31
Hibernian,5716,1,19,12,5,54,26,28,69
Morton,5716,2,19,10,7,55,37,18,67
Falkirk,5716,3,16,11,9,56,36,20,59
Dundee Utd,5716,4,14,11,11,48,44,4,53
Dumbarton,5716,5,12,12,12,49,50,-1,48
Raith,5716,6,11,10,15,35,47,-12,43
Queen of S't,5716,7,10,12,14,47,52,-5,42
Dunfermline,5716,8,7,15,14,41,47,-6,36
Ayr,5716,9,8,11,17,35,61,-26,35
St Mirren,5716,10,7,10,19,37,57,-20,31
Hibernian,5717,1,20,11,5,56,21,35,71
Morton,5717,2,17,12,7,48,35,13,63
Falkirk,5717,3,17,11,8,57,35,22,62
Dundee Utd,5717,4,14,12,10,45,37,8,54
Queen of S't,5717,5,11,11,14,45,51,-6,44
Dumbarton,5717,6,10,10,16,47,55,-8,40
St Mirren,5717,7,10,10,16,42,54,-12,40
Raith,5717,8,9,10,17,32,50,-18,37
Ayr,5717,9,8,13,15,32,54,-22,37
Dunfermline,5717,10,8,12,16,40,52,-12,36
Hibernian,5718,1,19,12,5,55,26,29,69
Falkirk,5718,2,18,9,9,65,40,25,63
Morton,5718,3,16,12,8,47,34,13,60
Dundee Utd,5718,4,15,9,12,49,43,6,54
Queen of S't,5718,5,13,8,15,46,54,-8,47
Dunfermline,5718,6,10,12,14,47,53,-6,42
Dumbarton,5718,7,10,11,15,47,56,-9,41
Ayr,5718,8,9,12,15,37,54,-17,39
Raith,5718,9,9,10,17,35,54,-19,37
St Mirren,5718,10,8,11,17,42,56,-14,35
Hibernian,5719,1,20,13,3,60,26,34,73
Falkirk,5719,2,16,12,8,60,38,22,60
Morton,5719,3,16,10,10,50,38,12,58
Dundee Utd,5719,4,14,12,10,43,38,5,54
Queen of S't,5719,5,12,10,14,46,49,-3,46
Dumbarton,5719,6,11,11,14,54,57,-3,44
Raith,5719,7,11,9,16,35,52,-17,42
Dunfermline,5719,8,8,14,14,41,51,-10,38
Ayr,5719,9,8,12,16,32,54,-22,36
St Mirren,5719,10,8,9,19,38,56,-18,33
Hibernian,5720,1,18,13,5,53,24,29,67
Morton,5720,2,18,10,8,55,37,18,64
Dundee Utd,5720,3,16,10,10,49,38,11,58
Falkirk,5720,4,15,11,10,57,41,16,56
Dunfermline,5720,5,11,11,14,45,49,-4,44
Queen of S't,5720,6,12,8,16,44,50,-6,44
Raith,5720,7,11,9,16,35,54,-19,42
St Mirren,5720,8,10,10,16,41,51,-10,40
Ayr,5720,9,9,11,16,35,55,-20,38
Dumbarton,5720,10,8,11,17,43,58,-15,35
Hibernian,5721,1,19,12,5,54,31,23,69
Falkirk,5721,2,18,10,8,69,41,28,64
Morton,5721,3,16,12,8,49,34,15,60
Dundee Utd,5721,4,14,10,12,50,48,2,52
Queen of S't,5721,5,12,9,15,52,56,-4,45
Ayr,5721,6,10,12,14,44,57,-13,42
Dunfermline,5721,7,8,17,11,50,52,-2,41
Dumbarton,5721,8,9,11,16,46,62,-16,38
Raith,5721,9,9,11,16,36,52,-16,38
St Mirren,5721,10,8,10,18,45,62,-17,34
Morton,5722,1,19,11,6,52,33,19,68
Hibernian,5722,2,16,13,7,51,30,21,61
Falkirk,5722,3,17,9,10,63,44,19,60
Dundee Utd,5722,4,15,10,11,49,41,8,55
Dunfermline,5722,5,12,12,12,49,49,0,48
Queen of S't,5722,6,12,10,14,46,52,-6,46
Raith,5722,7,11,9,16,36,49,-13,42
Dumbarton,5722,8,9,10,17,52,61,-9,37
St Mirren,5722,9,8,11,17,39,53,-14,35
Ayr,5722,10,8,11,17,30,55,-25,35
Hibernian,5723,1,18,13,5,59,30,29,67
Morton,5723,2,18,11,7,52,34,18,65
Falkirk,5723,3,14,12,10,55,43,12,54
Dundee Utd,5723,4,13,13,10,44,39,5,52
Queen of S't,5723,5,11,12,13,44,47,-3,45
Dumbarton,5723,6,10,14,12,49,53,-4,44
Raith,5723,7,10,11,15,34,48,-14,41
Dunfermline,5723,8,8,14,14,44,49,-5,38
Ayr,5723,9,7,15,14,36,56,-20,36
St Mirren,5723,10,8,11,17,38,56,-18,35
Hibernian,5724,1,19,12,5,59,30,29,69
Morton,5724,2,19,10,7,59,38,21,67
Falkirk,5724,3,15,10,11,59,48,11,55
Dundee Utd,5724,4,14,10,12,52,46,6,52
Dunfermline,5724,5,11,12,13,52,51,1,45
Dumbarton,5724,6,11,12,13,54,60,-6,45
Queen of S't,5724,7,11,9,16,47,57,-10,42
Ayr,5724,8,9,13,14,37,55,-18,40
Raith,5724,9,9,9,18,34,52,-18,36
St Mirren,5724,10,8,11,17,42,58,-16,35
Hibernian,5725,1,18,15,3,53,24,29,69
Falkirk,5725,2,18,10,8,63,38,25,64
Morton,5725,3,17,13,6,50,32,18,64
Dundee Utd,5725,4,14,12,10,48,40,8,54
Dunfermline,5725,5,11,14,11,46,45,1,47
Queen of S't,5725,6,10,12,14,41,48,-7,42
Raith,5725,7,9,11,16,37,50,-13,38
St Mirren,5725,8,8,11,17,38,57,-19,35
Dumbarton,5725,9,7,13,16,43,57,-14,34
Ayr,5725,10,6,13,17,34,62,-28,31
Hibernian,5726,1,19,12,5,58,29,29,69
Falkirk,5726,2,17,10,9,63,43,20,61
Dundee Utd,5726,3,16,9,11,50,41,9,57
Morton,5726,4,15,11,10,47,38,9,56
Raith,5726,5,12,9,15,41,53,-12,45
Dunfermline,5726,6,11,11,14,51,50,1,44
Dumbarton,5726,7,10,12,14,48,56,-8,42
Queen of S't,5726,8,10,10,16,45,55,-10,40
Ayr,5726,9,9,12,15,36,53,-17,39
St Mirren,5726,10,8,10,18,38,59,-21,34
Hibernian,5727,1,20,11,5,62,26,36,71
Falkirk,5727,2,18,9,9,63,43,20,63
Dundee Utd,5727,3,17,9,10,55,39,16,60
Morton,5727,4,16,11,9,46,37,9,59
Dunfermline,5727,5,10,11,15,43,49,-6,41
Queen of S't,5727,6,10,11,15,45,56,-11,41
Dumbarton,5727,7,9,13,14,50,60,-10,40
Raith,5727,8,9,12,15,35,50,-15,39
Ayr,5727,9,8,12,16,35,58,-23,36
St Mirren,5727,10,8,11,17,44,60,-16,35
Falkirk,5728,1,19,10,7,60,37,23,67
Hibernian,5728,2,17,13,6,53,26,27,64
Morton,5728,3,17,13,6,52,34,18,64
Dundee Utd,5728,4,16,11,9,52,40,12,59
Dumbarton,5728,5,10,10,16,50,60,-10,40
Queen of S't,5728,6,10,10,16,41,53,-12,40
Ayr,5728,7,9,13,14,40,57,-17,40
Dunfermline,5728,8,8,13,15,43,51,-8,37
St Mirren,5728,9,9,10,17,38,54,-16,37
Raith,5728,10,8,11,17,34,51,-17,35
Hibernian,5729,1,21,10,5,59,22,37,73
Dundee Utd,5729,2,17,10,9,51,39,12,61
Falkirk,5729,3,16,11,9,58,41,17,59
Morton,5729,4,15,12,9,49,38,11,57
Queen of S't,5729,5,12,11,13,50,56,-6,47
Dunfermline,5729,6,9,15,12,43,45,-2,42
Dumbarton,5729,7,9,11,16,47,58,-11,38
Raith,5729,8,9,10,17,38,55,-17,37
St Mirren,5729,9,9,9,18,43,56,-13,36
Ayr,5729,10,6,15,15,34,62,-28,33
Hibernian,5730,1,17,14,5,50,27,23,65
Morton,5730,2,17,10,9,49,38,11,61
Dundee Utd,5730,3,15,9,12,49,44,5,54
Falkirk,5730,4,14,11,11,56,44,12,53
Dunfermline,5730,5,11,13,12,51,47,4,46
Queen of S't,5730,6,12,10,14,52,53,-1,46
St Mirren,5730,7,11,10,15,46,57,-11,43
Dumbarton,5730,8,10,11,15,50,60,-10,41
Ayr,5730,9,9,12,15,35,53,-18,39
Raith,5730,10,9,10,17,34,49,-15,37
Hibernian,5731,1,20,11,5,55,26,29,71
Morton,5731,2,18,11,7,55,35,20,65
Dundee Utd,5731,3,17,11,8,52,37,15,62
Falkirk,5731,4,15,11,10,58,44,14,56
Queen of S't,5731,5,12,10,14,51,54,-3,46
Raith,5731,6,11,10,15,38,50,-12,43
Dunfermline,5731,7,8,14,14,44,52,-8,38
St Mirren,5731,8,8,12,16,36,51,-15,36
Dumbarton,5731,9,7,12,17,47,62,-15,33
Ayr,5731,10,7,12,17,32,57,-25,33
Hibernian,5732,1,19,12,5,55,24,31,69
Morton,5732,2,19,12,5,52,32,20,69
Dundee Utd,5732,3,17,11,8,55,36,19,62
Falkirk,5732,4,16,9,11,62,48,14,57
Queen of S't,5732,5,13,8,15,49,52,-3,47
Raith,5732,6,12,8,16,42,48,-6,44
Dunfermline,5732,7,8,13,15,44,57,-13,37
Dumbarton,5732,8,8,11,17,47,64,-17,35
St Mirren,5732,9,8,11,17,39,58,-19,35
Ayr,5732,10,6,13,17,31,57,-26,31
Hibernian,5733,1,21,12,3,59,23,36,75
Morton,5733,2,18,9,9,58,35,23,63
Falkirk,5733,3,15,12,9,59,42,17,57
Dundee Utd,5733,4,15,9,12,51,44,7,54
Dunfermline,5733,5,12,12,12,52,49,3,48
Queen of S't,5733,6,12,10,14,48,54,-6,46
Raith,5733,7,10,8,18,31,55,-24,38
Ayr,5733,8,9,10,17,33,58,-25,37
Dumbarton,5733,9,8,11,17,46,58,-12,35
St Mirren,5733,10,8,11,17,40,59,-19,35
Hibernian,5734,1,18,12,6,58,28,30,66
Morton,5734,2,17,13,6,54,38,16,64
Falkirk,5734,3,17,10,9,61,39,22,61
Dundee Utd,5734,4,17,10,9,53,37,16,61
Dunfermline,5734,5,11,14,11,48,45,3,47
Raith,5734,6,11,10,15,40,51,-11,43
Dumbarton,5734,7,9,13,14,46,53,-7,40
Queen of S't,5734,8,10,8,18,40,59,-19,38
St Mirren,5734,9,8,10,18,35,55,-20,34
Ayr,5734,10,7,10,19,33,63,-30,31
Hibernian,5735,1,20,12,4,59,25,34,72
Morton,5735,2,17,10,9,51,40,11,61
Falkirk,5735,3,16,11,9,59,40,19,59
Dundee Utd,5735,4,15,12,9,53,40,13,57
Queen of S't,5735,5,13,8,15,44,48,-4,47
Dunfermline,5735,6,10,13,13,49,52,-3,43
Raith,5735,7,10,10,16,37,53,-16,40
Dumbarton,5735,8,9,12,15,48,60,-12,39
Ayr,5735,9,8,12,16,37,56,-19,36
St Mirren,5735,10,7,10,19,36,59,-23,31
Hibernian,5736,1,20,11,5,55,25,30,71
Falkirk,5736,2,15,12,9,56,40,16,57
Dundee Utd,5736,3,16,9,11,49,40,9,57
Morton,5736,4,14,9,13,43,42,1,51
Dumbarton,5736,5,13,10,13,52,54,-2,49
Dunfermline,5736,6,10,13,13,45,48,-3,43
Queen of S't,5736,7,11,9,16,44,50,-6,42
Ayr,5736,8,10,11,15,35,51,-16,41
Raith,5736,9,9,12,15,32,45,-13,39
St Mirren,5736,10,9,10,17,42,58,-16,37
Hibernian,5737,1,17,15,4,54,26,28,66
Morton,5737,2,18,10,8,55,40,15,64
Falkirk,5737,3,16,11,9,58,40,18,59
Dundee Utd,5737,4,16,10,10,48,37,11,58
Queen of S't,5737,5,11,9,16,45,52,-7,42
Dunfermline,5737,6,9,14,13,44,48,-4,41
Raith,5737,7,10,10,16,36,48,-12,40
Dumbarton,5737,8,9,12,15,46,61,-15,39
St Mirren,5737,9,8,14,14,38,50,-12,38
Ayr,5737,10,7,13,16,35,57,-22,34
Morton,5738,1,19,11,6,51,33,18,68
Hibernian,5738,2,17,13,6,53,28,25,64
Falkirk,5738,3,16,10,10,60,40,20,58
Dundee Utd,5738,4,16,9,11,52,42,10,57
Raith,5738,5,12,9,15,36,50,-14,45
Queen of S't,5738,6,11,10,15,42,53,-11,43
Dunfermline,5738,7,9,14,13,44,50,-6,41
Dumbarton,5738,8,9,11,16,52,58,-6,38
Ayr,5738,9,8,13,15,33,53,-20,37
St Mirren,5738,10,7,12,17,39,55,-16,33
Hibernian,5739,1,21,11,4,58,24,34,74
Falkirk,5739,2,17,10,9,61,42,19,61
Dundee Utd,5739,3,16,12,8,55,42,13,60
Morton,5739,4,15,13,8,55,39,16,58
Queen of S't,5739,5,12,10,14,49,50,-1,46
Raith,5739,6,10,10,16,36,49,-13,40
Ayr,5739,7,8,14,14,33,57,-24,38
Dunfermline,5739,8,8,12,16,43,54,-11,36
St Mirren,5739,9,8,11,17,41,58,-17,35
Dumbarton,5739,10,7,13,16,49,65,-16,34
Hibernian,5740,1,22,11,3,56,20,36,77
Dundee Utd,5740,2,17,10,9,55,39,16,61
Morton,5740,3,16,12,8,50,38,12,60
Falkirk,5740,4,16,11,9,58,42,16,59
Dunfermline,5740,5,11,12,13,49,47,2,45
Queen of S't,5740,6,11,8,17,45,56,-11,41
Raith,5740,7,11,8,17,39,53,-14,41
Dumbarton,5740,8,8,12,16,45,61,-16,36
St Mirren,5740,9,7,12,17,39,55,-16,33
Ayr,5740,10,7,12,17,32,57,-25,33
Hibernian,5741,1,19,12,5,55,26,29,69
Morton,5741,2,16,12,8,50,38,12,60
Falkirk,5741,3,15,10,11,55,45,10,55
Dundee Utd,5741,4,14,13,9,52,42,10,55
Queen of S't,5741,5,12,11,13,48,48,0,47
Dumbarton,5741,6,12,10,14,51,52,-1,46
Dunfermline,5741,7,9,13,14,42,48,-6,40
Raith,5741,8,10,9,17,34,50,-16,39
St Mirren,5741,9,8,12,16,39,53,-14,36
Ayr,5741,10,8,12,16,30,54,-24,36
Hibernian,5742,1,19,13,4,52,25,27,70
Morton,5742,2,17,10,9,57,39,18,61
Falkirk,5742,3,16,9,11,56,43,13,57
Dundee Utd,5742,4,16,8,12,50,40,10,56
Ayr,5742,5,11,13,12,41,48,-7,46
Queen of S't,5742,6,12,9,15,44,51,-7,45
Dunfermline,5742,7,11,11,14,45,50,-5,44
Raith,5742,8,10,9,17,33,49,-16,39
St Mirren,5742,9,9,10,17,41,59,-18,37
Dumbarton,5742,10,8,10,18,49,64,-15,34
Hibernian,5743,1,17,14,5,52,26,26,65
Falkirk,5743,2,17,10,9,62,44,18,61
Morton,5743,3,16,11,9,44,34,10,59
Dundee Utd,5743,4,14,10,12,47,43,4,52
Dunfermline,5743,5,11,14,11,50,45,5,47
Queen of S't,5743,6,12,9,15,43,49,-6,45
Dumbarton,5743,7,9,13,14,50,57,-7,40
Raith,5743,8,10,10,16,34,47,-13,40
St Mirren,5743,9,9,11,16,41,57,-16,38
Ayr,5743,10,8,12,16,31,52,-21,36
Hibernian,5744,1,18,14,4,58,27,31,68
Morton,5744,2,15,16,5,44,30,14,61
Dundee Utd,5744,3,16,10,10,52,38,14,58
Falkirk,5744,4,14,10,12,54,48,6,52
Queen of S't,5744,5,13,9,14,49,50,-1,48
Dunfermline,5744,6,10,14,12,42,42,0,44
Ayr,5744,7,9,13,14,35,52,-17,40
St Mirren,5744,8,9,11,16,41,55,-14,38
Raith,5744,9,9,10,17,35,52,-17,37
Dumbarton,5744,10,8,11,17,46,62,-16,35
Hibernian,5745,1,18,13,5,54,25,29,67
Morton,5745,2,16,12,8,49,40,9,60
Falkirk,5745,3,15,12,9,56,39,17,57
Queen of S't,5745,4,14,9,13,46,43,3,51
Dundee Utd,5745,5,14,9,13,45,42,3,51
Dunfermline,5745,6,10,12,14,49,50,-1,42
Dumbarton,5745,7,10,12,14,52,57,-5,42
St Mirren,5745,8,10,11,15,39,49,-10,41
Raith,5745,9,9,11,16,36,52,-16,38
Ayr,5745,10,8,11,17,34,63,-29,35
Hibernian,5746,1,19,12,5,54,27,27,69
Dundee Utd,5746,2,19,8,9,55,37,18,65
Morton,5746,3,18,9,9,52,40,12,63
Falkirk,5746,4,16,12,8,57,39,18,60
Queen of S't,5746,5,12,9,15,44,51,-7,45
Raith,5746,6,11,9,16,34,47,-13,42
Dunfermline,5746,7,9,13,14,46,48,-2,40
St Mirren,5746,8,8,11,17,39,52,-13,35
Ayr,5746,9,8,11,17,37,58,-21,35
Dumbarton,5746,10,8,10,18,46,65,-19,34
Hibernian,5747,1,20,11,5,56,24,32,71
Dundee Utd,5747,2,18,9,9,60,36,24,63
Falkirk,5747,3,16,11,9,66,41,25,59
Morton,5747,4,15,11,10,49,42,7,56
Queen of S't,5747,5,12,9,15,48,55,-7,45
Dumbarton,5747,6,10,11,15,48,59,-11,41
Ayr,5747,7,10,11,15,38,56,-18,41
Dunfermline,5747,8,9,12,15,46,53,-7,39
Raith,5747,9,10,8,18,35,59,-24,38
St Mirren,5747,10,8,11,17,40,61,-21,35
Hibernian,5748,1,22,11,3,57,22,35,77
Falkirk,5748,2,17,11,8,58,37,21,62
Morton,5748,3,16,10,10,51,41,10,58
Dundee Utd,5748,4,15,10,11,47,36,11,55
Dunfermline,5748,5,10,14,12,46,47,-1,44
Raith,5748,6,12,8,16,39,50,-11,44
Queen of S't,5748,7,11,9,16,44,51,-7,42
Ayr,5748,8,8,13,15,34,52,-18,37
Dumbarton,5748,9,8,12,16,45,62,-17,36
St Mirren,5748,10,6,12,18,36,59,-23,30
Hibernian,5749,1,18,13,5,54,29,25,67
Dundee Utd,5749,2,18,9,9,57,39,18,63
Morton,5749,3,15,11,10,48,41,7,56
Falkirk,5749,4,15,10,11,55,43,12,55
Queen of S't,5749,5,13,10,13,43,46,-3,49
Raith,5749,6,11,9,16,35,47,-12,42
Dunfermline,5749,7,9,13,14,48,54,-6,40
St Mirren,5749,8,10,10,16,45,53,-8,40
Dumbarton,5749,9,9,12,15,47,58,-11,39
Ayr,5749,10,7,13,16,37,59,-22,34
Hibernian,5750,1,19,12,5,56,26,30,69
Morton,5750,2,18,9,9,53,38,15,63
Dundee Utd,5750,3,17,10,9,55,37,18,61
Falkirk,5750,4,15,12,9,59,39,20,57
Dunfermline,5750,5,12,13,11,55,51,4,49
St Mirren,5750,6,11,9,16,44,60,-16,42
Queen of S't,5750,7,10,11,15,41,51,-10,41
Raith,5750,8,10,11,15,40,51,-11,41
Ayr,5750,9,7,11,18,32,62,-30,32
Dumbarton,5750,10,7,10,19,43,63,-20,31
Hibernian,5751,1,18,13,5,56,28,28,67
Dundee Utd,5751,2,17,9,10,53,39,14,60
Morton,5751,3,16,11,9,51,44,7,59
Falkirk,5751,4,15,9,12,55,43,12,54
Queen of S't,5751,5,12,12,12,48,47,1,48
Dunfermline,5751,6,10,13,13,42,46,-4,43
Dumbarton,5751,7,9,12,15,50,59,-9,39
Ayr,5751,8,9,12,15,32,53,-21,39
Raith,5751,9,9,11,16,35,50,-15,38
St Mirren,5751,10,9,10,17,41,54,-13,37
Hibernian,5752,1,20,11,5,56,26,30,71
Dundee Utd,5752,2,17,10,9,50,35,15,61
Morton,5752,3,15,14,7,49,38,11,59
Falkirk,5752,4,16,10,10,62,40,22,58
Queen of S't,5752,5,11,11,14,46,51,-5,44
Raith,5752,6,10,11,15,39,51,-12,41
St Mirren,5752,7,10,10,16,45,55,-10,40
Dunfermline,5752,8,8,13,15,41,53,-12,37
Ayr,5752,9,8,13,15,35,61,-26,37
Dumbarton,5752,10,8,11,17,46,59,-13,35
Hibernian,5753,1,18,13,5,57,29,28,67
Morton,5753,2,18,12,6,52,35,17,66
Falkirk,5753,3,17,11,8,60,39,21,62
Dundee Utd,5753,4,16,9,11,55,43,12,57
Queen of S't,5753,5,11,10,15,44,48,-4,43
Dunfermline,5753,6,10,12,14,46,53,-7,42
St Mirren,5753,7,10,9,17,42,55,-13,39
Dumbarton,5753,8,9,11,16,47,58,-11,38
Raith,5753,9,9,10,17,36,54,-18,37
Ayr,5753,10,7,13,16,32,57,-25,34
Hibernian,5754,1,18,12,6,55,25,30,66
Morton,5754,2,18,11,7,53,35,18,65
Falkirk,5754,3,16,10,10,62,45,17,58
Dundee Utd,5754,4,16,9,11,48,39,9,57
Ayr,5754,5,11,11,14,38,51,-13,44
Queen of S't,5754,6,11,9,16,46,55,-9,42
Raith,5754,7,11,9,16,34,48,-14,42
Dunfermline,5754,8,10,11,15,45,55,-10,41
Dumbarton,5754,9,10,10,16,44,57,-13,40
St Mirren,5754,10,7,12,17,41,56,-15,33
Hibernian,5755,1,19,13,4,56,24,32,70
Dundee Utd,5755,2,16,12,8,54,41,13,60
Morton,5755,3,16,12,8,48,38,10,60
Falkirk,5755,4,15,13,8,58,41,17,58
Dunfermline,5755,5,10,14,12,50,48,2,44
Queen of S't,5755,6,11,9,16,45,57,-12,42
St Mirren,5755,7,10,11,15,41,52,-11,41
Dumbarton,5755,8,9,10,17,46,60,-14,37
Raith,5755,9,9,9,18,36,52,-16,36
Ayr,5755,10,8,11,17,38,59,-21,35
Hibernian,5756,1,21,11,4,53,23,30,74
Morton,5756,2,18,10,8,52,35,17,64
Dundee Utd,5756,3,17,10,9,56,38,18,61
Falkirk,5756,4,14,10,12,53,45,8,52
Queen of S't,5756,5,13,10,13,48,47,1,49
Dunfermline,5756,6,10,13,13,46,46,0,43
Dumbarton,5756,7,9,13,14,48,59,-11,40
Raith,5756,8,9,9,18,35,54,-19,36
St Mirren,5756,9,8,11,17,36,54,-18,35
Ayr,5756,10,6,13,17,34,60,-26,31
Hibernian,5757,1,20,13,3,67,26,41,73
Morton,5757,2,16,13,7,47,35,12,61
Falkirk,5757,3,16,12,8,60,39,21,60
Dundee Utd,5757,4,16,10,10,51,41,10,58
Queen of S't,5757,5,12,10,14,44,49,-5,46
Dunfermline,5757,6,9,15,12,43,44,-1,42
Raith,5757,7,10,9,17,32,51,-19,39
Dumbarton,5757,8,8,13,15,45,56,-11,37
Ayr,5757,9,7,13,16,36,59,-23,34
St Mirren,5757,10,7,10,19,36,61,-25,31
Hibernian,5758,1,21,12,3,58,25,33,75
Falkirk,5758,2,16,11,9,57,38,19,59
Morton,5758,3,16,11,9,52,39,13,59
Dundee Utd,5758,4,15,10,11,48,43,5,55
Dumbarton,5758,5,11,12,13,53,54,-1,45
Queen of S't,5758,6,10,12,14,41,47,-6,42
Raith,5758,7,11,9,16,35,46,-11,42
Dunfermline,5758,8,9,13,14,47,50,-3,40
St Mirren,5758,9,8,11,17,38,59,-21,35
Ayr,5758,10,6,13,17,30,58,-28,31
Hibernian,5759,1,20,11,5,51,22,29,71
Morton,5759,2,16,12,8,53,38,15,60
Falkirk,5759,3,16,11,9,59,41,18,59
Dundee Utd,5759,4,14,10,12,55,47,8,52
Raith,5759,5,12,9,15,36,47,-11,45
Dumbarton,5759,6,11,11,14,51,61,-10,44
Ayr,5759,7,11,11,14,41,58,-17,44
Dunfermline,5759,8,9,13,14,45,51,-6,40
Queen of S't,5759,9,9,9,18,43,55,-12,36
St Mirren,5759,10,9,9,18,39,53,-14,36
Hibernian,5760,1,19,12,5,56,29,27,69
Morton,5760,2,19,10,7,58,35,23,67
Dundee Utd,5760,3,18,9,9,58,40,18,63
Falkirk,5760,4,14,9,13,55,45,10,51
Queen of S't,5760,5,11,10,15,46,55,-9,43
Raith,5760,6,11,8,17,36,47,-11,41
Dumbarton,5760,7,10,11,15,49,61,-12,41
Ayr,5760,8,9,12,15,36,55,-19,39
Dunfermline,5760,9,9,11,16,41,51,-10,38
St Mirren,5760,10,9,10,17,42,59,-17,37
Hibernian,5761,1,20,10,6,56,28,28,70
Morton,5761,2,18,12,6,58,36,22,66
Falkirk,5761,3,18,10,8,63,35,28,64
Dundee Utd,5761,4,14,10,12,50,47,3,52
Dunfermline,5761,5,10,13,13,46,50,-4,43
Raith,5761,6,11,9,16,35,46,-11,42
Queen of S't,5761,7,10,10,16,44,54,-10,40
Dumbarton,5761,8,9,11,16,46,64,-18,38
Ayr,5761,9,9,10,17,36,58,-22,37
St Mirren,5761,10,8,11,17,39,55,-16,35
Hibernian,5762,1,21,11,4,51,20,31,74
Morton,5762,2,16,11,9,46,36,10,59
Dundee Utd,5762,3,16,10,10,53,40,13,58
Falkirk,5762,4,14,11,11,55,42,13,53
Dunfermline,5762,5,12,12,12,48,45,3,48
Queen of S't,5762,6,12,9,15,48,53,-5,45
Raith,5762,7,11,9,16,35,49,-14,42
Dumbarton,5762,8,9,11,16,48,59,-11,38
St Mirren,5762,9,9,10,17,39,54,-15,37
Ayr,5762,10,7,12,17,32,57,-25,33
Hibernian,5763,1,21,11,4,63,28,35,74
Morton,5763,2,18,9,9,49,36,13,63
Falkirk,5763,3,17,9,10,59,42,17,60
Dundee Utd,5763,4,16,9,11,53,42,11,57
Queen of S't,5763,5,12,9,15,47,50,-3,45
Ayr,5763,6,10,11,15,41,56,-15,41
Dunfermline,5763,7,9,13,14,44,51,-7,40
St Mirren,5763,8,9,10,17,42,57,-15,37
Dumbarton,5763,9,8,13,15,48,64,-16,37
Raith,5763,10,9,8,19,33,53,-20,35
Hibernian,5764,1,18,13,5,57,29,28,67
Dundee Utd,5764,2,17,10,9,53,38,15,61
Morton,5764,3,16,11,9,47,41,6,59
Falkirk,5764,4,13,12,11,56,48,8,51
Queen of S't,5764,5,11,12,13,47,48,-1,45
Raith,5764,6,11,11,14,39,46,-7,44
Dumbarton,5764,7,10,11,15,49,61,-12,41
Dunfermline,5764,8,9,12,15,42,47,-5,39
Ayr,5764,9,8,15,13,41,57,-16,39
St Mirren,5764,10,8,11,17,41,57,-16,35
Hibernian,5765,1,18,14,4,49,23,26,68
Falkirk,5765,2,17,10,9,59,38,21,61
Morton,5765,3,16,13,7,49,37,12,61
Dundee Utd,5765,4,14,9,13,51,44,7,51
Queen of S't,5765,5,13,10,13,48,49,-1,49
Dunfermline,5765,6,9,15,12,44,47,-3,42
Dumbarton,5765,7,10,10,16,48,60,-12,40
Raith,5765,8,10,9,17,36,48,-12,39
Ayr,5765,9,9,11,16,39,62,-23,38
St Mirren,5765,10,8,11,17,45,60,-15,35
Hibernian,5766,1,20,11,5,52,23,29,71
Morton,5766,2,15,13,8,44,36,8,58
Dundee Utd,5766,3,16,9,11,58,42,16,57
Falkirk,5766,4,15,11,10,55,41,14,56
Queen of S't,5766,5,12,10,14,47,51,-4,46
Dunfermline,5766,6,10,13,13,44,51,-7,43
Raith,5766,7,11,10,15,37,48,-11,43
Dumbarton,5766,8,9,11,16,46,56,-10,38
Ayr,5766,9,9,11,16,33,54,-21,38
St Mirren,5766,10,8,11,17,41,55,-14,35
Hibernian,5767,1,18,13,5,53,26,27,67
Dundee Utd,5767,2,17,10,9,51,41,10,61
Falkirk,5767,3,16,12,8,60,38,22,60
Morton,5767,4,16,12,8,55,41,14,60
Queen of S't,5767,5,11,10,15,46,52,-6,43
Dunfermline,5767,6,10,12,14,46,49,-3,42
Dumbarton,5767,7,9,13,14,49,60,-11,40
St Mirren,5767,8,9,11,16,43,57,-14,38
Ayr,5767,9,7,15,14,37,54,-17,36
Raith,5767,10,8,10,18,35,57,-22,34
Hibernian,5768,1,19,11,6,50,23,27,68
Morton,5768,2,18,10,8,56,39,17,64
Falkirk,5768,3,16,12,8,59,43,16,60
Dundee Utd,5768,4,14,12,10,51,45,6,54
Queen of S't,5768,5,13,11,12,52,52,0,50
Dunfermline,5768,6,10,13,13,47,46,1,43
Raith,5768,7,10,10,16,36,50,-14,40
Ayr,5768,8,10,10,16,36,52,-16,40
Dumbarton,5768,9,9,12,15,50,60,-10,39
St Mirren,5768,10,6,9,21,37,64,-27,27
Hibernian,5769,1,18,13,5,51,27,24,67
Dundee Utd,5769,2,18,8,10,57,37,20,62
Falkirk,5769,3,14,13,9,55,41,14,55
Morton,5769,4,14,11,11,43,42,1,53
Dunfermline,5769,5,12,14,10,51,45,6,50
Raith,5769,6,12,8,16,42,47,-5,44
Dumbarton,5769,7,10,12,14,53,62,-9,42
Ayr,5769,8,10,11,15,39,56,-17,41
Queen of S't,5769,9,9,9,18,41,54,-13,36
St Mirren,5769,10,8,11,17,41,62,-21,35
Hibernian,5770,1,17,12,7,50,25,25,63
Morton,5770,2,18,9,9,51,41,10,63
Dundee Utd,5770,3,17,9,10,54,42,12,60
Falkirk,5770,4,14,11,11,55,44,11,53
Queen of S't,5770,5,12,10,14,46,51,-5,46
Dumbarton,5770,6,10,13,13,51,53,-2,43
Dunfermline,5770,7,10,12,14,45,50,-5,42
St Mirren,5770,8,10,11,15,40,52,-12,41
Raith,5770,9,10,9,17,33,49,-16,39
Ayr,5770,10,8,12,16,40,58,-18,36
Hibernian,5771,1,20,11,5,56,25,31,71
Morton,5771,2,19,12,5,49,30,19,69
Falkirk,5771,3,17,11,8,63,43,20,62
Dundee Utd,5771,4,15,11,10,50,39,11,56
Queen of S't,5771,5,12,9,15,45,48,-3,45
Dunfermline,5771,6,8,15,13,41,46,-5,39
Ayr,5771,7,9,12,15,31,50,-19,39
Dumbarton,5771,8,7,14,15,44,60,-16,35
Raith,5771,9,9,8,19,33,50,-17,35
St Mirren,5771,10,8,9,19,37,58,-21,33
Hibernian,5772,1,18,12,6,53,30,23,66
Falkirk,5772,2,17,10,9,61,44,17,61
Morton,5772,3,16,12,8,48,40,8,60
Dundee Utd,5772,4,14,12,10,49,39,10,54
Dunfermline,5772,5,12,12,12,51,48,3,48
Dumbarton,5772,6,10,12,14,53,60,-7,42
Queen of S't,5772,7,10,11,15,43,49,-6,41
Raith,5772,8,10,9,17,35,49,-14,39
St Mirren,5772,9,9,11,16,44,56,-12,38
Ayr,5772,10,7,13,16,32,54,-22,34
Hibernian,5773,1,20,11,5,65,31,34,71
Dundee Utd,5773,2,18,9,9,58,37,21,63
Morton,5773,3,17,11,8,47,33,14,62
Falkirk,5773,4,17,10,9,57,42,15,61
Queen of S't,5773,5,13,8,15,45,51,-6,47
Dumbarton,5773,6,10,11,15,53,62,-9,41
St Mirren,5773,7,10,10,16,43,54,-11,40
Dunfermline,5773,8,8,12,16,44,54,-10,36
Raith,5773,9,9,8,19,37,57,-20,35
Ayr,5773,10,7,12,17,32,60,-28,33
Hibernian,5774,1,18,12,6,54,28,26,66
Morton,5774,2,18,11,7,52,34,18,65
Falkirk,5774,3,17,9,10,59,40,19,60
Dundee Utd,5774,4,14,9,13,48,46,2,51
Dumbarton,5774,5,12,11,13,52,58,-6,47
Dunfermline,5774,6,10,14,12,45,48,-3,44
Queen of S't,5774,7,11,11,14,45,49,-4,44
St Mirren,5774,8,9,10,17,39,53,-14,37
Raith,5774,9,9,10,17,31,47,-16,37
Ayr,5774,10,7,13,16,34,56,-22,34
Hibernian,5775,1,18,14,4,55,24,31,68
Morton,5775,2,18,10,8,57,43,14,64
Falkirk,5775,3,17,9,10,64,44,20,60
Dundee Utd,5775,4,16,8,12,51,43,8,56
Queen of S't,5775,5,11,11,14,45,51,-6,44
Ayr,5775,6,10,14,12,39,50,-11,44
Dunfermline,5775,7,10,13,13,47,49,-2,43
Raith,5775,8,9,10,17,37,55,-18,37
Dumbarton,5775,9,8,11,17,43,58,-15,35
St Mirren,5775,10,8,10,18,37,58,-21,34
Hibernian,5776,1,18,12,6,53,25,28,66
Dundee Utd,5776,2,19,8,9,59,40,19,65
Morton,5776,3,16,14,6,51,36,15,62
Falkirk,5776,4,16,11,9,57,41,16,59
Queen of S't,5776,5,11,8,17,42,53,-11,41
Dunfermline,5776,6,9,13,14,44,50,-6,40
St Mirren,5776,7,10,10,16,44,57,-13,40
Raith,5776,8,10,9,17,36,49,-13,39
Dumbarton,5776,9,9,11,16,46,59,-13,38
Ayr,5776,10,9,10,17,32,54,-22,37
Hibernian,5777,1,20,12,4,57,23,34,72
Morton,5777,2,17,11,8,55,37,18,62
Dundee Utd,5777,3,17,9,10,53,43,10,60
Falkirk,5777,4,16,10,10,55,38,17,58
Dunfermline,5777,5,11,13,12,49,48,1,46
Queen of S't,5777,6,10,11,15,46,54,-8,41
Ayr,5777,7,9,11,16,35,59,-24,38
Dumbarton,5777,8,9,10,17,47,60,-13,37
St Mirren,5777,9,9,10,17,40,56,-16,37
Raith,5777,10,8,11,17,32,51,-19,35
Hibernian,5778,1,21,11,4,67,30,37,74
Morton,5778,2,18,11,7,61,41,20,65
Dundee Utd,5778,3,17,9,10,57,44,13,60
Falkirk,5778,4,15,12,9,55,40,15,57
Dunfermline,5778,5,10,12,14,52,53,-1,42
Raith,5778,6,11,9,16,37,51,-14,42
Queen of S't,5778,7,10,11,15,45,57,-12,41
Ayr,5778,8,9,11,16,34,52,-18,38
Dumbarton,5778,9,7,12,17,47,65,-18,33
St Mirren,5778,10,7,12,17,40,62,-22,33
Morton,5779,1,18,11,7,51,37,14,65
Hibernian,5779,2,17,13,6,57,31,26,64
Dundee Utd,5779,3,17,8,11,54,37,17,59
Falkirk,5779,4,14,11,11,59,45,14,53
Queen of S't,5779,5,13,10,13,49,51,-2,49
Dunfermline,5779,6,10,14,12,47,49,-2,44
Raith,5779,7,10,10,16,37,51,-14,40
Dumbarton,5779,8,9,11,16,48,59,-11,38
Ayr,5779,9,8,14,14,35,56,-21,38
St Mirren,5779,10,8,10,18,38,59,-21,34
Hibernian,5780,1,19,12,5,51,24,27,69
Morton,5780,2,15,13,8,53,42,11,58
Dundee Utd,5780,3,14,13,9,47,37,10,55
Falkirk,5780,4,13,11,12,53,43,10,50
Dunfermline,5780,5,12,12,12,49,47,2,48
Queen of S't,5780,6,13,8,15,45,51,-6,47
Raith,5780,7,13,8,15,38,46,-8,47
Dumbarton,5780,8,10,11,15,50,62,-12,41
St Mirren,5780,9,8,11,17,40,52,-12,35
Ayr,5780,10,7,13,16,33,55,-22,34
Hibernian,5781,1,18,12,6,59,33,26,66
Dundee Utd,5781,2,18,8,10,55,42,13,62
Morton,5781,3,17,9,10,53,43,10,60
Falkirk,5781,4,14,11,11,59,48,11,53
Dunfermline,5781,5,13,11,12,48,44,4,50
Queen of S't,5781,6,12,9,15,51,54,-3,45
Raith,5781,7,11,12,13,37,45,-8,45
St Mirren,5781,8,9,10,17,43,54,-11,37
Dumbarton,5781,9,9,10,17,48,66,-18,37
Ayr,5781,10,7,12,17,36,60,-24,33
Hibernian,5782,1,19,13,4,58,25,33,70
Morton,5782,2,17,11,8,52,39,13,62
Falkirk,5782,3,16,12,8,63,43,20,60
Dundee Utd,5782,4,15,11,10,53,41,12,56
Dunfermline,5782,5,10,12,14,48,54,-6,42
Ayr,5782,6,10,12,14,39,53,-14,42
Queen of S't,5782,7,11,8,17,46,57,-11,41
Raith,5782,8,10,10,16,36,51,-15,40
Dumbarton,5782,9,8,13,15,47,61,-14,37
St Mirren,5782,10,7,12,17,37,55,-18,33
Hibernian,5783,1,17,14,5,54,29,25,65
Dundee Utd,5783,2,18,10,8,59,38,21,64
Falkirk,5783,3,16,11,9,58,40,18,59
Morton,5783,4,13,10,13,44,44,0,49
Queen of S't,5783,5,12,11,13,47,50,-3,47
Dunfermline,5783,6,11,12,13,46,46,0,45
Raith,5783,7,11,11,14,37,48,-11,44
Dumbarton,5783,8,10,11,15,46,57,-11,41
Ayr,5783,9,8,13,15,37,57,-20,37
St Mirren,5783,10,8,9,19,42,61,-19,33
Hibernian,5784,1,19,12,5,54,24,30,69
Morton,5784,2,19,10,7,52,34,18,67
Falkirk,5784,3,16,10,10,59,44,15,58
Dundee Utd,5784,4,16,10,10,55,40,15,58
Dunfermline,5784,5,12,13,11,47,44,3,49
Queen of S't,5784,6,10,10,16,41,49,-8,40
Raith,5784,7,10,9,17,34,52,-18,39
St Mirren,5784,8,9,11,16,42,55,-13,38
Ayr,5784,9,8,11,17,37,62,-25,35
Dumbarton,5784,10,8,10,18,46,63,-17,34
Hibernian,5785,1,16,12,8,51,32,19,60
Falkirk,5785,2,16,12,8,59,42,17,60
Morton,5785,3,16,11,9,52,41,11,59
Dundee Utd,5785,4,16,8,12,54,45,9,56
Dumbarton,5785,5,12,11,13,50,54,-4,47
Queen of S't,5785,6,11,12,13,47,49,-2,45
Raith,5785,7,12,9,15,43,53,-10,45
Dunfermline,5785,8,10,14,12,46,43,3,44
St Mirren,5785,9,9,10,17,37,55,-18,37
Ayr,5785,10,7,11,18,33,58,-25,32
Hibernian,5786,1,17,15,4,52,26,26,66
Morton,5786,2,16,13,7,53,39,14,61
Dundee Utd,5786,3,17,9,10,55,41,14,60
Falkirk,5786,4,14,11,11,54,43,11,53
Queen of S't,5786,5,14,8,14,49,50,-1,50
Dunfermline,5786,6,11,12,13,50,51,-1,45
Raith,5786,7,11,10,15,39,52,-13,43
Dumbarton,5786,8,9,12,15,49,63,-14,39
Ayr,5786,9,7,13,16,33,54,-21,34
St Mirren,5786,10,7,11,18,39,54,-15,32
Morton,5787,1,19,9,8,59,39,20,66
Hibernian,5787,2,18,11,7,56,29,27,65
Falkirk,5787,3,16,10,10,59,39,20,58
Dundee Utd,5787,4,14,9,13,48,47,1,51
Dunfermline,5787,5,11,13,12,53,51,2,46
St Mirren,5787,6,12,10,14,50,52,-2,46
Ayr,5787,7,12,10,14,43,57,-14,46
Raith,5787,8,11,8,17,38,53,-15,41
Queen of S't,5787,9,10,8,18,39,57,-18,38
Dumbarton,5787,10,8,10,18,42,63,-21,34
Hibernian,5788,1,22,10,4,61,22,39,76
Dundee Utd,5788,2,17,9,10,51,40,11,60
Morton,5788,3,16,10,10,49,41,8,58
Falkirk,5788,4,15,11,10,56,42,14,56
Queen of S't,5788,5,15,9,12,49,45,4,54
Dumbarton,5788,6,11,10,15,53,55,-2,43
Dunfermline,5788,7,9,12,15,44,51,-7,39
Raith,5788,8,9,11,16,38,59,-21,38
St Mirren,5788,9,8,10,18,37,56,-19,34
Ayr,5788,10,7,10,19,33,60,-27,31
Hibernian,5789,1,20,13,3,57,26,31,73
Morton,5789,2,16,11,9,48,37,11,59
Dundee Utd,5789,3,16,10,10,52,38,14,58
Falkirk,5789,4,16,9,11,62,44,18,57
Queen of S't,5789,5,12,10,14,45,50,-5,46
Raith,5789,6,11,9,16,35,50,-15,42
Dunfermline,5789,7,8,14,14,44,50,-6,38
Dumbarton,5789,8,9,11,16,48,58,-10,38
St Mirren,5789,9,9,11,16,39,53,-14,38
Ayr,5789,10,8,12,16,31,55,-24,36
Hibernian,5790,1,18,14,4,52,24,28,68
Falkirk,5790,2,16,10,10,57,41,16,58
Morton,5790,3,14,13,9,50,37,13,55
Dundee Utd,5790,4,12,14,10,45,43,2,50
St Mirren,5790,5,12,10,14,47,50,-3,46
Queen of S't,5790,6,11,12,13,46,49,-3,45
Dunfermline,5790,7,9,15,12,44,46,-2,42
Dumbarton,5790,8,9,12,15,48,56,-8,39
Raith,5790,9,10,9,17,35,58,-23,39
Ayr,5790,10,8,13,15,34,54,-20,37
Hibernian,5791,1,19,11,6,51,24,27,68
Morton,5791,2,17,12,7,50,35,15,63
Falkirk,5791,3,16,11,9,56,39,17,59
Dundee Utd,5791,4,14,12,10,47,41,6,54
Dunfermline,5791,5,10,14,12,48,48,0,44
Queen of S't,5791,6,10,12,14,48,54,-6,42
Ayr,5791,7,10,10,16,42,56,-14,40
St Mirren,5791,8,10,9,17,39,53,-14,39
Raith,5791,9,10,9,17,36,53,-17,39
Dumbarton,5791,10,8,12,16,47,61,-14,36
Hibernian,5792,1,20,13,3,58,27,31,73
Dundee Utd,5792,2,16,10,10,52,39,13,58
Morton,5792,3,16,10,10,54,42,12,58
Falkirk,5792,4,14,13,9,57,44,13,55
Dunfermline,5792,5,11,12,13,53,53,0,45
Queen of S't,5792,6,12,8,16,43,50,-7,44
Raith,5792,7,10,11,15,35,49,-14,41
Dumbarton,5792,8,9,12,15,52,60,-8,39
St Mirren,5792,9,8,12,16,41,57,-16,36
Ayr,5792,10,8,11,17,34,58,-24,35
Hibernian,5793,1,19,14,3,56,24,32,71
Morton,5793,2,18,12,6,54,38,16,66
Dundee Utd,5793,3,17,9,10,50,38,12,60
Falkirk,5793,4,16,10,10,57,38,19,58
Dumbarton,5793,5,11,11,14,50,55,-5,44
Dunfermline,5793,6,9,14,13,46,48,-2,41
Queen of S't,5793,7,10,10,16,46,59,-13,40
Raith,5793,8,9,11,16,36,50,-14,38
Ayr,5793,9,8,11,17,32,55,-23,35
St Mirren,5793,10,7,10,19,36,58,-22,31
Hibernian,5794,1,19,11,6,57,27,30,68
Morton,5794,2,16,14,6,54,41,13,62
Falkirk,5794,3,16,12,8,60,38,22,60
Dundee Utd,5794,4,14,12,10,51,43,8,54
Queen of S't,5794,5,13,9,14,48,48,0,48
Dunfermline,5794,6,11,13,12,46,46,0,46
Ayr,5794,7,9,11,16,39,56,-17,38
Raith,5794,8,9,10,17,31,49,-18,37
St Mirren,5794,9,8,11,17,41,58,-17,35
Dumbarton,5794,10,7,13,16,48,69,-21,34
Hibernian,5795,1,20,11,5,52,23,29,71
Morton,5795,2,16,11,9,49,36,13,59
Falkirk,5795,3,15,12,9,63,43,20,57
Dundee Utd,5795,4,16,9,11,55,43,12,57
Queen of S't,5795,5,12,10,14,51,55,-4,46
Dunfermline,5795,6,9,15,12,47,51,-4,42
Raith,5795,7,11,9,16,39,53,-14,42
Dumbarton,5795,8,10,10,16,49,61,-12,40
St Mirren,5795,9,8,12,16,39,57,-18,36
Ayr,5795,10,8,11,17,32,54,-22,35
Hibernian,5796,1,19,12,5,55,26,29,69
Dundee Utd,5796,2,18,10,8,61,37,24,64
Falkirk,5796,3,18,9,9,55,37,18,63
Morton,5796,4,17,10,9,48,38,10,61
Queen of S't,5796,5,11,9,16,43,50,-7,42
Dunfermline,5796,6,10,12,14,44,54,-10,42
Raith,5796,7,10,10,16,36,49,-13,40
Ayr,5796,8,9,12,15,32,53,-21,39
St Mirren,5796,9,9,10,17,41,54,-13,37
Dumbarton,5796,10,7,10,19,42,59,-17,31
Hibernian,5797,1,18,11,7,56,32,24,65
Falkirk,5797,2,18,9,9,63,41,22,63
Morton,5797,3,17,11,8,55,39,16,62
Dundee Utd,5797,4,14,11,11,47,41,6,53
Queen of S't,5797,5,13,8,15,43,51,-8,47
Dunfermline,5797,6,9,14,13,45,50,-5,41
Dumbarton,5797,7,9,14,13,51,57,-6,41
Ayr,5797,8,9,12,15,35,56,-21,39
Raith,5797,9,9,10,17,37,52,-15,37
St Mirren,5797,10,8,12,16,43,56,-13,36
Morton,5798,1,19,11,6,54,32,22,68
Hibernian,5798,2,16,15,5,49,25,24,63
Dundee Utd,5798,3,17,9,10,51,36,15,60
Falkirk,5798,4,14,12,10,57,45,12,54
Queen of S't,5798,5,12,11,13,48,48,0,47
Dunfermline,5798,6,12,11,13,47,51,-4,47
Dumbarton,5798,7,9,12,15,46,57,-11,39
Raith,5798,8,9,11,16,35,50,-15,38
St Mirren,5798,9,8,10,18,38,55,-17,34
Ayr,5798,10,7,12,17,30,56,-26,33
Hibernian,5799,1,22,11,3,60,22,38,77
Morton,5799,2,18,11,7,52,37,15,65
Falkirk,5799,3,15,12,9,58,40,18,57
Dundee Utd,5799,4,14,10,12,41,40,1,52
Queen of S't,5799,5,13,9,14,45,48,-3,48
St Mirren,5799,6,10,11,15,43,52,-9,41
Dunfermline,5799,7,9,13,14,42,50,-8,40
Raith,5799,8,9,10,17,32,48,-16,37
Ayr,5799,9,8,11,17,33,53,-20,35
Dumbarton,5799,10,8,10,18,46,62,-16,34
Hibernian,5800,1,20,12,4,61,23,38,72
Falkirk,5800,2,17,10,9,60,41,19,61
Morton,5800,3,16,13,7,53,34,19,61
Dundee Utd,5800,4,17,9,10,55,41,14,60
Dunfermline,5800,5,10,13,13,44,49,-5,43
Dumbarton,5800,6,10,11,15,52,59,-7,41
Raith,5800,7,10,10,16,34,54,-20,40
Queen of S't,5800,8,9,10,17,44,54,-10,37
St Mirren,5800,9,9,9,18,39,60,-21,36
Ayr,5800,10,8,11,17,35,62,-27,35
Hibernian,5801,1,21,11,4,56,24,32,74
Dundee Utd,5801,2,18,9,9,57,41,16,63
Falkirk,5801,3,17,10,9,59,40,19,61
Morton,5801,4,16,11,9,55,43,12,59
Queen of S't,5801,5,12,10,14,49,53,-4,46
Dunfermline,5801,6,10,12,14,48,52,-4,42
Dumbarton,5801,7,9,11,16,49,56,-7,38
Raith,5801,8,9,10,17,34,52,-18,37
Ayr,5801,9,6,15,15,32,57,-25,33
St Mirren,5801,10,7,11,18,37,58,-21,32
Hibernian,5802,1,18,11,7,56,28,28,65
Falkirk,5802,2,16,12,8,61,39,22,60
Dundee Utd,5802,3,17,9,10,54,40,14,60
Morton,5802,4,17,9,10,49,40,9,60
Queen of S't,5802,5,14,8,14,48,51,-3,50
Dunfermline,5802,6,10,14,12,48,48,0,44
St Mirren,5802,7,9,11,16,41,58,-17,38
Dumbarton,5802,8,9,10,17,46,60,-14,37
Raith,5802,9,9,10,17,35,52,-17,37
Ayr,5802,10,9,10,17,35,57,-22,37
Hibernian,5803,1,20,12,4,55,22,33,72
Morton,5803,2,19,11,6,52,34,18,68
Dundee Utd,5803,3,17,9,10,57,40,17,60
Falkirk,5803,4,16,9,11,61,45,16,57
Dunfermline,5803,5,11,14,11,53,47,6,47
Queen of S't,5803,6,11,8,17,42,56,-14,41
Raith,5803,7,10,9,17,36,51,-15,39
St Mirren,5803,8,9,10,17,43,60,-17,37
Ayr,5803,9,8,12,16,32,56,-24,36
Dumbarton,5803,10,7,10,19,45,65,-20,31
Hibernian,5804,1,18,13,5,56,29,27,67
Morton,5804,2,17,13,6,52,35,17,64
Falkirk,5804,3,15,12,9,59,43,16,57
Dundee Utd,5804,4,15,11,10,50,40,10,56
Queen of S't,5804,5,14,8,14,50,49,1,50
Dunfermline,5804,6,9,12,15,48,53,-5,39
St Mirren,5804,7,9,12,15,44,59,-15,39
Dumbarton,5804,8,9,11,16,43,54,-11,38
Raith,5804,9,9,10,17,36,54,-18,37
Ayr,5804,10,6,16,14,33,55,-22,34
Hibernian,5805,1,20,11,5,62,25,37,71
Morton,5805,2,18,11,7,50,33,17,65
Dundee Utd,5805,3,17,9,10,55,37,18,60
Falkirk,5805,4,16,11,9,60,43,17,59
Queen of S't,5805,5,14,8,14,49,46,3,50
Dunfermline,5805,6,10,11,15,48,54,-6,41
St Mirren,5805,7,9,12,15,42,57,-15,39
Raith,5805,8,9,9,18,34,54,-20,36
Dumbarton,5805,9,8,11,17,47,66,-19,35
Ayr,5805,10,7,11,18,30,62,-32,32
Hibernian,5806,1,17,13,6,50,29,21,64
Morton,5806,2,17,12,7,54,33,21,63
Falkirk,5806,3,17,10,9,60,41,19,61
Dundee Utd,5806,4,14,12,10,45,43,2,54
Dunfermline,5806,5,11,14,11,48,45,3,47
Queen of S't,5806,6,11,10,15,45,49,-4,43
Raith,5806,7,10,11,15,35,48,-13,41
Ayr,5806,8,8,16,12,36,50,-14,40
St Mirren,5806,9,7,12,17,37,53,-16,33
Dumbarton,5806,10,7,12,17,45,64,-19,33
Hibernian,5807,1,19,14,3,57,24,33,71
Morton,5807,2,17,10,9,51,40,11,61
Falkirk,5807,3,16,12,8,56,36,20,60
Dundee Utd,5807,4,15,11,10,48,39,9,56
Queen of S't,5807,5,13,10,13,49,46,3,49
Dumbarton,5807,6,10,10,16,53,68,-15,40
Ayr,5807,7,9,12,15,40,60,-20,39
Dunfermline,5807,8,9,11,16,45,53,-8,38
Raith,5807,9,9,10,17,35,51,-16,37
St Mirren,5807,10,8,10,18,44,61,-17,34
Falkirk,5808,1,19,9,8,66,44,22,66
Dundee Utd,5808,2,18,10,8,62,40,22,64
Hibernian,5808,3,17,12,7,52,28,24,63
Morton,5808,4,16,10,10,50,41,9,58
Raith,5808,5,13,8,15,40,49,-9,47
Dunfermline,5808,6,10,11,15,46,53,-7,41
Dumbarton,5808,7,10,10,16,53,62,-9,40
Ayr,5808,8,8,14,14,37,54,-17,38
Queen of S't,5808,9,10,8,18,41,59,-18,38
St Mirren,5808,10,7,12,17,39,56,-17,33
Hibernian,5809,1,20,12,4,55,24,31,72
Dundee Utd,5809,2,18,9,9,53,39,14,63
Falkirk,5809,3,16,9,11,59,44,15,57
Morton,5809,4,14,13,9,46,38,8,55
Dunfermline,5809,5,13,11,12,49,47,2,50
Queen of S't,5809,6,10,10,16,45,53,-8,40
Dumbarton,5809,7,10,10,16,48,59,-11,40
St Mirren,5809,8,9,10,17,46,59,-13,37
Ayr,5809,9,8,13,15,34,53,-19,37
Raith,5809,10,9,9,18,32,51,-19,36
Hibernian,5810,1,20,13,3,60,23,37,73
Morton,5810,2,17,10,9,57,44,13,61
Falkirk,5810,3,14,11,11,53,40,13,53
Dundee Utd,5810,4,14,10,12,49,41,8,52
Queen of S't,5810,5,13,11,12,43,41,2,50
Dunfermline,5810,6,11,13,12,45,48,-3,46
Raith,5810,7,11,8,17,36,51,-15,41
Ayr,5810,8,9,11,16,32,55,-23,38
St Mirren,5810,9,9,10,17,38,54,-16,37
Dumbarton,5810,10,8,11,17,44,60,-16,35
Hibernian,5811,1,20,12,4,54,25,29,72
Morton,5811,2,17,11,8,51,39,12,62
Dundee Utd,5811,3,17,10,9,52,40,12,61
Falkirk,5811,4,15,10,11,57,44,13,55
Queen of S't,5811,5,12,11,13,45,48,-3,47
Raith,5811,6,11,10,15,39,47,-8,43
Ayr,5811,7,8,13,15,36,56,-20,37
Dunfermline,5811,8,7,15,14,43,50,-7,36
St Mirren,5811,9,9,9,18,41,57,-16,36
Dumbarton,5811,10,8,11,17,48,60,-12,35
Hibernian,5812,1,20,13,3,61,25,36,73
Morton,5812,2,16,12,8,50,37,13,60
Falkirk,5812,3,15,12,9,59,43,16,57
Dundee Utd,5812,4,14,12,10,51,44,7,54
Queen of S't,5812,5,11,12,13,46,50,-4,45
Dunfermline,5812,6,9,13,14,44,52,-8,40
Raith,5812,7,10,10,16,34,49,-15,40
Ayr,5812,8,9,13,14,39,55,-16,40
St Mirren,5812,9,8,12,16,43,57,-14,36
Dumbarton,5812,10,7,13,16,47,62,-15,34
Hibernian,5813,1,22,10,4,62,27,35,76
Morton,5813,2,17,11,8,48,34,14,62
Falkirk,5813,3,16,10,10,64,41,23,58
Dundee Utd,5813,4,16,9,11,52,39,13,57
Queen of S't,5813,5,12,9,15,42,47,-5,45
Dumbarton,5813,6,11,11,14,49,57,-8,44
Raith,5813,7,10,10,16,36,50,-14,40
Dunfermline,5813,8,9,11,16,43,53,-10,38
Ayr,5813,9,8,11,17,33,60,-27,35
St Mirren,5813,10,7,12,17,36,57,-21,33
Hibernian,5814,1,19,10,7,55,29,26,67
Morton,5814,2,17,11,8,49,40,9,62
Falkirk,5814,3,17,9,10,61,39,22,60
Dundee Utd,5814,4,16,8,12,55,41,14,56
Queen of S't,5814,5,14,9,13,48,49,-1,51
Dumbarton,5814,6,11,11,14,50,56,-6,44
Raith,5814,7,12,8,16,37,48,-11,44
Dunfermline,5814,8,9,14,13,46,50,-4,41
St Mirren,5814,9,9,9,18,37,51,-14,36
Ayr,5814,10,6,11,19,27,62,-35,29
Hibernian,5815,1,19,12,5,56,27,29,69
Falkirk,5815,2,16,11,9,59,41,18,59
Morton,5815,3,16,11,9,47,40,7,59
Dundee Utd,5815,4,14,9,13,51,46,5,51
Ayr,5815,5,11,11,14,38,53,-15,44
Queen of S't,5815,6,11,10,15,45,51,-6,43
Dunfermline,5815,7,10,12,14,47,47,0,42
St Mirren,5815,8,11,9,16,42,53,-11,42
Raith,5815,9,10,10,16,33,49,-16,40
Dumbarton,5815,10,9,11,16,45,56,-11,38
Hibernian,5816,1,21,12,3,59,20,39,75
Morton,5816,2,18,10,8,52,38,14,64
Dundee Utd,5816,3,16,8,12,50,42,8,56
Falkirk,5816,4,13,13,10,55,49,6,52
Queen of S't,5816,5,12,11,13,42,44,-2,47
Dumbarton,5816,6,9,13,14,45,53,-8,40
Ayr,5816,7,9,13,14,37,53,-16,40
Dunfermline,5816,8,8,13,15,40,48,-8,37
Raith,5816,9,9,10,17,34,50,-16,37
St Mirren,5816,10,8,11,17,40,57,-17,35
Morton,5817,1,18,11,7,51,36,15,65
Hibernian,5817,2,17,13,6,47,26,21,64
Falkirk,5817,3,17,11,8,58,38,20,62
Dundee Utd,5817,4,15,10,11,54,44,10,55
Queen of S't,5817,5,13,9,14,49,51,-2,48
Dumbarton,5817,6,10,11,15,52,62,-10,41
Dunfermline,5817,7,9,13,14,49,49,0,40
St Mirren,5817,8,9,12,15,40,51,-11,39
Raith,5817,9,8,12,16,32,50,-18,36
Ayr,5817,10,7,12,17,34,59,-25,33
Hibernian,5818,1,19,13,4,57,29,28,70
Falkirk,5818,2,18,10,8,61,38,23,64
Morton,5818,3,15,14,7,48,37,11,59
Dundee Utd,5818,4,15,10,11,51,46,5,55
Queen of S't,5818,5,12,9,15,46,49,-3,45
Dunfermline,5818,6,10,13,13,48,49,-1,43
Dumbarton,5818,7,10,11,15,49,56,-7,41
St Mirren,5818,8,8,12,16,40,55,-15,36
Raith,5818,9,8,11,17,34,53,-19,35
Ayr,5818,10,6,15,15,33,55,-22,33
Hibernian,5819,1,18,14,4,55,28,27,68
Morton,5819,2,17,12,7,52,36,16,63
Falkirk,5819,3,16,11,9,56,40,16,59
Dundee Utd,5819,4,15,11,10,47,36,11,56
Queen of S't,5819,5,12,10,14,42,46,-4,46
Dunfermline,5819,6,9,14,13,42,47,-5,41
Ayr,5819,7,9,13,14,36,55,-19,40
Dumbarton,5819,8,9,11,16,46,56,-10,38
Raith,5819,9,8,13,15,32,46,-14,37
St Mirren,5819,10,7,11,18,37,55,-18,32
Hibernian,5820,1,20,12,4,60,29,31,72
Dundee Utd,5820,2,18,10,8,57,35,22,64
Falkirk,5820,3,17,10,9,57,41,16,61
Morton,5820,4,16,11,9,55,44,11,59
Dunfermline,5820,5,10,13,13,46,48,-2,43
Queen of S't,5820,6,11,9,16,44,54,-10,42
Dumbarton,5820,7,10,10,16,53,65,-12,40
Raith,5820,8,10,8,18,38,53,-15,38
St Mirren,5820,9,8,12,16,41,55,-14,36
Ayr,5820,10,7,11,18,33,60,-27,32
Hibernian,5821,1,20,13,3,56,23,33,73
Falkirk,5821,2,17,9,10,58,41,17,60
Morton,5821,3,15,12,9,47,37,10,57
Dundee Utd,5821,4,15,10,11,49,40,9,55
Queen of S't,5821,5,11,11,14,44,50,-6,44
Dumbarton,5821,6,10,12,14,50,56,-6,42
Dunfermline,5821,7,9,14,13,45,50,-5,41
Raith,5821,8,10,9,17,31,48,-17,39
Ayr,5821,9,8,13,15,34,54,-20,37
St Mirren,5821,10,8,11,17,39,54,-15,35
Hibernian,5822,1,20,12,4,56,25,31,72
Morton,5822,2,18,11,7,57,37,20,65
Falkirk,5822,3,15,12,9,56,39,17,57
Dundee Utd,5822,4,16,9,11,45,38,7,57
Queen of S't,5822,5,14,10,12,45,43,2,52
Dunfermline,5822,6,8,15,13,47,53,-6,39
Raith,5822,7,10,8,18,33,53,-20,38
Dumbarton,5822,8,8,13,15,44,56,-12,37
St Mirren,5822,9,9,9,18,39,53,-14,36
Ayr,5822,10,7,11,18,32,57,-25,32
Hibernian,5823,1,21,11,4,53,22,31,74
Falkirk,5823,2,19,9,8,61,35,26,66
Dundee Utd,5823,3,16,9,11,46,36,10,57
Morton,5823,4,14,11,11,47,43,4,53
Ayr,5823,5,11,11,14,37,51,-14,44
Dunfermline,5823,6,10,12,14,47,51,-4,42
Dumbarton,5823,7,9,12,15,48,59,-11,39
Raith,5823,8,10,9,17,33,51,-18,39
Queen of S't,5823,9,10,8,18,42,54,-12,38
St Mirren,5823,10,9,10,17,42,54,-12,37
Hibernian,5824,1,19,11,6,58,28,30,68
Morton,5824,2,18,11,7,55,40,15,65
Falkirk,5824,3,17,10,9,57,37,20,61
Dundee Utd,5824,4,17,10,9,48,36,12,61
Raith,5824,5,11,11,14,38,50,-12,44
Dunfermline,5824,6,10,11,15,50,51,-1,41
Queen of S't,5824,7,10,11,15,41,51,-10,41
Dumbarton,5824,8,9,13,14,48,57,-9,40
Ayr,5824,9,7,11,18,33,56,-23,32
St Mirren,5824,10,6,13,17,32,54,-22,31
Hibernian,5825,1,18,13,5,55,26,29,67
Morton,5825,2,18,11,7,53,34,19,65
Dundee Utd,5825,3,18,9,9,58,40,18,63
Falkirk,5825,4,15,9,12,54,46,8,54
Queen of S't,5825,5,13,10,13,50,50,0,49
Dunfermline,5825,6,9,15,12,47,50,-3,42
Ayr,5825,7,9,12,15,32,50,-18,39
Raith,5825,8,9,10,17,31,49,-18,37
Dumbarton,5825,9,8,11,17,49,66,-17,35
St Mirren,5825,10,8,10,18,38,56,-18,34
Hibernian,5826,1,19,13,4,61,26,35,70
Morton,5826,2,17,12,7,55,41,14,63
Falkirk,5826,3,15,11,10,60,43,17,56
Dundee Utd,5826,4,15,11,10,51,39,12,56
Queen of S't,5826,5,11,10,15,44,50,-6,43
Raith,5826,6,11,9,16,39,51,-12,42
Ayr,5826,7,10,12,14,36,57,-21,42
Dunfermline,5826,8,9,14,13,47,52,-5,41
St Mirren,5826,9,9,10,17,43,61,-18,37
Dumbarton,5826,10,7,12,17,48,64,-16,33
Hibernian,5827,1,21,12,3,63,26,37,75
Falkirk,5827,2,17,10,9,61,44,17,61
Dundee Utd,5827,3,15,12,9,51,36,15,57
Morton,5827,4,14,13,9,49,43,6,55
Queen of S't,5827,5,12,10,14,44,47,-3,46
Raith,5827,6,11,10,15,36,48,-12,43
Dumbarton,5827,7,10,11,15,47,53,-6,41
Dunfermline,5827,8,8,14,14,45,56,-11,38
St Mirren,5827,9,8,10,18,39,58,-19,34
Ayr,5827,10,7,12,17,31,55,-24,33
Hibernian,5828,1,18,12,6,61,29,32,66
Morton,5828,2,16,12,8,51,37,14,60
Falkirk,5828,3,15,12,9,59,40,19,57
Dundee Utd,5828,4,15,12,9,52,42,10,57
Queen of S't,5828,5,12,9,15,47,56,-9,45
Dunfermline,5828,6,10,14,12,44,48,-4,44
Raith,5828,7,10,11,15,37,50,-13,41
St Mirren,5828,8,9,13,14,41,52,-11,40
Dumbarton,5828,9,8,14,14,46,57,-11,38
Ayr,5828,10,7,11,18,32,59,-27,32
Hibernian,5829,1,20,12,4,58,27,31,72
Morton,5829,2,18,10,8,54,36,18,64
Falkirk,5829,3,16,10,10,59,43,16,58
Dundee Utd,5829,4,12,11,13,45,45,0,47
Dunfermline,5829,5,10,14,12,45,48,-3,44
Queen of S't,5829,6,11,11,14,51,56,-5,44
Ayr,5829,7,9,14,13,45,57,-12,41
St Mirren,5829,8,10,10,16,42,54,-12,40
Raith,5829,9,10,9,17,35,49,-14,39
Dumbarton,5829,10,7,13,16,47,66,-19,34
Hibernian,5830,1,20,10,6,52,27,25,70
Dundee Utd,5830,2,18,9,9,59,42,17,63
Morton,5830,3,18,9,9,54,37,17,63
Falkirk,5830,4,15,11,10,59,47,12,56
Queen of S't,5830,5,12,9,15,46,53,-7,45
Dunfermline,5830,6,10,12,14,48,52,-4,42
Raith,5830,7,11,8,17,38,51,-13,41
Ayr,5830,8,10,10,16,40,53,-13,40
Dumbarton,5830,9,8,13,15,45,55,-10,37
St Mirren,5830,10,7,11,18,36,60,-24,32
Morton,5831,1,17,14,5,53,32,21,65
Hibernian,5831,2,16,13,7,50,29,21,61
Dundee Utd,5831,3,16,11,9,53,39,14,59
Falkirk,5831,4,14,14,8,56,40,16,56
Queen of S't,5831,5,12,10,14,47,50,-3,46
Dumbarton,5831,6,10,12,14,49,56,-7,42
Raith,5831,7,10,11,15,34,45,-11,41
Dunfermline,5831,8,8,15,13,38,43,-5,39
St Mirren,5831,9,9,12,15,41,55,-14,39
Ayr,5831,10,6,12,18,28,60,-32,30
Hibernian,5832,1,20,12,4,63,29,34,72
Falkirk,5832,2,17,10,9,61,42,19,61
Morton,5832,3,15,11,10,47,37,10,56
Dundee Utd,5832,4,14,10,12,47,42,5,52
Dunfermline,5832,5,11,12,13,43,46,-3,45
Raith,5832,6,11,10,15,37,47,-10,43
Queen of S't,5832,7,11,9,16,41,52,-11,42
Dumbarton,5832,8,10,11,15,49,59,-10,41
St Mirren,5832,9,8,12,16,43,58,-15,36
Ayr,5832,10,7,15,14,34,53,-19,36
Morton,5833,1,20,9,7,56,35,21,69
Hibernian,5833,2,18,11,7,53,29,24,65
Dundee Utd,5833,3,15,11,10,53,44,9,56
Falkirk,5833,4,14,10,12,59,49,10,52
Dunfermline,5833,5,11,13,12,48,49,-1,46
Queen of S't,5833,6,12,10,14,45,48,-3,46
Raith,5833,7,10,10,16,33,46,-13,40
Ayr,5833,8,9,12,15,32,51,-19,39
Dumbarton,5833,9,9,10,17,48,61,-13,37
St Mirren,5833,10,9,10,17,41,56,-15,37
Hibernian,5834,1,18,13,5,54,28,26,67
Dundee Utd,5834,2,17,10,9,53,34,19,61
Morton,5834,3,16,11,9,52,37,15,59
Falkirk,5834,4,16,9,11,59,44,15,57
Queen of S't,5834,5,13,11,12,46,45,1,50
Raith,5834,6,11,10,15,37,48,-11,43
Dunfermline,5834,7,10,12,14,47,53,-6,42
Dumbarton,5834,8,8,11,17,43,58,-15,35
St Mirren,5834,9,8,11,17,42,62,-20,35
Ayr,5834,10,7,14,15,31,55,-24,35
Hibernian,5835,1,19,12,5,57,27,30,69
Morton,5835,2,18,11,7,48,34,14,65
Falkirk,5835,3,14,13,9,56,41,15,55
Dundee Utd,5835,4,14,10,12,50,44,6,52
Dumbarton,5835,5,12,10,14,52,57,-5,46
Queen of S't,5835,6,11,11,14,44,47,-3,44
Dunfermline,5835,7,9,14,13,41,45,-4,41
Raith,5835,8,10,11,15,39,50,-11,41
St Mirren,5835,9,8,11,17,44,60,-16,35
Ayr,5835,10,7,13,16,34,60,-26,34
Hibernian,5836,1,21,11,4,59,26,33,74
Morton,5836,2,18,10,8,54,36,18,64
Falkirk,5836,3,15,11,10,55,40,15,56
Dundee Utd,5836,4,15,10,11,45,38,7,55
Queen of S't,5836,5,11,11,14,46,50,-4,44
Dunfermline,5836,6,10,12,14,46,48,-2,42
Raith,5836,7,10,10,16,34,48,-14,40
Ayr,5836,8,9,12,15,34,51,-17,39
Dumbarton,5836,9,8,12,16,45,63,-18,36
St Mirren,5836,10,8,11,17,38,56,-18,35
Morton,5837,1,21,9,6,61,33,28,72
Hibernian,5837,2,18,13,5,58,28,30,67
Falkirk,5837,3,16,11,9,60,38,22,59
Dundee Utd,5837,4,17,8,11,50,39,11,59
Queen of S't,5837,5,12,9,15,48,53,-5,45
Dunfermline,5837,6,9,14,13,47,54,-7,41
Dumbarton,5837,7,10,10,16,46,60,-14,40
St Mirren,5837,8,9,10,17,40,53,-13,37
Raith,5837,9,9,10,17,32,52,-20,37
Ayr,5837,10,6,12,18,29,61,-32,30
Morton,5838,1,19,9,8,55,40,15,66
Hibernian,5838,2,18,11,7,56,31,25,65
Falkirk,5838,3,16,11,9,57,39,18,59
Dundee Utd,5838,4,15,11,10,55,45,10,56
Queen of S't,5838,5,13,9,14,47,50,-3,48
Dunfermline,5838,6,11,12,13,51,49,2,45
Raith,5838,7,10,10,16,37,52,-15,40
Ayr,5838,8,9,12,15,35,59,-24,39
Dumbarton,5838,9,9,10,17,49,60,-11,37
St Mirren,5838,10,7,11,18,38,55,-17,32
Hibernian,5839,1,21,12,3,52,20,32,75
Dundee Utd,5839,2,17,10,9,53,39,14,61
Falkirk,5839,3,17,9,10,60,43,17,60
Morton,5839,4,15,12,9,49,42,7,57
Queen of S't,5839,5,11,9,16,41,51,-10,42
Dumbarton,5839,6,10,11,15,56,64,-8,41
St Mirren,5839,7,10,10,16,46,53,-7,40
Raith,5839,8,10,9,17,37,52,-15,39
Dunfermline,5839,9,8,14,14,49,53,-4,38
Ayr,5839,10,7,12,17,30,56,-26,33
Morton,5840,1,18,12,6,50,33,17,66
Hibernian,5840,2,17,13,6,52,25,27,64
Dundee Utd,5840,3,17,9,10,51,38,13,60
Falkirk,5840,4,16,11,9,58,42,16,59
Dunfermline,5840,5,11,12,13,47,47,0,45
Queen of S't,5840,6,12,9,15,44,50,-6,45
Dumbarton,5840,7,10,11,15,50,59,-9,41
Ayr,5840,8,9,13,14,38,53,-15,40
Raith,5840,9,8,11,17,34,53,-19,35
St Mirren,5840,10,7,9,20,37,61,-24,30
Hibernian,5841,1,18,13,5,50,24,26,67
Morton,5841,2,18,10,8,57,38,19,64
Falkirk,5841,3,14,13,9,56,40,16,55
Dundee Utd,5841,4,14,10,12,49,47,2,52
Queen of S't,5841,5,13,9,14,50,49,1,48
Dunfermline,5841,6,10,13,13,48,52,-4,43
Ayr,5841,7,9,15,12,37,50,-13,42
Dumbarton,5841,8,9,11,16,46,59,-13,38
Raith,5841,9,9,11,16,34,52,-18,38
St Mirren,5841,10,8,11,17,39,55,-16,35
Morton,5842,1,20,11,5,53,30,23,71
Hibernian,5842,2,19,11,6,57,26,31,68
Falkirk,5842,3,16,12,8,56,35,21,60
Dundee Utd,5842,4,15,8,13,44,39,5,53
Queen of S't,5842,5,13,9,14,47,49,-2,48
Dunfermline,5842,6,10,13,13,44,45,-1,43
Raith,5842,7,10,9,17,33,47,-14,39
Dumbarton,5842,8,8,13,15,44,65,-21,37
St Mirren,5842,9,9,9,18,42,56,-14,36
Ayr,5842,10,7,11,18,31,59,-28,32
Hibernian,5843,1,19,11,6,56,27,29,68
Falkirk,5843,2,17,11,8,60,37,23,62
Dundee Utd,5843,3,17,8,11,51,36,15,59
Morton,5843,4,16,10,10,46,36,10,58
Dunfermline,5843,5,11,11,14,49,55,-6,44
Queen of S't,5843,6,11,9,16,48,58,-10,42
St Mirren,5843,7,10,10,16,44,56,-12,40
Ayr,5843,8,10,10,16,35,52,-17,40
Raith,5843,9,10,10,16,39,57,-18,40
Dumbarton,5843,10,8,12,16,48,62,-14,36
Hibernian,5844,1,18,15,3,56,24,32,69
Dundee Utd,5844,2,17,10,9,54,41,13,61
Morton,5844,3,16,11,9,48,38,10,59
Falkirk,5844,4,15,9,12,57,46,11,54
Dunfermline,5844,5,10,14,12,50,51,-1,44
Queen of S't,5844,6,12,8,16,47,53,-6,44
St Mirren,5844,7,10,12,14,45,52,-7,42
Raith,5844,8,10,11,15,37,48,-11,41
Dumbarton,5844,9,10,10,16,48,62,-14,40
Ayr,5844,10,6,12,18,36,63,-27,30
Hibernian,5845,1,19,11,6,56,29,27,68
Morton,5845,2,18,11,7,49,33,16,65
Dundee Utd,5845,3,17,8,11,52,39,13,59
Falkirk,5845,4,14,11,11,55,43,12,53
Dunfermline,5845,5,13,12,11,49,45,4,51
Queen of S't,5845,6,11,9,16,44,51,-7,42
Dumbarton,5845,7,10,10,16,51,60,-9,40
St Mirren,5845,8,10,9,17,39,55,-16,39
Ayr,5845,9,9,11,16,36,56,-20,38
Raith,5845,10,8,10,18,31,51,-20,34
Hibernian,5846,1,19,11,6,58,29,29,68
Falkirk,5846,2,17,11,8,57,37,20,62
Morton,5846,3,17,10,9,46,37,9,61
Dundee Utd,5846,4,16,8,12,51,39,12,56
Dunfermline,5846,5,11,12,13,47,45,2,45
Queen of S't,5846,6,10,12,14,45,52,-7,42
Raith,5846,7,10,10,16,36,50,-14,40
Ayr,5846,8,10,10,16,35,56,-21,40
St Mirren,5846,9,8,12,16,40,57,-17,36
Dumbarton,5846,10,7,14,15,45,58,-13,35
Hibernian,5847,1,18,13,5,59,26,33,67
Dundee Utd,5847,2,17,8,11,54,40,14,59
Morton,5847,3,15,13,8,49,37,12,58
Falkirk,5847,4,15,10,11,57,46,11,55
Queen of S't,5847,5,13,9,14,48,53,-5,48
Dunfermline,5847,6,10,15,11,49,46,3,45
Ayr,5847,7,9,12,15,35,52,-17,39
St Mirren,5847,8,10,9,17,40,60,-20,39
Dumbarton,5847,9,9,11,16,50,62,-12,38
Raith,5847,10,9,10,17,32,51,-19,37
Hibernian,5848,1,18,12,6,55,29,26,66
Morton,5848,2,18,11,7,51,34,17,65
Falkirk,5848,3,17,11,8,61,41,20,62
Dundee Utd,5848,4,15,9,12,48,41,7,54
Queen of S't,5848,5,12,10,14,51,56,-5,46
Dunfermline,5848,6,10,14,12,49,46,3,44
Ayr,5848,7,10,11,15,32,52,-20,41
Raith,5848,8,10,9,17,37,49,-12,39
Dumbarton,5848,9,8,11,17,45,62,-17,35
St Mirren,5848,10,7,12,17,42,61,-19,33
Hibernian,5849,1,19,12,5,56,25,31,69
Falkirk,5849,2,15,12,9,58,39,19,57
Morton,5849,3,15,12,9,53,43,10,57
Dundee Utd,5849,4,14,8,14,46,44,2,50
Dunfermline,5849,5,11,14,11,52,52,0,47
Queen of S't,5849,6,13,8,15,46,52,-6,47
Dumbarton,5849,7,10,12,14,53,59,-6,42
Raith,5849,8,11,9,16,35,48,-13,42
Ayr,5849,9,9,12,15,38,56,-18,39
St Mirren,5849,10,8,11,17,40,59,-19,35
Hibernian,5850,1,22,11,3,65,28,37,77
Falkirk,5850,2,17,9,10,59,42,17,60
Morton,5850,3,16,12,8,51,37,14,60
Dundee Utd,5850,4,15,10,11,50,44,6,55
Queen of S't,5850,5,12,9,15,50,54,-4,45
Ayr,5850,6,8,15,13,37,54,-17,39
St Mirren,5850,7,9,11,16,48,57,-9,38
Dunfermline,5850,8,9,11,16,43,52,-9,38
Dumbarton,5850,9,9,11,16,46,60,-14,38
Raith,5850,10,9,9,18,31,52,-21,36
Morton,5851,1,18,12,6,55,36,19,66
Falkirk,5851,2,17,10,9,59,37,22,61
Hibernian,5851,3,16,13,7,49,28,21,61
Dundee Utd,5851,4,15,8,13,44,42,2,53
Queen of S't,5851,5,12,9,15,44,49,-5,45
St Mirren,5851,6,11,10,15,44,56,-12,43
Dunfermline,5851,7,9,13,14,45,51,-6,40
Raith,5851,8,10,10,16,38,49,-11,40
Dumbarton,5851,9,9,12,15,46,57,-11,39
Ayr,5851,10,9,11,16,41,60,-19,38
Hibernian,5852,1,18,12,6,56,28,28,66
Morton,5852,2,17,12,7,48,34,14,63
Dundee Utd,5852,3,17,10,9,52,37,15,61
Falkirk,5852,4,15,11,10,55,40,15,56
Dumbarton,5852,5,11,13,12,49,52,-3,46
Queen of S't,5852,6,11,11,14,41,46,-5,44
Raith,5852,7,10,9,17,33,50,-17,39
Dunfermline,5852,8,9,11,16,43,49,-6,38
Ayr,5852,9,9,11,16,32,55,-23,38
St Mirren,5852,10,8,10,18,35,53,-18,34
Hibernian,5853,1,16,14,6,47,26,21,62
Morton,5853,2,15,11,10,49,41,8,56
Dundee Utd,5853,3,15,10,11,48,39,9,55
Falkirk,5853,4,14,11,11,56,42,14,53
Raith,5853,5,12,10,14,38,44,-6,46
Queen of S't,5853,6,12,9,15,44,47,-3,45
Ayr,5853,7,11,12,13,35,49,-14,45
Dunfermline,5853,8,10,12,14,48,55,-7,42
Dumbarton,5853,9,10,11,15,50,61,-11,41
St Mirren,5853,10,9,12,15,43,54,-11,39
Hibernian,5854,1,17,12,7,50,28,22,63
Falkirk,5854,2,17,11,8,58,39,19,62
Morton,5854,3,17,11,8,52,35,17,62
Dundee Utd,5854,4,15,10,11,52,42,10,55
Dunfermline,5854,5,12,13,11,50,47,3,49
Queen of S't,5854,6,13,8,15,45,48,-3,47
Raith,5854,7,11,9,16,33,46,-13,42
Ayr,5854,8,8,13,15,33,57,-24,37
Dumbarton,5854,9,8,11,17,48,62,-14,35
St Mirren,5854,10,7,12,17,38,55,-17,33
Hibernian,5855,1,21,11,4,60,28,32,74
Morton,5855,2,18,11,7,53,34,19,65
Falkirk,5855,3,17,9,10,64,42,22,60
Dundee Utd,5855,4,17,8,11,49,39,10,59
Queen of S't,5855,5,12,9,15,46,53,-7,45
Dunfermline,5855,6,10,12,14,47,52,-5,42
Raith,5855,7,11,9,16,34,46,-12,42
Dumbarton,5855,8,8,12,16,49,62,-13,36
Ayr,5855,9,8,12,16,31,54,-23,36
St Mirren,5855,10,7,9,20,38,61,-23,30
Hibernian,5856,1,20,11,5,54,24,30,71
Dundee Utd,5856,2,19,9,8,59,38,21,66
Morton,5856,3,17,11,8,47,33,14,62
Falkirk,5856,4,17,10,9,60,40,20,61
Queen of S't,5856,5,10,12,14,41,50,-9,42
Dunfermline,5856,6,9,13,14,45,50,-5,40
Dumbarton,5856,7,9,12,15,47,59,-12,39
St Mirren,5856,8,8,11,17,44,58,-14,35
Raith,5856,9,8,11,17,31,49,-18,35
Ayr,5856,10,7,12,17,33,60,-27,33
Hibernian,5857,1,21,11,4,59,22,37,74
Morton,5857,2,18,11,7,53,35,18,65
Dundee Utd,5857,3,16,8,12,48,41,7,56
Falkirk,5857,4,15,10,11,55,44,11,55
Dunfermline,5857,5,11,15,10,51,46,5,48
Queen of S't,5857,6,11,11,14,46,50,-4,44
Ayr,5857,7,9,13,14,34,52,-18,40
Dumbarton,5857,8,8,11,17,43,60,-17,35
Raith,5857,9,8,11,17,33,52,-19,35
St Mirren,5857,10,7,11,18,37,57,-20,32
Hibernian,5858,1,19,13,4,54,25,29,70
Falkirk,5858,2,19,10,7,61,34,27,67
Morton,5858,3,16,13,7,47,34,13,61
Dundee Utd,5858,4,14,11,11,49,42,7,53
Queen of S't,5858,5,13,9,14,44,48,-4,48
Ayr,5858,6,10,13,13,35,51,-16,43
Dunfermline,5858,7,9,13,14,48,51,-3,40
Dumbarton,5858,8,8,11,17,44,58,-14,35
St Mirren,5858,9,8,11,17,39,56,-17,35
Raith,5858,10,8,8,20,31,53,-22,32
Hibernian,5859,1,20,12,4,59,26,33,72
Morton,5859,2,17,11,8,50,35,15,62
Falkirk,5859,3,17,10,9,58,39,19,61
Dundee Utd,5859,4,16,10,10,54,45,9,58
Queen of S't,5859,5,12,10,14,45,49,-4,46
Dunfermline,5859,6,11,11,14,48,51,-3,44
Raith,5859,7,9,11,16,31,47,-16,38
Dumbarton,5859,8,9,10,17,50,62,-12,37
Ayr,5859,9,8,11,17,33,60,-27,35
St Mirren,5859,10,7,12,17,41,55,-14,33
Hibernian,5860,1,21,11,4,58,23,35,74
Falkirk,5860,2,17,9,10,60,41,19,60
Dundee Utd,5860,3,16,10,10,50,38,12,58
Morton,5860,4,13,11,12,41,42,-1,50
Raith,5860,5,12,10,14,35,45,-10,46
Dumbarton,5860,6,10,12,14,47,52,-5,42
Queen of S't,5860,7,11,9,16,41,49,-8,42
Dunfermline,5860,8,9,14,13,41,47,-6,41
Ayr,5860,9,8,13,15,34,53,-19,37
St Mirren,5860,10,9,9,18,40,57,-17,36
Hibernian,5861,1,21,10,5,62,27,35,73
Dundee Utd,5861,2,17,9,10,54,37,17,60
Falkirk,5861,3,15,11,10,54,43,11,56
Morton,5861,4,14,10,12,46,44,2,52
Queen of S't,5861,5,12,10,14,48,54,-6,46
Dumbarton,5861,6,11,11,14,50,57,-7,44
St Mirren,5861,7,11,9,16,44,54,-10,42
Dunfermline,5861,8,9,13,14,46,54,-8,40
Raith,5861,9,10,9,17,34,48,-14,39
Ayr,5861,10,9,10,17,33,53,-20,37
Hibernian,5862,1,20,11,5,58,26,32,71
Morton,5862,2,17,11,8,51,34,17,62
Falkirk,5862,3,17,9,10,57,39,18,60
Dundee Utd,5862,4,14,13,9,49,40,9,55
Dunfermline,5862,5,11,13,12,49,52,-3,46
Queen of S't,5862,6,12,9,15,48,50,-2,45
Raith,5862,7,10,10,16,35,50,-15,40
Ayr,5862,8,8,13,15,35,54,-19,37
Dumbarton,5862,9,7,13,16,49,63,-14,34
St Mirren,5862,10,7,12,17,42,65,-23,33
Hibernian,5863,1,19,11,6,54,25,29,68
Morton,5863,2,18,10,8,47,34,13,64
Dundee Utd,5863,3,18,9,9,53,34,19,63
Falkirk,5863,4,14,13,9,55,44,11,55
Queen of S't,5863,5,12,10,14,45,49,-4,46
Raith,5863,6,11,9,16,40,52,-12,42
Ayr,5863,7,9,11,16,36,55,-19,38
Dunfermline,5863,8,8,13,15,45,53,-8,37
St Mirren,5863,9,9,10,17,44,58,-14,37
Dumbarton,5863,10,8,12,16,48,63,-15,36
Hibernian,5864,1,19,10,7,51,28,23,67
Dundee Utd,5864,2,17,10,9,53,41,12,61
Morton,5864,3,15,12,9,48,38,10,57
Falkirk,5864,4,15,9,12,58,43,15,54
Queen of S't,5864,5,13,10,13,42,45,-3,49
Dunfermline,5864,6,11,14,11,45,43,2,47
Raith,5864,7,11,8,17,34,45,-11,41
St Mirren,5864,8,9,10,17,43,58,-15,37
Ayr,5864,9,8,13,15,35,53,-18,37
Dumbarton,5864,10,8,12,16,50,65,-15,36
Hibernian,5865,1,18,13,5,54,22,32,67
Morton,5865,2,17,12,7,49,33,16,63
Dundee Utd,5865,3,18,8,10,53,40,13,62
Falkirk,5865,4,17,10,9,59,45,14,61
Dunfermline,5865,5,10,13,13,46,47,-1,43
Queen of S't,5865,6,10,11,15,43,51,-8,41
Raith,5865,7,9,12,15,34,48,-14,39
Ayr,5865,8,9,12,15,32,49,-17,39
Dumbarton,5865,9,9,11,16,46,59,-13,38
St Mirren,5865,10,6,12,18,35,57,-22,30
Hibernian,5866,1,18,14,4,54,27,27,68
Morton,5866,2,17,9,10,50,40,10,60
Falkirk,5866,3,15,11,10,55,40,15,56
Dundee Utd,5866,4,15,11,10,48,41,7,56
Queen of S't,5866,5,13,10,13,46,47,-1,49
Ayr,5866,6,10,13,13,42,55,-13,43
Raith,5866,7,11,9,16,36,50,-14,42
Dunfermline,5866,8,9,11,16,44,51,-7,38
St Mirren,5866,9,9,11,16,42,54,-12,38
Dumbarton,5866,10,8,11,17,47,59,-12,35
Hibernian,5867,1,20,11,5,58,25,33,71
Morton,5867,2,17,12,7,47,32,15,63
Falkirk,5867,3,15,11,10,55,41,14,56
Queen of S't,5867,4,14,9,13,48,48,0,51
Dundee Utd,5867,5,13,11,12,45,41,4,50
Raith,5867,6,11,10,15,40,53,-13,43
St Mirren,5867,7,10,11,15,47,56,-9,41
Dumbarton,5867,8,9,13,14,50,59,-9,40
Dunfermline,5867,9,8,14,14,45,52,-7,38
Ayr,5867,10,6,12,18,30,58,-28,30
Hibernian,5868,1,21,12,3,59,22,37,75
Falkirk,5868,2,16,11,9,55,39,16,59
Dundee Utd,5868,3,15,11,10,51,41,10,56
Morton,5868,4,15,11,10,46,39,7,56
Raith,5868,5,11,11,14,33,45,-12,44
Dunfermline,5868,6,9,15,12,47,48,-1,42
Queen of S't,5868,7,10,10,16,41,55,-14,40
Dumbarton,5868,8,9,11,16,52,60,-8,38
St Mirren,5868,9,8,12,16,41,55,-14,36
Ayr,5868,10,7,14,15,32,53,-21,35
Hibernian,5869,1,19,10,7,59,27,32,67
Morton,5869,2,17,11,8,51,38,13,62
Dundee Utd,5869,3,17,9,10,56,40,16,60
Falkirk,5869,4,16,11,9,59,45,14,59
Queen of S't,5869,5,13,8,15,48,54,-6,47
Dunfermline,5869,6,10,13,13,46,49,-3,43
Raith,5869,7,10,9,17,37,52,-15,39
Ayr,5869,8,9,11,16,31,53,-22,38
St Mirren,5869,9,8,13,15,43,57,-14,37
Dumbarton,5869,10,7,13,16,42,57,-15,34
Hibernian,5870,1,19,11,6,54,28,26,68
Morton,5870,2,17,11,8,49,36,13,62
Falkirk,5870,3,15,11,10,54,39,15,56
Dundee Utd,5870,4,16,8,12,50,40,10,56
Dunfermline,5870,5,11,12,13,47,49,-2,45
Dumbarton,5870,6,10,14,12,48,50,-2,44
Queen of S't,5870,7,11,11,14,42,49,-7,44
St Mirren,5870,8,9,11,16,40,55,-15,38
Raith,5870,9,9,10,17,35,51,-16,37
Ayr,5870,10,7,13,16,33,55,-22,34
Hibernian,5871,1,19,11,6,54,28,26,68
Falkirk,5871,2,16,10,10,56,42,14,58
Dunfermline,5871,3,15,11,10,49,41,8,56
Dundee Utd,5871,4,15,9,12,51,42,9,54
Morton,5871,5,14,12,10,46,39,7,54
Queen of S't,5871,6,13,9,14,47,48,-1,48
Raith,5871,7,10,9,17,36,53,-17,39
Ayr,5871,8,9,11,16,35,61,-26,38
St Mirren,5871,9,9,10,17,49,58,-9,37
Dumbarton,5871,10,9,10,17,52,63,-11,37
Hibernian,5872,1,20,13,3,61,25,36,73
Morton,5872,2,16,10,10,44,36,8,58
Falkirk,5872,3,14,14,8,55,39,16,56
Dundee Utd,5872,4,16,8,12,50,41,9,56
Queen of S't,5872,5,11,11,14,44,50,-6,44
Raith,5872,6,11,11,14,36,43,-7,44
Dumbarton,5872,7,9,13,14,48,58,-10,40
Dunfermline,5872,8,8,15,13,41,47,-6,39
St Mirren,5872,9,8,12,16,40,54,-14,36
Ayr,5872,10,8,11,17,32,58,-26,35
Hibernian,5873,1,21,12,3,59,23,36,75
Morton,5873,2,16,13,7,50,38,12,61
Dundee Utd,5873,3,16,11,9,57,38,19,59
Falkirk,5873,4,15,12,9,56,45,11,57
Queen of S't,5873,5,10,10,16,44,54,-10,40
Raith,5873,6,9,12,15,36,51,-15,39
Dumbarton,5873,7,9,11,16,48,61,-13,38
Ayr,5873,8,8,14,14,33,51,-18,38
Dunfermline,5873,9,7,16,13,41,46,-5,37
St Mirren,5873,10,7,13,16,39,56,-17,34
Hibernian,5874,1,21,11,4,60,26,34,74
Morton,5874,2,18,12,6,54,35,19,66
Dundee Utd,5874,3,18,8,10,52,39,13,62
Falkirk,5874,4,16,10,10,62,43,19,58
Raith,5874,5,12,9,15,38,46,-8,45
Queen of S't,5874,6,11,10,15,47,52,-5,43
Dumbarton,5874,7,10,12,14,48,54,-6,42
Ayr,5874,8,8,11,17,33,55,-22,35
Dunfermline,5874,9,7,12,17,41,57,-16,33
St Mirren,5874,10,7,9,20,39,67,-28,30
Hibernian,5875,1,19,11,6,50,25,25,68
Morton,5875,2,19,10,7,54,35,19,67
Falkirk,5875,3,16,10,10,58,42,16,58
Dundee Utd,5875,4,16,8,12,50,42,8,56
Queen of S't,5875,5,12,10,14,47,50,-3,46
Dunfermline,5875,6,10,14,12,45,44,1,44
Ayr,5875,7,9,11,16,33,54,-21,38
St Mirren,5875,8,9,10,17,48,61,-13,37
Raith,5875,9,9,10,17,33,52,-19,37
Dumbarton,5875,10,8,12,16,46,59,-13,36
Hibernian,5876,1,21,10,5,62,23,39,73
Dundee Utd,5876,2,19,9,8,57,36,21,66
Morton,5876,3,17,10,9,50,39,11,61
Falkirk,5876,4,13,10,13,51,43,8,49
Raith,5876,5,12,10,14,34,43,-9,46
Queen of S't,5876,6,12,9,15,44,51,-7,45
Dunfermline,5876,7,11,11,14,47,51,-4,44
St Mirren,5876,8,9,11,16,40,56,-16,38
Dumbarton,5876,9,8,11,17,45,61,-16,35
Ayr,5876,10,7,11,18,33,60,-27,32
Hibernian,5877,1,18,14,4,54,24,30,68
Falkirk,5877,2,17,12,7,59,36,23,63
Morton,5877,3,15,12,9,43,35,8,57
Dundee Utd,5877,4,15,9,12,49,41,8,54
Queen of S't,5877,5,12,9,15,44,51,-7,45
Dunfermline,5877,6,9,15,12,43,45,-2,42
St Mirren,5877,7,9,11,16,44,56,-12,38
Dumbarton,5877,8,8,14,14,47,61,-14,38
Raith,5877,9,9,11,16,35,50,-15,38
Ayr,5877,10,9,11,16,33,52,-19,38
Hibernian,5878,1,17,13,6,53,30,23,64
Morton,5878,2,16,13,7,51,37,14,61
Dundee Utd,5878,3,16,10,10,50,38,12,58
Falkirk,5878,4,15,11,10,60,44,16,56
Queen of S't,5878,5,13,10,13,51,51,0,49
St Mirren,5878,6,11,11,14,44,50,-6,44
Dunfermline,5878,7,9,11,16,41,51,-10,38
Raith,5878,8,9,11,16,33,51,-18,38
Dumbarton,5878,9,8,13,15,50,60,-10,37
Ayr,5878,10,8,13,15,34,55,-21,37
Hibernian,5879,1,21,10,5,63,24,39,73
Morton,5879,2,18,10,8,54,38,16,64
Dundee Utd,5879,3,17,9,10,53,39,14,60
Falkirk,5879,4,16,9,11,61,42,19,57
Queen of S't,5879,5,14,8,14,48,52,-4,50
Dunfermline,5879,6,11,13,12,45,45,0,46
Ayr,5879,7,9,11,16,33,53,-20,38
Dumbarton,5879,8,8,11,17,45,60,-15,35
Raith,5879,9,9,8,19,29,54,-25,35
St Mirren,5879,10,8,9,19,36,60,-24,33
Hibernian,5880,1,16,13,7,50,30,20,61
Falkirk,5880,2,16,11,9,63,44,19,59
Morton,5880,3,16,11,9,48,41,7,59
Dundee Utd,5880,4,16,10,10,54,43,11,58
Queen of S't,5880,5,14,8,14,48,48,0,50
Dumbarton,5880,6,11,10,15,50,54,-4,43
Raith,5880,7,11,10,15,37,48,-11,43
Ayr,5880,8,10,13,13,36,48,-12,43
Dunfermline,5880,9,8,12,16,43,57,-14,36
St Mirren,5880,10,7,12,17,43,59,-16,33
Hibernian,5881,1,19,12,5,54,27,27,69
Morton,5881,2,17,11,8,48,34,14,62
Dundee Utd,5881,3,16,10,10,56,45,11,58
Falkirk,5881,4,14,12,10,56,41,15,54
Queen of S't,5881,5,13,8,15,47,52,-5,47
Ayr,5881,6,10,13,13,38,51,-13,43
Raith,5881,7,11,9,16,35,47,-12,42
Dunfermline,5881,8,8,14,14,41,47,-6,38
St Mirren,5881,9,8,12,16,41,56,-15,36
Dumbarton,5881,10,8,11,17,44,60,-16,35
Hibernian,5882,1,19,12,5,55,23,32,69
Falkirk,5882,2,17,10,9,58,40,18,61
Morton,5882,3,17,9,10,52,44,8,60
Dundee Utd,5882,4,15,9,12,51,46,5,54
Dunfermline,5882,5,11,13,12,46,47,-1,46
Queen of S't,5882,6,12,9,15,47,50,-3,45
Dumbarton,5882,7,10,12,14,54,61,-7,42
Ayr,5882,8,9,12,15,40,57,-17,39
St Mirren,5882,9,8,11,17,41,55,-14,35
Raith,5882,10,8,11,17,31,52,-21,35
Hibernian,5883,1,22,11,3,62,22,40,77
Dundee Utd,5883,2,17,10,9,49,40,9,61
Morton,5883,3,17,9,10,56,43,13,60
Falkirk,5883,4,14,13,9,53,39,14,55
Queen of S't,5883,5,12,9,15,43,49,-6,45
Dumbarton,5883,6,10,11,15,51,60,-9,41
St Mirren,5883,7,10,10,16,44,58,-14,40
Dunfermline,5883,8,9,11,16,48,49,-1,38
Raith,5883,9,9,10,17,35,54,-19,37
Ayr,5883,10,6,14,16,31,58,-27,32
Hibernian,5884,1,19,12,5,56,30,26,69
Morton,5884,2,18,11,7,54,32,22,65
Dundee Utd,5884,3,15,11,10,48,40,8,56
Falkirk,5884,4,15,10,11,56,43,13,55
Queen of S't,5884,5,13,9,14,47,48,-1,48
Raith,5884,6,11,9,16,38,51,-13,42
Dunfermline,5884,7,9,14,13,47,48,-1,41
Dumbarton,5884,8,10,11,15,47,58,-11,41
St Mirren,5884,9,8,11,17,40,59,-19,35
Ayr,5884,10,6,14,16,33,57,-24,32
Hibernian,5885,1,20,12,4,60,25,35,72
Morton,5885,2,18,12,6,54,39,15,66
Falkirk,5885,3,16,12,8,56,35,21,60
Dundee Utd,5885,4,13,9,14,44,44,0,48
Queen of S't,5885,5,13,9,14,48,51,-3,48
St Mirren,5885,6,10,11,15,40,52,-12,41
Dunfermline,5885,7,9,13,14,41,49,-8,40
Raith,5885,8,9,12,15,34,45,-11,39
Ayr,5885,9,8,12,16,32,56,-24,36
Dumbarton,5885,10,7,12,17,45,58,-13,33
Hibernian,5886,1,20,11,5,54,24,30,71
Morton,5886,2,19,9,8,52,35,17,66
Falkirk,5886,3,17,11,8,62,37,25,62
Dundee Utd,5886,4,17,8,11,50,39,11,59
Queen of S't,5886,5,12,9,15,47,51,-4,45
Raith,5886,6,12,9,15,37,48,-11,45
Dumbarton,5886,7,10,11,15,52,56,-4,41
St Mirren,5886,8,9,10,17,39,56,-17,37
Dunfermline,5886,9,7,12,17,43,58,-15,33
Ayr,5886,10,7,10,19,30,62,-32,31
Hibernian,5887,1,18,13,5,50,22,28,67
Falkirk,5887,2,18,11,7,64,38,26,65
Morton,5887,3,16,12,8,48,38,10,60
Dundee Utd,5887,4,15,11,10,48,40,8,56
Queen of S't,5887,5,10,11,15,44,52,-8,41
Dumbarton,5887,6,10,10,16,49,59,-10,40
Ayr,5887,7,9,12,15,38,56,-18,39
Dunfermline,5887,8,7,17,12,43,47,-4,38
St Mirren,5887,9,9,11,16,38,52,-14,38
Raith,5887,10,9,10,17,34,52,-18,37
Hibernian,5888,1,20,12,4,54,23,31,72
Morton,5888,2,15,11,10,50,35,15,56
Falkirk,5888,3,15,11,10,53,43,10,56
Dundee Utd,5888,4,15,11,10,48,39,9,56
Dunfermline,5888,5,11,13,12,50,44,6,46
Queen of S't,5888,6,11,11,14,44,48,-4,44
Raith,5888,7,10,10,16,34,48,-14,40
Ayr,5888,8,9,12,15,40,59,-19,39
Dumbarton,5888,9,9,11,16,46,64,-18,38
St Mirren,5888,10,8,12,16,38,54,-16,36
Dundee Utd,5889,1,19,9,8,54,36,18,66
Hibernian,5889,2,16,14,6,55,31,24,62
Morton,5889,3,16,11,9,48,39,9,59
Falkirk,5889,4,16,10,10,62,41,21,58
Queen of S't,5889,5,10,12,14,45,51,-6,42
Dunfermline,5889,6,10,11,15,46,48,-2,41
Dumbarton,5889,7,10,11,15,52,65,-13,41
Ayr,5889,8,9,13,14,36,52,-16,40
Raith,5889,9,9,11,16,36,54,-18,38
St Mirren,5889,10,9,10,17,38,55,-17,37
Hibernian,5890,1,20,12,4,59,25,34,72
Morton,5890,2,19,11,6,51,37,14,68
Dundee Utd,5890,3,18,9,9,52,38,14,63
Falkirk,5890,4,15,10,11,55,41,14,55
Dunfermline,5890,5,11,13,12,52,48,4,46
Queen of S't,5890,6,12,9,15,42,51,-9,45
Raith,5890,7,9,10,17,36,51,-15,37
Ayr,5890,8,9,10,17,40,58,-18,37
Dumbarton,5890,9,8,10,18,49,66,-17,34
St Mirren,5890,10,7,10,19,42,63,-21,31
Hibernian,5891,1,19,12,5,56,29,27,69
Dundee Utd,5891,2,18,10,8,61,42,19,64
Morton,5891,3,16,11,9,47,36,11,59
Falkirk,5891,4,14,11,11,56,44,12,53
Dunfermline,5891,5,12,12,12,48,47,1,48
Queen of S't,5891,6,11,10,15,43,49,-6,43
St Mirren,5891,7,10,12,14,43,51,-8,42
Raith,5891,8,11,9,16,36,49,-13,42
Dumbarton,5891,9,7,14,15,47,61,-14,35
Ayr,5891,10,6,11,19,31,60,-29,29
Hibernian,5892,1,21,11,4,57,23,34,74
Morton,5892,2,18,11,7,50,34,16,65
Dundee Utd,5892,3,15,11,10,52,40,12,56
Falkirk,5892,4,14,11,11,56,44,12,53
Queen of S't,5892,5,12,8,16,46,56,-10,44
Raith,5892,6,11,9,16,35,49,-14,42
Ayr,5892,7,10,12,14,35,52,-17,42
Dunfermline,5892,8,10,11,15,47,48,-1,41
Dumbarton,5892,9,8,12,16,47,59,-12,36
St Mirren,5892,10,8,10,18,38,58,-20,34
Hibernian,5893,1,19,11,6,55,26,29,68
Morton,5893,2,17,12,7,47,32,15,63
Dundee Utd,5893,3,18,8,10,53,36,17,62
Falkirk,5893,4,16,11,9,54,41,13,59
Queen of S't,5893,5,11,11,14,44,49,-5,44
Dunfermline,5893,6,9,14,13,47,51,-4,41
Dumbarton,5893,7,9,13,14,47,55,-8,40
Raith,5893,8,9,11,16,34,47,-13,38
Ayr,5893,9,8,12,16,36,60,-24,36
St Mirren,5893,10,7,11,18,38,58,-20,32
Morton,5894,1,18,13,5,54,32,22,67
Hibernian,5894,2,18,12,6,58,30,28,66
Dundee Utd,5894,3,18,8,10,49,39,10,62
Falkirk,5894,4,15,11,10,57,42,15,56
Dunfermline,5894,5,10,12,14,45,47,-2,42
St Mirren,5894,6,10,12,14,45,52,-7,42
Queen of S't,5894,7,11,9,16,44,57,-13,42
Dumbarton,5894,8,9,11,16,49,58,-9,38
Ayr,5894,9,8,12,16,35,58,-23,36
Raith,5894,10,8,10,18,30,51,-21,34
Hibernian,5895,1,19,11,6,56,26,30,68
Morton,5895,2,17,9,10,50,42,8,60
Dundee Utd,5895,3,15,10,11,52,45,7,55
Falkirk,5895,4,14,12,10,57,48,9,54
Queen of S't,5895,5,14,9,13,52,49,3,51
Dunfermline,5895,6,12,13,11,54,45,9,49
Ayr,5895,7,10,11,15,41,55,-14,41
St Mirren,5895,8,9,11,16,40,53,-13,38
Raith,5895,9,9,9,18,33,54,-21,36
Dumbarton,5895,10,8,11,17,44,62,-18,35
Hibernian,5896,1,18,13,5,54,25,29,67
Morton,5896,2,19,10,7,54,32,22,67
Falkirk,5896,3,16,11,9,58,41,17,59
Dundee Utd,5896,4,14,12,10,42,35,7,54
Queen of S't,5896,5,13,10,13,47,48,-1,49
Dunfermline,5896,6,10,14,12,49,48,1,44
St Mirren,5896,7,9,11,16,39,53,-14,38
Dumbarton,5896,8,9,10,17,44,57,-13,37
Raith,5896,9,9,9,18,32,57,-25,36
Ayr,5896,10,6,14,16,32,55,-23,32
Hibernian,5897,1,19,13,4,60,28,32,70
Morton,5897,2,18,12,6,52,33,19,66
Falkirk,5897,3,17,9,10,68,49,19,60
Dundee Utd,5897,4,17,9,10,55,37,18,60
Queen of S't,5897,5,12,9,15,51,58,-7,45
Raith,5897,6,10,10,16,36,52,-16,40
Dunfermline,5897,7,9,11,16,46,59,-13,38
Ayr,5897,8,9,11,16,32,52,-20,38
Dumbarton,5897,9,9,10,17,51,67,-16,37
St Mirren,5897,10,7,12,17,38,54,-16,33
Hibernian,5898,1,19,12,5,60,30,30,69
Falkirk,5898,2,17,10,9,59,41,18,61
Dundee Utd,5898,3,16,12,8,56,38,18,60
Morton,5898,4,16,10,10,50,40,10,58
Dunfermline,5898,5,12,13,11,46,43,3,49
Queen of S't,5898,6,11,10,15,44,54,-10,43
Ayr,5898,7,9,13,14,38,53,-15,40
Raith,5898,8,10,9,17,35,48,-13,39
St Mirren,5898,9,8,10,18,37,61,-24,34
Dumbarton,5898,10,7,11,18,44,61,-17,32
Hibernian,5899,1,22,10,4,59,23,36,76
Morton,5899,2,17,10,9,57,39,18,61
Falkirk,5899,3,15,13,8,58,38,20,58
Dundee Utd,5899,4,15,12,9,53,42,11,57
Dunfermline,5899,5,11,14,11,49,46,3,47
Queen of S't,5899,6,11,11,14,43,51,-8,44
Raith,5899,7,9,11,16,36,52,-16,38
Dumbarton,5899,8,8,12,16,44,60,-16,36
Ayr,5899,9,8,11,17,33,57,-24,35
St Mirren,5899,10,7,10,19,38,62,-24,31
Hibernian,5900,1,18,13,5,58,29,29,67
Morton,5900,2,18,11,7,55,37,18,65
Falkirk,5900,3,17,10,9,58,41,17,61
Dundee Utd,5900,4,15,11,10,52,41,11,56
Dunfermline,5900,5,11,14,11,49,45,4,47
Dumbarton,5900,6,11,11,14,53,58,-5,44
Queen of S't,5900,7,11,8,17,43,52,-9,41
Raith,5900,8,9,11,16,34,51,-17,38
Ayr,5900,9,8,11,17,32,58,-26,35
St Mirren,5900,10,7,10,19,38,60,-22,31
Hibernian,5901,1,22,10,4,63,26,37,76
Dundee Utd,5901,2,18,9,9,52,35,17,63
Morton,5901,3,16,10,10,45,36,9,58
Falkirk,5901,4,13,11,12,55,49,6,50
Dunfermline,5901,5,11,13,12,45,45,0,46
Raith,5901,6,11,10,15,37,45,-8,43
Queen of S't,5901,7,11,8,17,45,53,-8,41
Dumbarton,5901,8,9,12,15,45,58,-13,39
Ayr,5901,9,9,11,16,31,53,-22,38
St Mirren,5901,10,7,12,17,36,54,-18,33
Hibernian,5902,1,20,10,6,57,28,29,70
Morton,5902,2,16,12,8,50,39,11,60
Dundee Utd,5902,3,13,13,10,48,41,7,52
Falkirk,5902,4,13,12,11,54,43,11,51
Dunfermline,5902,5,11,13,12,54,49,5,46
Ayr,5902,6,11,13,12,37,49,-12,46
Raith,5902,7,11,9,16,36,49,-13,42
Queen of S't,5902,8,10,11,15,42,48,-6,41
Dumbarton,5902,9,8,13,15,47,61,-14,37
St Mirren,5902,10,8,12,16,40,58,-18,36
Hibernian,5903,1,18,11,7,52,32,20,65
Morton,5903,2,18,11,7,54,36,18,65
Falkirk,5903,3,15,14,7,60,41,19,59
Dundee Utd,5903,4,14,11,11,50,45,5,53
Queen of S't,5903,5,12,11,13,46,49,-3,47
Dunfermline,5903,6,11,12,13,49,46,3,45
Raith,5903,7,10,10,16,34,47,-13,40
Dumbarton,5903,8,8,15,13,48,57,-9,39
St Mirren,5903,9,7,13,16,42,60,-18,34
Ayr,5903,10,7,12,17,33,55,-22,33
Hibernian,5904,1,19,13,4,61,27,34,70
Morton,5904,2,17,11,8,54,39,15,62
Falkirk,5904,3,16,10,10,56,41,15,58
Dundee Utd,5904,4,14,11,11,49,42,7,53
Queen of S't,5904,5,13,10,13,48,50,-2,49
Dunfermline,5904,6,9,15,12,45,47,-2,42
Raith,5904,7,11,8,17,41,51,-10,41
St Mirren,5904,8,10,11,15,42,57,-15,41
Ayr,5904,9,8,13,15,36,54,-18,37
Dumbarton,5904,10,7,10,19,42,66,-24,31
Hibernian,5905,1,22,10,4,58,22,36,76
Morton,5905,2,16,11,9,50,35,15,59
Dundee Utd,5905,3,15,11,10,53,41,12,56
Falkirk,5905,4,14,13,9,55,40,15,55
Raith,5905,5,11,10,15,36,45,-9,43
Queen of S't,5905,6,10,11,15,41,51,-10,41
St Mirren,5905,7,10,10,16,40,55,-15,40
Dunfermline,5905,8,8,14,14,43,54,-11,38
Dumbarton,5905,9,8,13,15,43,54,-11,37
Ayr,5905,10,8,13,15,34,56,-22,37
Hibernian,5906,1,20,12,4,58,24,34,72
Dundee Utd,5906,2,19,8,9,56,37,19,65
Morton,5906,3,17,9,10,48,37,11,60
Falkirk,5906,4,15,11,10,64,48,16,56
Queen of S't,5906,5,12,10,14,45,51,-6,46
Dunfermline,5906,6,10,12,14,44,47,-3,42
Raith,5906,7,9,12,15,35,52,-17,39
St Mirren,5906,8,9,10,17,43,57,-14,37
Dumbarton,5906,9,9,10,17,45,62,-17,37
Ayr,5906,10,7,12,17,32,55,-23,33
Hibernian,5907,1,20,12,4,52,23,29,72
Dundee Utd,5907,2,16,10,10,54,42,12,58
Morton,5907,3,15,12,9,44,35,9,57
Falkirk,5907,4,15,9,12,55,43,12,54
Queen of S't,5907,5,12,10,14,46,50,-4,46
Ayr,5907,6,11,12,13,38,50,-12,45
Dumbarton,5907,7,10,12,14,44,52,-8,42
Dunfermline,5907,8,9,12,15,43,49,-6,39
St Mirren,5907,9,9,11,16,39,50,-11,38
Raith,5907,10,8,10,18,33,54,-21,34
Hibernian,5908,1,18,12,6,56,28,28,66
Morton,5908,2,17,11,8,51,35,16,62
Falkirk,5908,3,17,9,10,62,44,18,60
Dundee Utd,5908,4,15,9,12,46,40,6,54
Dunfermline,5908,5,12,12,12,53,46,7,48
Raith,5908,6,12,8,16,36,45,-9,44
Queen of S't,5908,7,11,10,15,43,54,-11,43
St Mirren,5908,8,10,9,17,42,55,-13,39
Ayr,5908,9,9,11,16,35,62,-27,38
Dumbarton,5908,10,7,13,16,44,59,-15,34
Hibernian,5909,1,20,12,4,62,26,36,72
Falkirk,5909,2,16,11,9,58,44,14,59
Dundee Utd,5909,3,15,12,9,46,39,7,57
Morton,5909,4,14,14,8,47,41,6,56
Queen of S't,5909,5,12,10,14,45,46,-1,46
Raith,5909,6,11,10,15,35,47,-12,43
Dunfermline,5909,7,10,12,14,46,48,-2,42
St Mirren,5909,8,8,14,14,45,55,-10,38
Dumbarton,5909,9,8,13,15,45,56,-11,37
Ayr,5909,10,6,12,18,29,56,-27,30
Morton,5910,1,17,14,5,50,34,16,65
Hibernian,5910,2,17,13,6,53,27,26,64
Falkirk,5910,3,17,11,8,60,34,26,62
Dundee Utd,5910,4,17,9,10,58,39,19,60
Dunfermline,5910,5,10,15,11,46,45,1,45
Queen of S't,5910,6,11,10,15,44,50,-6,43
Raith,5910,7,10,10,16,33,50,-17,40
Dumbarton,5910,8,8,11,17,46,67,-21,35
Ayr,5910,9,8,11,17,36,62,-26,35
St Mirren,5910,10,8,10,18,45,63,-18,34
Hibernian,5911,1,18,14,4,58,28,30,68
Morton,5911,2,16,14,6,52,37,15,62
Dundee Utd,5911,3,17,10,9,54,39,15,61
Falkirk,5911,4,15,11,10,57,39,18,56
Queen of S't,5911,5,12,11,13,49,52,-3,47
Raith,5911,6,10,12,14,36,46,-10,42
Dunfermline,5911,7,9,13,14,48,52,-4,40
Dumbarton,5911,8,8,11,17,45,62,-17,35
Ayr,5911,9,7,14,15,33,54,-21,35
St Mirren,5911,10,8,10,18,36,59,-23,34
Hibernian,5912,1,18,12,6,55,30,25,66
Morton,5912,2,18,12,6,55,36,19,66
Falkirk,5912,3,16,11,9,61,40,21,59
Dundee Utd,5912,4,13,13,10,43,38,5,52
Dunfermline,5912,5,10,14,12,49,46,3,44
Queen of S't,5912,6,11,10,15,44,51,-7,43
Ayr,5912,7,9,13,14,34,50,-16,40
Dumbarton,5912,8,9,12,15,42,53,-11,39
Raith,5912,9,10,9,17,37,55,-18,39
St Mirren,5912,10,8,10,18,39,60,-21,34
Hibernian,5913,1,19,10,7,51,24,27,67
Morton,5913,2,17,11,8,48,33,15,62
Dundee Utd,5913,3,17,8,11,50,41,9,59
Falkirk,5913,4,14,11,11,56,45,11,53
Raith,5913,5,13,8,15,38,46,-8,47
Queen of S't,5913,6,12,10,14,51,54,-3,46
Dunfermline,5913,7,10,11,15,47,50,-3,41
Dumbarton,5913,8,9,13,14,49,58,-9,40
Ayr,5913,9,9,12,15,32,52,-20,39
St Mirren,5913,10,8,10,18,39,58,-19,34
Hibernian,5914,1,19,12,5,56,25,31,69
Morton,5914,2,17,11,8,50,37,13,62
Falkirk,5914,3,17,10,9,62,42,20,61
Dundee Utd,5914,4,17,10,9,50,37,13,61
Queen of S't,5914,5,12,10,14,42,49,-7,46
Dunfermline,5914,6,9,13,14,47,52,-5,40
Raith,5914,7,10,10,16,35,50,-15,40
Ayr,5914,8,9,11,16,36,53,-17,38
St Mirren,5914,9,8,11,17,42,57,-15,35
Dumbarton,5914,10,7,12,17,45,63,-18,33
Hibernian,5915,1,17,13,6,50,24,26,64
Falkirk,5915,2,17,12,7,57,36,21,63
Dundee Utd,5915,3,17,10,9,54,38,16,61
Morton,5915,4,15,12,9,53,39,14,57
Dunfermline,5915,5,10,13,13,45,48,-3,43
Queen of S't,5915,6,10,13,13,42,47,-5,43
Dumbarton,5915,7,9,14,13,51,58,-7,41
Raith,5915,8,10,10,16,35,47,-12,40
Ayr,5915,9,8,12,16,31,61,-30,36
St Mirren,5915,10,8,9,19,36,56,-20,33
Hibernian,5916,1,21,10,5,62,27,35,73
Morton,5916,2,17,11,8,52,39,13,62
Dundee Utd,5916,3,16,11,9,52,41,11,59
Falkirk,5916,4,15,11,10,62,48,14,56
Dumbarton,5916,5,11,11,14,54,60,-6,44
Dunfermline,5916,6,10,13,13,49,51,-2,43
Raith,5916,7,11,9,16,42,52,-10,42
Queen of S't,5916,8,9,11,16,43,58,-15,38
Ayr,5916,9,8,11,17,33,56,-23,35
St Mirren,5916,10,7,12,17,38,55,-17,33
Hibernian,5917,1,21,11,4,61,24,37,74
Falkirk,5917,2,18,9,9,65,41,24,63
Morton,5917,3,16,12,8,58,39,19,60
Dundee Utd,5917,4,15,10,11,52,41,11,55
Dumbarton,5917,5,10,12,14,50,57,-7,42
Queen of S't,5917,6,10,11,15,44,55,-11,41
Raith,5917,7,10,11,15,34,50,-16,41
Dunfermline,5917,8,8,14,14,47,54,-7,38
St Mirren,5917,9,8,11,17,39,63,-24,35
Ayr,5917,10,8,11,17,33,59,-26,35
Hibernian,5918,1,16,16,4,54,27,27,64
Falkirk,5918,2,18,10,8,66,41,25,64
Morton,5918,3,17,11,8,47,33,14,62
Dundee Utd,5918,4,15,12,9,53,39,14,57
Queen of S't,5918,5,12,11,13,49,48,1,47
Dunfermline,5918,6,9,13,14,47,54,-7,40
Dumbarton,5918,7,9,13,14,47,60,-13,40
Raith,5918,8,10,9,17,33,50,-17,39
St Mirren,5918,9,9,9,18,43,61,-18,36
Ayr,5918,10,6,14,16,28,54,-26,32
Hibernian,5919,1,21,10,5,60,27,33,73
Morton,5919,2,16,11,9,51,42,9,59
Falkirk,5919,3,15,12,9,55,42,13,57
Dundee Utd,5919,4,15,9,12,52,43,9,54
Ayr,5919,5,10,14,12,37,49,-12,44
Queen of S't,5919,6,11,9,16,46,54,-8,42
Dunfermline,5919,7,9,13,14,48,50,-2,40
Dumbarton,5919,8,9,13,14,46,55,-9,40
Raith,5919,9,10,10,16,32,48,-16,40
St Mirren,5919,10,8,11,17,37,54,-17,35
Hibernian,5920,1,20,12,4,60,27,33,72
Falkirk,5920,2,17,9,10,61,38,23,60
Dundee Utd,5920,3,17,9,10,52,40,12,60
Morton,5920,4,16,12,8,47,38,9,60
Queen of S't,5920,5,11,10,15,43,51,-8,43
St Mirren,5920,6,11,9,16,40,55,-15,42
Dumbarton,5920,7,10,11,15,50,57,-7,41
Dunfermline,5920,8,7,16,13,43,49,-6,37
Raith,5920,9,8,11,17,35,53,-18,35
Ayr,5920,10,7,13,16,37,60,-23,34
Hibernian,5921,1,19,13,4,55,22,33,70
Morton,5921,2,18,10,8,58,39,19,64
Dundee Utd,5921,3,16,9,11,54,37,17,57
Falkirk,5921,4,15,10,11,58,46,12,55
Dunfermline,5921,5,10,13,13,44,49,-5,43
Raith,5921,6,11,10,15,38,49,-11,43
Queen of S't,5921,7,10,11,15,43,55,-12,41
Ayr,5921,8,9,13,14,36,57,-21,40
Dumbarton,5921,9,9,12,15,50,59,-9,39
St Mirren,5921,10,7,11,18,37,60,-23,32
Hibernian,5922,1,21,10,5,55,27,28,73
Dundee Utd,5922,2,18,9,9,52,41,11,63
Morton,5922,3,16,13,7,51,36,15,61
Falkirk,5922,4,15,11,10,59,43,16,56
Dunfermline,5922,5,10,13,13,53,50,3,43
Queen of S't,5922,6,10,12,14,45,51,-6,42
Raith,5922,7,10,10,16,36,51,-15,40
Dumbarton,5922,8,8,14,14,45,55,-10,38
Ayr,5922,9,8,11,17,33,54,-21,35
St Mirren,5922,10,8,9,19,37,58,-21,33
Hibernian,5923,1,19,11,6,54,26,28,68
Falkirk,5923,2,17,10,9,58,37,21,61
Morton,5923,3,16,12,8,50,40,10,60
Dundee Utd,5923,4,16,10,10,50,38,12,58
Queen of S't,5923,5,12,11,13,43,47,-4,47
Raith,5923,6,11,10,15,35,45,-10,43
Dunfermline,5923,7,9,13,14,44,52,-8,40
Ayr,5923,8,9,11,16,36,51,-15,38
Dumbarton,5923,9,8,12,16,44,58,-14,36
St Mirren,5923,10,8,10,18,37,57,-20,34
Hibernian,5924,1,18,13,5,51,23,28,67
Falkirk,5924,2,16,11,9,55,37,18,59
Dundee Utd,5924,3,16,11,9,52,38,14,59
Morton,5924,4,16,11,9,50,40,10,59
Dunfermline,5924,5,10,14,12,48,48,0,44
Queen of S't,5924,6,10,11,15,44,52,-8,41
Ayr,5924,7,8,15,13,33,50,-17,39
St Mirren,5924,8,9,11,16,41,55,-14,38
Dumbarton,5924,9,9,11,16,49,64,-15,38
Raith,5924,10,9,10,17,32,48,-16,37
Hibernian,5925,1,19,11,6,58,26,32,68
Falkirk,5925,2,19,10,7,58,35,23,67
Morton,5925,3,18,12,6,50,33,17,66
Dundee Utd,5925,4,15,9,12,48,40,8,54
Queen of S't,5925,5,11,12,13,45,49,-4,45
Raith,5925,6,10,11,15,35,46,-11,41
Dumbarton,5925,7,9,12,15,47,56,-9,39
Dunfermline,5925,8,8,12,16,41,48,-7,36
Ayr,5925,9,7,14,15,35,61,-26,35
St Mirren,5925,10,7,11,18,36,59,-23,32
Hibernian,5926,1,19,13,4,58,23,35,70
Morton,5926,2,18,11,7,53,42,11,65
Falkirk,5926,3,18,9,9,64,37,27,63
Dundee Utd,5926,4,17,9,10,52,43,9,60
Dunfermline,5926,5,10,15,11,50,50,0,45
Raith,5926,6,11,9,16,35,51,-16,42
Queen of S't,5926,7,10,10,16,41,55,-14,40
Ayr,5926,8,9,11,16,35,52,-17,38
St Mirren,5926,9,7,11,18,39,57,-18,32
Dumbarton,5926,10,7,10,19,43,60,-17,31
Hibernian,5927,1,18,12,6,54,29,25,66
Morton,5927,2,17,12,7,51,36,15,63
Falkirk,5927,3,16,11,9,59,39,20,59
Dundee Utd,5927,4,16,10,10,52,40,12,58
Dunfermline,5927,5,11,13,12,53,51,2,46
Queen of S't,5927,6,11,9,16,47,57,-10,42
Ayr,5927,7,10,11,15,36,54,-18,41
Raith,5927,8,10,8,18,37,52,-15,38
Dumbarton,5927,9,8,12,16,48,63,-15,36
St Mirren,5927,10,8,12,16,39,55,-16,36
Hibernian,5928,1,18,13,5,57,29,28,67
Falkirk,5928,2,17,10,9,60,39,21,61
Dundee Utd,5928,3,17,9,10,53,39,14,60
Morton,5928,4,16,11,9,47,39,8,59
Dunfermline,5928,5,11,13,12,51,49,2,46
Dumbarton,5928,6,11,10,15,48,57,-9,43
Queen of S't,5928,7,10,9,17,44,56,-12,39
Ayr,5928,8,9,12,15,34,52,-18,39
Raith,5928,9,9,10,17,33,50,-17,37
St Mirren,5928,10,8,11,17,38,55,-17,35
Hibernian,5929,1,18,12,6,52,25,27,66
Falkirk,5929,2,17,11,8,65,37,28,62
Morton,5929,3,16,13,7,50,37,13,61
Dundee Utd,5929,4,14,9,13,45,45,0,51
Dunfermline,5929,5,11,12,13,44,46,-2,45
Dumbarton,5929,6,11,11,14,49,59,-10,44
Queen of S't,5929,7,11,9,16,43,52,-9,42
Raith,5929,8,10,10,16,36,51,-15,40
St Mirren,5929,9,9,11,16,44,56,-12,38
Ayr,5929,10,8,12,16,31,51,-20,36
Hibernian,5930,1,21,12,3,62,26,36,75
Morton,5930,2,18,10,8,54,36,18,64
Falkirk,5930,3,17,10,9,62,42,20,61
Dundee Utd,5930,4,17,9,10,54,40,14,60
Queen of S't,5930,5,11,9,16,46,52,-6,42
Dumbarton,5930,6,10,10,16,47,63,-16,40
Ayr,5930,7,10,10,16,37,56,-19,40
Raith,5930,8,10,9,17,32,47,-15,39
Dunfermline,5930,9,8,12,16,39,49,-10,36
St Mirren,5930,10,8,9,19,36,58,-22,33
Morton,5931,1,20,10,6,54,34,20,70
Hibernian,5931,2,18,13,5,58,25,33,67
Falkirk,5931,3,16,12,8,57,36,21,60
Dundee Utd,5931,4,14,12,10,45,37,8,54
Queen of S't,5931,5,12,10,14,45,49,-4,46
Dunfermline,5931,6,10,13,13,49,44,5,43
Raith,5931,7,11,8,17,35,57,-22,41
Ayr,5931,8,8,13,15,32,52,-20,37
Dumbarton,5931,9,8,10,18,44,63,-19,34
St Mirren,5931,10,8,9,19,39,61,-22,33
Hibernian,5932,1,20,11,5,55,26,29,71
Morton,5932,2,17,10,9,48,37,11,61
Dundee Utd,5932,3,16,11,9,53,37,16,59
Falkirk,5932,4,15,10,11,56,43,13,55
Dunfermline,5932,5,11,14,11,49,42,7,47
Dumbarton,5932,6,11,12,13,52,56,-4,45
Queen of S't,5932,7,11,10,15,45,50,-5,43
Raith,5932,8,9,11,16,32,50,-18,38
Ayr,5932,9,8,11,17,32,56,-24,35
St Mirren,5932,10,7,10,19,36,61,-25,31
Hibernian,5933,1,20,11,5,58,28,30,71
Morton,5933,2,20,11,5,61,32,29,71
Falkirk,5933,3,17,9,10,59,44,15,60
Dundee Utd,5933,4,16,8,12,48,39,9,56
Queen of S't,5933,5,12,11,13,50,52,-2,47
Raith,5933,6,10,11,15,36,50,-14,41
Dunfermline,5933,7,8,13,15,44,51,-7,37
Dumbarton,5933,8,8,12,16,50,63,-13,36
St Mirren,5933,9,8,11,17,41,58,-17,35
Ayr,5933,10,7,11,18,33,63,-30,32
Hibernian,5934,1,21,11,4,60,25,35,74
Morton,5934,2,17,11,8,51,36,15,62
Dundee Utd,5934,3,15,12,9,52,40,12,57
Falkirk,5934,4,14,12,10,57,43,14,54
Queen of S't,5934,5,12,10,14,46,50,-4,46
Dunfermline,5934,6,10,12,14,48,52,-4,42
Dumbarton,5934,7,10,10,16,48,60,-12,40
Raith,5934,8,10,10,16,35,49,-14,40
Ayr,5934,9,6,16,14,31,51,-20,34
St Mirren,5934,10,8,10,18,36,58,-22,34
Morton,5935,1,17,12,7,52,36,16,63
Hibernian,5935,2,16,14,6,50,28,22,62
Falkirk,5935,3,17,11,8,60,40,20,62
Dundee Utd,5935,4,16,9,11,53,47,6,57
Queen of S't,5935,5,12,10,14,48,52,-4,46
Dunfermline,5935,6,9,15,12,47,47,0,42
Raith,5935,7,10,9,17,37,49,-12,39
Dumbarton,5935,8,8,13,15,44,56,-12,37
St Mirren,5935,9,9,10,17,41,56,-15,37
Ayr,5935,10,8,13,15,37,58,-21,37
Hibernian,5936,1,19,13,4,60,28,32,70
Morton,5936,2,16,13,7,52,36,16,61
Dundee Utd,5936,3,17,9,10,54,41,13,60
Falkirk,5936,4,14,12,10,55,43,12,54
Dunfermline,5936,5,10,15,11,46,46,0,45
St Mirren,5936,6,11,11,14,42,50,-8,44
Queen of S't,5936,7,10,11,15,45,52,-7,41
Raith,5936,8,9,9,18,33,54,-21,36
Ayr,5936,9,8,12,16,33,55,-22,36
Dumbarton,5936,10,7,13,16,44,59,-15,34
Hibernian,5937,1,18,13,5,54,27,27,67
Falkirk,5937,2,17,12,7,63,36,27,63
Dundee Utd,5937,3,15,12,9,46,38,8,57
Morton,5937,4,14,12,10,45,40,5,54
Ayr,5937,5,10,13,13,46,51,-5,43
Queen of S't,5937,6,11,9,16,43,55,-12,42
Dunfermline,5937,7,9,13,14,44,51,-7,40
Dumbarton,5937,8,10,10,16,49,61,-12,40
Raith,5937,9,10,9,17,35,52,-17,39
St Mirren,5937,10,9,11,16,41,55,-14,38
Hibernian,5938,1,19,10,7,56,29,27,67
Morton,5938,2,18,10,8,56,39,17,64
Falkirk,5938,3,16,11,9,59,40,19,59
Dundee Utd,5938,4,14,11,11,48,42,6,53
Queen of S't,5938,5,12,9,15,44,52,-8,45
Raith,5938,6,11,10,15,37,46,-9,43
Dumbarton,5938,7,10,12,14,51,55,-4,42
Dunfermline,5938,8,8,15,13,42,47,-5,39
St Mirren,5938,9,9,10,17,45,64,-19,37
Ayr,5938,10,8,12,16,34,58,-24,36
Morton,5939,1,20,10,6,54,33,21,70
Hibernian,5939,2,18,13,5,52,26,26,67
Falkirk,5939,3,16,11,9,57,39,18,59
Dundee Utd,5939,4,16,11,9,49,37,12,59
Queen of S't,5939,5,11,10,15,45,54,-9,43
St Mirren,5939,6,9,12,15,38,50,-12,39
Dunfermline,5939,7,8,14,14,44,49,-5,38
Dumbarton,5939,8,9,11,16,50,61,-11,38
Raith,5939,9,8,11,17,35,52,-17,35
Ayr,5939,10,8,11,17,33,56,-23,35
Hibernian,5940,1,19,13,4,59,28,31,70
Morton,5940,2,16,13,7,52,36,16,61
Falkirk,5940,3,16,11,9,58,37,21,59
Dundee Utd,5940,4,14,13,9,47,40,7,55
Dunfermline,5940,5,10,13,13,50,50,0,43
Dumbarton,5940,6,9,12,15,44,55,-11,39
St Mirren,5940,7,9,12,15,45,57,-12,39
Raith,5940,8,10,9,17,37,53,-16,39
Ayr,5940,9,8,14,14,34,53,-19,38
Queen of S't,5940,10,9,10,17,41,58,-17,37
Morton,5941,1,20,9,7,51,33,18,69
Hibernian,5941,2,19,10,7,52,28,24,67
Falkirk,5941,3,18,10,8,63,37,26,64
Dundee Utd,5941,4,13,12,11,44,38,6,51
Dumbarton,5941,5,12,12,12,52,53,-1,48
Queen of S't,5941,6,12,10,14,42,46,-4,46
Raith,5941,7,10,9,17,32,51,-19,39
St Mirren,5941,8,9,9,18,40,56,-16,36
Dunfermline,5941,9,7,13,16,40,50,-10,34
Ayr,5941,10,6,14,16,32,56,-24,32
Hibernian,5942,1,21,12,3,59,25,34,75
Morton,5942,2,17,10,9,44,34,10,61
Dundee Utd,5942,3,17,9,10,47,36,11,60
Falkirk,5942,4,15,10,11,55,42,13,55
Dunfermline,5942,5,12,12,12,52,48,4,48
Queen of S't,5942,6,12,9,15,44,53,-9,45
St Mirren,5942,7,10,10,16,49,52,-3,40
Dumbarton,5942,8,9,10,17,44,62,-18,37
Raith,5942,9,9,9,18,34,51,-17,36
Ayr,5942,10,7,11,18,28,53,-25,32
Morton,5943,1,19,9,8,53,34,19,66
Hibernian,5943,2,18,11,7,52,31,21,65
Dundee Utd,5943,3,16,10,10,52,39,13,58
Falkirk,5943,4,15,12,9,54,37,17,57
Queen of S't,5943,5,13,9,14,46,48,-2,48
Dunfermline,5943,6,10,13,13,46,49,-3,43
Dumbarton,5943,7,10,11,15,48,61,-13,41
Raith,5943,8,10,10,16,32,45,-13,40
Ayr,5943,9,10,10,16,36,55,-19,40
St Mirren,5943,10,7,9,20,38,58,-20,30
Hibernian,5944,1,20,11,5,55,25,30,71
Falkirk,5944,2,17,11,8,61,39,22,62
Morton,5944,3,17,10,9,51,37,14,61
Dundee Utd,5944,4,16,10,10,54,44,10,58
Queen of S't,5944,5,12,10,14,43,45,-2,46
Dunfermline,5944,6,10,12,14,46,54,-8,42
Raith,5944,7,11,9,16,36,48,-12,42
Ayr,5944,8,9,10,17,35,59,-24,37
Dumbarton,5944,9,8,11,17,45,58,-13,35
St Mirren,5944,10,7,12,17,41,58,-17,33
Hibernian,5945,1,20,12,4,61,21,40,72
Morton,5945,2,18,11,7,53,33,20,65
Falkirk,5945,3,16,10,10,58,41,17,58
Dundee Utd,5945,4,15,9,12,47,43,4,54
Queen of S't,5945,5,14,8,14,49,56,-7,50
Dunfermline,5945,6,9,15,12,43,46,-3,42
Dumbarton,5945,7,9,11,16,47,57,-10,38
Raith,5945,8,9,11,16,33,52,-19,38
St Mirren,5945,9,8,10,18,36,55,-19,34
Ayr,5945,10,7,13,16,31,54,-23,34
Hibernian,5946,1,20,13,3,59,27,32,73
Morton,5946,2,18,11,7,55,39,16,65
Dundee Utd,5946,3,18,8,10,59,40,19,62
Falkirk,5946,4,14,12,10,55,43,12,54
Dunfermline,5946,5,11,12,13,48,50,-2,45
Queen of S't,5946,6,12,9,15,48,55,-7,45
Raith,5946,7,10,10,16,35,49,-14,40
Dumbarton,5946,8,9,11,16,49,59,-10,38
Ayr,5946,9,8,10,18,33,59,-26,34
St Mirren,5946,10,7,10,19,35,55,-20,31
Hibernian,5947,1,21,12,3,60,23,37,75
Falkirk,5947,2,17,9,10,61,43,18,60
Morton,5947,3,13,17,6,48,38,10,56
Dundee Utd,5947,4,15,10,11,47,41,6,55
Queen of S't,5947,5,11,10,15,44,49,-5,43
Dumbarton,5947,6,10,13,13,48,54,-6,43
Raith,5947,7,10,10,16,34,52,-18,40
St Mirren,5947,8,9,11,16,40,53,-13,38
Dunfermline,5947,9,8,13,15,42,50,-8,37
Ayr,5947,10,7,13,16,32,53,-21,34
Hibernian,5948,1,18,13,5,56,29,27,67
Morton,5948,2,17,11,8,50,35,15,62
Dundee Utd,5948,3,15,11,10,56,40,16,56
Falkirk,5948,4,14,12,10,59,47,12,54
Dumbarton,5948,5,12,11,13,55,54,1,47
Queen of S't,5948,6,12,10,14,44,48,-4,46
Dunfermline,5948,7,10,13,13,48,52,-4,43
Ayr,5948,8,10,12,14,37,55,-18,42
St Mirren,5948,9,7,12,17,35,51,-16,33
Raith,5948,10,8,9,19,34,63,-29,33
Hibernian,5949,1,20,12,4,58,24,34,72
Morton,5949,2,19,10,7,52,34,18,67
Dundee Utd,5949,3,16,9,11,53,43,10,57
Falkirk,5949,4,14,12,10,56,43,13,54
Queen of S't,5949,5,13,9,14,46,47,-1,48
Dumbarton,5949,6,10,12,14,48,56,-8,42
Raith,5949,7,10,10,16,35,49,-14,40
St Mirren,5949,8,9,12,15,41,54,-13,39
Dunfermline,5949,9,7,13,16,41,53,-12,34
Ayr,5949,10,7,11,18,35,62,-27,32
Hibernian,5950,1,19,12,5,53,24,29,69
Falkirk,5950,2,16,9,11,58,44,14,57
Dundee Utd,5950,3,15,11,10,57,44,13,56
Morton,5950,4,15,11,10,47,39,8,56
Ayr,5950,5,12,12,12,43,52,-9,48
Raith,5950,6,11,10,15,43,51,-8,43
Queen of S't,5950,7,11,10,15,46,55,-9,43
Dunfermline,5950,8,8,15,13,42,49,-7,39
Dumbarton,5950,9,9,10,17,47,61,-14,37
St Mirren,5950,10,9,10,17,43,60,-17,37
Hibernian,5951,1,18,11,7,50,24,26,65
Morton,5951,2,16,12,8,49,38,11,60
Falkirk,5951,3,15,12,9,59,38,21,57
Dundee Utd,5951,4,15,12,9,51,39,12,57
Queen of S't,5951,5,11,12,13,46,52,-6,45
Ayr,5951,6,10,13,13,39,52,-13,43
Dunfermline,5951,7,10,12,14,48,51,-3,42
St Mirren,5951,8,9,11,16,42,58,-16,38
Dumbarton,5951,9,8,13,15,45,57,-12,37
Raith,5951,10,9,10,17,34,54,-20,37
Hibernian,5952,1,19,14,3,60,27,33,71
Dundee Utd,5952,2,17,9,10,55,39,16,60
Morton,5952,3,15,13,8,45,35,10,58
Falkirk,5952,4,15,11,10,58,44,14,56
Queen of S't,5952,5,14,9,13,52,48,4,51
Dunfermline,5952,6,10,12,14,43,50,-7,42
Raith,5952,7,9,12,15,33,47,-14,39
St Mirren,5952,8,9,11,16,40,56,-16,38
Dumbarton,5952,9,8,11,17,43,59,-16,35
Ayr,5952,10,7,12,17,34,58,-24,33
Falkirk,5953,1,18,9,9,61,38,23,63
Hibernian,5953,2,17,12,7,54,31,23,63
Morton,5953,3,17,10,9,53,41,12,61
Dundee Utd,5953,4,15,10,11,44,37,7,55
Dunfermline,5953,5,10,14,12,47,46,1,44
Raith,5953,6,11,11,14,36,44,-8,44
Queen of S't,5953,7,11,10,15,43,52,-9,43
Dumbarton,5953,8,10,11,15,49,57,-8,41
St Mirren,5953,9,9,11,16,37,55,-18,38
Ayr,5953,10,7,12,17,31,54,-23,33
Hibernian,5954,1,20,13,3,62,26,36,73
Morton,5954,2,18,10,8,51,37,14,64
Dundee Utd,5954,3,16,9,11,51,39,12,57
Falkirk,5954,4,14,12,10,56,46,10,54
Queen of S't,5954,5,12,10,14,42,49,-7,46
Raith,5954,6,12,8,16,42,48,-6,44
Dunfermline,5954,7,9,14,13,46,49,-3,41
St Mirren,5954,8,9,11,16,40,54,-14,38
Dumbarton,5954,9,7,14,15,42,54,-12,35
Ayr,5954,10,7,11,18,28,58,-30,32
Hibernian,5955,1,17,12,7,54,33,21,63
Morton,5955,2,17,12,7,52,37,15,63
Falkirk,5955,3,17,11,8,60,39,21,62
Dundee Utd,5955,4,14,9,13,44,44,0,51
Dunfermline,5955,5,12,12,12,56,46,10,48
Queen of S't,5955,6,13,9,14,41,46,-5,48
St Mirren,5955,7,10,11,15,41,51,-10,41
Ayr,5955,8,9,11,16,35,53,-18,38
Raith,5955,9,9,10,17,33,54,-21,37
Dumbarton,5955,10,8,11,17,46,59,-13,35
Hibernian,5956,1,21,11,4,56,25,31,74
Morton,5956,2,17,10,9,49,34,15,61
Falkirk,5956,3,14,12,10,54,43,11,54
Dundee Utd,5956,4,14,12,10,43,36,7,54
Queen of S't,5956,5,12,8,16,45,54,-9,44
Dumbarton,5956,6,11,10,15,54,60,-6,43
Raith,5956,7,11,8,17,37,48,-11,41
Dunfermline,5956,8,9,13,14,43,47,-4,40
Ayr,5956,9,9,11,16,32,53,-21,38
St Mirren,5956,10,8,13,15,42,55,-13,37
Hibernian,5957,1,17,13,6,51,27,24,64
Falkirk,5957,2,16,12,8,54,34,20,60
Morton,5957,3,15,13,8,51,40,11,58
Dundee Utd,5957,4,15,11,10,53,40,13,56
Dunfermline,5957,5,12,13,11,47,48,-1,49
Queen of S't,5957,6,11,12,13,46,50,-4,45
Ayr,5957,7,11,12,13,37,51,-14,45
Raith,5957,8,10,9,17,34,49,-15,39
Dumbarton,5957,9,8,11,17,45,58,-13,35
St Mirren,5957,10,7,10,19,34,55,-21,31
Hibernian,5958,1,17,14,5,54,25,29,65
Falkirk,5958,2,18,10,8,62,38,24,64
Morton,5958,3,16,11,9,46,38,8,59
Dundee Utd,5958,4,15,8,13,48,47,1,53
Dunfermline,5958,5,11,13,12,50,50,0,46
Queen of S't,5958,6,11,11,14,46,50,-4,44
Raith,5958,7,11,11,14,38,49,-11,44
Dumbarton,5958,8,9,11,16,48,64,-16,38
Ayr,5958,9,8,12,16,36,55,-19,36
St Mirren,5958,10,8,11,17,40,52,-12,35
Morton,5959,1,20,11,5,56,32,24,71
Hibernian,5959,2,18,11,7,49,27,22,65
Falkirk,5959,3,17,9,10,57,39,18,60
Dundee Utd,5959,4,16,9,11,51,39,12,57
Raith,5959,5,12,10,14,39,48,-9,46
Dunfermline,5959,6,11,11,14,43,48,-5,44
Queen of S't,5959,7,11,8,17,43,51,-8,41
Dumbarton,5959,8,9,12,15,48,59,-11,39
Ayr,5959,9,7,13,16,31,53,-22,34
St Mirren,5959,10,7,10,19,37,58,-21,31
Hibernian,5960,1,18,12,6,52,28,24,66
Dundee Utd,5960,2,18,9,9,60,36,24,63
Morton,5960,3,17,12,7,48,32,16,63
Falkirk,5960,4,15,11,10,58,39,19,56
Queen of S't,5960,5,12,8,16,46,50,-4,44
Raith,5960,6,12,8,16,38,50,-12,44
Dunfermline,5960,7,10,13,13,49,50,-1,43
Dumbarton,5960,8,9,11,16,46,68,-22,38
Ayr,5960,9,7,14,15,32,55,-23,35
St Mirren,5960,10,8,10,18,39,60,-21,34
Hibernian,5961,1,20,10,6,55,26,29,70
Falkirk,5961,2,17,10,9,66,38,28,61
Dundee Utd,5961,3,17,9,10,51,39,12,60
Morton,5961,4,16,11,9,46,36,10,59
Dunfermline,5961,5,12,12,12,47,48,-1,48
Queen of S't,5961,6,11,11,14,44,49,-5,44
Raith,5961,7,11,10,15,36,45,-9,43
Dumbarton,5961,8,10,12,14,48,59,-11,42
St Mirren,5961,9,6,12,18,36,62,-26,30
Ayr,5961,10,6,11,19,33,60,-27,29
Hibernian,5962,1,20,13,3,59,25,34,73
Morton,5962,2,16,11,9,52,42,10,59
Falkirk,5962,3,15,13,8,56,37,19,58
Dundee Utd,5962,4,14,9,13,47,43,4,51
Queen of S't,5962,5,12,10,14,49,52,-3,46
Raith,5962,6,12,8,16,34,48,-14,44
Ayr,5962,7,10,12,14,40,53,-13,42
Dumbarton,5962,8,10,11,15,47,58,-11,41
Dunfermline,5962,9,9,13,14,49,53,-4,40
St Mirren,5962,10,7,10,19,35,57,-22,31
Morton,5963,1,20,11,5,56,31,25,71
Hibernian,5963,2,18,11,7,58,31,27,65
Dundee Utd,5963,3,16,12,8,50,35,15,60
Falkirk,5963,4,15,10,11,53,44,9,55
Queen of S't,5963,5,12,11,13,47,49,-2,47
Dunfermline,5963,6,10,13,13,46,46,0,43
Raith,5963,7,11,8,17,36,52,-16,41
St Mirren,5963,8,8,12,16,37,55,-18,36
Dumbarton,5963,9,8,11,17,44,61,-17,35
Ayr,5963,10,7,11,18,32,55,-23,32
Hibernian,5964,1,19,13,4,53,21,32,70
Dundee Utd,5964,2,18,9,9,53,38,15,63
Morton,5964,3,16,12,8,48,36,12,60
Falkirk,5964,4,16,11,9,58,41,17,59
Queen of S't,5964,5,12,9,15,45,50,-5,45
Raith,5964,6,11,9,16,36,46,-10,42
Dumbarton,5964,7,9,13,14,45,55,-10,40
Ayr,5964,8,8,12,16,33,57,-24,36
Dunfermline,5964,9,7,14,15,39,49,-10,35
St Mirren,5964,10,8,10,18,37,54,-17,34
Hibernian,5965,1,18,12,6,58,28,30,66
Morton,5965,2,18,11,7,54,35,19,65
Falkirk,5965,3,16,10,10,55,41,14,58
Dundee Utd,5965,4,16,9,11,49,41,8,57
Queen of S't,5965,5,12,8,16,46,56,-10,44
Raith,5965,6,12,8,16,38,50,-12,44
Ayr,5965,7,11,10,15,38,50,-12,43
Dunfermline,5965,8,9,12,15,45,56,-11,39
Dumbarton,5965,9,8,13,15,45,57,-12,37
St Mirren,5965,10,8,11,17,39,53,-14,35
Hibernian,5966,1,20,13,3,63,24,39,73
Dundee Utd,5966,2,18,9,9,57,37,20,63
Morton,5966,3,15,12,9,43,37,6,57
Falkirk,5966,4,14,12,10,55,41,14,54
Dunfermline,5966,5,11,12,13,50,47,3,45
Raith,5966,6,10,10,16,38,52,-14,40
Queen of S't,5966,7,10,10,16,43,59,-16,40
Dumbarton,5966,8,8,14,14,45,59,-14,38
Ayr,5966,9,9,11,16,37,57,-20,38
St Mirren,5966,10,7,13,16,42,60,-18,34
Hibernian,5967,1,19,12,5,57,28,29,69
Falkirk,5967,2,18,10,8,57,36,21,64
Morton,5967,3,17,12,7,54,41,13,63
Dundee Utd,5967,4,14,11,11,49,41,8,53
Raith,5967,5,12,10,14,41,50,-9,46
Queen of S't,5967,6,11,10,15,48,55,-7,43
Dumbarton,5967,7,9,12,15,44,55,-11,39
St Mirren,5967,8,9,10,17,38,51,-13,37
Ayr,5967,9,8,13,15,35,53,-18,37
Dunfermline,5967,10,7,12,17,40,53,-13,33
Morton,5968,1,18,12,6,52,37,15,66
Hibernian,5968,2,17,13,6,59,33,26,64
Falkirk,5968,3,16,10,10,60,42,18,58
Dundee Utd,5968,4,13,11,12,45,44,1,50
Dumbarton,5968,5,12,10,14,54,57,-3,46
Queen of S't,5968,6,11,11,14,40,47,-7,44
Raith,5968,7,11,9,16,39,52,-13,42
Dunfermline,5968,8,9,13,14,46,50,-4,40
Ayr,5968,9,9,13,14,38,54,-16,40
St Mirren,5968,10,7,12,17,41,58,-17,33
Hibernian,5969,1,17,15,4,51,22,29,66
Falkirk,5969,2,17,11,8,60,40,20,62
Dundee Utd,5969,3,15,12,9,48,37,11,57
Morton,5969,4,14,14,8,49,41,8,56
Dunfermline,5969,5,12,12,12,51,47,4,48
Queen of S't,5969,6,11,11,14,48,52,-4,44
Dumbarton,5969,7,8,13,15,44,55,-11,37
Ayr,5969,8,8,13,15,34,54,-20,37
Raith,5969,9,9,10,17,36,57,-21,37
St Mirren,5969,10,7,13,16,38,54,-16,34
Hibernian,5970,1,20,11,5,56,25,31,71
Morton,5970,2,17,12,7,48,33,15,63
Dundee Utd,5970,3,18,9,9,51,37,14,63
Falkirk,5970,4,15,10,11,55,48,7,55
Dunfermline,5970,5,10,12,14,44,47,-3,42
Queen of S't,5970,6,11,9,16,44,50,-6,42
Raith,5970,7,10,11,15,37,47,-10,41
Ayr,5970,8,9,12,15,32,52,-20,39
Dumbarton,5970,9,8,12,16,50,59,-9,36
St Mirren,5970,10,8,10,18,40,59,-19,34
Hibernian,5971,1,19,11,6,54,26,28,68
Morton,5971,2,18,10,8,47,32,15,64
Dundee Utd,5971,3,16,9,11,50,42,8,57
Falkirk,5971,4,15,10,11,56,45,11,55
Dunfermline,5971,5,11,11,14,45,50,-5,44
Queen of S't,5971,6,12,8,16,47,55,-8,44
Dumbarton,5971,7,10,11,15,50,56,-6,41
St Mirren,5971,8,10,10,16,44,56,-12,40
Raith,5971,9,10,10,16,38,50,-12,40
Ayr,5971,10,8,12,16,33,52,-19,36
Hibernian,5972,1,18,12,6,56,28,28,66
Dundee Utd,5972,2,17,8,11,48,40,8,59
Morton,5972,3,16,10,10,48,36,12,58
Falkirk,5972,4,15,10,11,56,41,15,55
Queen of S't,5972,5,12,9,15,43,51,-8,45
Dunfermline,5972,6,11,11,14,44,46,-2,44
Raith,5972,7,10,12,14,35,46,-11,42
Dumbarton,5972,8,10,11,15,50,58,-8,41
St Mirren,5972,9,9,12,15,39,54,-15,39
Ayr,5972,10,9,11,16,31,50,-19,38
Hibernian,5973,1,21,11,4,60,21,39,74
Falkirk,5973,2,17,10,9,61,39,22,61
Dundee Utd,5973,3,16,11,9,51,41,10,59
Morton,5973,4,15,13,8,48,39,9,58
Dunfermline,5973,5,8,15,13,44,53,-9,39
Queen of S't,5973,6,9,12,15,41,54,-13,39
Ayr,5973,7,9,12,15,39,55,-16,39
Dumbarton,5973,8,8,14,14,50,58,-8,38
Raith,5973,9,9,11,16,35,50,-15,38
St Mirren,5973,10,8,11,17,37,56,-19,35
Hibernian,5974,1,18,15,3,56,24,32,69
Morton,5974,2,17,10,9,51,37,14,61
Falkirk,5974,3,14,12,10,58,46,12,54
Dundee Utd,5974,4,14,10,12,48,41,7,52
Dunfermline,5974,5,10,15,11,45,44,1,45
Queen of S't,5974,6,11,11,14,45,51,-6,44
Raith,5974,7,11,11,14,38,50,-12,44
St Mirren,5974,8,9,11,16,46,58,-12,38
Dumbarton,5974,9,8,12,16,43,59,-16,36
Ayr,5974,10,7,15,14,33,53,-20,36
Hibernian,5975,1,19,12,5,55,25,30,69
Falkirk,5975,2,17,11,8,62,37,25,62
Morton,5975,3,16,12,8,48,35,13,60
Dundee Utd,5975,4,16,9,11,50,44,6,57
Dunfermline,5975,5,11,13,12,48,47,1,46
Queen of S't,5975,6,10,11,15,43,52,-9,41
Dumbarton,5975,7,9,13,14,46,56,-10,40
St Mirren,5975,8,9,10,17,38,54,-16,37
Raith,5975,9,8,13,15,30,48,-18,37
Ayr,5975,10,7,12,17,31,53,-22,33
Hibernian,5976,1,19,13,4,54,23,31,70
Dundee Utd,5976,2,18,10,8,57,36,21,64
Falkirk,5976,3,15,11,10,58,43,15,56
Morton,5976,4,13,12,11,46,42,4,51
Dunfermline,5976,5,13,12,11,49,46,3,51
Queen of S't,5976,6,12,10,14,47,51,-4,46
Dumbarton,5976,7,9,12,15,47,62,-15,39
Raith,5976,8,9,10,17,37,52,-15,37
St Mirren,5976,9,7,13,16,35,54,-19,34
Ayr,5976,10,7,13,16,32,53,-21,34
Hibernian,5977,1,21,12,3,62,22,40,75
Morton,5977,2,17,11,8,53,36,17,62
Falkirk,5977,3,16,10,10,58,40,18,58
Dundee Utd,5977,4,16,10,10,53,38,15,58
Queen of S't,5977,5,12,9,15,48,54,-6,45
Dunfermline,5977,6,11,11,14,45,47,-2,44
Dumbarton,5977,7,10,11,15,48,62,-14,41
Raith,5977,8,9,9,18,35,55,-20,36
Ayr,5977,9,7,13,16,33,60,-27,34
St Mirren,5977,10,7,12,17,39,60,-21,33
Hibernian,5978,1,22,11,3,58,23,35,77
Dundee Utd,5978,2,17,8,11,53,39,14,59
Falkirk,5978,3,15,11,10,60,48,12,56
Morton,5978,4,15,11,10,47,40,7,56
Queen of S't,5978,5,12,11,13,49,48,1,47
Raith,5978,6,10,11,15,34,48,-14,41
Dunfermline,5978,7,9,12,15,45,49,-4,39
Ayr,5978,8,9,12,15,38,54,-16,39
Dumbarton,5978,9,8,12,16,50,64,-14,36
St Mirren,5978,10,9,9,18,40,61,-21,36
Hibernian,5979,1,19,12,5,52,28,24,69
Falkirk,5979,2,16,11,9,60,42,18,59
Morton,5979,3,16,11,9,52,37,15,59
Dundee Utd,5979,4,16,9,11,52,42,10,57
Queen of S't,5979,5,11,9,16,45,52,-7,42
Dumbarton,5979,6,10,12,14,46,54,-8,42
Raith,5979,7,11,9,16,37,48,-11,42
Dunfermline,5979,8,9,14,13,45,52,-7,41
Ayr,5979,9,9,11,16,36,54,-18,38
St Mirren,5979,10,9,10,17,39,55,-16,37
Hibernian,5980,1,20,13,3,57,24,33,73
Dundee Utd,5980,2,16,11,9,51,39,12,59
Morton,5980,3,16,10,10,49,37,12,58
Falkirk,5980,4,15,10,11,60,44,16,55
Queen of S't,5980,5,12,9,15,44,47,-3,45
Dunfermline,5980,6,10,13,13,46,50,-4,43
Raith,5980,7,11,9,16,35,50,-15,42
St Mirren,5980,8,10,10,16,43,55,-12,40
Dumbarton,5980,9,9,11,16,44,57,-13,38
Ayr,5980,10,6,14,16,33,59,-26,32
Hibernian,5981,1,18,11,7,56,32,24,65
Morton,5981,2,17,10,9,49,40,9,61
Falkirk,5981,3,16,10,10,55,40,15,58
Dundee Utd,5981,4,16,10,10,50,39,11,58
Queen of S't,5981,5,14,9,13,52,48,4,51
Dunfermline,5981,6,11,12,13,47,46,1,45
Dumbarton,5981,7,11,11,14,52,61,-9,44
Ayr,5981,8,9,12,15,41,59,-18,39
Raith,5981,9,9,9,18,36,52,-16,36
St Mirren,5981,10,7,10,19,37,58,-21,31
Hibernian,5982,1,21,11,4,59,24,35,74
Morton,5982,2,17,12,7,50,34,16,63
Falkirk,5982,3,17,10,9,57,40,17,61
Dundee Utd,5982,4,15,9,12,48,42,6,54
Queen of S't,5982,5,12,10,14,50,53,-3,46
Dunfermline,5982,6,11,12,13,46,49,-3,45
Dumbarton,5982,7,10,12,14,50,55,-5,42
Ayr,5982,8,9,11,16,33,54,-21,38
Raith,5982,9,9,10,17,34,50,-16,37
St Mirren,5982,10,6,9,21,33,59,-26,27
Hibernian,5983,1,19,12,5,52,27,25,69
Morton,5983,2,17,12,7,51,35,16,63
Dundee Utd,5983,3,16,11,9,52,39,13,59
Falkirk,5983,4,14,11,11,54,44,10,53
Raith,5983,5,12,10,14,41,48,-7,46
Dunfermline,5983,6,9,15,12,46,48,-2,42
Queen of S't,5983,7,10,11,15,46,53,-7,41
Ayr,5983,8,9,13,14,35,50,-15,40
Dumbarton,5983,9,8,12,16,46,61,-15,36
St Mirren,5983,10,8,9,19,41,59,-18,33
Hibernian,5984,1,19,11,6,55,27,28,68
Dundee Utd,5984,2,18,9,9,56,39,17,63
Falkirk,5984,3,17,10,9,66,42,24,61
Morton,5984,4,16,9,11,51,42,9,57
Dunfermline,5984,5,11,11,14,46,49,-3,44
Raith,5984,6,12,8,16,37,49,-12,44
Queen of S't,5984,7,11,9,16,45,56,-11,42
Dumbarton,5984,8,10,10,16,51,60,-9,40
Ayr,5984,9,9,12,15,33,53,-20,39
St Mirren,5984,10,8,9,19,39,62,-23,33
Hibernian,5985,1,22,11,3,61,25,36,77
Morton,5985,2,17,10,9,50,39,11,61
Falkirk,5985,3,15,12,9,56,39,17,57
Dundee Utd,5985,4,15,9,12,50,43,7,54
Raith,5985,5,11,11,14,35,45,-10,44
Queen of S't,5985,6,11,10,15,47,53,-6,43
Dumbarton,5985,7,9,13,14,55,61,-6,40
Dunfermline,5985,8,8,13,15,43,52,-9,37
Ayr,5985,9,8,12,16,36,59,-23,36
St Mirren,5985,10,8,11,17,38,55,-17,35
Hibernian,5986,1,20,10,6,56,27,29,70
Dundee Utd,5986,2,17,10,9,54,35,19,61
Morton,5986,3,16,11,9,49,40,9,59
Falkirk,5986,4,15,12,9,58,41,17,57
Dunfermline,5986,5,13,12,11,50,47,3,51
Queen of S't,5986,6,11,11,14,43,48,-5,44
Dumbarton,5986,7,8,14,14,46,55,-9,38
St Mirren,5986,8,8,12,16,41,56,-15,36
Raith,5986,9,8,11,17,34,54,-20,35
Ayr,5986,10,6,13,17,30,58,-28,31
Hibernian,5987,1,20,10,6,57,31,26,70
Dundee Utd,5987,2,17,10,9,56,42,14,61
Morton,5987,3,16,12,8,50,39,11,60
Falkirk,5987,4,15,11,10,56,43,13,56
Dunfermline,5987,5,11,15,10,57,49,8,48
Queen of S't,5987,6,13,8,15,54,51,3,47
Raith,5987,7,10,9,17,32,50,-18,39
Dumbarton,5987,8,8,12,16,45,58,-13,36
St Mirren,5987,9,8,12,16,42,61,-19,36
Ayr,5987,10,7,11,18,34,59,-25,32
Morton,5988,1,20,10,6,56,33,23,70
Hibernian,5988,2,17,12,7,49,25,24,63
Falkirk,5988,3,15,14,7,58,39,19,59
Dundee Utd,5988,4,15,13,8,51,40,11,58
Queen of S't,5988,5,13,9,14,45,48,-3,48
Dunfermline,5988,6,11,11,14,49,50,-1,44
St Mirren,5988,7,9,11,16,41,55,-14,38
Raith,5988,8,9,9,18,32,52,-20,36
Ayr,5988,9,8,11,17,36,57,-21,35
Dumbarton,5988,10,7,12,17,43,61,-18,33
Hibernian,5989,1,19,12,5,56,29,27,69
Dundee Utd,5989,2,17,9,10,54,43,11,60
Falkirk,5989,3,16,11,9,60,43,17,59
Morton,5989,4,16,10,10,50,40,10,58
Queen of S't,5989,5,12,9,15,44,47,-3,45
Ayr,5989,6,11,12,13,37,51,-14,45
Dunfermline,5989,7,9,13,14,43,48,-5,40
Dumbarton,5989,8,9,11,16,52,63,-11,38
Raith,5989,9,9,10,17,31,46,-15,37
St Mirren,5989,10,9,9,18,42,59,-17,36
Hibernian,5990,1,19,11,6,60,31,29,68
Morton,5990,2,18,10,8,49,32,17,64
Dundee Utd,5990,3,16,10,10,52,42,10,58
Falkirk,5990,4,14,11,11,55,43,12,53
Queen of S't,5990,5,13,9,14,52,53,-1,48
Dumbarton,5990,6,11,11,14,52,57,-5,44
Raith,5990,7,11,11,14,41,48,-7,44
Dunfermline,5990,8,10,12,14,47,51,-4,42
St Mirren,5990,9,8,11,17,43,63,-20,35
Ayr,5990,10,7,10,19,29,60,-31,31
Hibernian,5991,1,18,13,5,51,28,23,67
Dundee Utd,5991,2,18,10,8,53,37,16,64
Falkirk,5991,3,16,12,8,55,35,20,60
Morton,5991,4,15,12,9,49,40,9,57
Raith,5991,5,12,9,15,33,45,-12,45
Dunfermline,5991,6,10,11,15,49,48,1,41
St Mirren,5991,7,9,12,15,41,48,-7,39
Queen of S't,5991,8,10,8,18,44,59,-15,38
Ayr,5991,9,8,14,14,38,57,-19,38
Dumbarton,5991,10,8,11,17,47,63,-16,35
Hibernian,5992,1,19,13,4,55,25,30,70
Falkirk,5992,2,17,11,8,60,41,19,62
Morton,5992,3,16,13,7,50,35,15,61
Dundee Utd,5992,4,15,12,9,48,37,11,57
Queen of S't,5992,5,12,9,15,43,50,-7,45
Dunfermline,5992,6,9,13,14,42,50,-8,40
Raith,5992,7,10,9,17,37,53,-16,39
Ayr,5992,8,8,13,15,35,53,-18,37
Dumbarton,5992,9,8,12,16,45,55,-10,36
St Mirren,5992,10,7,13,16,36,52,-16,34
Hibernian,5993,1,17,13,6,50,27,23,64
Morton,5993,2,18,10,8,53,36,17,64
Falkirk,5993,3,17,12,7,57,37,20,63
Dundee Utd,5993,4,14,10,12,48,44,4,52
Ayr,5993,5,11,12,13,36,48,-12,45
Dunfermline,5993,6,10,12,14,46,49,-3,42
Queen of S't,5993,7,11,8,17,41,54,-13,41
Dumbarton,5993,8,9,12,15,47,57,-10,39
Raith,5993,9,10,9,17,40,50,-10,39
St Mirren,5993,10,8,12,16,41,57,-16,36
Hibernian,5994,1,19,12,5,54,28,26,69
Dundee Utd,5994,2,15,11,10,52,41,11,56
Morton,5994,3,14,14,8,45,37,8,56
Falkirk,5994,4,15,10,11,56,42,14,55
St Mirren,5994,5,12,10,14,47,54,-7,46
Dumbarton,5994,6,11,11,14,54,58,-4,44
Dunfermline,5994,7,10,14,12,49,53,-4,44
Queen of S't,5994,8,10,9,17,41,51,-10,39
Raith,5994,9,9,10,17,32,48,-16,37
Ayr,5994,10,7,15,14,35,53,-18,36
Hibernian,5995,1,20,12,4,59,22,37,72
Dundee Utd,5995,2,17,9,10,56,40,16,60
Morton,5995,3,16,12,8,48,36,12,60
Falkirk,5995,4,16,10,10,61,45,16,58
St Mirren,5995,5,10,11,15,43,51,-8,41
Dunfermline,5995,6,9,13,14,48,49,-1,40
Queen of S't,5995,7,9,13,14,44,59,-15,40
Dumbarton,5995,8,9,12,15,45,60,-15,39
Raith,5995,9,9,10,17,33,51,-18,37
Ayr,5995,10,8,12,16,30,54,-24,36
Hibernian,5996,1,18,14,4,57,29,28,68
Dundee Utd,5996,2,16,12,8,63,44,19,60
Morton,5996,3,14,13,9,42,37,5,55
Falkirk,5996,4,14,11,11,58,44,14,53
Queen of S't,5996,5,13,9,14,47,50,-3,48
Dunfermline,5996,6,10,14,12,55,52,3,44
Raith,5996,7,11,9,16,39,56,-17,42
Ayr,5996,8,9,13,14,41,58,-17,40
Dumbarton,5996,9,9,12,15,47,59,-12,39
St Mirren,5996,10,7,11,18,41,61,-20,32
Hibernian,5997,1,19,13,4,54,24,30,70
Morton,5997,2,18,10,8,49,37,12,64
Falkirk,5997,3,15,11,10,52,39,13,56
Dundee Utd,5997,4,14,12,10,50,43,7,54
Queen of S't,5997,5,12,10,14,51,53,-2,46
Dunfermline,5997,6,9,14,13,48,52,-4,41
Raith,5997,7,10,10,16,38,49,-11,40
Dumbarton,5997,8,9,12,15,50,58,-8,39
St Mirren,5997,9,8,12,16,38,54,-16,36
Ayr,5997,10,8,12,16,40,61,-21,36
Hibernian,5998,1,17,15,4,54,27,27,66
Morton,5998,2,18,11,7,55,35,20,65
Falkirk,5998,3,16,11,9,61,43,18,59
Dundee Utd,5998,4,16,10,10,55,41,14,58
Queen of S't,5998,5,12,11,13,42,44,-2,47
Raith,5998,6,11,11,14,37,46,-9,44
Dumbarton,5998,7,9,12,15,45,57,-12,39
Dunfermline,5998,8,7,14,15,39,47,-8,35
St Mirren,5998,9,8,10,18,40,61,-21,34
Ayr,5998,10,7,13,16,35,62,-27,34
Hibernian,5999,1,22,11,3,56,20,36,77
Falkirk,5999,2,17,9,10,57,38,19,60
Morton,5999,3,16,12,8,49,36,13,60
Dundee Utd,5999,4,16,11,9,49,37,12,59
Queen of S't,5999,5,12,9,15,46,52,-6,45
Dunfermline,5999,6,10,13,13,46,49,-3,43
Dumbarton,5999,7,10,11,15,48,55,-7,41
Raith,5999,8,9,10,17,35,50,-15,37
St Mirren,5999,9,8,12,16,36,52,-16,36
Ayr,5999,10,6,10,20,28,61,-33,28
Hibernian,6000,1,21,10,5,60,27,33,73
Morton,6000,2,17,9,10,57,41,16,60
Falkirk,6000,3,16,10,10,58,39,19,58
Dundee Utd,6000,4,16,9,11,54,45,9,57
Queen of S't,6000,5,14,9,13,49,47,2,51
Raith,6000,6,12,9,15,38,49,-11,45
Dunfermline,6000,7,10,12,14,48,55,-7,42
Dumbarton,6000,8,9,11,16,49,60,-11,38
St Mirren,6000,9,8,9,19,38,62,-24,33
Ayr,6000,10,7,12,17,33,59,-26,33
Hibernian,6001,1,20,11,5,56,27,29,71
Morton,6001,2,17,11,8,54,41,13,62
Falkirk,6001,3,17,10,9,57,36,21,61
Dundee Utd,6001,4,15,10,11,48,40,8,55
Queen of S't,6001,5,12,9,15,51,52,-1,45
Raith,6001,6,12,9,15,38,46,-8,45
Dumbarton,6001,7,9,12,15,46,60,-14,39
St Mirren,6001,8,10,9,17,37,55,-18,39
Dunfermline,6001,9,8,12,16,47,51,-4,36
Ayr,6001,10,7,13,16,30,56,-26,34
Hibernian,6002,1,20,11,5,57,21,36,71
Morton,6002,2,17,13,6,49,33,16,64
Falkirk,6002,3,18,9,9,65,40,25,63
Dundee Utd,6002,4,14,8,14,45,42,3,50
Dunfermline,6002,5,11,13,12,47,48,-1,46
Dumbarton,6002,6,11,11,14,53,60,-7,44
Queen of S't,6002,7,10,11,15,45,54,-9,41
St Mirren,6002,8,9,11,16,38,55,-17,38
Raith,6002,9,10,8,18,35,54,-19,38
Ayr,6002,10,6,13,17,28,55,-27,31
Hibernian,6003,1,17,14,5,53,30,23,65
Morton,6003,2,17,11,8,49,34,15,62
Falkirk,6003,3,17,10,9,64,39,25,61
Dundee Utd,6003,4,16,11,9,53,36,17,59
Queen of S't,6003,5,13,9,14,43,48,-5,48
Dunfermline,6003,6,10,15,11,45,45,0,45
St Mirren,6003,7,9,10,17,41,57,-16,37
Raith,6003,8,9,10,17,30,46,-16,37
Ayr,6003,9,8,12,16,30,56,-26,36
Dumbarton,6003,10,7,12,17,45,62,-17,33
Hibernian,6004,1,20,11,5,58,25,33,71
Morton,6004,2,18,9,9,50,39,11,63
Dundee Utd,6004,3,17,9,10,52,35,17,60
Falkirk,6004,4,15,10,11,53,41,12,55
Queen of S't,6004,5,13,9,14,45,48,-3,48
Dumbarton,6004,6,11,10,15,48,54,-6,43
Raith,6004,7,11,10,15,43,50,-7,43
St Mirren,6004,8,9,10,17,37,56,-19,37
Dunfermline,6004,9,8,12,16,40,54,-14,36
Ayr,6004,10,7,12,17,33,57,-24,33
Hibernian,6005,1,20,11,5,56,24,32,71
Morton,6005,2,16,12,8,45,34,11,60
Falkirk,6005,3,16,10,10,62,42,20,58
Dundee Utd,6005,4,15,11,10,43,35,8,56
Queen of S't,6005,5,12,10,14,45,52,-7,46
St Mirren,6005,6,11,10,15,46,52,-6,43
Dumbarton,6005,7,10,11,15,48,55,-7,41
Dunfermline,6005,8,8,14,14,43,49,-6,38
Ayr,6005,9,7,16,13,31,49,-18,37
Raith,6005,10,8,9,19,30,57,-27,33
Hibernian,6006,1,18,13,5,53,28,25,67
Morton,6006,2,16,13,7,52,36,16,61
Falkirk,6006,3,15,14,7,55,36,19,59
Dundee Utd,6006,4,16,10,10,50,42,8,58
Dunfermline,6006,5,10,15,11,48,48,0,45
Raith,6006,6,11,10,15,36,47,-11,43
Queen of S't,6006,7,11,9,16,47,56,-9,42
Dumbarton,6006,8,9,11,16,47,58,-11,38
Ayr,6006,9,8,11,17,30,51,-21,35
St Mirren,6006,10,8,10,18,41,57,-16,34
Hibernian,6007,1,16,15,5,52,28,24,63
Morton,6007,2,17,12,7,53,37,16,63
Falkirk,6007,3,17,11,8,64,44,20,62
Dundee Utd,6007,4,16,9,11,50,40,10,57
Queen of S't,6007,5,12,10,14,46,47,-1,46
Dunfermline,6007,6,9,15,12,44,48,-4,42
Raith,6007,7,10,9,17,35,49,-14,39
Ayr,6007,8,9,12,15,34,55,-21,39
Dumbarton,6007,9,8,12,16,47,60,-13,36
St Mirren,6007,10,8,11,17,41,58,-17,35
Hibernian,6008,1,20,10,6,58,28,30,70
Morton,6008,2,18,12,6,56,33,23,66
Dundee Utd,6008,3,19,8,9,57,37,20,65
Falkirk,6008,4,15,10,11,56,46,10,55
Dunfermline,6008,5,11,11,14,46,55,-9,44
Queen of S't,6008,6,10,10,16,42,55,-13,40
Dumbarton,6008,7,8,13,15,45,57,-12,37
St Mirren,6008,8,9,10,17,43,58,-15,37
Raith,6008,9,9,10,17,36,52,-16,37
Ayr,6008,10,7,14,15,36,54,-18,35
Hibernian,6009,1,19,12,5,58,28,30,69
Falkirk,6009,2,18,9,9,65,41,24,63
Dundee Utd,6009,3,17,8,11,55,43,12,59
Morton,6009,4,15,13,8,51,39,12,58
Queen of S't,6009,5,14,8,14,50,47,3,50
Raith,6009,6,12,9,15,40,51,-11,45
Dunfermline,6009,7,9,13,14,47,52,-5,40
St Mirren,6009,8,9,10,17,40,55,-15,37
Dumbarton,6009,9,7,13,16,44,66,-22,34
Ayr,6009,10,7,11,18,32,60,-28,32
Hibernian,6010,1,19,13,4,53,24,29,70
Falkirk,6010,2,17,12,7,58,33,25,63
Dundee Utd,6010,3,17,10,9,51,36,15,61
Morton,6010,4,15,13,8,52,37,15,58
Queen of S't,6010,5,12,11,13,47,48,-1,47
Dunfermline,6010,6,9,13,14,47,50,-3,40
Raith,6010,7,9,11,16,32,49,-17,38
Dumbarton,6010,8,8,12,16,45,64,-19,36
Ayr,6010,9,7,14,15,30,52,-22,35
St Mirren,6010,10,7,11,18,35,57,-22,32
Morton,6011,1,20,10,6,54,31,23,70
Falkirk,6011,2,16,13,7,64,42,22,61
Hibernian,6011,3,16,13,7,50,32,18,61
Dundee Utd,6011,4,16,10,10,52,40,12,58
Queen of S't,6011,5,12,11,13,49,50,-1,47
Dunfermline,6011,6,10,11,15,46,50,-4,41
Raith,6011,7,10,10,16,34,52,-18,40
St Mirren,6011,8,9,10,17,42,55,-13,37
Ayr,6011,9,8,13,15,32,54,-22,37
Dumbarton,6011,10,7,11,18,47,64,-17,32
Hibernian,6012,1,19,13,4,57,24,33,70
Morton,6012,2,15,13,8,49,37,12,58
Falkirk,6012,3,15,11,10,57,41,16,56
Dundee Utd,6012,4,14,11,11,50,44,6,53
Dumbarton,6012,5,13,10,13,55,58,-3,49
Queen of S't,6012,6,12,12,12,44,44,0,48
Ayr,6012,7,10,10,16,39,55,-16,40
Dunfermline,6012,8,8,15,13,43,48,-5,39
Raith,6012,9,9,9,18,32,56,-24,36
St Mirren,6012,10,8,10,18,39,58,-19,34
Hibernian,6013,1,21,11,4,60,27,33,74
Falkirk,6013,2,19,9,8,64,41,23,66
Morton,6013,3,17,10,9,50,39,11,61
Dundee Utd,6013,4,15,9,12,49,41,8,54
Dunfermline,6013,5,11,11,14,46,49,-3,44
Dumbarton,6013,6,10,11,15,50,55,-5,41
Raith,6013,7,10,11,15,33,46,-13,41
Queen of S't,6013,8,9,10,17,39,52,-13,37
St Mirren,6013,9,8,11,17,44,62,-18,35
Ayr,6013,10,7,13,16,33,56,-23,34
Hibernian,6014,1,18,14,4,55,24,31,68
Dundee Utd,6014,2,16,10,10,56,39,17,58
Falkirk,6014,3,15,12,9,58,41,17,57
Morton,6014,4,15,12,9,44,38,6,57
Raith,6014,5,13,8,15,36,46,-10,47
Queen of S't,6014,6,11,10,15,46,56,-10,43
Dunfermline,6014,7,9,13,14,48,53,-5,40
Dumbarton,6014,8,9,12,15,49,63,-14,39
St Mirren,6014,9,9,11,16,40,52,-12,38
Ayr,6014,10,8,12,16,34,54,-20,36
Hibernian,6015,1,19,12,5,59,31,28,69
Falkirk,6015,2,18,10,8,59,37,22,64
Dundee Utd,6015,3,17,9,10,55,43,12,60
Morton,6015,4,15,12,9,57,47,10,57
Dunfermline,6015,5,10,12,14,45,51,-6,42
Raith,6015,6,11,9,16,36,49,-13,42
Ayr,6015,7,10,12,14,38,55,-17,42
Dumbarton,6015,8,10,11,15,46,53,-7,41
Queen of S't,6015,9,10,9,17,42,51,-9,39
St Mirren,6015,10,7,10,19,38,58,-20,31
Hibernian,6016,1,17,13,6,56,28,28,64
Morton,6016,2,17,10,9,50,35,15,61
Falkirk,6016,3,15,11,10,60,46,14,56
Dundee Utd,6016,4,14,12,10,46,41,5,54
Dunfermline,6016,5,11,12,13,45,48,-3,45
Dumbarton,6016,6,11,11,14,49,53,-4,44
Raith,6016,7,10,12,14,38,47,-9,42
Queen of S't,6016,8,10,10,16,45,56,-11,40
St Mirren,6016,9,9,11,16,42,59,-17,38
Ayr,6016,10,8,14,14,35,53,-18,38
Morton,6017,1,20,10,6,53,34,19,70
Hibernian,6017,2,18,13,5,54,25,29,67
Dundee Utd,6017,3,17,9,10,52,40,12,60
Falkirk,6017,4,16,11,9,60,40,20,59
Ayr,6017,5,11,10,15,40,55,-15,43
Dunfermline,6017,6,9,12,15,41,51,-10,39
St Mirren,6017,7,9,11,16,47,58,-11,38
Queen of S't,6017,8,10,8,18,41,56,-15,38
Raith,6017,9,9,10,17,36,52,-16,37
Dumbarton,6017,10,8,12,16,46,59,-13,36
Hibernian,6018,1,17,13,6,52,28,24,64
Falkirk,6018,2,17,11,8,62,39,23,62
Dundee Utd,6018,3,16,11,9,51,38,13,59
Morton,6018,4,15,12,9,47,38,9,57
Dunfermline,6018,5,11,12,13,47,49,-2,45
Queen of S't,6018,6,11,10,15,42,52,-10,43
Raith,6018,7,10,10,16,36,50,-14,40
Dumbarton,6018,8,9,12,15,50,63,-13,39
Ayr,6018,9,8,13,15,37,54,-17,37
St Mirren,6018,10,8,12,16,41,54,-13,36
Hibernian,6019,1,19,14,3,59,21,38,71
Morton,6019,2,15,14,7,50,35,15,59
Falkirk,6019,3,16,9,11,56,41,15,57
Dundee Utd,6019,4,14,12,10,51,45,6,54
Queen of S't,6019,5,12,9,15,43,56,-13,45
Ayr,6019,6,9,15,12,35,48,-13,42
Dunfermline,6019,7,9,14,13,43,48,-5,41
St Mirren,6019,8,9,12,15,39,51,-12,39
Dumbarton,6019,9,8,13,15,47,57,-10,37
Raith,6019,10,8,10,18,32,53,-21,34
Hibernian,6020,1,18,13,5,54,27,27,67
Morton,6020,2,18,10,8,49,35,14,64
Dundee Utd,6020,3,17,10,9,53,38,15,61
Falkirk,6020,4,15,10,11,59,45,14,55
Raith,6020,5,11,11,14,38,49,-11,44
St Mirren,6020,6,10,10,16,38,50,-12,40
Dunfermline,6020,7,9,12,15,44,49,-5,39
Dumbarton,6020,8,9,12,15,46,56,-10,39
Queen of S't,6020,9,10,9,17,44,57,-13,39
Ayr,6020,10,9,11,16,35,54,-19,38
Hibernian,6021,1,16,15,5,51,28,23,63
Dundee Utd,6021,2,17,9,10,60,43,17,60
Morton,6021,3,16,12,8,48,39,9,60
Falkirk,6021,4,14,10,12,56,48,8,52
Queen of S't,6021,5,12,10,14,46,47,-1,46
Dumbarton,6021,6,10,13,13,50,56,-6,43
Ayr,6021,7,10,12,14,34,51,-17,42
Raith,6021,8,10,11,15,36,46,-10,41
Dunfermline,6021,9,9,13,14,42,48,-6,40
St Mirren,6021,10,7,13,16,37,54,-17,34
Hibernian,6022,1,18,11,7,52,27,25,65
Morton,6022,2,18,11,7,50,34,16,65
Falkirk,6022,3,17,10,9,57,39,18,61
Dundee Utd,6022,4,17,10,9,51,39,12,61
Queen of S't,6022,5,12,8,16,48,54,-6,44
Dunfermline,6022,6,10,13,13,45,46,-1,43
Ayr,6022,7,10,11,15,39,56,-17,41
Raith,6022,8,9,11,16,38,51,-13,38
Dumbarton,6022,9,8,11,17,45,62,-17,35
St Mirren,6022,10,8,10,18,39,56,-17,34
Hibernian,6023,1,18,13,5,53,25,28,67
Morton,6023,2,16,13,7,50,34,16,61
Dundee Utd,6023,3,16,9,11,59,48,11,57
Falkirk,6023,4,15,10,11,58,47,11,55
Queen of S't,6023,5,13,10,13,53,52,1,49
Dunfermline,6023,6,11,12,13,52,52,0,45
St Mirren,6023,7,11,10,15,47,54,-7,43
Raith,6023,8,10,9,17,35,53,-18,39
Dumbarton,6023,9,8,12,16,51,65,-14,36
Ayr,6023,10,7,12,17,32,60,-28,33
Hibernian,6024,1,21,10,5,57,25,32,73
Morton,6024,2,18,11,7,50,34,16,65
Falkirk,6024,3,15,13,8,56,39,17,58
Dundee Utd,6024,4,13,11,12,45,40,5,50
Dunfermline,6024,5,9,14,13,46,48,-2,41
Dumbarton,6024,6,10,11,15,45,58,-13,41
Ayr,6024,7,10,11,15,34,54,-20,41
Queen of S't,6024,8,10,10,16,46,52,-6,40
Raith,6024,9,8,13,15,34,50,-16,37
St Mirren,6024,10,8,12,16,40,53,-13,36
Hibernian,6025,1,19,13,4,57,23,34,70
Dundee Utd,6025,2,18,9,9,49,36,13,63
Morton,6025,3,16,11,9,48,36,12,59
Falkirk,6025,4,15,11,10,60,50,10,56
Dunfermline,6025,5,11,13,12,49,47,2,46
Queen of S't,6025,6,11,9,16,43,54,-11,42
Dumbarton,6025,7,9,13,14,49,54,-5,40
St Mirren,6025,8,10,10,16,44,56,-12,40
Raith,6025,9,9,9,18,35,51,-16,36
Ayr,6025,10,8,10,18,33,60,-27,34
Hibernian,6026,1,18,13,5,55,29,26,67
Falkirk,6026,2,17,12,7,59,36,23,63
Dundee Utd,6026,3,16,12,8,50,35,15,60
Morton,6026,4,15,12,9,51,39,12,57
Queen of S't,6026,5,11,10,15,41,48,-7,43
Dumbarton,6026,6,10,11,15,48,56,-8,41
Raith,6026,7,10,11,15,34,47,-13,41
Dunfermline,6026,8,9,13,14,43,48,-5,40
St Mirren,6026,9,8,12,16,43,58,-15,36
Ayr,6026,10,6,14,16,34,62,-28,32
Hibernian,6027,1,18,15,3,56,26,30,69
Morton,6027,2,18,10,8,57,39,18,64
Falkirk,6027,3,15,11,10,56,39,17,56
Queen of S't,6027,4,14,10,12,52,45,7,52
Dundee Utd,6027,5,13,12,11,50,44,6,51
Dunfermline,6027,6,10,14,12,48,51,-3,44
St Mirren,6027,7,9,12,15,47,59,-12,39
Dumbarton,6027,8,9,10,17,48,65,-17,37
Raith,6027,9,8,11,17,34,54,-20,35
Ayr,6027,10,7,13,16,31,57,-26,34
Hibernian,6028,1,21,12,3,56,23,33,75
Morton,6028,2,17,11,8,48,36,12,62
Dundee Utd,6028,3,17,10,9,54,41,13,61
Falkirk,6028,4,14,10,12,59,47,12,52
Dunfermline,6028,5,11,14,11,49,47,2,47
Queen of S't,6028,6,12,9,15,47,50,-3,45
Ayr,6028,7,10,10,16,36,51,-15,40
St Mirren,6028,8,8,12,16,40,54,-14,36
Dumbarton,6028,9,8,12,16,47,62,-15,36
Raith,6028,10,8,8,20,34,59,-25,32
Hibernian,6029,1,20,10,6,53,24,29,70
Falkirk,6029,2,17,11,8,58,36,22,62
Dundee Utd,6029,3,18,8,10,56,43,13,62
Morton,6029,4,17,11,8,47,36,11,62
Queen of S't,6029,5,13,9,14,48,50,-2,48
Raith,6029,6,10,11,15,36,46,-10,41
Dunfermline,6029,7,8,14,14,44,53,-9,38
Dumbarton,6029,8,8,13,15,44,57,-13,37
Ayr,6029,9,7,12,17,31,55,-24,33
St Mirren,6029,10,7,11,18,40,57,-17,32
Hibernian,6030,1,19,13,4,67,27,40,70
Morton,6030,2,17,11,8,51,42,9,62
Falkirk,6030,3,16,12,8,56,37,19,60
Dundee Utd,6030,4,13,11,12,47,43,4,50
Dunfermline,6030,5,10,13,13,50,49,1,43
Dumbarton,6030,6,10,12,14,51,58,-7,42
Ayr,6030,7,10,12,14,40,57,-17,42
Queen of S't,6030,8,10,11,15,43,53,-10,41
Raith,6030,9,9,12,15,36,51,-15,39
St Mirren,6030,10,7,11,18,36,60,-24,32
Hibernian,6031,1,22,11,3,62,24,38,77
Morton,6031,2,15,12,9,47,36,11,57
Falkirk,6031,3,14,12,10,56,45,11,54
Dundee Utd,6031,4,13,11,12,48,46,2,50
Dunfermline,6031,5,11,14,11,49,47,2,47
St Mirren,6031,6,12,9,15,49,53,-4,45
Queen of S't,6031,7,11,9,16,43,50,-7,42
Dumbarton,6031,8,9,13,14,52,62,-10,40
Raith,6031,9,10,10,16,35,48,-13,40
Ayr,6031,10,7,11,18,33,63,-30,32
Hibernian,6032,1,20,12,4,65,28,37,72
Morton,6032,2,17,10,9,50,38,12,61
Falkirk,6032,3,17,9,10,60,41,19,60
Dundee Utd,6032,4,16,10,10,49,38,11,58
Raith,6032,5,13,8,15,39,48,-9,47
Dunfermline,6032,6,9,14,13,42,45,-3,41
Queen of S't,6032,7,11,8,17,45,55,-10,41
Ayr,6032,8,9,11,16,36,62,-26,38
St Mirren,6032,9,8,11,17,42,56,-14,35
Dumbarton,6032,10,8,11,17,42,59,-17,35
Hibernian,6033,1,21,12,3,61,23,38,75
Morton,6033,2,17,13,6,56,37,19,64
Dundee Utd,6033,3,16,9,11,48,38,10,57
Falkirk,6033,4,15,10,11,58,45,13,55
Queen of S't,6033,5,14,8,14,53,52,1,50
Dunfermline,6033,6,9,14,13,46,49,-3,41
Dumbarton,6033,7,9,11,16,47,57,-10,38
St Mirren,6033,8,9,10,17,38,57,-19,37
Raith,6033,9,9,10,17,33,52,-19,37
Ayr,6033,10,7,11,18,29,59,-30,32
Falkirk,6034,1,19,9,8,65,40,25,66
Hibernian,6034,2,16,13,7,49,30,19,61
Morton,6034,3,15,12,9,48,38,10,57
Dundee Utd,6034,4,14,11,11,50,42,8,53
Raith,6034,5,12,10,14,37,44,-7,46
Ayr,6034,6,12,10,14,37,50,-13,46
Dunfermline,6034,7,10,13,13,45,49,-4,43
Queen of S't,6034,8,10,12,14,42,49,-7,42
Dumbarton,6034,9,8,11,17,42,56,-14,35
St Mirren,6034,10,8,11,17,36,53,-17,35
Hibernian,6035,1,22,10,4,59,23,36,76
Falkirk,6035,2,17,11,8,58,36,22,62
Morton,6035,3,17,11,8,50,36,14,62
Dundee Utd,6035,4,15,11,10,56,41,15,56
Queen of S't,6035,5,11,10,15,42,49,-7,43
Dunfermline,6035,6,10,12,14,47,49,-2,42
Raith,6035,7,11,9,16,37,53,-16,42
Dumbarton,6035,8,8,14,14,41,53,-12,38
Ayr,6035,9,7,12,17,31,59,-28,33
St Mirren,6035,10,7,10,19,40,62,-22,31
Hibernian,6036,1,18,13,5,52,24,28,67
Morton,6036,2,18,11,7,54,32,22,65
Falkirk,6036,3,17,12,7,57,36,21,63
Dundee Utd,6036,4,13,13,10,44,39,5,52
Queen of S't,6036,5,11,10,15,47,50,-3,43
Dunfermline,6036,6,9,14,13,45,52,-7,41
Dumbarton,6036,7,9,12,15,48,60,-12,39
St Mirren,6036,8,9,11,16,40,55,-15,38
Raith,6036,9,9,10,17,35,54,-19,37
Ayr,6036,10,8,12,16,34,54,-20,36
Hibernian,6037,1,20,11,5,61,26,35,71
Morton,6037,2,18,11,7,51,35,16,65
Dundee Utd,6037,3,18,8,10,61,42,19,62
Falkirk,6037,4,16,9,11,58,43,15,57
Queen of S't,6037,5,12,9,15,44,55,-11,45
St Mirren,6037,6,10,10,16,44,54,-10,40
Dunfermline,6037,7,9,12,15,42,51,-9,39
Raith,6037,8,10,9,17,34,58,-24,39
Ayr,6037,9,8,12,16,40,59,-19,36
Dumbarton,6037,10,8,11,17,46,58,-12,35
Morton,6038,1,18,12,6,54,34,20,66
Hibernian,6038,2,17,14,5,53,30,23,65
Falkirk,6038,3,17,11,8,61,39,22,62
Dundee Utd,6038,4,16,10,10,47,36,11,58
Dunfermline,6038,5,12,12,12,49,46,3,48
Queen of S't,6038,6,10,12,14,42,49,-7,42
Ayr,6038,7,9,12,15,38,55,-17,39
Raith,6038,8,8,13,15,34,49,-15,37
Dumbarton,6038,9,7,11,18,47,63,-16,32
St Mirren,6038,10,7,11,18,39,63,-24,32
Hibernian,6039,1,20,10,6,64,32,32,70
Morton,6039,2,17,10,9,48,36,12,61
Falkirk,6039,3,16,11,9,61,43,18,59
Dundee Utd,6039,4,15,10,11,45,37,8,55
Queen of S't,6039,5,14,10,12,48,46,2,52
Dunfermline,6039,6,10,12,14,46,47,-1,42
Raith,6039,7,11,9,16,39,50,-11,42
Dumbarton,6039,8,9,11,16,45,59,-14,38
St Mirren,6039,9,8,11,17,37,56,-19,35
Ayr,6039,10,8,10,18,31,58,-27,34
Hibernian,6040,1,19,13,4,53,23,30,70
Morton,6040,2,17,12,7,49,32,17,63
Dundee Utd,6040,3,15,12,9,54,42,12,57
Falkirk,6040,4,14,11,11,57,41,16,53
Queen of S't,6040,5,13,9,14,50,49,1,48
Dunfermline,6040,6,9,14,13,41,48,-7,41
Dumbarton,6040,7,9,13,14,46,56,-10,40
Raith,6040,8,10,10,16,34,49,-15,40
St Mirren,6040,9,9,10,17,38,59,-21,37
Ayr,6040,10,6,14,16,32,55,-23,32
Hibernian,6041,1,17,15,4,53,25,28,66
Morton,6041,2,16,11,9,48,39,9,59
Falkirk,6041,3,16,10,10,59,45,14,58
Dundee Utd,6041,4,16,9,11,49,38,11,57
Dunfermline,6041,5,11,13,12,49,47,2,46
Queen of S't,6041,6,11,11,14,44,49,-5,44
Raith,6041,7,11,10,15,39,50,-11,43
Ayr,6041,8,9,13,14,31,50,-19,40
St Mirren,6041,9,8,12,16,39,53,-14,36
Dumbarton,6041,10,8,10,18,44,59,-15,34
Hibernian,6042,1,19,11,6,55,24,31,68
Morton,6042,2,17,14,5,50,33,17,65
Falkirk,6042,3,15,10,11,56,43,13,55
Dundee Utd,6042,4,14,11,11,52,45,7,53
Dunfermline,6042,5,12,14,10,46,41,5,50
Queen of S't,6042,6,10,11,15,42,52,-10,41
Raith,6042,7,10,10,16,34,49,-15,40
St Mirren,6042,8,9,11,16,47,60,-13,38
Dumbarton,6042,9,8,13,15,46,58,-12,37
Ayr,6042,10,7,13,16,33,56,-23,34
Hibernian,6043,1,20,10,6,54,27,27,70
Morton,6043,2,16,11,9,51,37,14,59
Falkirk,6043,3,16,10,10,56,38,18,58
Dundee Utd,6043,4,14,11,11,51,45,6,53
Dunfermline,6043,5,13,12,11,48,45,3,51
Ayr,6043,6,10,13,13,42,55,-13,43
Queen of S't,6043,7,11,9,16,45,59,-14,42
St Mirren,6043,8,9,11,16,47,56,-9,38
Dumbarton,6043,9,8,12,16,45,57,-12,36
Raith,6043,10,8,11,17,33,53,-20,35
Hibernian,6044,1,18,13,5,55,27,28,67
Morton,6044,2,17,10,9,47,36,11,61
Dundee Utd,6044,3,17,9,10,55,42,13,60
Falkirk,6044,4,15,11,10,55,44,11,56
Raith,6044,5,13,9,14,42,50,-8,48
Dunfermline,6044,6,10,16,10,46,41,5,46
Queen of S't,6044,7,10,11,15,45,51,-6,41
Ayr,6044,8,8,14,14,38,55,-17,38
Dumbarton,6044,9,8,12,16,46,62,-16,36
St Mirren,6044,10,6,11,19,35,56,-21,29
Hibernian,6045,1,21,11,4,59,24,35,74
Morton,6045,2,17,11,8,53,35,18,62
Falkirk,6045,3,17,9,10,60,44,16,60
Dundee Utd,6045,4,17,8,11,52,41,11,59
Queen of S't,6045,5,13,9,14,50,49,1,48
Ayr,6045,6,10,11,15,39,55,-16,41
Raith,6045,7,10,8,18,34,52,-18,38
Dunfermline,6045,8,8,13,15,44,56,-12,37
St Mirren,6045,9,9,9,18,44,61,-17,36
Dumbarton,6045,10,8,11,17,48,66,-18,35
Hibernian,6046,1,20,11,5,50,22,28,71
Morton,6046,2,19,12,5,50,29,21,69
Dundee Utd,6046,3,17,11,8,57,34,23,62
Falkirk,6046,4,14,11,11,53,42,11,53
Dunfermline,6046,5,11,13,12,52,46,6,46
Queen of S't,6046,6,11,8,17,41,52,-11,41
Raith,6046,7,10,10,16,38,55,-17,40
St Mirren,6046,8,9,11,16,38,52,-14,38
Dumbarton,6046,9,8,10,18,47,67,-20,34
Ayr,6046,10,7,11,18,32,59,-27,32
Hibernian,6047,1,19,13,4,58,24,34,70
Morton,6047,2,16,11,9,51,36,15,59
Falkirk,6047,3,15,12,9,55,44,11,57
Dundee Utd,6047,4,16,8,12,49,42,7,56
Dunfermline,6047,5,11,12,13,46,45,1,45
Queen of S't,6047,6,12,9,15,46,52,-6,45
Ayr,6047,7,11,11,14,40,53,-13,44
Dumbarton,6047,8,10,11,15,47,58,-11,41
Raith,6047,9,10,9,17,32,48,-16,39
St Mirren,6047,10,7,10,19,36,58,-22,31
Hibernian,6048,1,21,12,3,61,24,37,75
Morton,6048,2,17,12,7,51,34,17,63
Falkirk,6048,3,16,10,10,62,44,18,58
Dundee Utd,6048,4,15,10,11,49,42,7,55
Queen of S't,6048,5,13,8,15,48,51,-3,47
Raith,6048,6,11,9,16,37,49,-12,42
Dunfermline,6048,7,8,15,13,41,48,-7,39
Ayr,6048,8,9,11,16,32,54,-22,38
Dumbarton,6048,9,7,13,16,47,59,-12,34
St Mirren,6048,10,8,10,18,40,63,-23,34
Hibernian,6049,1,20,12,4,62,24,38,72
Morton,6049,2,17,11,8,57,41,16,62
Dundee Utd,6049,3,18,8,10,53,41,12,62
Falkirk,6049,4,16,9,11,65,44,21,57
Dunfermline,6049,5,11,12,13,51,49,2,45
Queen of S't,6049,6,12,9,15,43,49,-6,45
St Mirren,6049,7,9,11,16,44,62,-18,38
Ayr,6049,8,8,14,14,31,50,-19,38
Raith,6049,9,8,10,18,31,54,-23,34
Dumbarton,6049,10,7,12,17,43,66,-23,33
Hibernian,6050,1,17,14,5,54,28,26,65
Morton,6050,2,16,13,7,47,37,10,61
Dundee Utd,6050,3,16,10,10,48,39,9,58
Falkirk,6050,4,14,12,10,58,43,15,54
Queen of S't,6050,5,12,10,14,44,46,-2,46
Raith,6050,6,11,10,15,34,47,-13,43
Dunfermline,6050,7,10,12,14,48,50,-2,42
Dumbarton,6050,8,9,12,15,47,59,-12,39
St Mirren,6050,9,9,11,16,41,53,-12,38
Ayr,6050,10,8,12,16,35,54,-19,36
Hibernian,6051,1,18,12,6,58,30,28,66
Falkirk,6051,2,18,10,8,64,42,22,64
Morton,6051,3,16,11,9,49,40,9,59
Dundee Utd,6051,4,16,9,11,46,38,8,57
Dunfermline,6051,5,11,11,14,48,51,-3,44
Dumbarton,6051,6,10,12,14,46,55,-9,42
Raith,6051,7,11,9,16,36,48,-12,42
Queen of S't,6051,8,10,11,15,43,51,-8,41
Ayr,6051,9,10,11,15,37,52,-15,41
St Mirren,6051,10,7,10,19,37,57,-20,31
Hibernian,6052,1,17,14,5,53,24,29,65
Morton,6052,2,18,11,7,55,33,22,65
Falkirk,6052,3,16,10,10,59,42,17,58
Dundee Utd,6052,4,15,12,9,46,37,9,57
Queen of S't,6052,5,13,10,13,45,46,-1,49
Dunfermline,6052,6,9,14,13,48,54,-6,41
Raith,6052,7,10,10,16,38,54,-16,40
Dumbarton,6052,8,9,11,16,44,53,-9,38
St Mirren,6052,9,8,11,17,34,56,-22,35
Ayr,6052,10,6,15,15,30,53,-23,33
Hibernian,6053,1,17,13,6,57,32,25,64
Falkirk,6053,2,17,10,9,63,45,18,61
Dundee Utd,6053,3,17,9,10,59,46,13,60
Morton,6053,4,16,11,9,50,43,7,59
Dunfermline,6053,5,13,12,11,54,48,6,51
Dumbarton,6053,6,9,14,13,52,58,-6,41
Raith,6053,7,9,12,15,36,50,-14,39
Queen of S't,6053,8,9,11,16,47,58,-11,38
St Mirren,6053,9,9,10,17,42,58,-16,37
Ayr,6053,10,7,12,17,42,64,-22,33
Hibernian,6054,1,20,12,4,54,23,31,72
Dundee Utd,6054,2,17,10,9,52,34,18,61
Morton,6054,3,16,9,11,49,44,5,57
Falkirk,6054,4,15,11,10,53,43,10,56
Dunfermline,6054,5,11,13,12,48,46,2,46
Queen of S't,6054,6,11,10,15,44,48,-4,43
Ayr,6054,7,9,13,14,35,53,-18,40
Dumbarton,6054,8,9,11,16,50,60,-10,38
Raith,6054,9,9,11,16,36,50,-14,38
St Mirren,6054,10,8,10,18,38,58,-20,34
Hibernian,6055,1,20,12,4,59,24,35,72
Dundee Utd,6055,2,19,8,9,53,39,14,65
Morton,6055,3,18,9,9,54,43,11,63
Falkirk,6055,4,17,9,10,66,41,25,60
Queen of S't,6055,5,11,9,16,41,55,-14,42
Dunfermline,6055,6,9,12,15,45,54,-9,39
Raith,6055,7,9,12,15,35,49,-14,39
Ayr,6055,8,9,11,16,34,53,-19,38
St Mirren,6055,9,9,10,17,39,55,-16,37
Dumbarton,6055,10,8,10,18,46,59,-13,34
Hibernian,6056,1,19,14,3,52,23,29,71
Morton,6056,2,16,10,10,49,37,12,58
Dundee Utd,6056,3,15,11,10,48,39,9,56
Falkirk,6056,4,14,10,12,56,44,12,52
Queen of S't,6056,5,14,8,14,54,54,0,50
Dunfermline,6056,6,9,14,13,49,52,-3,41
Raith,6056,7,10,10,16,36,52,-16,40
Ayr,6056,8,8,15,13,34,52,-18,39
Dumbarton,6056,9,8,13,15,43,55,-12,37
St Mirren,6056,10,8,13,15,40,53,-13,37
Hibernian,6057,1,19,12,5,51,24,27,69
Dundee Utd,6057,2,17,9,10,55,43,12,60
Falkirk,6057,3,16,11,9,61,37,24,59
Morton,6057,4,16,11,9,47,35,12,59
Queen of S't,6057,5,12,8,16,45,53,-8,44
Ayr,6057,6,10,12,14,37,56,-19,42
Raith,6057,7,10,11,15,34,48,-14,41
Dunfermline,6057,8,8,14,14,44,48,-4,38
Dumbarton,6057,9,9,11,16,45,54,-9,38
St Mirren,6057,10,7,13,16,36,57,-21,34
Morton,6058,1,18,10,8,50,35,15,64
Falkirk,6058,2,17,12,7,60,38,22,63
Hibernian,6058,3,17,11,8,52,29,23,62
Dundee Utd,6058,4,15,10,11,54,50,4,55
Dunfermline,6058,5,12,14,10,50,42,8,50
Queen of S't,6058,6,11,11,14,41,47,-6,44
Raith,6058,7,10,9,17,36,49,-13,39
Dumbarton,6058,8,8,14,14,47,61,-14,38
Ayr,6058,9,8,12,16,40,58,-18,36
St Mirren,6058,10,8,9,19,42,63,-21,33
Morton,6059,1,20,10,6,52,31,21,70
Hibernian,6059,2,17,13,6,52,30,22,64
Falkirk,6059,3,17,9,10,60,44,16,60
Dundee Utd,6059,4,15,11,10,54,46,8,56
Queen of S't,6059,5,11,11,14,49,54,-5,44
Ayr,6059,6,10,11,15,44,56,-12,41
Raith,6059,7,10,11,15,36,50,-14,41
Dunfermline,6059,8,9,12,15,45,50,-5,39
Dumbarton,6059,9,9,10,17,45,59,-14,37
St Mirren,6059,10,8,10,18,40,57,-17,34
Hibernian,6060,1,18,12,6,50,25,25,66
Morton,6060,2,18,10,8,52,37,15,64
Falkirk,6060,3,17,10,9,60,40,20,61
Dundee Utd,6060,4,16,9,11,49,39,10,57
Dunfermline,6060,5,11,12,13,47,45,2,45
Queen of S't,6060,6,12,9,15,46,53,-7,45
Raith,6060,7,12,9,15,36,44,-8,45
Ayr,6060,8,9,11,16,31,53,-22,38
Dumbarton,6060,9,8,11,17,46,60,-14,35
St Mirren,6060,10,7,11,18,36,57,-21,32
Hibernian,6061,1,17,16,3,52,24,28,67
Morton,6061,2,18,11,7,54,35,19,65
Dundee Utd,6061,3,17,9,10,52,39,13,60
Falkirk,6061,4,16,9,11,60,43,17,57
Dunfermline,6061,5,10,15,11,48,47,1,45
Raith,6061,6,12,9,15,35,48,-13,45
Queen of S't,6061,7,11,10,15,43,50,-7,43
Dumbarton,6061,8,8,12,16,52,64,-12,36
St Mirren,6061,9,7,12,17,38,59,-21,33
Ayr,6061,10,6,13,17,29,54,-25,31
Hibernian,6062,1,19,12,5,58,31,27,69
Morton,6062,2,17,9,10,52,42,10,60
Falkirk,6062,3,16,11,9,57,38,19,59
Dundee Utd,6062,4,16,11,9,53,40,13,59
Dunfermline,6062,5,13,13,10,53,42,11,52
Queen of S't,6062,6,10,11,15,42,49,-7,41
Raith,6062,7,10,11,15,35,49,-14,41
Dumbarton,6062,8,8,11,17,43,59,-16,35
Ayr,6062,9,7,14,15,33,53,-20,35
St Mirren,6062,10,6,13,17,35,58,-23,31
Hibernian,6063,1,18,13,5,58,29,29,67
Falkirk,6063,2,18,11,7,58,35,23,65
Morton,6063,3,16,12,8,53,42,11,60
Dundee Utd,6063,4,16,9,11,48,39,9,57
Dunfermline,6063,5,10,15,11,50,48,2,45
Queen of S't,6063,6,11,10,15,47,50,-3,43
Dumbarton,6063,7,9,12,15,50,60,-10,39
Ayr,6063,8,8,13,15,36,59,-23,37
St Mirren,6063,9,8,11,17,41,59,-18,35
Raith,6063,10,8,10,18,31,51,-20,34
Hibernian,6064,1,21,11,4,62,22,40,74
Falkirk,6064,2,16,12,8,57,38,19,60
Morton,6064,3,15,13,8,45,38,7,58
Dundee Utd,6064,4,15,9,12,51,45,6,54
Queen of S't,6064,5,13,9,14,45,50,-5,48
Dunfermline,6064,6,9,15,12,46,49,-3,42
Dumbarton,6064,7,9,12,15,49,57,-8,39
Raith,6064,8,9,10,17,34,50,-16,37
St Mirren,6064,9,8,12,16,38,53,-15,36
Ayr,6064,10,7,13,16,32,57,-25,34
Hibernian,6065,1,21,12,3,58,22,36,75
Falkirk,6065,2,18,9,9,62,40,22,63
Morton,6065,3,15,12,9,50,41,9,57
Dundee Utd,6065,4,13,12,11,44,40,4,51
Queen of S't,6065,5,12,9,15,48,54,-6,45
Dunfermline,6065,6,11,11,14,47,49,-2,44
Dumbarton,6065,7,9,13,14,52,60,-8,40
Raith,6065,8,10,10,16,35,52,-17,40
St Mirren,6065,9,8,12,16,44,59,-15,36
Ayr,6065,10,6,14,16,31,54,-23,32
Hibernian,6066,1,21,11,4,58,24,34,74
Dundee Utd,6066,2,16,11,9,53,39,14,59
Morton,6066,3,15,11,10,44,39,5,56
Falkirk,6066,4,14,12,10,56,42,14,54
Dunfermline,6066,5,11,12,13,47,46,1,45
Raith,6066,6,11,10,15,36,49,-13,43
Queen of S't,6066,7,11,9,16,41,49,-8,42
Dumbarton,6066,8,9,11,16,46,60,-14,38
Ayr,6066,9,8,13,15,33,52,-19,37
St Mirren,6066,10,7,14,15,38,52,-14,35
Hibernian,6067,1,20,11,5,56,26,30,71
Dundee Utd,6067,2,18,9,9,56,42,14,63
Morton,6067,3,17,11,8,51,38,13,62
Falkirk,6067,4,14,11,11,58,44,14,53
Queen of S't,6067,5,12,10,14,51,50,1,46
Dunfermline,6067,6,10,11,15,45,53,-8,41
Dumbarton,6067,7,9,12,15,48,56,-8,39
Raith,6067,8,10,9,17,33,52,-19,39
St Mirren,6067,9,9,10,17,40,56,-16,37
Ayr,6067,10,8,12,16,33,54,-21,36
Hibernian,6068,1,21,11,4,58,22,36,74
Morton,6068,2,17,11,8,51,37,14,62
Falkirk,6068,3,15,12,9,54,38,16,57
Dundee Utd,6068,4,15,10,11,49,37,12,55
Dunfermline,6068,5,10,14,12,42,44,-2,44
Queen of S't,6068,6,11,10,15,43,51,-8,43
Raith,6068,7,10,9,17,36,54,-18,39
Ayr,6068,8,9,11,16,34,56,-22,38
Dumbarton,6068,9,9,10,17,46,59,-13,37
St Mirren,6068,10,9,10,17,43,58,-15,37
Hibernian,6069,1,19,14,3,53,21,32,71
Falkirk,6069,2,18,10,8,60,39,21,64
Morton,6069,3,15,13,8,47,34,13,58
Dundee Utd,6069,4,15,12,9,45,36,9,57
Dunfermline,6069,5,9,16,11,47,45,2,43
Queen of S't,6069,6,11,10,15,42,48,-6,43
St Mirren,6069,7,9,12,15,41,52,-11,39
Dumbarton,6069,8,9,11,16,44,56,-12,38
Raith,6069,9,9,10,17,32,53,-21,37
Ayr,6069,10,6,12,18,28,55,-27,30
Hibernian,6070,1,19,12,5,51,24,27,69
Morton,6070,2,18,9,9,46,35,11,63
Dundee Utd,6070,3,16,10,10,52,40,12,58
Falkirk,6070,4,15,10,11,56,45,11,55
Queen of S't,6070,5,13,9,14,47,50,-3,48
Dunfermline,6070,6,12,11,13,52,50,2,47
St Mirren,6070,7,10,11,15,42,52,-10,41
Raith,6070,8,10,8,18,31,47,-16,38
Dumbarton,6070,9,9,10,17,54,65,-11,37
Ayr,6070,10,7,12,17,31,54,-23,33
Hibernian,6071,1,19,11,6,56,30,26,68
Falkirk,6071,2,16,12,8,57,38,19,60
Dundee Utd,6071,3,15,13,8,51,40,11,58
Morton,6071,4,16,10,10,53,44,9,58
Queen of S't,6071,5,12,9,15,47,51,-4,45
Dunfermline,6071,6,10,13,13,47,49,-2,43
Raith,6071,7,11,9,16,41,52,-11,42
Dumbarton,6071,8,10,10,16,48,58,-10,40
Ayr,6071,9,8,12,16,35,59,-24,36
St Mirren,6071,10,8,11,17,41,55,-14,35
Hibernian,6072,1,18,11,7,53,30,23,65
Morton,6072,2,17,11,8,51,39,12,62
Falkirk,6072,3,16,10,10,58,39,19,58
Dundee Utd,6072,4,16,10,10,51,38,13,58
Raith,6072,5,13,8,15,36,47,-11,47
Ayr,6072,6,11,11,14,44,53,-9,44
Dunfermline,6072,7,10,13,13,51,53,-2,43
Dumbarton,6072,8,10,12,14,51,61,-10,42
Queen of S't,6072,9,10,10,16,40,51,-11,40
St Mirren,6072,10,6,10,20,33,57,-24,28
Hibernian,6073,1,17,14,5,47,24,23,65
Falkirk,6073,2,17,11,8,61,40,21,62
Morton,6073,3,17,9,10,50,37,13,60
Dundee Utd,6073,4,16,10,10,53,42,11,58
Dunfermline,6073,5,11,13,12,47,48,-1,46
Raith,6073,6,12,10,14,40,47,-7,46
Queen of S't,6073,7,11,9,16,47,53,-6,42
Dumbarton,6073,8,9,11,16,48,58,-10,38
Ayr,6073,9,9,11,16,37,58,-21,38
St Mirren,6073,10,7,10,19,34,57,-23,31
Hibernian,6074,1,18,12,6,50,25,25,66
Dundee Utd,6074,2,18,8,10,60,44,16,62
Falkirk,6074,3,16,11,9,64,42,22,59
Morton,6074,4,16,11,9,45,34,11,59
Queen of S't,6074,5,11,10,15,46,53,-7,43
Ayr,6074,6,11,10,15,38,55,-17,43
Dunfermline,6074,7,10,12,14,42,48,-6,42
Raith,6074,8,11,9,16,36,49,-13,42
St Mirren,6074,9,8,12,16,41,56,-15,36
Dumbarton,6074,10,8,11,17,45,61,-16,35
Hibernian,6075,1,20,12,4,59,23,36,72
Falkirk,6075,2,17,10,9,61,36,25,61
Morton,6075,3,16,11,9,50,40,10,59
Dundee Utd,6075,4,13,12,11,47,43,4,51
Dumbarton,6075,5,12,11,13,53,53,0,47
Dunfermline,6075,6,11,12,13,51,52,-1,45
Queen of S't,6075,7,11,10,15,43,53,-10,43
Raith,6075,8,10,10,16,34,50,-16,40
Ayr,6075,9,9,13,14,35,52,-17,40
St Mirren,6075,10,6,9,21,35,66,-31,27
Morton,6076,1,19,9,8,54,40,14,66
Falkirk,6076,2,18,10,8,61,39,22,64
Hibernian,6076,3,16,13,7,51,29,22,61
Queen of S't,6076,4,14,9,13,54,49,5,51
Dundee Utd,6076,5,14,9,13,48,46,2,51
Dunfermline,6076,6,10,13,13,45,48,-3,43
Dumbarton,6076,7,11,10,15,54,62,-8,43
Raith,6076,8,11,8,17,36,48,-12,41
St Mirren,6076,9,9,9,18,39,56,-17,36
Ayr,6076,10,7,12,17,30,55,-25,33
Morton,6077,1,20,9,7,59,35,24,69
Hibernian,6077,2,19,11,6,57,28,29,68
Falkirk,6077,3,17,12,7,55,35,20,63
Dundee Utd,6077,4,14,11,11,47,40,7,53
Queen of S't,6077,5,13,8,15,42,45,-3,47
Dumbarton,6077,6,10,10,16,48,56,-8,40
Raith,6077,7,10,9,17,32,50,-18,39
Dunfermline,6077,8,9,11,16,47,55,-8,38
St Mirren,6077,9,9,9,18,39,57,-18,36
Ayr,6077,10,8,12,16,34,59,-25,36
Morton,6078,1,19,11,6,55,37,18,68
Hibernian,6078,2,18,12,6,58,32,26,66
Falkirk,6078,3,18,10,8,63,40,23,64
Dundee Utd,6078,4,16,8,12,48,41,7,56
Queen of S't,6078,5,12,11,13,50,52,-2,47
Dunfermline,6078,6,10,13,13,44,45,-1,43
Raith,6078,7,10,10,16,37,46,-9,40
Dumbarton,6078,8,9,12,15,48,63,-15,39
Ayr,6078,9,7,12,17,35,58,-23,33
St Mirren,6078,10,6,11,19,38,62,-24,29
Hibernian,6079,1,21,11,4,55,24,31,74
Morton,6079,2,16,14,6,54,36,18,62
Dundee Utd,6079,3,18,8,10,54,43,11,62
Falkirk,6079,4,14,13,9,58,43,15,55
Queen of S't,6079,5,11,10,15,41,45,-4,43
Dunfermline,6079,6,8,16,12,40,45,-5,40
St Mirren,6079,7,9,12,15,43,57,-14,39
Raith,6079,8,9,12,15,35,49,-14,39
Dumbarton,6079,9,8,12,16,44,56,-12,36
Ayr,6079,10,7,10,19,29,55,-26,31
Hibernian,6080,1,19,13,4,54,24,30,70
Morton,6080,2,17,13,6,48,31,17,64
Falkirk,6080,3,17,10,9,58,40,18,61
Dundee Utd,6080,4,15,9,12,43,40,3,54
Dunfermline,6080,5,11,11,14,43,45,-2,44
Raith,6080,6,11,10,15,33,43,-10,43
Queen of S't,6080,7,10,11,15,46,53,-7,41
Dumbarton,6080,8,8,13,15,47,59,-12,37
Ayr,6080,9,7,14,15,37,56,-19,35
St Mirren,6080,10,8,10,18,43,61,-18,34
Hibernian,6081,1,20,12,4,64,27,37,72
Dundee Utd,6081,2,17,10,9,50,36,14,61
Falkirk,6081,3,16,10,10,57,42,15,58
Morton,6081,4,13,14,9,44,42,2,53
Queen of S't,6081,5,13,9,14,45,48,-3,48
Dunfermline,6081,6,8,17,11,44,45,-1,41
Ayr,6081,7,9,12,15,34,53,-19,39
Dumbarton,6081,8,9,11,16,47,59,-12,38
Raith,6081,9,9,11,16,33,49,-16,38
St Mirren,6081,10,8,10,18,35,52,-17,34
Hibernian,6082,1,18,14,4,54,24,30,68
Morton,6082,2,17,12,7,54,36,18,63
Dundee Utd,6082,3,16,10,10,53,35,18,58
Falkirk,6082,4,15,12,9,57,39,18,57
Queen of S't,6082,5,12,10,14,44,48,-4,46
Dumbarton,6082,6,11,11,14,51,57,-6,44
Dunfermline,6082,7,9,14,13,43,49,-6,41
Raith,6082,8,9,11,16,33,51,-18,38
St Mirren,6082,9,8,11,17,37,59,-22,35
Ayr,6082,10,6,13,17,29,57,-28,31
Hibernian,6083,1,21,12,3,60,24,36,75
Morton,6083,2,18,11,7,55,38,17,65
Dundee Utd,6083,3,17,9,10,49,37,12,60
Falkirk,6083,4,16,10,10,60,43,17,58
Queen of S't,6083,5,11,9,16,46,51,-5,42
Raith,6083,6,10,10,16,37,53,-16,40
Ayr,6083,7,8,14,14,33,51,-18,38
Dunfermline,6083,8,8,13,15,44,56,-12,37
St Mirren,6083,9,8,11,17,37,53,-16,35
Dumbarton,6083,10,7,13,16,43,58,-15,34
Hibernian,6084,1,19,14,3,57,25,32,71
Morton,6084,2,18,10,8,46,36,10,64
Falkirk,6084,3,17,12,7,63,42,21,63
Dundee Utd,6084,4,14,11,11,49,42,7,53
Dunfermline,6084,5,10,13,13,45,48,-3,43
Queen of S't,6084,6,10,10,16,44,53,-9,40
Dumbarton,6084,7,9,12,15,51,60,-9,39
Raith,6084,8,10,9,17,35,48,-13,39
Ayr,6084,9,8,12,16,32,52,-20,36
St Mirren,6084,10,8,11,17,40,56,-16,35
Hibernian,6085,1,18,12,6,57,30,27,66
Morton,6085,2,17,11,8,53,39,14,62
Dundee Utd,6085,3,16,11,9,50,37,13,59
Falkirk,6085,4,15,9,12,56,47,9,54
Queen of S't,6085,5,14,9,13,54,51,3,51
Raith,6085,6,11,9,16,36,51,-15,42
St Mirren,6085,7,10,11,15,46,53,-7,41
Dumbarton,6085,8,9,12,15,49,60,-11,39
Dunfermline,6085,9,9,11,16,44,53,-9,38
Ayr,6085,10,7,13,16,33,57,-24,34
Hibernian,6086,1,21,11,4,59,24,35,74
Dundee Utd,6086,2,18,9,9,57,37,20,63
Falkirk,6086,3,15,12,9,54,42,12,57
Morton,6086,4,14,13,9,45,37,8,55
Queen of S't,6086,5,11,10,15,44,52,-8,43
Dunfermline,6086,6,9,14,13,42,45,-3,41
Dumbarton,6086,7,9,12,15,48,60,-12,39
Ayr,6086,8,9,12,15,34,52,-18,39
Raith,6086,9,9,10,17,32,48,-16,37
St Mirren,6086,10,8,11,17,39,57,-18,35
Hibernian,6087,1,21,10,5,61,25,36,73
Falkirk,6087,2,18,10,8,60,37,23,64
Morton,6087,3,18,10,8,47,33,14,64
Dundee Utd,6087,4,16,9,11,45,38,7,57
Dumbarton,6087,5,13,10,13,54,52,2,49
Queen of S't,6087,6,12,8,16,43,47,-4,44
Dunfermline,6087,7,9,13,14,40,51,-11,40
Ayr,6087,8,8,11,17,30,53,-23,35
Raith,6087,9,8,9,19,32,52,-20,33
St Mirren,6087,10,7,10,19,33,57,-24,31
Morton,6088,1,20,9,7,54,39,15,69
Hibernian,6088,2,19,11,6,57,32,25,68
Falkirk,6088,3,16,10,10,61,44,17,58
Dundee Utd,6088,4,15,11,10,53,43,10,56
Dunfermline,6088,5,13,12,11,55,44,11,51
Queen of S't,6088,6,11,8,17,48,57,-9,41
Raith,6088,7,9,11,16,36,50,-14,38
Ayr,6088,8,8,14,14,35,54,-19,38
Dumbarton,6088,9,8,10,18,46,64,-18,34
St Mirren,6088,10,7,12,17,40,58,-18,33
Hibernian,6089,1,20,11,5,57,25,32,71
Morton,6089,2,19,11,6,55,34,21,68
Falkirk,6089,3,18,9,9,60,38,22,63
Dundee Utd,6089,4,13,12,11,48,41,7,51
Queen of S't,6089,5,12,10,14,47,50,-3,46
Dunfermline,6089,6,10,12,14,42,52,-10,42
Raith,6089,7,11,8,17,36,48,-12,41
Dumbarton,6089,8,9,10,17,46,58,-12,37
Ayr,6089,9,7,14,15,35,58,-23,35
St Mirren,6089,10,7,11,18,35,57,-22,32
Hibernian,6090,1,18,13,5,55,29,26,67
Dundee Utd,6090,2,16,10,10,50,40,10,58
Morton,6090,3,15,11,10,50,40,10,56
Falkirk,6090,4,13,11,12,51,44,7,50
Raith,6090,5,13,10,13,40,44,-4,49
Dunfermline,6090,6,11,13,12,45,50,-5,46
Queen of S't,6090,7,11,10,15,43,50,-7,43
Dumbarton,6090,8,10,11,15,49,54,-5,41
St Mirren,6090,9,9,11,16,43,54,-11,38
Ayr,6090,10,8,12,16,36,57,-21,36
Hibernian,6091,1,17,14,5,54,26,28,65
Morton,6091,2,17,12,7,50,38,12,63
Falkirk,6091,3,16,10,10,55,46,9,58
Dundee Utd,6091,4,14,11,11,46,42,4,53
Dunfermline,6091,5,12,12,12,54,45,9,48
Queen of S't,6091,6,12,10,14,50,54,-4,46
Dumbarton,6091,7,10,11,15,53,58,-5,41
Ayr,6091,8,9,11,16,37,55,-18,38
St Mirren,6091,9,9,10,17,44,58,-14,37
Raith,6091,10,9,9,18,34,55,-21,36
Hibernian,6092,1,19,12,5,53,26,27,69
Falkirk,6092,2,18,11,7,63,37,26,65
Dundee Utd,6092,3,18,9,9,53,39,14,63
Morton,6092,4,15,11,10,48,38,10,56
Queen of S't,6092,5,12,8,16,45,53,-8,44
Dunfermline,6092,6,10,12,14,46,49,-3,42
Raith,6092,7,9,12,15,35,50,-15,39
Dumbarton,6092,8,9,11,16,47,58,-11,38
St Mirren,6092,9,9,9,18,40,57,-17,36
Ayr,6092,10,8,11,17,37,60,-23,35
Hibernian,6093,1,21,12,3,62,27,35,75
Morton,6093,2,19,11,6,53,33,20,68
Dundee Utd,6093,3,17,9,10,49,38,11,60
Falkirk,6093,4,15,12,9,58,43,15,57
Dumbarton,6093,5,10,11,15,48,56,-8,41
Raith,6093,6,10,10,16,33,47,-14,40
Dunfermline,6093,7,8,15,13,40,47,-7,39
Queen of S't,6093,8,10,9,17,40,51,-11,39
St Mirren,6093,9,7,12,17,39,55,-16,33
Ayr,6093,10,7,11,18,31,56,-25,32
Hibernian,6094,1,21,11,4,58,24,34,74
Falkirk,6094,2,17,9,10,57,40,17,60
Morton,6094,3,15,13,8,44,35,9,58
Dundee Utd,6094,4,16,8,12,49,40,9,56
Queen of S't,6094,5,12,10,14,48,50,-2,46
Raith,6094,6,10,10,16,35,50,-15,40
Dumbarton,6094,7,9,12,15,49,60,-11,39
St Mirren,6094,8,10,9,17,40,54,-14,39
Dunfermline,6094,9,8,14,14,43,51,-8,38
Ayr,6094,10,8,12,16,37,56,-19,36
Morton,6095,1,20,10,6,56,31,25,70
Hibernian,6095,2,19,11,6,54,26,28,68
Dundee Utd,6095,3,15,10,11,55,44,11,55
Falkirk,6095,4,14,12,10,59,43,16,54
Queen of S't,6095,5,12,9,15,41,49,-8,45
Raith,6095,6,12,9,15,38,51,-13,45
Dunfermline,6095,7,10,13,13,45,49,-4,43
Ayr,6095,8,9,11,16,36,53,-17,38
Dumbarton,6095,9,8,12,16,45,58,-13,36
St Mirren,6095,10,7,11,18,36,61,-25,32
Hibernian,6096,1,20,12,4,59,26,33,72
Morton,6096,2,18,10,8,51,35,16,64
Falkirk,6096,3,17,10,9,64,45,19,61
Dundee Utd,6096,4,15,9,12,45,41,4,54
Dunfermline,6096,5,13,12,11,53,45,8,51
Queen of S't,6096,6,11,8,17,45,51,-6,41
Raith,6096,7,10,8,18,34,50,-16,38
Ayr,6096,8,9,11,16,34,55,-21,38
St Mirren,6096,9,9,10,17,41,63,-22,37
Dumbarton,6096,10,7,12,17,43,58,-15,33
Hibernian,6097,1,21,12,3,57,23,34,75
Morton,6097,2,18,12,6,57,39,18,66
Dundee Utd,6097,3,17,9,10,55,44,11,60
Falkirk,6097,4,15,9,12,57,44,13,54
Queen of S't,6097,5,13,8,15,48,54,-6,47
Raith,6097,6,11,9,16,39,47,-8,42
Dunfermline,6097,7,9,13,14,47,52,-5,40
St Mirren,6097,8,8,11,17,39,57,-18,35
Ayr,6097,9,8,11,17,37,59,-22,35
Dumbarton,6097,10,8,10,18,47,64,-17,34
Hibernian,6098,1,20,12,4,57,26,31,72
Dundee Utd,6098,2,18,8,10,51,40,11,62
Falkirk,6098,3,17,10,9,69,44,25,61
Morton,6098,4,16,11,9,50,39,11,59
Dunfermline,6098,5,10,12,14,45,48,-3,42
Raith,6098,6,10,12,14,39,48,-9,42
Queen of S't,6098,7,10,11,15,43,50,-7,41
Ayr,6098,8,9,10,17,37,57,-20,37
Dumbarton,6098,9,8,12,16,48,63,-15,36
St Mirren,6098,10,8,10,18,41,65,-24,34
Hibernian,6099,1,19,11,6,59,32,27,68
Falkirk,6099,2,17,10,9,62,39,23,61
Morton,6099,3,16,12,8,54,38,16,60
Dundee Utd,6099,4,14,9,13,47,45,2,51
Dunfermline,6099,5,12,13,11,52,49,3,49
Ayr,6099,6,11,12,13,39,52,-13,45
Raith,6099,7,11,9,16,39,54,-15,42
Queen of S't,6099,8,11,8,17,48,57,-9,41
Dumbarton,6099,9,8,13,15,46,60,-14,37
St Mirren,6099,10,7,11,18,40,60,-20,32
Hibernian,6100,1,18,12,6,57,30,27,66
Dundee Utd,6100,2,17,9,10,52,40,12,60
Morton,6100,3,15,12,9,48,39,9,57
Falkirk,6100,4,14,10,12,53,42,11,52
Dunfermline,6100,5,11,12,13,54,55,-1,45
Queen of S't,6100,6,11,12,13,46,49,-3,45
Ayr,6100,7,11,11,14,40,55,-15,44
Raith,6100,8,11,10,15,39,51,-12,43
Dumbarton,6100,9,8,13,15,46,57,-11,37
St Mirren,6100,10,8,11,17,42,59,-17,35
Morton,6101,1,18,12,6,51,35,16,66
Hibernian,6101,2,18,11,7,54,28,26,65
Falkirk,6101,3,17,10,9,61,41,20,61
Dundee Utd,6101,4,16,11,9,60,42,18,59
Queen of S't,6101,5,13,9,14,45,50,-5,48
Dunfermline,6101,6,9,15,12,49,52,-3,42
Dumbarton,6101,7,10,11,15,49,57,-8,41
Ayr,6101,8,9,11,16,35,56,-21,38
Raith,6101,9,9,8,19,33,53,-20,35
St Mirren,6101,10,7,10,19,38,61,-23,31
Hibernian,6102,1,19,13,4,59,27,32,70
Morton,6102,2,15,13,8,48,44,4,58
Falkirk,6102,3,16,9,11,59,43,16,57
Dundee Utd,6102,4,15,11,10,48,38,10,56
Dunfermline,6102,5,13,12,11,48,43,5,51
Queen of S't,6102,6,10,11,15,43,51,-8,41
Raith,6102,7,10,10,16,37,47,-10,40
Dumbarton,6102,8,9,11,16,45,56,-11,38
St Mirren,6102,9,9,10,17,41,60,-19,37
Ayr,6102,10,8,12,16,34,53,-19,36
Hibernian,6103,1,22,11,3,62,20,42,77
Morton,6103,2,16,11,9,49,39,10,59
Dundee Utd,6103,3,14,13,9,49,41,8,55
Falkirk,6103,4,13,12,11,54,44,10,51
Queen of S't,6103,5,12,11,13,46,50,-4,47
Dunfermline,6103,6,9,13,14,44,51,-7,40
St Mirren,6103,7,9,12,15,46,58,-12,39
Raith,6103,8,9,12,15,35,49,-14,39
Dumbarton,6103,9,8,14,14,47,57,-10,38
Ayr,6103,10,7,13,16,34,57,-23,34
Hibernian,6104,1,19,12,5,57,30,27,69
Morton,6104,2,16,14,6,49,34,15,62
Dundee Utd,6104,3,16,10,10,50,44,6,58
Falkirk,6104,4,15,12,9,64,43,21,57
Queen of S't,6104,5,13,9,14,52,46,6,48
Raith,6104,6,11,10,15,35,48,-13,43
Ayr,6104,7,10,11,15,34,49,-15,41
Dunfermline,6104,8,8,15,13,44,46,-2,39
Dumbarton,6104,9,9,11,16,46,63,-17,38
St Mirren,6104,10,6,10,20,33,61,-28,28
Hibernian,6105,1,19,11,6,59,30,29,68
Morton,6105,2,18,10,8,52,34,18,64
Falkirk,6105,3,17,11,8,60,40,20,62
Dundee Utd,6105,4,15,9,12,46,41,5,54
Queen of S't,6105,5,12,9,15,43,52,-9,45
Dunfermline,6105,6,11,11,14,48,49,-1,44
St Mirren,6105,7,10,11,15,44,52,-8,41
Raith,6105,8,10,11,15,39,52,-13,41
Dumbarton,6105,9,8,11,17,44,60,-16,35
Ayr,6105,10,8,10,18,34,59,-25,34
Hibernian,6106,1,19,11,6,56,29,27,68
Dundee Utd,6106,2,17,9,10,52,35,17,60
Morton,6106,3,16,10,10,49,39,10,58
Falkirk,6106,4,15,12,9,57,41,16,57
Queen of S't,6106,5,13,10,13,49,48,1,49
Dunfermline,6106,6,11,12,13,45,48,-3,45
Dumbarton,6106,7,10,11,15,49,64,-15,41
St Mirren,6106,8,9,11,16,48,56,-8,38
Ayr,6106,9,8,12,16,33,54,-21,36
Raith,6106,10,8,10,18,33,57,-24,34
Hibernian,6107,1,18,13,5,52,26,26,67
Falkirk,6107,2,16,11,9,60,39,21,59
Morton,6107,3,15,11,10,46,38,8,56
Dundee Utd,6107,4,14,10,12,50,44,6,52
Dunfermline,6107,5,12,12,12,52,50,2,48
Raith,6107,6,11,11,14,38,48,-10,44
Queen of S't,6107,7,10,13,13,44,49,-5,43
Dumbarton,6107,8,10,12,14,50,57,-7,42
St Mirren,6107,9,8,12,16,37,52,-15,36
Ayr,6107,10,8,11,17,32,58,-26,35
Hibernian,6108,1,19,14,3,55,23,32,71
Falkirk,6108,2,17,11,8,62,38,24,62
Morton,6108,3,17,10,9,51,36,15,61
Dundee Utd,6108,4,17,8,11,51,39,12,59
Queen of S't,6108,5,12,10,14,45,51,-6,46
Dunfermline,6108,6,10,12,14,45,48,-3,42
Dumbarton,6108,7,10,12,14,47,55,-8,42
Raith,6108,8,9,9,18,32,52,-20,36
St Mirren,6108,9,8,10,18,38,58,-20,34
Ayr,6108,10,7,12,17,34,60,-26,33
Hibernian,6109,1,17,14,5,53,29,24,65
Dundee Utd,6109,2,18,9,9,57,37,20,63
Morton,6109,3,17,11,8,47,35,12,62
Falkirk,6109,4,17,9,10,56,39,17,60
Raith,6109,5,12,9,15,38,46,-8,45
Dumbarton,6109,6,10,11,15,48,55,-7,41
Dunfermline,6109,7,9,13,14,42,49,-7,40
Queen of S't,6109,8,10,10,16,41,53,-12,40
Ayr,6109,9,8,12,16,35,57,-22,36
St Mirren,6109,10,7,12,17,41,58,-17,33
Hibernian,6110,1,20,12,4,56,25,31,72
Falkirk,6110,2,17,10,9,62,42,20,61
Morton,6110,3,16,11,9,52,38,14,59
Dundee Utd,6110,4,16,11,9,51,38,13,59
Dunfermline,6110,5,10,14,12,49,48,1,44
Queen of S't,6110,6,11,10,15,44,49,-5,43
Raith,6110,7,10,9,17,36,53,-17,39
Ayr,6110,8,9,12,15,34,55,-21,39
Dumbarton,6110,9,8,12,16,43,59,-16,36
St Mirren,6110,10,8,9,19,38,58,-20,33
Hibernian,6111,1,18,12,6,53,30,23,66
Dundee Utd,6111,2,19,8,9,56,37,19,65
Morton,6111,3,15,12,9,53,41,12,57
Falkirk,6111,4,15,11,10,55,41,14,56
Dunfermline,6111,5,11,13,12,47,49,-2,46
St Mirren,6111,6,10,11,15,42,52,-10,41
Queen of S't,6111,7,9,12,15,44,54,-10,39
Raith,6111,8,9,12,15,39,51,-12,39
Ayr,6111,9,9,12,15,37,56,-19,39
Dumbarton,6111,10,8,11,17,46,61,-15,35
Morton,6112,1,19,10,7,52,30,22,67
Hibernian,6112,2,17,13,6,48,28,20,64
Dundee Utd,6112,3,16,9,11,47,39,8,57
Falkirk,6112,4,14,11,11,55,44,11,53
Dumbarton,6112,5,12,11,13,51,54,-3,47
Queen of S't,6112,6,12,10,14,44,47,-3,46
Dunfermline,6112,7,10,12,14,45,45,0,42
Raith,6112,8,10,10,16,35,49,-14,40
Ayr,6112,9,10,10,16,36,54,-18,40
St Mirren,6112,10,7,10,19,37,60,-23,31
Hibernian,6113,1,18,12,6,51,26,25,66
Morton,6113,2,17,13,6,49,34,15,64
Falkirk,6113,3,17,10,9,62,42,20,61
Dundee Utd,6113,4,16,9,11,56,41,15,57
Dunfermline,6113,5,11,14,11,49,48,1,47
Queen of S't,6113,6,12,10,14,44,49,-5,46
Ayr,6113,7,9,12,15,34,52,-18,39
St Mirren,6113,8,9,10,17,42,52,-10,37
Raith,6113,9,9,9,18,30,52,-22,36
Dumbarton,6113,10,7,11,18,48,69,-21,32
Hibernian,6114,1,21,11,4,61,24,37,74
Morton,6114,2,16,11,9,52,41,11,59
Dundee Utd,6114,3,17,8,11,46,37,9,59
Falkirk,6114,4,14,11,11,54,42,12,53
Dumbarton,6114,5,12,11,13,51,52,-1,47
Dunfermline,6114,6,10,14,12,45,48,-3,44
Queen of S't,6114,7,11,10,15,47,52,-5,43
St Mirren,6114,8,9,10,17,45,60,-15,37
Raith,6114,9,9,10,17,35,54,-19,37
Ayr,6114,10,7,12,17,34,60,-26,33
Morton,6115,1,18,11,7,51,33,18,65
Hibernian,6115,2,17,13,6,51,29,22,64
Falkirk,6115,3,17,10,9,58,38,20,61
Dundee Utd,6115,4,16,11,9,50,39,11,59
Dumbarton,6115,5,10,11,15,47,54,-7,41
Queen of S't,6115,6,10,10,16,42,55,-13,40
Raith,6115,7,10,10,16,37,50,-13,40
St Mirren,6115,8,9,12,15,38,49,-11,39
Ayr,6115,9,8,14,14,36,53,-17,38
Dunfermline,6115,10,8,12,16,40,50,-10,36
Hibernian,6116,1,20,12,4,52,21,31,72
Dundee Utd,6116,2,16,10,10,52,37,15,58
Morton,6116,3,14,15,7,46,35,11,57
Falkirk,6116,4,15,11,10,57,41,16,56
Queen of S't,6116,5,12,9,15,48,51,-3,45
Dunfermline,6116,6,10,14,12,49,49,0,44
Ayr,6116,7,10,11,15,32,54,-22,41
Raith,6116,8,10,10,16,35,49,-14,40
Dumbarton,6116,9,8,11,17,45,60,-15,35
St Mirren,6116,10,8,11,17,40,59,-19,35
Hibernian,6117,1,21,12,3,54,21,33,75
Falkirk,6117,2,16,12,8,60,39,21,60
Morton,6117,3,16,11,9,52,40,12,59
Dundee Utd,6117,4,16,11,9,48,38,10,59
Dunfermline,6117,5,11,13,12,48,46,2,46
Raith,6117,6,12,8,16,36,48,-12,44
Queen of S't,6117,7,10,11,15,43,49,-6,41
Dumbarton,6117,8,8,13,15,46,59,-13,37
Ayr,6117,9,6,14,16,31,56,-25,32
St Mirren,6117,10,6,11,19,35,57,-22,29
Hibernian,6118,1,20,11,5,58,24,34,71
Morton,6118,2,18,10,8,47,34,13,64
Falkirk,6118,3,15,12,9,57,44,13,57
Dundee Utd,6118,4,15,11,10,51,42,9,56
Dunfermline,6118,5,10,13,13,48,50,-2,43
Queen of S't,6118,6,11,10,15,46,53,-7,43
Raith,6118,7,10,10,16,33,46,-13,40
Dumbarton,6118,8,9,12,15,49,61,-12,39
Ayr,6118,9,8,12,16,33,53,-20,36
St Mirren,6118,10,8,11,17,42,57,-15,35
Hibernian,6119,1,20,10,6,59,27,32,70
Dundee Utd,6119,2,19,8,9,52,38,14,65
Morton,6119,3,16,12,8,53,43,10,60
Falkirk,6119,4,14,12,10,56,41,15,54
Queen of S't,6119,5,12,8,16,46,51,-5,44
Dunfermline,6119,6,9,12,15,46,52,-6,39
Dumbarton,6119,7,9,12,15,51,60,-9,39
Ayr,6119,8,9,12,15,35,53,-18,39
St Mirren,6119,9,9,11,16,42,57,-15,38
Raith,6119,10,9,11,16,33,51,-18,38
Hibernian,6120,1,20,11,5,57,28,29,71
Falkirk,6120,2,17,11,8,60,39,21,62
Dundee Utd,6120,3,16,12,8,53,38,15,60
Morton,6120,4,14,14,8,44,36,8,56
Ayr,6120,5,11,11,14,37,55,-18,44
Dunfermline,6120,6,9,15,12,45,45,0,42
Queen of S't,6120,7,11,8,17,44,50,-6,41
Raith,6120,8,9,11,16,34,49,-15,38
Dumbarton,6120,9,8,11,17,44,57,-13,35
St Mirren,6120,10,8,10,18,35,56,-21,34
Hibernian,6121,1,20,11,5,58,27,31,71
Dundee Utd,6121,2,17,10,9,56,38,18,61
Morton,6121,3,17,10,9,53,35,18,61
Falkirk,6121,4,16,11,9,58,40,18,59
Queen of S't,6121,5,11,10,15,43,50,-7,43
Ayr,6121,6,11,10,15,40,57,-17,43
St Mirren,6121,7,10,10,16,42,56,-14,40
Dumbarton,6121,8,9,11,16,45,56,-11,38
Dunfermline,6121,9,7,14,15,45,57,-12,35
Raith,6121,10,8,11,17,38,62,-24,35
Hibernian,6122,1,18,13,5,54,28,26,67
Morton,6122,2,17,11,8,48,33,15,62
Falkirk,6122,3,17,10,9,59,41,18,61
Dundee Utd,6122,4,17,9,10,55,39,16,60
Queen of S't,6122,5,13,8,15,46,51,-5,47
Dunfermline,6122,6,10,13,13,47,46,1,43
Ayr,6122,7,10,10,16,36,59,-23,40
Dumbarton,6122,8,9,10,17,47,58,-11,37
Raith,6122,9,9,10,17,35,52,-17,37
St Mirren,6122,10,8,10,18,41,61,-20,34
Hibernian,6123,1,18,12,6,50,26,24,66
Dundee Utd,6123,2,17,10,9,55,41,14,61
Morton,6123,3,16,13,7,51,39,12,61
Falkirk,6123,4,16,11,9,61,46,15,59
Queen of S't,6123,5,13,9,14,47,46,1,48
Dunfermline,6123,6,10,12,14,46,49,-3,42
Dumbarton,6123,7,9,13,14,47,57,-10,40
Raith,6123,8,10,8,18,33,49,-16,38
St Mirren,6123,9,9,10,17,41,53,-12,37
Ayr,6123,10,7,12,17,31,56,-25,33
Hibernian,6124,1,22,10,4,62,23,39,76
Dundee Utd,6124,2,17,9,10,55,41,14,60
Morton,6124,3,17,9,10,48,38,10,60
Falkirk,6124,4,13,13,10,56,44,12,52
Dunfermline,6124,5,10,14,12,43,46,-3,44
Dumbarton,6124,6,10,12,14,50,57,-7,42
Raith,6124,7,10,12,14,36,46,-10,42
Queen of S't,6124,8,10,9,17,46,58,-12,39
Ayr,6124,9,9,11,16,34,56,-22,38
St Mirren,6124,10,7,11,18,37,58,-21,32
Hibernian,6125,1,21,12,3,56,20,36,75
Morton,6125,2,16,12,8,47,38,9,60
Falkirk,6125,3,16,10,10,59,41,18,58
Dundee Utd,6125,4,14,9,13,49,46,3,51
Dunfermline,6125,5,11,13,12,48,44,4,46
Queen of S't,6125,6,11,11,14,42,46,-4,44
Raith,6125,7,10,11,15,33,48,-15,41
Dumbarton,6125,8,9,12,15,55,63,-8,39
St Mirren,6125,9,9,9,18,39,58,-19,36
Ayr,6125,10,7,13,16,34,58,-24,34
Hibernian,6126,1,20,10,6,63,28,35,70
Morton,6126,2,18,11,7,52,37,15,65
Falkirk,6126,3,16,13,7,59,38,21,61
Dundee Utd,6126,4,15,11,10,49,43,6,56
Queen of S't,6126,5,12,10,14,46,51,-5,46
Dunfermline,6126,6,10,12,14,46,48,-2,42
St Mirren,6126,7,10,9,17,42,57,-15,39
Raith,6126,8,10,9,17,34,52,-18,39
Dumbarton,6126,9,8,13,15,43,54,-11,37
Ayr,6126,10,6,12,18,31,57,-26,30
Hibernian,6127,1,19,14,3,58,24,34,71
Dundee Utd,6127,2,16,12,8,51,40,11,60
Morton,6127,3,15,12,9,47,39,8,57
Falkirk,6127,4,15,10,11,57,42,15,55
Raith,6127,5,11,12,13,37,45,-8,45
Dumbarton,6127,6,10,12,14,54,61,-7,42
Dunfermline,6127,7,8,15,13,41,46,-5,39
Queen of S't,6127,8,10,9,17,42,53,-11,39
Ayr,6127,9,7,15,14,33,52,-19,36
St Mirren,6127,10,8,11,17,38,56,-18,35
Hibernian,6128,1,19,12,5,62,26,36,69
Morton,6128,2,18,11,7,51,32,19,65
Falkirk,6128,3,17,10,9,59,41,18,61
Dundee Utd,6128,4,15,9,12,48,44,4,54
Queen of S't,6128,5,13,11,12,44,42,2,50
St Mirren,6128,6,10,10,16,42,54,-12,40
Dunfermline,6128,7,8,14,14,44,51,-7,38
Raith,6128,8,9,10,17,34,57,-23,37
Ayr,6128,9,7,14,15,33,54,-21,35
Dumbarton,6128,10,7,13,16,40,56,-16,34
Hibernian,6129,1,17,13,6,54,31,23,64
Falkirk,6129,2,17,10,9,62,44,18,61
Morton,6129,3,17,9,10,48,39,9,60
Dundee Utd,6129,4,16,10,10,51,40,11,58
Queen of S't,6129,5,13,10,13,54,55,-1,49
Dunfermline,6129,6,10,13,13,48,49,-1,43
St Mirren,6129,7,9,12,15,40,51,-11,39
Raith,6129,8,10,9,17,34,53,-19,39
Ayr,6129,9,8,13,15,37,53,-16,37
Dumbarton,6129,10,7,13,16,45,58,-13,34
Hibernian,6130,1,21,10,5,61,30,31,73
Morton,6130,2,19,9,8,56,36,20,66
Falkirk,6130,3,18,11,7,65,38,27,65
Dundee Utd,6130,4,16,9,11,44,39,5,57
Queen of S't,6130,5,12,8,16,44,50,-6,44
Dumbarton,6130,6,9,13,14,47,54,-7,40
Raith,6130,7,10,10,16,37,53,-16,40
Dunfermline,6130,8,8,12,16,42,51,-9,36
St Mirren,6130,9,8,11,17,39,56,-17,35
Ayr,6130,10,7,11,18,29,57,-28,32
Hibernian,6131,1,21,10,5,56,24,32,73
Morton,6131,2,17,12,7,54,36,18,63
Dundee Utd,6131,3,17,11,8,57,41,16,62
Falkirk,6131,4,16,11,9,60,43,17,59
Dunfermline,6131,5,10,14,12,48,50,-2,44
Queen of S't,6131,6,11,8,17,44,56,-12,41
Raith,6131,7,10,9,17,32,45,-13,39
Ayr,6131,8,9,11,16,32,53,-21,38
St Mirren,6131,9,7,13,16,41,56,-15,34
Dumbarton,6131,10,7,11,18,44,64,-20,32
Hibernian,6132,1,19,13,4,53,23,30,70
Falkirk,6132,2,17,10,9,60,40,20,61
Morton,6132,3,17,10,9,56,39,17,61
Dundee Utd,6132,4,14,8,14,51,44,7,50
Dunfermline,6132,5,10,14,12,42,46,-4,44
Queen of S't,6132,6,11,11,14,43,48,-5,44
Dumbarton,6132,7,10,11,15,48,62,-14,41
Raith,6132,8,10,10,16,38,49,-11,40
Ayr,6132,9,9,12,15,33,57,-24,39
St Mirren,6132,10,9,9,18,42,58,-16,36
Hibernian,6133,1,19,13,4,50,23,27,70
Falkirk,6133,2,17,10,9,62,38,24,61
Dundee Utd,6133,3,17,10,9,57,40,17,61
Morton,6133,4,16,10,10,56,42,14,58
Queen of S't,6133,5,10,12,14,45,52,-7,42
St Mirren,6133,6,10,11,15,47,54,-7,41
Dunfermline,6133,7,9,13,14,48,57,-9,40
Raith,6133,8,10,10,16,38,53,-15,40
Ayr,6133,9,8,12,16,36,60,-24,36
Dumbarton,6133,10,7,13,16,44,64,-20,34
Hibernian,6134,1,19,11,6,57,30,27,68
Morton,6134,2,17,12,7,51,35,16,63
Dundee Utd,6134,3,15,11,10,53,39,14,56
Falkirk,6134,4,14,12,10,52,42,10,54
Dunfermline,6134,5,11,13,12,47,47,0,46
Queen of S't,6134,6,11,11,14,45,47,-2,44
Dumbarton,6134,7,11,11,14,56,59,-3,44
St Mirren,6134,8,10,9,17,45,55,-10,39
Raith,6134,9,9,9,18,31,58,-27,36
Ayr,6134,10,8,11,17,34,59,-25,35
Hibernian,6135,1,18,12,6,54,28,26,66
Dundee Utd,6135,2,16,10,10,49,38,11,58
Morton,6135,3,14,14,8,47,39,8,56
Falkirk,6135,4,14,11,11,54,45,9,53
Raith,6135,5,12,9,15,40,50,-10,45
Dunfermline,6135,6,10,14,12,49,46,3,44
Queen of S't,6135,7,11,11,14,45,52,-7,44
Dumbarton,6135,8,10,12,14,51,58,-7,42
Ayr,6135,9,9,12,15,34,53,-19,39
St Mirren,6135,10,8,11,17,44,58,-14,35
Hibernian,6136,1,19,13,4,55,23,32,70
Morton,6136,2,20,9,7,49,31,18,69
Dundee Utd,6136,3,16,10,10,54,38,16,58
Falkirk,6136,4,14,13,9,58,45,13,55
Queen of S't,6136,5,13,11,12,50,48,2,50
Dumbarton,6136,6,10,11,15,47,57,-10,41
Dunfermline,6136,7,8,12,16,44,54,-10,36
St Mirren,6136,8,9,9,18,39,58,-19,36
Ayr,6136,9,8,12,16,36,59,-23,36
Raith,6136,10,8,10,18,31,50,-19,34
Hibernian,6137,1,18,14,4,55,27,28,68
Morton,6137,2,18,10,8,55,36,19,64
Dundee Utd,6137,3,16,10,10,54,42,12,58
Falkirk,6137,4,14,12,10,55,43,12,54
Dunfermline,6137,5,10,14,12,48,48,0,44
Queen of S't,6137,6,11,11,14,44,48,-4,44
Raith,6137,7,11,10,15,38,49,-11,43
Ayr,6137,8,10,11,15,39,58,-19,41
Dumbarton,6137,9,8,12,16,45,61,-16,36
St Mirren,6137,10,7,10,19,36,57,-21,31
Hibernian,6138,1,19,12,5,54,27,27,69
Morton,6138,2,17,12,7,49,32,17,63
Falkirk,6138,3,17,11,8,59,38,21,62
Dundee Utd,6138,4,15,9,12,50,41,9,54
Dunfermline,6138,5,11,13,12,49,49,0,46
Raith,6138,6,11,9,16,38,47,-9,42
Dumbarton,6138,7,9,14,13,49,57,-8,41
Queen of S't,6138,8,10,9,17,43,57,-14,39
Ayr,6138,9,8,12,16,36,59,-23,36
St Mirren,6138,10,8,9,19,39,59,-20,33
Hibernian,6139,1,17,14,5,52,26,26,65
Falkirk,6139,2,18,10,8,63,39,24,64
Morton,6139,3,16,12,8,48,34,14,60
Dundee Utd,6139,4,15,10,11,47,37,10,55
Raith,6139,5,11,11,14,37,47,-10,44
St Mirren,6139,6,10,11,15,41,52,-11,41
Queen of S't,6139,7,10,10,16,42,53,-11,40
Dumbarton,6139,8,9,12,15,46,58,-12,39
Dunfermline,6139,9,9,11,16,42,51,-9,38
Ayr,6139,10,8,13,15,31,52,-21,37
Hibernian,6140,1,19,12,5,53,27,26,69
Morton,6140,2,17,11,8,51,38,13,62
Falkirk,6140,3,16,12,8,57,37,20,60
Dundee Utd,6140,4,15,11,10,47,37,10,56
Queen of S't,6140,5,12,9,15,41,46,-5,45
Dunfermline,6140,6,10,14,12,41,41,0,44
Raith,6140,7,11,9,16,38,50,-12,42
Dumbarton,6140,8,9,13,14,45,55,-10,40
Ayr,6140,9,8,10,18,32,58,-26,34
St Mirren,6140,10,7,11,18,41,57,-16,32
Hibernian,6141,1,20,11,5,59,27,32,71
Morton,6141,2,16,11,9,50,37,13,59
Dundee Utd,6141,3,16,9,11,49,39,10,57
Falkirk,6141,4,14,10,12,54,44,10,52
Queen of S't,6141,5,13,8,15,45,50,-5,47
Dumbarton,6141,6,12,10,14,55,55,0,46
Raith,6141,7,10,11,15,35,49,-14,41
St Mirren,6141,8,9,12,15,40,55,-15,39
Dunfermline,6141,9,8,14,14,45,55,-10,38
Ayr,6141,10,7,14,15,32,53,-21,35
Hibernian,6142,1,20,11,5,59,26,33,71
Falkirk,6142,2,17,9,10,62,44,18,60
Morton,6142,3,14,14,8,49,39,10,56
Dundee Utd,6142,4,15,10,11,49,45,4,55
Queen of S't,6142,5,13,10,13,48,48,0,49
Dunfermline,6142,6,10,14,12,48,48,0,44
Dumbarton,6142,7,10,11,15,53,59,-6,41
Raith,6142,8,9,11,16,36,51,-15,38
St Mirren,6142,9,8,11,17,40,59,-19,35
Ayr,6142,10,8,11,17,32,57,-25,35
Hibernian,6143,1,21,11,4,57,24,33,74
Falkirk,6143,2,16,11,9,55,36,19,59
Dundee Utd,6143,3,16,10,10,46,35,11,58
Morton,6143,4,15,12,9,46,37,9,57
Dunfermline,6143,5,12,12,12,49,46,3,48
Queen of S't,6143,6,10,13,13,43,46,-3,43
Ayr,6143,7,8,14,14,33,51,-18,38
Dumbarton,6143,8,8,12,16,43,57,-14,36
St Mirren,6143,9,8,11,17,37,53,-16,35
Raith,6143,10,8,10,18,32,56,-24,34
Hibernian,6144,1,21,11,4,59,23,36,74
Morton,6144,2,17,12,7,52,38,14,63
Dundee Utd,6144,3,17,11,8,51,37,14,62
Falkirk,6144,4,16,11,9,56,38,18,59
Queen of S't,6144,5,11,12,13,45,47,-2,45
Dunfermline,6144,6,8,14,14,42,49,-7,38
Dumbarton,6144,7,9,10,17,44,56,-12,37
Raith,6144,8,9,10,17,36,53,-17,37
Ayr,6144,9,7,14,15,30,52,-22,35
St Mirren,6144,10,7,11,18,40,62,-22,32
Hibernian,6145,1,20,13,3,63,22,41,73
Dundee Utd,6145,2,17,9,10,60,45,15,60
Morton,6145,3,15,14,7,47,35,12,59
Falkirk,6145,4,16,10,10,62,40,22,58
Queen of S't,6145,5,14,9,13,47,49,-2,51
Dumbarton,6145,6,10,12,14,50,60,-10,42
Raith,6145,7,9,12,15,32,48,-16,39
Dunfermline,6145,8,7,14,15,41,52,-11,35
Ayr,6145,9,7,13,16,31,53,-22,34
St Mirren,6145,10,7,10,19,37,66,-29,31
Hibernian,6146,1,21,11,4,59,26,33,74
Falkirk,6146,2,15,13,8,58,40,18,58
Morton,6146,3,14,13,9,44,36,8,55
Dundee Utd,6146,4,14,10,12,47,42,5,52
Dunfermline,6146,5,12,12,12,48,45,3,48
Raith,6146,6,11,10,15,36,48,-12,43
Queen of S't,6146,7,11,9,16,42,51,-9,42
Dumbarton,6146,8,10,11,15,49,58,-9,41
Ayr,6146,9,8,12,16,34,54,-20,36
St Mirren,6146,10,8,11,17,38,55,-17,35
Hibernian,6147,1,17,13,6,49,25,24,64
Morton,6147,2,16,11,9,47,37,10,59
Falkirk,6147,3,16,10,10,56,40,16,58
Dundee Utd,6147,4,16,9,11,46,37,9,57
Dunfermline,6147,5,11,14,11,46,42,4,47
Queen of S't,6147,6,13,8,15,49,49,0,47
St Mirren,6147,7,10,10,16,41,52,-11,40
Raith,6147,8,10,10,16,33,49,-16,40
Dumbarton,6147,9,8,13,15,43,59,-16,37
Ayr,6147,10,8,12,16,33,53,-20,36
Hibernian,6148,1,20,10,6,55,23,32,70
Dundee Utd,6148,2,19,9,8,56,35,21,66
Falkirk,6148,3,17,10,9,60,39,21,61
Morton,6148,4,15,10,11,48,42,6,55
Queen of S't,6148,5,11,13,12,42,45,-3,46
Dunfermline,6148,6,11,12,13,45,51,-6,45
Dumbarton,6148,7,10,10,16,47,56,-9,40
Ayr,6148,8,9,11,16,33,54,-21,38
St Mirren,6148,9,8,10,18,37,56,-19,34
Raith,6148,10,8,9,19,29,51,-22,33
Hibernian,6149,1,20,13,3,56,22,34,73
Morton,6149,2,17,13,6,52,35,17,64
Dundee Utd,6149,3,18,9,9,59,37,22,63
Falkirk,6149,4,14,11,11,52,44,8,53
Queen of S't,6149,5,12,11,13,43,45,-2,47
Dunfermline,6149,6,9,13,14,45,49,-4,40
Raith,6149,7,9,10,17,35,50,-15,37
Dumbarton,6149,8,8,12,16,46,60,-14,36
St Mirren,6149,9,8,11,17,36,57,-21,35
Ayr,6149,10,7,13,16,35,60,-25,34
Hibernian,6150,1,22,10,4,59,21,38,76
Falkirk,6150,2,17,11,8,58,36,22,62
Morton,6150,3,17,11,8,54,39,15,62
Dundee Utd,6150,4,17,9,10,49,37,12,60
Queen of S't,6150,5,11,11,14,43,51,-8,44
Dunfermline,6150,6,9,13,14,49,52,-3,40
St Mirren,6150,7,10,9,17,38,56,-18,39
Raith,6150,8,9,11,16,33,46,-13,38
Dumbarton,6150,9,7,13,16,45,61,-16,34
Ayr,6150,10,6,12,18,30,59,-29,30
Hibernian,6151,1,17,14,5,54,31,23,65
Morton,6151,2,17,11,8,51,35,16,62
Dundee Utd,6151,3,18,8,10,53,38,15,62
Falkirk,6151,4,15,11,10,59,42,17,56
Raith,6151,5,11,11,14,41,52,-11,44
Queen of S't,6151,6,10,11,15,43,49,-6,41
Dumbarton,6151,7,10,11,15,46,57,-11,41
Ayr,6151,8,10,11,15,37,51,-14,41
Dunfermline,6151,9,8,15,13,48,54,-6,39
St Mirren,6151,10,8,9,19,36,59,-23,33
Hibernian,6152,1,20,11,5,55,28,27,71
Falkirk,6152,2,17,10,9,56,38,18,61
Morton,6152,3,17,10,9,49,35,14,61
Dundee Utd,6152,4,16,11,9,56,39,17,59
Queen of S't,6152,5,12,8,16,45,51,-6,44
Raith,6152,6,12,8,16,39,47,-8,44
Dunfermline,6152,7,10,11,15,48,52,-4,41
Ayr,6152,8,9,10,17,34,59,-25,37
Dumbarton,6152,9,8,12,16,48,64,-16,36
St Mirren,6152,10,8,11,17,39,56,-17,35
Hibernian,6153,1,20,13,3,60,23,37,73
Falkirk,6153,2,17,11,8,60,39,21,62
Morton,6153,3,15,12,9,50,42,8,57
Dundee Utd,6153,4,15,11,10,47,39,8,56
Queen of S't,6153,5,12,11,13,47,47,0,47
Dunfermline,6153,6,9,16,11,43,44,-1,43
St Mirren,6153,7,10,11,15,40,50,-10,41
Dumbarton,6153,8,9,10,17,44,60,-16,37
Raith,6153,9,8,9,19,30,52,-22,33
Ayr,6153,10,7,12,17,29,54,-25,33
Hibernian,6154,1,19,14,3,55,24,31,71
Dundee Utd,6154,2,17,10,9,59,40,19,61
Falkirk,6154,3,16,10,10,57,42,15,58
Morton,6154,4,13,13,10,44,40,4,52
Queen of S't,6154,5,14,10,12,48,45,3,52
Dunfermline,6154,6,10,15,11,54,51,3,45
Raith,6154,7,10,9,17,35,53,-18,39
Dumbarton,6154,8,8,11,17,46,60,-14,35
St Mirren,6154,9,8,11,17,40,60,-20,35
Ayr,6154,10,7,13,16,31,54,-23,34
Hibernian,6155,1,19,11,6,59,28,31,68
Morton,6155,2,18,10,8,50,33,17,64
Falkirk,6155,3,17,9,10,61,42,19,60
Dundee Utd,6155,4,15,11,10,47,41,6,56
Queen of S't,6155,5,12,9,15,40,51,-11,45
Ayr,6155,6,10,12,14,35,50,-15,42
Dumbarton,6155,7,9,14,13,52,59,-7,41
Raith,6155,8,10,10,16,34,47,-13,40
Dunfermline,6155,9,9,12,15,43,48,-5,39
St Mirren,6155,10,7,10,19,36,58,-22,31
Hibernian,6156,1,17,14,5,54,29,25,65
Morton,6156,2,17,12,7,52,35,17,63
Falkirk,6156,3,15,13,8,58,41,17,58
Dundee Utd,6156,4,15,12,9,55,43,12,57
Queen of S't,6156,5,12,11,13,50,49,1,47
Raith,6156,6,11,10,15,36,47,-11,43
Dunfermline,6156,7,9,14,13,41,46,-5,41
Dumbarton,6156,8,10,11,15,50,62,-12,41
Ayr,6156,9,7,13,16,37,58,-21,34
St Mirren,6156,10,7,10,19,42,65,-23,31
Hibernian,6157,1,19,12,5,59,28,31,69
Morton,6157,2,16,14,6,50,38,12,62
Falkirk,6157,3,16,11,9,62,39,23,59
Dundee Utd,6157,4,16,10,10,55,41,14,58
Queen of S't,6157,5,11,11,14,45,48,-3,44
Dunfermline,6157,6,9,16,11,45,47,-2,43
Raith,6157,7,10,11,15,35,49,-14,41
Ayr,6157,8,8,12,16,35,63,-28,36
St Mirren,6157,9,8,11,17,39,55,-16,35
Dumbarton,6157,10,7,12,17,43,60,-17,33
Hibernian,6158,1,18,13,5,52,25,27,67
Dundee Utd,6158,2,17,9,10,57,43,14,60
Morton,6158,3,15,13,8,51,36,15,58
Falkirk,6158,4,13,12,11,56,49,7,51
Raith,6158,5,12,10,14,39,44,-5,46
Queen of S't,6158,6,11,11,14,42,49,-7,44
Ayr,6158,7,10,12,14,38,53,-15,42
Dunfermline,6158,8,9,13,14,46,52,-6,40
Dumbarton,6158,9,8,13,15,46,59,-13,37
St Mirren,6158,10,9,10,17,39,56,-17,37
Hibernian,6159,1,19,11,6,55,28,27,68
Dundee Utd,6159,2,18,9,9,50,36,14,63
Falkirk,6159,3,16,10,10,58,40,18,58
Morton,6159,4,15,12,9,50,38,12,57
Dumbarton,6159,5,12,11,13,50,53,-3,47
Queen of S't,6159,6,11,10,15,41,50,-9,43
Raith,6159,7,11,9,16,37,46,-9,42
Dunfermline,6159,8,8,14,14,44,55,-11,38
St Mirren,6159,9,9,10,17,37,51,-14,37
Ayr,6159,10,7,12,17,31,56,-25,33
Hibernian,6160,1,20,12,4,61,28,33,72
Falkirk,6160,2,17,11,8,66,44,22,62
Morton,6160,3,16,10,10,49,38,11,58
Dundee Utd,6160,4,16,9,11,46,37,9,57
Dumbarton,6160,5,10,12,14,47,53,-6,42
Queen of S't,6160,6,11,9,16,42,54,-12,42
Raith,6160,7,10,11,15,36,46,-10,41
Dunfermline,6160,8,9,13,14,43,51,-8,40
Ayr,6160,9,9,12,15,32,51,-19,39
St Mirren,6160,10,8,9,19,40,60,-20,33
Morton,6161,1,18,12,6,52,34,18,66
Hibernian,6161,2,18,11,7,51,28,23,65
Falkirk,6161,3,17,11,8,60,39,21,62
Dundee Utd,6161,4,14,10,12,47,43,4,52
Queen of S't,6161,5,12,9,15,45,48,-3,45
Ayr,6161,6,10,12,14,38,55,-17,42
Raith,6161,7,9,13,14,37,49,-12,40
St Mirren,6161,8,9,11,16,41,54,-13,38
Dunfermline,6161,9,7,15,14,42,50,-8,36
Dumbarton,6161,10,8,12,16,45,58,-13,36
Hibernian,6162,1,18,14,4,52,24,28,68
Morton,6162,2,16,13,7,47,34,13,61
Falkirk,6162,3,16,11,9,60,41,19,59
Dundee Utd,6162,4,15,12,9,51,40,11,57
Dunfermline,6162,5,10,13,13,43,45,-2,43
Dumbarton,6162,6,10,11,15,50,59,-9,41
Queen of S't,6162,7,10,9,17,41,51,-10,39
St Mirren,6162,8,9,11,16,42,57,-15,38
Ayr,6162,9,8,14,14,35,54,-19,38
Raith,6162,10,9,10,17,33,49,-16,37
Hibernian,6163,1,23,10,3,62,26,36,79
Falkirk,6163,2,17,10,9,60,39,21,61
Dundee Utd,6163,3,16,10,10,55,37,18,58
Morton,6163,4,14,12,10,44,38,6,54
Ayr,6163,5,10,11,15,37,57,-20,41
Dunfermline,6163,6,9,13,14,46,50,-4,40
Queen of S't,6163,7,10,10,16,43,56,-13,40
Raith,6163,8,10,10,16,36,51,-15,40
St Mirren,6163,9,9,11,16,41,53,-12,38
Dumbarton,6163,10,7,13,16,45,62,-17,34
Hibernian,6164,1,17,13,6,51,27,24,64
Dundee Utd,6164,2,17,9,10,50,38,12,60
Morton,6164,3,15,12,9,50,39,11,57
Falkirk,6164,4,15,10,11,55,42,13,55
Queen of S't,6164,5,14,9,13,52,50,2,51
Dumbarton,6164,6,11,11,14,50,55,-5,44
Raith,6164,7,11,9,16,35,48,-13,42
Dunfermline,6164,8,9,13,14,43,48,-5,40
Ayr,6164,9,8,13,15,33,56,-23,37
St Mirren,6164,10,9,9,18,38,54,-16,36
Hibernian,6165,1,18,12,6,54,26,28,66
Dundee Utd,6165,2,18,10,8,58,38,20,64
Falkirk,6165,3,17,11,8,61,37,24,62
Morton,6165,4,17,10,9,53,43,10,61
Queen of S't,6165,5,12,9,15,47,49,-2,45
Raith,6165,6,12,9,15,41,48,-7,45
Dunfermline,6165,7,8,13,15,44,57,-13,37
St Mirren,6165,8,9,10,17,44,59,-15,37
Ayr,6165,9,8,12,16,34,59,-25,36
Dumbarton,6165,10,7,12,17,46,66,-20,33
Hibernian,6166,1,19,13,4,57,25,32,70
Morton,6166,2,15,13,8,47,37,10,58
Dundee Utd,6166,3,16,8,12,51,43,8,56
Falkirk,6166,4,14,12,10,55,43,12,54
Dunfermline,6166,5,11,13,12,42,42,0,46
Queen of S't,6166,6,11,10,15,46,50,-4,43
Raith,6166,7,10,11,15,36,48,-12,41
Dumbarton,6166,8,9,12,15,46,61,-15,39
Ayr,6166,9,8,14,14,39,54,-15,38
St Mirren,6166,10,8,12,16,38,54,-16,36
Hibernian,6167,1,21,12,3,64,26,38,75
Falkirk,6167,2,18,10,8,63,41,22,64
Morton,6167,3,15,12,9,56,41,15,57
Dundee Utd,6167,4,15,11,10,53,42,11,56
Queen of S't,6167,5,12,10,14,45,50,-5,46
Dunfermline,6167,6,9,15,12,47,52,-5,42
Dumbarton,6167,7,9,12,15,48,58,-10,39
Ayr,6167,8,8,12,16,34,55,-21,36
Raith,6167,9,9,8,19,31,55,-24,35
St Mirren,6167,10,8,10,18,38,59,-21,34
Hibernian,6168,1,19,10,7,58,25,33,67
Morton,6168,2,15,12,9,45,37,8,57
Falkirk,6168,3,14,11,11,57,47,10,53
Dundee Utd,6168,4,12,12,12,45,43,2,48
Dumbarton,6168,5,12,11,13,54,56,-2,47
Queen of S't,6168,6,13,8,15,50,56,-6,47
Dunfermline,6168,7,10,14,12,47,47,0,44
St Mirren,6168,8,11,10,15,41,54,-13,43
Raith,6168,9,10,11,15,36,47,-11,41
Ayr,6168,10,8,13,15,33,54,-21,37
Hibernian,6169,1,18,14,4,57,24,33,68
Morton,6169,2,17,12,7,50,34,16,63
Dundee Utd,6169,3,17,9,10,50,39,11,60
Falkirk,6169,4,14,13,9,58,44,14,55
Dunfermline,6169,5,12,11,13,47,47,0,47
Ayr,6169,6,11,12,13,37,49,-12,45
Dumbarton,6169,7,9,12,15,48,61,-13,39
Queen of S't,6169,8,9,10,17,45,58,-13,37
Raith,6169,9,9,10,17,33,49,-16,37
St Mirren,6169,10,7,11,18,40,60,-20,32
Hibernian,6170,1,18,14,4,52,26,26,68
Morton,6170,2,17,11,8,51,36,15,62
Dundee Utd,6170,3,16,10,10,55,44,11,58
Falkirk,6170,4,14,12,10,49,39,10,54
Dunfermline,6170,5,11,13,12,49,47,2,46
Ayr,6170,6,10,12,14,36,54,-18,42
Queen of S't,6170,7,10,9,17,43,53,-10,39
Dumbarton,6170,8,9,11,16,44,55,-11,38
St Mirren,6170,9,9,11,16,40,52,-12,38
Raith,6170,10,9,11,16,31,44,-13,38
Hibernian,6171,1,17,16,3,57,28,29,67
Morton,6171,2,16,13,7,48,34,14,61
Falkirk,6171,3,16,11,9,55,38,17,59
Dundee Utd,6171,4,15,9,12,48,41,7,54
Queen of S't,6171,5,15,9,12,52,49,3,54
Dumbarton,6171,6,11,11,14,50,53,-3,44
Dunfermline,6171,7,9,13,14,44,49,-5,40
Raith,6171,8,10,8,18,35,54,-19,38
St Mirren,6171,9,7,13,16,39,57,-18,34
Ayr,6171,10,6,13,17,32,57,-25,31
Hibernian,6172,1,17,15,4,55,25,30,66
Falkirk,6172,2,17,11,8,58,39,19,62
Morton,6172,3,16,14,6,49,36,13,62
Dundee Utd,6172,4,14,10,12,47,41,6,52
Raith,6172,5,11,10,15,39,49,-10,43
Dumbarton,6172,6,10,12,14,45,52,-7,42
Queen of S't,6172,7,11,8,17,44,58,-14,41
Ayr,6172,8,9,12,15,33,51,-18,39
St Mirren,6172,9,9,11,16,41,55,-14,38
Dunfermline,6172,10,8,13,15,45,50,-5,37
Morton,6173,1,20,10,6,55,30,25,70
Falkirk,6173,2,19,9,8,63,37,26,66
Hibernian,6173,3,17,12,7,53,28,25,63
Dundee Utd,6173,4,14,11,11,48,42,6,53
Queen of S't,6173,5,12,9,15,49,52,-3,45
Dunfermline,6173,6,9,14,13,46,53,-7,41
Ayr,6173,7,9,12,15,31,52,-21,39
Dumbarton,6173,8,9,11,16,48,59,-11,38
Raith,6173,9,9,10,17,34,52,-18,37
St Mirren,6173,10,8,10,18,37,59,-22,34
Hibernian,6174,1,19,13,4,54,25,29,70
Morton,6174,2,17,13,6,49,32,17,64
Falkirk,6174,3,17,9,10,59,43,16,60
Dundee Utd,6174,4,17,8,11,48,38,10,59
Queen of S't,6174,5,13,9,14,44,47,-3,48
Dunfermline,6174,6,11,13,12,54,53,1,46
Raith,6174,7,10,11,15,38,49,-11,41
Dumbarton,6174,8,8,11,17,46,60,-14,35
St Mirren,6174,9,7,11,18,37,55,-18,32
Ayr,6174,10,6,12,18,31,58,-27,30
Hibernian,6175,1,19,13,4,59,29,30,70
Morton,6175,2,17,10,9,52,39,13,61
Falkirk,6175,3,16,11,9,57,39,18,59
Dundee Utd,6175,4,16,10,10,51,38,13,58
Queen of S't,6175,5,12,9,15,47,48,-1,45
Ayr,6175,6,11,12,13,40,57,-17,45
Dunfermline,6175,7,10,14,12,44,44,0,44
St Mirren,6175,8,8,11,17,47,62,-15,35
Raith,6175,9,9,8,19,38,60,-22,35
Dumbarton,6175,10,7,12,17,46,65,-19,33
Hibernian,6176,1,20,11,5,53,25,28,71
Falkirk,6176,2,17,11,8,63,41,22,62
Dundee Utd,6176,3,17,8,11,53,40,13,59
Morton,6176,4,16,11,9,51,38,13,59
Queen of S't,6176,5,13,9,14,49,48,1,48
Dunfermline,6176,6,9,12,15,42,50,-8,39
Dumbarton,6176,7,9,11,16,47,62,-15,38
Ayr,6176,8,9,11,16,35,54,-19,38
Raith,6176,9,9,10,17,32,51,-19,37
St Mirren,6176,10,8,12,16,40,56,-16,36
Hibernian,6177,1,20,13,3,54,23,31,73
Morton,6177,2,15,15,6,55,37,18,60
Falkirk,6177,3,15,12,9,55,39,16,57
Dundee Utd,6177,4,14,12,10,47,42,5,54
Dunfermline,6177,5,12,12,12,45,44,1,48
Queen of S't,6177,6,11,9,16,48,53,-5,42
Ayr,6177,7,9,13,14,36,51,-15,40
Raith,6177,8,9,10,17,31,46,-15,37
St Mirren,6177,9,9,10,17,38,56,-18,37
Dumbarton,6177,10,7,12,17,42,60,-18,33
Hibernian,6178,1,19,11,6,56,26,30,68
Morton,6178,2,17,12,7,51,34,17,63
Falkirk,6178,3,16,10,10,57,41,16,58
Dundee Utd,6178,4,16,10,10,56,43,13,58
Queen of S't,6178,5,12,8,16,48,56,-8,44
Dunfermline,6178,6,10,12,14,44,51,-7,42
Raith,6178,7,11,8,17,35,48,-13,41
Ayr,6178,8,9,13,14,35,54,-19,40
Dumbarton,6178,9,8,13,15,51,65,-14,37
St Mirren,6178,10,8,11,17,42,57,-15,35
Hibernian,6179,1,19,12,5,55,28,27,69
Dundee Utd,6179,2,17,10,9,51,38,13,61
Morton,6179,3,16,12,8,49,35,14,60
Falkirk,6179,4,14,14,8,57,42,15,56
Dunfermline,6179,5,11,13,12,46,44,2,46
Queen of S't,6179,6,11,11,14,46,52,-6,44
Raith,6179,7,11,9,16,38,46,-8,42
Dumbarton,6179,8,9,12,15,48,61,-13,39
St Mirren,6179,9,8,9,19,40,57,-17,33
Ayr,6179,10,7,12,17,36,63,-27,33
Hibernian,6180,1,19,10,7,56,27,29,67
Falkirk,6180,2,17,11,8,60,42,18,62
Dundee Utd,6180,3,17,10,9,54,37,17,61
Morton,6180,4,17,10,9,52,41,11,61
Queen of S't,6180,5,12,10,14,41,46,-5,46
Dunfermline,6180,6,11,12,13,48,49,-1,45
Raith,6180,7,9,10,17,32,47,-15,37
Ayr,6180,8,8,13,15,33,53,-20,37
Dumbarton,6180,9,8,12,16,44,58,-14,36
St Mirren,6180,10,7,12,17,39,59,-20,33
Hibernian,6181,1,19,14,3,55,24,31,71
Morton,6181,2,17,10,9,49,40,9,61
Dundee Utd,6181,3,16,9,11,53,39,14,57
Falkirk,6181,4,15,10,11,62,47,15,55
Queen of S't,6181,5,13,9,14,50,53,-3,48
Dumbarton,6181,6,11,12,13,57,57,0,45
Raith,6181,7,11,11,14,37,47,-10,44
Dunfermline,6181,8,9,11,16,44,53,-9,38
Ayr,6181,9,8,13,15,31,52,-21,37
St Mirren,6181,10,6,11,19,35,61,-26,29
Hibernian,6182,1,21,11,4,55,23,32,74
Morton,6182,2,18,9,9,50,39,11,63
Dundee Utd,6182,3,16,11,9,50,39,11,59
Falkirk,6182,4,15,10,11,56,43,13,55
Dumbarton,6182,5,11,11,14,47,56,-9,44
Queen of S't,6182,6,11,9,16,43,51,-8,42
Dunfermline,6182,7,9,13,14,41,45,-4,40
Ayr,6182,8,9,13,14,40,50,-10,40
Raith,6182,9,9,9,18,31,50,-19,36
St Mirren,6182,10,7,12,17,36,53,-17,33
Hibernian,6183,1,18,14,4,57,27,30,68
Falkirk,6183,2,17,10,9,60,43,17,61
Dundee Utd,6183,3,17,9,10,52,38,14,60
Morton,6183,4,16,11,9,50,37,13,59
Dunfermline,6183,5,11,12,13,48,49,-1,45
Raith,6183,6,11,9,16,35,47,-12,42
Ayr,6183,7,10,10,16,34,54,-20,40
Queen of S't,6183,8,10,9,17,44,55,-11,39
St Mirren,6183,9,8,12,16,43,55,-12,36
Dumbarton,6183,10,8,12,16,48,66,-18,36
Hibernian,6184,1,18,11,7,54,31,23,65
Morton,6184,2,17,12,7,51,35,16,63
Falkirk,6184,3,14,12,10,53,40,13,54
Dundee Utd,6184,4,15,9,12,47,41,6,54
Queen of S't,6184,5,13,8,15,47,49,-2,47
Dumbarton,6184,6,11,12,13,49,54,-5,45
Dunfermline,6184,7,10,13,13,51,51,0,43
Raith,6184,8,10,11,15,33,47,-14,41
St Mirren,6184,9,9,11,16,42,52,-10,38
Ayr,6184,10,8,11,17,33,60,-27,35
Hibernian,6185,1,20,12,4,55,27,28,72
Morton,6185,2,18,11,7,55,35,20,65
Falkirk,6185,3,16,12,8,58,38,20,60
Dundee Utd,6185,4,14,10,12,45,41,4,52
Queen of S't,6185,5,12,10,14,44,44,0,46
Raith,6185,6,11,9,16,34,46,-12,42
St Mirren,6185,7,9,11,16,42,54,-12,38
Ayr,6185,8,9,11,16,36,54,-18,38
Dunfermline,6185,9,8,13,15,41,49,-8,37
Dumbarton,6185,10,7,13,16,43,65,-22,34
Hibernian,6186,1,19,12,5,51,26,25,69
Morton,6186,2,19,9,8,59,34,25,66
Dundee Utd,6186,3,16,11,9,54,44,10,59
Falkirk,6186,4,15,10,11,58,46,12,55
Dunfermline,6186,5,10,13,13,47,46,1,43
Queen of S't,6186,6,11,10,15,46,53,-7,43
Raith,6186,7,11,10,15,40,52,-12,43
St Mirren,6186,8,8,12,16,38,53,-15,36
Dumbarton,6186,9,7,14,15,45,56,-11,35
Ayr,6186,10,7,13,16,30,58,-28,34
Hibernian,6187,1,18,13,5,61,30,31,67
Morton,6187,2,18,11,7,53,36,17,65
Dundee Utd,6187,3,17,8,11,46,36,10,59
Falkirk,6187,4,15,10,11,57,42,15,55
Dunfermline,6187,5,11,13,12,46,44,2,46
Queen of S't,6187,6,11,10,15,43,51,-8,43
Dumbarton,6187,7,9,11,16,45,61,-16,38
Ayr,6187,8,8,14,14,35,51,-16,38
Raith,6187,9,9,11,16,36,53,-17,38
St Mirren,6187,10,9,9,18,43,61,-18,36
Hibernian,6188,1,21,10,5,58,25,33,73
Morton,6188,2,18,11,7,52,35,17,65
Falkirk,6188,3,18,10,8,57,35,22,64
Dundee Utd,6188,4,17,9,10,54,46,8,60
Dunfermline,6188,5,11,12,13,43,44,-1,45
Raith,6188,6,10,10,16,31,44,-13,40
Queen of S't,6188,7,10,8,18,39,50,-11,38
Dumbarton,6188,8,9,11,16,49,61,-12,38
St Mirren,6188,9,9,9,18,41,57,-16,36
Ayr,6188,10,6,12,18,31,58,-27,30
Hibernian,6189,1,19,11,6,53,28,25,68
Morton,6189,2,18,10,8,54,35,19,64
Dundee Utd,6189,3,16,11,9,50,38,12,59
Falkirk,6189,4,16,10,10,59,40,19,58
Raith,6189,5,12,9,15,36,47,-11,45
Dunfermline,6189,6,10,12,14,47,52,-5,42
Dumbarton,6189,7,9,13,14,51,59,-8,40
Queen of S't,6189,8,10,10,16,43,53,-10,40
Ayr,6189,9,8,12,16,34,55,-21,36
St Mirren,6189,10,8,10,18,39,59,-20,34
Hibernian,6190,1,18,12,6,58,30,28,66
Dundee Utd,6190,2,18,9,9,52,39,13,63
Morton,6190,3,16,12,8,48,38,10,60
Falkirk,6190,4,16,9,11,55,39,16,57
Dunfermline,6190,5,11,13,12,50,48,2,46
Queen of S't,6190,6,12,9,15,42,47,-5,45
Raith,6190,7,11,9,16,36,51,-15,42
Dumbarton,6190,8,10,11,15,49,56,-7,41
Ayr,6190,9,7,13,16,35,56,-21,34
St Mirren,6190,10,8,9,19,36,57,-21,33
Hibernian,6191,1,18,12,6,52,24,28,66
Dundee Utd,6191,2,17,10,9,51,38,13,61
Morton,6191,3,17,10,9,47,37,10,61
Falkirk,6191,4,16,12,8,60,40,20,60
Queen of S't,6191,5,11,10,15,46,52,-6,43
Raith,6191,6,10,11,15,38,52,-14,41
St Mirren,6191,7,10,10,16,41,55,-14,40
Dunfermline,6191,8,8,15,13,43,48,-5,39
Dumbarton,6191,9,9,11,16,48,61,-13,38
Ayr,6191,10,8,11,17,38,57,-19,35
Hibernian,6192,1,21,10,5,60,25,35,73
Morton,6192,2,18,10,8,49,34,15,64
Dundee Utd,6192,3,16,9,11,50,41,9,57
Falkirk,6192,4,15,10,11,57,40,17,55
Queen of S't,6192,5,14,8,14,43,44,-1,50
Dunfermline,6192,6,10,11,15,42,50,-8,41
Ayr,6192,7,9,12,15,36,54,-18,39
St Mirren,6192,8,9,10,17,39,53,-14,37
Dumbarton,6192,9,9,10,17,44,61,-17,37
Raith,6192,10,9,10,17,34,52,-18,37
Hibernian,6193,1,20,13,3,61,25,36,73
Morton,6193,2,18,12,6,62,36,26,66
Dundee Utd,6193,3,18,8,10,56,40,16,62
Falkirk,6193,4,14,10,12,55,46,9,52
Queen of S't,6193,5,14,8,14,50,48,2,50
Dumbarton,6193,6,9,12,15,50,60,-10,39
Dunfermline,6193,7,9,12,15,41,57,-16,39
St Mirren,6193,8,8,12,16,44,57,-13,36
Ayr,6193,9,7,14,15,34,56,-22,35
Raith,6193,10,8,9,19,33,61,-28,33
Hibernian,6194,1,19,11,6,57,28,29,68
Falkirk,6194,2,18,10,8,60,39,21,64
Morton,6194,3,18,10,8,58,40,18,64
Dundee Utd,6194,4,16,9,11,54,46,8,57
Queen of S't,6194,5,12,10,14,49,50,-1,46
Dunfermline,6194,6,10,13,13,50,53,-3,43
Dumbarton,6194,7,8,13,15,45,59,-14,37
Raith,6194,8,9,10,17,33,52,-19,37
Ayr,6194,9,8,12,16,37,57,-20,36
St Mirren,6194,10,8,10,18,41,60,-19,34
Hibernian,6195,1,20,12,4,59,26,33,72
Morton,6195,2,17,12,7,52,39,13,63
Falkirk,6195,3,16,11,9,62,43,19,59
Dundee Utd,6195,4,14,12,10,51,41,10,54
Raith,6195,5,11,10,15,39,46,-7,43
Queen of S't,6195,6,11,10,15,45,54,-9,43
Dunfermline,6195,7,9,13,14,44,49,-5,40
Dumbarton,6195,8,9,13,14,44,51,-7,40
Ayr,6195,9,9,12,15,36,56,-20,39
St Mirren,6195,10,6,11,19,35,62,-27,29
Morton,6196,1,19,11,6,52,31,21,68
Hibernian,6196,2,17,12,7,49,28,21,63
Falkirk,6196,3,16,12,8,56,37,19,60
Dundee Utd,6196,4,17,9,10,47,35,12,60
Queen of S't,6196,5,11,11,14,40,44,-4,44
Dunfermline,6196,6,10,13,13,45,46,-1,43
Ayr,6196,7,10,12,14,34,50,-16,42
Raith,6196,8,10,9,17,36,53,-17,39
Dumbarton,6196,9,8,10,18,45,60,-15,34
St Mirren,6196,10,7,11,18,37,57,-20,32
Hibernian,6197,1,20,11,5,55,24,31,71
Morton,6197,2,19,9,8,59,35,24,66
Dundee Utd,6197,3,16,10,10,56,44,12,58
Falkirk,6197,4,15,12,9,59,44,15,57
Queen of S't,6197,5,12,11,13,48,47,1,47
Dunfermline,6197,6,9,13,14,45,51,-6,40
Raith,6197,7,10,10,16,40,58,-18,40
St Mirren,6197,8,9,11,16,44,56,-12,38
Dumbarton,6197,9,7,13,16,46,62,-16,34
Ayr,6197,10,7,12,17,31,62,-31,33
Hibernian,6198,1,19,11,6,57,30,27,68
Dundee Utd,6198,2,17,11,8,50,34,16,62
Morton,6198,3,17,10,9,56,39,17,61
Falkirk,6198,4,17,9,10,55,38,17,60
Raith,6198,5,13,10,13,37,42,-5,49
Dumbarton,6198,6,10,11,15,45,57,-12,41
Dunfermline,6198,7,8,14,14,43,51,-8,38
Queen of S't,6198,8,9,10,17,41,54,-13,37
Ayr,6198,9,7,15,14,35,55,-20,36
St Mirren,6198,10,7,11,18,36,55,-19,32
Hibernian,6199,1,17,15,4,53,27,26,66
Morton,6199,2,18,11,7,53,36,17,65
Dundee Utd,6199,3,16,11,9,50,36,14,59
Falkirk,6199,4,15,13,8,60,41,19,58
Dunfermline,6199,5,10,14,12,43,46,-3,44
Queen of S't,6199,6,11,10,15,44,48,-4,43
Raith,6199,7,11,9,16,34,47,-13,42
Ayr,6199,8,9,12,15,32,52,-20,39
Dumbarton,6199,9,7,13,16,46,58,-12,34
St Mirren,6199,10,6,12,18,34,58,-24,30
Hibernian,6200,1,19,12,5,60,25,35,69
Morton,6200,2,18,11,7,51,32,19,65
Dundee Utd,6200,3,16,11,9,49,36,13,59
Falkirk,6200,4,14,12,10,55,45,10,54
Queen of S't,6200,5,11,10,15,44,50,-6,43
Dunfermline,6200,6,10,12,14,47,53,-6,42
Dumbarton,6200,7,9,12,15,46,58,-12,39
Raith,6200,8,10,9,17,33,50,-17,39
Ayr,6200,9,9,12,15,34,52,-18,39
St Mirren,6200,10,8,11,17,39,57,-18,35
Hibernian,6201,1,20,11,5,59,26,33,71
Falkirk,6201,2,18,9,9,62,39,23,63
Dundee Utd,6201,3,17,9,10,57,41,16,60
Morton,6201,4,13,15,8,45,39,6,54
Queen of S't,6201,5,12,8,16,46,60,-14,44
Dunfermline,6201,6,9,16,11,50,49,1,43
St Mirren,6201,7,11,9,16,42,51,-9,42
Raith,6201,8,10,11,15,41,50,-9,41
Dumbarton,6201,9,7,12,17,48,67,-19,33
Ayr,6201,10,7,12,17,35,63,-28,33
Hibernian,6202,1,19,12,5,55,26,29,69
Falkirk,6202,2,15,11,10,58,41,17,56
Dundee Utd,6202,3,15,11,10,43,35,8,56
Morton,6202,4,13,14,9,47,40,7,53
Queen of S't,6202,5,12,10,14,45,50,-5,46
Dunfermline,6202,6,10,15,11,46,46,0,45
Raith,6202,7,11,10,15,35,49,-14,43
St Mirren,6202,8,10,9,17,48,58,-10,39
Dumbarton,6202,9,8,13,15,49,62,-13,37
Ayr,6202,10,8,13,15,34,53,-19,37
Hibernian,6203,1,20,11,5,57,25,32,71
Morton,6203,2,16,12,8,51,38,13,60
Falkirk,6203,3,16,11,9,57,40,17,59
Dundee Utd,6203,4,16,9,11,52,42,10,57
Queen of S't,6203,5,12,11,13,46,48,-2,47
Dunfermline,6203,6,10,13,13,49,49,0,43
Dumbarton,6203,7,10,12,14,44,53,-9,42
Raith,6203,8,9,11,16,32,49,-17,38
St Mirren,6203,9,7,12,17,37,55,-18,33
Ayr,6203,10,7,12,17,35,61,-26,33
Hibernian,6204,1,19,12,5,53,26,27,69
Morton,6204,2,16,12,8,51,41,10,60
Dundee Utd,6204,3,14,11,11,52,43,9,53
Falkirk,6204,4,13,12,11,56,45,11,51
Dunfermline,6204,5,10,14,12,49,47,2,44
St Mirren,6204,6,11,10,15,50,55,-5,43
Ayr,6204,7,10,12,14,32,51,-19,42
Dumbarton,6204,8,9,13,14,49,59,-10,40
Queen of S't,6204,9,10,10,16,42,52,-10,40
Raith,6204,10,10,10,16,36,51,-15,40
Hibernian,6205,1,22,10,4,60,23,37,76
Dundee Utd,6205,2,19,9,8,63,39,24,66
Morton,6205,3,17,11,8,52,44,8,62
Falkirk,6205,4,16,11,9,58,40,18,59
Queen of S't,6205,5,13,8,15,46,52,-6,47
Dunfermline,6205,6,10,12,14,48,52,-4,42
St Mirren,6205,7,8,11,17,45,59,-14,35
Raith,6205,8,8,11,17,31,50,-19,35
Dumbarton,6205,9,7,12,17,45,61,-16,33
Ayr,6205,10,6,13,17,31,59,-28,31
Hibernian,6206,1,20,12,4,57,23,34,72
Morton,6206,2,17,10,9,53,43,10,61
Falkirk,6206,3,16,10,10,58,42,16,58
Dundee Utd,6206,4,15,11,10,54,40,14,56
Dumbarton,6206,5,12,11,13,52,53,-1,47
Dunfermline,6206,6,11,12,13,45,47,-2,45
Queen of S't,6206,7,11,9,16,43,50,-7,42
Raith,6206,8,11,8,17,32,48,-16,41
Ayr,6206,9,6,16,14,32,52,-20,34
St Mirren,6206,10,6,11,19,37,65,-28,29
Hibernian,6207,1,19,11,6,56,28,28,68
Morton,6207,2,18,12,6,55,39,16,66
Dundee Utd,6207,3,15,12,9,50,37,13,57
Falkirk,6207,4,15,10,11,60,47,13,55
St Mirren,6207,5,12,10,14,49,50,-1,46
Dumbarton,6207,6,10,10,16,53,59,-6,40
Raith,6207,7,10,10,16,35,51,-16,40
Queen of S't,6207,8,9,12,15,41,52,-11,39
Dunfermline,6207,9,8,13,15,48,59,-11,37
Ayr,6207,10,8,12,16,31,56,-25,36
Morton,6208,1,17,13,6,53,36,17,64
Falkirk,6208,2,16,12,8,62,40,22,60
Hibernian,6208,3,15,13,8,51,33,18,58
Dundee Utd,6208,4,16,10,10,50,40,10,58
Queen of S't,6208,5,12,11,13,48,51,-3,47
Raith,6208,6,11,9,16,36,51,-15,42
Dunfermline,6208,7,9,14,13,44,49,-5,41
St Mirren,6208,8,10,11,15,42,53,-11,41
Ayr,6208,9,8,13,15,33,52,-19,37
Dumbarton,6208,10,7,12,17,43,57,-14,33
Hibernian,6209,1,19,12,5,52,27,25,69
Morton,6209,2,19,10,7,55,33,22,67
Falkirk,6209,3,16,10,10,61,44,17,58
Dundee Utd,6209,4,15,9,12,50,45,5,54
Queen of S't,6209,5,14,8,14,47,45,2,50
Ayr,6209,6,10,11,15,36,56,-20,41
Dumbarton,6209,7,10,10,16,48,58,-10,40
Dunfermline,6209,8,8,14,14,45,50,-5,38
St Mirren,6209,9,8,12,16,42,56,-14,36
Raith,6209,10,9,8,19,34,56,-22,35
Morton,6210,1,19,11,6,57,37,20,68
Hibernian,6210,2,19,10,7,55,28,27,67
Falkirk,6210,3,17,11,8,62,40,22,62
Dundee Utd,6210,4,15,12,9,48,38,10,57
Queen of S't,6210,5,12,9,15,43,49,-6,45
Dunfermline,6210,6,10,11,15,45,50,-5,41
Ayr,6210,7,9,12,15,34,54,-20,39
Dumbarton,6210,8,8,12,16,46,59,-13,36
St Mirren,6210,9,8,11,17,35,52,-17,35
Raith,6210,10,8,11,17,36,54,-18,35
Hibernian,6211,1,21,11,4,62,25,37,74
Dundee Utd,6211,2,17,11,8,53,40,13,62
Morton,6211,3,16,12,8,51,35,16,60
Falkirk,6211,4,14,10,12,55,44,11,52
Queen of S't,6211,5,11,11,14,47,55,-8,44
Dunfermline,6211,6,10,13,13,51,55,-4,43
Raith,6211,7,11,10,15,35,49,-14,43
Dumbarton,6211,8,10,12,14,48,55,-7,42
St Mirren,6211,9,7,11,18,38,57,-19,32
Ayr,6211,10,7,11,18,32,57,-25,32
Hibernian,6212,1,18,12,6,57,31,26,66
Morton,6212,2,16,13,7,50,39,11,61
Dundee Utd,6212,3,16,10,10,50,39,11,58
Falkirk,6212,4,15,10,11,53,43,10,55
Raith,6212,5,14,8,14,38,42,-4,50
Dunfermline,6212,6,9,16,11,47,47,0,43
Queen of S't,6212,7,10,11,15,47,51,-4,41
Dumbarton,6212,8,8,14,14,47,57,-10,38
Ayr,6212,9,8,13,15,35,54,-19,37
St Mirren,6212,10,7,11,18,37,58,-21,32
Hibernian,6213,1,18,14,4,58,29,29,68
Morton,6213,2,17,12,7,58,41,17,63
Dundee Utd,6213,3,17,9,10,54,39,15,60
Falkirk,6213,4,16,11,9,58,43,15,59
Queen of S't,6213,5,12,10,14,46,50,-4,46
Dunfermline,6213,6,10,13,13,48,51,-3,43
Dumbarton,6213,7,9,12,15,50,61,-11,39
St Mirren,6213,8,9,11,16,45,53,-8,38
Raith,6213,9,9,10,17,32,50,-18,37
Ayr,6213,10,6,12,18,31,63,-32,30
Hibernian,6214,1,18,12,6,54,29,25,66
Morton,6214,2,18,11,7,50,32,18,65
Falkirk,6214,3,17,10,9,59,40,19,61
Dundee Utd,6214,4,14,12,10,45,35,10,54
Ayr,6214,5,10,13,13,35,50,-15,43
Queen of S't,6214,6,11,9,16,42,50,-8,42
Raith,6214,7,11,9,16,37,50,-13,42
Dunfermline,6214,8,9,14,13,44,46,-2,41
Dumbarton,6214,9,8,12,16,47,62,-15,36
St Mirren,6214,10,8,10,18,38,57,-19,34
Hibernian,6215,1,19,12,5,55,25,30,69
Dundee Utd,6215,2,18,9,9,61,44,17,63
Falkirk,6215,3,17,11,8,61,40,21,62
Morton,6215,4,17,11,8,53,35,18,62
Queen of S't,6215,5,10,12,14,43,50,-7,42
Dumbarton,6215,6,10,11,15,49,59,-10,41
Dunfermline,6215,7,9,13,14,45,52,-7,40
Raith,6215,8,9,12,15,34,47,-13,39
Ayr,6215,9,9,11,16,37,59,-22,38
St Mirren,6215,10,6,10,20,38,65,-27,28
Hibernian,6216,1,19,12,5,59,28,31,69
Morton,6216,2,18,11,7,50,34,16,65
Dundee Utd,6216,3,16,10,10,46,36,10,58
Falkirk,6216,4,15,12,9,58,41,17,57
Queen of S't,6216,5,11,11,14,43,48,-5,44
Dumbarton,6216,6,10,11,15,50,54,-4,41
Raith,6216,7,10,11,15,37,49,-12,41
Dunfermline,6216,8,8,13,15,42,53,-11,37
St Mirren,6216,9,8,12,16,37,54,-17,36
Ayr,6216,10,7,13,16,32,57,-25,34
Hibernian,6217,1,19,13,4,63,32,31,70
Falkirk,6217,2,16,11,9,62,44,18,59
Morton,6217,3,15,14,7,48,35,13,59
Dundee Utd,6217,4,16,10,10,53,41,12,58
Ayr,6217,5,10,13,13,39,50,-11,43
Queen of S't,6217,6,11,9,16,43,55,-12,42
Dunfermline,6217,7,9,13,14,48,55,-7,40
Raith,6217,8,10,9,17,35,51,-16,39
Dumbarton,6217,9,8,13,15,47,58,-11,37
St Mirren,6217,10,7,13,16,39,56,-17,34
Hibernian,6218,1,23,10,3,64,24,40,79
Falkirk,6218,2,16,11,9,55,37,18,59
Morton,6218,3,15,11,10,43,35,8,56
Dundee Utd,6218,4,13,11,12,49,49,0,50
Dunfermline,6218,5,10,14,12,47,48,-1,44
Dumbarton,6218,6,10,12,14,50,54,-4,42
Queen of S't,6218,7,10,12,14,43,50,-7,42
St Mirren,6218,8,10,9,17,40,56,-16,39
Ayr,6218,9,7,15,14,38,57,-19,36
Raith,6218,10,9,9,18,33,52,-19,36
Hibernian,6219,1,18,13,5,54,24,30,67
Morton,6219,2,18,10,8,48,34,14,64
Falkirk,6219,3,16,12,8,62,40,22,60
Dundee Utd,6219,4,15,9,12,49,44,5,54
Queen of S't,6219,5,10,13,13,44,50,-6,43
Dumbarton,6219,6,10,11,15,47,60,-13,41
Dunfermline,6219,7,9,13,14,44,52,-8,40
Raith,6219,8,10,10,16,34,49,-15,40
Ayr,6219,9,9,12,15,38,52,-14,39
St Mirren,6219,10,8,11,17,42,57,-15,35
Hibernian,6220,1,18,13,5,52,24,28,67
Falkirk,6220,2,17,11,8,61,40,21,62
Morton,6220,3,16,11,9,49,39,10,59
Dundee Utd,6220,4,14,12,10,45,40,5,54
Queen of S't,6220,5,15,8,13,53,49,4,53
St Mirren,6220,6,10,11,15,46,49,-3,41
Dunfermline,6220,7,10,11,15,44,50,-6,41
Dumbarton,6220,8,9,11,16,47,60,-13,38
Raith,6220,9,9,10,17,31,50,-19,37
Ayr,6220,10,6,14,16,31,58,-27,32
Hibernian,6221,1,19,13,4,55,24,31,70
Falkirk,6221,2,16,12,8,57,37,20,60
Morton,6221,3,15,12,9,44,36,8,57
Dundee Utd,6221,4,14,11,11,47,39,8,53
Queen of S't,6221,5,13,11,12,45,44,1,50
Dunfermline,6221,6,10,12,14,45,48,-3,42
St Mirren,6221,7,10,11,15,42,52,-10,41
Dumbarton,6221,8,9,11,16,45,58,-13,38
Ayr,6221,9,9,11,16,33,53,-20,38
Raith,6221,10,8,10,18,30,52,-22,34
Hibernian,6222,1,20,12,4,63,25,38,72
Morton,6222,2,17,12,7,51,35,16,63
Dundee Utd,6222,3,17,9,10,49,37,12,60
Falkirk,6222,4,14,10,12,55,48,7,52
Queen of S't,6222,5,12,9,15,44,49,-5,45
Dunfermline,6222,6,9,16,11,43,46,-3,43
Dumbarton,6222,7,10,11,15,48,54,-6,41
St Mirren,6222,8,10,11,15,43,57,-14,41
Raith,6222,9,9,8,19,31,55,-24,35
Ayr,6222,10,8,10,18,35,56,-21,34
Hibernian,6223,1,20,11,5,64,27,37,71
Morton,6223,2,16,12,8,49,39,10,60
Falkirk,6223,3,16,10,10,56,40,16,58
Dundee Utd,6223,4,15,11,10,55,40,15,56
Dunfermline,6223,5,11,12,13,46,48,-2,45
Queen of S't,6223,6,12,8,16,47,56,-9,44
St Mirren,6223,7,10,10,16,40,52,-12,40
Dumbarton,6223,8,9,12,15,48,60,-12,39
Raith,6223,9,10,9,17,37,51,-14,39
Ayr,6223,10,8,11,17,35,64,-29,35
Hibernian,6224,1,18,14,4,52,24,28,68
Dundee Utd,6224,2,17,11,8,54,39,15,62
Falkirk,6224,3,15,12,9,57,38,19,57
Morton,6224,4,15,12,9,46,38,8,57
Queen of S't,6224,5,12,10,14,42,47,-5,46
Dunfermline,6224,6,10,14,12,47,47,0,44
Raith,6224,7,11,11,14,36,47,-11,44
St Mirren,6224,8,8,11,17,41,56,-15,35
Dumbarton,6224,9,8,10,18,44,59,-15,34
Ayr,6224,10,7,13,16,33,57,-24,34
Hibernian,6225,1,20,11,5,53,25,28,71
Morton,6225,2,18,11,7,51,33,18,65
Falkirk,6225,3,15,11,10,60,43,17,56
Dundee Utd,6225,4,15,10,11,51,41,10,55
Queen of S't,6225,5,12,8,16,44,52,-8,44
Dunfermline,6225,6,10,12,14,43,46,-3,42
Raith,6225,7,11,8,17,35,51,-16,41
Ayr,6225,8,9,12,15,35,53,-18,39
Dumbarton,6225,9,8,14,14,50,60,-10,38
St Mirren,6225,10,8,11,17,45,63,-18,35
Hibernian,6226,1,19,12,5,54,27,27,69
Morton,6226,2,17,12,7,50,37,13,63
Falkirk,6226,3,17,11,8,62,39,23,62
Dundee Utd,6226,4,16,10,10,53,41,12,58
Dumbarton,6226,5,10,13,13,48,53,-5,43
Queen of S't,6226,6,11,9,16,41,48,-7,42
Dunfermline,6226,7,10,11,15,45,48,-3,41
St Mirren,6226,8,9,10,17,40,59,-19,37
Raith,6226,9,9,9,18,32,49,-17,36
Ayr,6226,10,8,11,17,33,57,-24,35
Hibernian,6227,1,20,10,6,64,26,38,70
Morton,6227,2,17,12,7,52,38,14,63
Dundee Utd,6227,3,18,8,10,57,40,17,62
Falkirk,6227,4,16,10,10,60,44,16,58
Queen of S't,6227,5,12,9,15,46,55,-9,45
Raith,6227,6,12,9,15,38,52,-14,45
Dunfermline,6227,7,10,14,12,46,45,1,44
Dumbarton,6227,8,8,12,16,42,56,-14,36
St Mirren,6227,9,8,10,18,37,57,-20,34
Ayr,6227,10,6,12,18,28,57,-29,30
Hibernian,6228,1,19,12,5,54,27,27,69
Falkirk,6228,2,17,11,8,62,42,20,62
Dundee Utd,6228,3,17,10,9,55,39,16,61
Morton,6228,4,14,13,9,50,43,7,55
Queen of S't,6228,5,12,9,15,42,49,-7,45
Dunfermline,6228,6,10,14,12,49,49,0,44
Dumbarton,6228,7,9,13,14,48,58,-10,40
Ayr,6228,8,9,13,14,38,51,-13,40
Raith,6228,9,9,11,16,31,46,-15,38
St Mirren,6228,10,6,10,20,33,58,-25,28
Hibernian,6229,1,17,15,4,52,26,26,66
Dundee Utd,6229,2,17,9,10,53,39,14,60
Falkirk,6229,3,16,11,9,57,38,19,59
Morton,6229,4,14,16,6,47,34,13,58
Queen of S't,6229,5,10,12,14,44,51,-7,42
Dumbarton,6229,6,10,12,14,45,55,-10,42
Raith,6229,7,10,12,14,36,46,-10,42
Dunfermline,6229,8,8,16,12,41,44,-3,40
Ayr,6229,9,9,12,15,36,56,-20,39
St Mirren,6229,10,6,11,19,37,59,-22,29
Hibernian,6230,1,21,10,5,59,24,35,73
Falkirk,6230,2,16,10,10,58,41,17,58
Dundee Utd,6230,3,16,10,10,49,38,11,58
Morton,6230,4,15,11,10,48,47,1,56
Queen of S't,6230,5,14,8,14,52,49,3,50
Dunfermline,6230,6,11,11,14,49,51,-2,44
St Mirren,6230,7,9,12,15,43,54,-11,39
Raith,6230,8,10,9,17,35,52,-17,39
Dumbarton,6230,9,8,12,16,44,60,-16,36
Ayr,6230,10,8,11,17,35,56,-21,35
Hibernian,6231,1,18,13,5,56,28,28,67
Morton,6231,2,17,14,5,54,32,22,65
Falkirk,6231,3,17,9,10,57,43,14,60
Dundee Utd,6231,4,15,10,11,51,46,5,55
Dunfermline,6231,5,11,15,10,53,48,5,48
Raith,6231,6,10,10,16,35,50,-15,40
Queen of S't,6231,7,10,9,17,45,55,-10,39
Ayr,6231,8,9,12,15,35,52,-17,39
St Mirren,6231,9,8,11,17,42,57,-15,35
Dumbarton,6231,10,8,11,17,44,61,-17,35
Hibernian,6232,1,19,14,3,56,24,32,71
Morton,6232,2,17,13,6,54,35,19,64
Falkirk,6232,3,16,10,10,56,44,12,58
Dundee Utd,6232,4,15,10,11,47,41,6,55
Queen of S't,6232,5,12,8,16,48,54,-6,44
Dunfermline,6232,6,10,12,14,50,50,0,42
Ayr,6232,7,9,13,14,39,51,-12,40
Raith,6232,8,10,9,17,38,52,-14,39
Dumbarton,6232,9,9,11,16,47,63,-16,38
St Mirren,6232,10,7,12,17,35,56,-21,33
Hibernian,6233,1,19,12,5,55,27,28,69
Morton,6233,2,17,12,7,50,37,13,63
Dundee Utd,6233,3,17,10,9,56,35,21,61
Falkirk,6233,4,16,9,11,57,50,7,57
Dunfermline,6233,5,11,12,13,50,46,4,45
Raith,6233,6,11,10,15,36,48,-12,43
Queen of S't,6233,7,11,9,16,45,53,-8,42
Dumbarton,6233,8,9,12,15,49,60,-11,39
St Mirren,6233,9,9,9,18,41,52,-11,36
Ayr,6233,10,6,13,17,30,61,-31,31
Hibernian,6234,1,18,15,3,59,27,32,69
Morton,6234,2,15,14,7,50,40,10,59
Falkirk,6234,3,16,10,10,59,42,17,58
Dundee Utd,6234,4,16,9,11,53,43,10,57
Dumbarton,6234,5,11,10,15,50,63,-13,43
Queen of S't,6234,6,11,9,16,46,52,-6,42
Dunfermline,6234,7,9,14,13,45,49,-4,41
Ayr,6234,8,9,12,15,38,54,-16,39
Raith,6234,9,10,9,17,32,48,-16,39
St Mirren,6234,10,9,10,17,39,53,-14,37
Hibernian,6235,1,18,13,5,53,27,26,67
Dundee Utd,6235,2,19,8,9,59,38,21,65
Falkirk,6235,3,15,11,10,57,41,16,56
Morton,6235,4,14,12,10,46,37,9,54
Queen of S't,6235,5,13,8,15,45,49,-4,47
Raith,6235,6,12,9,15,36,43,-7,45
Dunfermline,6235,7,10,14,12,44,46,-2,44
Dumbarton,6235,8,9,11,16,49,66,-17,38
Ayr,6235,9,9,11,16,34,55,-21,38
St Mirren,6235,10,7,11,18,39,60,-21,32
Hibernian,6236,1,20,12,4,59,26,33,72
Morton,6236,2,17,12,7,48,34,14,63
Falkirk,6236,3,17,11,8,64,38,26,62
Dundee Utd,6236,4,15,11,10,48,38,10,56
Dunfermline,6236,5,11,12,13,49,47,2,45
Ayr,6236,6,10,13,13,37,49,-12,43
Queen of S't,6236,7,11,8,17,44,59,-15,41
St Mirren,6236,8,8,11,17,41,56,-15,35
Raith,6236,9,9,8,19,34,57,-23,35
Dumbarton,6236,10,7,12,17,45,65,-20,33
Falkirk,6237,1,19,9,8,61,36,25,66
Hibernian,6237,2,17,12,7,52,30,22,63
Morton,6237,3,17,11,8,50,36,14,62
Dundee Utd,6237,4,16,11,9,52,40,12,59
Queen of S't,6237,5,13,9,14,49,51,-2,48
St Mirren,6237,6,10,9,17,43,54,-11,39
Dumbarton,6237,7,9,11,16,48,63,-15,38
Raith,6237,8,9,11,16,30,46,-16,38
Dunfermline,6237,9,8,13,15,45,52,-7,37
Ayr,6237,10,7,14,15,32,54,-22,35
Hibernian,6238,1,21,11,4,59,26,33,74
Dundee Utd,6238,2,17,10,9,58,39,19,61
Morton,6238,3,13,16,7,45,36,9,55
Falkirk,6238,4,14,12,10,55,44,11,54
Raith,6238,5,11,12,13,39,42,-3,45
Dunfermline,6238,6,9,15,12,45,49,-4,42
Queen of S't,6238,7,10,10,16,43,52,-9,40
St Mirren,6238,8,9,10,17,39,53,-14,37
Ayr,6238,9,8,12,16,31,60,-29,36
Dumbarton,6238,10,7,14,15,43,56,-13,35
Hibernian,6239,1,18,11,7,55,28,27,65
Falkirk,6239,2,18,10,8,60,38,22,64
Morton,6239,3,16,12,8,48,34,14,60
Dundee Utd,6239,4,14,11,11,50,47,3,53
Queen of S't,6239,5,14,9,13,48,48,0,51
Raith,6239,6,12,8,16,39,53,-14,44
Dumbarton,6239,7,10,13,13,54,57,-3,43
Ayr,6239,8,9,13,14,38,51,-13,40
Dunfermline,6239,9,8,14,14,43,49,-6,38
St Mirren,6239,10,6,9,21,33,63,-30,27
Hibernian,6240,1,19,11,6,58,28,30,68
Falkirk,6240,2,18,11,7,68,38,30,65
Morton,6240,3,16,13,7,50,33,17,61
Dundee Utd,6240,4,14,11,11,46,43,3,53
Queen of S't,6240,5,14,9,13,49,49,0,51
Dunfermline,6240,6,9,15,12,43,49,-6,42
Dumbarton,6240,7,9,11,16,46,59,-13,38
Ayr,6240,8,8,13,15,31,52,-21,37
St Mirren,6240,9,8,11,17,41,58,-17,35
Raith,6240,10,8,9,19,33,56,-23,33
Hibernian,6241,1,19,13,4,57,27,30,70
Dundee Utd,6241,2,18,8,10,56,40,16,62
Falkirk,6241,3,15,14,7,57,38,19,59
Morton,6241,4,15,12,9,50,41,9,57
Queen of S't,6241,5,13,10,13,53,48,5,49
Dunfermline,6241,6,9,14,13,46,50,-4,41
Raith,6241,7,9,12,15,37,53,-16,39
Dumbarton,6241,8,8,13,15,47,58,-11,37
Ayr,6241,9,8,12,16,35,61,-26,36
St Mirren,6241,10,7,10,19,39,61,-22,31
Hibernian,6242,1,18,14,4,55,27,28,68
Morton,6242,2,17,11,8,49,35,14,62
Falkirk,6242,3,15,12,9,55,41,14,57
Dundee Utd,6242,4,15,11,10,52,42,10,56
Dunfermline,6242,5,11,13,12,45,45,0,46
Queen of S't,6242,6,11,11,14,44,49,-5,44
Raith,6242,7,9,12,15,34,48,-14,39
Ayr,6242,8,8,14,14,36,53,-17,38
Dumbarton,6242,9,8,11,17,42,62,-20,35
St Mirren,6242,10,7,13,16,46,56,-10,34
Hibernian,6243,1,20,12,4,58,25,33,72
Morton,6243,2,17,13,6,54,35,19,64
Falkirk,6243,3,16,11,9,56,42,14,59
Dundee Utd,6243,4,15,12,9,49,39,10,57
Dunfermline,6243,5,10,13,13,46,47,-1,43
Queen of S't,6243,6,11,10,15,45,52,-7,43
Raith,6243,7,9,11,16,34,47,-13,38
Dumbarton,6243,8,7,15,14,48,59,-11,36
Ayr,6243,9,7,14,15,37,59,-22,35
St Mirren,6243,10,7,11,18,36,58,-22,32
Hibernian,6244,1,19,12,5,61,31,30,69
Falkirk,6244,2,17,10,9,62,44,18,61
Morton,6244,3,16,13,7,54,40,14,61
Dundee Utd,6244,4,16,8,12,51,43,8,56
Dunfermline,6244,5,12,12,12,55,49,6,48
Queen of S't,6244,6,12,10,14,42,46,-4,46
Dumbarton,6244,7,10,12,14,53,55,-2,42
Raith,6244,8,9,10,17,36,55,-19,37
St Mirren,6244,9,8,11,17,41,60,-19,35
Ayr,6244,10,6,12,18,32,64,-32,30
Hibernian,6245,1,19,11,6,56,31,25,68
Morton,6245,2,17,12,7,51,34,17,63
Dundee Utd,6245,3,16,11,9,48,37,11,59
Falkirk,6245,4,15,11,10,56,42,14,56
Queen of S't,6245,5,11,11,14,46,51,-5,44
Ayr,6245,6,11,11,14,36,51,-15,44
Raith,6245,7,10,10,16,35,48,-13,40
Dumbarton,6245,8,8,15,13,46,54,-8,39
Dunfermline,6245,9,8,14,14,44,49,-5,38
St Mirren,6245,10,7,10,19,36,57,-21,31
Hibernian,6246,1,20,10,6,56,29,27,70
Morton,6246,2,18,10,8,54,36,18,64
Falkirk,6246,3,17,10,9,67,45,22,61
Dundee Utd,6246,4,14,13,9,51,42,9,55
Dunfermline,6246,5,12,12,12,52,52,0,48
Queen of S't,6246,6,11,10,15,44,50,-6,43
Raith,6246,7,10,9,17,35,52,-17,39
St Mirren,6246,8,9,11,16,46,59,-13,38
Ayr,6246,9,7,13,16,32,53,-21,34
Dumbarton,6246,10,7,12,17,44,63,-19,33
Hibernian,6247,1,21,11,4,65,25,40,74
Morton,6247,2,18,11,7,52,35,17,65
Dundee Utd,6247,3,17,8,11,48,38,10,59
Falkirk,6247,4,14,12,10,58,45,13,54
Queen of S't,6247,5,12,12,12,51,47,4,48
Dunfermline,6247,6,9,14,13,45,44,1,41
Ayr,6247,7,9,11,16,32,59,-27,38
St Mirren,6247,8,8,12,16,41,59,-18,36
Dumbarton,6247,9,7,14,15,45,58,-13,35
Raith,6247,10,8,9,19,32,59,-27,33
Hibernian,6248,1,20,13,3,55,21,34,73
Falkirk,6248,2,17,10,9,63,45,18,61
Dundee Utd,6248,3,16,9,11,55,42,13,57
Morton,6248,4,15,12,9,49,40,9,57
Dunfermline,6248,5,11,11,14,47,52,-5,44
Ayr,6248,6,10,13,13,40,51,-11,43
Raith,6248,7,11,9,16,36,50,-14,42
Queen of S't,6248,8,9,11,16,39,50,-11,38
Dumbarton,6248,9,8,12,16,48,61,-13,36
St Mirren,6248,10,8,10,18,38,58,-20,34
Hibernian,6249,1,18,13,5,52,26,26,67
Dundee Utd,6249,2,18,10,8,56,37,19,64
Morton,6249,3,16,13,7,46,33,13,61
Falkirk,6249,4,15,9,12,54,42,12,54
Queen of S't,6249,5,12,9,15,51,51,0,45
Dunfermline,6249,6,11,12,13,47,50,-3,45
Raith,6249,7,12,9,15,35,47,-12,45
Dumbarton,6249,8,10,10,16,46,57,-11,40
St Mirren,6249,9,9,11,16,40,54,-14,38
Ayr,6249,10,6,10,20,29,59,-30,28
Hibernian,6250,1,21,11,4,61,24,37,74
Morton,6250,2,15,14,7,51,39,12,59
Falkirk,6250,3,16,10,10,60,42,18,58
Dundee Utd,6250,4,15,10,11,48,41,7,55
Dumbarton,6250,5,10,12,14,49,55,-6,42
Queen of S't,6250,6,11,9,16,43,54,-11,42
Raith,6250,7,11,9,16,37,54,-17,42
Dunfermline,6250,8,9,14,13,47,50,-3,41
Ayr,6250,9,9,12,15,38,55,-17,39
St Mirren,6250,10,6,13,17,39,59,-20,31
Hibernian,6251,1,21,11,4,55,22,33,74
Falkirk,6251,2,17,11,8,61,39,22,62
Morton,6251,3,16,14,6,52,33,19,62
Dundee Utd,6251,4,17,10,9,52,39,13,61
Raith,6251,5,11,10,15,36,45,-9,43
Queen of S't,6251,6,10,12,14,42,51,-9,42
Dumbarton,6251,7,10,11,15,49,58,-9,41
Dunfermline,6251,8,7,13,16,40,57,-17,34
Ayr,6251,9,7,12,17,31,53,-22,33
St Mirren,6251,10,6,12,18,37,58,-21,30
Hibernian,6252,1,17,13,6,52,30,22,64
Morton,6252,2,18,10,8,48,35,13,64
Falkirk,6252,3,16,11,9,58,38,20,59
Dundee Utd,6252,4,14,12,10,46,40,6,54
Queen of S't,6252,5,11,11,14,43,49,-6,44
Dunfermline,6252,6,10,13,13,48,47,1,43
Raith,6252,7,9,13,14,31,43,-12,40
Ayr,6252,8,9,13,14,34,51,-17,40
Dumbarton,6252,9,9,12,15,47,57,-10,39
St Mirren,6252,10,7,12,17,35,52,-17,33
Hibernian,6253,1,19,14,3,57,25,32,71
Dundee Utd,6253,2,17,9,10,57,45,12,60
Morton,6253,3,16,11,9,50,38,12,59
Falkirk,6253,4,15,12,9,57,42,15,57
Queen of S't,6253,5,11,11,14,45,50,-5,44
Raith,6253,6,10,10,16,35,51,-16,40
Dumbarton,6253,7,9,12,15,46,58,-12,39
St Mirren,6253,8,10,9,17,45,57,-12,39
Dunfermline,6253,9,8,14,14,45,50,-5,38
Ayr,6253,10,8,12,16,37,58,-21,36
Hibernian,6254,1,20,13,3,57,22,35,73
Dundee Utd,6254,2,16,9,11,51,40,11,57
Morton,6254,3,15,12,9,49,42,7,57
Falkirk,6254,4,14,10,12,53,46,7,52
Queen of S't,6254,5,11,11,14,49,52,-3,44
Raith,6254,6,11,9,16,34,47,-13,42
Dumbarton,6254,7,10,11,15,46,57,-11,41
Dunfermline,6254,8,9,13,14,47,51,-4,40
Ayr,6254,9,8,15,13,40,56,-16,39
St Mirren,6254,10,9,11,16,40,53,-13,38
Hibernian,6255,1,18,11,7,54,28,26,65
Dundee Utd,6255,2,18,9,9,53,37,16,63
Morton,6255,3,17,10,9,52,41,11,61
Falkirk,6255,4,16,11,9,60,40,20,59
Ayr,6255,5,12,11,13,39,48,-9,47
Queen of S't,6255,6,11,9,16,46,53,-7,42
Raith,6255,7,10,10,16,34,46,-12,40
Dumbarton,6255,8,9,11,16,46,59,-13,38
St Mirren,6255,9,9,10,17,39,57,-18,37
Dunfermline,6255,10,8,12,16,42,56,-14,36
Hibernian,6256,1,19,14,3,54,24,30,71
Morton,6256,2,17,11,8,49,34,15,62
Falkirk,6256,3,15,13,8,57,38,19,58
Dundee Utd,6256,4,16,10,10,54,40,14,58
Queen of S't,6256,5,11,10,15,43,49,-6,43
Dunfermline,6256,6,10,12,14,47,50,-3,42
Dumbarton,6256,7,10,11,15,51,58,-7,41
St Mirren,6256,8,10,9,17,44,59,-15,39
Raith,6256,9,9,9,18,31,55,-24,36
Ayr,6256,10,8,11,17,34,57,-23,35
Hibernian,6257,1,18,14,4,55,26,29,68
Morton,6257,2,19,11,6,55,33,22,68
Falkirk,6257,3,15,10,11,53,39,14,55
Queen of S't,6257,4,14,9,13,48,46,2,51
Dundee Utd,6257,5,13,11,12,45,43,2,50
St Mirren,6257,6,10,11,15,46,54,-8,41
Dumbarton,6257,7,9,13,14,45,55,-10,40
Raith,6257,8,10,9,17,35,51,-16,39
Ayr,6257,9,8,12,16,35,58,-23,36
Dunfermline,6257,10,7,14,15,44,56,-12,35
Hibernian,6258,1,19,12,5,55,25,30,69
Dundee Utd,6258,2,17,9,10,57,42,15,60
Falkirk,6258,3,16,10,10,57,43,14,58
Morton,6258,4,15,10,11,52,42,10,55
Queen of S't,6258,5,13,9,14,48,52,-4,48
Dunfermline,6258,6,11,11,14,49,54,-5,44
Dumbarton,6258,7,10,13,13,48,54,-6,43
Raith,6258,8,10,8,18,33,48,-15,38
Ayr,6258,9,9,11,16,33,54,-21,38
St Mirren,6258,10,8,11,17,37,55,-18,35
Hibernian,6259,1,20,11,5,54,27,27,71
Falkirk,6259,2,18,11,7,65,36,29,65
Morton,6259,3,16,12,8,49,36,13,60
Dundee Utd,6259,4,14,11,11,47,42,5,53
Dunfermline,6259,5,12,12,12,52,47,5,48
Dumbarton,6259,6,10,11,15,47,58,-11,41
Queen of S't,6259,7,10,10,16,45,55,-10,40
Raith,6259,8,9,11,16,31,46,-15,38
St Mirren,6259,9,8,10,18,37,56,-19,34
Ayr,6259,10,7,13,16,30,54,-24,34
Hibernian,6260,1,19,12,5,51,23,28,69
Falkirk,6260,2,16,11,9,60,38,22,59
Dundee Utd,6260,3,16,11,9,48,36,12,59
Morton,6260,4,15,11,10,44,36,8,56
Dunfermline,6260,5,10,13,13,42,43,-1,43
Queen of S't,6260,6,11,10,15,42,50,-8,43
Raith,6260,7,11,10,15,37,48,-11,43
Dumbarton,6260,8,10,11,15,49,60,-11,41
Ayr,6260,9,8,12,16,29,51,-22,36
St Mirren,6260,10,7,13,16,35,52,-17,34
Hibernian,6261,1,19,11,6,55,26,29,68
Morton,6261,2,18,12,6,54,36,18,66
Dundee Utd,6261,3,16,11,9,53,41,12,59
Falkirk,6261,4,14,9,13,51,43,8,51
Queen of S't,6261,5,14,8,14,51,50,1,50
Dunfermline,6261,6,11,11,14,48,49,-1,44
St Mirren,6261,7,9,12,15,39,51,-12,39
Raith,6261,8,10,9,17,37,49,-12,39
Ayr,6261,9,9,11,16,35,59,-24,38
Dumbarton,6261,10,8,10,18,45,64,-19,34
Hibernian,6262,1,21,11,4,56,26,30,74
Dundee Utd,6262,2,18,10,8,56,38,18,64
Falkirk,6262,3,17,10,9,61,40,21,61
Morton,6262,4,15,11,10,43,35,8,56
Queen of S't,6262,5,12,9,15,48,55,-7,45
Dunfermline,6262,6,10,12,14,48,52,-4,42
St Mirren,6262,7,9,11,16,44,56,-12,38
Raith,6262,8,10,8,18,37,54,-17,38
Dumbarton,6262,9,8,11,17,46,60,-14,35
Ayr,6262,10,7,13,16,36,59,-23,34
Hibernian,6263,1,20,12,4,55,23,32,72
Morton,6263,2,16,12,8,51,38,13,60
Falkirk,6263,3,16,9,11,56,41,15,57
Dundee Utd,6263,4,14,12,10,44,38,6,54
Dunfermline,6263,5,10,15,11,44,44,0,45
Raith,6263,6,11,11,14,35,45,-10,44
Queen of S't,6263,7,11,10,15,45,50,-5,43
St Mirren,6263,8,9,11,16,45,58,-13,38
Dumbarton,6263,9,9,10,17,47,62,-15,37
Ayr,6263,10,6,14,16,32,55,-23,32
Hibernian,6264,1,20,11,5,58,24,34,71
Morton,6264,2,18,9,9,48,38,10,63
Dundee Utd,6264,3,17,9,10,54,37,17,60
Falkirk,6264,4,16,11,9,57,39,18,59
Queen of S't,6264,5,12,9,15,48,49,-1,45
St Mirren,6264,6,12,9,15,46,55,-9,45
Dunfermline,6264,7,8,15,13,41,45,-4,39
Raith,6264,8,9,9,18,35,58,-23,36
Dumbarton,6264,9,8,11,17,45,58,-13,35
Ayr,6264,10,8,11,17,35,64,-29,35
Hibernian,6265,1,19,13,4,57,26,31,70
Morton,6265,2,17,12,7,50,34,16,63
Falkirk,6265,3,15,13,8,53,37,16,58
Queen of S't,6265,4,14,9,13,51,50,1,51
Dundee Utd,6265,5,13,10,13,45,45,0,49
Dumbarton,6265,6,10,11,15,53,57,-4,41
Dunfermline,6265,7,9,13,14,44,49,-5,40
Raith,6265,8,10,9,17,33,47,-14,39
Ayr,6265,9,9,11,16,35,56,-21,38
St Mirren,6265,10,8,11,17,35,55,-20,35
Hibernian,6266,1,21,12,3,60,25,35,75
Morton,6266,2,18,11,7,59,37,22,65
Dundee Utd,6266,3,16,11,9,52,38,14,59
Falkirk,6266,4,16,10,10,57,37,20,58
Queen of S't,6266,5,12,12,12,48,48,0,48
St Mirren,6266,6,9,11,16,43,56,-13,38
Dunfermline,6266,7,8,13,15,46,53,-7,37
Ayr,6266,8,8,11,17,35,59,-24,35
Raith,6266,9,8,11,17,31,55,-24,35
Dumbarton,6266,10,8,10,18,43,66,-23,34
Hibernian,6267,1,19,12,5,58,27,31,69
Falkirk,6267,2,15,13,8,55,40,15,58
Morton,6267,3,15,13,8,49,37,12,58
Dundee Utd,6267,4,14,13,9,46,38,8,55
Raith,6267,5,10,12,14,37,48,-11,42
Queen of S't,6267,6,10,11,15,47,52,-5,41
Dumbarton,6267,7,9,14,13,45,52,-7,41
Ayr,6267,8,9,14,13,34,49,-15,41
Dunfermline,6267,9,8,16,12,42,50,-8,40
St Mirren,6267,10,6,12,18,37,57,-20,30
Hibernian,6268,1,19,10,7,58,27,31,67
Morton,6268,2,18,12,6,55,38,17,66
Dundee Utd,6268,3,17,10,9,58,47,11,61
Falkirk,6268,4,14,13,9,59,47,12,55
Raith,6268,5,10,12,14,39,52,-13,42
Dunfermline,6268,6,9,13,14,45,47,-2,40
Queen of S't,6268,7,10,10,16,43,56,-13,40
Dumbarton,6268,8,9,12,15,46,53,-7,39
St Mirren,6268,9,9,11,16,43,58,-15,38
Ayr,6268,10,8,11,17,36,57,-21,35
Hibernian,6269,1,19,12,5,57,26,31,69
Morton,6269,2,17,11,8,51,35,16,62
Dundee Utd,6269,3,16,11,9,54,44,10,59
Falkirk,6269,4,14,11,11,55,42,13,53
Dunfermline,6269,5,14,11,11,51,44,7,53
Queen of S't,6269,6,11,9,16,44,53,-9,42
Dumbarton,6269,7,10,10,16,49,62,-13,40
Ayr,6269,8,8,14,14,36,52,-16,38
Raith,6269,9,8,11,17,33,53,-20,35
St Mirren,6269,10,8,10,18,42,61,-19,34
Hibernian,6270,1,17,14,5,58,31,27,65
Dundee Utd,6270,2,17,11,8,51,35,16,62
Morton,6270,3,15,15,6,49,34,15,60
Falkirk,6270,4,16,10,10,60,42,18,58
St Mirren,6270,5,11,9,16,46,54,-8,42
Raith,6270,6,11,9,16,44,55,-11,42
Dumbarton,6270,7,10,11,15,52,60,-8,41
Queen of S't,6270,8,10,10,16,48,59,-11,40
Dunfermline,6270,9,9,12,15,44,57,-13,39
Ayr,6270,10,6,15,15,34,59,-25,33
Hibernian,6271,1,21,12,3,64,24,40,75
Dundee Utd,6271,2,20,8,8,56,34,22,68
Falkirk,6271,3,15,12,9,57,40,17,57
Morton,6271,4,15,10,11,47,43,4,55
Dunfermline,6271,5,9,14,13,44,49,-5,41
Queen of S't,6271,6,10,10,16,40,53,-13,40
Raith,6271,7,9,11,16,35,49,-14,38
Ayr,6271,8,9,11,16,35,56,-21,38
Dumbarton,6271,9,9,10,17,45,57,-12,37
St Mirren,6271,10,9,10,17,38,56,-18,37
Hibernian,6272,1,22,10,4,58,25,33,76
Morton,6272,2,18,10,8,52,38,14,64
Falkirk,6272,3,16,9,11,58,43,15,57
Dundee Utd,6272,4,16,9,11,48,38,10,57
Dunfermline,6272,5,10,12,14,44,49,-5,42
Queen of S't,6272,6,10,10,16,42,53,-11,40
Dumbarton,6272,7,9,11,16,47,59,-12,38
St Mirren,6272,8,9,11,16,43,57,-14,38
Ayr,6272,9,8,14,14,38,55,-17,38
Raith,6272,10,9,10,17,38,51,-13,37
Hibernian,6273,1,20,12,4,60,28,32,72
Falkirk,6273,2,16,12,8,59,40,19,60
Morton,6273,3,15,14,7,47,34,13,59
Dundee Utd,6273,4,15,12,9,50,39,11,57
Queen of S't,6273,5,13,8,15,50,51,-1,47
Raith,6273,6,12,9,15,39,51,-12,45
Dumbarton,6273,7,9,11,16,48,59,-11,38
Dunfermline,6273,8,8,13,15,47,56,-9,37
Ayr,6273,9,7,14,15,31,54,-23,35
St Mirren,6273,10,6,13,17,41,60,-19,31
Hibernian,6274,1,20,12,4,56,22,34,72
Morton,6274,2,17,10,9,48,37,11,61
Falkirk,6274,3,16,12,8,58,40,18,60
Dundee Utd,6274,4,16,10,10,53,40,13,58
Dunfermline,6274,5,10,15,11,47,46,1,45
Raith,6274,6,11,10,15,38,48,-10,43
Queen of S't,6274,7,9,12,15,40,50,-10,39
Dumbarton,6274,8,8,13,15,44,54,-10,37
Ayr,6274,9,8,13,15,30,50,-20,37
St Mirren,6274,10,6,11,19,34,61,-27,29
Morton,6275,1,19,11,6,48,30,18,68
Hibernian,6275,2,18,13,5,55,28,27,67
Dundee Utd,6275,3,17,10,9,48,34,14,61
Falkirk,6275,4,16,10,10,57,42,15,58
Queen of S't,6275,5,11,10,15,51,58,-7,43
Dumbarton,6275,6,10,13,13,47,54,-7,43
Dunfermline,6275,7,10,12,14,49,52,-3,42
St Mirren,6275,8,8,11,17,39,53,-14,35
Raith,6275,9,8,10,18,33,52,-19,34
Ayr,6275,10,7,12,17,32,56,-24,33
Hibernian,6276,1,18,14,4,53,24,29,68
Morton,6276,2,18,11,7,57,34,23,65
Falkirk,6276,3,17,10,9,57,38,19,61
Dundee Utd,6276,4,16,8,12,49,41,8,56
Queen of S't,6276,5,13,9,14,48,48,0,48
Ayr,6276,6,11,10,15,36,54,-18,43
Dunfermline,6276,7,10,11,15,44,53,-9,41
Dumbarton,6276,8,10,10,16,47,61,-14,40
Raith,6276,9,8,10,18,38,55,-17,34
St Mirren,6276,10,8,9,19,37,58,-21,33
Hibernian,6277,1,16,17,3,50,24,26,65
Falkirk,6277,2,15,13,8,57,37,20,58
Morton,6277,3,15,13,8,49,37,12,58
Dundee Utd,6277,4,15,11,10,49,39,10,56
Queen of S't,6277,5,12,11,13,49,48,1,47
Dunfermline,6277,6,11,14,11,47,46,1,47
Dumbarton,6277,7,9,13,14,49,59,-10,40
Raith,6277,8,10,10,16,34,49,-15,40
St Mirren,6277,9,8,11,17,39,56,-17,35
Ayr,6277,10,7,11,18,29,57,-28,32
Hibernian,6278,1,20,10,6,57,26,31,70
Morton,6278,2,18,9,9,49,38,11,63
Falkirk,6278,3,16,11,9,58,43,15,59
Dundee Utd,6278,4,16,9,11,52,43,9,57
Queen of S't,6278,5,11,11,14,44,49,-5,44
Dumbarton,6278,6,10,11,15,45,56,-11,41
Dunfermline,6278,7,9,13,14,43,49,-6,40
St Mirren,6278,8,10,10,16,42,53,-11,40
Raith,6278,9,10,10,16,37,48,-11,40
Ayr,6278,10,8,10,18,32,54,-22,34
Hibernian,6279,1,21,11,4,64,26,38,74
Morton,6279,2,16,13,7,49,34,15,61
Falkirk,6279,3,16,11,9,60,43,17,59
Dundee Utd,6279,4,13,11,12,52,48,4,50
Dunfermline,6279,5,10,13,13,45,51,-6,43
Queen of S't,6279,6,11,9,16,46,59,-13,42
Raith,6279,7,10,11,15,34,49,-15,41
Dumbarton,6279,8,9,12,15,47,56,-9,39
Ayr,6279,9,9,12,15,36,56,-20,39
St Mirren,6279,10,8,11,17,44,55,-11,35
Hibernian,6280,1,17,14,5,54,28,26,65
Morton,6280,2,18,11,7,54,35,19,65
Falkirk,6280,3,16,10,10,60,43,17,58
Dundee Utd,6280,4,16,9,11,53,46,7,57
Dunfermline,6280,5,10,14,12,51,51,0,44
Queen of S't,6280,6,10,12,14,50,54,-4,42
Ayr,6280,7,9,12,15,37,53,-16,39
Dumbarton,6280,8,9,11,16,50,65,-15,38
Raith,6280,9,9,11,16,36,53,-17,38
St Mirren,6280,10,9,10,17,40,57,-17,37
Hibernian,6281,1,22,11,3,64,26,38,77
Morton,6281,2,17,12,7,55,37,18,63
Dundee Utd,6281,3,17,10,9,50,34,16,61
Falkirk,6281,4,17,9,10,58,43,15,60
Queen of S't,6281,5,11,10,15,47,51,-4,43
Dunfermline,6281,6,9,12,15,46,53,-7,39
Raith,6281,7,10,9,17,36,50,-14,39
St Mirren,6281,8,8,12,16,39,54,-15,36
Dumbarton,6281,9,7,13,16,48,65,-17,34
Ayr,6281,10,7,12,17,29,59,-30,33
Hibernian,6282,1,20,12,4,57,25,32,72
Falkirk,6282,2,16,11,9,55,38,17,59
Morton,6282,3,16,11,9,49,39,10,59
Dundee Utd,6282,4,15,11,10,50,38,12,56
Queen of S't,6282,5,11,11,14,44,50,-6,44
Dumbarton,6282,6,11,10,15,50,55,-5,43
Raith,6282,7,11,10,15,35,46,-11,43
Dunfermline,6282,8,8,14,14,42,47,-5,38
St Mirren,6282,9,9,11,16,42,56,-14,38
Ayr,6282,10,7,11,18,32,62,-30,32
Hibernian,6283,1,19,13,4,53,23,30,70
Dundee Utd,6283,2,17,10,9,57,41,16,61
Falkirk,6283,3,17,9,10,59,43,16,60
Morton,6283,4,15,11,10,49,40,9,56
Queen of S't,6283,5,13,9,14,49,49,0,48
Dunfermline,6283,6,10,15,11,50,48,2,45
Ayr,6283,7,9,12,15,35,56,-21,39
Raith,6283,8,9,9,18,33,50,-17,36
St Mirren,6283,9,7,13,16,39,56,-17,34
Dumbarton,6283,10,7,13,16,46,64,-18,34
Hibernian,6284,1,21,10,5,58,26,32,73
Morton,6284,2,19,10,7,50,32,18,67
Falkirk,6284,3,15,10,11,55,43,12,55
Queen of S't,6284,4,14,10,12,50,46,4,52
Dundee Utd,6284,5,14,9,13,47,44,3,51
Dunfermline,6284,6,10,12,14,46,49,-3,42
Dumbarton,6284,7,9,11,16,47,60,-13,38
Raith,6284,8,9,11,16,37,53,-16,38
St Mirren,6284,9,9,10,17,40,54,-14,37
Ayr,6284,10,8,11,17,31,54,-23,35
Hibernian,6285,1,18,14,4,54,28,26,68
Falkirk,6285,2,17,12,7,59,37,22,63
Morton,6285,3,17,11,8,57,39,18,62
Dundee Utd,6285,4,16,10,10,54,39,15,58
Queen of S't,6285,5,10,13,13,43,49,-6,43
Raith,6285,6,11,9,16,36,49,-13,42
Dumbarton,6285,7,9,12,15,47,62,-15,39
Dunfermline,6285,8,8,14,14,44,51,-7,38
St Mirren,6285,9,8,11,17,40,58,-18,35
Ayr,6285,10,8,10,18,35,57,-22,34
Hibernian,6286,1,21,10,5,55,25,30,73
Morton,6286,2,18,11,7,51,34,17,65
Falkirk,6286,3,17,12,7,60,37,23,63
Dundee Utd,6286,4,15,9,12,52,44,8,54
Dumbarton,6286,5,12,12,12,56,53,3,48
Queen of S't,6286,6,11,11,14,44,50,-6,44
Dunfermline,6286,7,10,11,15,46,50,-4,41
Raith,6286,8,9,11,16,34,48,-14,38
St Mirren,6286,9,7,11,18,39,63,-24,32
Ayr,6286,10,6,10,20,31,64,-33,28
Hibernian,6287,1,17,16,3,55,28,27,67
Morton,6287,2,18,11,7,51,34,17,65
Falkirk,6287,3,17,11,8,60,40,20,62
Dundee Utd,6287,4,14,11,11,53,42,11,53
Queen of S't,6287,5,12,11,13,51,52,-1,47
Dumbarton,6287,6,10,11,15,49,63,-14,41
Ayr,6287,7,9,13,14,35,52,-17,40
Raith,6287,8,10,9,17,34,50,-16,39
Dunfermline,6287,9,8,14,14,43,49,-6,38
St Mirren,6287,10,7,9,20,38,59,-21,30
Hibernian,6288,1,17,16,3,51,23,28,67
Morton,6288,2,16,15,5,50,35,15,63
Dundee Utd,6288,3,15,13,8,54,39,15,58
Falkirk,6288,4,15,10,11,52,39,13,55
Queen of S't,6288,5,12,11,13,46,49,-3,47
Dunfermline,6288,6,10,13,13,44,47,-3,43
Raith,6288,7,10,12,14,36,46,-10,42
Dumbarton,6288,8,8,12,16,49,62,-13,36
Ayr,6288,9,7,13,16,34,56,-22,34
St Mirren,6288,10,6,13,17,37,57,-20,31
Hibernian,6289,1,21,12,3,57,21,36,75
Dundee Utd,6289,2,15,11,10,49,45,4,56
Falkirk,6289,3,14,12,10,52,42,10,54
Morton,6289,4,13,14,9,44,37,7,53
Dunfermline,6289,5,9,16,11,45,44,1,43
Queen of S't,6289,6,11,10,15,42,49,-7,43
Dumbarton,6289,7,10,12,14,46,52,-6,42
St Mirren,6289,8,9,11,16,43,54,-11,38
Raith,6289,9,9,11,16,33,51,-18,38
Ayr,6289,10,7,15,14,41,57,-16,36
Hibernian,6290,1,20,10,6,58,26,32,70
Dundee Utd,6290,2,17,11,8,56,38,18,62
Morton,6290,3,16,12,8,59,44,15,60
Falkirk,6290,4,15,12,9,58,39,19,57
Queen of S't,6290,5,11,11,14,43,48,-5,44
Raith,6290,6,11,9,16,35,54,-19,42
Dumbarton,6290,7,10,10,16,47,62,-15,40
St Mirren,6290,8,9,12,15,42,51,-9,39
Dunfermline,6290,9,8,13,15,44,52,-8,37
Ayr,6290,10,7,12,17,34,62,-28,33
Hibernian,6291,1,20,11,5,58,29,29,71
Falkirk,6291,2,17,10,9,59,38,21,61
Dundee Utd,6291,3,17,10,9,51,37,14,61
Morton,6291,4,16,12,8,48,33,15,60
Queen of S't,6291,5,13,10,13,51,52,-1,49
Dunfermline,6291,6,10,12,14,46,52,-6,42
Ayr,6291,7,8,14,14,33,52,-19,38
Dumbarton,6291,8,8,12,16,48,60,-12,36
Raith,6291,9,9,9,18,36,54,-18,36
St Mirren,6291,10,7,10,19,36,59,-23,31
Hibernian,6292,1,20,11,5,54,24,30,71
Morton,6292,2,18,10,8,50,31,19,64
Dundee Utd,6292,3,17,9,10,51,38,13,60
Falkirk,6292,4,15,11,10,52,40,12,56
Queen of S't,6292,5,11,10,15,43,48,-5,43
Ayr,6292,6,9,14,13,39,52,-13,41
Raith,6292,7,10,9,17,34,49,-15,39
St Mirren,6292,8,9,11,16,39,54,-15,38
Dunfermline,6292,9,8,13,15,43,53,-10,37
Dumbarton,6292,10,8,12,16,46,62,-16,36
Hibernian,6293,1,20,11,5,55,26,29,71
Falkirk,6293,2,16,10,10,55,38,17,58
Morton,6293,3,15,12,9,47,37,10,57
Dundee Utd,6293,4,15,8,13,48,42,6,53
Queen of S't,6293,5,14,8,14,43,45,-2,50
Dunfermline,6293,6,12,13,11,49,43,6,49
Ayr,6293,7,11,10,15,33,49,-16,43
Raith,6293,8,10,8,18,34,53,-19,38
Dumbarton,6293,9,7,14,15,41,54,-13,35
St Mirren,6293,10,8,10,18,35,53,-18,34
Hibernian,6294,1,19,11,6,57,29,28,68
Dundee Utd,6294,2,17,10,9,52,35,17,61
Morton,6294,3,15,13,8,47,36,11,58
Falkirk,6294,4,15,11,10,57,40,17,56
Queen of S't,6294,5,13,10,13,48,47,1,49
Dunfermline,6294,6,10,14,12,47,48,-1,44
Dumbarton,6294,7,10,12,14,51,58,-7,42
St Mirren,6294,8,9,11,16,40,53,-13,38
Raith,6294,9,9,9,18,32,56,-24,36
Ayr,6294,10,7,11,18,33,62,-29,32
Dundee Utd,6295,1,19,8,9,59,39,20,65
Hibernian,6295,2,17,13,6,53,27,26,64
Falkirk,6295,3,18,9,9,61,40,21,63
Morton,6295,4,15,12,9,48,41,7,57
Dunfermline,6295,5,10,12,14,47,51,-4,42
St Mirren,6295,6,11,9,16,43,54,-11,42
Dumbarton,6295,7,10,11,15,52,57,-5,41
Queen of S't,6295,8,10,11,15,41,51,-10,41
Raith,6295,9,9,11,16,33,49,-16,38
Ayr,6295,10,7,12,17,29,57,-28,33
Morton,6296,1,20,11,5,63,35,28,71
Hibernian,6296,2,18,12,6,53,29,24,66
Falkirk,6296,3,15,14,7,62,39,23,59
Dundee Utd,6296,4,16,9,11,53,42,11,57
Raith,6296,5,11,10,15,40,53,-13,43
Queen of S't,6296,6,11,9,16,44,57,-13,42
Dunfermline,6296,7,8,14,14,46,53,-7,38
Ayr,6296,8,9,11,16,40,60,-20,38
Dumbarton,6296,9,8,12,16,48,60,-12,36
St Mirren,6296,10,8,10,18,38,59,-21,34
Hibernian,6297,1,20,10,6,57,25,32,70
Dundee Utd,6297,2,19,8,9,56,40,16,65
Morton,6297,3,18,10,8,47,35,12,64
Falkirk,6297,4,16,11,9,56,39,17,59
Queen of S't,6297,5,12,8,16,45,53,-8,44
Dunfermline,6297,6,10,13,13,46,44,2,43
Dumbarton,6297,7,11,10,15,51,54,-3,43
Raith,6297,8,10,8,18,32,50,-18,38
St Mirren,6297,9,8,10,18,38,60,-22,34
Ayr,6297,10,7,10,19,30,58,-28,31
Hibernian,6298,1,20,13,3,56,22,34,73
Morton,6298,2,17,10,9,50,35,15,61
Dundee Utd,6298,3,17,10,9,50,36,14,61
Falkirk,6298,4,16,9,11,58,44,14,57
Raith,6298,5,12,10,14,35,43,-8,46
Dunfermline,6298,6,10,14,12,42,43,-1,44
Dumbarton,6298,7,9,10,17,47,61,-14,37
Queen of S't,6298,8,9,10,17,42,56,-14,37
St Mirren,6298,9,9,9,18,39,56,-17,36
Ayr,6298,10,8,11,17,32,55,-23,35
Hibernian,6299,1,17,15,4,53,26,27,66
Morton,6299,2,18,12,6,50,32,18,66
Falkirk,6299,3,16,11,9,63,43,20,59
Dundee Utd,6299,4,16,11,9,53,38,15,59
Queen of S't,6299,5,12,11,13,42,47,-5,47
Dunfermline,6299,6,9,14,13,43,46,-3,41
Raith,6299,7,9,11,16,34,51,-17,38
Dumbarton,6299,8,9,10,17,49,60,-11,37
Ayr,6299,9,8,12,16,32,52,-20,36
St Mirren,6299,10,6,13,17,34,58,-24,31
Hibernian,6300,1,18,13,5,57,29,28,67
Dundee Utd,6300,2,16,12,8,54,38,16,60
Falkirk,6300,3,15,11,10,63,47,16,56
Morton,6300,4,14,11,11,44,41,3,53
Raith,6300,5,13,10,13,41,45,-4,49
Dunfermline,6300,6,11,14,11,47,45,2,47
Queen of S't,6300,7,10,11,15,42,50,-8,41
St Mirren,6300,8,10,9,17,41,58,-17,39
Ayr,6300,9,8,13,15,32,51,-19,37
Dumbarton,6300,10,8,10,18,46,63,-17,34
Hibernian,6301,1,18,11,7,59,28,31,65
Falkirk,6301,2,16,11,9,61,43,18,59
Dundee Utd,6301,3,16,9,11,51,41,10,57
Morton,6301,4,15,12,9,45,37,8,57
Dunfermline,6301,5,11,12,13,45,48,-3,45
Ayr,6301,6,11,11,14,39,51,-12,44
Queen of S't,6301,7,11,10,15,45,54,-9,43
Raith,6301,8,10,11,15,33,47,-14,41
St Mirren,6301,9,9,11,16,42,59,-17,38
Dumbarton,6301,10,8,12,16,44,56,-12,36
Hibernian,6302,1,20,13,3,61,22,39,73
Morton,6302,2,17,13,6,52,30,22,64
Falkirk,6302,3,15,11,10,59,49,10,56
Dundee Utd,6302,4,16,8,12,54,44,10,56
Queen of S't,6302,5,13,8,15,49,51,-2,47
Dunfermline,6302,6,11,13,12,47,47,0,46
St Mirren,6302,7,9,11,16,42,54,-12,38
Dumbarton,6302,8,8,14,14,44,57,-13,38
Raith,6302,9,9,9,18,32,55,-23,36
Ayr,6302,10,6,12,18,31,62,-31,30
Hibernian,6303,1,21,10,5,62,27,35,73
Morton,6303,2,16,11,9,51,41,10,59
Falkirk,6303,3,15,13,8,54,37,17,58
Dundee Utd,6303,4,15,9,12,49,43,6,54
Queen of S't,6303,5,11,11,14,43,49,-6,44
Dunfermline,6303,6,9,14,13,49,54,-5,41
Dumbarton,6303,7,10,11,15,50,58,-8,41
Raith,6303,8,10,11,15,37,48,-11,41
St Mirren,6303,9,9,10,17,40,57,-17,37
Ayr,6303,10,8,12,16,35,56,-21,36
Hibernian,6304,1,17,13,6,50,28,22,64
Morton,6304,2,16,13,7,52,36,16,61
Falkirk,6304,3,16,11,9,62,43,19,59
Dundee Utd,6304,4,16,10,10,55,43,12,58
Dunfermline,6304,5,11,15,10,47,42,5,48
Queen of S't,6304,6,12,9,15,42,52,-10,45
Dumbarton,6304,7,11,10,15,48,60,-12,43
Ayr,6304,8,10,11,15,41,58,-17,41
St Mirren,6304,9,8,9,19,41,57,-16,33
Raith,6304,10,8,9,19,33,52,-19,33
Hibernian,6305,1,21,10,5,70,33,37,73
Morton,6305,2,16,12,8,50,42,8,60
Dundee Utd,6305,3,16,8,12,53,43,10,56
Falkirk,6305,4,15,9,12,57,51,6,54
Dunfermline,6305,5,12,12,12,55,47,8,48
Queen of S't,6305,6,12,11,13,46,50,-4,47
Raith,6305,7,10,9,17,39,54,-15,39
Dumbarton,6305,8,8,14,14,52,63,-11,38
St Mirren,6305,9,8,12,16,42,56,-14,36
Ayr,6305,10,7,13,16,32,57,-25,34
Hibernian,6306,1,19,12,5,53,23,30,69
Morton,6306,2,18,11,7,54,37,17,65
Falkirk,6306,3,16,10,10,58,42,16,58
Dundee Utd,6306,4,15,9,12,45,42,3,54
Queen of S't,6306,5,12,9,15,45,51,-6,45
Raith,6306,6,12,9,15,35,45,-10,45
Dunfermline,6306,7,10,12,14,45,50,-5,42
Dumbarton,6306,8,9,11,16,50,61,-11,38
St Mirren,6306,9,8,12,16,40,53,-13,36
Ayr,6306,10,7,13,16,35,56,-21,34
Hibernian,6307,1,20,12,4,60,26,34,72
Dundee Utd,6307,2,17,11,8,51,37,14,62
Falkirk,6307,3,16,11,9,58,39,19,59
Morton,6307,4,15,12,9,52,42,10,57
Raith,6307,5,11,8,17,39,53,-14,41
Dunfermline,6307,6,9,13,14,45,51,-6,40
Queen of S't,6307,7,10,10,16,42,51,-9,40
Ayr,6307,8,8,14,14,35,52,-17,38
Dumbarton,6307,9,8,13,15,50,62,-12,37
St Mirren,6307,10,8,12,16,40,59,-19,36
Morton,6308,1,20,10,6,61,33,28,70
Hibernian,6308,2,19,11,6,53,26,27,68
Falkirk,6308,3,16,10,10,61,44,17,58
Dundee Utd,6308,4,14,12,10,48,42,6,54
Queen of S't,6308,5,13,9,14,46,53,-7,48
Dunfermline,6308,6,9,14,13,48,52,-4,41
Dumbarton,6308,7,10,10,16,50,60,-10,40
St Mirren,6308,8,9,10,17,41,58,-17,37
Raith,6308,9,9,9,18,35,52,-17,36
Ayr,6308,10,7,13,16,34,57,-23,34
Hibernian,6309,1,18,13,5,53,28,25,67
Morton,6309,2,18,11,7,58,37,21,65
Dundee Utd,6309,3,16,10,10,57,41,16,58
Falkirk,6309,4,15,11,10,60,46,14,56
Queen of S't,6309,5,11,12,13,45,48,-3,45
Dunfermline,6309,6,10,13,13,48,50,-2,43
Dumbarton,6309,7,10,11,15,51,61,-10,41
Raith,6309,8,9,12,15,33,51,-18,39
Ayr,6309,9,7,14,15,35,57,-22,35
St Mirren,6309,10,7,11,18,40,61,-21,32
Hibernian,6310,1,22,10,4,57,22,35,76
Dundee Utd,6310,2,17,11,8,52,36,16,62
Falkirk,6310,3,15,12,9,57,42,15,57
Morton,6310,4,15,12,9,50,41,9,57
Dunfermline,6310,5,10,15,11,48,48,0,45
Queen of S't,6310,6,11,10,15,47,52,-5,43
Dumbarton,6310,7,9,11,16,45,58,-13,38
Raith,6310,8,9,11,16,36,53,-17,38
Ayr,6310,9,8,13,15,36,55,-19,37
St Mirren,6310,10,6,11,19,34,55,-21,29
Hibernian,6311,1,19,12,5,53,24,29,69
Falkirk,6311,2,17,11,8,60,39,21,62
Morton,6311,3,17,11,8,51,36,15,62
Dundee Utd,6311,4,16,12,8,57,41,16,60
Dunfermline,6311,5,11,14,11,49,45,4,47
Queen of S't,6311,6,12,8,16,43,51,-8,44
Ayr,6311,7,9,10,17,37,59,-22,37
St Mirren,6311,8,8,12,16,43,58,-15,36
Raith,6311,9,9,9,18,33,54,-21,36
Dumbarton,6311,10,7,11,18,43,62,-19,32
Hibernian,6312,1,20,12,4,59,27,32,72
Falkirk,6312,2,17,10,9,63,44,19,61
Dundee Utd,6312,3,16,11,9,51,40,11,59
Morton,6312,4,15,13,8,48,38,10,58
Dunfermline,6312,5,11,14,11,51,48,3,47
Queen of S't,6312,6,11,10,15,47,54,-7,43
Raith,6312,7,9,11,16,34,51,-17,38
St Mirren,6312,8,9,10,17,39,54,-15,37
Dumbarton,6312,9,8,11,17,49,61,-12,35
Ayr,6312,10,7,12,17,29,53,-24,33
Hibernian,6313,1,19,13,4,57,29,28,70
Falkirk,6313,2,16,12,8,61,40,21,60
Morton,6313,3,17,9,10,52,44,8,60
Dundee Utd,6313,4,15,10,11,49,41,8,55
Queen of S't,6313,5,13,10,13,48,47,1,49
Dunfermline,6313,6,11,13,12,56,50,6,46
Dumbarton,6313,7,10,13,13,54,60,-6,43
Raith,6313,8,9,9,18,37,57,-20,36
St Mirren,6313,9,8,10,18,42,61,-19,34
Ayr,6313,10,6,13,17,30,57,-27,31
Hibernian,6314,1,21,12,3,64,25,39,75
Dundee Utd,6314,2,17,9,10,49,38,11,60
Morton,6314,3,16,11,9,48,38,10,59
Falkirk,6314,4,14,10,12,53,43,10,52
Dunfermline,6314,5,10,15,11,47,47,0,45
Queen of S't,6314,6,12,9,15,47,51,-4,45
Raith,6314,7,10,9,17,33,54,-21,39
Dumbarton,6314,8,8,14,14,49,58,-9,38
St Mirren,6314,9,9,10,17,44,56,-12,37
Ayr,6314,10,8,11,17,32,56,-24,35
Hibernian,6315,1,20,11,5,62,27,35,71
Morton,6315,2,18,11,7,55,38,17,65
Dundee Utd,6315,3,18,8,10,57,39,18,62
Falkirk,6315,4,16,10,10,57,46,11,58
Dunfermline,6315,5,10,13,13,46,53,-7,43
Queen of S't,6315,6,10,11,15,42,52,-10,41
Raith,6315,7,10,10,16,34,46,-12,40
Ayr,6315,8,8,14,14,38,52,-14,38
Dumbarton,6315,9,9,11,16,46,63,-17,38
St Mirren,6315,10,6,11,19,37,58,-21,29
Hibernian,6316,1,20,12,4,61,25,36,72
Falkirk,6316,2,17,11,8,62,36,26,62
Morton,6316,3,16,13,7,55,40,15,61
Dundee Utd,6316,4,15,13,8,52,35,17,58
Queen of S't,6316,5,12,11,13,48,50,-2,47
Dunfermline,6316,6,8,16,12,43,48,-5,40
Raith,6316,7,10,10,16,32,49,-17,40
St Mirren,6316,8,8,11,17,37,58,-21,35
Dumbarton,6316,9,7,12,17,43,62,-19,33
Ayr,6316,10,7,11,18,30,60,-30,32
Hibernian,6317,1,19,13,4,57,26,31,70
Morton,6317,2,17,12,7,53,36,17,63
Falkirk,6317,3,16,12,8,54,35,19,60
Dundee Utd,6317,4,16,9,11,56,40,16,57
Ayr,6317,5,10,12,14,36,56,-20,42
Queen of S't,6317,6,10,11,15,42,49,-7,41
Dunfermline,6317,7,9,13,14,43,53,-10,40
Dumbarton,6317,8,9,11,16,47,58,-11,38
Raith,6317,9,9,11,16,37,52,-15,38
St Mirren,6317,10,7,12,17,39,59,-20,33
Hibernian,6318,1,21,11,4,58,25,33,74
Falkirk,6318,2,18,9,9,60,42,18,63
Morton,6318,3,17,11,8,51,37,14,62
Dundee Utd,6318,4,17,10,9,56,41,15,61
Raith,6318,5,11,10,15,37,48,-11,43
Dunfermline,6318,6,9,13,14,42,47,-5,40
Queen of S't,6318,7,9,12,15,41,50,-9,39
Dumbarton,6318,8,9,12,15,47,58,-11,39
Ayr,6318,9,8,11,17,32,54,-22,35
St Mirren,6318,10,6,11,19,38,60,-22,29
Hibernian,6319,1,21,11,4,57,24,33,74
Morton,6319,2,16,13,7,48,37,11,61
Dundee Utd,6319,3,15,13,8,52,38,14,58
Falkirk,6319,4,15,10,11,53,44,9,55
Dunfermline,6319,5,11,14,11,51,46,5,47
Raith,6319,6,10,12,14,34,43,-9,42
Queen of S't,6319,7,10,11,15,45,55,-10,41
Dumbarton,6319,8,9,11,16,49,59,-10,38
St Mirren,6319,9,7,12,17,37,54,-17,33
Ayr,6319,10,6,13,17,32,58,-26,31
Morton,6320,1,19,9,8,54,33,21,66
Dundee Utd,6320,2,17,11,8,51,34,17,62
Hibernian,6320,3,16,13,7,50,29,21,61
Falkirk,6320,4,16,10,10,60,39,21,58
Queen of S't,6320,5,12,10,14,46,51,-5,46
Dunfermline,6320,6,10,12,14,46,54,-8,42
St Mirren,6320,7,9,11,16,40,56,-16,38
Raith,6320,8,9,11,16,33,49,-16,38
Ayr,6320,9,8,13,15,32,54,-22,37
Dumbarton,6320,10,8,12,16,48,61,-13,36
Hibernian,6321,1,18,14,4,52,24,28,68
Falkirk,6321,2,17,10,9,56,40,16,61
Dundee Utd,6321,3,16,9,11,52,39,13,57
Morton,6321,4,15,11,10,45,40,5,56
Dunfermline,6321,5,12,12,12,52,48,4,48
Queen of S't,6321,6,12,10,14,47,50,-3,46
Raith,6321,7,10,10,16,35,48,-13,40
Dumbarton,6321,8,9,11,16,46,60,-14,38
Ayr,6321,9,9,11,16,36,56,-20,38
St Mirren,6321,10,8,10,18,39,55,-16,34
Hibernian,6322,1,17,13,6,53,30,23,64
Morton,6322,2,15,14,7,51,38,13,59
Falkirk,6322,3,16,10,10,60,43,17,58
Dundee Utd,6322,4,16,9,11,49,39,10,57
Dunfermline,6322,5,10,13,13,44,46,-2,43
Dumbarton,6322,6,10,13,13,51,55,-4,43
Raith,6322,7,11,10,15,37,48,-11,43
Queen of S't,6322,8,10,10,16,41,53,-12,40
St Mirren,6322,9,9,11,16,39,54,-15,38
Ayr,6322,10,8,13,15,36,55,-19,37
Morton,6323,1,18,11,7,54,35,19,65
Falkirk,6323,2,17,12,7,60,38,22,63
Hibernian,6323,3,17,12,7,52,30,22,63
Dundee Utd,6323,4,16,11,9,52,43,9,59
Dunfermline,6323,5,11,11,14,46,48,-2,44
Raith,6323,6,11,10,15,37,50,-13,43
Queen of S't,6323,7,10,9,17,45,52,-7,39
Dumbarton,6323,8,8,13,15,45,57,-12,37
Ayr,6323,9,9,10,17,34,55,-21,37
St Mirren,6323,10,8,11,17,42,59,-17,35
Hibernian,6324,1,20,11,5,57,26,31,71
Morton,6324,2,17,11,8,47,33,14,62
Dundee Utd,6324,3,16,11,9,54,40,14,59
Falkirk,6324,4,16,9,11,55,41,14,57
Dunfermline,6324,5,11,13,12,48,47,1,46
Dumbarton,6324,6,10,12,14,51,58,-7,42
Queen of S't,6324,7,11,9,16,43,52,-9,42
Raith,6324,8,11,9,16,36,50,-14,42
St Mirren,6324,9,9,10,17,40,53,-13,37
Ayr,6324,10,6,11,19,31,62,-31,29
Hibernian,6325,1,19,14,3,52,22,30,71
Morton,6325,2,17,10,9,50,37,13,61
Dundee Utd,6325,3,15,10,11,47,42,5,55
Falkirk,6325,4,13,10,13,51,47,4,49
Dunfermline,6325,5,11,12,13,47,46,1,45
Dumbarton,6325,6,11,11,14,54,55,-1,44
Queen of S't,6325,7,11,11,14,44,51,-7,44
Raith,6325,8,9,13,14,34,45,-11,40
Ayr,6325,9,8,14,14,34,52,-18,38
St Mirren,6325,10,8,11,17,36,52,-16,35
Hibernian,6326,1,19,14,3,62,29,33,71
Morton,6326,2,16,10,10,49,38,11,58
Dundee Utd,6326,3,16,10,10,48,38,10,58
Falkirk,6326,4,15,12,9,60,44,16,57
Queen of S't,6326,5,11,12,13,48,50,-2,45
Raith,6326,6,11,10,15,39,52,-13,43
Dunfermline,6326,7,9,14,13,46,52,-6,41
Dumbarton,6326,8,9,11,16,53,64,-11,38
Ayr,6326,9,8,13,15,37,58,-21,37
St Mirren,6326,10,8,10,18,44,61,-17,34
Hibernian,6327,1,20,11,5,58,24,34,71
Morton,6327,2,19,9,8,57,36,21,66
Falkirk,6327,3,16,11,9,60,42,18,59
Dundee Utd,6327,4,15,11,10,49,43,6,56
Ayr,6327,5,11,13,12,37,50,-13,46
Queen of S't,6327,6,10,11,15,42,49,-7,41
Dunfermline,6327,7,9,13,14,48,53,-5,40
Dumbarton,6327,8,8,13,15,46,60,-14,37
Raith,6327,9,8,10,18,32,52,-20,34
St Mirren,6327,10,7,12,17,37,57,-20,33
Hibernian,6328,1,20,12,4,54,24,30,72
Morton,6328,2,17,10,9,48,35,13,61
Dundee Utd,6328,3,16,11,9,53,43,10,59
Falkirk,6328,4,16,9,11,60,47,13,57
Dunfermline,6328,5,10,12,14,46,49,-3,42
Queen of S't,6328,6,11,9,16,43,50,-7,42
Raith,6328,7,10,9,17,38,51,-13,39
Ayr,6328,8,8,15,13,35,53,-18,39
Dumbarton,6328,9,9,11,16,47,56,-9,38
St Mirren,6328,10,8,12,16,39,55,-16,36
Hibernian,6329,1,21,11,4,58,21,37,74
Morton,6329,2,19,9,8,50,35,15,66
Falkirk,6329,3,16,10,10,53,39,14,58
Dundee Utd,6329,4,16,9,11,54,40,14,57
Queen of S't,6329,5,12,10,14,44,46,-2,46
Ayr,6329,6,11,11,14,36,52,-16,44
Raith,6329,7,10,11,15,38,50,-12,41
Dumbarton,6329,8,9,10,17,52,63,-11,37
Dunfermline,6329,9,7,12,17,41,58,-17,33
St Mirren,6329,10,8,9,19,43,65,-22,33
Hibernian,6330,1,20,13,3,57,23,34,73
Morton,6330,2,15,11,10,48,41,7,56
Dundee Utd,6330,3,15,9,12,52,43,9,54
Falkirk,6330,4,14,10,12,59,47,12,52
Dunfermline,6330,5,11,13,12,51,47,4,46
Queen of S't,6330,6,12,9,15,43,52,-9,45
Dumbarton,6330,7,11,10,15,50,56,-6,43
St Mirren,6330,8,10,10,16,44,54,-10,40
Ayr,6330,9,9,12,15,36,56,-20,39
Raith,6330,10,10,9,17,39,60,-21,39
Hibernian,6331,1,19,12,5,58,29,29,69
Morton,6331,2,19,9,8,54,38,16,66
Falkirk,6331,3,17,10,9,64,43,21,61
Dundee Utd,6331,4,16,10,10,55,42,13,58
Dunfermline,6331,5,11,13,12,47,50,-3,46
Queen of S't,6331,6,11,9,16,46,53,-7,42
Raith,6331,7,10,10,16,36,50,-14,40
Ayr,6331,8,9,12,15,35,54,-19,39
St Mirren,6331,9,8,10,18,46,63,-17,34
Dumbarton,6331,10,7,11,18,44,63,-19,32
Hibernian,6332,1,18,14,4,57,24,33,68
Morton,6332,2,16,11,9,50,40,10,59
Dundee Utd,6332,3,15,10,11,58,42,16,55
Falkirk,6332,4,15,9,12,55,51,4,54
Raith,6332,5,11,11,14,36,46,-10,44
Dumbarton,6332,6,11,10,15,48,55,-7,43
Dunfermline,6332,7,9,15,12,51,50,1,42
Queen of S't,6332,8,10,11,15,46,55,-9,41
St Mirren,6332,9,10,10,16,40,52,-12,40
Ayr,6332,10,8,13,15,33,59,-26,37
Hibernian,6333,1,18,13,5,57,30,27,67
Falkirk,6333,2,19,9,8,68,39,29,66
Morton,6333,3,17,10,9,49,39,10,61
Dundee Utd,6333,4,16,10,10,51,43,8,58
Queen of S't,6333,5,12,9,15,44,49,-5,45
Raith,6333,6,11,11,14,38,52,-14,44
Dunfermline,6333,7,8,15,13,47,49,-2,39
St Mirren,6333,8,7,14,15,40,56,-16,35
Ayr,6333,9,7,13,16,33,53,-20,34
Dumbarton,6333,10,7,12,17,44,61,-17,33
Morton,6334,1,18,12,6,53,35,18,66
Hibernian,6334,2,17,13,6,54,29,25,64
Falkirk,6334,3,16,10,10,57,40,17,58
Dundee Utd,6334,4,15,8,13,50,49,1,53
Dumbarton,6334,5,11,12,13,49,54,-5,45
Queen of S't,6334,6,12,8,16,45,51,-6,44
Dunfermline,6334,7,10,13,13,50,52,-2,43
Ayr,6334,8,10,11,15,40,55,-15,41
Raith,6334,9,9,10,17,31,51,-20,37
St Mirren,6334,10,8,11,17,37,50,-13,35
Hibernian,6335,1,21,12,3,62,26,36,75
Dundee Utd,6335,2,18,8,10,56,40,16,62
Falkirk,6335,3,16,12,8,57,39,18,60
Morton,6335,4,17,9,10,53,39,14,60
Dumbarton,6335,5,10,11,15,46,56,-10,41
Raith,6335,6,11,8,17,37,51,-14,41
Dunfermline,6335,7,9,13,14,44,47,-3,40
Queen of S't,6335,8,10,8,18,45,56,-11,38
Ayr,6335,9,9,10,17,35,60,-25,37
St Mirren,6335,10,9,9,18,40,61,-21,36
Hibernian,6336,1,20,11,5,55,24,31,71
Falkirk,6336,2,18,9,9,65,40,25,63
Morton,6336,3,17,11,8,53,37,16,62
Dundee Utd,6336,4,18,8,10,54,42,12,62
Queen of S't,6336,5,12,8,16,48,52,-4,44
Dumbarton,6336,6,10,10,16,49,63,-14,40
Dunfermline,6336,7,9,12,15,45,53,-8,39
St Mirren,6336,8,10,9,17,40,57,-17,39
Raith,6336,9,9,9,18,32,49,-17,36
Ayr,6336,10,8,11,17,30,54,-24,35
Hibernian,6337,1,18,12,6,54,30,24,66
Morton,6337,2,17,12,7,53,36,17,63
Falkirk,6337,3,16,10,10,57,40,17,58
Dundee Utd,6337,4,16,9,11,47,42,5,57
Queen of S't,6337,5,14,8,14,54,49,5,50
Dunfermline,6337,6,11,13,12,49,53,-4,46
Raith,6337,7,12,9,15,38,48,-10,45
Dumbarton,6337,8,8,12,16,49,58,-9,36
Ayr,6337,9,8,11,17,33,57,-24,35
St Mirren,6337,10,7,10,19,41,62,-21,31
Hibernian,6338,1,17,15,4,54,27,27,66
Falkirk,6338,2,17,11,8,54,35,19,62
Morton,6338,3,14,16,6,48,37,11,58
Dundee Utd,6338,4,15,9,12,50,43,7,54
Queen of S't,6338,5,13,11,12,49,48,1,50
Dunfermline,6338,6,10,15,11,48,46,2,45
Raith,6338,7,10,8,18,37,51,-14,38
Ayr,6338,8,8,13,15,35,57,-22,37
St Mirren,6338,9,8,11,17,40,57,-17,35
Dumbarton,6338,10,7,13,16,45,59,-14,34
Morton,6339,1,18,13,5,56,34,22,67
Hibernian,6339,2,17,13,6,51,28,23,64
Falkirk,6339,3,17,10,9,58,39,19,61
Dundee Utd,6339,4,15,10,11,45,40,5,55
Queen of S't,6339,5,10,12,14,44,50,-6,42
Dunfermline,6339,6,8,17,11,43,46,-3,41
Raith,6339,7,10,11,15,36,47,-11,41
St Mirren,6339,8,10,9,17,45,55,-10,39
Dumbarton,6339,9,9,11,16,50,60,-10,38
Ayr,6339,10,8,10,18,31,60,-29,34
Hibernian,6340,1,20,12,4,58,27,31,72
Morton,6340,2,18,11,7,56,33,23,65
Falkirk,6340,3,17,9,10,57,45,12,60
Dundee Utd,6340,4,16,10,10,47,36,11,58
Queen of S't,6340,5,10,11,15,43,49,-6,41
Dumbarton,6340,6,9,14,13,52,59,-7,41
Ayr,6340,7,10,11,15,35,53,-18,41
Dunfermline,6340,8,7,16,13,40,48,-8,37
Raith,6340,9,9,9,18,30,49,-19,36
St Mirren,6340,10,7,11,18,37,56,-19,32
Hibernian,6341,1,18,13,5,50,23,27,67
Falkirk,6341,2,17,12,7,62,35,27,63
Morton,6341,3,18,9,9,50,38,12,63
Dundee Utd,6341,4,15,9,12,44,42,2,54
Dunfermline,6341,5,12,12,12,50,45,5,48
Raith,6341,6,11,9,16,39,53,-14,42
St Mirren,6341,7,10,10,16,43,55,-12,40
Queen of S't,6341,8,10,9,17,41,53,-12,39
Ayr,6341,9,9,12,15,34,53,-19,39
Dumbarton,6341,10,7,11,18,44,60,-16,32
Hibernian,6342,1,19,12,5,54,27,27,69
Falkirk,6342,2,16,11,9,58,41,17,59
Morton,6342,3,16,11,9,55,45,10,59
Dundee Utd,6342,4,16,10,10,53,42,11,58
Queen of S't,6342,5,12,8,16,44,50,-6,44
Ayr,6342,6,10,13,13,37,51,-14,43
Dunfermline,6342,7,9,15,12,45,47,-2,42
Dumbarton,6342,8,8,13,15,49,63,-14,37
St Mirren,6342,9,8,12,16,42,55,-13,36
Raith,6342,10,8,11,17,34,50,-16,35
Hibernian,6343,1,20,11,5,54,25,29,71
Morton,6343,2,18,11,7,52,36,16,65
Dundee Utd,6343,3,15,11,10,50,42,8,56
Falkirk,6343,4,13,12,11,54,43,11,51
Queen of S't,6343,5,12,11,13,47,50,-3,47
Raith,6343,6,10,11,15,39,47,-8,41
Dumbarton,6343,7,9,14,13,54,63,-9,41
St Mirren,6343,8,9,10,17,50,59,-9,37
Ayr,6343,9,8,13,15,35,59,-24,37
Dunfermline,6343,10,8,12,16,44,55,-11,36
Hibernian,6344,1,20,12,4,55,23,32,72
Falkirk,6344,2,18,10,8,59,38,21,64
Morton,6344,3,15,12,9,46,37,9,57
Dundee Utd,6344,4,15,10,11,47,40,7,55
Queen of S't,6344,5,11,9,16,43,50,-7,42
Dumbarton,6344,6,10,12,14,49,57,-8,42
Ayr,6344,7,10,12,14,36,50,-14,42
Dunfermline,6344,8,9,13,14,45,51,-6,40
Raith,6344,9,9,9,18,32,50,-18,36
St Mirren,6344,10,8,11,17,38,54,-16,35
Hibernian,6345,1,20,11,5,57,28,29,71
Falkirk,6345,2,17,10,9,62,45,17,61
Dundee Utd,6345,3,16,11,9,53,39,14,59
Morton,6345,4,16,11,9,50,38,12,59
Queen of S't,6345,5,14,8,14,52,49,3,50
Raith,6345,6,11,9,16,39,50,-11,42
Dumbarton,6345,7,9,12,15,47,59,-12,39
Ayr,6345,8,8,12,16,32,55,-23,36
Dunfermline,6345,9,8,11,17,43,54,-11,35
St Mirren,6345,10,8,11,17,36,54,-18,35
Hibernian,6346,1,21,11,4,59,23,36,74
Dundee Utd,6346,2,18,9,9,52,38,14,63
Falkirk,6346,3,16,12,8,67,45,22,60
Morton,6346,4,16,10,10,47,38,9,58
Queen of S't,6346,5,13,9,14,46,52,-6,48
St Mirren,6346,6,9,12,15,38,51,-13,39
Raith,6346,7,9,12,15,33,48,-15,39
Dunfermline,6346,8,8,12,16,42,53,-11,36
Dumbarton,6346,9,7,13,16,44,57,-13,34
Ayr,6346,10,7,12,17,32,55,-23,33
Hibernian,6347,1,18,12,6,51,26,25,66
Falkirk,6347,2,17,11,8,62,37,25,62
Morton,6347,3,17,11,8,50,36,14,62
Dundee Utd,6347,4,17,9,10,51,37,14,60
Queen of S't,6347,5,13,8,15,48,53,-5,47
Dunfermline,6347,6,11,13,12,46,46,0,46
Ayr,6347,7,8,13,15,36,57,-21,37
Raith,6347,8,9,10,17,33,54,-21,37
Dumbarton,6347,9,7,13,16,44,60,-16,34
St Mirren,6347,10,7,12,17,40,55,-15,33
Hibernian,6348,1,19,13,4,54,25,29,70
Morton,6348,2,18,10,8,51,37,14,64
Falkirk,6348,3,15,11,10,53,36,17,56
Dundee Utd,6348,4,15,11,10,49,39,10,56
Dumbarton,6348,5,11,12,13,49,53,-4,45
Dunfermline,6348,6,10,12,14,47,51,-4,42
Queen of S't,6348,7,10,12,14,48,55,-7,42
Raith,6348,8,10,10,16,38,50,-12,40
St Mirren,6348,9,8,10,18,37,55,-18,34
Ayr,6348,10,6,15,15,31,56,-25,33
Hibernian,6349,1,19,13,4,57,26,31,70
Falkirk,6349,2,18,9,9,62,41,21,63
Morton,6349,3,16,11,9,49,39,10,59
Dundee Utd,6349,4,16,10,10,51,39,12,58
Dumbarton,6349,5,11,10,15,52,60,-8,43
Dunfermline,6349,6,10,12,14,46,49,-3,42
Raith,6349,7,11,9,16,36,49,-13,42
Queen of S't,6349,8,10,10,16,42,53,-11,40
Ayr,6349,9,8,12,16,34,56,-22,36
St Mirren,6349,10,8,10,18,39,56,-17,34
Hibernian,6350,1,20,11,5,53,25,28,71
Morton,6350,2,18,10,8,51,36,15,64
Falkirk,6350,3,17,9,10,61,40,21,60
Dundee Utd,6350,4,16,9,11,51,41,10,57
Dunfermline,6350,5,12,11,13,51,47,4,47
Queen of S't,6350,6,11,10,15,43,50,-7,43
Raith,6350,7,10,10,16,38,50,-12,40
Dumbarton,6350,8,8,12,16,43,60,-17,36
St Mirren,6350,9,9,9,18,40,59,-19,36
Ayr,6350,10,7,13,16,34,57,-23,34
Hibernian,6351,1,18,13,5,55,26,29,67
Morton,6351,2,18,13,5,55,32,23,67
Falkirk,6351,3,15,11,10,61,43,18,56
Dundee Utd,6351,4,15,10,11,51,42,9,55
Queen of S't,6351,5,13,9,14,46,46,0,48
Dunfermline,6351,6,10,13,13,48,50,-2,43
Raith,6351,7,10,12,14,32,47,-15,42
St Mirren,6351,8,9,10,17,37,55,-18,37
Ayr,6351,9,7,13,16,34,61,-27,34
Dumbarton,6351,10,7,12,17,43,60,-17,33
Hibernian,6352,1,17,13,6,52,29,23,64
Morton,6352,2,18,9,9,54,38,16,63
Dundee Utd,6352,3,17,10,9,55,38,17,61
Falkirk,6352,4,15,11,10,56,40,16,56
Dunfermline,6352,5,12,12,12,49,49,0,48
Queen of S't,6352,6,10,12,14,44,51,-7,42
Dumbarton,6352,7,10,11,15,49,60,-11,41
Raith,6352,8,11,8,17,34,46,-12,41
St Mirren,6352,9,8,12,16,40,56,-16,36
Ayr,6352,10,7,12,17,33,59,-26,33
Hibernian,6353,1,16,13,7,52,31,21,61
Falkirk,6353,2,16,10,10,57,42,15,58
Morton,6353,3,15,12,9,46,35,11,57
Dundee Utd,6353,4,15,11,10,47,40,7,56
Ayr,6353,5,13,10,13,43,52,-9,49
Queen of S't,6353,6,11,10,15,41,49,-8,43
Dunfermline,6353,7,9,14,13,43,46,-3,41
Raith,6353,8,10,11,15,34,44,-10,41
Dumbarton,6353,9,10,10,16,43,55,-12,40
St Mirren,6353,10,9,11,16,38,50,-12,38
Hibernian,6354,1,20,13,3,57,24,33,73
Dundee Utd,6354,2,16,10,10,49,40,9,58
Morton,6354,3,15,12,9,45,37,8,57
Falkirk,6354,4,14,13,9,54,40,14,55
Queen of S't,6354,5,13,8,15,44,48,-4,47
Dunfermline,6354,6,9,16,11,44,45,-1,43
Ayr,6354,7,9,12,15,36,53,-17,39
Raith,6354,8,9,11,16,36,49,-13,38
Dumbarton,6354,9,8,13,15,45,54,-9,37
St Mirren,6354,10,8,10,18,38,58,-20,34
Hibernian,6355,1,18,13,5,52,25,27,67
Falkirk,6355,2,18,10,8,59,38,21,64
Morton,6355,3,17,12,7,55,39,16,63
Dundee Utd,6355,4,17,10,9,52,39,13,61
Queen of S't,6355,5,12,8,16,43,48,-5,44
St Mirren,6355,6,10,10,16,49,56,-7,40
Dunfermline,6355,7,8,15,13,45,49,-4,39
Raith,6355,8,10,9,17,33,55,-22,39
Dumbarton,6355,9,8,11,17,44,60,-16,35
Ayr,6355,10,8,10,18,33,56,-23,34
Hibernian,6356,1,20,11,5,62,24,38,71
Morton,6356,2,19,10,7,49,34,15,67
Falkirk,6356,3,16,11,9,57,39,18,59
Dundee Utd,6356,4,15,11,10,48,44,4,56
Queen of S't,6356,5,13,9,14,48,48,0,48
Raith,6356,6,11,10,15,40,49,-9,43
Dunfermline,6356,7,10,11,15,50,53,-3,41
Dumbarton,6356,8,8,12,16,48,65,-17,36
St Mirren,6356,9,8,10,18,40,56,-16,34
Ayr,6356,10,7,11,18,32,62,-30,32
Hibernian,6357,1,20,11,5,60,26,34,71
Morton,6357,2,16,11,9,49,40,9,59
Dundee Utd,6357,3,15,12,9,56,44,12,57
Falkirk,6357,4,15,10,11,54,43,11,55
Queen of S't,6357,5,11,12,13,44,49,-5,45
Dumbarton,6357,6,10,11,15,48,61,-13,41
Dunfermline,6357,7,9,12,15,47,54,-7,39
Raith,6357,8,9,12,15,31,44,-13,39
St Mirren,6357,9,9,11,16,42,54,-12,38
Ayr,6357,10,8,14,14,35,51,-16,38
Hibernian,6358,1,19,12,5,52,22,30,69
Morton,6358,2,18,11,7,47,32,15,65
Falkirk,6358,3,17,11,8,62,39,23,62
Dundee Utd,6358,4,17,8,11,60,41,19,59
Raith,6358,5,11,9,16,40,52,-12,42
Queen of S't,6358,6,11,8,17,46,59,-13,41
Dumbarton,6358,7,10,10,16,52,63,-11,40
Ayr,6358,8,10,10,16,39,59,-20,40
Dunfermline,6358,9,9,11,16,45,56,-11,38
St Mirren,6358,10,8,10,18,39,59,-20,34
Hibernian,6359,1,20,12,4,55,25,30,72
Morton,6359,2,17,9,10,50,36,14,60
Falkirk,6359,3,16,11,9,61,43,18,59
Dundee Utd,6359,4,16,10,10,52,40,12,58
Dunfermline,6359,5,11,12,13,46,47,-1,45
Queen of S't,6359,6,11,10,15,46,52,-6,43
Ayr,6359,7,10,11,15,36,54,-18,41
Dumbarton,6359,8,9,12,15,51,62,-11,39
Raith,6359,9,10,8,18,34,49,-15,38
St Mirren,6359,10,7,11,18,37,60,-23,32
Hibernian,6360,1,17,14,5,56,32,24,65
Morton,6360,2,16,14,6,53,37,16,62
Falkirk,6360,3,17,10,9,62,41,21,61
Dundee Utd,6360,4,16,11,9,52,39,13,59
Raith,6360,5,12,9,15,37,48,-11,45
Queen of S't,6360,6,11,10,15,44,52,-8,43
St Mirren,6360,7,9,11,16,40,55,-15,38
Ayr,6360,8,9,11,16,38,56,-18,38
Dunfermline,6360,9,7,15,14,43,49,-6,36
Dumbarton,6360,10,8,11,17,46,62,-16,35
Hibernian,6361,1,18,13,5,58,30,28,67
Morton,6361,2,16,13,7,51,37,14,61
Falkirk,6361,3,16,12,8,58,43,15,60
Dundee Utd,6361,4,15,10,11,47,41,6,55
Queen of S't,6361,5,12,8,16,47,51,-4,44
Dumbarton,6361,6,10,13,13,51,53,-2,43
Dunfermline,6361,7,9,16,11,46,48,-2,43
Raith,6361,8,11,8,17,38,49,-11,41
St Mirren,6361,9,8,12,16,37,56,-19,36
Ayr,6361,10,7,11,18,30,55,-25,32
Hibernian,6362,1,20,11,5,57,26,31,71
Falkirk,6362,2,17,10,9,57,39,18,61
Morton,6362,3,17,10,9,51,38,13,61
Dundee Utd,6362,4,15,10,11,49,40,9,55
Dunfermline,6362,5,12,11,13,50,52,-2,47
Queen of S't,6362,6,10,10,16,40,49,-9,40
St Mirren,6362,7,10,10,16,41,52,-11,40
Dumbarton,6362,8,9,11,16,46,57,-11,38
Raith,6362,9,9,11,16,34,49,-15,38
Ayr,6362,10,8,12,16,33,56,-23,36
Hibernian,6363,1,17,14,5,50,25,25,65
Falkirk,6363,2,17,12,7,67,44,23,63
Morton,6363,3,16,13,7,47,36,11,61
Dundee Utd,6363,4,15,9,12,51,39,12,54
Dunfermline,6363,5,9,16,11,44,47,-3,43
Dumbarton,6363,6,10,12,14,49,55,-6,42
Queen of S't,6363,7,10,12,14,43,51,-8,42
Raith,6363,8,10,9,17,34,48,-14,39
Ayr,6363,9,9,12,15,36,55,-19,39
St Mirren,6363,10,8,9,19,36,57,-21,33
Hibernian,6364,1,19,13,4,57,28,29,70
Morton,6364,2,17,10,9,47,39,8,61
Falkirk,6364,3,16,11,9,57,37,20,59
Dundee Utd,6364,4,16,11,9,49,36,13,59
Dunfermline,6364,5,12,13,11,51,47,4,49
Queen of S't,6364,6,12,9,15,46,50,-4,45
Dumbarton,6364,7,9,10,17,47,61,-14,37
Ayr,6364,8,8,13,15,36,54,-18,37
St Mirren,6364,9,8,11,17,40,56,-16,35
Raith,6364,10,8,9,19,31,53,-22,33
Hibernian,6365,1,17,13,6,57,35,22,64
Morton,6365,2,17,11,8,54,35,19,62
Dundee Utd,6365,3,17,11,8,53,39,14,62
Falkirk,6365,4,16,11,9,62,44,18,59
Dunfermline,6365,5,9,15,12,46,47,-1,42
Queen of S't,6365,6,10,12,14,44,50,-6,42
Raith,6365,7,10,11,15,37,50,-13,41
Dumbarton,6365,8,9,12,15,47,59,-12,39
St Mirren,6365,9,8,12,16,44,58,-14,36
Ayr,6365,10,7,12,17,32,59,-27,33
Hibernian,6366,1,19,11,6,56,28,28,68
Morton,6366,2,19,11,6,55,33,22,68
Dundee Utd,6366,3,19,8,9,57,41,16,65
Falkirk,6366,4,16,9,11,59,45,14,57
Queen of S't,6366,5,11,11,14,46,50,-4,44
Dunfermline,6366,6,9,15,12,46,52,-6,42
Raith,6366,7,9,11,16,34,51,-17,38
Dumbarton,6366,8,8,12,16,50,63,-13,36
Ayr,6366,9,8,11,17,37,59,-22,35
St Mirren,6366,10,8,9,19,39,57,-18,33
Hibernian,6367,1,20,12,4,58,25,33,72
Dundee Utd,6367,2,17,10,9,53,40,13,61
Falkirk,6367,3,17,9,10,60,42,18,60
Morton,6367,4,14,10,12,46,40,6,52
Dunfermline,6367,5,11,13,12,49,50,-1,46
Raith,6367,6,11,9,16,36,50,-14,42
Queen of S't,6367,7,11,8,17,49,56,-7,41
St Mirren,6367,8,10,10,16,43,57,-14,40
Ayr,6367,9,9,11,16,33,52,-19,38
Dumbarton,6367,10,9,10,17,48,63,-15,37
Hibernian,6368,1,20,13,3,54,23,31,73
Falkirk,6368,2,18,9,9,59,41,18,63
Morton,6368,3,15,13,8,49,39,10,58
Dundee Utd,6368,4,15,9,12,49,43,6,54
Queen of S't,6368,5,13,9,14,49,48,1,48
Dunfermline,6368,6,10,13,13,48,47,1,43
Raith,6368,7,9,11,16,35,52,-17,38
Dumbarton,6368,8,8,12,16,44,60,-16,36
Ayr,6368,9,8,12,16,38,58,-20,36
St Mirren,6368,10,8,11,17,38,52,-14,35
Hibernian,6369,1,19,11,6,56,27,29,68
Falkirk,6369,2,18,10,8,59,38,21,64
Morton,6369,3,17,12,7,57,41,16,63
Dundee Utd,6369,4,15,10,11,51,43,8,55
Queen of S't,6369,5,12,9,15,46,47,-1,45
Raith,6369,6,11,11,14,38,50,-12,44
Dunfermline,6369,7,9,13,14,47,54,-7,40
Dumbarton,6369,8,10,10,16,51,60,-9,40
St Mirren,6369,9,8,10,18,37,57,-20,34
Ayr,6369,10,8,10,18,33,58,-25,34
Hibernian,6370,1,21,12,3,60,22,38,75
Morton,6370,2,15,11,10,51,45,6,56
Dundee Utd,6370,3,15,10,11,52,48,4,55
Falkirk,6370,4,14,10,12,56,44,12,52
Dunfermline,6370,5,12,13,11,50,46,4,49
Queen of S't,6370,6,13,9,14,48,50,-2,48
Ayr,6370,7,10,13,13,36,51,-15,43
Raith,6370,8,10,10,16,37,48,-11,40
Dumbarton,6370,9,8,11,17,50,63,-13,35
St Mirren,6370,10,7,11,18,39,62,-23,32
Hibernian,6371,1,19,11,6,61,30,31,68
Falkirk,6371,2,16,12,8,60,41,19,60
Morton,6371,3,16,11,9,51,41,10,59
Dundee Utd,6371,4,16,9,11,52,42,10,57
Dunfermline,6371,5,10,13,13,44,48,-4,43
Raith,6371,6,11,10,15,36,46,-10,43
Queen of S't,6371,7,11,9,16,47,54,-7,42
Ayr,6371,8,9,12,15,35,58,-23,39
Dumbarton,6371,9,9,11,16,48,58,-10,38
St Mirren,6371,10,8,12,16,41,57,-16,36
Hibernian,6372,1,18,11,7,56,30,26,65
Morton,6372,2,16,13,7,51,36,15,61
Falkirk,6372,3,17,9,10,57,40,17,60
Dundee Utd,6372,4,15,12,9,56,44,12,57
Queen of S't,6372,5,13,10,13,47,45,2,49
Dunfermline,6372,6,11,11,14,50,56,-6,44
Dumbarton,6372,7,9,13,14,48,55,-7,40
St Mirren,6372,8,9,11,16,42,56,-14,38
Raith,6372,9,9,10,17,39,56,-17,37
Ayr,6372,10,7,12,17,34,62,-28,33
Morton,6373,1,18,11,7,48,35,13,65
Hibernian,6373,2,17,12,7,56,30,26,63
Falkirk,6373,3,15,12,9,60,43,17,57
Dundee Utd,6373,4,16,8,12,48,40,8,56
Dunfermline,6373,5,12,12,12,52,49,3,48
Dumbarton,6373,6,10,13,13,48,54,-6,43
Queen of S't,6373,7,10,11,15,44,50,-6,41
St Mirren,6373,8,10,9,17,41,57,-16,39
Ayr,6373,9,8,13,15,36,54,-18,37
Raith,6373,10,9,9,18,35,56,-21,36
Hibernian,6374,1,19,14,3,65,26,39,71
Morton,6374,2,18,12,6,60,37,23,66
Falkirk,6374,3,18,9,9,56,42,14,63
Dundee Utd,6374,4,16,10,10,56,41,15,58
Queen of S't,6374,5,12,9,15,43,47,-4,45
Raith,6374,6,11,9,16,37,49,-12,42
Dumbarton,6374,7,8,13,15,45,55,-10,37
St Mirren,6374,8,9,10,17,40,61,-21,37
Dunfermline,6374,9,7,13,16,43,56,-13,34
Ayr,6374,10,6,13,17,30,61,-31,31
Hibernian,6375,1,19,13,4,52,22,30,70
Morton,6375,2,19,12,5,56,30,26,69
Dundee Utd,6375,3,16,10,10,54,42,12,58
Falkirk,6375,4,15,11,10,55,41,14,56
Queen of S't,6375,5,11,9,16,45,49,-4,42
Dunfermline,6375,6,8,14,14,44,53,-9,38
Raith,6375,7,9,11,16,34,49,-15,38
Ayr,6375,8,8,14,14,34,53,-19,38
St Mirren,6375,9,8,12,16,39,55,-16,36
Dumbarton,6375,10,8,12,16,47,66,-19,36
Hibernian,6376,1,21,11,4,69,23,46,74
Morton,6376,2,18,11,7,52,37,15,65
Dundee Utd,6376,3,15,10,11,47,39,8,55
Falkirk,6376,4,14,11,11,52,41,11,53
Raith,6376,5,12,10,14,38,44,-6,46
Dumbarton,6376,6,11,12,13,50,54,-4,45
Dunfermline,6376,7,10,12,14,42,49,-7,42
Queen of S't,6376,8,9,12,15,42,56,-14,39
Ayr,6376,9,7,12,17,33,57,-24,33
St Mirren,6376,10,7,11,18,35,60,-25,32
Hibernian,6377,1,18,13,5,55,26,29,67
Morton,6377,2,17,11,8,53,36,17,62
Dundee Utd,6377,3,17,9,10,51,40,11,60
Falkirk,6377,4,15,11,10,57,43,14,56
Dunfermline,6377,5,10,13,13,47,50,-3,43
Queen of S't,6377,6,11,10,15,41,48,-7,43
Raith,6377,7,10,10,16,36,49,-13,40
Dumbarton,6377,8,8,14,14,51,59,-8,38
St Mirren,6377,9,9,10,17,39,57,-18,37
Ayr,6377,10,8,13,15,33,55,-22,37
Hibernian,6378,1,18,12,6,52,25,27,66
Dundee Utd,6378,2,16,11,9,52,41,11,59
Morton,6378,3,16,10,10,47,39,8,58
Falkirk,6378,4,14,14,8,53,37,16,56
Queen of S't,6378,5,12,11,13,47,48,-1,47
Dunfermline,6378,6,11,13,12,50,46,4,46
Ayr,6378,7,10,12,14,33,49,-16,42
Raith,6378,8,10,9,17,33,49,-16,39
Dumbarton,6378,9,8,12,16,48,63,-15,36
St Mirren,6378,10,7,12,17,34,52,-18,33
Hibernian,6379,1,19,13,4,56,23,33,70
Dundee Utd,6379,2,17,10,9,52,37,15,61
Morton,6379,3,16,13,7,52,38,14,61
Falkirk,6379,4,15,10,11,53,45,8,55
Dunfermline,6379,5,9,14,13,44,47,-3,41
St Mirren,6379,6,10,11,15,48,55,-7,41
Queen of S't,6379,7,10,10,16,43,52,-9,40
Ayr,6379,8,9,12,15,38,57,-19,39
Raith,6379,9,9,11,16,34,51,-17,38
Dumbarton,6379,10,8,12,16,46,61,-15,36
Hibernian,6380,1,20,12,4,62,23,39,72
Morton,6380,2,18,10,8,52,36,16,64
Dundee Utd,6380,3,18,8,10,56,43,13,62
Falkirk,6380,4,16,11,9,63,46,17,59
Queen of S't,6380,5,13,9,14,51,52,-1,48
Dunfermline,6380,6,11,12,13,56,52,4,45
Ayr,6380,7,10,12,14,37,53,-16,42
Raith,6380,8,8,10,18,34,55,-21,34
St Mirren,6380,9,7,10,19,38,63,-25,31
Dumbarton,6380,10,7,10,19,43,69,-26,31
Hibernian,6381,1,19,13,4,55,23,32,70
Morton,6381,2,17,11,8,49,36,13,62
Dundee Utd,6381,3,17,8,11,50,38,12,59
Falkirk,6381,4,14,11,11,51,40,11,53
Queen of S't,6381,5,12,12,12,49,46,3,48
St Mirren,6381,6,11,9,16,44,52,-8,42
Dunfermline,6381,7,9,13,14,46,56,-10,40
Raith,6381,8,9,11,16,37,51,-14,38
Ayr,6381,9,8,13,15,32,55,-23,37
Dumbarton,6381,10,7,13,16,41,57,-16,34
Hibernian,6382,1,19,13,4,53,24,29,70
Falkirk,6382,2,15,14,7,53,35,18,59
Morton,6382,3,16,11,9,47,36,11,59
Dundee Utd,6382,4,15,10,11,49,38,11,55
Dunfermline,6382,5,13,12,11,46,41,5,51
Queen of S't,6382,6,11,10,15,45,52,-7,43
Dumbarton,6382,7,8,14,14,45,55,-10,38
Raith,6382,8,9,10,17,30,47,-17,37
Ayr,6382,9,8,13,15,32,51,-19,37
St Mirren,6382,10,7,11,18,38,59,-21,32
Hibernian,6383,1,20,10,6,55,26,29,70
Morton,6383,2,16,11,9,54,36,18,59
Falkirk,6383,3,15,12,9,57,41,16,57
Dundee Utd,6383,4,13,12,11,49,45,4,51
Dunfermline,6383,5,11,13,12,47,47,0,46
Ayr,6383,6,11,11,14,33,51,-18,44
Queen of S't,6383,7,11,10,15,42,49,-7,43
Raith,6383,8,10,10,16,35,48,-13,40
Dumbarton,6383,9,9,11,16,44,60,-16,38
St Mirren,6383,10,8,12,16,41,54,-13,36
Hibernian,6384,1,19,13,4,57,25,32,70
Falkirk,6384,2,16,10,10,59,41,18,58
Morton,6384,3,15,13,8,51,39,12,58
Dundee Utd,6384,4,16,10,10,52,42,10,58
Queen of S't,6384,5,13,9,14,47,52,-5,48
Dunfermline,6384,6,10,13,13,41,45,-4,43
Raith,6384,7,10,12,14,38,50,-12,42
Dumbarton,6384,8,8,12,16,47,58,-11,36
St Mirren,6384,9,8,12,16,41,56,-15,36
Ayr,6384,10,6,14,16,36,61,-25,32
Hibernian,6385,1,18,14,4,53,27,26,68
Morton,6385,2,17,11,8,51,33,18,62
Falkirk,6385,3,17,10,9,61,38,23,61
Dundee Utd,6385,4,17,10,9,55,38,17,61
Queen of S't,6385,5,12,9,15,49,54,-5,45
Raith,6385,6,10,11,15,38,52,-14,41
Dumbarton,6385,7,10,10,16,50,61,-11,40
St Mirren,6385,8,9,9,18,41,59,-18,36
Ayr,6385,9,8,12,16,35,59,-24,36
Dunfermline,6385,10,7,14,15,45,57,-12,35
Hibernian,6386,1,20,12,4,59,25,34,72
Morton,6386,2,17,12,7,50,35,15,63
Dundee Utd,6386,3,17,11,8,58,41,17,62
Falkirk,6386,4,15,11,10,57,44,13,56
Queen of S't,6386,5,11,11,14,47,53,-6,44
Dumbarton,6386,6,9,13,14,47,56,-9,40
Dunfermline,6386,7,8,15,13,44,50,-6,39
Raith,6386,8,9,12,15,37,52,-15,39
St Mirren,6386,9,8,10,18,38,57,-19,34
Ayr,6386,10,6,13,17,32,56,-24,31
Hibernian,6387,1,18,14,4,55,28,27,68
Morton,6387,2,18,10,8,54,37,17,64
Falkirk,6387,3,17,11,8,60,38,22,62
Dundee Utd,6387,4,13,11,12,49,48,1,50
Dunfermline,6387,5,11,13,12,46,50,-4,46
Queen of S't,6387,6,11,9,16,47,51,-4,42
Raith,6387,7,10,10,16,33,48,-15,40
Dumbarton,6387,8,9,11,16,48,58,-10,38
St Mirren,6387,9,9,10,17,40,57,-17,37
Ayr,6387,10,8,13,15,35,52,-17,37
Hibernian,6388,1,20,12,4,59,23,36,72
Morton,6388,2,17,12,7,52,34,18,63
Falkirk,6388,3,16,11,9,58,41,17,59
Dundee Utd,6388,4,15,10,11,47,44,3,55
Raith,6388,5,12,9,15,36,47,-11,45
Dunfermline,6388,6,9,14,13,45,47,-2,41
Queen of S't,6388,7,10,10,16,39,51,-12,40
Ayr,6388,8,9,12,15,38,51,-13,39
St Mirren,6388,9,8,11,17,39,57,-18,35
Dumbarton,6388,10,7,13,16,42,60,-18,34
Hibernian,6389,1,20,11,5,59,24,35,71
Falkirk,6389,2,19,10,7,62,35,27,67
Morton,6389,3,14,13,9,46,38,8,55
Dundee Utd,6389,4,14,12,10,55,43,12,54
Dunfermline,6389,5,10,15,11,46,47,-1,45
Raith,6389,6,11,9,16,36,52,-16,42
Queen of S't,6389,7,10,10,16,41,49,-8,40
Dumbarton,6389,8,10,10,16,48,60,-12,40
Ayr,6389,9,8,12,16,36,57,-21,36
St Mirren,6389,10,8,10,18,35,59,-24,34
Hibernian,6390,1,17,14,5,54,28,26,65
Falkirk,6390,2,15,13,8,56,39,17,58
Morton,6390,3,14,15,7,49,38,11,57
Dundee Utd,6390,4,14,12,10,50,43,7,54
Dunfermline,6390,5,13,12,11,53,47,6,51
Queen of S't,6390,6,10,10,16,43,53,-10,40
Raith,6390,7,9,13,14,34,45,-11,40
Ayr,6390,8,8,14,14,36,58,-22,38
St Mirren,6390,9,8,13,15,45,54,-9,37
Dumbarton,6390,10,8,12,16,46,61,-15,36
Hibernian,6391,1,19,12,5,55,26,29,69
Morton,6391,2,18,9,9,52,35,17,63
Falkirk,6391,3,17,11,8,58,37,21,62
Dundee Utd,6391,4,16,10,10,52,40,12,58
Queen of S't,6391,5,11,9,16,47,57,-10,42
Dunfermline,6391,6,9,13,14,45,52,-7,40
Ayr,6391,7,9,13,14,32,49,-17,40
Dumbarton,6391,8,8,13,15,46,60,-14,37
Raith,6391,9,9,10,17,38,53,-15,37
St Mirren,6391,10,8,12,16,39,55,-16,36
Hibernian,6392,1,19,12,5,59,31,28,69
Morton,6392,2,19,11,6,55,36,19,68
Dundee Utd,6392,3,16,9,11,50,46,4,57
Falkirk,6392,4,14,12,10,53,43,10,54
Queen of S't,6392,5,12,9,15,47,51,-4,45
Dunfermline,6392,6,10,13,13,46,48,-2,43
Dumbarton,6392,7,10,12,14,55,59,-4,42
Raith,6392,8,9,12,15,37,48,-11,39
Ayr,6392,9,8,11,17,37,58,-21,35
St Mirren,6392,10,7,11,18,42,61,-19,32
Hibernian,6393,1,19,11,6,56,26,30,68
Morton,6393,2,18,11,7,54,37,17,65
Falkirk,6393,3,17,11,8,57,37,20,62
Dundee Utd,6393,4,14,10,12,46,41,5,52
Dumbarton,6393,5,12,11,13,52,57,-5,47
Queen of S't,6393,6,12,9,15,47,50,-3,45
Dunfermline,6393,7,10,13,13,52,55,-3,43
Raith,6393,8,11,9,16,34,47,-13,42
Ayr,6393,9,7,12,17,32,57,-25,33
St Mirren,6393,10,7,9,20,35,58,-23,30
Hibernian,6394,1,18,14,4,53,24,29,68
Dundee Utd,6394,2,19,8,9,57,38,19,65
Morton,6394,3,17,12,7,50,36,14,63
Falkirk,6394,4,16,11,9,59,42,17,59
Dunfermline,6394,5,10,13,13,48,48,0,43
Queen of S't,6394,6,11,10,15,47,55,-8,43
Raith,6394,7,10,10,16,38,47,-9,40
St Mirren,6394,8,9,9,18,40,61,-21,36
Dumbarton,6394,9,8,11,17,49,62,-13,35
Ayr,6394,10,7,12,17,31,59,-28,33
Hibernian,6395,1,18,12,6,55,31,24,66
Falkirk,6395,2,18,10,8,61,41,20,64
Dundee Utd,6395,3,18,8,10,55,39,16,62
Morton,6395,4,16,9,11,49,43,6,57
Dunfermline,6395,5,11,12,13,49,49,0,45
Queen of S't,6395,6,11,10,15,45,50,-5,43
Dumbarton,6395,7,10,11,15,52,62,-10,41
St Mirren,6395,8,10,10,16,46,54,-8,40
Raith,6395,9,10,10,16,36,53,-17,40
Ayr,6395,10,6,12,18,31,57,-26,30
Hibernian,6396,1,19,13,4,56,24,32,70
Morton,6396,2,17,11,8,53,41,12,62
Dundee Utd,6396,3,16,10,10,59,43,16,58
Falkirk,6396,4,15,12,9,59,43,16,57
Dunfermline,6396,5,12,11,13,49,51,-2,47
Raith,6396,6,12,9,15,44,49,-5,45
Queen of S't,6396,7,10,12,14,45,55,-10,42
Dumbarton,6396,8,9,12,15,50,60,-10,39
St Mirren,6396,9,8,10,18,40,57,-17,34
Ayr,6396,10,6,12,18,36,68,-32,30
Falkirk,6397,1,16,12,8,59,40,19,60
Hibernian,6397,2,16,12,8,48,29,19,60
Morton,6397,3,16,10,10,48,36,12,58
Dundee Utd,6397,4,16,10,10,48,37,11,58
Dunfermline,6397,5,10,14,12,47,48,-1,44
Raith,6397,6,11,11,14,38,47,-9,44
Ayr,6397,7,10,13,13,36,50,-14,43
Queen of S't,6397,8,10,11,15,38,48,-10,41
Dumbarton,6397,9,9,11,16,49,62,-13,38
St Mirren,6397,10,9,10,17,42,56,-14,37
Hibernian,6398,1,22,11,3,65,26,39,77
Falkirk,6398,2,17,10,9,59,39,20,61
Morton,6398,3,17,10,9,49,37,12,61
Dundee Utd,6398,4,14,9,13,52,46,6,51
Queen of S't,6398,5,12,9,15,46,54,-8,45
Dumbarton,6398,6,11,11,14,49,52,-3,44
Raith,6398,7,11,9,16,36,49,-13,42
Dunfermline,6398,8,9,12,15,45,52,-7,39
Ayr,6398,9,9,10,17,34,58,-24,37
St Mirren,6398,10,8,9,19,39,61,-22,33
Hibernian,6399,1,20,12,4,56,25,31,72
Morton,6399,2,17,11,8,49,34,15,62
Dundee Utd,6399,3,17,10,9,52,37,15,61
Falkirk,6399,4,16,12,8,62,41,21,60
Raith,6399,5,11,10,15,44,54,-10,43
Queen of S't,6399,6,10,12,14,46,53,-7,42
St Mirren,6399,7,10,10,16,52,55,-3,40
Dunfermline,6399,8,8,13,15,42,51,-9,37
Dumbarton,6399,9,7,12,17,44,63,-19,33
Ayr,6399,10,7,12,17,31,65,-34,33
Hibernian,6400,1,20,12,4,54,24,30,72
Falkirk,6400,2,15,14,7,59,39,20,59
Morton,6400,3,16,10,10,50,39,11,58
Dundee Utd,6400,4,14,11,11,47,40,7,53
Dunfermline,6400,5,11,13,12,48,47,1,46
Queen of S't,6400,6,11,10,15,45,52,-7,43
Dumbarton,6400,7,10,11,15,48,60,-12,41
Raith,6400,8,10,10,16,35,50,-15,40
Ayr,6400,9,9,12,15,37,54,-17,39
St Mirren,6400,10,7,11,18,37,55,-18,32
Hibernian,6401,1,19,12,5,56,26,30,69
Morton,6401,2,17,12,7,53,33,20,63
Falkirk,6401,3,16,12,8,64,41,23,60
Dundee Utd,6401,4,13,13,10,47,42,5,52
Queen of S't,6401,5,14,9,13,44,44,0,51
Dunfermline,6401,6,9,14,13,46,51,-5,41
Raith,6401,7,10,10,16,34,48,-14,40
Ayr,6401,8,9,12,15,32,53,-21,39
St Mirren,6401,9,8,11,17,39,57,-18,35
Dumbarton,6401,10,7,11,18,46,66,-20,32
Hibernian,6402,1,20,10,6,58,26,32,70
Morton,6402,2,17,11,8,55,38,17,62
Falkirk,6402,3,16,10,10,58,44,14,58
Dundee Utd,6402,4,16,9,11,45,37,8,57
Queen of S't,6402,5,13,8,15,46,51,-5,47
Raith,6402,6,12,10,14,43,49,-6,46
Dunfermline,6402,7,10,13,13,45,50,-5,43
Dumbarton,6402,8,8,13,15,45,56,-11,37
Ayr,6402,9,7,13,16,33,55,-22,34
St Mirren,6402,10,7,11,18,40,62,-22,32
Hibernian,6403,1,17,13,6,55,30,25,64
Morton,6403,2,16,12,8,50,38,12,60
Dundee Utd,6403,3,15,11,10,50,39,11,56
Falkirk,6403,4,14,13,9,54,39,15,55
Queen of S't,6403,5,14,10,12,49,44,5,52
Raith,6403,6,12,10,14,40,49,-9,46
Dunfermline,6403,7,10,14,12,45,47,-2,44
Dumbarton,6403,8,9,14,13,48,58,-10,41
St Mirren,6403,9,6,13,17,40,60,-20,31
Ayr,6403,10,6,12,18,31,58,-27,30
Hibernian,6404,1,20,11,5,58,26,32,71
Morton,6404,2,17,11,8,51,36,15,62
Dundee Utd,6404,3,18,8,10,51,37,14,62
Falkirk,6404,4,15,10,11,54,42,12,55
Dunfermline,6404,5,12,13,11,44,41,3,49
Raith,6404,6,11,9,16,35,49,-14,42
Dumbarton,6404,7,10,10,16,47,55,-8,40
Queen of S't,6404,8,10,8,18,43,58,-15,38
St Mirren,6404,9,9,9,18,39,58,-19,36
Ayr,6404,10,8,11,17,33,53,-20,35
Hibernian,6405,1,21,11,4,63,27,36,74
Falkirk,6405,2,18,9,9,62,40,22,63
Morton,6405,3,17,11,8,51,36,15,62
Dundee Utd,6405,4,13,11,12,53,49,4,50
Ayr,6405,5,11,13,12,37,45,-8,46
Dunfermline,6405,6,9,13,14,49,57,-8,40
Queen of S't,6405,7,10,10,16,45,57,-12,40
Dumbarton,6405,8,9,12,15,48,60,-12,39
Raith,6405,9,9,10,17,37,54,-17,37
St Mirren,6405,10,8,10,18,38,58,-20,34
Hibernian,6406,1,19,11,6,57,32,25,68
Morton,6406,2,18,10,8,58,39,19,64
Falkirk,6406,3,16,9,11,63,49,14,57
Dundee Utd,6406,4,14,12,10,49,45,4,54
Queen of S't,6406,5,12,10,14,48,51,-3,46
Dunfermline,6406,6,11,12,13,50,53,-3,45
Dumbarton,6406,7,10,11,15,50,59,-9,41
Raith,6406,8,10,9,17,36,48,-12,39
Ayr,6406,9,9,11,16,34,52,-18,38
St Mirren,6406,10,8,11,17,42,59,-17,35
Falkirk,6407,1,19,10,7,63,39,24,67
Hibernian,6407,2,18,12,6,55,27,28,66
Morton,6407,3,17,13,6,48,32,16,64
Dundee Utd,6407,4,14,12,10,50,41,9,54
Raith,6407,5,11,9,16,37,48,-11,42
Dunfermline,6407,6,8,17,11,47,49,-2,41
Queen of S't,6407,7,10,11,15,46,55,-9,41
St Mirren,6407,8,9,10,17,38,56,-18,37
Dumbarton,6407,9,7,15,14,49,59,-10,36
Ayr,6407,10,6,13,17,32,59,-27,31
Hibernian,6408,1,20,11,5,58,25,33,71
Morton,6408,2,20,10,6,52,31,21,70
Falkirk,6408,3,18,9,9,62,43,19,63
Dundee Utd,6408,4,15,9,12,46,42,4,54
Dunfermline,6408,5,11,13,12,46,44,2,46
Queen of S't,6408,6,10,10,16,44,49,-5,40
St Mirren,6408,7,9,11,16,41,55,-14,38
Raith,6408,8,9,11,16,33,48,-15,38
Ayr,6408,9,8,11,17,35,60,-25,35
Dumbarton,6408,10,7,11,18,43,63,-20,32
Hibernian,6409,1,19,13,4,56,27,29,70
Morton,6409,2,17,12,7,52,35,17,63
Dundee Utd,6409,3,17,10,9,50,39,11,61
Falkirk,6409,4,15,11,10,54,40,14,56
Queen of S't,6409,5,12,8,16,49,51,-2,44
Dunfermline,6409,6,10,12,14,46,48,-2,42
St Mirren,6409,7,9,11,16,41,55,-14,38
Raith,6409,8,8,13,15,31,45,-14,37
Ayr,6409,9,8,13,15,36,56,-20,37
Dumbarton,6409,10,8,11,17,46,65,-19,35
Hibernian,6410,1,21,11,4,56,24,32,74
Falkirk,6410,2,17,10,9,59,37,22,61
Morton,6410,3,15,12,9,45,39,6,57
Dundee Utd,6410,4,15,10,11,49,40,9,55
Queen of S't,6410,5,14,8,14,48,44,4,50
St Mirren,6410,6,10,11,15,44,53,-9,41
Ayr,6410,7,9,11,16,37,56,-19,38
Dumbarton,6410,8,8,13,15,43,58,-15,37
Raith,6410,9,9,10,17,34,52,-18,37
Dunfermline,6410,10,8,12,16,40,52,-12,36
Hibernian,6411,1,20,13,3,59,26,33,73
Dundee Utd,6411,2,17,9,10,55,41,14,60
Morton,6411,3,16,12,8,50,37,13,60
Falkirk,6411,4,14,12,10,57,42,15,54
Queen of S't,6411,5,12,9,15,45,51,-6,45
Dunfermline,6411,6,10,14,12,46,51,-5,44
Dumbarton,6411,7,9,13,14,47,56,-9,40
Ayr,6411,8,9,12,15,36,50,-14,39
Raith,6411,9,8,11,17,30,46,-16,35
St Mirren,6411,10,7,11,18,36,61,-25,32
Hibernian,6412,1,19,11,6,57,30,27,68
Dundee Utd,6412,2,18,9,9,52,36,16,63
Morton,6412,3,16,11,9,54,43,11,59
Falkirk,6412,4,14,12,10,56,43,13,54
Dunfermline,6412,5,11,14,11,54,46,8,47
Queen of S't,6412,6,11,11,14,46,52,-6,44
Raith,6412,7,12,8,16,37,51,-14,44
St Mirren,6412,8,11,9,16,47,53,-6,42
Dumbarton,6412,9,8,12,16,49,64,-15,36
Ayr,6412,10,6,11,19,30,64,-34,29
Hibernian,6413,1,19,12,5,55,24,31,69
Morton,6413,2,19,11,6,51,31,20,68
Dundee Utd,6413,3,16,10,10,48,38,10,58
Falkirk,6413,4,15,11,10,58,45,13,56
Dunfermline,6413,5,12,11,13,49,45,4,47
Raith,6413,6,11,9,16,35,50,-15,42
Queen of S't,6413,7,10,11,15,42,52,-10,41
St Mirren,6413,8,9,10,17,45,55,-10,37
Dumbarton,6413,9,8,11,17,44,62,-18,35
Ayr,6413,10,7,12,17,29,54,-25,33
Hibernian,6414,1,19,14,3,55,24,31,71
Morton,6414,2,17,13,6,49,31,18,64
Dundee Utd,6414,3,16,11,9,51,36,15,59
Falkirk,6414,4,14,12,10,54,41,13,54
Dumbarton,6414,5,10,12,14,47,55,-8,42
Raith,6414,6,10,11,15,34,45,-11,41
Ayr,6414,7,9,12,15,32,55,-23,39
Dunfermline,6414,8,8,14,14,42,50,-8,38
Queen of S't,6414,9,9,11,16,41,51,-10,38
St Mirren,6414,10,8,10,18,38,55,-17,34
Hibernian,6415,1,20,12,4,60,24,36,72
Morton,6415,2,18,10,8,51,39,12,64
Falkirk,6415,3,17,10,9,57,38,19,61
Dundee Utd,6415,4,15,9,12,48,41,7,54
Dumbarton,6415,5,11,10,15,50,54,-4,43
Queen of S't,6415,6,11,8,17,42,52,-10,41
Dunfermline,6415,7,9,13,14,45,50,-5,40
St Mirren,6415,8,10,9,17,37,52,-15,39
Raith,6415,9,10,9,17,35,51,-16,39
Ayr,6415,10,9,10,17,35,59,-24,37
Hibernian,6416,1,20,12,4,63,25,38,72
Dundee Utd,6416,2,18,9,9,55,39,16,63
Falkirk,6416,3,16,12,8,57,38,19,60
Morton,6416,4,16,11,9,50,40,10,59
Queen of S't,6416,5,13,10,13,50,52,-2,49
Raith,6416,6,11,10,15,35,46,-11,43
Dunfermline,6416,7,9,11,16,44,53,-9,38
Dumbarton,6416,8,8,13,15,47,58,-11,37
St Mirren,6416,9,8,10,18,41,61,-20,34
Ayr,6416,10,6,12,18,29,59,-30,30
Hibernian,6417,1,18,13,5,55,28,27,67
Dundee Utd,6417,2,18,9,9,53,39,14,63
Morton,6417,3,16,12,8,48,34,14,60
Falkirk,6417,4,16,11,9,57,41,16,59
Queen of S't,6417,5,12,10,14,47,49,-2,46
Dunfermline,6417,6,10,12,14,43,48,-5,42
Dumbarton,6417,7,9,13,14,49,57,-8,40
Raith,6417,8,9,11,16,32,49,-17,38
St Mirren,6417,9,8,10,18,36,53,-17,34
Ayr,6417,10,7,13,16,35,57,-22,34
Hibernian,6418,1,20,10,6,57,28,29,70
Morton,6418,2,18,9,9,52,36,16,63
Dundee Utd,6418,3,16,10,10,57,40,17,58
Falkirk,6418,4,15,11,10,63,44,19,56
Queen of S't,6418,5,12,9,15,46,51,-5,45
Dunfermline,6418,6,11,11,14,49,59,-10,44
Dumbarton,6418,7,11,10,15,52,62,-10,43
Ayr,6418,8,10,11,15,38,54,-16,41
Raith,6418,9,10,9,17,37,54,-17,39
St Mirren,6418,10,7,10,19,39,62,-23,31
Hibernian,6419,1,20,11,5,56,26,30,71
Morton,6419,2,16,13,7,47,34,13,61
Dundee Utd,6419,3,17,9,10,56,39,17,60
Falkirk,6419,4,15,11,10,57,40,17,56
Queen of S't,6419,5,12,10,14,44,48,-4,46
Dunfermline,6419,6,10,14,12,42,46,-4,44
Dumbarton,6419,7,9,13,14,48,58,-10,40
Raith,6419,8,9,9,18,31,48,-17,36
St Mirren,6419,9,8,11,17,40,57,-17,35
Ayr,6419,10,6,15,15,28,53,-25,33
Hibernian,6420,1,19,13,4,55,24,31,70
Morton,6420,2,19,10,7,59,32,27,67
Dundee Utd,6420,3,19,9,8,55,36,19,66
Falkirk,6420,4,14,12,10,56,43,13,54
Raith,6420,5,13,9,14,40,49,-9,48
Dumbarton,6420,6,10,12,14,54,56,-2,42
Queen of S't,6420,7,10,11,15,42,54,-12,41
Dunfermline,6420,8,8,14,14,43,50,-7,38
St Mirren,6420,9,7,9,20,36,63,-27,30
Ayr,6420,10,6,11,19,30,63,-33,29
Morton,6421,1,19,11,6,49,33,16,68
Hibernian,6421,2,16,13,7,51,28,23,61
Falkirk,6421,3,16,11,9,60,40,20,59
Queen of S't,6421,4,14,9,13,52,46,6,51
Dundee Utd,6421,5,13,10,13,46,46,0,49
Raith,6421,6,12,9,15,37,47,-10,45
Dunfermline,6421,7,9,15,12,44,46,-2,42
St Mirren,6421,8,9,11,16,40,53,-13,38
Ayr,6421,9,8,13,15,32,53,-21,37
Dumbarton,6421,10,7,12,17,43,62,-19,33
Hibernian,6422,1,17,15,4,56,26,30,66
Morton,6422,2,17,12,7,53,37,16,63
Falkirk,6422,3,17,11,8,62,37,25,62
Dundee Utd,6422,4,16,10,10,51,44,7,58
Dunfermline,6422,5,10,13,13,49,51,-2,43
St Mirren,6422,6,10,11,15,46,56,-10,41
Queen of S't,6422,7,9,12,15,42,53,-11,39
Dumbarton,6422,8,9,11,16,51,61,-10,38
Raith,6422,9,8,12,16,34,51,-17,36
Ayr,6422,10,7,13,16,33,61,-28,34
Hibernian,6423,1,20,12,4,57,26,31,72
Morton,6423,2,18,10,8,55,39,16,64
Falkirk,6423,3,16,10,10,61,46,15,58
Dundee Utd,6423,4,15,10,11,56,47,9,55
Dumbarton,6423,5,13,10,13,54,57,-3,49
Queen of S't,6423,6,11,10,15,45,51,-6,43
Dunfermline,6423,7,9,13,14,45,50,-5,40
Raith,6423,8,10,8,18,36,54,-18,38
Ayr,6423,9,8,12,16,33,56,-23,36
St Mirren,6423,10,7,11,18,43,59,-16,32
Hibernian,6424,1,17,13,6,51,28,23,64
Morton,6424,2,17,11,8,53,38,15,62
Dundee Utd,6424,3,16,12,8,50,37,13,60
Falkirk,6424,4,16,11,9,55,37,18,59
Dunfermline,6424,5,10,14,12,49,48,1,44
Raith,6424,6,10,12,14,38,48,-10,42
Dumbarton,6424,7,10,10,16,46,56,-10,40
St Mirren,6424,8,10,9,17,40,56,-16,39
Queen of S't,6424,9,9,11,16,44,54,-10,38
Ayr,6424,10,7,13,16,35,59,-24,34
Hibernian,6425,1,18,12,6,55,27,28,66
Dundee Utd,6425,2,18,10,8,54,37,17,64
Morton,6425,3,17,10,9,50,35,15,61
Falkirk,6425,4,15,12,9,57,43,14,57
Queen of S't,6425,5,12,8,16,48,53,-5,44
Raith,6425,6,10,11,15,37,50,-13,41
Dumbarton,6425,7,10,10,16,52,58,-6,40
Dunfermline,6425,8,9,13,14,41,49,-8,40
St Mirren,6425,9,10,10,16,45,55,-10,40
Ayr,6425,10,7,12,17,32,64,-32,33
Hibernian,6426,1,22,11,3,62,23,39,77
Falkirk,6426,2,17,9,10,57,39,18,60
Morton,6426,3,16,11,9,49,37,12,59
Dundee Utd,6426,4,16,11,9,49,38,11,59
Queen of S't,6426,5,11,9,16,45,53,-8,42
St Mirren,6426,6,10,10,16,43,53,-10,40
Ayr,6426,7,10,10,16,36,56,-20,40
Raith,6426,8,10,9,17,34,53,-19,39
Dunfermline,6426,9,8,13,15,43,50,-7,37
Dumbarton,6426,10,8,11,17,45,61,-16,35
Hibernian,6427,1,18,13,5,54,29,25,67
Falkirk,6427,2,16,12,8,60,46,14,60
Dundee Utd,6427,3,17,8,11,56,40,16,59
Morton,6427,4,16,11,9,50,38,12,59
Queen of S't,6427,5,13,8,15,44,51,-7,47
Dumbarton,6427,6,11,11,14,53,56,-3,44
Dunfermline,6427,7,10,12,14,43,49,-6,42
Ayr,6427,8,10,11,15,41,54,-13,41
Raith,6427,9,10,10,16,35,49,-14,40
St Mirren,6427,10,6,10,20,34,58,-24,28
Hibernian,6428,1,18,11,7,58,28,30,65
Dundee Utd,6428,2,18,9,9,50,37,13,63
Morton,6428,3,16,11,9,50,39,11,59
Falkirk,6428,4,16,10,10,58,41,17,58
Raith,6428,5,12,10,14,39,46,-7,46
Queen of S't,6428,6,12,8,16,44,56,-12,44
Dumbarton,6428,7,10,12,14,50,54,-4,42
St Mirren,6428,8,10,11,15,44,53,-9,41
Dunfermline,6428,9,8,13,15,43,54,-11,37
Ayr,6428,10,7,11,18,31,59,-28,32
Hibernian,6429,1,16,14,6,55,32,23,62
Dundee Utd,6429,2,17,9,10,57,42,15,60
Morton,6429,3,15,12,9,46,43,3,57
Falkirk,6429,4,14,13,9,57,43,14,55
Queen of S't,6429,5,14,8,14,47,48,-1,50
Dunfermline,6429,6,11,13,12,53,50,3,46
Dumbarton,6429,7,10,12,14,53,57,-4,42
Raith,6429,8,10,10,16,40,53,-13,40
Ayr,6429,9,8,12,16,38,60,-22,36
St Mirren,6429,10,8,11,17,37,55,-18,35
Hibernian,6430,1,17,12,7,55,34,21,63
Morton,6430,2,17,12,7,51,40,11,63
Dundee Utd,6430,3,16,10,10,57,45,12,58
Falkirk,6430,4,15,11,10,54,41,13,56
Dunfermline,6430,5,11,14,11,48,46,2,47
Queen of S't,6430,6,12,9,15,47,54,-7,45
Dumbarton,6430,7,9,13,14,52,61,-9,40
Raith,6430,8,9,12,15,37,49,-12,39
St Mirren,6430,9,8,12,16,46,58,-12,36
Ayr,6430,10,8,11,17,35,54,-19,35
Hibernian,6431,1,17,16,3,58,28,30,67
Morton,6431,2,17,12,7,52,41,11,63
Falkirk,6431,3,16,13,7,59,37,22,61
Dundee Utd,6431,4,15,11,10,47,39,8,56
Queen of S't,6431,5,11,11,14,45,48,-3,44
Ayr,6431,6,9,14,13,37,52,-15,41
Dumbarton,6431,7,9,12,15,45,57,-12,39
Dunfermline,6431,8,8,14,14,48,53,-5,38
Raith,6431,9,9,9,18,32,50,-18,36
St Mirren,6431,10,8,10,18,36,54,-18,34
Hibernian,6432,1,21,12,3,55,20,35,75
Morton,6432,2,18,9,9,48,35,13,63
Falkirk,6432,3,17,10,9,64,40,24,61
Dundee Utd,6432,4,14,10,12,50,45,5,52
Dunfermline,6432,5,11,13,12,47,46,1,46
Raith,6432,6,11,10,15,38,46,-8,43
Dumbarton,6432,7,10,11,15,46,53,-7,41
Queen of S't,6432,8,10,10,16,40,52,-12,40
Ayr,6432,9,7,12,17,33,60,-27,33
St Mirren,6432,10,7,11,18,34,58,-24,32
Hibernian,6433,1,20,11,5,55,28,27,71
Morton,6433,2,18,12,6,56,37,19,66
Dundee Utd,6433,3,17,10,9,55,36,19,61
Falkirk,6433,4,15,11,10,53,40,13,56
Queen of S't,6433,5,10,12,14,44,49,-5,42
Dumbarton,6433,6,9,12,15,48,60,-12,39
Raith,6433,7,9,10,17,32,48,-16,37
St Mirren,6433,8,9,10,17,40,57,-17,37
Ayr,6433,9,8,13,15,33,50,-17,37
Dunfermline,6433,10,7,15,14,40,51,-11,36
Hibernian,6434,1,21,12,3,63,24,39,75
Falkirk,6434,2,16,10,10,61,45,16,58
Morton,6434,3,15,13,8,48,42,6,58
Dundee Utd,6434,4,16,8,12,52,43,9,56
Dunfermline,6434,5,11,13,12,49,44,5,46
Queen of S't,6434,6,12,10,14,47,50,-3,46
Ayr,6434,7,9,12,15,39,58,-19,39
Dumbarton,6434,8,9,11,16,49,61,-12,38
St Mirren,6434,9,9,9,18,40,60,-20,36
Raith,6434,10,9,8,19,34,55,-21,35
Hibernian,6435,1,20,12,4,52,21,31,72
Falkirk,6435,2,19,9,8,62,37,25,66
Morton,6435,3,18,12,6,53,33,20,66
Dundee Utd,6435,4,19,8,9,59,36,23,65
Queen of S't,6435,5,11,10,15,44,51,-7,43
Raith,6435,6,9,12,15,35,50,-15,39
Dunfermline,6435,7,8,12,16,44,57,-13,36
Dumbarton,6435,8,7,12,17,42,58,-16,33
St Mirren,6435,9,7,11,18,37,57,-20,32
Ayr,6435,10,6,14,16,28,56,-28,32
Hibernian,6436,1,19,12,5,52,24,28,69
Morton,6436,2,18,12,6,53,36,17,66
Falkirk,6436,3,17,10,9,61,41,20,61
Dundee Utd,6436,4,16,12,8,52,36,16,60
Queen of S't,6436,5,11,11,14,42,50,-8,44
Dumbarton,6436,6,10,12,14,48,55,-7,42
Raith,6436,7,10,8,18,35,54,-19,38
Dunfermline,6436,8,8,13,15,42,47,-5,37
St Mirren,6436,9,9,9,18,43,60,-17,36
Ayr,6436,10,6,13,17,32,57,-25,31
Hibernian,6437,1,22,10,4,65,24,41,76
Falkirk,6437,2,15,13,8,58,43,15,58
Morton,6437,3,16,10,10,50,39,11,58
Dundee Utd,6437,4,15,10,11,51,42,9,55
Queen of S't,6437,5,12,8,16,44,53,-9,44
Ayr,6437,6,10,12,14,37,52,-15,42
St Mirren,6437,7,10,10,16,41,55,-14,40
Dunfermline,6437,8,8,14,14,43,51,-8,38
Dumbarton,6437,9,9,11,16,46,60,-14,38
Raith,6437,10,9,10,17,33,49,-16,37
Morton,6438,1,18,12,6,53,37,16,66
Dundee Utd,6438,2,19,8,9,52,38,14,65
Hibernian,6438,3,17,13,6,58,32,26,64
Falkirk,6438,4,16,12,8,57,37,20,60
Raith,6438,5,11,10,15,36,48,-12,43
Queen of S't,6438,6,11,9,16,46,54,-8,42
Dunfermline,6438,7,8,15,13,46,52,-6,39
St Mirren,6438,8,8,11,17,42,56,-14,35
Dumbarton,6438,9,8,11,17,44,59,-15,35
Ayr,6438,10,8,11,17,31,52,-21,35
Hibernian,6439,1,18,14,4,56,27,29,68
Morton,6439,2,17,12,7,57,39,18,63
Falkirk,6439,3,17,11,8,60,40,20,62
Dundee Utd,6439,4,17,9,10,54,45,9,60
Queen of S't,6439,5,11,10,15,51,53,-2,43
Dunfermline,6439,6,9,14,13,47,49,-2,41
Ayr,6439,7,10,11,15,41,57,-16,41
St Mirren,6439,8,9,9,18,38,58,-20,36
Raith,6439,9,9,9,18,35,56,-21,36
Dumbarton,6439,10,8,11,17,47,62,-15,35
Hibernian,6440,1,20,12,4,52,22,30,72
Dundee Utd,6440,2,18,9,9,54,37,17,63
Falkirk,6440,3,16,11,9,55,36,19,59
Morton,6440,4,15,12,9,48,35,13,57
Queen of S't,6440,5,12,8,16,48,52,-4,44
Raith,6440,6,11,10,15,34,46,-12,43
Dunfermline,6440,7,9,14,13,45,53,-8,41
Ayr,6440,8,9,11,16,32,52,-20,38
Dumbarton,6440,9,8,12,16,46,63,-17,36
St Mirren,6440,10,7,11,18,38,56,-18,32
Hibernian,6441,1,20,11,5,53,22,31,71
Falkirk,6441,2,17,10,9,63,43,20,61
Morton,6441,3,15,14,7,49,36,13,59
Dundee Utd,6441,4,15,11,10,59,44,15,56
Dunfermline,6441,5,11,13,12,47,50,-3,46
Queen of S't,6441,6,11,9,16,46,54,-8,42
Raith,6441,7,9,12,15,33,46,-13,39
Dumbarton,6441,8,9,10,17,49,65,-16,37
St Mirren,6441,9,8,12,16,43,57,-14,36
Ayr,6441,10,7,14,15,33,58,-25,35
Hibernian,6442,1,18,13,5,54,25,29,67
Morton,6442,2,17,11,8,49,34,15,62
Falkirk,6442,3,14,11,11,56,46,10,53
Queen of S't,6442,4,15,8,13,47,46,1,53
Dundee Utd,6442,5,14,9,13,48,43,5,51
Dunfermline,6442,6,11,11,14,50,55,-5,44
Raith,6442,7,11,10,15,36,45,-9,43
Dumbarton,6442,8,10,11,15,51,59,-8,41
Ayr,6442,9,9,12,15,33,52,-19,39
St Mirren,6442,10,8,10,18,36,55,-19,34
Hibernian,6443,1,20,11,5,59,27,32,71
Dundee Utd,6443,2,19,9,8,53,36,17,66
Falkirk,6443,3,16,11,9,59,43,16,59
Morton,6443,4,14,12,10,42,36,6,54
Queen of S't,6443,5,11,11,14,45,50,-5,44
Raith,6443,6,11,9,16,37,48,-11,42
Dunfermline,6443,7,9,13,14,45,50,-5,40
Ayr,6443,8,10,10,16,36,54,-18,40
Dumbarton,6443,9,8,12,16,47,59,-12,36
St Mirren,6443,10,8,10,18,36,56,-20,34
Hibernian,6444,1,19,11,6,57,28,29,68
Morton,6444,2,18,11,7,52,34,18,65
Falkirk,6444,3,17,11,8,57,37,20,62
Dundee Utd,6444,4,16,9,11,53,43,10,57
Queen of S't,6444,5,12,10,14,42,46,-4,46
Dunfermline,6444,6,11,11,14,48,51,-3,44
Ayr,6444,7,10,11,15,41,56,-15,41
St Mirren,6444,8,9,11,16,46,59,-13,38
Dumbarton,6444,9,8,11,17,43,60,-17,35
Raith,6444,10,8,8,20,31,56,-25,32
Hibernian,6445,1,18,12,6,56,29,27,66
Dundee Utd,6445,2,19,8,9,51,38,13,65
Falkirk,6445,3,17,10,9,65,45,20,61
Morton,6445,4,17,10,9,50,38,12,61
Queen of S't,6445,5,11,10,15,45,52,-7,43
Raith,6445,6,10,11,15,36,49,-13,41
Dunfermline,6445,7,9,13,14,46,49,-3,40
St Mirren,6445,8,10,10,16,44,55,-11,40
Ayr,6445,9,8,12,16,36,58,-22,36
Dumbarton,6445,10,8,10,18,46,62,-16,34
Hibernian,6446,1,19,13,4,57,29,28,70
Dundee Utd,6446,2,19,8,9,56,37,19,65
Morton,6446,3,16,11,9,52,39,13,59
Falkirk,6446,4,14,12,10,57,45,12,54
Queen of S't,6446,5,12,9,15,45,51,-6,45
Raith,6446,6,12,8,16,38,48,-10,44
Dumbarton,6446,7,9,14,13,51,58,-7,41
Dunfermline,6446,8,8,14,14,42,49,-7,38
St Mirren,6446,9,8,11,17,44,61,-17,35
Ayr,6446,10,8,10,18,35,60,-25,34
Hibernian,6447,1,22,10,4,56,23,33,76
Morton,6447,2,17,12,7,49,34,15,63
Falkirk,6447,3,16,12,8,59,39,20,60
Dundee Utd,6447,4,14,12,10,45,39,6,54
Ayr,6447,5,11,11,14,37,52,-15,44
Dunfermline,6447,6,10,11,15,49,53,-4,41
Queen of S't,6447,7,10,10,16,43,53,-10,40
Raith,6447,8,9,11,16,36,52,-16,38
St Mirren,6447,9,8,11,17,40,56,-16,35
Dumbarton,6447,10,8,10,18,49,62,-13,34
Hibernian,6448,1,17,13,6,49,25,24,64
Morton,6448,2,17,13,6,48,33,15,64
Falkirk,6448,3,16,11,9,58,41,17,59
Dundee Utd,6448,4,15,10,11,48,40,8,55
Queen of S't,6448,5,13,9,14,49,51,-2,48
Ayr,6448,6,10,12,14,39,54,-15,42
Dunfermline,6448,7,9,14,13,42,47,-5,41
Dumbarton,6448,8,9,12,15,50,59,-9,39
Raith,6448,9,9,9,18,34,51,-17,36
St Mirren,6448,10,8,11,17,38,54,-16,35
Hibernian,6449,1,18,14,4,54,23,31,68
Falkirk,6449,2,17,10,9,59,40,19,61
Morton,6449,3,17,9,10,47,35,12,60
Dundee Utd,6449,4,16,9,11,48,43,5,57
Dunfermline,6449,5,10,14,12,48,49,-1,44
Dumbarton,6449,6,10,12,14,55,57,-2,42
Raith,6449,7,10,11,15,34,45,-11,41
Queen of S't,6449,8,10,10,16,44,56,-12,40
St Mirren,6449,9,9,10,17,39,56,-17,37
Ayr,6449,10,7,13,16,33,57,-24,34
Hibernian,6450,1,21,12,3,57,22,35,75
Morton,6450,2,18,10,8,49,32,17,64
Dundee Utd,6450,3,17,10,9,52,35,17,61
Falkirk,6450,4,16,9,11,56,45,11,57
Queen of S't,6450,5,12,8,16,41,56,-15,44
Dunfermline,6450,6,10,13,13,45,48,-3,43
Dumbarton,6450,7,9,12,15,50,56,-6,39
Raith,6450,8,10,8,18,32,47,-15,38
Ayr,6450,9,9,11,16,35,54,-19,38
St Mirren,6450,10,6,11,19,35,57,-22,29
Hibernian,6451,1,18,14,4,54,22,32,68
Morton,6451,2,17,12,7,49,34,15,63
Falkirk,6451,3,16,11,9,55,36,19,59
Dundee Utd,6451,4,14,9,13,46,43,3,51
Dunfermline,6451,5,11,14,11,48,46,2,47
Queen of S't,6451,6,12,11,13,48,48,0,47
Raith,6451,7,9,12,15,32,47,-15,39
St Mirren,6451,8,9,10,17,42,54,-12,37
Dumbarton,6451,9,8,11,17,42,64,-22,35
Ayr,6451,10,7,14,15,29,51,-22,35
Morton,6452,1,19,11,6,55,34,21,68
Hibernian,6452,2,19,10,7,54,27,27,67
Falkirk,6452,3,17,11,8,59,38,21,62
Dundee Utd,6452,4,13,10,13,44,43,1,49
Queen of S't,6452,5,13,10,13,47,49,-2,49
St Mirren,6452,6,9,13,14,40,52,-12,40
Dunfermline,6452,7,9,12,15,45,50,-5,39
Dumbarton,6452,8,8,13,15,48,62,-14,37
Ayr,6452,9,7,15,14,31,48,-17,36
Raith,6452,10,8,11,17,32,52,-20,35
Hibernian,6453,1,20,12,4,59,23,36,72
Dundee Utd,6453,2,18,8,10,51,37,14,62
Morton,6453,3,15,12,9,45,41,4,57
Falkirk,6453,4,14,11,11,52,40,12,53
Queen of S't,6453,5,11,12,13,44,48,-4,45
Dunfermline,6453,6,10,14,12,43,45,-2,44
Raith,6453,7,10,13,13,36,46,-10,43
Dumbarton,6453,8,8,14,14,48,57,-9,38
St Mirren,6453,9,7,12,17,38,56,-18,33
Ayr,6453,10,6,14,16,29,52,-23,32
Morton,6454,1,22,9,5,53,28,25,75
Hibernian,6454,2,20,11,5,55,25,30,71
Dundee Utd,6454,3,18,8,10,59,39,20,62
Falkirk,6454,4,15,9,12,57,45,12,54
Queen of S't,6454,5,12,8,16,42,51,-9,44
Dunfermline,6454,6,10,12,14,45,50,-5,42
Raith,6454,7,10,9,17,35,50,-15,39
Dumbarton,6454,8,9,10,17,46,62,-16,37
St Mirren,6454,9,8,11,17,42,58,-16,35
Ayr,6454,10,7,11,18,34,60,-26,32
Hibernian,6455,1,20,10,6,61,31,30,70
Falkirk,6455,2,18,10,8,62,40,22,64
Morton,6455,3,17,13,6,50,35,15,64
Dundee Utd,6455,4,17,9,10,53,42,11,60
Dunfermline,6455,5,10,13,13,48,46,2,43
Queen of S't,6455,6,11,9,16,44,53,-9,42
Dumbarton,6455,7,10,11,15,47,56,-9,41
Ayr,6455,8,8,14,14,35,53,-18,38
Raith,6455,9,8,9,19,34,62,-28,33
St Mirren,6455,10,7,10,19,46,62,-16,31
Hibernian,6456,1,18,13,5,51,23,28,67
Dundee Utd,6456,2,18,8,10,53,37,16,62
Morton,6456,3,16,12,8,53,38,15,60
Falkirk,6456,4,14,13,9,53,41,12,55
Queen of S't,6456,5,13,9,14,46,46,0,48
Dunfermline,6456,6,11,12,13,43,46,-3,45
Raith,6456,7,11,10,15,32,43,-11,43
Dumbarton,6456,8,9,10,17,46,61,-15,37
St Mirren,6456,9,8,11,17,41,60,-19,35
Ayr,6456,10,7,12,17,29,52,-23,33
Hibernian,6457,1,20,10,6,56,27,29,70
Morton,6457,2,18,10,8,49,34,15,64
Falkirk,6457,3,16,10,10,62,41,21,58
Dundee Utd,6457,4,14,11,11,47,44,3,53
Queen of S't,6457,5,12,9,15,44,51,-7,45
Dunfermline,6457,6,11,11,14,49,51,-2,44
Raith,6457,7,11,9,16,37,47,-10,42
St Mirren,6457,8,10,10,16,44,56,-12,40
Dumbarton,6457,9,9,13,14,47,60,-13,40
Ayr,6457,10,7,11,18,33,57,-24,32
Hibernian,6458,1,19,13,4,61,27,34,70
Morton,6458,2,17,11,8,51,39,12,62
Dundee Utd,6458,3,14,11,11,53,45,8,53
Falkirk,6458,4,14,11,11,55,49,6,53
Queen of S't,6458,5,13,10,13,49,50,-1,49
Dumbarton,6458,6,10,12,14,52,56,-4,42
St Mirren,6458,7,11,9,16,43,52,-9,42
Dunfermline,6458,8,9,13,14,48,56,-8,40
Raith,6458,9,10,10,16,37,51,-14,40
Ayr,6458,10,7,12,17,35,59,-24,33
Hibernian,6459,1,18,14,4,54,26,28,68
Morton,6459,2,18,11,7,53,35,18,65
Falkirk,6459,3,16,11,9,58,41,17,59
Dundee Utd,6459,4,15,10,11,46,42,4,55
Queen of S't,6459,5,11,11,14,45,50,-5,44
Raith,6459,6,12,8,16,36,46,-10,44
Dumbarton,6459,7,10,13,13,52,55,-3,43
Dunfermline,6459,8,8,14,14,39,45,-6,38
St Mirren,6459,9,8,11,17,41,55,-14,35
Ayr,6459,10,7,11,18,30,59,-29,32
Hibernian,6460,1,19,13,4,54,24,30,70
Morton,6460,2,18,11,7,55,35,20,65
Dundee Utd,6460,3,16,9,11,52,42,10,57
Falkirk,6460,4,15,10,11,55,41,14,55
Queen of S't,6460,5,12,10,14,49,53,-4,46
Dunfermline,6460,6,10,11,15,44,51,-7,41
Dumbarton,6460,7,9,12,15,50,60,-10,39
St Mirren,6460,8,9,11,16,40,55,-15,38
Ayr,6460,9,8,13,15,38,57,-19,37
Raith,6460,10,9,10,17,36,55,-19,37
Hibernian,6461,1,21,11,4,60,26,34,74
Falkirk,6461,2,19,9,8,66,39,27,66
Morton,6461,3,17,11,8,56,36,20,62
Dundee Utd,6461,4,17,10,9,55,42,13,61
Dunfermline,6461,5,11,13,12,49,52,-3,46
Raith,6461,6,10,9,17,35,51,-16,39
Dumbarton,6461,7,9,11,16,51,62,-11,38
St Mirren,6461,8,9,10,17,44,58,-14,37
Queen of S't,6461,9,9,9,18,42,62,-20,36
Ayr,6461,10,6,11,19,34,64,-30,29
Hibernian,6462,1,20,11,5,54,22,32,71
Morton,6462,2,19,10,7,50,32,18,67
Dundee Utd,6462,3,17,10,9,52,36,16,61
Falkirk,6462,4,17,9,10,55,39,16,60
Queen of S't,6462,5,12,9,15,43,50,-7,45
Raith,6462,6,10,11,15,32,45,-13,41
Dumbarton,6462,7,10,10,16,47,59,-12,40
Dunfermline,6462,8,9,11,16,45,51,-6,38
St Mirren,6462,9,9,11,16,41,53,-12,38
Ayr,6462,10,6,10,20,28,60,-32,28
Hibernian,6463,1,20,10,6,53,26,27,70
Morton,6463,2,17,11,8,53,36,17,62
Falkirk,6463,3,16,11,9,57,38,19,59
Dundee Utd,6463,4,15,10,11,47,40,7,55
Dunfermline,6463,5,11,13,12,48,50,-2,46
Queen of S't,6463,6,12,8,16,44,51,-7,44
Ayr,6463,7,10,11,15,37,52,-15,41
St Mirren,6463,8,9,12,15,39,53,-14,39
Dumbarton,6463,9,8,12,16,48,58,-10,36
Raith,6463,10,8,10,18,30,52,-22,34
Hibernian,6464,1,19,13,4,54,24,30,70
Morton,6464,2,18,11,7,53,35,18,65
Falkirk,6464,3,16,12,8,59,43,16,60
Dundee Utd,6464,4,15,12,9,54,39,15,57
Queen of S't,6464,5,11,10,15,45,52,-7,43
Dunfermline,6464,6,9,14,13,45,51,-6,41
St Mirren,6464,7,9,12,15,38,51,-13,39
Dumbarton,6464,8,9,11,16,50,64,-14,38
Raith,6464,9,9,9,18,37,52,-15,36
Ayr,6464,10,8,10,18,32,56,-24,34
Hibernian,6465,1,19,11,6,50,25,25,68
Dundee Utd,6465,2,18,9,9,52,38,14,63
Morton,6465,3,17,11,8,52,37,15,62
Queen of S't,6465,4,15,8,13,47,44,3,53
Falkirk,6465,5,14,10,12,54,45,9,52
Dunfermline,6465,6,11,12,13,50,47,3,45
Raith,6465,7,11,9,16,35,49,-14,42
St Mirren,6465,8,8,12,16,39,54,-15,36
Dumbarton,6465,9,8,11,17,48,62,-14,35
Ayr,6465,10,7,11,18,34,60,-26,32
Hibernian,6466,1,19,13,4,59,30,29,70
Morton,6466,2,17,10,9,48,36,12,61
Dundee Utd,6466,3,16,11,9,49,37,12,59
Falkirk,6466,4,13,10,13,57,50,7,49
Queen of S't,6466,5,13,10,13,49,47,2,49
Dunfermline,6466,6,11,13,12,49,51,-2,46
St Mirren,6466,7,10,10,16,43,53,-10,40
Dumbarton,6466,8,9,12,15,48,59,-11,39
Raith,6466,9,9,10,17,32,49,-17,37
Ayr,6466,10,8,11,17,31,53,-22,35
Hibernian,6467,1,22,10,4,58,25,33,76
Falkirk,6467,2,17,11,8,60,38,22,62
Dundee Utd,6467,3,17,10,9,51,36,15,61
Morton,6467,4,15,11,10,47,40,7,56
Raith,6467,5,11,10,15,38,51,-13,43
Dunfermline,6467,6,9,15,12,45,47,-2,42
Queen of S't,6467,7,11,9,16,41,49,-8,42
Dumbarton,6467,8,9,11,16,45,56,-11,38
St Mirren,6467,9,8,11,17,37,54,-17,35
Ayr,6467,10,7,10,19,30,56,-26,31
Hibernian,6468,1,18,12,6,53,27,26,66
Morton,6468,2,17,12,7,50,35,15,63
Falkirk,6468,3,17,11,8,57,37,20,62
Dundee Utd,6468,4,13,11,12,47,43,4,50
Queen of S't,6468,5,12,8,16,44,48,-4,44
Raith,6468,6,11,9,16,35,47,-12,42
Ayr,6468,7,10,11,15,35,55,-20,41
Dunfermline,6468,8,9,13,14,42,52,-10,40
Dumbarton,6468,9,9,12,15,48,55,-7,39
St Mirren,6468,10,9,11,16,43,55,-12,38
Hibernian,6469,1,19,12,5,55,26,29,69
Dundee Utd,6469,2,18,9,9,55,39,16,63
Morton,6469,3,17,10,9,50,40,10,61
Falkirk,6469,4,16,10,10,61,42,19,58
Dunfermline,6469,5,11,12,13,47,46,1,45
Raith,6469,6,11,10,15,36,49,-13,43
Dumbarton,6469,7,10,11,15,51,59,-8,41
Queen of S't,6469,8,10,11,15,43,54,-11,41
Ayr,6469,9,7,12,17,33,57,-24,33
St Mirren,6469,10,7,11,18,38,57,-19,32
Hibernian,6470,1,21,12,3,63,22,41,75
Dundee Utd,6470,2,16,10,10,50,36,14,58
Morton,6470,3,15,12,9,46,38,8,57
Falkirk,6470,4,15,11,10,54,39,15,56
Dunfermline,6470,5,10,15,11,42,43,-1,45
Queen of S't,6470,6,10,11,15,42,48,-6,41
Dumbarton,6470,7,9,12,15,47,58,-11,39
Raith,6470,8,10,9,17,33,49,-16,39
St Mirren,6470,9,9,11,16,37,55,-18,38
Ayr,6470,10,8,11,17,31,57,-26,35
Hibernian,6471,1,21,12,3,62,24,38,75
Morton,6471,2,16,12,8,50,40,10,60
Falkirk,6471,3,16,11,9,62,41,21,59
Dundee Utd,6471,4,16,10,10,47,37,10,58
Queen of S't,6471,5,10,13,13,47,52,-5,43
Dumbarton,6471,6,11,10,15,52,62,-10,43
Raith,6471,7,9,11,16,37,53,-16,38
Dunfermline,6471,8,8,13,15,44,54,-10,37
Ayr,6471,9,8,13,15,33,51,-18,37
St Mirren,6471,10,8,9,19,37,57,-20,33
Hibernian,6472,1,21,11,4,56,21,35,74
Falkirk,6472,2,18,10,8,60,38,22,64
Morton,6472,3,15,13,8,49,38,11,58
Dundee Utd,6472,4,14,12,10,49,39,10,54
Queen of S't,6472,5,12,10,14,48,49,-1,46
Dunfermline,6472,6,9,13,14,48,54,-6,40
Dumbarton,6472,7,9,12,15,47,59,-12,39
Raith,6472,8,9,12,15,32,45,-13,39
Ayr,6472,9,8,11,17,31,56,-25,35
St Mirren,6472,10,8,10,18,39,60,-21,34
Hibernian,6473,1,22,10,4,63,25,38,76
Falkirk,6473,2,16,11,9,63,42,21,59
Dundee Utd,6473,3,16,11,9,53,40,13,59
Morton,6473,4,16,11,9,48,38,10,59
Queen of S't,6473,5,13,9,14,49,51,-2,48
Raith,6473,6,10,11,15,36,48,-12,41
Dunfermline,6473,7,9,13,14,44,51,-7,40
Dumbarton,6473,8,8,12,16,47,61,-14,36
St Mirren,6473,9,8,10,18,41,64,-23,34
Ayr,6473,10,7,12,17,32,56,-24,33
Hibernian,6474,1,19,11,6,56,27,29,68
Dundee Utd,6474,2,16,10,10,53,45,8,58
Falkirk,6474,3,15,10,11,56,44,12,55
Morton,6474,4,14,13,9,46,37,9,55
Dunfermline,6474,5,11,13,12,51,47,4,46
Queen of S't,6474,6,12,10,14,53,54,-1,46
Ayr,6474,7,8,16,12,39,51,-12,40
St Mirren,6474,8,9,11,16,37,50,-13,38
Raith,6474,9,9,11,16,31,49,-18,38
Dumbarton,6474,10,8,13,15,45,63,-18,37
Hibernian,6475,1,19,13,4,58,23,35,70
Dundee Utd,6475,2,18,8,10,54,40,14,62
Morton,6475,3,17,11,8,49,40,9,62
Falkirk,6475,4,17,10,9,62,41,21,61
Dunfermline,6475,5,11,12,13,53,52,1,45
Raith,6475,6,11,8,17,34,48,-14,41
Dumbarton,6475,7,9,12,15,49,58,-9,39
Queen of S't,6475,8,10,9,17,40,54,-14,39
St Mirren,6475,9,8,12,16,39,55,-16,36
Ayr,6475,10,7,11,18,30,57,-27,32
Hibernian,6476,1,19,11,6,51,25,26,68
Morton,6476,2,19,10,7,51,31,20,67
Falkirk,6476,3,16,11,9,58,41,17,59
Dundee Utd,6476,4,16,9,11,50,41,9,57
Queen of S't,6476,5,15,8,13,52,46,6,53
Dunfermline,6476,6,9,14,13,44,49,-5,41
Raith,6476,7,10,9,17,35,49,-14,39
Dumbarton,6476,8,7,14,15,45,60,-15,35
Ayr,6476,9,8,11,17,34,57,-23,35
St Mirren,6476,10,6,13,17,39,60,-21,31
Hibernian,6477,1,19,13,4,55,26,29,70
Morton,6477,2,19,9,8,54,35,19,66
Falkirk,6477,3,16,11,9,61,38,23,59
Dundee Utd,6477,4,16,11,9,56,39,17,59
Queen of S't,6477,5,12,10,14,48,53,-5,46
Dunfermline,6477,6,9,13,14,48,53,-5,40
Ayr,6477,7,9,12,15,33,59,-26,39
St Mirren,6477,8,9,10,17,37,52,-15,37
Raith,6477,9,9,10,17,34,50,-16,37
Dumbarton,6477,10,7,11,18,42,63,-21,32
Hibernian,6478,1,20,13,3,56,21,35,73
Morton,6478,2,17,11,8,52,35,17,62
Dundee Utd,6478,3,17,9,10,51,40,11,60
Falkirk,6478,4,15,12,9,61,44,17,57
Queen of S't,6478,5,12,10,14,50,52,-2,46
Dunfermline,6478,6,9,14,13,44,51,-7,41
Raith,6478,7,9,12,15,30,44,-14,39
Dumbarton,6478,8,8,12,16,46,59,-13,36
St Mirren,6478,9,8,10,18,40,60,-20,34
Ayr,6478,10,6,15,15,34,58,-24,33
Hibernian,6479,1,19,12,5,60,27,33,69
Morton,6479,2,18,12,6,51,33,18,66
Dundee Utd,6479,3,17,11,8,58,41,17,62
Falkirk,6479,4,15,10,11,58,47,11,55
Queen of S't,6479,5,11,10,15,45,53,-8,43
Dunfermline,6479,6,9,14,13,47,53,-6,41
Dumbarton,6479,7,10,10,16,55,60,-5,40
Raith,6479,8,9,11,16,31,48,-17,38
St Mirren,6479,9,9,9,18,38,58,-20,36
Ayr,6479,10,8,11,17,31,54,-23,35
Hibernian,6480,1,23,10,3,63,26,37,79
Falkirk,6480,2,17,10,9,58,42,16,61
Morton,6480,3,17,10,9,47,34,13,61
Dundee Utd,6480,4,14,10,12,46,41,5,52
Queen of S't,6480,5,13,8,15,48,53,-5,47
Ayr,6480,6,11,11,14,40,50,-10,44
Dunfermline,6480,7,10,12,14,45,49,-4,42
Dumbarton,6480,8,8,11,17,48,61,-13,35
Raith,6480,9,9,8,19,33,53,-20,35
St Mirren,6480,10,7,12,17,37,56,-19,33
Hibernian,6481,1,18,13,5,51,26,25,67
Morton,6481,2,16,13,7,50,37,13,61
Dundee Utd,6481,3,17,8,11,55,43,12,59
Falkirk,6481,4,15,9,12,58,46,12,54
Queen of S't,6481,5,13,9,14,47,49,-2,48
Dunfermline,6481,6,11,12,13,56,52,4,45
Dumbarton,6481,7,10,13,13,50,56,-6,43
Raith,6481,8,10,9,17,34,53,-19,39
Ayr,6481,9,8,12,16,35,55,-20,36
St Mirren,6481,10,8,10,18,40,59,-19,34
Hibernian,6482,1,20,12,4,58,26,32,72
Falkirk,6482,2,16,11,9,58,40,18,59
Morton,6482,3,15,14,7,51,38,13,59
Dundee Utd,6482,4,15,12,9,51,40,11,57
Raith,6482,5,12,8,16,38,47,-9,44
Queen of S't,6482,6,11,9,16,45,56,-11,42
Dunfermline,6482,7,8,15,13,47,52,-5,39
Ayr,6482,8,9,11,16,34,57,-23,38
St Mirren,6482,9,8,12,16,45,57,-12,36
Dumbarton,6482,10,8,12,16,47,61,-14,36
Hibernian,6483,1,19,13,4,58,27,31,70
Dundee Utd,6483,2,17,10,9,49,35,14,61
Falkirk,6483,3,15,12,9,57,39,18,57
Morton,6483,4,14,14,8,48,41,7,56
Dunfermline,6483,5,10,14,12,45,45,0,44
Dumbarton,6483,6,8,15,13,48,56,-8,39
Queen of S't,6483,7,10,9,17,42,54,-12,39
Raith,6483,8,10,9,17,34,51,-17,39
St Mirren,6483,9,9,11,16,42,56,-14,38
Ayr,6483,10,8,13,15,36,55,-19,37
Hibernian,6484,1,21,11,4,53,21,32,74
Morton,6484,2,17,10,9,48,39,9,61
Dundee Utd,6484,3,16,10,10,49,39,10,58
Falkirk,6484,4,13,12,11,55,45,10,51
Dunfermline,6484,5,12,11,13,50,51,-1,47
Queen of S't,6484,6,11,10,15,46,49,-3,43
Dumbarton,6484,7,10,12,14,53,60,-7,42
Raith,6484,8,11,9,16,35,47,-12,42
Ayr,6484,9,8,12,16,35,55,-20,36
St Mirren,6484,10,7,11,18,39,57,-18,32
Hibernian,6485,1,18,13,5,57,27,30,67
Falkirk,6485,2,17,11,8,58,41,17,62
Dundee Utd,6485,3,17,8,11,56,43,13,59
Morton,6485,4,15,13,8,48,41,7,58
Queen of S't,6485,5,12,11,13,53,49,4,47
Raith,6485,6,10,11,15,36,48,-12,41
Dunfermline,6485,7,8,16,12,44,48,-4,40
Ayr,6485,8,8,14,14,35,53,-18,38
Dumbarton,6485,9,8,11,17,45,64,-19,35
St Mirren,6485,10,7,12,17,38,56,-18,33
Hibernian,6486,1,18,12,6,55,30,25,66
Dundee Utd,6486,2,16,11,9,53,40,13,59
Falkirk,6486,3,16,10,10,57,39,18,58
Morton,6486,4,14,10,12,48,48,0,52
Dunfermline,6486,5,12,13,11,53,47,6,49
Queen of S't,6486,6,12,9,15,44,52,-8,45
Raith,6486,7,12,8,16,38,47,-9,44
Dumbarton,6486,8,10,11,15,49,57,-8,41
Ayr,6486,9,9,11,16,35,58,-23,38
St Mirren,6486,10,8,11,17,38,52,-14,35
Hibernian,6487,1,21,12,3,59,23,36,75
Morton,6487,2,17,13,6,54,37,17,64
Falkirk,6487,3,15,11,10,56,41,15,56
Dundee Utd,6487,4,14,10,12,47,42,5,52
Ayr,6487,5,10,13,13,40,56,-16,43
Queen of S't,6487,6,11,8,17,42,53,-11,41
St Mirren,6487,7,10,10,16,44,56,-12,40
Dunfermline,6487,8,8,15,13,46,49,-3,39
Raith,6487,9,9,10,17,35,52,-17,37
Dumbarton,6487,10,8,12,16,42,56,-14,36
Hibernian,6488,1,19,13,4,55,24,31,70
Dundee Utd,6488,2,17,10,9,51,35,16,61
Morton,6488,3,15,12,9,43,35,8,57
Falkirk,6488,4,15,11,10,56,41,15,56
Dunfermline,6488,5,9,15,12,46,46,0,42
Queen of S't,6488,6,10,12,14,44,51,-7,42
Dumbarton,6488,7,10,10,16,48,62,-14,40
Ayr,6488,8,9,13,14,33,50,-17,40
St Mirren,6488,9,8,12,16,42,57,-15,36
Raith,6488,10,8,12,16,31,48,-17,36
Hibernian,6489,1,20,12,4,54,25,29,72
Morton,6489,2,17,10,9,50,38,12,61
Dundee Utd,6489,3,16,10,10,51,42,9,58
Falkirk,6489,4,15,12,9,60,42,18,57
Dumbarton,6489,5,11,10,15,48,56,-8,43
Dunfermline,6489,6,9,14,13,49,52,-3,41
Ayr,6489,7,10,11,15,35,50,-15,41
Queen of S't,6489,8,10,9,17,42,53,-11,39
St Mirren,6489,9,9,10,17,39,55,-16,37
Raith,6489,10,8,12,16,33,48,-15,36
Hibernian,6490,1,20,11,5,58,24,34,71
Dundee Utd,6490,2,15,13,8,49,38,11,58
Morton,6490,3,15,11,10,47,41,6,56
Falkirk,6490,4,13,10,13,51,44,7,49
Dunfermline,6490,5,11,13,12,54,49,5,46
Queen of S't,6490,6,11,10,15,42,53,-11,43
St Mirren,6490,7,10,12,14,43,51,-8,42
Ayr,6490,8,9,13,14,34,49,-15,40
Raith,6490,9,10,10,16,35,52,-17,40
Dumbarton,6490,10,9,11,16,46,58,-12,38
Hibernian,6491,1,19,12,5,54,26,28,69
Morton,6491,2,16,12,8,50,40,10,60
Dundee Utd,6491,3,14,12,10,51,43,8,54
Falkirk,6491,4,14,11,11,54,41,13,53
Dunfermline,6491,5,11,12,13,52,49,3,45
Queen of S't,6491,6,11,12,13,43,48,-5,45
Raith,6491,7,11,10,15,33,44,-11,43
Dumbarton,6491,8,9,12,15,48,57,-9,39
Ayr,6491,9,9,12,15,37,56,-19,39
St Mirren,6491,10,7,13,16,42,60,-18,34
Hibernian,6492,1,19,10,7,59,30,29,67
Falkirk,6492,2,19,9,8,62,39,23,66
Morton,6492,3,18,10,8,52,37,15,64
Dundee Utd,6492,4,16,11,9,53,43,10,59
Dunfermline,6492,5,10,15,11,48,47,1,45
Ayr,6492,6,11,11,14,39,52,-13,44
Queen of S't,6492,7,10,9,17,46,56,-10,39
Dumbarton,6492,8,9,11,16,49,64,-15,38
Raith,6492,9,9,9,18,34,49,-15,36
St Mirren,6492,10,7,9,20,38,63,-25,30
Hibernian,6493,1,19,12,5,56,28,28,69
Morton,6493,2,18,10,8,51,37,14,64
Falkirk,6493,3,16,12,8,60,39,21,60
Dundee Utd,6493,4,17,9,10,49,39,10,60
Queen of S't,6493,5,13,8,15,49,53,-4,47
Dunfermline,6493,6,9,13,14,45,53,-8,40
Dumbarton,6493,7,9,12,15,50,62,-12,39
Raith,6493,8,10,8,18,35,48,-13,38
St Mirren,6493,9,8,11,17,38,54,-16,35
Ayr,6493,10,8,11,17,34,54,-20,35
Morton,6494,1,20,11,5,50,30,20,71
Hibernian,6494,2,19,12,5,52,25,27,69
Falkirk,6494,3,16,10,10,56,40,16,58
Dundee Utd,6494,4,16,10,10,50,40,10,58
Queen of S't,6494,5,14,10,12,48,44,4,52
Dunfermline,6494,6,10,14,12,46,43,3,44
St Mirren,6494,7,8,10,18,42,59,-17,34
Raith,6494,8,8,10,18,34,58,-24,34
Dumbarton,6494,9,7,12,17,45,64,-19,33
Ayr,6494,10,7,11,18,40,60,-20,32
Morton,6495,1,18,11,7,52,33,19,65
Hibernian,6495,2,17,13,6,53,28,25,64
Dundee Utd,6495,3,16,11,9,51,38,13,59
Falkirk,6495,4,15,11,10,56,43,13,56
Dunfermline,6495,5,10,14,12,48,50,-2,44
Ayr,6495,6,9,14,13,37,51,-14,41
Dumbarton,6495,7,9,13,14,45,55,-10,40
Raith,6495,8,10,9,17,31,51,-20,39
Queen of S't,6495,9,9,11,16,40,50,-10,38
St Mirren,6495,10,9,9,18,41,55,-14,36
Hibernian,6496,1,20,10,6,54,27,27,70
Morton,6496,2,18,10,8,53,39,14,64
Dundee Utd,6496,3,17,9,10,47,36,11,60
Falkirk,6496,4,16,10,10,57,42,15,58
Dunfermline,6496,5,12,12,12,49,47,2,48
Queen of S't,6496,6,12,9,15,44,47,-3,45
Ayr,6496,7,8,13,15,37,54,-17,37
Raith,6496,8,9,10,17,34,51,-17,37
Dumbarton,6496,9,7,13,16,44,58,-14,34
St Mirren,6496,10,8,10,18,41,59,-18,34
Morton,6497,1,19,11,6,53,33,20,68
Hibernian,6497,2,18,12,6,52,26,26,66
Falkirk,6497,3,16,10,10,58,42,16,58
Dundee Utd,6497,4,15,10,11,48,42,6,55
Dunfermline,6497,5,13,12,11,47,45,2,51
Queen of S't,6497,6,11,11,14,42,47,-5,44
Dumbarton,6497,7,9,12,15,50,59,-9,39
St Mirren,6497,8,9,9,18,41,57,-16,36
Raith,6497,9,9,9,18,32,51,-19,36
Ayr,6497,10,8,10,18,37,58,-21,34
Hibernian,6498,1,19,11,6,57,29,28,68
Dundee Utd,6498,2,17,10,9,57,38,19,61
Morton,6498,3,17,10,9,50,38,12,61
Falkirk,6498,4,15,11,10,57,43,14,56
Raith,6498,5,11,11,14,38,45,-7,44
Dumbarton,6498,6,10,12,14,50,60,-10,42
Dunfermline,6498,7,9,14,13,46,48,-2,41
Queen of S't,6498,8,10,11,15,41,50,-9,41
Ayr,6498,9,8,12,16,35,60,-25,36
St Mirren,6498,10,8,10,18,41,61,-20,34
Morton,6499,1,20,10,6,53,34,19,70
Hibernian,6499,2,17,14,5,53,26,27,65
Dundee Utd,6499,3,15,10,11,50,38,12,55
Falkirk,6499,4,15,9,12,55,48,7,54
Dunfermline,6499,5,10,14,12,47,46,1,44
Queen of S't,6499,6,11,10,15,43,52,-9,43
Dumbarton,6499,7,10,12,14,47,53,-6,42
Ayr,6499,8,9,12,15,36,54,-18,39
Raith,6499,9,9,10,17,35,51,-16,37
St Mirren,6499,10,8,11,17,37,54,-17,35
Hibernian,6500,1,20,11,5,55,26,29,71
Dundee Utd,6500,2,17,9,10,55,40,15,60
Morton,6500,3,16,11,9,48,36,12,59
Falkirk,6500,4,14,11,11,50,40,10,53
Queen of S't,6500,5,14,9,13,55,52,3,51
Dunfermline,6500,6,12,11,13,50,52,-2,47
Dumbarton,6500,7,9,12,15,49,61,-12,39
St Mirren,6500,8,9,10,17,40,57,-17,37
Ayr,6500,9,9,10,17,36,55,-19,37
Raith,6500,10,8,10,18,33,52,-19,34
Hibernian,6501,1,19,12,5,51,23,28,69
Morton,6501,2,19,9,8,56,32,24,66
Falkirk,6501,3,15,10,11,55,43,12,55
Dundee Utd,6501,4,15,8,13,46,45,1,53
Queen of S't,6501,5,14,10,12,53,47,6,52
Raith,6501,6,11,10,15,38,47,-9,43
Dumbarton,6501,7,10,11,15,48,61,-13,41
Dunfermline,6501,8,9,12,15,40,46,-6,39
St Mirren,6501,9,9,9,18,37,57,-20,36
Ayr,6501,10,8,11,17,32,55,-23,35
Morton,6502,1,19,10,7,51,33,18,67
Hibernian,6502,2,16,13,7,52,29,23,61
Falkirk,6502,3,15,13,8,58,39,19,58
Dundee Utd,6502,4,16,10,10,50,39,11,58
Dunfermline,6502,5,12,12,12,50,46,4,48
Queen of S't,6502,6,13,9,14,48,48,0,48
Raith,6502,7,10,10,16,38,51,-13,40
St Mirren,6502,8,9,10,17,37,55,-18,37
Ayr,6502,9,8,11,17,31,57,-26,35
Dumbarton,6502,10,8,10,18,45,63,-18,34
Hibernian,6503,1,18,12,6,56,29,27,66
Morton,6503,2,17,12,7,47,35,12,63
Falkirk,6503,3,17,11,8,65,40,25,62
Dundee Utd,6503,4,16,10,10,54,41,13,58
Dunfermline,6503,5,11,12,13,49,52,-3,45
Queen of S't,6503,6,11,10,15,43,55,-12,43
Ayr,6503,7,9,13,14,40,51,-11,40
Raith,6503,8,8,12,16,34,50,-16,36
St Mirren,6503,9,8,11,17,36,57,-21,35
Dumbarton,6503,10,7,13,16,45,59,-14,34
Hibernian,6504,1,19,14,3,59,24,35,71
Falkirk,6504,2,17,10,9,65,46,19,61
Morton,6504,3,16,12,8,51,39,12,60
Dundee Utd,6504,4,16,10,10,53,37,16,58
Dunfermline,6504,5,11,13,12,53,52,1,46
Queen of S't,6504,6,11,9,16,42,54,-12,42
Raith,6504,7,10,8,18,35,51,-16,38
St Mirren,6504,8,9,10,17,36,53,-17,37
Dumbarton,6504,9,8,12,16,51,65,-14,36
Ayr,6504,10,8,12,16,33,57,-24,36
Hibernian,6505,1,21,10,5,61,30,31,73
Morton,6505,2,19,10,7,55,35,20,67
Dundee Utd,6505,3,18,9,9,54,42,12,63
Falkirk,6505,4,15,9,12,59,45,14,54
Queen of S't,6505,5,13,8,15,45,51,-6,47
Dunfermline,6505,6,10,13,13,44,45,-1,43
Dumbarton,6505,7,10,12,14,47,55,-8,42
Ayr,6505,8,8,12,16,34,55,-21,36
Raith,6505,9,9,8,19,33,51,-18,35
St Mirren,6505,10,7,9,20,39,62,-23,30
Hibernian,6506,1,21,12,3,56,22,34,75
Morton,6506,2,18,12,6,51,35,16,66
Falkirk,6506,3,16,12,8,59,39,20,60
Dundee Utd,6506,4,16,9,11,52,39,13,57
Queen of S't,6506,5,11,10,15,46,51,-5,43
Dunfermline,6506,6,9,12,15,42,49,-7,39
Dumbarton,6506,7,9,12,15,47,61,-14,39
St Mirren,6506,8,9,10,17,43,56,-13,37
Raith,6506,9,9,9,18,34,51,-17,36
Ayr,6506,10,7,12,17,30,57,-27,33
Hibernian,6507,1,19,11,6,53,28,25,68
Morton,6507,2,17,10,9,54,42,12,61
Dundee Utd,6507,3,16,10,10,51,38,13,58
Falkirk,6507,4,15,10,11,55,41,14,55
Dumbarton,6507,5,12,12,12,56,56,0,48
Dunfermline,6507,6,10,13,13,48,48,0,43
Raith,6507,7,11,9,16,39,54,-15,42
Queen of S't,6507,8,10,9,17,45,57,-12,39
St Mirren,6507,9,9,11,16,39,54,-15,38
Ayr,6507,10,8,11,17,36,58,-22,35
Hibernian,6508,1,20,12,4,61,27,34,72
Morton,6508,2,16,14,6,47,34,13,62
Falkirk,6508,3,16,11,9,61,41,20,59
Dundee Utd,6508,4,16,10,10,51,40,11,58
Queen of S't,6508,5,12,9,15,46,52,-6,45
St Mirren,6508,6,9,12,15,44,54,-10,39
Dumbarton,6508,7,9,11,16,48,60,-12,38
Ayr,6508,8,8,14,14,32,52,-20,38
Raith,6508,9,8,12,16,33,51,-18,36
Dunfermline,6508,10,7,13,16,38,50,-12,34
Hibernian,6509,1,19,10,7,55,29,26,67
Dundee Utd,6509,2,19,8,9,57,38,19,65
Morton,6509,3,18,9,9,55,40,15,63
Falkirk,6509,4,16,10,10,56,39,17,58
Dunfermline,6509,5,12,11,13,49,52,-3,47
Queen of S't,6509,6,10,10,16,44,51,-7,40
Raith,6509,7,10,10,16,34,47,-13,40
Dumbarton,6509,8,9,11,16,49,61,-12,38
St Mirren,6509,9,9,10,17,41,58,-17,37
Ayr,6509,10,7,13,16,36,61,-25,34
Hibernian,6510,1,19,11,6,55,24,31,68
Falkirk,6510,2,16,10,10,51,35,16,58
Morton,6510,3,15,13,8,47,36,11,58
Dundee Utd,6510,4,15,9,12,52,42,10,54
Dunfermline,6510,5,11,14,11,46,43,3,47
Queen of S't,6510,6,12,10,14,44,50,-6,46
St Mirren,6510,7,11,10,15,46,54,-8,43
Dumbarton,6510,8,9,12,15,47,58,-11,39
Raith,6510,9,8,12,16,34,54,-20,36
Ayr,6510,10,7,13,16,36,62,-26,34
Hibernian,6511,1,21,11,4,53,22,31,74
Falkirk,6511,2,18,11,7,59,35,24,65
Morton,6511,3,18,11,7,50,33,17,65
Dundee Utd,6511,4,16,9,11,51,38,13,57
Raith,6511,5,11,9,16,39,52,-13,42
Queen of S't,6511,6,11,8,17,44,57,-13,41
Dumbarton,6511,7,9,13,14,48,63,-15,40
Dunfermline,6511,8,9,12,15,43,47,-4,39
St Mirren,6511,9,8,9,19,40,57,-17,33
Ayr,6511,10,7,11,18,36,59,-23,32
Hibernian,6512,1,19,12,5,55,25,30,69
Falkirk,6512,2,19,10,7,63,38,25,67
Morton,6512,3,18,12,6,52,30,22,66
Dundee Utd,6512,4,15,9,12,47,41,6,54
Raith,6512,5,11,11,14,38,46,-8,44
Queen of S't,6512,6,10,11,15,43,52,-9,41
Ayr,6512,7,9,11,16,32,56,-24,38
Dunfermline,6512,8,8,13,15,43,56,-13,37
Dumbarton,6512,9,8,12,16,48,59,-11,36
St Mirren,6512,10,7,11,18,40,58,-18,32
Morton,6513,1,18,12,6,52,34,18,66
Hibernian,6513,2,16,13,7,49,27,22,61
Falkirk,6513,3,16,12,8,56,39,17,60
Dundee Utd,6513,4,16,10,10,46,36,10,58
Queen of S't,6513,5,14,9,13,46,45,1,51
Raith,6513,6,11,11,14,35,45,-10,44
Dumbarton,6513,7,11,10,15,50,55,-5,43
Dunfermline,6513,8,8,13,15,42,50,-8,37
Ayr,6513,9,8,11,17,35,55,-20,35
St Mirren,6513,10,7,9,20,34,59,-25,30
Hibernian,6514,1,20,11,5,57,25,32,71
Dundee Utd,6514,2,18,9,9,57,37,20,63
Falkirk,6514,3,15,10,11,54,46,8,55
Morton,6514,4,15,9,12,46,42,4,54
Dunfermline,6514,5,11,12,13,48,48,0,45
Dumbarton,6514,6,11,11,14,54,55,-1,44
St Mirren,6514,7,11,11,14,40,48,-8,44
Queen of S't,6514,8,11,8,17,46,58,-12,41
Raith,6514,9,10,9,17,33,51,-18,39
Ayr,6514,10,8,10,18,30,55,-25,34
Hibernian,6515,1,21,11,4,57,24,33,74
Falkirk,6515,2,15,12,9,55,38,17,57
Dundee Utd,6515,3,16,9,11,50,40,10,57
Morton,6515,4,15,10,11,44,42,2,55
Queen of S't,6515,5,12,10,14,45,47,-2,46
Dunfermline,6515,6,9,16,11,48,44,4,43
Raith,6515,7,10,11,15,36,49,-13,41
Ayr,6515,8,10,10,16,34,55,-21,40
St Mirren,6515,9,9,9,18,41,55,-14,36
Dumbarton,6515,10,8,12,16,46,62,-16,36
Hibernian,6516,1,19,13,4,61,30,31,70
Morton,6516,2,19,10,7,54,36,18,67
Dundee Utd,6516,3,18,8,10,55,38,17,62
Falkirk,6516,4,16,10,10,62,45,17,58
Dumbarton,6516,5,11,10,15,55,62,-7,43
Dunfermline,6516,6,10,11,15,46,51,-5,41
Queen of S't,6516,7,11,8,17,47,57,-10,41
Raith,6516,8,9,10,17,33,52,-19,37
Ayr,6516,9,9,10,17,38,61,-23,37
St Mirren,6516,10,7,12,17,41,60,-19,33
Hibernian,6517,1,20,10,6,54,27,27,70
Dundee Utd,6517,2,18,10,8,58,34,24,64
Morton,6517,3,18,9,9,50,35,15,63
Falkirk,6517,4,16,10,10,58,42,16,58
Queen of S't,6517,5,11,11,14,46,52,-6,44
St Mirren,6517,6,11,10,15,42,49,-7,43
Dunfermline,6517,7,9,11,16,43,50,-7,38
Raith,6517,8,9,10,17,33,55,-22,37
Ayr,6517,9,8,13,15,32,55,-23,37
Dumbarton,6517,10,8,10,18,48,65,-17,34
Hibernian,6518,1,20,11,5,60,30,30,71
Morton,6518,2,18,13,5,52,35,17,67
Dundee Utd,6518,3,17,10,9,58,36,22,61
Falkirk,6518,4,16,11,9,54,35,19,59
Dumbarton,6518,5,11,10,15,52,62,-10,43
Raith,6518,6,10,11,15,35,47,-12,41
Dunfermline,6518,7,8,14,14,45,51,-6,38
Queen of S't,6518,8,9,11,16,43,56,-13,38
Ayr,6518,9,7,12,17,32,57,-25,33
St Mirren,6518,10,7,11,18,35,57,-22,32
Hibernian,6519,1,20,13,3,54,23,31,73
Falkirk,6519,2,16,11,9,59,42,17,59
Morton,6519,3,15,13,8,44,33,11,58
Dundee Utd,6519,4,16,8,12,51,43,8,56
Dunfermline,6519,5,10,14,12,49,52,-3,44
Queen of S't,6519,6,11,8,17,40,49,-9,41
Raith,6519,7,11,8,17,36,45,-9,41
Ayr,6519,8,10,11,15,34,52,-18,41
Dumbarton,6519,9,8,13,15,47,59,-12,37
St Mirren,6519,10,8,11,17,36,52,-16,35
Hibernian,6520,1,18,12,6,53,30,23,66
Falkirk,6520,2,18,10,8,63,38,25,64
Morton,6520,3,18,10,8,53,39,14,64
Dundee Utd,6520,4,15,10,11,52,43,9,55
Raith,6520,5,12,9,15,44,49,-5,45
Dunfermline,6520,6,10,12,14,45,53,-8,42
St Mirren,6520,7,10,11,15,47,52,-5,41
Dumbarton,6520,8,9,11,16,51,62,-11,38
Queen of S't,6520,9,10,8,18,42,56,-14,38
Ayr,6520,10,8,11,17,34,62,-28,35
Hibernian,6521,1,20,11,5,56,26,30,71
Dundee Utd,6521,2,18,8,10,57,40,17,62
Falkirk,6521,3,17,10,9,63,41,22,61
Morton,6521,4,16,11,9,48,38,10,59
Raith,6521,5,13,9,14,39,44,-5,48
Queen of S't,6521,6,12,9,15,47,52,-5,45
Dumbarton,6521,7,10,10,16,49,63,-14,40
Dunfermline,6521,8,9,12,15,39,47,-8,39
St Mirren,6521,9,8,10,18,39,60,-21,34
Ayr,6521,10,7,10,19,34,60,-26,31
Hibernian,6522,1,18,14,4,52,22,30,68
Morton,6522,2,17,11,8,49,36,13,62
Falkirk,6522,3,15,11,10,56,44,12,56
Dundee Utd,6522,4,15,10,11,52,46,6,55
Dunfermline,6522,5,12,13,11,52,46,6,49
Queen of S't,6522,6,12,11,13,45,46,-1,47
Dumbarton,6522,7,9,12,15,50,58,-8,39
St Mirren,6522,8,9,11,16,45,60,-15,38
Raith,6522,9,10,8,18,31,51,-20,38
Ayr,6522,10,6,13,17,32,55,-23,31
Hibernian,6523,1,19,12,5,59,30,29,69
Falkirk,6523,2,16,11,9,62,46,16,59
Morton,6523,3,15,13,8,49,40,9,58
Dundee Utd,6523,4,15,10,11,54,45,9,55
Queen of S't,6523,5,12,9,15,48,51,-3,45
Raith,6523,6,12,9,15,44,50,-6,45
Dumbarton,6523,7,11,11,14,54,58,-4,44
Ayr,6523,8,9,13,14,38,53,-15,40
St Mirren,6523,9,8,11,17,36,58,-22,35
Dunfermline,6523,10,7,13,16,44,57,-13,34
Hibernian,6524,1,19,14,3,56,24,32,71
Falkirk,6524,2,17,12,7,58,37,21,63
Morton,6524,3,16,11,9,51,37,14,59
Dundee Utd,6524,4,16,8,12,52,43,9,56
Dunfermline,6524,5,10,13,13,43,47,-4,43
Dumbarton,6524,6,9,12,15,50,60,-10,39
Queen of S't,6524,7,10,9,17,45,55,-10,39
St Mirren,6524,8,10,9,17,40,57,-17,39
Raith,6524,9,9,11,16,33,53,-20,38
Ayr,6524,10,8,13,15,38,53,-15,37
Hibernian,6525,1,17,14,5,55,26,29,65
Morton,6525,2,17,12,7,52,40,12,63
Dundee Utd,6525,3,17,9,10,53,41,12,60
Falkirk,6525,4,16,9,11,61,42,19,57
Dunfermline,6525,5,10,14,12,47,48,-1,44
St Mirren,6525,6,11,11,14,46,54,-8,44
Raith,6525,7,10,10,16,36,50,-14,40
Ayr,6525,8,9,12,15,38,56,-18,39
Queen of S't,6525,9,9,10,17,40,57,-17,37
Dumbarton,6525,10,8,11,17,45,59,-14,35
Hibernian,6526,1,19,12,5,56,26,30,69
Morton,6526,2,19,11,6,56,37,19,68
Falkirk,6526,3,15,12,9,55,39,16,57
Dundee Utd,6526,4,15,10,11,53,45,8,55
Queen of S't,6526,5,13,9,14,47,49,-2,48
Raith,6526,6,11,9,16,34,50,-16,42
Dumbarton,6526,7,9,12,15,49,63,-14,39
St Mirren,6526,8,9,10,17,40,53,-13,37
Ayr,6526,9,8,12,16,40,57,-17,36
Dunfermline,6526,10,7,13,16,44,55,-11,34
Hibernian,6527,1,19,13,4,55,26,29,70
Morton,6527,2,17,12,7,49,34,15,63
Falkirk,6527,3,17,10,9,57,40,17,61
Dundee Utd,6527,4,17,9,10,51,37,14,60
Queen of S't,6527,5,13,9,14,47,47,0,48
Dumbarton,6527,6,10,10,16,51,60,-9,40
Dunfermline,6527,7,9,12,15,45,52,-7,39
Raith,6527,8,9,10,17,34,50,-16,37
Ayr,6527,9,7,13,16,32,57,-25,34
St Mirren,6527,10,6,14,16,35,53,-18,32
Hibernian,6528,1,20,10,6,59,25,34,70
Morton,6528,2,18,10,8,54,39,15,64
Falkirk,6528,3,17,10,9,61,37,24,61
Dundee Utd,6528,4,16,12,8,52,38,14,60
Dunfermline,6528,5,10,12,14,45,52,-7,42
Ayr,6528,6,10,12,14,41,53,-12,42
Raith,6528,7,11,9,16,37,53,-16,42
Queen of S't,6528,8,10,9,17,42,55,-13,39
Dumbarton,6528,9,9,11,16,47,58,-11,38
St Mirren,6528,10,7,9,20,36,64,-28,30
Hibernian,6529,1,19,13,4,52,24,28,70
Dundee Utd,6529,2,17,10,9,54,38,16,61
Morton,6529,3,16,12,8,54,36,18,60
Falkirk,6529,4,16,10,10,58,42,16,58
Dumbarton,6529,5,11,11,14,53,57,-4,44
Raith,6529,6,11,11,14,39,46,-7,44
Dunfermline,6529,7,9,13,14,44,60,-16,40
Queen of S't,6529,8,9,9,18,41,55,-14,36
Ayr,6529,9,8,12,16,32,54,-22,36
St Mirren,6529,10,8,11,17,40,55,-15,35
Hibernian,6530,1,22,10,4,59,26,33,76
Morton,6530,2,18,10,8,57,40,17,64
Falkirk,6530,3,16,10,10,58,41,17,58
Dundee Utd,6530,4,15,11,10,55,43,12,56
Queen of S't,6530,5,12,9,15,51,53,-2,45
Dunfermline,6530,6,10,13,13,48,50,-2,43
Dumbarton,6530,7,9,11,16,47,59,-12,38
Raith,6530,8,10,8,18,34,54,-20,38
St Mirren,6530,9,8,11,17,39,61,-22,35
Ayr,6530,10,7,13,16,35,56,-21,34
Morton,6531,1,20,10,6,62,30,32,70
Hibernian,6531,2,18,13,5,59,32,27,67
Dundee Utd,6531,3,17,9,10,54,40,14,60
Falkirk,6531,4,14,12,10,52,40,12,54
Queen of S't,6531,5,15,8,13,53,49,4,53
Dunfermline,6531,6,9,13,14,43,54,-11,40
Raith,6531,7,10,10,16,36,51,-15,40
Dumbarton,6531,8,9,11,16,46,60,-14,38
St Mirren,6531,9,8,10,18,37,59,-22,34
Ayr,6531,10,6,12,18,30,57,-27,30
Hibernian,6532,1,20,12,4,56,23,33,72
Morton,6532,2,21,9,6,54,29,25,72
Dundee Utd,6532,3,18,9,9,57,42,15,63
Falkirk,6532,4,16,10,10,59,45,14,58
Raith,6532,5,12,9,15,40,51,-11,45
Dunfermline,6532,6,10,12,14,45,46,-1,42
Ayr,6532,7,8,13,15,36,55,-19,37
Dumbarton,6532,8,8,12,16,47,62,-15,36
Queen of S't,6532,9,9,8,19,40,54,-14,35
St Mirren,6532,10,6,10,20,40,67,-27,28
Hibernian,6533,1,19,12,5,59,32,27,69
Morton,6533,2,18,11,7,54,39,15,65
Falkirk,6533,3,17,9,10,66,43,23,60
Dundee Utd,6533,4,15,10,11,49,38,11,55
Queen of S't,6533,5,11,10,15,43,50,-7,43
Dunfermline,6533,6,10,12,14,44,50,-6,42
Raith,6533,7,10,10,16,32,47,-15,40
Ayr,6533,8,9,12,15,36,53,-17,39
St Mirren,6533,9,9,11,16,42,59,-17,38
Dumbarton,6533,10,8,11,17,48,62,-14,35
Hibernian,6534,1,19,11,6,52,24,28,68
Morton,6534,2,17,13,6,53,34,19,64
Falkirk,6534,3,16,11,9,61,44,17,59
Dundee Utd,6534,4,14,12,10,44,37,7,54
Queen of S't,6534,5,12,11,13,42,45,-3,47
Dunfermline,6534,6,10,15,11,44,47,-3,45
Dumbarton,6534,7,9,10,17,50,60,-10,37
St Mirren,6534,8,8,12,16,42,59,-17,36
Raith,6534,9,9,9,18,34,52,-18,36
Ayr,6534,10,8,12,16,35,55,-20,36
Hibernian,6535,1,22,10,4,59,24,35,76
Dundee Utd,6535,2,18,9,9,53,39,14,63
Falkirk,6535,3,16,10,10,58,40,18,58
Morton,6535,4,15,12,9,50,39,11,57
Queen of S't,6535,5,13,9,14,53,54,-1,48
Raith,6535,6,11,8,17,38,56,-18,41
Dumbarton,6535,7,10,10,16,49,63,-14,40
Dunfermline,6535,8,9,12,15,44,53,-9,39
St Mirren,6535,9,8,11,17,44,57,-13,35
Ayr,6535,10,7,11,18,36,59,-23,32
Hibernian,6536,1,18,13,5,54,26,28,67
Dundee Utd,6536,2,17,9,10,51,39,12,60
Morton,6536,3,15,11,10,43,36,7,56
Falkirk,6536,4,15,10,11,56,42,14,55
Queen of S't,6536,5,13,10,13,44,47,-3,49
Dunfermline,6536,6,12,12,12,46,44,2,48
St Mirren,6536,7,10,11,15,44,52,-8,41
Ayr,6536,8,9,12,15,35,51,-16,39
Dumbarton,6536,9,9,10,17,45,62,-17,37
Raith,6536,10,8,10,18,32,51,-19,34
Hibernian,6537,1,19,12,5,54,25,29,69
Falkirk,6537,2,18,10,8,61,38,23,64
Morton,6537,3,17,10,9,48,37,11,61
Dundee Utd,6537,4,17,9,10,50,39,11,60
Dunfermline,6537,5,12,12,12,45,43,2,48
Queen of S't,6537,6,11,10,15,42,50,-8,43
Ayr,6537,7,8,13,15,32,53,-21,37
Dumbarton,6537,8,8,12,16,43,56,-13,36
St Mirren,6537,9,8,11,17,38,53,-15,35
Raith,6537,10,8,9,19,30,49,-19,33
Hibernian,6538,1,19,10,7,52,29,23,67
Morton,6538,2,19,10,7,49,32,17,67
Falkirk,6538,3,15,12,9,54,38,16,57
Dundee Utd,6538,4,14,11,11,47,41,6,53
Queen of S't,6538,5,12,10,14,48,47,1,46
Dunfermline,6538,6,11,12,13,52,54,-2,45
Dumbarton,6538,7,11,10,15,47,57,-10,43
St Mirren,6538,8,9,10,17,41,52,-11,37
Raith,6538,9,9,10,17,30,48,-18,37
Ayr,6538,10,8,11,17,34,56,-22,35
Hibernian,6539,1,20,12,4,56,27,29,72
Falkirk,6539,2,17,10,9,59,38,21,61
Morton,6539,3,16,11,9,54,42,12,59
Dundee Utd,6539,4,15,10,11,49,43,6,55
Dunfermline,6539,5,11,13,12,50,49,1,46
Queen of S't,6539,6,12,9,15,44,48,-4,45
Ayr,6539,7,11,10,15,38,53,-15,43
Raith,6539,8,10,9,17,36,52,-16,39
St Mirren,6539,9,8,11,17,40,55,-15,35
Dumbarton,6539,10,7,11,18,48,67,-19,32
Hibernian,6540,1,21,12,3,59,22,37,75
Dundee Utd,6540,2,17,10,9,51,40,11,61
Morton,6540,3,16,12,8,51,35,16,60
Falkirk,6540,4,14,11,11,56,45,11,53
Dunfermline,6540,5,10,13,13,45,48,-3,43
Raith,6540,6,10,10,16,33,47,-14,40
Ayr,6540,7,9,13,14,30,48,-18,40
Queen of S't,6540,8,9,12,15,42,52,-10,39
St Mirren,6540,9,9,10,17,44,59,-15,37
Dumbarton,6540,10,7,13,16,44,59,-15,34
Hibernian,6541,1,20,12,4,57,26,31,72
Morton,6541,2,19,10,7,55,37,18,67
Falkirk,6541,3,16,9,11,62,48,14,57
Dundee Utd,6541,4,15,11,10,51,40,11,56
Dunfermline,6541,5,11,13,12,47,47,0,46
Queen of S't,6541,6,11,10,15,45,50,-5,43
Dumbarton,6541,7,10,11,15,50,59,-9,41
Raith,6541,8,10,10,16,35,49,-14,40
Ayr,6541,9,7,12,17,32,56,-24,33
St Mirren,6541,10,7,10,19,37,59,-22,31
Hibernian,6542,1,19,11,6,56,27,29,68
Morton,6542,2,18,10,8,56,41,15,64
Falkirk,6542,3,17,11,8,56,37,19,62
Dundee Utd,6542,4,15,10,11,51,44,7,55
Queen of S't,6542,5,14,8,14,48,49,-1,50
Dunfermline,6542,6,11,13,12,45,47,-2,46
Raith,6542,7,11,8,17,37,46,-9,41
St Mirren,6542,8,9,9,18,38,57,-19,36
Dumbarton,6542,9,8,10,18,44,57,-13,34
Ayr,6542,10,8,10,18,37,63,-26,34
Hibernian,6543,1,19,13,4,60,29,31,70
Morton,6543,2,16,13,7,51,39,12,61
Dundee Utd,6543,3,15,10,11,52,43,9,55
Falkirk,6543,4,15,9,12,52,44,8,54
Queen of S't,6543,5,12,10,14,46,47,-1,46
Dunfermline,6543,6,11,12,13,50,48,2,45
Dumbarton,6543,7,10,12,14,50,58,-8,42
St Mirren,6543,8,9,12,15,39,53,-14,39
Ayr,6543,9,8,13,15,38,58,-20,37
Raith,6543,10,8,10,18,33,52,-19,34
Falkirk,6544,1,19,10,7,57,34,23,67
Hibernian,6544,2,18,11,7,56,32,24,65
Morton,6544,3,16,12,8,47,36,11,60
Dundee Utd,6544,4,16,9,11,51,40,11,57
Dunfermline,6544,5,10,14,12,44,43,1,44
Queen of S't,6544,6,11,9,16,47,54,-7,42
Ayr,6544,7,10,11,15,34,54,-20,41
Dumbarton,6544,8,9,11,16,49,60,-11,38
St Mirren,6544,9,8,13,15,40,53,-13,37
Raith,6544,10,8,10,18,31,50,-19,34
Hibernian,6545,1,19,10,7,57,28,29,67
Falkirk,6545,2,18,9,9,59,39,20,63
Dundee Utd,6545,3,18,8,10,53,39,14,62
Morton,6545,4,15,11,10,46,42,4,56
Dunfermline,6545,5,12,12,12,52,47,5,48
Queen of S't,6545,6,11,10,15,44,49,-5,43
Ayr,6545,7,9,14,13,35,50,-15,41
St Mirren,6545,8,9,10,17,40,56,-16,37
Raith,6545,9,9,10,17,36,54,-18,37
Dumbarton,6545,10,7,12,17,40,58,-18,33
Hibernian,6546,1,20,11,5,56,26,30,71
Morton,6546,2,18,10,8,55,37,18,64
Falkirk,6546,3,15,12,9,55,37,18,57
Dundee Utd,6546,4,15,11,10,52,44,8,56
Queen of S't,6546,5,13,9,14,49,51,-2,48
Raith,6546,6,11,10,15,38,52,-14,43
Dunfermline,6546,7,9,13,14,46,51,-5,40
St Mirren,6546,8,9,10,17,41,55,-14,37
Dumbarton,6546,9,8,12,16,48,65,-17,36
Ayr,6546,10,7,12,17,34,56,-22,33
Hibernian,6547,1,19,11,6,53,25,28,68
Morton,6547,2,17,12,7,48,34,14,63
Dundee Utd,6547,3,16,9,11,52,42,10,57
Falkirk,6547,4,15,10,11,56,44,12,55
St Mirren,6547,5,12,10,14,51,52,-1,46
Dumbarton,6547,6,11,11,14,48,55,-7,44
Queen of S't,6547,7,11,9,16,42,50,-8,42
Dunfermline,6547,8,9,12,15,47,52,-5,39
Raith,6547,9,9,11,16,32,51,-19,38
Ayr,6547,10,6,15,15,28,52,-24,33
Hibernian,6548,1,19,13,4,52,24,28,70
Dundee Utd,6548,2,17,9,10,59,39,20,60
Falkirk,6548,3,15,13,8,61,43,18,58
Morton,6548,4,15,12,9,50,41,9,57
Queen of S't,6548,5,11,10,15,48,52,-4,43
Raith,6548,6,11,9,16,37,49,-12,42
Dunfermline,6548,7,10,11,15,48,52,-4,41
St Mirren,6548,8,9,11,16,44,58,-14,38
Dumbarton,6548,9,9,11,16,45,62,-17,38
Ayr,6548,10,9,11,16,34,58,-24,38
Hibernian,6549,1,21,12,3,58,24,34,75
Morton,6549,2,17,12,7,59,44,15,63
Falkirk,6549,3,16,10,10,59,45,14,58
Dundee Utd,6549,4,15,11,10,51,42,9,56
Queen of S't,6549,5,12,9,15,45,50,-5,45
Dunfermline,6549,6,9,14,13,48,52,-4,41
Raith,6549,7,10,10,16,32,45,-13,40
Dumbarton,6549,8,8,13,15,49,60,-11,37
St Mirren,6549,9,8,11,17,34,50,-16,35
Ayr,6549,10,8,10,18,32,55,-23,34
Hibernian,6550,1,19,12,5,61,32,29,69
Falkirk,6550,2,16,10,10,59,43,16,58
Dundee Utd,6550,3,16,10,10,52,40,12,58
Morton,6550,4,14,13,9,49,39,10,55
Queen of S't,6550,5,11,11,14,44,51,-7,44
Raith,6550,6,11,10,15,38,48,-10,43
Dumbarton,6550,7,10,12,14,45,52,-7,42
Dunfermline,6550,8,9,12,15,43,53,-10,39
St Mirren,6550,9,9,11,16,41,56,-15,38
Ayr,6550,10,8,13,15,32,50,-18,37
Hibernian,6551,1,21,11,4,61,23,38,74
Morton,6551,2,17,11,8,52,39,13,62
Falkirk,6551,3,17,9,10,61,45,16,60
Dundee Utd,6551,4,14,12,10,52,46,6,54
St Mirren,6551,5,11,10,15,45,55,-10,43
Queen of S't,6551,6,11,9,16,44,52,-8,42
Raith,6551,7,11,8,17,34,50,-16,41
Dumbarton,6551,8,9,12,15,51,61,-10,39
Dunfermline,6551,9,9,11,16,48,51,-3,38
Ayr,6551,10,7,13,16,35,61,-26,34
Hibernian,6552,1,18,13,5,54,27,27,67
Falkirk,6552,2,18,11,7,62,38,24,65
Dundee Utd,6552,3,16,10,10,49,39,10,58
Morton,6552,4,15,13,8,46,37,9,58
Queen of S't,6552,5,12,12,12,50,48,2,48
Dunfermline,6552,6,10,12,14,44,50,-6,42
Dumbarton,6552,7,10,10,16,46,57,-11,40
Raith,6552,8,9,11,16,35,50,-15,38
St Mirren,6552,9,8,10,18,40,57,-17,34
Ayr,6552,10,7,12,17,32,55,-23,33
Hibernian,6553,1,20,11,5,60,24,36,71
Falkirk,6553,2,17,9,10,57,43,14,60
Morton,6553,3,15,14,7,46,37,9,59
Dundee Utd,6553,4,16,8,12,52,44,8,56
Dunfermline,6553,5,9,16,11,48,47,1,43
Raith,6553,6,11,10,15,36,47,-11,43
Queen of S't,6553,7,10,12,14,42,50,-8,42
Ayr,6553,8,9,12,15,35,55,-20,39
Dumbarton,6553,9,8,13,15,44,55,-11,37
St Mirren,6553,10,7,11,18,37,55,-18,32
Hibernian,6554,1,19,13,4,55,26,29,70
Falkirk,6554,2,17,9,10,61,37,24,60
Morton,6554,3,16,12,8,55,43,12,60
Dundee Utd,6554,4,17,9,10,51,44,7,60
Queen of S't,6554,5,12,10,14,42,47,-5,46
Dunfermline,6554,6,11,12,13,46,46,0,45
Ayr,6554,7,9,11,16,37,60,-23,38
St Mirren,6554,8,9,10,17,44,54,-10,37
Raith,6554,9,9,10,17,33,47,-14,37
Dumbarton,6554,10,8,10,18,46,66,-20,34
Hibernian,6555,1,18,13,5,54,27,27,67
Dundee Utd,6555,2,19,8,9,59,39,20,65
Morton,6555,3,16,11,9,49,38,11,59
Falkirk,6555,4,15,12,9,64,40,24,57
Dunfermline,6555,5,10,12,14,46,53,-7,42
Queen of S't,6555,6,10,10,16,40,48,-8,40
Raith,6555,7,9,13,14,37,50,-13,40
Dumbarton,6555,8,9,12,15,47,56,-9,39
St Mirren,6555,9,9,11,16,41,63,-22,38
Ayr,6555,10,8,12,16,34,57,-23,36
Hibernian,6556,1,20,13,3,62,27,35,73
Dundee Utd,6556,2,17,11,8,54,34,20,62
Falkirk,6556,3,16,12,8,62,42,20,60
Morton,6556,4,16,12,8,49,38,11,60
Raith,6556,5,11,10,15,34,47,-13,43
Dunfermline,6556,6,9,13,14,44,51,-7,40
Queen of S't,6556,7,10,10,16,44,54,-10,40
Ayr,6556,8,8,13,15,36,53,-17,37
Dumbarton,6556,9,8,11,17,51,68,-17,35
St Mirren,6556,10,6,13,17,36,58,-22,31
Hibernian,6557,1,20,11,5,54,23,31,71
Falkirk,6557,2,17,11,8,60,35,25,62
Morton,6557,3,17,10,9,54,41,13,61
Dundee Utd,6557,4,17,9,10,51,44,7,60
Queen of S't,6557,5,11,12,13,45,49,-4,45
Dunfermline,6557,6,9,13,14,45,48,-3,40
Ayr,6557,7,9,13,14,41,56,-15,40
St Mirren,6557,8,9,9,18,40,56,-16,36
Raith,6557,9,9,9,18,35,54,-19,36
Dumbarton,6557,10,8,11,17,42,61,-19,35
Hibernian,6558,1,19,10,7,55,29,26,67
Morton,6558,2,17,13,6,56,36,20,64
Falkirk,6558,3,17,10,9,57,38,19,61
Dundee Utd,6558,4,15,10,11,49,42,7,55
Raith,6558,5,11,12,13,37,45,-8,45
Dunfermline,6558,6,10,12,14,42,47,-5,42
Queen of S't,6558,7,11,8,17,41,50,-9,41
Ayr,6558,8,9,13,14,37,54,-17,40
St Mirren,6558,9,8,11,17,39,54,-15,35
Dumbarton,6558,10,7,13,16,45,63,-18,34
Hibernian,6559,1,20,12,4,58,24,34,72
Morton,6559,2,17,11,8,50,37,13,62
Falkirk,6559,3,14,11,11,59,46,13,53
Dundee Utd,6559,4,12,15,9,46,41,5,51
Queen of S't,6559,5,12,11,13,43,48,-5,47
St Mirren,6559,6,11,9,16,46,57,-11,42
Dunfermline,6559,7,8,16,12,43,46,-3,40
Dumbarton,6559,8,9,12,15,50,59,-9,39
Raith,6559,9,10,9,17,34,47,-13,39
Ayr,6559,10,7,14,15,34,58,-24,35
Hibernian,6560,1,22,11,3,66,27,39,77
Morton,6560,2,18,11,7,50,33,17,65
Dundee Utd,6560,3,17,11,8,50,36,14,62
Falkirk,6560,4,15,10,11,52,39,13,55
Queen of S't,6560,5,12,8,16,49,56,-7,44
Ayr,6560,6,9,12,15,37,54,-17,39
Raith,6560,7,9,11,16,32,47,-15,38
Dunfermline,6560,8,8,12,16,44,56,-12,36
St Mirren,6560,9,7,14,15,37,53,-16,35
Dumbarton,6560,10,7,12,17,45,61,-16,33
Hibernian,6561,1,19,12,5,60,27,33,69
Morton,6561,2,17,12,7,54,37,17,63
Falkirk,6561,3,17,9,10,55,41,14,60
Dundee Utd,6561,4,14,12,10,48,40,8,54
Queen of S't,6561,5,13,9,14,45,49,-4,48
St Mirren,6561,6,10,11,15,45,57,-12,41
Dunfermline,6561,7,9,13,14,44,50,-6,40
Raith,6561,8,10,10,16,40,52,-12,40
Dumbarton,6561,9,9,11,16,46,57,-11,38
Ayr,6561,10,7,11,18,30,57,-27,32
Hibernian,6562,1,20,12,4,64,26,38,72
Morton,6562,2,18,11,7,51,35,16,65
Dundee Utd,6562,3,16,10,10,54,40,14,58
Falkirk,6562,4,15,11,10,63,46,17,56
Dunfermline,6562,5,11,14,11,52,50,2,47
Queen of S't,6562,6,12,10,14,45,54,-9,46
St Mirren,6562,7,9,12,15,43,52,-9,39
Raith,6562,8,8,11,17,32,49,-17,35
Dumbarton,6562,9,8,10,18,46,69,-23,34
Ayr,6562,10,6,13,17,31,60,-29,31
Hibernian,6563,1,19,13,4,55,25,30,70
Morton,6563,2,18,11,7,48,31,17,65
Falkirk,6563,3,16,11,9,61,43,18,59
Dundee Utd,6563,4,16,11,9,53,39,14,59
Dunfermline,6563,5,10,15,11,44,44,0,45
Queen of S't,6563,6,10,11,15,44,56,-12,41
Raith,6563,7,10,8,18,33,49,-16,38
Dumbarton,6563,8,8,13,15,49,61,-12,37
St Mirren,6563,9,9,10,17,42,58,-16,37
Ayr,6563,10,7,11,18,33,56,-23,32
Hibernian,6564,1,18,13,5,54,24,30,67
Dundee Utd,6564,2,18,8,10,54,37,17,62
Morton,6564,3,17,11,8,47,34,13,62
Falkirk,6564,4,14,11,11,56,42,14,53
Raith,6564,5,13,8,15,41,45,-4,47
Queen of S't,6564,6,11,11,14,45,53,-8,44
Dunfermline,6564,7,10,13,13,42,45,-3,43
Ayr,6564,8,8,13,15,35,56,-21,37
St Mirren,6564,9,9,9,18,37,58,-21,36
Dumbarton,6564,10,7,13,16,44,61,-17,34
Hibernian,6565,1,22,11,3,66,21,45,77
Morton,6565,2,20,10,6,58,35,23,70
Dundee Utd,6565,3,15,10,11,52,39,13,55
Falkirk,6565,4,14,11,11,56,50,6,53
Queen of S't,6565,5,13,10,13,46,46,0,49
Dumbarton,6565,6,11,11,14,52,53,-1,44
Dunfermline,6565,7,8,13,15,47,57,-10,37
Raith,6565,8,9,9,18,34,55,-21,36
St Mirren,6565,9,8,10,18,38,61,-23,34
Ayr,6565,10,7,11,18,30,62,-32,32
Hibernian,6566,1,19,14,3,59,24,35,71
Falkirk,6566,2,17,10,9,60,39,21,61
Morton,6566,3,15,12,9,48,38,10,57
Dundee Utd,6566,4,14,12,10,48,44,4,54
Queen of S't,6566,5,11,11,14,41,45,-4,44
Dunfermline,6566,6,10,12,14,44,46,-2,42
Raith,6566,7,11,9,16,35,49,-14,42
Dumbarton,6566,8,9,13,14,47,58,-11,40
Ayr,6566,9,7,15,14,33,53,-20,36
St Mirren,6566,10,8,10,18,37,56,-19,34
Hibernian,6567,1,21,11,4,60,25,35,74
Falkirk,6567,2,18,10,8,60,36,24,64
Morton,6567,3,16,13,7,50,38,12,61
Dundee Utd,6567,4,15,9,12,51,40,11,54
Queen of S't,6567,5,13,8,15,50,56,-6,47
Dunfermline,6567,6,11,13,12,53,50,3,46
Raith,6567,7,10,9,17,37,55,-18,39
St Mirren,6567,8,8,11,17,43,54,-11,35
Dumbarton,6567,9,8,11,17,46,66,-20,35
Ayr,6567,10,7,11,18,34,64,-30,32
Hibernian,6568,1,18,13,5,54,25,29,67
Morton,6568,2,18,11,7,49,33,16,65
Dundee Utd,6568,3,16,8,12,49,41,8,56
Falkirk,6568,4,14,12,10,55,41,14,54
Ayr,6568,5,12,12,12,38,47,-9,48
Queen of S't,6568,6,11,10,15,39,48,-9,43
Dunfermline,6568,7,10,12,14,44,49,-5,42
Dumbarton,6568,8,10,10,16,46,56,-10,40
Raith,6568,9,9,12,15,33,47,-14,39
St Mirren,6568,10,7,10,19,34,54,-20,31
Hibernian,6569,1,19,12,5,55,27,28,69
Morton,6569,2,16,12,8,49,35,14,60
Falkirk,6569,3,15,10,11,58,43,15,55
Dundee Utd,6569,4,14,11,11,45,42,3,53
Dunfermline,6569,5,12,14,10,50,47,3,50
Queen of S't,6569,6,10,12,14,47,51,-4,42
Ayr,6569,7,9,13,14,32,53,-21,40
St Mirren,6569,8,10,9,17,47,58,-11,39
Dumbarton,6569,9,8,13,15,49,57,-8,37
Raith,6569,10,9,10,17,33,52,-19,37
Hibernian,6570,1,18,13,5,57,24,33,67
Morton,6570,2,16,13,7,44,36,8,61
Falkirk,6570,3,16,11,9,62,38,24,59
Dundee Utd,6570,4,16,9,11,52,40,12,57
Dunfermline,6570,5,12,13,11,49,44,5,49
Ayr,6570,6,10,14,12,40,49,-9,44
Queen of S't,6570,7,11,9,16,44,55,-11,42
Raith,6570,8,11,8,17,36,53,-17,41
Dumbarton,6570,9,7,14,15,44,59,-15,35
St Mirren,6570,10,6,10,20,36,66,-30,28
Hibernian,6571,1,19,11,6,55,28,27,68
Morton,6571,2,18,12,6,55,35,20,66
Dundee Utd,6571,3,17,10,9,55,41,14,61
Falkirk,6571,4,15,11,10,56,41,15,56
Queen of S't,6571,5,13,10,13,45,47,-2,49
Dunfermline,6571,6,10,12,14,44,50,-6,42
Dumbarton,6571,7,9,10,17,50,63,-13,37
St Mirren,6571,8,9,10,17,40,55,-15,37
Raith,6571,9,8,11,17,29,47,-18,35
Ayr,6571,10,8,11,17,32,54,-22,35
Hibernian,6572,1,18,11,7,57,32,25,65
Morton,6572,2,18,10,8,53,36,17,64
Falkirk,6572,3,17,12,7,60,39,21,63
Dundee Utd,6572,4,15,10,11,54,45,9,55
Queen of S't,6572,5,14,9,13,51,47,4,51
Dumbarton,6572,6,10,12,14,52,58,-6,42
Raith,6572,7,11,9,16,38,50,-12,42
Dunfermline,6572,8,9,12,15,44,52,-8,39
St Mirren,6572,9,9,10,17,45,59,-14,37
Ayr,6572,10,6,11,19,34,70,-36,29
Hibernian,6573,1,19,11,6,51,27,24,68
Morton,6573,2,15,10,11,48,41,7,55
Dundee Utd,6573,3,15,10,11,47,42,5,55
Falkirk,6573,4,15,9,12,57,43,14,54
Dunfermline,6573,5,13,12,11,54,45,9,51
Raith,6573,6,13,8,15,37,47,-10,47
Queen of S't,6573,7,12,9,15,49,54,-5,45
Dumbarton,6573,8,9,13,14,50,59,-9,40
St Mirren,6573,9,9,11,16,39,53,-14,38
Ayr,6573,10,7,13,16,32,53,-21,34
Hibernian,6574,1,20,13,3,55,24,31,73
Morton,6574,2,17,13,6,50,33,17,64
Falkirk,6574,3,17,11,8,58,36,22,62
Dundee Utd,6574,4,17,11,8,50,34,16,62
Queen of S't,6574,5,11,8,17,42,53,-11,41
Dunfermline,6574,6,9,12,15,43,49,-6,39
Raith,6574,7,9,9,18,36,51,-15,36
Ayr,6574,8,8,12,16,36,58,-22,36
Dumbarton,6574,9,7,14,15,45,59,-14,35
St Mirren,6574,10,8,11,17,39,57,-18,35
Morton,6575,1,18,13,5,51,32,19,67
Hibernian,6575,2,17,14,5,51,28,23,65
Falkirk,6575,3,16,11,9,62,43,19,59
Dundee Utd,6575,4,16,9,11,50,41,9,57
Dunfermline,6575,5,10,13,13,47,48,-1,43
Queen of S't,6575,6,11,9,16,43,53,-10,42
Raith,6575,7,10,10,16,35,46,-11,40
Dumbarton,6575,8,9,12,15,50,59,-9,39
Ayr,6575,9,8,13,15,34,56,-22,37
St Mirren,6575,10,7,12,17,35,52,-17,33
Hibernian,6576,1,22,11,3,61,24,37,77
Dundee Utd,6576,2,19,8,9,56,37,19,65
Falkirk,6576,3,16,11,9,57,41,16,59
Morton,6576,4,14,11,11,46,41,5,53
Queen of S't,6576,5,12,8,16,45,53,-8,44
Dunfermline,6576,6,9,12,15,44,49,-5,39
Dumbarton,6576,7,9,11,16,53,64,-11,38
St Mirren,6576,8,9,11,16,41,56,-15,38
Raith,6576,9,9,11,16,35,50,-15,38
Ayr,6576,10,8,12,16,37,60,-23,36
Hibernian,6577,1,18,13,5,56,29,27,67
Morton,6577,2,18,13,5,52,32,20,67
Dundee Utd,6577,3,16,9,11,52,40,12,57
Falkirk,6577,4,14,13,9,60,45,15,55
Dunfermline,6577,5,10,14,12,46,47,-1,44
Dumbarton,6577,6,10,12,14,52,59,-7,42
Queen of S't,6577,7,10,11,15,47,53,-6,41
Raith,6577,8,9,10,17,32,51,-19,37
Ayr,6577,9,8,13,15,36,56,-20,37
St Mirren,6577,10,8,10,18,38,59,-21,34
Hibernian,6578,1,20,11,5,55,25,30,71
Dundee Utd,6578,2,16,11,9,49,37,12,59
Morton,6578,3,15,12,9,44,34,10,57
Falkirk,6578,4,14,12,10,55,42,13,54
Raith,6578,5,12,11,13,38,45,-7,47
Dunfermline,6578,6,11,12,13,47,45,2,45
Queen of S't,6578,7,11,10,15,42,51,-9,43
Dumbarton,6578,8,10,10,16,48,59,-11,40
Ayr,6578,9,7,13,16,32,53,-21,34
St Mirren,6578,10,7,12,17,34,53,-19,33
Hibernian,6579,1,20,12,4,57,25,32,72
Morton,6579,2,16,11,9,50,38,12,59
Falkirk,6579,3,16,10,10,57,36,21,58
Dundee Utd,6579,4,15,11,10,50,38,12,56
Queen of S't,6579,5,13,9,14,53,53,0,48
Dunfermline,6579,6,10,12,14,45,55,-10,42
St Mirren,6579,7,10,10,16,40,52,-12,40
Ayr,6579,8,9,12,15,33,50,-17,39
Dumbarton,6579,9,8,12,16,44,61,-17,36
Raith,6579,10,9,9,18,33,54,-21,36
Hibernian,6580,1,20,11,5,57,27,30,71
Falkirk,6580,2,16,11,9,55,38,17,59
Morton,6580,3,16,10,10,51,42,9,58
Dundee Utd,6580,4,16,9,11,49,38,11,57
Dunfermline,6580,5,12,11,13,46,47,-1,47
Raith,6580,6,13,8,15,40,43,-3,47
Dumbarton,6580,7,10,10,16,48,59,-11,40
Queen of S't,6580,8,10,9,17,42,52,-10,39
St Mirren,6580,9,9,10,17,38,54,-16,37
Ayr,6580,10,7,13,16,33,59,-26,34
Hibernian,6581,1,17,14,5,50,28,22,65
Falkirk,6581,2,17,10,9,61,42,19,61
Morton,6581,3,16,13,7,45,32,13,61
Dundee Utd,6581,4,13,12,11,46,42,4,51
Dunfermline,6581,5,12,13,11,53,46,7,49
Queen of S't,6581,6,11,10,15,46,51,-5,43
Raith,6581,7,11,9,16,36,46,-10,42
Dumbarton,6581,8,9,11,16,48,60,-12,38
Ayr,6581,9,8,14,14,33,51,-18,38
St Mirren,6581,10,8,10,18,33,53,-20,34
Hibernian,6582,1,19,12,5,54,29,25,69
Morton,6582,2,16,11,9,48,35,13,59
Dundee Utd,6582,3,16,9,11,52,41,11,57
Falkirk,6582,4,14,12,10,53,45,8,54
Queen of S't,6582,5,12,10,14,52,53,-1,46
Dunfermline,6582,6,11,12,13,49,50,-1,45
Dumbarton,6582,7,11,11,14,54,57,-3,44
St Mirren,6582,8,10,11,15,45,56,-11,41
Raith,6582,9,8,13,15,34,50,-16,37
Ayr,6582,10,6,13,17,36,61,-25,31
Hibernian,6583,1,19,13,4,54,24,30,70
Dundee Utd,6583,2,18,9,9,54,37,17,63
Falkirk,6583,3,17,10,9,60,41,19,61
Morton,6583,4,15,11,10,45,39,6,56
Raith,6583,5,12,10,14,37,45,-8,46
Queen of S't,6583,6,11,9,16,46,53,-7,42
Dunfermline,6583,7,9,13,14,45,50,-5,40
Dumbarton,6583,8,9,10,17,48,60,-12,37
St Mirren,6583,9,8,12,16,39,55,-16,36
Ayr,6583,10,8,11,17,35,59,-24,35
Hibernian,6584,1,18,10,8,52,30,22,64
Morton,6584,2,17,11,8,46,32,14,62
Falkirk,6584,3,15,11,10,57,40,17,56
Dundee Utd,6584,4,16,8,12,49,41,8,56
Queen of S't,6584,5,14,9,13,51,48,3,51
Ayr,6584,6,10,13,13,34,48,-14,43
Dumbarton,6584,7,10,12,14,46,54,-8,42
Dunfermline,6584,8,9,12,15,43,50,-7,39
St Mirren,6584,9,9,12,15,42,56,-14,39
Raith,6584,10,8,10,18,30,51,-21,34
Hibernian,6585,1,18,12,6,53,27,26,66
Morton,6585,2,15,15,6,47,34,13,60
Falkirk,6585,3,15,13,8,52,36,16,58
Dundee Utd,6585,4,13,14,9,46,38,8,53
Queen of S't,6585,5,12,10,14,47,50,-3,46
Dunfermline,6585,6,9,14,13,45,49,-4,41
St Mirren,6585,7,10,11,15,46,54,-8,41
Dumbarton,6585,8,9,12,15,47,55,-8,39
Raith,6585,9,9,10,17,33,52,-19,37
Ayr,6585,10,8,13,15,35,56,-21,37
Hibernian,6586,1,18,13,5,55,27,28,67
Dundee Utd,6586,2,18,9,9,54,38,16,63
Morton,6586,3,17,11,8,54,41,13,62
Falkirk,6586,4,16,9,11,56,40,16,57
Raith,6586,5,13,8,15,38,48,-10,47
Dumbarton,6586,6,11,10,15,53,64,-11,43
Queen of S't,6586,7,11,9,16,46,53,-7,42
Ayr,6586,8,10,11,15,33,50,-17,41
Dunfermline,6586,9,8,13,15,45,53,-8,37
St Mirren,6586,10,7,9,20,39,59,-20,30
Hibernian,6587,1,20,12,4,52,23,29,72
Dundee Utd,6587,2,16,10,10,52,36,16,58
Falkirk,6587,3,16,9,11,63,45,18,57
Morton,6587,4,14,14,8,45,37,8,56
Queen of S't,6587,5,12,9,15,44,50,-6,45
Dunfermline,6587,6,9,16,11,45,44,1,43
Raith,6587,7,11,9,16,36,50,-14,42
Dumbarton,6587,8,10,10,16,46,57,-11,40
Ayr,6587,9,10,10,16,36,54,-18,40
St Mirren,6587,10,7,11,18,33,56,-23,32
Hibernian,6588,1,19,13,4,59,24,35,70
Morton,6588,2,18,11,7,51,34,17,65
Dundee Utd,6588,3,18,9,9,51,39,12,63
Falkirk,6588,4,16,10,10,56,40,16,58
Queen of S't,6588,5,11,9,16,46,54,-8,42
Dunfermline,6588,6,9,13,14,46,54,-8,40
Ayr,6588,7,10,10,16,33,53,-20,40
Dumbarton,6588,8,8,12,16,46,58,-12,36
St Mirren,6588,9,8,12,16,38,51,-13,36
Raith,6588,10,9,9,18,35,54,-19,36
Morton,6589,1,20,9,7,51,32,19,69
Hibernian,6589,2,18,12,6,52,26,26,66
Falkirk,6589,3,17,11,8,54,34,20,62
Dundee Utd,6589,4,14,9,13,48,42,6,51
Dumbarton,6589,5,12,10,14,52,54,-2,46
Dunfermline,6589,6,11,11,14,46,49,-3,44
Queen of S't,6589,7,12,8,16,49,54,-5,44
Ayr,6589,8,8,12,16,32,59,-27,36
St Mirren,6589,9,8,11,17,37,53,-16,35
Raith,6589,10,8,11,17,32,50,-18,35
Hibernian,6590,1,22,11,3,61,22,39,77
Falkirk,6590,2,16,11,9,61,38,23,59
Dundee Utd,6590,3,16,11,9,53,41,12,59
Morton,6590,4,15,12,9,45,39,6,57
Dunfermline,6590,5,11,12,13,48,48,0,45
Ayr,6590,6,9,14,13,33,49,-16,41
Queen of S't,6590,7,10,10,16,43,53,-10,40
Dumbarton,6590,8,9,11,16,45,62,-17,38
St Mirren,6590,9,9,10,17,40,55,-15,37
Raith,6590,10,8,8,20,30,52,-22,32
Hibernian,6591,1,20,12,4,56,23,33,72
Dundee Utd,6591,2,18,10,8,60,37,23,64
Falkirk,6591,3,15,11,10,61,47,14,56
Morton,6591,4,15,11,10,49,42,7,56
Queen of S't,6591,5,12,10,14,45,47,-2,46
Dunfermline,6591,6,10,11,15,44,57,-13,41
Raith,6591,7,11,8,17,37,51,-14,41
St Mirren,6591,8,10,9,17,41,57,-16,39
Dumbarton,6591,9,9,11,16,48,57,-9,38
Ayr,6591,10,7,13,16,32,55,-23,34
Hibernian,6592,1,19,12,5,56,30,26,69
Falkirk,6592,2,15,12,9,57,42,15,57
Morton,6592,3,15,11,10,50,43,7,56
Dundee Utd,6592,4,15,9,12,49,42,7,54
Dunfermline,6592,5,13,12,11,52,50,2,51
Queen of S't,6592,6,12,9,15,48,48,0,45
Raith,6592,7,11,10,15,41,51,-10,43
St Mirren,6592,8,10,10,16,44,55,-11,40
Dumbarton,6592,9,9,12,15,50,59,-9,39
Ayr,6592,10,7,11,18,34,61,-27,32
Hibernian,6593,1,17,13,6,56,32,24,64
Falkirk,6593,2,16,12,8,61,40,21,60
Morton,6593,3,15,15,6,51,38,13,60
Dundee Utd,6593,4,15,10,11,48,44,4,55
Queen of S't,6593,5,12,9,15,47,53,-6,45
Dunfermline,6593,6,9,17,10,50,50,0,44
Ayr,6593,7,10,12,14,38,53,-15,42
Raith,6593,8,9,11,16,37,51,-14,38
Dumbarton,6593,9,8,12,16,49,61,-12,36
St Mirren,6593,10,8,11,17,37,52,-15,35
Hibernian,6594,1,19,12,5,55,26,29,69
Falkirk,6594,2,16,10,10,56,41,15,58
Morton,6594,3,15,12,9,47,40,7,57
Dundee Utd,6594,4,13,10,13,46,45,1,49
Queen of S't,6594,5,13,9,14,48,46,2,48
St Mirren,6594,6,11,11,14,42,52,-10,44
Dumbarton,6594,7,10,12,14,47,54,-7,42
Dunfermline,6594,8,9,13,14,43,50,-7,40
Raith,6594,9,10,9,17,35,49,-14,39
Ayr,6594,10,8,14,14,37,53,-16,38
Hibernian,6595,1,18,13,5,53,25,28,67
Morton,6595,2,17,12,7,53,40,13,63
Dundee Utd,6595,3,16,11,9,51,38,13,59
Falkirk,6595,4,15,13,8,62,42,20,58
Raith,6595,5,12,10,14,39,45,-6,46
Dunfermline,6595,6,10,12,14,44,51,-7,42
Queen of S't,6595,7,10,10,16,44,53,-9,40
Ayr,6595,8,8,13,15,34,56,-22,37
Dumbarton,6595,9,8,11,17,46,61,-15,35
St Mirren,6595,10,7,13,16,40,55,-15,34
Hibernian,6596,1,19,13,4,53,22,31,70
Falkirk,6596,2,17,10,9,58,37,21,61
Morton,6596,3,16,10,10,44,36,8,58
Dundee Utd,6596,4,16,9,11,55,41,14,57
Dunfermline,6596,5,12,12,12,52,53,-1,48
Dumbarton,6596,6,10,12,14,50,58,-8,42
Queen of S't,6596,7,10,9,17,41,52,-11,39
Raith,6596,8,9,11,16,36,49,-13,38
Ayr,6596,9,8,14,14,33,53,-20,38
St Mirren,6596,10,8,10,18,37,58,-21,34
Hibernian,6597,1,17,13,6,49,24,25,64
Dundee Utd,6597,2,18,8,10,55,38,17,62
Falkirk,6597,3,16,11,9,57,41,16,59
Morton,6597,4,15,11,10,48,38,10,56
Dumbarton,6597,5,10,12,14,51,58,-7,42
Queen of S't,6597,6,11,9,16,43,52,-9,42
Dunfermline,6597,7,9,14,13,41,47,-6,41
Ayr,6597,8,10,11,15,35,52,-17,41
St Mirren,6597,9,9,12,15,46,57,-11,39
Raith,6597,10,10,9,17,33,51,-18,39
Hibernian,6598,1,21,12,3,56,22,34,75
Morton,6598,2,17,10,9,51,37,14,61
Falkirk,6598,3,17,9,10,61,43,18,60
Dundee Utd,6598,4,15,10,11,56,44,12,55
Queen of S't,6598,5,12,9,15,48,54,-6,45
Raith,6598,6,12,9,15,38,48,-10,45
Dumbarton,6598,7,10,12,14,51,58,-7,42
Dunfermline,6598,8,10,12,14,45,52,-7,42
Ayr,6598,9,8,10,18,36,61,-25,34
St Mirren,6598,10,6,11,19,36,59,-23,29
Hibernian,6599,1,19,13,4,58,28,30,70
Falkirk,6599,2,17,10,9,63,44,19,61
Morton,6599,3,16,13,7,51,35,16,61
Dundee Utd,6599,4,14,11,11,48,40,8,53
Dumbarton,6599,5,10,12,14,49,54,-5,42
Queen of S't,6599,6,11,9,16,45,54,-9,42
St Mirren,6599,7,10,11,15,43,55,-12,41
Ayr,6599,8,10,11,15,35,52,-17,41
Dunfermline,6599,9,8,13,15,46,57,-11,37
Raith,6599,10,9,9,18,37,56,-19,36
Hibernian,6600,1,20,11,5,56,27,29,71
Dundee Utd,6600,2,17,10,9,52,41,11,61
Morton,6600,3,16,12,8,47,35,12,60
Falkirk,6600,4,16,9,11,56,42,14,57
Queen of S't,6600,5,13,9,14,46,50,-4,48
Dunfermline,6600,6,10,15,11,48,45,3,45
Raith,6600,7,12,8,16,37,49,-12,44
Dumbarton,6600,8,8,12,16,47,59,-12,36
Ayr,6600,9,8,11,17,34,54,-20,35
St Mirren,6600,10,7,9,20,37,58,-21,30
Hibernian,6601,1,17,13,6,55,28,27,64
Morton,6601,2,17,13,6,49,32,17,64
Dundee Utd,6601,3,16,12,8,51,35,16,60
Falkirk,6601,4,15,11,10,58,43,15,56
Queen of S't,6601,5,12,10,14,45,47,-2,46
Dumbarton,6601,6,11,12,13,54,54,0,45
Raith,6601,7,11,11,14,39,51,-12,44
Dunfermline,6601,8,8,12,16,43,54,-11,36
Ayr,6601,9,7,13,16,32,55,-23,34
St Mirren,6601,10,7,11,18,35,62,-27,32
Morton,6602,1,18,12,6,53,39,14,66
Hibernian,6602,2,16,16,4,50,24,26,64
Falkirk,6602,3,17,10,9,59,41,18,61
Dundee Utd,6602,4,17,9,10,58,38,20,60
Raith,6602,5,10,12,14,44,53,-9,42
Dumbarton,6602,6,10,11,15,50,61,-11,41
Queen of S't,6602,7,10,10,16,46,55,-9,40
Dunfermline,6602,8,8,14,14,45,56,-11,38
Ayr,6602,9,7,14,15,36,57,-21,35
St Mirren,6602,10,8,10,18,39,56,-17,34
Hibernian,6603,1,18,13,5,53,27,26,67
Morton,6603,2,18,10,8,54,36,18,64
Falkirk,6603,3,16,10,10,56,40,16,58
Dundee Utd,6603,4,16,10,10,50,38,12,58
Dunfermline,6603,5,10,14,12,46,47,-1,44
Queen of S't,6603,6,11,10,15,40,49,-9,43
Raith,6603,7,10,10,16,33,48,-15,40
Ayr,6603,8,9,11,16,36,58,-22,38
Dumbarton,6603,9,9,10,17,50,61,-11,37
St Mirren,6603,10,9,10,17,39,53,-14,37
Hibernian,6604,1,20,12,4,55,23,32,72
Dundee Utd,6604,2,17,10,9,50,38,12,61
Morton,6604,3,16,12,8,47,37,10,60
Falkirk,6604,4,16,11,9,57,44,13,59
Queen of S't,6604,5,13,11,12,54,46,8,50
Dunfermline,6604,6,10,12,14,46,49,-3,42
Raith,6604,7,9,11,16,34,47,-13,38
Ayr,6604,8,8,12,16,36,57,-21,36
Dumbarton,6604,9,8,11,17,47,65,-18,35
St Mirren,6604,10,7,10,19,39,59,-20,31
Falkirk,6605,1,18,10,8,62,39,23,64
Hibernian,6605,2,17,13,6,49,26,23,64
Morton,6605,3,16,14,6,52,38,14,62
Dundee Utd,6605,4,16,11,9,54,44,10,59
Queen of S't,6605,5,12,8,16,48,51,-3,44
St Mirren,6605,6,11,9,16,47,57,-10,42
Dunfermline,6605,7,9,14,13,48,50,-2,41
Raith,6605,8,10,11,15,35,48,-13,41
Dumbarton,6605,9,7,12,17,46,65,-19,33
Ayr,6605,10,7,12,17,35,58,-23,33
Hibernian,6606,1,18,12,6,55,31,24,66
Dundee Utd,6606,2,16,11,9,49,35,14,59
Morton,6606,3,15,13,8,46,35,11,58
Falkirk,6606,4,15,11,10,55,43,12,56
Dunfermline,6606,5,11,13,12,46,46,0,46
Queen of S't,6606,6,10,12,14,49,53,-4,42
Raith,6606,7,11,9,16,37,47,-10,42
Dumbarton,6606,8,9,13,14,49,55,-6,40
St Mirren,6606,9,9,11,16,36,52,-16,38
Ayr,6606,10,8,11,17,32,57,-25,35
Hibernian,6607,1,18,15,3,54,25,29,69
Dundee Utd,6607,2,17,10,9,51,37,14,61
Morton,6607,3,16,12,8,48,36,12,60
Falkirk,6607,4,14,11,11,57,44,13,53
Dumbarton,6607,5,11,12,13,51,53,-2,45
Dunfermline,6607,6,9,14,13,42,46,-4,41
Queen of S't,6607,7,11,8,17,43,54,-11,41
Raith,6607,8,10,10,16,35,49,-14,40
St Mirren,6607,9,8,12,16,40,54,-14,36
Ayr,6607,10,7,14,15,31,54,-23,35
Hibernian,6608,1,20,11,5,57,28,29,71
Morton,6608,2,16,13,7,50,36,14,61
Falkirk,6608,3,17,9,10,59,38,21,60
Dundee Utd,6608,4,16,9,11,48,38,10,57
Queen of S't,6608,5,12,10,14,42,47,-5,46
Dunfermline,6608,6,10,12,14,45,48,-3,42
Ayr,6608,7,10,12,14,34,49,-15,42
Dumbarton,6608,8,9,11,16,49,62,-13,38
Raith,6608,9,9,11,16,31,47,-16,38
St Mirren,6608,10,7,10,19,37,59,-22,31
Hibernian,6609,1,20,11,5,61,25,36,71
Morton,6609,2,17,9,10,50,37,13,60
Dundee Utd,6609,3,16,10,10,52,40,12,58
Falkirk,6609,4,14,12,10,58,47,11,54
Queen of S't,6609,5,11,12,13,48,53,-5,45
Raith,6609,6,11,10,15,38,51,-13,43
Dunfermline,6609,7,9,15,12,47,51,-4,42
Dumbarton,6609,8,10,10,16,51,61,-10,40
Ayr,6609,9,9,10,17,37,56,-19,37
St Mirren,6609,10,9,9,18,39,60,-21,36
Hibernian,6610,1,21,10,5,60,28,32,73
Falkirk,6610,2,17,9,10,59,41,18,60
Morton,6610,3,15,10,11,44,42,2,55
Dundee Utd,6610,4,13,10,13,46,43,3,49
Dunfermline,6610,5,12,12,12,52,46,6,48
Dumbarton,6610,6,12,11,13,56,55,1,47
Queen of S't,6610,7,12,10,14,43,47,-4,46
St Mirren,6610,8,10,9,17,42,59,-17,39
Ayr,6610,9,9,10,17,38,57,-19,37
Raith,6610,10,9,9,18,29,51,-22,36
Hibernian,6611,1,21,12,3,56,23,33,75
Morton,6611,2,16,11,9,48,40,8,59
Dundee Utd,6611,3,16,10,10,51,41,10,58
Falkirk,6611,4,15,12,9,54,40,14,57
Dunfermline,6611,5,12,12,12,53,49,4,48
Dumbarton,6611,6,10,12,14,53,59,-6,42
Queen of S't,6611,7,10,9,17,40,51,-11,39
St Mirren,6611,8,8,12,16,41,55,-14,36
Raith,6611,9,8,11,17,34,50,-16,35
Ayr,6611,10,8,11,17,36,58,-22,35
Hibernian,6612,1,20,11,5,62,25,37,71
Morton,6612,2,20,10,6,55,34,21,70
Falkirk,6612,3,16,10,10,58,42,16,58
Dundee Utd,6612,4,16,9,11,46,40,6,57
Queen of S't,6612,5,13,8,15,45,50,-5,47
Dunfermline,6612,6,11,12,13,47,48,-1,45
Raith,6612,7,10,10,16,33,50,-17,40
Dumbarton,6612,8,8,11,17,45,59,-14,35
Ayr,6612,9,8,11,17,34,54,-20,35
St Mirren,6612,10,7,10,19,38,61,-23,31
Hibernian,6613,1,20,11,5,57,26,31,71
Dundee Utd,6613,2,16,11,9,51,37,14,59
Falkirk,6613,3,15,13,8,58,37,21,58
Morton,6613,4,15,12,9,49,36,13,57
Raith,6613,5,13,9,14,40,45,-5,48
Dunfermline,6613,6,10,14,12,46,47,-1,44
Queen of S't,6613,7,10,12,14,46,54,-8,42
Dumbarton,6613,8,8,12,16,46,62,-16,36
St Mirren,6613,9,8,10,18,37,60,-23,34
Ayr,6613,10,6,14,16,33,59,-26,32
Hibernian,6614,1,20,10,6,57,27,30,70
Falkirk,6614,2,19,9,8,62,38,24,66
Dundee Utd,6614,3,16,9,11,50,41,9,57
Morton,6614,4,13,13,10,45,40,5,52
Dunfermline,6614,5,11,14,11,46,45,1,47
Queen of S't,6614,6,11,10,15,46,51,-5,43
Dumbarton,6614,7,10,12,14,51,57,-6,42
Raith,6614,8,9,10,17,33,48,-15,37
St Mirren,6614,9,9,10,17,36,58,-22,37
Ayr,6614,10,7,13,16,30,51,-21,34
Hibernian,6615,1,19,12,5,56,29,27,69
Morton,6615,2,17,12,7,59,40,19,63
Dundee Utd,6615,3,17,10,9,55,41,14,61
Falkirk,6615,4,17,9,10,57,39,18,60
Queen of S't,6615,5,12,10,14,42,49,-7,46
Raith,6615,6,11,10,15,35,46,-11,43
Dumbarton,6615,7,9,10,17,47,60,-13,37
Dunfermline,6615,8,8,12,16,43,51,-8,36
St Mirren,6615,9,8,12,16,39,54,-15,36
Ayr,6615,10,8,11,17,36,60,-24,35
Hibernian,6616,1,18,12,6,52,26,26,66
Falkirk,6616,2,18,10,8,59,38,21,64
Dundee Utd,6616,3,17,9,10,54,41,13,60
Morton,6616,4,16,11,9,47,39,8,59
Queen of S't,6616,5,12,10,14,51,52,-1,46
St Mirren,6616,6,11,10,15,46,50,-4,43
Raith,6616,7,10,9,17,37,51,-14,39
Ayr,6616,8,9,12,15,37,56,-19,39
Dumbarton,6616,9,9,10,17,49,67,-18,37
Dunfermline,6616,10,8,11,17,42,54,-12,35
Hibernian,6617,1,21,11,4,55,23,32,74
Morton,6617,2,17,11,8,51,37,14,62
Falkirk,6617,3,17,10,9,57,36,21,61
Dundee Utd,6617,4,14,11,11,46,40,6,53
Queen of S't,6617,5,12,8,16,48,48,0,44
Dumbarton,6617,6,11,10,15,46,59,-13,43
St Mirren,6617,7,9,12,15,45,49,-4,39
Dunfermline,6617,8,8,13,15,41,53,-12,37
Raith,6617,9,9,10,17,34,54,-20,37
Ayr,6617,10,8,12,16,29,53,-24,36
Hibernian,6618,1,18,14,4,53,24,29,68
Morton,6618,2,18,10,8,55,38,17,64
Dundee Utd,6618,3,16,10,10,56,47,9,58
Falkirk,6618,4,14,12,10,57,44,13,54
Raith,6618,5,12,10,14,40,47,-7,46
Queen of S't,6618,6,11,11,14,46,49,-3,44
Dumbarton,6618,7,10,11,15,49,58,-9,41
Dunfermline,6618,8,8,16,12,43,47,-4,40
St Mirren,6618,9,8,10,18,40,57,-17,34
Ayr,6618,10,7,12,17,33,61,-28,33
Hibernian,6619,1,20,12,4,59,29,30,72
Dundee Utd,6619,2,17,11,8,51,36,15,62
Morton,6619,3,17,10,9,54,40,14,61
Falkirk,6619,4,14,13,9,55,41,14,55
Dunfermline,6619,5,10,13,13,49,53,-4,43
Queen of S't,6619,6,10,13,13,45,51,-6,43
Raith,6619,7,10,10,16,36,50,-14,40
Dumbarton,6619,8,8,13,15,50,58,-8,37
Ayr,6619,9,8,12,16,33,53,-20,36
St Mirren,6619,10,7,11,18,40,61,-21,32
Hibernian,6620,1,19,12,5,54,26,28,69
Morton,6620,2,18,10,8,54,36,18,64
Dundee Utd,6620,3,18,9,9,53,38,15,63
Falkirk,6620,4,15,10,11,58,44,14,55
Queen of S't,6620,5,12,10,14,46,47,-1,46
Raith,6620,6,12,10,14,39,47,-8,46
Dunfermline,6620,7,9,12,15,45,54,-9,39
Ayr,6620,8,7,14,15,32,53,-21,35
Dumbarton,6620,9,7,13,16,47,64,-17,34
St Mirren,6620,10,7,12,17,36,55,-19,33
Hibernian,6621,1,21,10,5,61,31,30,73
Falkirk,6621,2,15,13,8,60,40,20,58
Dundee Utd,6621,3,15,12,9,47,37,10,57
Morton,6621,4,15,11,10,48,41,7,56
Dunfermline,6621,5,12,13,11,53,44,9,49
Queen of S't,6621,6,12,9,15,49,53,-4,45
Raith,6621,7,11,9,16,37,52,-15,42
Dumbarton,6621,8,8,13,15,45,58,-13,37
St Mirren,6621,9,8,10,18,36,57,-21,34
Ayr,6621,10,7,12,17,32,55,-23,33
Hibernian,6622,1,20,12,4,56,24,32,72
Falkirk,6622,2,16,12,8,59,37,22,60
Morton,6622,3,15,12,9,47,37,10,57
Dundee Utd,6622,4,14,12,10,45,37,8,54
Dunfermline,6622,5,12,12,12,48,45,3,48
Queen of S't,6622,6,11,10,15,47,51,-4,43
St Mirren,6622,7,10,10,16,43,52,-9,40
Ayr,6622,8,9,13,14,32,53,-21,40
Raith,6622,9,9,10,17,32,54,-22,37
Dumbarton,6622,10,7,11,18,44,63,-19,32
Hibernian,6623,1,19,13,4,53,25,28,70
Morton,6623,2,17,11,8,53,38,15,62
Falkirk,6623,3,16,11,9,64,43,21,59
Dundee Utd,6623,4,16,8,12,47,45,2,56
Queen of S't,6623,5,12,9,15,48,48,0,45
Raith,6623,6,12,8,16,39,53,-14,44
Dumbarton,6623,7,11,10,15,51,61,-10,43
Dunfermline,6623,8,9,12,15,52,55,-3,39
Ayr,6623,9,8,12,16,36,56,-20,36
St Mirren,6623,10,8,10,18,36,55,-19,34
Hibernian,6624,1,19,12,5,55,24,31,69
Morton,6624,2,18,11,7,51,34,17,65
Dundee Utd,6624,3,17,10,9,51,36,15,61
Falkirk,6624,4,15,10,11,53,40,13,55
Dunfermline,6624,5,10,12,14,47,50,-3,42
Queen of S't,6624,6,11,9,16,41,51,-10,42
Dumbarton,6624,7,9,12,15,47,55,-8,39
St Mirren,6624,8,9,12,15,42,54,-12,39
Raith,6624,9,10,8,18,35,55,-20,38
Ayr,6624,10,8,12,16,34,57,-23,36
Hibernian,6625,1,20,11,5,59,28,31,71
Falkirk,6625,2,16,11,9,60,40,20,59
Morton,6625,3,14,13,9,47,38,9,55
Dundee Utd,6625,4,14,11,11,49,40,9,53
Dunfermline,6625,5,10,15,11,46,44,2,45
Dumbarton,6625,6,9,13,14,46,56,-10,40
Queen of S't,6625,7,10,10,16,41,54,-13,40
Raith,6625,8,10,10,16,35,50,-15,40
Ayr,6625,9,9,13,14,36,54,-18,40
St Mirren,6625,10,9,11,16,42,57,-15,38
Hibernian,6626,1,18,12,6,58,29,29,66
Morton,6626,2,17,13,6,45,29,16,64
Dundee Utd,6626,3,16,11,9,49,35,14,59
Falkirk,6626,4,16,9,11,60,42,18,57
Queen of S't,6626,5,13,8,15,41,50,-9,47
Dunfermline,6626,6,11,13,12,47,46,1,46
Ayr,6626,7,9,12,15,36,58,-22,39
Raith,6626,8,10,8,18,39,54,-15,38
Dumbarton,6626,9,8,12,16,45,56,-11,36
St Mirren,6626,10,7,12,17,39,60,-21,33
Hibernian,6627,1,19,12,5,62,32,30,69
Morton,6627,2,16,12,8,49,39,10,60
Falkirk,6627,3,16,10,10,60,45,15,58
Dundee Utd,6627,4,15,11,10,48,39,9,56
Dunfermline,6627,5,11,13,12,46,46,0,46
Dumbarton,6627,6,11,12,13,52,57,-5,45
Queen of S't,6627,7,11,11,14,48,53,-5,44
Raith,6627,8,9,11,16,36,51,-15,38
Ayr,6627,9,8,11,17,36,56,-20,35
St Mirren,6627,10,7,11,18,41,60,-19,32
Hibernian,6628,1,20,11,5,59,27,32,71
Morton,6628,2,17,10,9,51,37,14,61
Falkirk,6628,3,16,9,11,60,41,19,57
Dundee Utd,6628,4,15,10,11,52,45,7,55
Dunfermline,6628,5,11,13,12,43,45,-2,46
Queen of S't,6628,6,11,10,15,46,53,-7,43
Raith,6628,7,10,10,16,35,56,-21,40
Dumbarton,6628,8,9,12,15,51,60,-9,39
Ayr,6628,9,9,11,16,36,57,-21,38
St Mirren,6628,10,8,12,16,44,56,-12,36
Hibernian,6629,1,17,15,4,51,23,28,66
Morton,6629,2,18,10,8,54,41,13,64
Falkirk,6629,3,15,10,11,55,40,15,55
Dundee Utd,6629,4,15,10,11,48,40,8,55
Queen of S't,6629,5,13,10,13,43,45,-2,49
Dumbarton,6629,6,11,11,14,52,58,-6,44
Raith,6629,7,11,10,15,42,51,-9,43
Dunfermline,6629,8,9,13,14,45,49,-4,40
St Mirren,6629,9,9,10,17,40,57,-17,37
Ayr,6629,10,7,11,18,29,55,-26,32
Hibernian,6630,1,19,12,5,53,25,28,69
Dundee Utd,6630,2,16,11,9,56,40,16,59
Falkirk,6630,3,15,12,9,57,38,19,57
Morton,6630,4,15,12,9,50,40,10,57
Ayr,6630,5,13,11,12,41,49,-8,50
Queen of S't,6630,6,12,10,14,49,52,-3,46
Dumbarton,6630,7,10,11,15,52,64,-12,41
Dunfermline,6630,8,8,14,14,48,54,-6,38
Raith,6630,9,9,9,18,33,52,-19,36
St Mirren,6630,10,7,10,19,37,62,-25,31
Dundee Utd,6631,1,20,8,8,53,34,19,68
Hibernian,6631,2,18,12,6,55,29,26,66
Falkirk,6631,3,17,11,8,61,39,22,62
Morton,6631,4,16,10,10,49,35,14,58
Dunfermline,6631,5,10,13,13,44,46,-2,43
Queen of S't,6631,6,11,9,16,44,53,-9,42
Raith,6631,7,10,11,15,36,49,-13,41
Dumbarton,6631,8,10,10,16,49,61,-12,40
St Mirren,6631,9,9,10,17,38,54,-16,37
Ayr,6631,10,7,10,19,30,59,-29,31
Hibernian,6632,1,18,13,5,54,26,28,67
Falkirk,6632,2,16,13,7,64,42,22,61
Dundee Utd,6632,3,16,11,9,50,42,8,59
Morton,6632,4,15,12,9,48,36,12,57
Dunfermline,6632,5,11,12,13,43,47,-4,45
Raith,6632,6,11,10,15,36,48,-12,43
Queen of S't,6632,7,11,8,17,51,60,-9,41
Ayr,6632,8,9,13,14,36,52,-16,40
St Mirren,6632,9,8,11,17,40,54,-14,35
Dumbarton,6632,10,8,11,17,48,63,-15,35
Hibernian,6633,1,19,13,4,58,28,30,70
Dundee Utd,6633,2,18,8,10,52,36,16,62
Falkirk,6633,3,17,10,9,55,42,13,61
Morton,6633,4,16,12,8,48,36,12,60
Dunfermline,6633,5,11,13,12,50,46,4,46
Queen of S't,6633,6,11,10,15,47,51,-4,43
Dumbarton,6633,7,9,10,17,45,59,-14,37
Raith,6633,8,9,10,17,37,53,-16,37
Ayr,6633,9,8,13,15,33,55,-22,37
St Mirren,6633,10,7,11,18,35,54,-19,32
Hibernian,6634,1,21,11,4,59,24,35,74
Morton,6634,2,17,11,8,51,36,15,62
Dundee Utd,6634,3,15,10,11,50,42,8,55
Falkirk,6634,4,14,11,11,56,46,10,53
Queen of S't,6634,5,14,9,13,49,45,4,51
St Mirren,6634,6,11,9,16,49,55,-6,42
Raith,6634,7,10,10,16,34,52,-18,40
Dumbarton,6634,8,9,12,15,46,56,-10,39
Dunfermline,6634,9,7,15,14,41,52,-11,36
Ayr,6634,10,7,12,17,32,59,-27,33
Hibernian,6635,1,19,14,3,61,27,34,71
Morton,6635,2,15,13,8,52,40,12,58
Falkirk,6635,3,15,11,10,57,42,15,56
Dundee Utd,6635,4,15,10,11,52,43,9,55
Queen of S't,6635,5,14,9,13,50,51,-1,51
Raith,6635,6,13,9,14,40,45,-5,48
Dunfermline,6635,7,8,13,15,45,58,-13,37
Ayr,6635,8,8,13,15,41,59,-18,37
Dumbarton,6635,9,8,11,17,47,64,-17,35
St Mirren,6635,10,7,13,16,43,59,-16,34
Hibernian,6636,1,18,14,4,57,29,28,68
Morton,6636,2,17,13,6,54,35,19,64
Dundee Utd,6636,3,18,10,8,56,38,18,64
Falkirk,6636,4,17,11,8,59,41,18,62
Queen of S't,6636,5,11,8,17,47,54,-7,41
Dumbarton,6636,6,10,11,15,49,58,-9,41
Raith,6636,7,11,8,17,36,50,-14,41
Dunfermline,6636,8,8,14,14,46,53,-7,38
Ayr,6636,9,8,10,18,33,60,-27,34
St Mirren,6636,10,8,9,19,35,54,-19,33
Hibernian,6637,1,19,10,7,53,27,26,67
Dundee Utd,6637,2,18,9,9,54,38,16,63
Morton,6637,3,16,11,9,50,38,12,59
Dunfermline,6637,4,14,12,10,49,41,8,54
Falkirk,6637,5,14,11,11,54,42,12,53
Raith,6637,6,12,10,14,41,49,-8,46
Dumbarton,6637,7,9,13,14,51,58,-7,40
Queen of S't,6637,8,10,10,16,42,51,-9,40
St Mirren,6637,9,8,10,18,39,58,-19,34
Ayr,6637,10,7,10,19,30,61,-31,31
Hibernian,6638,1,19,11,6,55,25,30,68
Morton,6638,2,18,9,9,52,38,14,63
Falkirk,6638,3,16,10,10,56,43,13,58
Dundee Utd,6638,4,14,10,12,48,43,5,52
Dunfermline,6638,5,12,12,12,50,44,6,48
Queen of S't,6638,6,11,9,16,42,51,-9,42
St Mirren,6638,7,10,11,15,41,53,-12,41
Raith,6638,8,10,10,16,33,49,-16,40
Ayr,6638,9,9,12,15,39,59,-20,39
Dumbarton,6638,10,9,10,17,47,58,-11,37
Hibernian,6639,1,21,12,3,58,20,38,75
Falkirk,6639,2,17,10,9,63,39,24,61
Morton,6639,3,15,14,7,47,34,13,59
Dundee Utd,6639,4,15,10,11,52,50,2,55
Queen of S't,6639,5,11,11,14,45,50,-5,44
Ayr,6639,6,10,12,14,34,51,-17,42
Dunfermline,6639,7,8,13,15,42,51,-9,37
Dumbarton,6639,8,8,13,15,45,57,-12,37
Raith,6639,9,9,10,17,35,55,-20,37
St Mirren,6639,10,8,11,17,42,56,-14,35
Hibernian,6640,1,20,13,3,57,24,33,73
Dundee Utd,6640,2,16,10,10,50,38,12,58
Falkirk,6640,3,16,9,11,61,48,13,57
Morton,6640,4,15,11,10,44,34,10,56
Queen of S't,6640,5,12,10,14,46,52,-6,46
Raith,6640,6,10,12,14,38,49,-11,42
Dumbarton,6640,7,10,11,15,46,56,-10,41
Ayr,6640,8,8,15,13,35,48,-13,39
Dunfermline,6640,9,9,11,16,45,52,-7,38
St Mirren,6640,10,7,12,17,34,55,-21,33
Hibernian,6641,1,21,10,5,60,23,37,73
Falkirk,6641,2,17,10,9,62,43,19,61
Morton,6641,3,15,11,10,52,45,7,56
Dundee Utd,6641,4,14,11,11,53,46,7,53
Dunfermline,6641,5,11,14,11,55,52,3,47
Dumbarton,6641,6,10,11,15,50,59,-9,41
St Mirren,6641,7,10,10,16,42,53,-11,40
Raith,6641,8,10,10,16,40,54,-14,40
Queen of S't,6641,9,10,10,16,45,60,-15,40
Ayr,6641,10,8,11,17,33,57,-24,35
Hibernian,6642,1,20,11,5,55,25,30,71
Falkirk,6642,2,16,10,10,54,37,17,58
Morton,6642,3,15,12,9,45,35,10,57
Dundee Utd,6642,4,15,11,10,48,41,7,56
Dunfermline,6642,5,12,11,13,47,45,2,47
Queen of S't,6642,6,12,9,15,46,52,-6,45
Raith,6642,7,10,10,16,35,49,-14,40
St Mirren,6642,8,9,11,16,39,50,-11,38
Dumbarton,6642,9,9,10,17,46,62,-16,37
Ayr,6642,10,8,13,15,37,56,-19,37
Hibernian,6643,1,19,14,3,54,24,30,71
Falkirk,6643,2,16,10,10,59,44,15,58
Morton,6643,3,15,12,9,45,34,11,57
Dundee Utd,6643,4,15,10,11,45,39,6,55
Dunfermline,6643,5,11,14,11,45,43,2,47
Queen of S't,6643,6,12,10,14,48,50,-2,46
Dumbarton,6643,7,10,11,15,49,58,-9,41
Raith,6643,8,9,11,16,33,49,-16,38
St Mirren,6643,9,8,11,17,37,53,-16,35
Ayr,6643,10,8,11,17,34,55,-21,35
Hibernian,6644,1,20,11,5,58,23,35,71
Morton,6644,2,17,11,8,50,36,14,62
Falkirk,6644,3,17,10,9,58,44,14,61
Dundee Utd,6644,4,14,9,13,50,45,5,51
Queen of S't,6644,5,13,9,14,49,47,2,48
Raith,6644,6,11,10,15,36,47,-11,43
Dumbarton,6644,7,9,12,15,47,58,-11,39
Ayr,6644,8,9,11,16,34,59,-25,38
Dunfermline,6644,9,8,13,15,43,53,-10,37
St Mirren,6644,10,8,12,16,41,54,-13,36
Hibernian,6645,1,17,14,5,50,24,26,65
Dundee Utd,6645,2,17,9,10,52,41,11,60
Morton,6645,3,16,11,9,49,39,10,59
Falkirk,6645,4,14,12,10,55,42,13,54
Raith,6645,5,12,10,14,42,48,-6,46
Dunfermline,6645,6,11,12,13,52,50,2,45
Queen of S't,6645,7,10,13,13,43,46,-3,43
Dumbarton,6645,8,9,12,15,50,59,-9,39
St Mirren,6645,9,9,10,17,40,60,-20,37
Ayr,6645,10,7,13,16,32,56,-24,34
Falkirk,6646,1,19,9,8,65,39,26,66
Hibernian,6646,2,17,13,6,58,31,27,64
Morton,6646,3,16,11,9,54,46,8,59
Dundee Utd,6646,4,16,10,10,51,40,11,58
Raith,6646,5,12,9,15,41,51,-10,45
Dumbarton,6646,6,10,11,15,47,58,-11,41
Queen of S't,6646,7,10,11,15,43,54,-11,41
Dunfermline,6646,8,8,15,13,47,51,-4,39
Ayr,6646,9,8,13,15,35,54,-19,37
St Mirren,6646,10,7,12,17,38,55,-17,33
Hibernian,6647,1,19,12,5,62,34,28,69
Dundee Utd,6647,2,17,10,9,54,37,17,61
Falkirk,6647,3,17,9,10,59,37,22,60
Morton,6647,4,16,11,9,54,48,6,59
Queen of S't,6647,5,13,8,15,47,51,-4,47
Ayr,6647,6,11,10,15,33,53,-20,43
Dumbarton,6647,7,10,10,16,51,60,-9,40
St Mirren,6647,8,9,11,16,45,58,-13,38
Raith,6647,9,9,9,18,34,51,-17,36
Dunfermline,6647,10,7,14,15,43,53,-10,35
Morton,6648,1,19,11,6,47,29,18,68
Hibernian,6648,2,17,14,5,48,23,25,65
Falkirk,6648,3,18,10,8,62,41,21,64
Dundee Utd,6648,4,15,12,9,50,37,13,57
Raith,6648,5,11,9,16,37,49,-12,42
Dunfermline,6648,6,9,13,14,43,48,-5,40
Queen of S't,6648,7,10,9,17,44,56,-12,39
St Mirren,6648,8,9,11,16,41,54,-13,38
Ayr,6648,9,8,13,15,32,54,-22,37
Dumbarton,6648,10,7,12,17,50,63,-13,33
Hibernian,6649,1,18,12,6,57,26,31,66
Falkirk,6649,2,17,10,9,58,40,18,61
Morton,6649,3,16,12,8,49,37,12,60
Dundee Utd,6649,4,15,8,13,52,44,8,53
Queen of S't,6649,5,14,8,14,46,48,-2,50
Dunfermline,6649,6,12,12,12,46,46,0,48
Raith,6649,7,10,10,16,34,48,-14,40
Dumbarton,6649,8,9,12,15,50,62,-12,39
St Mirren,6649,9,9,10,17,40,57,-17,37
Ayr,6649,10,7,12,17,32,56,-24,33
Hibernian,6650,1,18,12,6,52,25,27,66
Morton,6650,2,17,12,7,51,35,16,63
Falkirk,6650,3,16,13,7,62,38,24,61
Dundee Utd,6650,4,15,10,11,53,44,9,55
Queen of S't,6650,5,12,11,13,46,47,-1,47
Dunfermline,6650,6,9,14,13,42,51,-9,41
Ayr,6650,7,9,13,14,34,50,-16,40
Dumbarton,6650,8,8,13,15,45,57,-12,37
St Mirren,6650,9,8,12,16,43,58,-15,36
Raith,6650,10,8,10,18,34,57,-23,34
Hibernian,6651,1,19,13,4,53,25,28,70
Falkirk,6651,2,18,11,7,68,34,34,65
Morton,6651,3,18,10,8,57,36,21,64
Dundee Utd,6651,4,14,11,11,47,44,3,53
Queen of S't,6651,5,13,10,13,46,48,-2,49
Dumbarton,6651,6,10,13,13,52,54,-2,43
Dunfermline,6651,7,9,12,15,42,54,-12,39
Ayr,6651,8,8,13,15,32,51,-19,37
St Mirren,6651,9,7,11,18,39,63,-24,32
Raith,6651,10,8,8,20,32,59,-27,32
Hibernian,6652,1,18,13,5,54,27,27,67
Morton,6652,2,18,12,6,47,31,16,66
Dundee Utd,6652,3,18,9,9,53,35,18,63
Falkirk,6652,4,13,10,13,52,47,5,49
Dunfermline,6652,5,11,12,13,49,48,1,45
Queen of S't,6652,6,11,9,16,42,50,-8,42
Dumbarton,6652,7,10,10,16,46,57,-11,40
Raith,6652,8,10,10,16,33,49,-16,40
Ayr,6652,9,10,10,16,38,55,-17,40
St Mirren,6652,10,9,9,18,40,55,-15,36
Hibernian,6653,1,22,10,4,61,27,34,76
Morton,6653,2,17,11,8,50,36,14,62
Dundee Utd,6653,3,16,11,9,51,36,15,59
Falkirk,6653,4,16,10,10,57,42,15,58
Dunfermline,6653,5,10,13,13,48,47,1,43
Queen of S't,6653,6,11,9,16,47,53,-6,42
St Mirren,6653,7,10,9,17,41,57,-16,39
Ayr,6653,8,9,10,17,33,55,-22,37
Dumbarton,6653,9,8,12,16,44,59,-15,36
Raith,6653,10,8,11,17,32,52,-20,35
Hibernian,6654,1,19,11,6,55,30,25,68
Falkirk,6654,2,17,11,8,61,42,19,62
Dundee Utd,6654,3,17,11,8,56,39,17,62
Morton,6654,4,15,12,9,48,39,9,57
Dunfermline,6654,5,12,12,12,56,51,5,48
Raith,6654,6,11,9,16,41,53,-12,42
Queen of S't,6654,7,10,10,16,47,54,-7,40
Ayr,6654,8,9,12,15,36,56,-20,39
St Mirren,6654,9,8,10,18,46,62,-16,34
Dumbarton,6654,10,7,12,17,47,67,-20,33
Morton,6655,1,16,14,6,49,35,14,62
Hibernian,6655,2,16,13,7,52,32,20,61
Falkirk,6655,3,15,12,9,61,44,17,57
Dundee Utd,6655,4,15,10,11,51,42,9,55
Dunfermline,6655,5,12,14,10,59,51,8,50
Queen of S't,6655,6,13,8,15,46,51,-5,47
Ayr,6655,7,10,12,14,37,54,-17,42
St Mirren,6655,8,10,11,15,42,52,-10,41
Raith,6655,9,9,9,18,32,50,-18,36
Dumbarton,6655,10,7,11,18,48,66,-18,32
Hibernian,6656,1,21,10,5,62,25,37,73
Morton,6656,2,18,10,8,48,32,16,64
Dundee Utd,6656,3,18,8,10,50,40,10,62
Falkirk,6656,4,17,10,9,61,42,19,61
Raith,6656,5,11,9,16,37,54,-17,42
Dunfermline,6656,6,9,13,14,49,50,-1,40
Dumbarton,6656,7,9,12,15,45,55,-10,39
Queen of S't,6656,8,10,9,17,42,55,-13,39
Ayr,6656,9,9,10,17,34,54,-20,37
St Mirren,6656,10,8,9,19,38,59,-21,33
Hibernian,6657,1,20,12,4,54,22,32,72
Morton,6657,2,16,12,8,53,42,11,60
Dundee Utd,6657,3,16,11,9,53,39,14,59
Falkirk,6657,4,16,9,11,60,42,18,57
Queen of S't,6657,5,13,9,14,45,44,1,48
Dunfermline,6657,6,10,13,13,48,51,-3,43
Dumbarton,6657,7,10,12,14,48,59,-11,42
Raith,6657,8,10,9,17,31,50,-19,39
Ayr,6657,9,7,13,16,31,52,-21,34
St Mirren,6657,10,7,10,19,39,61,-22,31
Hibernian,6658,1,20,13,3,52,22,30,73
Morton,6658,2,16,11,9,50,39,11,59
Dundee Utd,6658,3,16,10,10,53,41,12,58
Falkirk,6658,4,16,9,11,58,41,17,57
Queen of S't,6658,5,12,9,15,43,47,-4,45
Dunfermline,6658,6,9,14,13,41,45,-4,41
St Mirren,6658,7,10,10,16,45,53,-8,40
Dumbarton,6658,8,9,11,16,45,56,-11,38
Raith,6658,9,9,10,17,31,52,-21,37
Ayr,6658,10,8,13,15,31,53,-22,37
Hibernian,6659,1,21,12,3,57,22,35,75
Dundee Utd,6659,2,17,9,10,51,41,10,60
Morton,6659,3,16,10,10,52,40,12,58
Falkirk,6659,4,15,11,10,59,41,18,56
Raith,6659,5,13,9,14,37,44,-7,48
Dumbarton,6659,6,11,12,13,51,53,-2,45
Queen of S't,6659,7,10,11,15,42,51,-9,41
Dunfermline,6659,8,8,14,14,44,52,-8,38
Ayr,6659,9,7,11,18,32,56,-24,32
St Mirren,6659,10,7,11,18,33,58,-25,32
Hibernian,6660,1,18,14,4,50,23,27,68
Morton,6660,2,16,12,8,49,36,13,60
Falkirk,6660,3,16,11,9,60,38,22,59
Dundee Utd,6660,4,14,11,11,51,45,6,53
Queen of S't,6660,5,13,9,14,52,53,-1,48
Dunfermline,6660,6,9,15,12,48,53,-5,42
Ayr,6660,7,10,11,15,36,56,-20,41
Raith,6660,8,9,11,16,35,51,-16,38
St Mirren,6660,9,9,10,17,42,54,-12,37
Dumbarton,6660,10,8,12,16,46,60,-14,36
Hibernian,6661,1,19,12,5,58,27,31,69
Dundee Utd,6661,2,17,10,9,57,38,19,61
Morton,6661,3,16,12,8,52,40,12,60
Falkirk,6661,4,14,10,12,54,44,10,52
Queen of S't,6661,5,12,8,16,45,54,-9,44
Raith,6661,6,11,11,14,36,46,-10,44
Dumbarton,6661,7,10,11,15,50,59,-9,41
Dunfermline,6661,8,9,13,14,46,52,-6,40
St Mirren,6661,9,10,10,16,43,55,-12,40
Ayr,6661,10,6,15,15,35,61,-26,33
Hibernian,6662,1,19,13,4,53,23,30,70
Morton,6662,2,17,11,8,52,38,14,62
Dundee Utd,6662,3,15,12,9,50,39,11,57
Falkirk,6662,4,15,11,10,57,41,16,56
Queen of S't,6662,5,12,10,14,49,48,1,46
Raith,6662,6,12,10,14,39,47,-8,46
Dunfermline,6662,7,9,14,13,45,48,-3,41
Dumbarton,6662,8,9,13,14,46,55,-9,40
St Mirren,6662,9,8,11,17,40,56,-16,35
Ayr,6662,10,6,11,19,28,64,-36,29
Hibernian,6663,1,19,13,4,58,26,32,70
Morton,6663,2,17,13,6,51,35,16,64
Dundee Utd,6663,3,16,9,11,51,45,6,57
Falkirk,6663,4,14,10,12,56,45,11,52
Queen of S't,6663,5,13,9,14,45,48,-3,48
Dumbarton,6663,6,10,12,14,49,55,-6,42
Dunfermline,6663,7,9,12,15,44,50,-6,39
Ayr,6663,8,9,12,15,35,51,-16,39
Raith,6663,9,10,9,17,31,49,-18,39
St Mirren,6663,10,8,11,17,36,52,-16,35
Hibernian,6664,1,20,12,4,58,21,37,72
Morton,6664,2,17,11,8,52,37,15,62
Falkirk,6664,3,17,10,9,57,42,15,61
Dundee Utd,6664,4,15,10,11,52,45,7,55
Queen of S't,6664,5,11,11,14,45,49,-4,44
Dunfermline,6664,6,10,12,14,43,51,-8,42
Raith,6664,7,10,11,15,34,46,-12,41
Dumbarton,6664,8,9,12,15,46,55,-9,39
St Mirren,6664,9,8,10,18,35,55,-20,34
Ayr,6664,10,7,13,16,34,55,-21,34
Hibernian,6665,1,19,12,5,63,30,33,69
Falkirk,6665,2,17,9,10,61,43,18,60
Morton,6665,3,15,11,10,49,44,5,56
Dundee Utd,6665,4,15,9,12,50,45,5,54
Queen of S't,6665,5,13,8,15,51,55,-4,47
Ayr,6665,6,12,10,14,37,48,-11,46
Dunfermline,6665,7,10,14,12,47,47,0,44
Raith,6665,8,11,8,17,36,49,-13,41
Dumbarton,6665,9,10,10,16,49,58,-9,40
St Mirren,6665,10,8,9,19,38,62,-24,33
Hibernian,6666,1,20,11,5,57,29,28,71
Morton,6666,2,17,10,9,56,39,17,61
Dundee Utd,6666,3,16,11,9,49,37,12,59
Falkirk,6666,4,15,12,9,54,39,15,57
Raith,6666,5,11,10,15,38,48,-10,43
Dumbarton,6666,6,9,13,14,47,55,-8,40
Queen of S't,6666,7,10,10,16,43,52,-9,40
St Mirren,6666,8,9,11,16,40,53,-13,38
Ayr,6666,9,9,11,16,34,56,-22,38
Dunfermline,6666,10,8,13,15,39,49,-10,37
Hibernian,6667,1,18,12,6,55,30,25,66
Falkirk,6667,2,17,10,9,57,43,14,61
Morton,6667,3,17,10,9,51,42,9,61
Dundee Utd,6667,4,16,10,10,57,41,16,58
Queen of S't,6667,5,13,8,15,47,51,-4,47
Dunfermline,6667,6,10,12,14,56,56,0,42
Dumbarton,6667,7,9,12,15,46,58,-12,39
Raith,6667,8,10,9,17,37,51,-14,39
Ayr,6667,9,9,12,15,35,52,-17,39
St Mirren,6667,10,8,11,17,40,57,-17,35
Hibernian,6668,1,20,13,3,58,23,35,73
Falkirk,6668,2,16,11,9,58,41,17,59
Dundee Utd,6668,3,16,11,9,47,36,11,59
Morton,6668,4,14,12,10,47,38,9,54
Queen of S't,6668,5,12,11,13,44,46,-2,47
Dunfermline,6668,6,10,13,13,48,51,-3,43
Raith,6668,7,11,9,16,38,50,-12,42
Dumbarton,6668,8,9,11,16,51,61,-10,38
St Mirren,6668,9,8,10,18,37,57,-20,34
Ayr,6668,10,7,13,16,31,56,-25,34
Hibernian,6669,1,17,16,3,52,24,28,67
Falkirk,6669,2,17,12,7,60,38,22,63
Morton,6669,3,14,15,7,44,34,10,57
Dundee Utd,6669,4,14,11,11,48,40,8,53
Queen of S't,6669,5,12,10,14,45,51,-6,46
Dunfermline,6669,6,9,14,13,44,50,-6,41
Raith,6669,7,9,12,15,36,50,-14,39
Dumbarton,6669,8,8,13,15,46,55,-9,37
St Mirren,6669,9,8,13,15,38,51,-13,37
Ayr,6669,10,7,14,15,35,55,-20,35
Hibernian,6670,1,18,13,5,55,28,27,67
Morton,6670,2,18,10,8,53,36,17,64
Dundee Utd,6670,3,18,10,8,54,38,16,64
Falkirk,6670,4,15,11,10,59,43,16,56
Queen of S't,6670,5,13,8,15,45,50,-5,47
Dunfermline,6670,6,10,12,14,45,47,-2,42
Raith,6670,7,10,9,17,35,53,-18,39
Dumbarton,6670,8,8,12,16,45,58,-13,36
St Mirren,6670,9,8,11,17,41,57,-16,35
Ayr,6670,10,6,16,14,34,56,-22,34
Hibernian,6671,1,17,10,9,54,30,24,61
Morton,6671,2,17,10,9,48,35,13,61
Dundee Utd,6671,3,16,10,10,53,45,8,58
Falkirk,6671,4,15,10,11,59,48,11,55
Dunfermline,6671,5,13,11,12,47,44,3,50
Dumbarton,6671,6,11,11,14,54,51,3,44
Queen of S't,6671,7,11,11,14,49,53,-4,44
Raith,6671,8,11,9,16,38,53,-15,42
Ayr,6671,9,7,15,14,31,51,-20,36
St Mirren,6671,10,9,9,18,39,62,-23,36
Hibernian,6672,1,19,12,5,54,24,30,69
Morton,6672,2,16,11,9,47,40,7,59
Falkirk,6672,3,15,13,8,54,37,17,58
Dundee Utd,6672,4,14,10,12,48,46,2,52
Queen of S't,6672,5,12,10,14,46,47,-1,46
Dunfermline,6672,6,11,12,13,44,44,0,45
Raith,6672,7,10,12,14,34,46,-12,42
Ayr,6672,8,9,13,14,37,50,-13,40
Dumbarton,6672,9,9,11,16,44,57,-13,38
St Mirren,6672,10,8,10,18,36,53,-17,34
Hibernian,6673,1,19,14,3,58,27,31,71
Morton,6673,2,18,12,6,52,32,20,66
Falkirk,6673,3,15,11,10,57,43,14,56
Dundee Utd,6673,4,13,11,12,44,40,4,50
Dunfermline,6673,5,12,12,12,49,45,4,48
Queen of S't,6673,6,11,10,15,45,49,-4,43
Dumbarton,6673,7,9,11,16,50,63,-13,38
Ayr,6673,8,8,14,14,34,51,-17,38
St Mirren,6673,9,9,10,17,42,59,-17,37
Raith,6673,10,9,9,18,36,58,-22,36
Hibernian,6674,1,19,11,6,52,23,29,68
Falkirk,6674,2,18,10,8,59,38,21,64
Morton,6674,3,15,12,9,48,40,8,57
Dundee Utd,6674,4,15,10,11,50,41,9,55
Dunfermline,6674,5,11,14,11,49,45,4,47
Queen of S't,6674,6,13,8,15,46,52,-6,47
Raith,6674,7,11,8,17,38,51,-13,41
St Mirren,6674,8,9,11,16,39,54,-15,38
Dumbarton,6674,9,7,14,15,45,60,-15,35
Ayr,6674,10,7,12,17,36,58,-22,33
Hibernian,6675,1,17,15,4,54,29,25,66
Morton,6675,2,18,11,7,56,38,18,65
Dundee Utd,6675,3,17,9,10,52,39,13,60
Falkirk,6675,4,15,12,9,55,46,9,57
Queen of S't,6675,5,12,9,15,44,47,-3,45
Dumbarton,6675,6,9,12,15,49,55,-6,39
Dunfermline,6675,7,8,14,14,44,50,-6,38
Ayr,6675,8,9,11,16,33,51,-18,38
St Mirren,6675,9,8,13,15,38,54,-16,37
Raith,6675,10,9,10,17,32,48,-16,37
Hibernian,6676,1,18,14,4,53,24,29,68
Morton,6676,2,17,11,8,49,34,15,62
Falkirk,6676,3,16,13,7,62,40,22,61
Dundee Utd,6676,4,17,9,10,54,41,13,60
Queen of S't,6676,5,11,10,15,45,53,-8,43
Raith,6676,6,10,13,13,35,45,-10,43
Dunfermline,6676,7,8,14,14,43,52,-9,38
Dumbarton,6676,8,9,11,16,46,58,-12,38
Ayr,6676,9,8,11,17,39,63,-24,35
St Mirren,6676,10,7,12,17,41,57,-16,33
Hibernian,6677,1,18,11,7,48,26,22,65
Morton,6677,2,17,12,7,54,36,18,63
Falkirk,6677,3,17,10,9,61,40,21,61
Dundee Utd,6677,4,14,9,13,51,46,5,51
Ayr,6677,5,10,13,13,40,54,-14,43
Queen of S't,6677,6,11,9,16,43,52,-9,42
Dunfermline,6677,7,9,14,13,49,50,-1,41
St Mirren,6677,8,10,10,16,41,55,-14,40
Dumbarton,6677,9,9,12,15,52,61,-9,39
Raith,6677,10,9,12,15,32,51,-19,39
Hibernian,6678,1,19,14,3,57,23,34,71
Morton,6678,2,17,13,6,52,32,20,64
Falkirk,6678,3,15,12,9,59,40,19,57
Dundee Utd,6678,4,15,10,11,43,35,8,55
Raith,6678,5,13,9,14,40,48,-8,48
Dumbarton,6678,6,11,11,14,49,56,-7,44
Queen of S't,6678,7,10,12,14,43,48,-5,42
Ayr,6678,8,9,13,14,33,56,-23,40
Dunfermline,6678,9,7,13,16,44,55,-11,34
St Mirren,6678,10,6,9,21,32,59,-27,27
Hibernian,6679,1,21,12,3,62,25,37,75
Morton,6679,2,16,11,9,49,40,9,59
Dundee Utd,6679,3,16,9,11,50,41,9,57
Falkirk,6679,4,15,10,11,63,47,16,55
Queen of S't,6679,5,13,10,13,52,55,-3,49
Dunfermline,6679,6,10,13,13,46,49,-3,43
Raith,6679,7,10,9,17,37,51,-14,39
Dumbarton,6679,8,9,11,16,47,58,-11,38
St Mirren,6679,9,9,10,17,43,57,-14,37
Ayr,6679,10,7,13,16,30,56,-26,34
Hibernian,6680,1,18,13,5,56,29,27,67
Morton,6680,2,18,10,8,55,44,11,64
Dundee Utd,6680,3,17,9,10,55,41,14,60
Falkirk,6680,4,16,10,10,60,42,18,58
Dunfermline,6680,5,10,13,13,53,52,1,43
Queen of S't,6680,6,11,9,16,46,55,-9,42
Raith,6680,7,11,8,17,43,53,-10,41
Dumbarton,6680,8,10,10,16,46,62,-16,40
St Mirren,6680,9,9,11,16,46,54,-8,38
Ayr,6680,10,8,11,17,35,63,-28,35
Hibernian,6681,1,20,11,5,52,23,29,71
Falkirk,6681,2,18,10,8,64,38,26,64
Morton,6681,3,18,10,8,56,37,19,64
Dundee Utd,6681,4,15,9,12,44,41,3,54
Dunfermline,6681,5,10,12,14,45,47,-2,42
Queen of S't,6681,6,11,9,16,40,49,-9,42
Raith,6681,7,11,9,16,39,52,-13,42
Dumbarton,6681,8,9,12,15,46,57,-11,39
St Mirren,6681,9,8,11,17,41,60,-19,35
Ayr,6681,10,7,13,16,30,53,-23,34
Morton,6682,1,18,11,7,51,35,16,65
Hibernian,6682,2,17,13,6,54,27,27,64
Falkirk,6682,3,17,12,7,62,38,24,63
Dundee Utd,6682,4,18,8,10,60,41,19,62
Queen of S't,6682,5,11,10,15,45,55,-10,43
Dunfermline,6682,6,9,14,13,46,50,-4,41
St Mirren,6682,7,9,11,16,42,60,-18,38
Dumbarton,6682,8,8,13,15,46,59,-13,37
Raith,6682,9,9,9,18,36,52,-16,36
Ayr,6682,10,8,11,17,38,63,-25,35
Hibernian,6683,1,19,12,5,58,25,33,69
Falkirk,6683,2,17,11,8,68,43,25,62
Morton,6683,3,17,11,8,48,35,13,62
Dundee Utd,6683,4,14,11,11,49,44,5,53
Queen of S't,6683,5,11,11,14,42,51,-9,44
Dunfermline,6683,6,10,13,13,45,46,-1,43
St Mirren,6683,7,11,9,16,43,52,-9,42
Raith,6683,8,11,9,16,34,48,-14,42
Dumbarton,6683,9,8,11,17,46,65,-19,35
Ayr,6683,10,6,14,16,34,58,-24,32
Hibernian,6684,1,18,11,7,53,27,26,65
Falkirk,6684,2,17,10,9,59,41,18,61
Dundee Utd,6684,3,17,9,10,56,41,15,60
Morton,6684,4,16,12,8,49,35,14,60
Dunfermline,6684,5,10,13,13,45,47,-2,43
Queen of S't,6684,6,11,10,15,42,49,-7,43
Raith,6684,7,11,9,16,38,50,-12,42
Dumbarton,6684,8,8,14,14,50,62,-12,38
St Mirren,6684,9,9,10,17,40,58,-18,37
Ayr,6684,10,7,14,15,37,59,-22,35
Hibernian,6685,1,20,11,5,62,29,33,71
Morton,6685,2,15,13,8,49,37,12,58
Falkirk,6685,3,14,13,9,55,41,14,55
Dundee Utd,6685,4,15,9,12,49,43,6,54
Queen of S't,6685,5,13,9,14,45,50,-5,48
Dunfermline,6685,6,9,14,13,43,50,-7,41
Raith,6685,7,10,11,15,41,53,-12,41
Dumbarton,6685,8,8,14,14,46,55,-9,38
Ayr,6685,9,9,11,16,37,55,-18,38
St Mirren,6685,10,8,13,15,43,57,-14,37
Hibernian,6686,1,20,12,4,54,24,30,72
Falkirk,6686,2,17,9,10,58,43,15,60
Morton,6686,3,17,9,10,50,41,9,60
Dundee Utd,6686,4,17,8,11,50,39,11,59
Queen of S't,6686,5,12,9,15,51,54,-3,45
Dunfermline,6686,6,10,13,13,51,51,0,43
Raith,6686,7,10,9,17,37,49,-12,39
Dumbarton,6686,8,9,11,16,48,61,-13,38
Ayr,6686,9,9,11,16,36,56,-20,38
St Mirren,6686,10,8,11,17,38,55,-17,35
Hibernian,6687,1,20,13,3,62,27,35,73
Morton,6687,2,18,12,6,53,33,20,66
Falkirk,6687,3,17,11,8,63,42,21,62
Dundee Utd,6687,4,15,11,10,48,37,11,56
Dunfermline,6687,5,8,16,12,45,51,-6,40
Raith,6687,6,10,9,17,32,48,-16,39
Queen of S't,6687,7,10,8,18,44,56,-12,38
Dumbarton,6687,8,9,11,16,47,61,-14,38
Ayr,6687,9,8,12,16,32,50,-18,36
St Mirren,6687,10,8,11,17,39,60,-21,35
Hibernian,6688,1,20,13,3,55,20,35,73
Dundee Utd,6688,2,16,10,10,52,42,10,58
Falkirk,6688,3,15,12,9,59,44,15,57
Morton,6688,4,14,12,10,45,39,6,54
Dunfermline,6688,5,11,14,11,48,47,1,47
Queen of S't,6688,6,11,10,15,46,53,-7,43
Dumbarton,6688,7,9,12,15,48,58,-10,39
Raith,6688,8,10,9,17,33,46,-13,39
Ayr,6688,9,8,13,15,35,55,-20,37
St Mirren,6688,10,8,11,17,38,55,-17,35
Hibernian,6689,1,20,11,5,56,24,32,71
Falkirk,6689,2,16,11,9,59,42,17,59
Dundee Utd,6689,3,17,8,11,57,47,10,59
Morton,6689,4,16,11,9,47,39,8,59
Queen of S't,6689,5,14,9,13,48,49,-1,51
Dunfermline,6689,6,10,13,13,51,52,-1,43
Raith,6689,7,10,10,16,36,49,-13,40
Ayr,6689,8,9,12,15,37,53,-16,39
Dumbarton,6689,9,7,12,17,43,60,-17,33
St Mirren,6689,10,8,9,19,36,55,-19,33
Hibernian,6690,1,18,12,6,55,28,27,66
Dundee Utd,6690,2,18,8,10,56,38,18,62
Falkirk,6690,3,17,9,10,59,45,14,60
Morton,6690,4,15,11,10,48,42,6,56
Queen of S't,6690,5,11,11,14,46,51,-5,44
Dunfermline,6690,6,10,12,14,46,47,-1,42
Dumbarton,6690,7,10,12,14,49,55,-6,42
Raith,6690,8,10,12,14,35,46,-11,42
Ayr,6690,9,10,12,14,35,54,-19,42
St Mirren,6690,10,6,11,19,36,59,-23,29
Hibernian,6691,1,20,10,6,53,24,29,70
Falkirk,6691,2,18,10,8,60,38,22,64
Morton,6691,3,17,10,9,54,38,16,61
Dundee Utd,6691,4,15,10,11,50,42,8,55
Queen of S't,6691,5,11,12,13,43,46,-3,45
Ayr,6691,6,10,13,13,35,49,-14,43
Dunfermline,6691,7,10,12,14,44,52,-8,42
Raith,6691,8,10,10,16,34,52,-18,40
Dumbarton,6691,9,7,12,17,48,62,-14,33
St Mirren,6691,10,7,11,18,36,54,-18,32
Hibernian,6692,1,20,12,4,55,25,30,72
Morton,6692,2,17,12,7,52,37,15,63
Dundee Utd,6692,3,17,9,10,49,39,10,60
Falkirk,6692,4,14,10,12,56,44,12,52
Queen of S't,6692,5,14,10,12,45,42,3,52
Dumbarton,6692,6,11,11,14,47,53,-6,44
Dunfermline,6692,7,9,14,13,45,49,-4,41
Raith,6692,8,10,9,17,34,49,-15,39
St Mirren,6692,9,8,11,17,43,56,-13,35
Ayr,6692,10,6,10,20,30,62,-32,28
Hibernian,6693,1,17,14,5,57,29,28,65
Morton,6693,2,16,13,7,50,38,12,61
Dundee Utd,6693,3,16,11,9,57,40,17,59
Falkirk,6693,4,16,9,11,61,46,15,57
Raith,6693,5,12,9,15,38,52,-14,45
St Mirren,6693,6,11,10,15,47,56,-9,43
Dumbarton,6693,7,10,12,14,52,61,-9,42
Queen of S't,6693,8,9,11,16,45,55,-10,38
Dunfermline,6693,9,8,13,15,44,53,-9,37
Ayr,6693,10,7,14,15,36,57,-21,35
Hibernian,6694,1,18,13,5,53,28,25,67
Morton,6694,2,17,12,7,48,34,14,63
Falkirk,6694,3,16,12,8,56,38,18,60
Dundee Utd,6694,4,13,11,12,51,47,4,50
Dunfermline,6694,5,12,12,12,55,50,5,48
Dumbarton,6694,6,10,11,15,47,57,-10,41
Queen of S't,6694,7,11,8,17,42,52,-10,41
Ayr,6694,8,9,14,13,34,49,-15,41
St Mirren,6694,9,9,12,15,41,51,-10,39
Raith,6694,10,8,9,19,31,52,-21,33
Hibernian,6695,1,21,11,4,62,25,37,74
Morton,6695,2,21,9,6,60,35,25,72
Dundee Utd,6695,3,16,10,10,56,43,13,58
Falkirk,6695,4,13,13,10,59,48,11,52
Queen of S't,6695,5,12,10,14,48,51,-3,46
Dunfermline,6695,6,8,15,13,47,55,-8,39
St Mirren,6695,7,9,10,17,42,53,-11,37
Dumbarton,6695,8,9,10,17,47,63,-16,37
Raith,6695,9,8,12,16,35,54,-19,36
Ayr,6695,10,7,12,17,31,60,-29,33
Hibernian,6696,1,19,12,5,54,26,28,69
Morton,6696,2,17,11,8,51,39,12,62
Dundee Utd,6696,3,16,11,9,49,37,12,59
Falkirk,6696,4,15,11,10,56,41,15,56
Queen of S't,6696,5,13,11,12,48,46,2,50
Dunfermline,6696,6,8,15,13,41,47,-6,39
Dumbarton,6696,7,8,13,15,45,57,-12,37
Raith,6696,8,8,13,15,33,48,-15,37
Ayr,6696,9,7,15,14,36,54,-18,36
St Mirren,6696,10,6,14,16,33,51,-18,32
Hibernian,6697,1,19,11,6,60,29,31,68
Morton,6697,2,15,14,7,49,36,13,59
Falkirk,6697,3,15,12,9,55,40,15,57
Dundee Utd,6697,4,15,12,9,47,36,11,57
Dunfermline,6697,5,12,13,11,52,47,5,49
Raith,6697,6,11,9,16,35,49,-14,42
Dumbarton,6697,7,9,13,14,46,54,-8,40
Queen of S't,6697,8,10,10,16,42,54,-12,40
St Mirren,6697,9,7,14,15,35,51,-16,35
Ayr,6697,10,7,12,17,29,54,-25,33
Hibernian,6698,1,18,15,3,51,23,28,69
Falkirk,6698,2,17,11,8,62,41,21,62
Morton,6698,3,15,12,9,44,35,9,57
Dundee Utd,6698,4,14,12,10,53,46,7,54
Queen of S't,6698,5,11,11,14,46,49,-3,44
Dunfermline,6698,6,9,13,14,43,49,-6,40
Dumbarton,6698,7,9,13,14,49,56,-7,40
St Mirren,6698,8,9,12,15,41,54,-13,39
Ayr,6698,9,8,14,14,32,51,-19,38
Raith,6698,10,9,9,18,32,49,-17,36
Hibernian,6699,1,19,12,5,54,25,29,69
Dundee Utd,6699,2,18,9,9,56,40,16,63
Morton,6699,3,16,10,10,46,38,8,58
Falkirk,6699,4,14,12,10,53,40,13,54
Queen of S't,6699,5,13,10,13,49,44,5,49
Dunfermline,6699,6,11,11,14,47,46,1,44
Dumbarton,6699,7,11,11,14,50,65,-15,44
Raith,6699,8,9,9,18,30,49,-19,36
St Mirren,6699,9,8,11,17,40,55,-15,35
Ayr,6699,10,8,11,17,33,56,-23,35
Morton,6700,1,18,12,6,48,29,19,66
Hibernian,6700,2,17,13,6,54,25,29,64
Falkirk,6700,3,17,12,7,60,38,22,63
Dundee Utd,6700,4,17,10,9,50,34,16,61
Dunfermline,6700,5,10,12,14,42,47,-5,42
Queen of S't,6700,6,10,12,14,40,48,-8,42
Raith,6700,7,11,9,16,38,51,-13,42
Dumbarton,6700,8,9,12,15,47,60,-13,39
St Mirren,6700,9,7,11,18,37,56,-19,32
Ayr,6700,10,7,11,18,28,56,-28,32
Hibernian,6701,1,21,11,4,63,22,41,74
Dundee Utd,6701,2,17,10,9,50,36,14,61
Morton,6701,3,15,13,8,46,36,10,58
Falkirk,6701,4,14,11,11,52,46,6,53
Dunfermline,6701,5,12,11,13,46,43,3,47
Dumbarton,6701,6,11,11,14,48,53,-5,44
Queen of S't,6701,7,10,10,16,45,55,-10,40
Raith,6701,8,9,9,18,36,54,-18,36
St Mirren,6701,9,8,12,16,34,52,-18,36
Ayr,6701,10,8,12,16,36,59,-23,36
Hibernian,6702,1,19,12,5,58,27,31,69
Morton,6702,2,16,13,7,51,38,13,61
Falkirk,6702,3,16,11,9,58,41,17,59
Dundee Utd,6702,4,15,8,13,51,45,6,53
Queen of S't,6702,5,12,9,15,43,49,-6,45
Raith,6702,6,12,9,15,35,47,-12,45
Dumbarton,6702,7,10,12,14,48,56,-8,42
Dunfermline,6702,8,9,13,14,44,48,-4,40
Ayr,6702,9,9,11,16,39,57,-18,38
St Mirren,6702,10,7,12,17,38,57,-19,33
Hibernian,6703,1,21,12,3,60,23,37,75
Falkirk,6703,2,17,11,8,58,41,17,62
Dundee Utd,6703,3,17,10,9,56,37,19,61
Morton,6703,4,15,12,9,49,42,7,57
Queen of S't,6703,5,12,10,14,44,46,-2,46
Dunfermline,6703,6,9,15,12,42,46,-4,42
Dumbarton,6703,7,8,14,14,48,58,-10,38
Raith,6703,8,9,11,16,35,50,-15,38
St Mirren,6703,9,8,10,18,39,57,-18,34
Ayr,6703,10,6,11,19,29,60,-31,29
Hibernian,6704,1,18,11,7,52,26,26,65
Morton,6704,2,18,11,7,51,34,17,65
Falkirk,6704,3,16,11,9,57,37,20,59
Dundee Utd,6704,4,16,8,12,55,44,11,56
Queen of S't,6704,5,14,8,14,45,50,-5,50
Raith,6704,6,11,10,15,38,45,-7,43
Ayr,6704,7,10,11,15,37,59,-22,41
Dunfermline,6704,8,9,13,14,47,52,-5,40
Dumbarton,6704,9,8,11,17,45,62,-17,35
St Mirren,6704,10,8,10,18,40,58,-18,34
Morton,6705,1,19,11,6,54,35,19,68
Hibernian,6705,2,17,15,4,52,26,26,66
Falkirk,6705,3,16,11,9,60,42,18,59
Dundee Utd,6705,4,16,10,10,50,37,13,58
Dunfermline,6705,5,9,16,11,48,45,3,43
Queen of S't,6705,6,10,13,13,46,52,-6,43
Raith,6705,7,9,10,17,34,52,-18,37
Dumbarton,6705,8,8,12,16,49,64,-15,36
Ayr,6705,9,7,14,15,35,54,-19,35
St Mirren,6705,10,8,10,18,39,60,-21,34
Hibernian,6706,1,19,11,6,55,27,28,68
Morton,6706,2,17,11,8,49,39,10,62
Dundee Utd,6706,3,16,10,10,54,41,13,58
Falkirk,6706,4,15,10,11,57,47,10,55
Raith,6706,5,13,8,15,43,47,-4,47
Queen of S't,6706,6,12,10,14,48,50,-2,46
Dumbarton,6706,7,11,11,14,55,62,-7,44
Dunfermline,6706,8,9,12,15,47,52,-5,39
St Mirren,6706,9,9,10,17,44,55,-11,37
Ayr,6706,10,7,11,18,32,64,-32,32
Hibernian,6707,1,19,13,4,57,25,32,70
Dundee Utd,6707,2,19,8,9,53,36,17,65
Falkirk,6707,3,16,10,10,56,45,11,58
Morton,6707,4,14,12,10,46,40,6,54
Queen of S't,6707,5,13,9,14,54,51,3,48
Dunfermline,6707,6,12,12,12,48,49,-1,48
Raith,6707,7,11,8,17,35,46,-11,41
Ayr,6707,8,8,13,15,37,56,-19,37
Dumbarton,6707,9,8,12,16,45,59,-14,36
St Mirren,6707,10,7,9,20,37,61,-24,30
Hibernian,6708,1,17,15,4,52,26,26,66
Morton,6708,2,16,12,8,49,36,13,60
Falkirk,6708,3,16,11,9,59,41,18,59
Dundee Utd,6708,4,15,10,11,48,39,9,55
Queen of S't,6708,5,12,9,15,44,49,-5,45
Raith,6708,6,11,11,14,35,46,-11,44
Dunfermline,6708,7,9,13,14,46,51,-5,40
Dumbarton,6708,8,9,12,15,45,55,-10,39
St Mirren,6708,9,8,12,16,37,52,-15,36
Ayr,6708,10,7,15,14,31,51,-20,36
Hibernian,6709,1,19,11,6,55,29,26,68
Morton,6709,2,18,12,6,52,32,20,66
Dundee Utd,6709,3,16,9,11,53,42,11,57
Falkirk,6709,4,14,13,9,58,42,16,55
Queen of S't,6709,5,11,9,16,44,52,-8,42
Dunfermline,6709,6,9,13,14,43,48,-5,40
Dumbarton,6709,7,9,13,14,51,59,-8,40
St Mirren,6709,8,10,10,16,44,59,-15,40
Raith,6709,9,9,11,16,32,48,-16,38
Ayr,6709,10,9,11,16,34,55,-21,38
Hibernian,6710,1,19,11,6,54,29,25,68
Falkirk,6710,2,17,11,8,59,39,20,62
Dundee Utd,6710,3,15,11,10,49,39,10,56
Morton,6710,4,14,12,10,40,37,3,54
Dunfermline,6710,5,11,13,12,47,45,2,46
Queen of S't,6710,6,11,9,16,42,48,-6,42
Raith,6710,7,11,9,16,38,50,-12,42
St Mirren,6710,8,10,11,15,45,52,-7,41
Dumbarton,6710,9,9,11,16,46,61,-15,38
Ayr,6710,10,7,14,15,29,49,-20,35
Hibernian,6711,1,18,13,5,51,23,28,67
Morton,6711,2,18,12,6,49,32,17,66
Falkirk,6711,3,15,12,9,58,47,11,57
Dundee Utd,6711,4,15,10,11,52,42,10,55
Queen of S't,6711,5,11,10,15,43,52,-9,43
Dunfermline,6711,6,10,12,14,46,51,-5,42
Ayr,6711,7,10,10,16,35,53,-18,40
St Mirren,6711,8,9,12,15,42,51,-9,39
Raith,6711,9,10,9,17,33,47,-14,39
Dumbarton,6711,10,9,10,17,49,60,-11,37
Hibernian,6712,1,20,12,4,57,24,33,72
Morton,6712,2,18,11,7,54,33,21,65
Falkirk,6712,3,16,9,11,55,42,13,57
Dundee Utd,6712,4,16,9,11,47,45,2,57
Dumbarton,6712,5,11,11,14,50,53,-3,44
Ayr,6712,6,10,13,13,37,49,-12,43
Dunfermline,6712,7,9,12,15,43,50,-7,39
Raith,6712,8,10,8,18,33,52,-19,38
Queen of S't,6712,9,9,10,17,40,53,-13,37
St Mirren,6712,10,8,11,17,39,54,-15,35
Hibernian,6713,1,17,15,4,54,27,27,66
Falkirk,6713,2,16,12,8,59,38,21,60
Morton,6713,3,16,12,8,47,36,11,60
Dundee Utd,6713,4,14,9,13,48,48,0,51
Dumbarton,6713,5,11,11,14,51,57,-6,44
Queen of S't,6713,6,10,13,13,42,47,-5,43
St Mirren,6713,7,10,11,15,44,53,-9,41
Dunfermline,6713,8,8,15,13,47,50,-3,39
Raith,6713,9,10,9,17,38,55,-17,39
Ayr,6713,10,8,13,15,33,52,-19,37
Hibernian,6714,1,20,11,5,62,29,33,71
Morton,6714,2,16,12,8,48,37,11,60
Falkirk,6714,3,16,10,10,62,49,13,58
Dundee Utd,6714,4,15,10,11,50,40,10,55
Queen of S't,6714,5,13,9,14,50,51,-1,48
St Mirren,6714,6,10,11,15,41,51,-10,41
Ayr,6714,7,9,13,14,37,55,-18,40
Raith,6714,8,10,9,17,33,49,-16,39
Dunfermline,6714,9,7,16,13,43,49,-6,37
Dumbarton,6714,10,8,11,17,49,65,-16,35
Hibernian,6715,1,18,10,8,54,29,25,64
Morton,6715,2,18,10,8,52,36,16,64
Falkirk,6715,3,17,11,8,61,38,23,62
Queen of S't,6715,4,15,8,13,54,50,4,53
Dundee Utd,6715,5,14,10,12,49,44,5,52
Dunfermline,6715,6,10,13,13,45,50,-5,43
St Mirren,6715,7,10,11,15,43,54,-11,41
Ayr,6715,8,9,11,16,37,56,-19,38
Dumbarton,6715,9,8,11,17,49,65,-16,35
Raith,6715,10,8,11,17,32,54,-22,35
Hibernian,6716,1,19,13,4,59,28,31,70
Morton,6716,2,17,12,7,50,35,15,63
Falkirk,6716,3,17,10,9,65,45,20,61
Dundee Utd,6716,4,16,9,11,53,45,8,57
Queen of S't,6716,5,12,8,16,46,51,-5,44
Dumbarton,6716,6,11,11,14,50,57,-7,44
Ayr,6716,7,10,12,14,39,57,-18,42
Raith,6716,8,10,9,17,36,49,-13,39
St Mirren,6716,9,8,10,18,42,59,-17,34
Dunfermline,6716,10,7,12,17,42,56,-14,33
Hibernian,6717,1,18,12,6,56,29,27,66
Falkirk,6717,2,16,10,10,60,44,16,58
Dundee Utd,6717,3,15,12,9,49,37,12,57
Morton,6717,4,15,12,9,46,38,8,57
Dunfermline,6717,5,11,12,13,47,49,-2,45
Raith,6717,6,11,9,16,37,49,-12,42
Ayr,6717,7,10,12,14,35,52,-17,42
Queen of S't,6717,8,10,11,15,39,49,-10,41
Dumbarton,6717,9,9,12,15,47,54,-7,39
St Mirren,6717,10,9,10,17,41,56,-15,37
Hibernian,6718,1,20,13,3,59,25,34,73
Morton,6718,2,16,11,9,46,35,11,59
Dundee Utd,6718,3,14,13,9,46,36,10,55
Falkirk,6718,4,14,10,12,52,46,6,52
Queen of S't,6718,5,12,11,13,43,47,-4,47
Dunfermline,6718,6,10,14,12,47,45,2,44
Raith,6718,7,10,10,16,33,46,-13,40
Dumbarton,6718,8,9,12,15,47,61,-14,39
Ayr,6718,9,9,12,15,37,52,-15,39
St Mirren,6718,10,7,12,17,36,53,-17,33
Morton,6719,1,19,11,6,48,29,19,68
Falkirk,6719,2,17,12,7,58,35,23,63
Hibernian,6719,3,17,11,8,49,26,23,62
Dundee Utd,6719,4,15,10,11,49,41,8,55
Queen of S't,6719,5,12,10,14,46,51,-5,46
Dunfermline,6719,6,9,13,14,45,52,-7,40
Raith,6719,7,10,10,16,34,48,-14,40
Ayr,6719,8,10,10,16,34,52,-18,40
Dumbarton,6719,9,7,14,15,48,60,-12,35
St Mirren,6719,10,8,11,17,40,57,-17,35
Hibernian,6720,1,18,12,6,51,26,25,66
Falkirk,6720,2,16,10,10,62,45,17,58
Morton,6720,3,15,13,8,45,35,10,58
Dundee Utd,6720,4,16,10,10,49,42,7,58
Dunfermline,6720,5,12,13,11,50,44,6,49
Queen of S't,6720,6,11,9,16,47,52,-5,42
St Mirren,6720,7,9,12,15,41,54,-13,39
Ayr,6720,8,9,12,15,36,58,-22,39
Dumbarton,6720,9,8,14,14,52,61,-9,38
Raith,6720,10,9,9,18,33,49,-16,36
Hibernian,6721,1,20,12,4,55,24,31,72
Morton,6721,2,19,11,6,52,31,21,68
Falkirk,6721,3,16,12,8,60,40,20,60
Dundee Utd,6721,4,15,11,10,46,38,8,56
Queen of S't,6721,5,10,11,15,43,50,-7,41
St Mirren,6721,6,10,10,16,42,54,-12,40
Dunfermline,6721,7,8,15,13,45,51,-6,39
Raith,6721,8,10,8,18,35,53,-18,38
Ayr,6721,9,8,12,16,31,55,-24,36
Dumbarton,6721,10,7,12,17,47,60,-13,33
Hibernian,6722,1,20,11,5,55,24,31,71
Morton,6722,2,17,12,7,47,33,14,63
Dundee Utd,6722,3,16,10,10,52,35,17,58
Falkirk,6722,4,15,9,12,56,50,6,54
Queen of S't,6722,5,11,11,14,42,48,-6,44
Dumbarton,6722,6,10,11,15,51,56,-5,41
Dunfermline,6722,7,9,13,14,44,49,-5,40
Raith,6722,8,10,10,16,36,50,-14,40
Ayr,6722,9,9,11,16,34,57,-23,38
St Mirren,6722,10,9,10,17,42,57,-15,37
Hibernian,6723,1,17,14,5,53,28,25,65
Falkirk,6723,2,16,12,8,61,37,24,60
Dundee Utd,6723,3,16,10,10,49,40,9,58
Morton,6723,4,15,11,10,52,43,9,56
St Mirren,6723,5,11,11,14,47,53,-6,44
Queen of S't,6723,6,11,10,15,47,56,-9,43
Dunfermline,6723,7,10,12,14,47,50,-3,42
Raith,6723,8,9,12,15,29,43,-14,39
Dumbarton,6723,9,9,11,16,50,66,-16,38
Ayr,6723,10,8,13,15,32,51,-19,37
Hibernian,6724,1,20,11,5,57,26,31,71
Morton,6724,2,18,10,8,52,41,11,64
Falkirk,6724,3,16,11,9,59,41,18,59
Dundee Utd,6724,4,14,11,11,46,39,7,53
Queen of S't,6724,5,12,10,14,46,50,-4,46
Dunfermline,6724,6,11,11,14,54,52,2,44
Dumbarton,6724,7,8,13,15,45,55,-10,37
Raith,6724,8,9,10,17,32,51,-19,37
St Mirren,6724,9,8,12,16,43,59,-16,36
Ayr,6724,10,7,15,14,31,51,-20,36
Hibernian,6725,1,20,12,4,54,21,33,72
Dundee Utd,6725,2,18,9,9,50,39,11,63
Morton,6725,3,17,9,10,52,36,16,60
Falkirk,6725,4,16,11,9,59,41,18,59
Queen of S't,6725,5,12,8,16,42,52,-10,44
Dunfermline,6725,6,10,13,13,43,45,-2,43
Raith,6725,7,11,10,15,37,47,-10,43
St Mirren,6725,8,8,11,17,42,56,-14,35
Ayr,6725,9,8,11,17,34,59,-25,35
Dumbarton,6725,10,7,12,17,46,63,-17,33
Hibernian,6726,1,20,11,5,56,26,30,71
Morton,6726,2,18,11,7,59,33,26,65
Falkirk,6726,3,16,10,10,62,42,20,58
Dundee Utd,6726,4,14,13,9,48,42,6,55
Dunfermline,6726,5,10,14,12,44,46,-2,44
Queen of S't,6726,6,11,9,16,45,50,-5,42
Raith,6726,7,11,8,17,36,53,-17,41
Ayr,6726,8,9,12,15,35,56,-21,39
Dumbarton,6726,9,9,11,16,42,59,-17,38
St Mirren,6726,10,8,9,19,40,60,-20,33
Hibernian,6727,1,18,12,6,56,25,31,66
Morton,6727,2,16,12,8,46,34,12,60
Dundee Utd,6727,3,15,11,10,46,39,7,56
Falkirk,6727,4,14,12,10,54,40,14,54
Queen of S't,6727,5,15,8,13,46,43,3,53
Dunfermline,6727,6,12,12,12,49,46,3,48
Dumbarton,6727,7,10,11,15,51,59,-8,41
Raith,6727,8,10,11,15,34,47,-13,41
Ayr,6727,9,7,13,16,32,56,-24,34
St Mirren,6727,10,6,12,18,34,59,-25,30
Hibernian,6728,1,17,14,5,51,26,25,65
Morton,6728,2,18,10,8,53,34,19,64
Dundee Utd,6728,3,17,10,9,50,37,13,61
Falkirk,6728,4,16,11,9,61,38,23,59
Queen of S't,6728,5,12,11,13,44,46,-2,47
Dunfermline,6728,6,10,12,14,44,47,-3,42
Dumbarton,6728,7,10,11,15,47,57,-10,41
Ayr,6728,8,8,15,13,32,50,-18,39
Raith,6728,9,8,10,18,31,55,-24,34
St Mirren,6728,10,7,10,19,35,58,-23,31
Hibernian,6729,1,20,11,5,55,26,29,71
Dundee Utd,6729,2,19,8,9,54,34,20,65
Falkirk,6729,3,15,11,10,57,41,16,56
Morton,6729,4,14,12,10,42,35,7,54
Dunfermline,6729,5,10,14,12,49,45,4,44
St Mirren,6729,6,10,11,15,42,52,-10,41
Raith,6729,7,11,8,17,34,54,-20,41
Queen of S't,6729,8,10,10,16,42,52,-10,40
Dumbarton,6729,9,9,12,15,45,57,-12,39
Ayr,6729,10,7,13,16,31,55,-24,34
Hibernian,6730,1,18,13,5,50,24,26,67
Dundee Utd,6730,2,16,11,9,46,38,8,59
Falkirk,6730,3,16,10,10,58,41,17,58
Morton,6730,4,15,13,8,47,35,12,58
Queen of S't,6730,5,13,9,14,47,48,-1,48
St Mirren,6730,6,10,10,16,39,52,-13,40
Raith,6730,7,10,10,16,32,48,-16,40
Dunfermline,6730,8,8,15,13,43,45,-2,39
Dumbarton,6730,9,8,13,15,46,57,-11,37
Ayr,6730,10,6,16,14,31,51,-20,34
Hibernian,6731,1,20,12,4,58,27,31,72
Falkirk,6731,2,18,10,8,63,34,29,64
Morton,6731,3,18,10,8,51,37,14,64
Dundee Utd,6731,4,16,10,10,51,43,8,58
Dunfermline,6731,5,10,12,14,45,51,-6,42
Queen of S't,6731,6,11,9,16,41,48,-7,42
Raith,6731,7,10,9,17,37,53,-16,39
Dumbarton,6731,8,8,12,16,48,60,-12,36
Ayr,6731,9,7,14,15,31,54,-23,35
St Mirren,6731,10,7,12,17,36,54,-18,33
Hibernian,6732,1,19,11,6,53,27,26,68
Dundee Utd,6732,2,18,9,9,55,38,17,63
Morton,6732,3,16,11,9,46,35,11,59
Falkirk,6732,4,16,10,10,62,46,16,58
Queen of S't,6732,5,15,8,13,50,48,2,53
Dumbarton,6732,6,9,12,15,49,59,-10,39
Raith,6732,7,10,9,17,39,56,-17,39
Dunfermline,6732,8,8,12,16,44,54,-10,36
St Mirren,6732,9,8,12,16,44,59,-15,36
Ayr,6732,10,8,12,16,36,56,-20,36
Hibernian,6733,1,18,12,6,54,27,27,66
Morton,6733,2,18,11,7,55,37,18,65
Dundee Utd,6733,3,16,9,11,46,37,9,57
Falkirk,6733,4,15,10,11,57,44,13,55
Dunfermline,6733,5,11,12,13,48,50,-2,45
Queen of S't,6733,6,12,9,15,43,51,-8,45
Raith,6733,7,12,9,15,39,50,-11,45
Ayr,6733,8,9,10,17,34,55,-21,37
St Mirren,6733,9,8,12,16,41,53,-12,36
Dumbarton,6733,10,7,14,15,46,59,-13,35
Hibernian,6734,1,19,11,6,55,27,28,68
Dundee Utd,6734,2,17,9,10,53,40,13,60
Morton,6734,3,16,10,10,48,38,10,58
Falkirk,6734,4,15,9,12,54,44,10,54
Dunfermline,6734,5,11,13,12,48,49,-1,46
Ayr,6734,6,12,10,14,44,54,-10,46
Queen of S't,6734,7,11,8,17,44,54,-10,41
Dumbarton,6734,8,10,10,16,47,60,-13,40
St Mirren,6734,9,10,9,17,42,55,-13,39
Raith,6734,10,10,9,17,34,48,-14,39
Hibernian,6735,1,21,12,3,62,23,39,75
Morton,6735,2,16,11,9,52,43,9,59
Falkirk,6735,3,16,10,10,58,40,18,58
Dundee Utd,6735,4,14,11,11,51,41,10,53
Dunfermline,6735,5,10,15,11,48,45,3,45
Queen of S't,6735,6,11,10,15,41,52,-11,43
Dumbarton,6735,7,9,13,14,50,58,-8,40
Raith,6735,8,10,9,17,34,49,-15,39
St Mirren,6735,9,9,10,17,40,61,-21,37
Ayr,6735,10,7,13,16,30,54,-24,34
Hibernian,6736,1,19,13,4,56,27,29,70
Falkirk,6736,2,15,13,8,56,37,19,58
Morton,6736,3,16,10,10,53,45,8,58
Dundee Utd,6736,4,14,13,9,48,41,7,55
Dunfermline,6736,5,11,14,11,51,47,4,47
Queen of S't,6736,6,10,13,13,49,52,-3,43
Raith,6736,7,11,9,16,33,47,-14,42
Dumbarton,6736,8,9,11,16,47,57,-10,38
Ayr,6736,9,8,12,16,33,54,-21,36
St Mirren,6736,10,7,12,17,36,55,-19,33
Hibernian,6737,1,21,10,5,59,27,32,73
Morton,6737,2,18,10,8,53,36,17,64
Falkirk,6737,3,16,10,10,59,41,18,58
Dundee Utd,6737,4,15,10,11,51,44,7,55
Queen of S't,6737,5,11,11,14,47,53,-6,44
Dunfermline,6737,6,10,11,15,44,50,-6,41
Ayr,6737,7,10,11,15,40,55,-15,41
St Mirren,6737,8,9,11,16,40,56,-16,38
Dumbarton,6737,9,8,13,15,46,59,-13,37
Raith,6737,10,8,11,17,35,53,-18,35
Hibernian,6738,1,19,11,6,56,29,27,68
Falkirk,6738,2,18,11,7,65,38,27,65
Morton,6738,3,16,12,8,50,38,12,60
Dundee Utd,6738,4,16,11,9,55,40,15,59
Queen of S't,6738,5,11,9,16,44,54,-10,42
Raith,6738,6,11,9,16,37,50,-13,42
St Mirren,6738,7,10,10,16,45,57,-12,40
Dunfermline,6738,8,8,15,13,46,53,-7,39
Dumbarton,6738,9,8,13,15,45,56,-11,37
Ayr,6738,10,7,11,18,32,60,-28,32
Hibernian,6739,1,20,11,5,59,26,33,71
Morton,6739,2,16,11,9,47,40,7,59
Falkirk,6739,3,15,11,10,59,41,18,56
Dundee Utd,6739,4,14,11,11,49,43,6,53
Raith,6739,5,11,10,15,37,49,-12,43
Dumbarton,6739,6,10,12,14,51,58,-7,42
Dunfermline,6739,7,9,14,13,47,50,-3,41
St Mirren,6739,8,10,10,16,41,53,-12,40
Queen of S't,6739,9,10,9,17,44,57,-13,39
Ayr,6739,10,8,15,13,32,49,-17,39
Hibernian,6740,1,19,13,4,55,24,31,70
Morton,6740,2,17,11,8,51,38,13,62
Falkirk,6740,3,16,12,8,59,39,20,60
Dundee Utd,6740,4,14,10,12,47,44,3,52
Raith,6740,5,11,11,14,40,50,-10,44
Dumbarton,6740,6,10,13,13,52,54,-2,43
Queen of S't,6740,7,10,12,14,43,49,-6,42
Ayr,6740,8,7,15,14,32,54,-22,36
Dunfermline,6740,9,7,14,15,44,55,-11,35
St Mirren,6740,10,8,11,17,41,57,-16,35
Hibernian,6741,1,18,12,6,55,28,27,66
Morton,6741,2,18,11,7,50,32,18,65
Dundee Utd,6741,3,17,10,9,57,39,18,61
Falkirk,6741,4,16,10,10,59,45,14,58
Queen of S't,6741,5,12,10,14,44,48,-4,46
Dumbarton,6741,6,10,11,15,47,56,-9,41
Raith,6741,7,10,11,15,32,43,-11,41
Dunfermline,6741,8,8,14,14,42,52,-10,38
Ayr,6741,9,8,11,17,34,58,-24,35
St Mirren,6741,10,8,10,18,40,59,-19,34
Hibernian,6742,1,17,15,4,55,28,27,66
Morton,6742,2,17,11,8,52,38,14,62
Falkirk,6742,3,17,10,9,62,39,23,61
Dundee Utd,6742,4,14,11,11,43,39,4,53
Dunfermline,6742,5,10,14,12,45,44,1,44
Queen of S't,6742,6,11,10,15,41,51,-10,43
Ayr,6742,7,10,13,13,38,50,-12,43
Raith,6742,8,9,11,16,31,48,-17,38
St Mirren,6742,9,9,10,17,40,55,-15,37
Dumbarton,6742,10,7,13,16,41,56,-15,34
Hibernian,6743,1,20,12,4,57,24,33,72
Morton,6743,2,19,10,7,54,36,18,67
Dundee Utd,6743,3,16,9,11,48,42,6,57
Falkirk,6743,4,15,10,11,56,43,13,55
Queen of S't,6743,5,11,10,15,47,50,-3,43
Dumbarton,6743,6,10,11,15,52,61,-9,41
Raith,6743,7,10,11,15,36,48,-12,41
Dunfermline,6743,8,8,14,14,45,52,-7,38
St Mirren,6743,9,9,11,16,40,53,-13,38
Ayr,6743,10,7,12,17,36,62,-26,33
Morton,6744,1,19,10,7,56,38,18,67
Hibernian,6744,2,16,13,7,51,30,21,61
Falkirk,6744,3,15,13,8,57,41,16,58
Dundee Utd,6744,4,16,9,11,56,44,12,57
Raith,6744,5,13,8,15,41,46,-5,47
Queen of S't,6744,6,11,11,14,47,53,-6,44
Dumbarton,6744,7,10,12,14,50,57,-7,42
Dunfermline,6744,8,9,12,15,44,51,-7,39
St Mirren,6744,9,9,10,17,39,57,-18,37
Ayr,6744,10,7,12,17,35,59,-24,33
Hibernian,6745,1,18,11,7,54,31,23,65
Dundee Utd,6745,2,17,10,9,56,38,18,61
Falkirk,6745,3,16,11,9,57,38,19,59
Morton,6745,4,14,11,11,49,45,4,53
Dumbarton,6745,5,10,12,14,50,59,-9,42
Raith,6745,6,11,9,16,37,51,-14,42
St Mirren,6745,7,10,11,15,47,50,-3,41
Queen of S't,6745,8,10,11,15,44,53,-9,41
Dunfermline,6745,9,9,13,14,47,56,-9,40
Ayr,6745,10,8,15,13,35,55,-20,39
Hibernian,6746,1,18,11,7,54,29,25,65
Morton,6746,2,18,9,9,56,41,15,63
Falkirk,6746,3,17,10,9,58,40,18,61
Dundee Utd,6746,4,15,11,10,47,39,8,56
Queen of S't,6746,5,12,10,14,45,47,-2,46
Dunfermline,6746,6,11,12,13,46,50,-4,45
Raith,6746,7,11,10,15,33,44,-11,43
Dumbarton,6746,8,10,12,14,54,59,-5,42
St Mirren,6746,9,8,11,17,39,55,-16,35
Ayr,6746,10,6,12,18,29,57,-28,30
Hibernian,6747,1,18,13,5,56,26,30,67
Falkirk,6747,2,17,9,10,55,42,13,60
Morton,6747,3,16,12,8,49,39,10,60
Dundee Utd,6747,4,15,12,9,48,36,12,57
Dunfermline,6747,5,12,12,12,49,41,8,48
Raith,6747,6,10,11,15,38,52,-14,41
Ayr,6747,7,8,15,13,35,50,-15,39
Queen of S't,6747,8,9,10,17,40,52,-12,37
Dumbarton,6747,9,8,12,16,44,60,-16,36
St Mirren,6747,10,8,12,16,41,57,-16,36
Hibernian,6748,1,21,12,3,61,26,35,75
Morton,6748,2,17,12,7,50,34,16,63
Falkirk,6748,3,17,11,8,56,37,19,62
Dundee Utd,6748,4,15,13,8,47,34,13,58
Raith,6748,5,11,9,16,35,47,-12,42
Queen of S't,6748,6,10,11,15,45,52,-7,41
Dunfermline,6748,7,8,14,14,41,47,-6,38
Dumbarton,6748,8,9,10,17,45,57,-12,37
Ayr,6748,9,8,11,17,32,58,-26,35
St Mirren,6748,10,7,11,18,35,55,-20,32
Hibernian,6749,1,19,10,7,56,30,26,67
Morton,6749,2,18,11,7,53,37,16,65
Dundee Utd,6749,3,17,10,9,53,36,17,61
Falkirk,6749,4,16,10,10,59,43,16,58
Dunfermline,6749,5,12,12,12,50,46,4,48
Queen of S't,6749,6,12,9,15,50,49,1,45
Raith,6749,7,11,9,16,39,52,-13,42
Ayr,6749,8,8,11,17,32,59,-27,35
St Mirren,6749,9,8,10,18,40,60,-20,34
Dumbarton,6749,10,7,12,17,45,65,-20,33
Morton,6750,1,19,10,7,55,34,21,67
Hibernian,6750,2,18,11,7,52,26,26,65
Dundee Utd,6750,3,16,10,10,52,36,16,58
Falkirk,6750,4,15,10,11,56,42,14,55
Queen of S't,6750,5,13,10,13,51,50,1,49
Raith,6750,6,12,9,15,36,48,-12,45
Dunfermline,6750,7,10,12,14,47,57,-10,42
Dumbarton,6750,8,9,11,16,47,61,-14,38
Ayr,6750,9,9,11,16,37,55,-18,38
St Mirren,6750,10,7,10,19,36,60,-24,31
Hibernian,6751,1,17,13,6,55,30,25,64
Morton,6751,2,16,13,7,50,39,11,61
Dundee Utd,6751,3,16,11,9,56,42,14,59
Falkirk,6751,4,14,13,9,57,43,14,55
Queen of S't,6751,5,11,11,14,47,47,0,44
St Mirren,6751,6,11,10,15,47,55,-8,43
Dumbarton,6751,7,10,12,14,49,57,-8,42
Dunfermline,6751,8,9,14,13,49,55,-6,41
Raith,6751,9,10,10,16,33,48,-15,40
Ayr,6751,10,7,11,18,35,62,-27,32
Hibernian,6752,1,20,13,3,54,20,34,73
Falkirk,6752,2,17,10,9,59,41,18,61
Morton,6752,3,17,10,9,51,37,14,61
Dundee Utd,6752,4,17,10,9,52,39,13,61
Queen of S't,6752,5,11,10,15,46,54,-8,43
Dunfermline,6752,6,9,13,14,40,46,-6,40
Raith,6752,7,9,11,16,34,47,-13,38
St Mirren,6752,8,9,11,16,37,54,-17,38
Dumbarton,6752,9,8,11,17,46,60,-14,35
Ayr,6752,10,7,13,16,34,55,-21,34
Hibernian,6753,1,20,12,4,57,25,32,72
Morton,6753,2,16,12,8,53,40,13,60
Falkirk,6753,3,14,11,11,56,45,11,53
Dundee Utd,6753,4,14,11,11,48,42,6,53
Queen of S't,6753,5,13,10,13,49,49,0,49
Dunfermline,6753,6,12,11,13,51,49,2,47
Ayr,6753,7,11,11,14,38,51,-13,44
Dumbarton,6753,8,8,12,16,46,60,-14,36
Raith,6753,9,9,9,18,33,53,-20,36
St Mirren,6753,10,7,13,16,38,55,-17,34
Hibernian,6754,1,19,13,4,58,26,32,70
Morton,6754,2,17,13,6,51,39,12,64
Falkirk,6754,3,15,12,9,53,39,14,57
Dundee Utd,6754,4,15,12,9,47,36,11,57
Queen of S't,6754,5,12,9,15,45,51,-6,45
Dunfermline,6754,6,10,14,12,46,44,2,44
Raith,6754,7,10,9,17,35,49,-14,39
Ayr,6754,8,8,12,16,34,55,-21,36
Dumbarton,6754,9,8,11,17,45,60,-15,35
St Mirren,6754,10,7,13,16,38,53,-15,34
Hibernian,6755,1,18,12,6,54,30,24,66
Morton,6755,2,18,11,7,54,35,19,65
Dundee Utd,6755,3,17,9,10,51,41,10,60
Falkirk,6755,4,15,11,10,61,43,18,56
Dunfermline,6755,5,11,12,13,48,50,-2,45
Queen of S't,6755,6,11,11,14,47,51,-4,44
St Mirren,6755,7,11,10,15,42,50,-8,43
Ayr,6755,8,10,10,16,36,57,-21,40
Dumbarton,6755,9,8,10,18,44,61,-17,34
Raith,6755,10,8,10,18,35,54,-19,34
Hibernian,6756,1,22,10,4,59,24,35,76
Morton,6756,2,20,9,7,54,35,19,69
Dundee Utd,6756,3,16,10,10,53,40,13,58
Falkirk,6756,4,14,11,11,56,44,12,53
Dunfermline,6756,5,10,13,13,49,48,1,43
Queen of S't,6756,6,10,11,15,45,54,-9,41
Raith,6756,7,10,11,15,37,50,-13,41
Dumbarton,6756,8,8,13,15,48,63,-15,37
Ayr,6756,9,7,13,16,36,57,-21,34
St Mirren,6756,10,7,11,18,39,61,-22,32
Hibernian,6757,1,18,14,4,58,28,30,68
Morton,6757,2,15,15,6,49,35,14,60
Dundee Utd,6757,3,16,9,11,55,43,12,57
Falkirk,6757,4,14,10,12,58,46,12,52
Queen of S't,6757,5,13,9,14,44,47,-3,48
Dunfermline,6757,6,10,14,12,47,51,-4,44
Raith,6757,7,10,10,16,40,51,-11,40
St Mirren,6757,8,9,12,15,42,54,-12,39
Dumbarton,6757,9,8,14,14,48,61,-13,38
Ayr,6757,10,7,13,16,38,63,-25,34
Hibernian,6758,1,19,12,5,54,24,30,69
Dundee Utd,6758,2,16,11,9,55,43,12,59
Morton,6758,3,16,11,9,49,37,12,59
Falkirk,6758,4,13,12,11,56,46,10,51
Dunfermline,6758,5,11,13,12,48,49,-1,46
Dumbarton,6758,6,10,11,15,46,53,-7,41
Ayr,6758,7,9,14,13,34,49,-15,41
Queen of S't,6758,8,10,10,16,43,53,-10,40
St Mirren,6758,9,10,10,16,39,53,-14,40
Raith,6758,10,8,12,16,31,48,-17,36
Hibernian,6759,1,21,11,4,61,25,36,74
Dundee Utd,6759,2,18,10,8,53,38,15,64
Falkirk,6759,3,16,10,10,58,44,14,58
Morton,6759,4,15,11,10,48,44,4,56
Queen of S't,6759,5,12,11,13,44,45,-1,47
Ayr,6759,6,9,12,15,36,51,-15,39
Raith,6759,7,10,9,17,32,48,-16,39
Dunfermline,6759,8,9,11,16,46,51,-5,38
Dumbarton,6759,9,8,12,16,45,63,-18,36
St Mirren,6759,10,8,11,17,41,55,-14,35
Hibernian,6760,1,20,12,4,55,26,29,72
Falkirk,6760,2,15,13,8,59,39,20,58
Morton,6760,3,15,12,9,44,34,10,57
Dundee Utd,6760,4,14,11,11,48,40,8,53
Queen of S't,6760,5,11,11,14,42,48,-6,44
Raith,6760,6,10,12,14,35,45,-10,42
Dunfermline,6760,7,10,11,15,46,54,-8,41
Dumbarton,6760,8,9,13,14,50,57,-7,40
Ayr,6760,9,8,15,13,33,49,-16,39
St Mirren,6760,10,6,14,16,37,57,-20,32
Hibernian,6761,1,18,14,4,51,22,29,68
Morton,6761,2,16,14,6,49,35,14,62
Falkirk,6761,3,15,12,9,55,39,16,57
Dundee Utd,6761,4,15,10,11,55,44,11,55
St Mirren,6761,5,12,9,15,45,53,-8,45
Queen of S't,6761,6,11,10,15,48,54,-6,43
Dunfermline,6761,7,9,14,13,44,50,-6,41
Dumbarton,6761,8,9,11,16,49,61,-12,38
Raith,6761,9,8,12,16,32,49,-17,36
Ayr,6761,10,7,14,15,32,53,-21,35
Hibernian,6762,1,20,12,4,54,24,30,72
Morton,6762,2,17,13,6,48,33,15,64
Dundee Utd,6762,3,15,11,10,53,41,12,56
Falkirk,6762,4,13,13,10,58,46,12,52
Raith,6762,5,12,9,15,39,47,-8,45
Queen of S't,6762,6,11,10,15,46,50,-4,43
Ayr,6762,7,11,10,15,40,57,-17,43
Dunfermline,6762,8,9,14,13,45,48,-3,41
Dumbarton,6762,9,8,11,17,46,63,-17,35
St Mirren,6762,10,7,11,18,39,59,-20,32
Hibernian,6763,1,20,12,4,57,22,35,72
Dundee Utd,6763,2,19,8,9,58,37,21,65
Falkirk,6763,3,18,10,8,64,43,21,64
Morton,6763,4,16,11,9,48,35,13,59
Dunfermline,6763,5,11,12,13,48,52,-4,45
Queen of S't,6763,6,10,9,17,43,57,-14,39
Ayr,6763,7,9,12,15,35,56,-21,39
St Mirren,6763,8,9,9,18,40,57,-17,36
Dumbarton,6763,9,8,11,17,46,63,-17,35
Raith,6763,10,9,8,19,35,52,-17,35
Hibernian,6764,1,16,14,6,51,33,18,62
Dundee Utd,6764,2,17,10,9,54,37,17,61
Falkirk,6764,3,15,11,10,58,47,11,56
Morton,6764,4,14,14,8,49,41,8,56
Queen of S't,6764,5,12,12,12,43,44,-1,48
Dunfermline,6764,6,9,15,12,47,50,-3,42
Dumbarton,6764,7,10,11,15,49,53,-4,41
Ayr,6764,8,10,11,15,35,56,-21,41
St Mirren,6764,9,9,10,17,46,57,-11,37
Raith,6764,10,9,10,17,32,46,-14,37
Hibernian,6765,1,20,11,5,56,28,28,71
Morton,6765,2,17,9,10,49,39,10,60
Falkirk,6765,3,16,9,11,60,45,15,57
Dundee Utd,6765,4,14,10,12,52,47,5,52
Raith,6765,5,12,10,14,38,47,-9,46
Dunfermline,6765,6,10,12,14,49,51,-2,42
Queen of S't,6765,7,11,9,16,46,52,-6,42
Dumbarton,6765,8,9,13,14,52,60,-8,40
St Mirren,6765,9,9,12,15,41,55,-14,39
Ayr,6765,10,8,13,15,39,58,-19,37
Hibernian,6766,1,23,10,3,64,23,41,79
Morton,6766,2,15,13,8,50,37,13,58
Dundee Utd,6766,3,15,10,11,48,40,8,55
Falkirk,6766,4,14,11,11,55,48,7,53
Queen of S't,6766,5,13,9,14,52,51,1,48
Dunfermline,6766,6,10,14,12,48,48,0,44
Dumbarton,6766,7,10,12,14,49,59,-10,42
Ayr,6766,8,9,10,17,32,55,-23,37
Raith,6766,9,8,12,16,32,48,-16,36
St Mirren,6766,10,7,11,18,35,56,-21,32
Hibernian,6767,1,20,10,6,57,27,30,70
Dundee Utd,6767,2,18,9,9,53,34,19,63
Falkirk,6767,3,15,10,11,53,41,12,55
Morton,6767,4,15,10,11,46,47,-1,55
Dumbarton,6767,5,12,11,13,50,55,-5,47
Raith,6767,6,12,10,14,37,46,-9,46
Queen of S't,6767,7,11,8,17,47,53,-6,41
Dunfermline,6767,8,9,13,14,50,50,0,40
Ayr,6767,9,8,12,16,32,55,-23,36
St Mirren,6767,10,8,11,17,39,56,-17,35
Hibernian,6768,1,20,12,4,53,23,30,72
Falkirk,6768,2,17,10,9,63,39,24,61
Dundee Utd,6768,3,16,11,9,52,37,15,59
Morton,6768,4,16,10,10,48,37,11,58
Dunfermline,6768,5,10,14,12,44,48,-4,44
Dumbarton,6768,6,11,11,14,50,58,-8,44
Queen of S't,6768,7,10,10,16,43,51,-8,40
Raith,6768,8,10,10,16,36,51,-15,40
Ayr,6768,9,8,12,16,35,56,-21,36
St Mirren,6768,10,7,10,19,38,62,-24,31
Hibernian,6769,1,19,13,4,55,25,30,70
Morton,6769,2,18,11,7,51,38,13,65
Falkirk,6769,3,17,10,9,69,43,26,61
Dundee Utd,6769,4,15,10,11,44,39,5,55
Dunfermline,6769,5,9,15,12,48,49,-1,42
Dumbarton,6769,6,10,12,14,48,56,-8,42
Queen of S't,6769,7,10,10,16,41,50,-9,40
Ayr,6769,8,8,14,14,32,53,-21,38
St Mirren,6769,9,9,9,18,47,62,-15,36
Raith,6769,10,9,8,19,30,50,-20,35
Hibernian,6770,1,17,15,4,52,28,24,66
Morton,6770,2,18,11,7,57,35,22,65
Falkirk,6770,3,15,14,7,57,37,20,59
Dundee Utd,6770,4,14,12,10,48,41,7,54
Queen of S't,6770,5,12,11,13,51,52,-1,47
Raith,6770,6,10,11,15,38,49,-11,41
St Mirren,6770,7,9,12,15,40,53,-13,39
Dumbarton,6770,8,9,11,16,42,55,-13,38
Dunfermline,6770,9,8,13,15,42,50,-8,37
Ayr,6770,10,7,12,17,31,58,-27,33
Hibernian,6771,1,19,12,5,55,28,27,69
Falkirk,6771,2,17,10,9,62,41,21,61
Morton,6771,3,16,10,10,48,41,7,58
Dundee Utd,6771,4,15,11,10,46,36,10,56
Dunfermline,6771,5,11,12,13,47,47,0,45
Queen of S't,6771,6,11,11,14,49,55,-6,44
Dumbarton,6771,7,10,12,14,53,59,-6,42
Ayr,6771,8,8,14,14,38,58,-20,38
St Mirren,6771,9,9,10,17,41,56,-15,37
Raith,6771,10,9,8,19,38,56,-18,35
Hibernian,6772,1,18,12,6,57,30,27,66
Falkirk,6772,2,17,10,9,57,39,18,61
Morton,6772,3,16,12,8,50,35,15,60
Dundee Utd,6772,4,16,10,10,50,39,11,58
Dunfermline,6772,5,12,12,12,46,45,1,48
Queen of S't,6772,6,10,11,15,46,53,-7,41
Dumbarton,6772,7,9,13,14,48,57,-9,40
Raith,6772,8,10,9,17,36,51,-15,39
Ayr,6772,9,8,12,16,31,57,-26,36
St Mirren,6772,10,8,11,17,41,56,-15,35
Hibernian,6773,1,18,15,3,58,25,33,69
Morton,6773,2,19,11,6,56,35,21,68
Falkirk,6773,3,15,13,8,55,38,17,58
Dundee Utd,6773,4,15,11,10,50,42,8,56
Queen of S't,6773,5,11,11,14,44,51,-7,44
Dunfermline,6773,6,10,13,13,42,45,-3,43
St Mirren,6773,7,9,11,16,39,51,-12,38
Ayr,6773,8,9,11,16,34,59,-25,38
Raith,6773,9,8,11,17,31,48,-17,35
Dumbarton,6773,10,7,11,18,45,60,-15,32
Hibernian,6774,1,20,12,4,59,23,36,72
Falkirk,6774,2,16,12,8,57,39,18,60
Dundee Utd,6774,3,16,9,11,49,39,10,57
Morton,6774,4,15,12,9,48,40,8,57
Queen of S't,6774,5,12,10,14,47,48,-1,46
Dunfermline,6774,6,10,13,13,47,52,-5,43
Dumbarton,6774,7,10,10,16,48,55,-7,40
Ayr,6774,8,9,12,15,31,50,-19,39
Raith,6774,9,9,10,17,33,50,-17,37
St Mirren,6774,10,8,10,18,37,60,-23,34
Hibernian,6775,1,21,11,4,62,24,38,74
Morton,6775,2,19,10,7,54,37,17,67
Falkirk,6775,3,15,10,11,57,44,13,55
Dundee Utd,6775,4,13,12,11,50,44,6,51
Queen of S't,6775,5,13,9,14,46,50,-4,48
Dunfermline,6775,6,11,13,12,48,50,-2,46
Dumbarton,6775,7,8,15,13,54,59,-5,39
St Mirren,6775,8,8,11,17,40,56,-16,35
Raith,6775,9,9,8,19,36,57,-21,35
Ayr,6775,10,7,13,16,35,61,-26,34
Hibernian,6776,1,19,12,5,54,25,29,69
Dundee Utd,6776,2,18,8,10,57,39,18,62
Morton,6776,3,17,11,8,48,39,9,62
Falkirk,6776,4,15,12,9,55,41,14,57
Ayr,6776,5,11,11,14,38,52,-14,44
Dunfermline,6776,6,10,13,13,48,46,2,43
Queen of S't,6776,7,10,11,15,42,50,-8,41
Raith,6776,8,10,9,17,35,47,-12,39
Dumbarton,6776,9,9,10,17,48,66,-18,37
St Mirren,6776,10,7,11,18,40,60,-20,32
Hibernian,6777,1,20,11,5,60,25,35,71
Morton,6777,2,19,9,8,54,34,20,66
Falkirk,6777,3,16,9,11,57,47,10,57
Dundee Utd,6777,4,14,12,10,48,39,9,54
Dumbarton,6777,5,10,12,14,51,55,-4,42
Queen of S't,6777,6,10,11,15,49,52,-3,41
Ayr,6777,7,10,11,15,38,56,-18,41
Dunfermline,6777,8,8,15,13,44,52,-8,39
Raith,6777,9,9,10,17,35,55,-20,37
St Mirren,6777,10,8,12,16,38,59,-21,36
Hibernian,6778,1,22,10,4,64,26,38,76
Morton,6778,2,18,10,8,54,39,15,64
Dundee Utd,6778,3,16,9,11,52,40,12,57
Falkirk,6778,4,14,11,11,54,43,11,53
Queen of S't,6778,5,11,11,14,45,52,-7,44
Dunfermline,6778,6,10,12,14,49,49,0,42
Dumbarton,6778,7,10,12,14,48,56,-8,42
St Mirren,6778,8,10,10,16,40,52,-12,40
Raith,6778,9,10,10,16,34,48,-14,40
Ayr,6778,10,6,11,19,30,65,-35,29
Hibernian,6779,1,20,10,6,59,29,30,70
Dundee Utd,6779,2,18,9,9,52,37,15,63
Morton,6779,3,17,10,9,49,36,13,61
Falkirk,6779,4,16,10,10,56,42,14,58
Dunfermline,6779,5,11,12,13,52,47,5,45
Queen of S't,6779,6,10,12,14,43,53,-10,42
Raith,6779,7,10,11,15,37,50,-13,41
Ayr,6779,8,9,12,15,39,55,-16,39
Dumbarton,6779,9,9,11,16,44,62,-18,38
St Mirren,6779,10,7,9,20,37,57,-20,30
Hibernian,6780,1,18,13,5,60,34,26,67
Morton,6780,2,18,10,8,55,37,18,64
Dundee Utd,6780,3,15,10,11,45,39,6,55
Falkirk,6780,4,13,11,12,55,46,9,50
Raith,6780,5,12,10,14,35,44,-9,46
Ayr,6780,6,11,10,15,36,54,-18,43
Dunfermline,6780,7,10,12,14,43,46,-3,42
Queen of S't,6780,8,11,9,16,44,51,-7,42
Dumbarton,6780,9,10,10,16,51,60,-9,40
St Mirren,6780,10,9,11,16,43,56,-13,38
Hibernian,6781,1,17,14,5,53,29,24,65
Dundee Utd,6781,2,17,11,8,58,41,17,62
Falkirk,6781,3,17,10,9,54,37,17,61
Morton,6781,4,14,17,5,49,36,13,59
Dunfermline,6781,5,9,16,11,46,47,-1,43
Queen of S't,6781,6,11,10,15,44,48,-4,43
Raith,6781,7,10,10,16,32,47,-15,40
Ayr,6781,8,9,11,16,42,61,-19,38
Dumbarton,6781,9,8,12,16,47,61,-14,36
St Mirren,6781,10,7,11,18,39,57,-18,32
Hibernian,6782,1,21,10,5,62,26,36,73
Morton,6782,2,16,13,7,51,37,14,61
Dundee Utd,6782,3,16,11,9,52,37,15,59
Falkirk,6782,4,15,10,11,54,41,13,55
Queen of S't,6782,5,13,10,13,48,47,1,49
Dunfermline,6782,6,9,14,13,47,53,-6,41
Raith,6782,7,10,10,16,33,47,-14,40
St Mirren,6782,8,10,10,16,41,56,-15,40
Ayr,6782,9,7,13,16,31,56,-25,34
Dumbarton,6782,10,7,11,18,45,64,-19,32
Hibernian,6783,1,19,12,5,57,27,30,69
Falkirk,6783,2,17,10,9,61,41,20,61
Morton,6783,3,16,11,9,54,42,12,59
Dundee Utd,6783,4,15,10,11,51,44,7,55
Dunfermline,6783,5,12,12,12,49,48,1,48
Ayr,6783,6,10,11,15,38,52,-14,41
Dumbarton,6783,7,10,10,16,46,60,-14,40
Queen of S't,6783,8,10,9,17,40,50,-10,39
St Mirren,6783,9,9,12,15,46,59,-13,39
Raith,6783,10,9,9,18,33,52,-19,36
Hibernian,6784,1,21,10,5,56,27,29,73
Falkirk,6784,2,17,10,9,57,37,20,61
Dundee Utd,6784,3,15,11,10,47,39,8,56
Morton,6784,4,15,11,10,46,38,8,56
Queen of S't,6784,5,11,10,15,42,47,-5,43
Dunfermline,6784,6,10,12,14,42,47,-5,42
Dumbarton,6784,7,9,14,13,46,53,-7,41
Raith,6784,8,10,9,17,33,48,-15,39
St Mirren,6784,9,9,11,16,42,55,-13,38
Ayr,6784,10,9,10,17,36,56,-20,37
Hibernian,6785,1,23,10,3,64,19,45,79
Dundee Utd,6785,2,16,11,9,50,38,12,59
Falkirk,6785,3,15,11,10,60,43,17,56
Morton,6785,4,14,11,11,49,43,6,53
Queen of S't,6785,5,14,8,14,49,50,-1,50
Dunfermline,6785,6,11,14,11,50,49,1,47
St Mirren,6785,7,10,9,17,41,53,-12,39
Raith,6785,8,10,8,18,32,56,-24,38
Dumbarton,6785,9,8,11,17,44,61,-17,35
Ayr,6785,10,7,11,18,32,59,-27,32
Hibernian,6786,1,20,12,4,54,24,30,72
Morton,6786,2,16,14,6,49,32,17,62
Dundee Utd,6786,3,17,9,10,55,40,15,60
Falkirk,6786,4,15,10,11,55,42,13,55
Queen of S't,6786,5,10,11,15,43,53,-10,41
St Mirren,6786,6,10,10,16,42,53,-11,40
Dumbarton,6786,7,9,12,15,45,59,-14,39
Dunfermline,6786,8,8,14,14,44,50,-6,38
Raith,6786,9,9,11,16,39,53,-14,38
Ayr,6786,10,8,13,15,38,58,-20,37
Hibernian,6787,1,20,12,4,60,28,32,72
Morton,6787,2,18,10,8,60,40,20,64
Dundee Utd,6787,3,15,12,9,51,40,11,57
Falkirk,6787,4,15,11,10,55,44,11,56
Queen of S't,6787,5,12,10,14,46,46,0,46
Raith,6787,6,11,11,14,35,45,-10,44
Dunfermline,6787,7,10,11,15,47,52,-5,41
Dumbarton,6787,8,9,11,16,46,61,-15,38
St Mirren,6787,9,8,12,16,40,57,-17,36
Ayr,6787,10,6,12,18,32,59,-27,30
Hibernian,6788,1,19,13,4,56,25,31,70
Morton,6788,2,19,10,7,51,33,18,67
Dundee Utd,6788,3,18,8,10,53,43,10,62
Falkirk,6788,4,17,9,10,56,37,19,60
Queen of S't,6788,5,10,10,16,43,53,-10,40
Dunfermline,6788,6,9,12,15,45,51,-6,39
Ayr,6788,7,9,12,15,36,55,-19,39
Dumbarton,6788,8,9,10,17,49,60,-11,37
St Mirren,6788,9,9,10,17,41,56,-15,37
Raith,6788,10,9,10,17,36,53,-17,37
Hibernian,6789,1,19,11,6,57,30,27,68
Falkirk,6789,2,19,9,8,64,40,24,66
Morton,6789,3,18,11,7,48,31,17,65
Dundee Utd,6789,4,15,12,9,48,40,8,57
Dunfermline,6789,5,11,13,12,45,43,2,46
Ayr,6789,6,9,13,14,40,55,-15,40
Raith,6789,7,9,10,17,32,50,-18,37
Queen of S't,6789,8,9,9,18,42,54,-12,36
St Mirren,6789,9,9,9,18,43,62,-19,36
Dumbarton,6789,10,7,13,16,48,62,-14,34
Hibernian,6790,1,17,14,5,52,25,27,65
Morton,6790,2,18,9,9,55,38,17,63
Dundee Utd,6790,3,16,11,9,50,42,8,59
Falkirk,6790,4,15,12,9,59,43,16,57
Queen of S't,6790,5,12,8,16,43,52,-9,44
Dunfermline,6790,6,10,13,13,46,46,0,43
Dumbarton,6790,7,9,12,15,46,53,-7,39
Raith,6790,8,10,9,17,36,51,-15,39
St Mirren,6790,9,10,9,17,41,58,-17,39
Ayr,6790,10,8,13,15,32,52,-20,37
Morton,6791,1,19,10,7,52,37,15,67
Hibernian,6791,2,18,11,7,53,30,23,65
Dundee Utd,6791,3,18,9,9,55,37,18,63
Falkirk,6791,4,15,13,8,57,39,18,58
Queen of S't,6791,5,11,10,15,44,49,-5,43
Raith,6791,6,10,10,16,35,50,-15,40
Ayr,6791,7,9,12,15,35,54,-19,39
Dunfermline,6791,8,8,13,15,42,49,-7,37
Dumbarton,6791,9,8,12,16,42,54,-12,36
St Mirren,6791,10,8,12,16,39,55,-16,36
Hibernian,6792,1,20,10,6,53,29,24,70
Morton,6792,2,17,11,8,54,39,15,62
Falkirk,6792,3,16,11,9,58,40,18,59
Dundee Utd,6792,4,15,11,10,52,42,10,56
Dunfermline,6792,5,11,13,12,49,47,2,46
Queen of S't,6792,6,11,9,16,47,53,-6,42
Dumbarton,6792,7,10,10,16,50,61,-11,40
Ayr,6792,8,9,12,15,38,57,-19,39
Raith,6792,9,9,10,17,34,52,-18,37
St Mirren,6792,10,8,11,17,40,55,-15,35
Morton,6793,1,18,11,7,55,37,18,65
Hibernian,6793,2,17,13,6,54,27,27,64
Dundee Utd,6793,3,17,8,11,49,38,11,59
Falkirk,6793,4,16,9,11,59,47,12,57
Dunfermline,6793,5,13,11,12,50,48,2,50
Queen of S't,6793,6,12,9,15,47,56,-9,45
Raith,6793,7,11,9,16,39,48,-9,42
Dumbarton,6793,8,9,13,14,49,58,-9,40
Ayr,6793,9,7,12,17,34,59,-25,33
St Mirren,6793,10,7,11,18,33,51,-18,32
Hibernian,6794,1,18,12,6,51,26,25,66
Falkirk,6794,2,17,11,8,59,38,21,62
Morton,6794,3,17,10,9,48,33,15,61
Dundee Utd,6794,4,16,10,10,56,44,12,58
Dunfermline,6794,5,11,12,13,46,48,-2,45
Queen of S't,6794,6,11,12,13,41,45,-4,45
St Mirren,6794,7,11,9,16,45,54,-9,42
Raith,6794,8,11,8,17,35,50,-15,41
Ayr,6794,9,7,13,16,31,57,-26,34
Dumbarton,6794,10,7,11,18,45,62,-17,32
Hibernian,6795,1,20,11,5,53,23,30,71
Morton,6795,2,17,11,8,50,37,13,62
Dundee Utd,6795,3,16,10,10,55,42,13,58
Falkirk,6795,4,14,12,10,57,44,13,54
Queen of S't,6795,5,12,11,13,47,47,0,47
Dunfermline,6795,6,9,14,13,44,51,-7,41
Ayr,6795,7,9,13,14,38,53,-15,40
Dumbarton,6795,8,9,12,15,51,61,-10,39
Raith,6795,9,10,9,17,31,49,-18,39
St Mirren,6795,10,7,11,18,38,57,-19,32
Morton,6796,1,18,11,7,56,38,18,65
Hibernian,6796,2,17,12,7,57,29,28,63
Dundee Utd,6796,3,15,12,9,52,41,11,57
Falkirk,6796,4,15,11,10,60,48,12,56
Queen of S't,6796,5,14,8,14,49,50,-1,50
Dunfermline,6796,6,10,13,13,48,51,-3,43
Dumbarton,6796,7,9,13,14,49,58,-9,40
St Mirren,6796,8,9,11,16,43,54,-11,38
Raith,6796,9,10,8,18,38,60,-22,38
Ayr,6796,10,7,13,16,33,56,-23,34
Hibernian,6797,1,21,10,5,56,24,32,73
Dundee Utd,6797,2,18,8,10,49,35,14,62
Morton,6797,3,17,11,8,45,36,9,62
Falkirk,6797,4,16,11,9,55,38,17,59
Queen of S't,6797,5,12,9,15,45,48,-3,45
Dunfermline,6797,6,10,13,13,46,49,-3,43
Dumbarton,6797,7,10,12,14,51,58,-7,42
Ayr,6797,8,8,12,16,29,50,-21,36
Raith,6797,9,8,9,19,31,50,-19,33
St Mirren,6797,10,6,13,17,38,57,-19,31
Morton,6798,1,19,12,5,52,28,24,69
Hibernian,6798,2,19,11,6,56,29,27,68
Falkirk,6798,3,16,12,8,60,40,20,60
Dundee Utd,6798,4,15,11,10,46,38,8,56
Queen of S't,6798,5,11,10,15,45,53,-8,43
Dunfermline,6798,6,10,12,14,45,49,-4,42
St Mirren,6798,7,9,13,14,41,50,-9,40
Dumbarton,6798,8,9,11,16,44,58,-14,38
Raith,6798,9,9,10,17,36,51,-15,37
Ayr,6798,10,7,10,19,30,59,-29,31
Hibernian,6799,1,20,13,3,55,24,31,73
Falkirk,6799,2,17,10,9,58,39,19,61
Dundee Utd,6799,3,17,8,11,49,40,9,59
Morton,6799,4,14,13,9,47,38,9,55
Dunfermline,6799,5,10,14,12,47,49,-2,44
Queen of S't,6799,6,11,8,17,49,54,-5,41
Raith,6799,7,11,8,17,35,50,-15,41
Ayr,6799,8,9,11,16,36,53,-17,38
Dumbarton,6799,9,8,13,15,45,59,-14,37
St Mirren,6799,10,9,10,17,39,54,-15,37
Hibernian,6800,1,18,13,5,57,24,33,67
Morton,6800,2,18,11,7,51,36,15,65
Falkirk,6800,3,16,11,9,60,38,22,59
Dundee Utd,6800,4,14,12,10,47,39,8,54
Dunfermline,6800,5,10,13,13,43,44,-1,43
Raith,6800,6,11,10,15,36,50,-14,43
Queen of S't,6800,7,10,11,15,43,57,-14,41
Dumbarton,6800,8,9,12,15,48,58,-10,39
Ayr,6800,9,8,14,14,34,54,-20,38
St Mirren,6800,10,7,11,18,41,60,-19,32
Hibernian,6801,1,19,12,5,53,25,28,69
Falkirk,6801,2,17,10,9,61,39,22,61
Morton,6801,3,16,12,8,50,35,15,60
Dundee Utd,6801,4,17,9,10,48,36,12,60
Queen of S't,6801,5,12,9,15,44,51,-7,45
Dunfermline,6801,6,10,13,13,47,49,-2,43
St Mirren,6801,7,10,10,16,39,50,-11,40
Raith,6801,8,10,10,16,31,47,-16,40
Dumbarton,6801,9,9,11,16,46,57,-11,38
Ayr,6801,10,6,12,18,29,59,-30,30
Hibernian,6802,1,21,11,4,62,26,36,74
Falkirk,6802,2,17,10,9,58,35,23,61
Morton,6802,3,16,11,9,50,42,8,59
Dundee Utd,6802,4,16,10,10,53,39,14,58
Queen of S't,6802,5,13,9,14,53,51,2,48
Dumbarton,6802,6,10,10,16,49,60,-11,40
Ayr,6802,7,10,10,16,36,59,-23,40
Raith,6802,8,10,9,17,36,50,-14,39
St Mirren,6802,9,8,11,17,38,55,-17,35
Dunfermline,6802,10,8,11,17,40,58,-18,35
Hibernian,6803,1,19,12,5,54,25,29,69
Falkirk,6803,2,16,10,10,58,42,16,58
Dundee Utd,6803,3,16,9,11,51,41,10,57
Morton,6803,4,14,14,8,48,42,6,56
Queen of S't,6803,5,13,8,15,45,54,-9,47
Dunfermline,6803,6,10,14,12,45,46,-1,44
Dumbarton,6803,7,11,11,14,49,53,-4,44
Raith,6803,8,9,11,16,38,50,-12,38
St Mirren,6803,9,9,9,18,43,56,-13,36
Ayr,6803,10,8,12,16,37,59,-22,36
Hibernian,6804,1,17,15,4,52,24,28,66
Morton,6804,2,17,12,7,54,35,19,63
Falkirk,6804,3,16,12,8,61,42,19,60
Dundee Utd,6804,4,15,9,12,51,47,4,54
Queen of S't,6804,5,13,9,14,49,50,-1,48
Dunfermline,6804,6,10,12,14,51,58,-7,42
Dumbarton,6804,7,10,11,15,48,55,-7,41
Raith,6804,8,10,10,16,33,46,-13,40
St Mirren,6804,9,8,11,17,41,54,-13,35
Ayr,6804,10,7,13,16,28,57,-29,34
Morton,6805,1,18,12,6,53,34,19,66
Hibernian,6805,2,18,11,7,53,28,25,65
Dundee Utd,6805,3,17,10,9,51,38,13,61
Falkirk,6805,4,15,10,11,57,46,11,55
Dunfermline,6805,5,10,13,13,46,48,-2,43
Queen of S't,6805,6,11,10,15,45,51,-6,43
Ayr,6805,7,10,10,16,42,56,-14,40
Raith,6805,8,10,10,16,31,46,-15,40
St Mirren,6805,9,10,9,17,39,53,-14,39
Dumbarton,6805,10,8,11,17,44,61,-17,35
Hibernian,6806,1,20,12,4,56,25,31,72
Morton,6806,2,17,12,7,56,42,14,63
Dundee Utd,6806,3,17,11,8,55,39,16,62
Falkirk,6806,4,16,11,9,60,38,22,59
Dunfermline,6806,5,10,15,11,50,43,7,45
Queen of S't,6806,6,10,12,14,43,50,-7,42
Raith,6806,7,9,12,15,36,58,-22,39
St Mirren,6806,8,8,10,18,38,56,-18,34
Dumbarton,6806,9,7,12,17,44,61,-17,33
Ayr,6806,10,6,13,17,35,61,-26,31
Hibernian,6807,1,19,13,4,57,29,28,70
Morton,6807,2,17,13,6,54,36,18,64
Falkirk,6807,3,18,9,9,62,40,22,63
Dundee Utd,6807,4,16,11,9,50,38,12,59
Queen of S't,6807,5,11,9,16,48,52,-4,42
Dumbarton,6807,6,10,12,14,50,57,-7,42
Raith,6807,7,11,9,16,38,48,-10,42
Dunfermline,6807,8,8,14,14,42,51,-9,38
St Mirren,6807,9,9,10,17,45,62,-17,37
Ayr,6807,10,6,10,20,29,62,-33,28
Hibernian,6808,1,19,13,4,57,24,33,70
Morton,6808,2,18,10,8,56,38,18,64
Falkirk,6808,3,17,10,9,58,39,19,61
Dundee Utd,6808,4,17,10,9,57,44,13,61
Dunfermline,6808,5,11,12,13,49,50,-1,45
Raith,6808,6,11,9,16,35,50,-15,42
Queen of S't,6808,7,10,11,15,44,53,-9,41
Ayr,6808,8,8,11,17,32,58,-26,35
Dumbarton,6808,9,8,10,18,46,59,-13,34
St Mirren,6808,10,8,10,18,42,61,-19,34
Hibernian,6809,1,21,12,3,57,22,35,75
Morton,6809,2,15,11,10,47,38,9,56
Dundee Utd,6809,3,15,10,11,50,40,10,55
Falkirk,6809,4,14,11,11,58,48,10,53
Dunfermline,6809,5,13,13,10,48,43,5,52
Ayr,6809,6,10,12,14,35,52,-17,42
Queen of S't,6809,7,10,10,16,48,56,-8,40
Raith,6809,8,10,9,17,36,49,-13,39
St Mirren,6809,9,9,11,16,39,53,-14,38
Dumbarton,6809,10,8,11,17,46,63,-17,35
Hibernian,6810,1,20,12,4,55,27,28,72
Morton,6810,2,16,12,8,49,39,10,60
Falkirk,6810,3,16,11,9,61,39,22,59
Dundee Utd,6810,4,16,10,10,51,45,6,58
Dunfermline,6810,5,9,15,12,51,49,2,42
Raith,6810,6,11,9,16,39,52,-13,42
Queen of S't,6810,7,10,11,15,42,51,-9,41
Dumbarton,6810,8,9,12,15,54,63,-9,39
Ayr,6810,9,8,12,16,39,55,-16,36
St Mirren,6810,10,8,10,18,38,59,-21,34
Morton,6811,1,19,12,5,58,34,24,69
Hibernian,6811,2,17,14,5,56,29,27,65
Dundee Utd,6811,3,15,11,10,52,38,14,56
Falkirk,6811,4,14,14,8,56,43,13,56
Queen of S't,6811,5,14,9,13,54,50,4,51
Raith,6811,6,10,8,18,33,50,-17,38
Dumbarton,6811,7,8,13,15,48,60,-12,37
Dunfermline,6811,8,8,13,15,44,56,-12,37
Ayr,6811,9,8,13,15,31,57,-26,37
St Mirren,6811,10,8,11,17,43,58,-15,35
Hibernian,6812,1,20,11,5,55,22,33,71
Morton,6812,2,19,9,8,53,38,15,66
Falkirk,6812,3,17,11,8,56,37,19,62
Dundee Utd,6812,4,15,10,11,50,43,7,55
Queen of S't,6812,5,11,10,15,48,51,-3,43
Dumbarton,6812,6,9,13,14,56,65,-9,40
Dunfermline,6812,7,8,15,13,43,47,-4,39
St Mirren,6812,8,10,9,17,41,54,-13,39
Ayr,6812,9,9,10,17,32,56,-24,37
Raith,6812,10,8,10,18,30,51,-21,34
Falkirk,6813,1,19,10,7,65,36,29,67
Hibernian,6813,2,18,12,6,52,28,24,66
Dundee Utd,6813,3,16,11,9,58,40,18,59
Morton,6813,4,16,11,9,48,37,11,59
Dunfermline,6813,5,10,15,11,45,45,0,45
Ayr,6813,6,10,11,15,36,52,-16,41
Queen of S't,6813,7,10,10,16,43,54,-11,40
St Mirren,6813,8,9,10,17,40,59,-19,37
Dumbarton,6813,9,8,12,16,45,64,-19,36
Raith,6813,10,9,8,19,34,51,-17,35
Hibernian,6814,1,18,12,6,54,28,26,66
Morton,6814,2,19,9,8,51,35,16,66
Falkirk,6814,3,15,11,10,60,44,16,56
Dundee Utd,6814,4,16,8,12,51,44,7,56
Queen of S't,6814,5,13,9,14,50,53,-3,48
Dunfermline,6814,6,11,12,13,47,48,-1,45
Raith,6814,7,11,11,14,42,49,-7,44
Ayr,6814,8,9,12,15,37,54,-17,39
Dumbarton,6814,9,8,10,18,46,65,-19,34
St Mirren,6814,10,7,12,17,37,55,-18,33
Dundee Utd,6815,1,19,8,9,67,39,28,65
Hibernian,6815,2,17,14,5,51,24,27,65
Morton,6815,3,16,11,9,46,36,10,59
Falkirk,6815,4,15,10,11,57,45,12,55
Queen of S't,6815,5,12,9,15,51,58,-7,45
Dunfermline,6815,6,10,13,13,45,50,-5,43
Raith,6815,7,10,11,15,37,50,-13,41
Dumbarton,6815,8,10,10,16,51,61,-10,40
St Mirren,6815,9,9,11,16,42,56,-14,38
Ayr,6815,10,7,13,16,30,58,-28,34
Hibernian,6816,1,18,12,6,60,29,31,66
Morton,6816,2,16,11,9,48,38,10,59
Dundee Utd,6816,3,16,10,10,57,43,14,58
Falkirk,6816,3,15,13,8,57,43,14,58
Raith,6816,5,11,10,15,41,47,-6,43
Queen of S't,6816,6,11,10,15,47,55,-8,43
Ayr,6816,7,10,13,13,43,56,-13,43
Dunfermline,6816,8,9,15,12,48,53,-5,42
St Mirren,6816,9,8,12,16,45,57,-12,36
Dumbarton,6816,10,8,10,18,43,68,-25,34
Hibernian,6817,1,18,13,5,55,28,27,67
Morton,6817,2,17,10,9,46,37,9,61
Dundee Utd,6817,3,16,12,8,56,39,17,60
Falkirk,6817,4,16,10,10,63,46,17,58
Queen of S't,6817,5,13,11,12,51,47,4,50
Dunfermline,6817,6,11,12,13,42,46,-4,45
Raith,6817,7,10,10,16,33,52,-19,40
Dumbarton,6817,8,9,11,16,47,57,-10,38
Ayr,6817,9,7,13,16,37,58,-21,34
St Mirren,6817,10,7,10,19,37,57,-20,31
Hibernian,6818,1,22,11,3,63,23,40,77
Dundee Utd,6818,2,17,9,10,48,36,12,60
Falkirk,6818,3,16,10,10,59,43,16,58
Morton,6818,4,15,9,12,48,42,6,54
Dunfermline,6818,5,11,13,12,50,52,-2,46
Ayr,6818,6,10,11,15,40,55,-15,41
Queen of S't,6818,7,10,10,16,42,52,-10,40
Raith,6818,8,9,11,16,36,53,-17,38
St Mirren,6818,9,9,10,17,42,55,-13,37
Dumbarton,6818,10,9,10,17,46,63,-17,37
Morton,6819,1,17,12,7,49,38,11,63
Hibernian,6819,2,16,14,6,55,33,22,62
Falkirk,6819,3,16,12,8,60,42,18,60
Dundee Utd,6819,4,16,9,11,50,42,8,57
Dunfermline,6819,5,11,12,13,51,48,3,45
St Mirren,6819,6,11,11,14,51,56,-5,44
Queen of S't,6819,7,11,10,15,43,49,-6,43
Raith,6819,8,10,12,14,38,49,-11,42
Dumbarton,6819,9,8,12,16,50,63,-13,36
Ayr,6819,10,6,12,18,34,61,-27,30
Hibernian,6820,1,19,12,5,57,26,31,69
Morton,6820,2,18,11,7,55,37,18,65
Dundee Utd,6820,3,16,9,11,53,43,10,57
Falkirk,6820,4,15,10,11,57,47,10,55
Dunfermline,6820,5,10,15,11,47,44,3,45
Queen of S't,6820,6,11,10,15,45,50,-5,43
Raith,6820,7,11,9,16,37,51,-14,42
Dumbarton,6820,8,9,11,16,48,61,-13,38
St Mirren,6820,9,9,11,16,43,58,-15,38
Ayr,6820,10,7,12,17,32,57,-25,33
Hibernian,6821,1,19,14,3,57,23,34,71
Falkirk,6821,2,18,10,8,66,40,26,64
Morton,6821,3,15,12,9,47,38,9,57
Dundee Utd,6821,4,14,11,11,54,48,6,53
Dunfermline,6821,5,11,15,10,49,45,4,48
Ayr,6821,6,10,13,13,39,54,-15,43
Raith,6821,7,11,8,17,34,53,-19,41
Queen of S't,6821,8,10,9,17,45,54,-9,39
St Mirren,6821,9,8,11,17,44,61,-17,35
Dumbarton,6821,10,7,11,18,45,64,-19,32
Hibernian,6822,1,19,12,5,55,26,29,69
Morton,6822,2,16,13,7,47,37,10,61
Falkirk,6822,3,16,11,9,57,40,17,59
Dundee Utd,6822,4,14,9,13,47,42,5,51
Queen of S't,6822,5,13,9,14,45,47,-2,48
Dunfermline,6822,6,9,15,12,45,48,-3,42
Dumbarton,6822,7,10,11,15,48,55,-7,41
Raith,6822,8,9,12,15,34,46,-12,39
St Mirren,6822,9,9,10,17,40,57,-17,37
Ayr,6822,10,8,12,16,35,55,-20,36
Hibernian,6823,1,17,15,4,55,25,30,66
Falkirk,6823,2,16,11,9,63,42,21,59
Morton,6823,3,15,11,10,48,42,6,56
Dundee Utd,6823,4,15,8,13,49,43,6,53
Queen of S't,6823,5,12,10,14,48,54,-6,46
Dunfermline,6823,6,11,12,13,48,47,1,45
Dumbarton,6823,7,11,11,14,50,61,-11,44
Ayr,6823,8,10,11,15,40,54,-14,41
Raith,6823,9,10,10,16,35,50,-15,40
St Mirren,6823,10,8,11,17,36,54,-18,35
Hibernian,6824,1,18,13,5,54,27,27,67
Morton,6824,2,16,12,8,51,38,13,60
Falkirk,6824,3,15,12,9,56,40,16,57
Dundee Utd,6824,4,15,10,11,48,40,8,55
Raith,6824,5,11,11,14,34,45,-11,44
Queen of S't,6824,6,11,10,15,41,47,-6,43
St Mirren,6824,7,11,10,15,41,50,-9,43
Dunfermline,6824,8,9,13,14,40,45,-5,40
Dumbarton,6824,9,9,10,17,44,59,-15,37
Ayr,6824,10,8,13,15,32,50,-18,37
Hibernian,6825,1,19,14,3,58,26,32,71
Falkirk,6825,2,17,11,8,64,39,25,62
Morton,6825,3,16,13,7,55,39,16,61
Dundee Utd,6825,4,14,10,12,50,46,4,52
Queen of S't,6825,5,11,11,14,46,52,-6,44
Raith,6825,6,11,9,16,36,47,-11,42
Dumbarton,6825,7,10,11,15,53,65,-12,41
Ayr,6825,8,10,11,15,38,52,-14,41
Dunfermline,6825,9,8,13,15,41,53,-12,37
St Mirren,6825,10,7,11,18,41,63,-22,32
Hibernian,6826,1,19,13,4,58,26,32,70
Morton,6826,2,19,9,8,54,37,17,66
Dundee Utd,6826,3,16,10,10,49,39,10,58
Falkirk,6826,4,15,12,9,55,38,17,57
Dunfermline,6826,5,10,13,13,46,48,-2,43
Queen of S't,6826,6,11,10,15,47,52,-5,43
Raith,6826,7,10,9,17,36,52,-16,39
Dumbarton,6826,8,9,10,17,49,64,-15,37
St Mirren,6826,9,8,12,16,37,54,-17,36
Ayr,6826,10,7,14,15,29,50,-21,35
Hibernian,6827,1,19,11,6,64,32,32,68
Morton,6827,2,17,11,8,52,40,12,62
Falkirk,6827,3,15,10,11,56,43,13,55
Dundee Utd,6827,4,15,10,11,50,41,9,55
Queen of S't,6827,5,12,10,14,43,50,-7,46
Raith,6827,6,11,10,15,38,46,-8,43
Dumbarton,6827,7,10,11,15,53,62,-9,41
Dunfermline,6827,8,9,13,14,42,48,-6,40
Ayr,6827,9,9,13,14,37,54,-17,40
St Mirren,6827,10,8,11,17,41,60,-19,35
Hibernian,6828,1,20,11,5,58,27,31,71
Morton,6828,2,17,12,7,51,33,18,63
Dundee Utd,6828,3,16,11,9,49,42,7,59
Falkirk,6828,4,16,10,10,57,40,17,58
Queen of S't,6828,5,12,11,13,44,48,-4,47
Raith,6828,6,12,8,16,34,46,-12,44
Dumbarton,6828,7,10,10,16,50,58,-8,40
St Mirren,6828,8,9,10,17,44,59,-15,37
Dunfermline,6828,9,7,14,15,38,47,-9,35
Ayr,6828,10,7,11,18,30,55,-25,32
Hibernian,6829,1,17,15,4,51,25,26,66
Morton,6829,2,17,11,8,54,38,16,62
Dundee Utd,6829,3,17,9,10,52,40,12,60
Falkirk,6829,4,14,13,9,55,39,16,55
Dumbarton,6829,5,11,11,14,47,56,-9,44
Dunfermline,6829,6,10,13,13,45,46,-1,43
Queen of S't,6829,7,11,10,15,44,52,-8,43
Raith,6829,8,10,9,17,35,51,-16,39
Ayr,6829,9,9,11,16,32,50,-18,38
St Mirren,6829,10,7,12,17,37,55,-18,33
Hibernian,6830,1,20,10,6,55,25,30,70
Dundee Utd,6830,2,18,10,8,51,34,17,64
Falkirk,6830,3,16,11,9,60,42,18,59
Morton,6830,4,14,12,10,45,39,6,54
Dunfermline,6830,5,9,17,10,44,43,1,44
Queen of S't,6830,6,11,10,15,43,46,-3,43
Raith,6830,7,11,10,15,36,48,-12,43
Dumbarton,6830,8,10,12,14,48,56,-8,42
St Mirren,6830,9,8,10,18,41,58,-17,34
Ayr,6830,10,6,12,18,29,61,-32,30
Hibernian,6831,1,17,13,6,54,28,26,64
Morton,6831,2,17,12,7,52,37,15,63
Dundee Utd,6831,3,16,9,11,50,41,9,57
Falkirk,6831,4,15,10,11,57,46,11,55
Dunfermline,6831,5,11,14,11,51,47,4,47
Queen of S't,6831,6,12,9,15,46,53,-7,45
Raith,6831,7,11,10,15,42,48,-6,43
Dumbarton,6831,8,10,10,16,49,60,-11,40
Ayr,6831,9,9,11,16,34,57,-23,38
St Mirren,6831,10,8,10,18,40,58,-18,34
Hibernian,6832,1,19,12,5,54,25,29,69
Morton,6832,2,17,11,8,51,37,14,62
Falkirk,6832,3,15,11,10,58,43,15,56
Dundee Utd,6832,4,15,10,11,54,42,12,55
Queen of S't,6832,5,11,10,15,43,50,-7,43
Dunfermline,6832,6,10,12,14,46,51,-5,42
Dumbarton,6832,7,9,13,14,46,56,-10,40
St Mirren,6832,8,9,12,15,38,52,-14,39
Ayr,6832,9,9,12,15,33,49,-16,39
Raith,6832,10,10,9,17,33,51,-18,39
Hibernian,6833,1,20,12,4,56,24,32,72
Falkirk,6833,2,17,10,9,59,39,20,61
Dundee Utd,6833,3,16,11,9,48,38,10,59
Morton,6833,4,16,10,10,48,37,11,58
Queen of S't,6833,5,11,9,16,42,47,-5,42
Ayr,6833,6,9,13,14,31,51,-20,40
Dunfermline,6833,7,9,12,15,43,50,-7,39
Dumbarton,6833,8,9,12,15,49,58,-9,39
Raith,6833,9,10,9,17,32,49,-17,39
St Mirren,6833,10,9,10,17,43,58,-15,37
Hibernian,6834,1,19,14,3,60,29,31,71
Dundee Utd,6834,2,18,9,9,50,34,16,63
Morton,6834,3,15,13,8,47,37,10,58
Falkirk,6834,4,15,12,9,56,41,15,57
Dunfermline,6834,5,9,17,10,48,46,2,44
Queen of S't,6834,6,11,11,14,44,51,-7,44
St Mirren,6834,7,9,11,16,36,50,-14,38
Raith,6834,8,9,11,16,33,50,-17,38
Dumbarton,6834,9,8,11,17,45,57,-12,35
Ayr,6834,10,7,11,18,30,54,-24,32
Hibernian,6835,1,22,10,4,59,24,35,76
Morton,6835,2,15,11,10,49,43,6,56
Falkirk,6835,3,14,13,9,55,39,16,55
Dundee Utd,6835,4,14,11,11,51,51,0,53
Queen of S't,6835,5,12,9,15,47,49,-2,45
Dumbarton,6835,6,10,13,13,50,54,-4,43
Ayr,6835,7,10,13,13,39,52,-13,43
Dunfermline,6835,8,8,16,12,43,47,-4,40
Raith,6835,9,9,11,16,36,49,-13,38
St Mirren,6835,10,6,13,17,36,57,-21,31
Hibernian,6836,1,17,13,6,54,31,23,64
Falkirk,6836,2,16,13,7,57,37,20,61
Morton,6836,3,16,13,7,44,30,14,61
Dundee Utd,6836,4,15,13,8,47,36,11,58
Queen of S't,6836,5,12,11,13,48,50,-2,47
Dunfermline,6836,6,8,16,12,44,47,-3,40
Dumbarton,6836,7,9,13,14,48,58,-10,40
Raith,6836,8,9,12,15,39,50,-11,39
St Mirren,6836,9,8,10,18,39,56,-17,34
Ayr,6836,10,6,14,16,30,55,-25,32
Morton,6837,1,19,10,7,55,37,18,67
Hibernian,6837,2,17,13,6,51,27,24,64
Falkirk,6837,3,16,12,8,62,39,23,60
Dundee Utd,6837,4,17,9,10,51,38,13,60
Queen of S't,6837,5,11,12,13,47,48,-1,45
Dunfermline,6837,6,10,11,15,48,57,-9,41
Raith,6837,7,10,10,16,34,50,-16,40
Dumbarton,6837,8,8,13,15,43,53,-10,37
Ayr,6837,9,8,13,15,32,54,-22,37
St Mirren,6837,10,7,11,18,37,57,-20,32
Hibernian,6838,1,20,11,5,55,24,31,71
Dundee Utd,6838,2,16,11,9,50,37,13,59
Morton,6838,3,15,13,8,48,39,9,58
Falkirk,6838,4,15,10,11,54,41,13,55
Queen of S't,6838,5,12,11,13,44,46,-2,47
Raith,6838,6,10,10,16,35,47,-12,40
Dunfermline,6838,7,8,15,13,43,51,-8,39
Dumbarton,6838,8,8,14,14,45,54,-9,38
St Mirren,6838,9,9,11,16,40,54,-14,38
Ayr,6838,10,8,12,16,33,54,-21,36
Hibernian,6839,1,18,11,7,52,26,26,65
Dundee Utd,6839,2,18,8,10,57,45,12,62
Morton,6839,3,16,11,9,53,40,13,59
Falkirk,6839,4,14,10,12,55,48,7,52
Queen of S't,6839,5,11,11,14,46,49,-3,44
Dunfermline,6839,6,10,13,13,47,47,0,43
Raith,6839,7,11,10,15,33,45,-12,43
Ayr,6839,8,9,13,14,39,57,-18,40
Dumbarton,6839,9,9,12,15,46,56,-10,39
St Mirren,6839,10,9,11,16,39,54,-15,38
Hibernian,6840,1,17,14,5,50,26,24,65
Dundee Utd,6840,2,17,9,10,47,40,7,60
Falkirk,6840,3,16,9,11,58,40,18,57
Morton,6840,4,14,14,8,47,39,8,56
Dunfermline,6840,5,11,15,10,51,48,3,48
Ayr,6840,6,10,12,14,38,49,-11,42
Queen of S't,6840,7,10,11,15,47,53,-6,41
Dumbarton,6840,8,9,11,16,45,57,-12,38
Raith,6840,9,9,11,16,36,52,-16,38
St Mirren,6840,10,9,10,17,38,53,-15,37
Hibernian,6841,1,18,15,3,56,27,29,69
Morton,6841,2,15,14,7,49,36,13,59
Falkirk,6841,3,16,10,10,62,45,17,58
Dundee Utd,6841,4,16,9,11,53,44,9,57
St Mirren,6841,5,10,12,14,44,53,-9,42
Raith,6841,6,10,11,15,34,48,-14,41
Dunfermline,6841,7,9,13,14,48,50,-2,40
Dumbarton,6841,8,9,13,14,51,61,-10,40
Ayr,6841,9,9,12,15,34,51,-17,39
Queen of S't,6841,10,9,9,18,43,59,-16,36
Morton,6842,1,18,11,7,56,35,21,65
Hibernian,6842,2,16,15,5,53,30,23,63
Falkirk,6842,3,17,11,8,59,41,18,62
Dundee Utd,6842,4,15,9,12,45,40,5,54
Dunfermline,6842,5,11,13,12,46,46,0,46
Raith,6842,6,11,9,16,36,50,-14,42
Queen of S't,6842,7,10,11,15,40,48,-8,41
Ayr,6842,8,9,12,15,34,52,-18,39
Dumbarton,6842,9,8,12,16,47,58,-11,36
St Mirren,6842,10,7,13,16,38,54,-16,34
Hibernian,6843,1,21,10,5,59,28,31,73
Morton,6843,2,17,10,9,50,36,14,61
Falkirk,6843,3,16,11,9,56,39,17,59
Dundee Utd,6843,4,14,12,10,46,38,8,54
Dunfermline,6843,5,11,12,13,46,49,-3,45
Queen of S't,6843,6,11,9,16,45,55,-10,42
Dumbarton,6843,7,10,10,16,50,59,-9,40
Ayr,6843,8,9,12,15,35,53,-18,39
Raith,6843,9,9,11,16,35,49,-14,38
St Mirren,6843,10,8,11,17,40,56,-16,35
Hibernian,6844,1,20,12,4,57,23,34,72
Morton,6844,2,17,10,9,56,38,18,61
Dundee Utd,6844,3,17,9,10,50,40,10,60
Falkirk,6844,4,16,10,10,58,39,19,58
Queen of S't,6844,5,12,9,15,48,53,-5,45
Raith,6844,6,12,8,16,37,48,-11,44
Dumbarton,6844,7,10,11,15,49,58,-9,41
Dunfermline,6844,8,9,12,15,43,51,-8,39
Ayr,6844,9,8,12,16,37,65,-28,36
St Mirren,6844,10,8,9,19,39,59,-20,33
Hibernian,6845,1,21,11,4,57,24,33,74
Dundee Utd,6845,2,15,11,10,48,42,6,56
Morton,6845,3,15,10,11,47,44,3,55
Falkirk,6845,4,13,13,10,54,42,12,52
Dunfermline,6845,5,12,12,12,49,46,3,48
Raith,6845,6,13,9,14,40,47,-7,48
Dumbarton,6845,7,10,13,13,50,53,-3,43
Queen of S't,6845,8,10,10,16,44,54,-10,40
Ayr,6845,9,9,11,16,39,56,-17,38
St Mirren,6845,10,6,12,18,36,56,-20,30
Dundee Utd,6846,1,19,8,9,58,37,21,65
Hibernian,6846,2,18,10,8,52,27,25,64
Morton,6846,3,15,13,8,48,36,12,58
Falkirk,6846,4,15,10,11,58,47,11,55
Queen of S't,6846,5,12,9,15,43,51,-8,45
Raith,6846,6,10,13,13,36,46,-10,43
Dunfermline,6846,7,10,12,14,46,51,-5,42
Dumbarton,6846,8,9,11,16,49,59,-10,38
St Mirren,6846,9,9,11,16,39,55,-16,38
Ayr,6846,10,9,11,16,34,54,-20,38
Hibernian,6847,1,19,11,6,59,27,32,68
Morton,6847,2,19,10,7,50,32,18,67
Falkirk,6847,3,16,10,10,59,45,14,58
Dundee Utd,6847,4,16,9,11,49,39,10,57
Raith,6847,5,12,9,15,37,50,-13,45
Ayr,6847,6,11,10,15,37,54,-17,43
Queen of S't,6847,7,11,8,17,42,52,-10,41
Dumbarton,6847,8,10,10,16,49,58,-9,40
St Mirren,6847,9,9,10,17,45,60,-15,37
Dunfermline,6847,10,7,13,16,41,51,-10,34
Hibernian,6848,1,19,13,4,58,28,30,70
Falkirk,6848,2,18,10,8,64,39,25,64
Dundee Utd,6848,3,16,9,11,49,43,6,57
Morton,6848,4,13,11,12,43,42,1,50
Dunfermline,6848,5,11,13,12,52,49,3,46
Queen of S't,6848,6,11,11,14,43,49,-6,44
St Mirren,6848,7,11,9,16,43,57,-14,42
Ayr,6848,8,9,13,14,41,56,-15,40
Raith,6848,9,9,10,17,36,52,-16,37
Dumbarton,6848,10,8,11,17,45,59,-14,35
Morton,6849,1,19,11,6,54,34,20,68
Hibernian,6849,2,18,12,6,53,25,28,66
Falkirk,6849,3,18,9,9,59,39,20,63
Dundee Utd,6849,4,12,12,12,44,42,2,48
Dunfermline,6849,5,12,11,13,48,44,4,47
Queen of S't,6849,6,12,9,15,47,51,-4,45
Ayr,6849,7,9,13,14,34,54,-20,40
Dumbarton,6849,8,9,11,16,45,58,-13,38
St Mirren,6849,9,8,12,16,38,55,-17,36
Raith,6849,10,8,10,18,29,49,-20,34
Morton,6850,1,19,11,6,57,34,23,68
Hibernian,6850,2,16,14,6,52,31,21,62
Falkirk,6850,3,17,10,9,64,41,23,61
Dundee Utd,6850,4,17,8,11,53,45,8,59
Dunfermline,6850,5,12,12,12,47,44,3,48
Queen of S't,6850,6,12,9,15,45,53,-8,45
Raith,6850,7,9,10,17,33,51,-18,37
Dumbarton,6850,8,8,12,16,44,59,-15,36
Ayr,6850,9,8,12,16,34,55,-21,36
St Mirren,6850,10,7,12,17,38,54,-16,33
Hibernian,6851,1,20,10,6,56,25,31,70
Falkirk,6851,2,19,10,7,67,42,25,67
Morton,6851,3,19,10,7,49,35,14,67
Dundee Utd,6851,4,16,8,12,50,39,11,56
Queen of S't,6851,5,13,8,15,48,52,-4,47
Dumbarton,6851,6,9,13,14,49,60,-11,40
St Mirren,6851,7,10,10,16,41,54,-13,40
Dunfermline,6851,8,8,12,16,45,57,-12,36
Ayr,6851,9,8,10,18,32,54,-22,34
Raith,6851,10,8,9,19,33,52,-19,33
Hibernian,6852,1,18,13,5,59,29,30,67
Morton,6852,2,17,10,9,53,45,8,61
Falkirk,6852,3,16,10,10,56,40,16,58
Dundee Utd,6852,4,14,9,13,45,46,-1,51
Queen of S't,6852,5,13,9,14,42,46,-4,48
Dunfermline,6852,6,11,12,13,53,49,4,45
Dumbarton,6852,7,10,12,14,48,53,-5,42
Raith,6852,8,11,8,17,34,48,-14,41
Ayr,6852,9,9,11,16,35,55,-20,38
St Mirren,6852,10,9,10,17,39,53,-14,37
Morton,6853,1,19,12,5,56,35,21,69
Falkirk,6853,2,17,12,7,60,38,22,63
Hibernian,6853,3,16,10,10,49,29,20,58
Dundee Utd,6853,4,14,11,11,48,43,5,53
Dunfermline,6853,5,10,15,11,44,43,1,45
Queen of S't,6853,6,12,8,16,45,53,-8,44
Ayr,6853,7,10,13,13,39,52,-13,43
Raith,6853,8,9,10,17,35,51,-16,37
Dumbarton,6853,9,8,12,16,43,56,-13,36
St Mirren,6853,10,9,9,18,37,56,-19,36
Hibernian,6854,1,19,11,6,62,34,28,68
Morton,6854,2,16,13,7,54,39,15,61
Falkirk,6854,3,16,11,9,59,42,17,59
Dundee Utd,6854,4,14,12,10,52,46,6,54
Queen of S't,6854,5,11,11,14,47,54,-7,44
Dunfermline,6854,6,9,15,12,51,47,4,42
Dumbarton,6854,7,10,12,14,50,58,-8,42
Raith,6854,8,9,12,15,33,46,-13,39
St Mirren,6854,9,9,10,17,42,61,-19,37
Ayr,6854,10,7,13,16,35,58,-23,34
Morton,6855,1,19,11,6,59,33,26,68
Hibernian,6855,2,18,11,7,60,33,27,65
Dundee Utd,6855,3,16,11,9,54,43,11,59
Falkirk,6855,4,16,10,10,59,39,20,58
Dunfermline,6855,5,12,11,13,46,50,-4,47
Queen of S't,6855,6,10,10,16,43,53,-10,40
Raith,6855,7,10,9,17,38,51,-13,39
St Mirren,6855,8,9,11,16,42,57,-15,38
Ayr,6855,9,8,13,15,34,58,-24,37
Dumbarton,6855,10,8,11,17,48,66,-18,35
Hibernian,6856,1,19,11,6,54,29,25,68
Morton,6856,2,18,12,6,57,36,21,66
Dundee Utd,6856,3,18,8,10,51,38,13,62
Falkirk,6856,4,15,9,12,58,47,11,54
Queen of S't,6856,5,14,9,13,47,46,1,51
Ayr,6856,6,9,12,15,35,54,-19,39
Raith,6856,7,9,11,16,37,49,-12,38
Dumbarton,6856,8,8,12,16,46,59,-13,36
St Mirren,6856,9,8,12,16,40,56,-16,36
Dunfermline,6856,10,7,14,15,45,56,-11,35
Falkirk,6857,1,19,9,8,62,37,25,66
Hibernian,6857,2,16,13,7,53,33,20,61
Morton,6857,3,16,12,8,48,37,11,60
Dundee Utd,6857,4,16,8,12,45,40,5,56
Dunfermline,6857,5,13,12,11,58,45,13,51
Queen of S't,6857,6,11,9,16,41,51,-10,42
Dumbarton,6857,7,10,11,15,48,56,-8,41
Ayr,6857,8,9,12,15,37,55,-18,39
St Mirren,6857,9,9,9,18,42,60,-18,36
Raith,6857,10,9,9,18,32,52,-20,36
Hibernian,6858,1,19,11,6,56,26,30,68
Falkirk,6858,2,15,12,9,59,42,17,57
Morton,6858,3,16,9,11,48,40,8,57
Dundee Utd,6858,4,15,11,10,51,40,11,56
Dumbarton,6858,5,11,11,14,51,58,-7,44
Dunfermline,6858,6,10,13,13,45,48,-3,43
Queen of S't,6858,7,11,9,16,48,55,-7,42
Raith,6858,8,11,9,16,35,51,-16,42
St Mirren,6858,9,9,12,15,43,56,-13,39
Ayr,6858,10,8,13,15,32,52,-20,37
Hibernian,6859,1,20,12,4,60,27,33,72
Dundee Utd,6859,2,19,9,8,61,38,23,66
Falkirk,6859,3,16,11,9,60,43,17,59
Morton,6859,4,16,11,9,50,41,9,59
Queen of S't,6859,5,12,10,14,46,55,-9,46
Dunfermline,6859,6,10,13,13,43,43,0,43
Raith,6859,7,9,10,17,37,55,-18,37
Dumbarton,6859,8,8,12,16,44,58,-14,36
St Mirren,6859,9,8,12,16,40,54,-14,36
Ayr,6859,10,7,10,19,33,60,-27,31
Hibernian,6860,1,20,13,3,59,26,33,73
Morton,6860,2,18,11,7,51,35,16,65
Falkirk,6860,3,16,10,10,57,39,18,58
Dundee Utd,6860,4,16,10,10,48,39,9,58
Queen of S't,6860,5,11,10,15,47,50,-3,43
Dunfermline,6860,6,10,12,14,44,49,-5,42
St Mirren,6860,7,9,11,16,37,52,-15,38
Dumbarton,6860,8,9,10,17,46,59,-13,37
Raith,6860,9,9,10,17,35,53,-18,37
Ayr,6860,10,7,13,16,35,57,-22,34
Hibernian,6861,1,19,14,3,58,26,32,71
Morton,6861,2,14,14,8,48,37,11,56
Dundee Utd,6861,3,15,11,10,47,39,8,56
Falkirk,6861,4,14,11,11,57,45,12,53
Queen of S't,6861,5,15,8,13,52,50,2,53
Dunfermline,6861,6,9,15,12,45,46,-1,42
Dumbarton,6861,7,10,12,14,52,59,-7,42
Raith,6861,8,9,12,15,36,50,-14,39
St Mirren,6861,9,9,10,17,42,59,-17,37
Ayr,6861,10,6,13,17,33,59,-26,31
Falkirk,6862,1,18,11,7,61,39,22,65
Morton,6862,2,18,10,8,54,36,18,64
Hibernian,6862,3,17,12,7,50,28,22,63
Dundee Utd,6862,4,17,10,9,54,37,17,61
Dunfermline,6862,5,11,12,13,48,49,-1,45
Queen of S't,6862,6,12,9,15,45,49,-4,45
Dumbarton,6862,7,10,11,15,48,57,-9,41
Raith,6862,8,9,9,18,32,48,-16,36
Ayr,6862,9,7,13,16,34,58,-24,34
St Mirren,6862,10,8,9,19,38,63,-25,33
Hibernian,6863,1,20,12,4,56,22,34,72
Dundee Utd,6863,2,16,11,9,53,39,14,59
Falkirk,6863,3,16,9,11,55,41,14,57
Morton,6863,4,14,13,9,45,38,7,55
Queen of S't,6863,5,12,10,14,45,51,-6,46
Raith,6863,6,12,9,15,37,47,-10,45
Dumbarton,6863,7,10,12,14,49,58,-9,42
Dunfermline,6863,8,9,13,14,46,50,-4,40
Ayr,6863,9,8,12,16,36,57,-21,36
St Mirren,6863,10,7,11,18,37,56,-19,32
Morton,6864,1,17,11,8,46,33,13,62
Hibernian,6864,2,15,15,6,48,26,22,60
Dundee Utd,6864,3,16,10,10,52,37,15,58
Falkirk,6864,4,15,12,9,55,41,14,57
Raith,6864,5,13,8,15,40,46,-6,47
Queen of S't,6864,6,12,10,14,41,47,-6,46
St Mirren,6864,7,12,9,15,45,50,-5,45
Dunfermline,6864,8,9,13,14,42,48,-6,40
Dumbarton,6864,9,8,11,17,46,65,-19,35
Ayr,6864,10,6,15,15,31,53,-22,33
Hibernian,6865,1,21,10,5,57,27,30,73
Dundee Utd,6865,2,17,8,11,49,40,9,59
Falkirk,6865,3,16,9,11,58,43,15,57
Morton,6865,4,15,10,11,45,38,7,55
Dunfermline,6865,5,12,11,13,47,44,3,47
Dumbarton,6865,6,11,10,15,50,60,-10,43
Queen of S't,6865,7,11,9,16,46,54,-8,42
Ayr,6865,8,10,12,14,36,52,-16,42
Raith,6865,9,10,11,15,37,50,-13,41
St Mirren,6865,10,7,10,19,39,56,-17,31
Hibernian,6866,1,18,12,6,54,28,26,66
Dundee Utd,6866,2,18,9,9,56,39,17,63
Morton,6866,3,17,12,7,55,39,16,63
Falkirk,6866,4,14,11,11,55,44,11,53
Queen of S't,6866,5,11,10,15,46,55,-9,43
St Mirren,6866,6,11,10,15,42,51,-9,43
Dumbarton,6866,7,10,12,14,50,56,-6,42
Dunfermline,6866,8,9,13,14,47,50,-3,40
Raith,6866,9,10,10,16,36,50,-14,40
Ayr,6866,10,7,11,18,31,60,-29,32
Hibernian,6867,1,18,13,5,51,24,27,67
Morton,6867,2,16,13,7,45,31,14,61
Falkirk,6867,3,17,9,10,66,44,22,60
Dundee Utd,6867,4,15,11,10,47,39,8,56
Dunfermline,6867,5,12,11,13,47,47,0,47
Raith,6867,6,11,9,16,38,54,-16,42
Dumbarton,6867,7,10,11,15,46,57,-11,41
Queen of S't,6867,8,10,10,16,44,52,-8,40
Ayr,6867,9,8,14,14,36,54,-18,38
St Mirren,6867,10,7,11,18,44,62,-18,32
Hibernian,6868,1,17,14,5,52,26,26,65
Morton,6868,2,18,11,7,56,34,22,65
Falkirk,6868,3,17,10,9,61,43,18,61
Dundee Utd,6868,4,17,9,10,56,40,16,60
Dunfermline,6868,5,11,13,12,48,47,1,46
Queen of S't,6868,6,12,9,15,44,51,-7,45
Dumbarton,6868,7,10,11,15,51,62,-11,41
Raith,6868,8,10,10,16,39,52,-13,40
St Mirren,6868,9,7,11,18,38,63,-25,32
Ayr,6868,10,6,12,18,31,58,-27,30
Hibernian,6869,1,19,12,5,56,26,30,69
Morton,6869,2,17,12,7,47,34,13,63
Falkirk,6869,3,17,9,10,57,38,19,60
Dundee Utd,6869,4,17,8,11,53,41,12,59
Dunfermline,6869,5,10,16,10,47,44,3,46
Queen of S't,6869,6,11,11,14,46,50,-4,44
Raith,6869,7,10,9,17,34,50,-16,39
Ayr,6869,8,9,11,16,34,54,-20,38
Dumbarton,6869,9,8,11,17,45,60,-15,35
St Mirren,6869,10,8,9,19,36,58,-22,33
Hibernian,6870,1,19,11,6,52,28,24,68
Morton,6870,2,19,10,7,54,35,19,67
Falkirk,6870,3,15,12,9,60,41,19,57
Dundee Utd,6870,4,15,9,12,48,43,5,54
Queen of S't,6870,5,11,12,13,48,52,-4,45
Raith,6870,6,11,9,16,37,55,-18,42
Dunfermline,6870,7,9,14,13,48,49,-1,41
St Mirren,6870,8,9,11,16,45,58,-13,38
Ayr,6870,9,8,12,16,33,52,-19,36
Dumbarton,6870,10,7,14,15,50,62,-12,35
Morton,6871,1,19,10,7,48,32,16,67
Falkirk,6871,2,18,11,7,64,37,27,65
Hibernian,6871,3,17,12,7,52,31,21,63
Dundee Utd,6871,4,14,10,12,50,43,7,52
Queen of S't,6871,5,13,9,14,49,48,1,48
Raith,6871,6,12,9,15,46,50,-4,45
Dunfermline,6871,7,9,12,15,42,55,-13,39
Dumbarton,6871,8,8,12,16,48,65,-17,36
Ayr,6871,9,8,12,16,35,56,-21,36
St Mirren,6871,10,8,11,17,43,60,-17,35
Hibernian,6872,1,21,11,4,54,23,31,74
Dundee Utd,6872,2,17,11,8,65,43,22,62
Morton,6872,3,16,12,8,52,37,15,60
Falkirk,6872,4,15,10,11,63,44,19,55
Queen of S't,6872,5,14,8,14,52,52,0,50
Dunfermline,6872,6,10,12,14,45,50,-5,42
Dumbarton,6872,7,9,14,13,51,59,-8,41
Raith,6872,8,8,10,18,31,53,-22,34
Ayr,6872,9,7,13,16,36,61,-25,34
St Mirren,6872,10,7,11,18,38,65,-27,32
Hibernian,6873,1,22,11,3,64,22,42,77
Dundee Utd,6873,2,17,8,11,53,44,9,59
Falkirk,6873,3,16,10,10,57,39,18,58
Morton,6873,4,15,11,10,46,43,3,56
Dunfermline,6873,5,11,12,13,48,48,0,45
Dumbarton,6873,6,11,10,15,54,59,-5,43
Queen of S't,6873,7,11,9,16,45,56,-11,42
Ayr,6873,8,9,12,15,38,57,-19,39
St Mirren,6873,9,8,11,17,40,58,-18,35
Raith,6873,10,8,10,18,34,53,-19,34
Hibernian,6874,1,20,10,6,56,25,31,70
Dundee Utd,6874,2,18,8,10,59,38,21,62
Morton,6874,3,16,11,9,46,41,5,59
Falkirk,6874,4,16,9,11,55,44,11,57
Dunfermline,6874,5,12,11,13,46,44,2,47
Queen of S't,6874,6,12,9,15,47,49,-2,45
Raith,6874,7,10,10,16,40,52,-12,40
Dumbarton,6874,8,9,11,16,45,59,-14,38
Ayr,6874,9,9,11,16,36,57,-21,38
St Mirren,6874,10,8,10,18,39,60,-21,34
Hibernian,6875,1,19,13,4,58,24,34,70
Morton,6875,2,18,11,7,53,37,16,65
Falkirk,6875,3,17,9,10,61,42,19,60
Dundee Utd,6875,4,15,10,11,52,43,9,55
Dunfermline,6875,5,10,12,14,47,53,-6,42
Queen of S't,6875,6,11,9,16,43,53,-10,42
Raith,6875,7,10,11,15,37,51,-14,41
Dumbarton,6875,8,10,10,16,55,62,-7,40
St Mirren,6875,9,9,12,15,44,56,-12,39
Ayr,6875,10,6,13,17,31,60,-29,31
Hibernian,6876,1,17,13,6,58,31,27,64
Morton,6876,2,17,10,9,56,43,13,61
Dundee Utd,6876,3,16,11,9,53,38,15,59
Falkirk,6876,4,15,13,8,58,40,18,58
Queen of S't,6876,5,12,11,13,46,49,-3,47
Dunfermline,6876,6,10,13,13,53,55,-2,43
St Mirren,6876,7,10,10,16,44,56,-12,40
Raith,6876,8,10,10,16,41,56,-15,40
Dumbarton,6876,9,9,12,15,47,61,-14,39
Ayr,6876,10,7,11,18,32,59,-27,32
Hibernian,6877,1,18,14,4,55,28,27,68
Morton,6877,2,17,13,6,55,36,19,64
Falkirk,6877,3,15,12,9,54,37,17,57
Dundee Utd,6877,4,14,11,11,45,42,3,53
Queen of S't,6877,5,11,11,14,49,56,-7,44
St Mirren,6877,6,9,13,14,46,58,-12,40
Dumbarton,6877,7,9,12,15,50,58,-8,39
Ayr,6877,8,9,12,15,41,55,-14,39
Dunfermline,6877,9,8,14,14,42,48,-6,38
Raith,6877,10,8,12,16,39,58,-19,36
Hibernian,6878,1,18,12,6,57,32,25,66
Morton,6878,2,18,12,6,55,33,22,66
Dundee Utd,6878,3,15,10,11,48,43,5,55
Falkirk,6878,4,13,10,13,51,49,2,49
Queen of S't,6878,5,13,8,15,47,49,-2,47
Raith,6878,6,11,10,15,39,47,-8,43
St Mirren,6878,7,11,10,15,41,53,-12,43
Dunfermline,6878,8,9,13,14,48,53,-5,40
Dumbarton,6878,9,9,12,15,48,55,-7,39
Ayr,6878,10,9,11,16,34,54,-20,38
Hibernian,6879,1,19,14,3,56,24,32,71
Morton,6879,2,15,13,8,51,42,9,58
Dundee Utd,6879,3,16,9,11,49,40,9,57
Falkirk,6879,4,15,10,11,57,46,11,55
Queen of S't,6879,5,13,9,14,48,48,0,48
Dunfermline,6879,6,10,14,12,49,49,0,44
Raith,6879,7,11,9,16,38,52,-14,42
Dumbarton,6879,8,9,12,15,48,56,-8,39
St Mirren,6879,9,8,11,17,44,57,-13,35
Ayr,6879,10,7,13,16,29,55,-26,34
Hibernian,6880,1,21,11,4,59,25,34,74
Falkirk,6880,2,17,11,8,65,40,25,62
Morton,6880,3,15,13,8,45,35,10,58
Dundee Utd,6880,4,16,9,11,54,45,9,57
Dunfermline,6880,5,10,14,12,46,47,-1,44
Raith,6880,6,11,8,17,36,49,-13,41
Queen of S't,6880,7,10,10,16,42,51,-9,40
Dumbarton,6880,8,8,15,13,44,52,-8,39
Ayr,6880,9,8,12,16,33,58,-25,36
St Mirren,6880,10,7,11,18,36,58,-22,32
Hibernian,6881,1,20,12,4,56,23,33,72
Morton,6881,2,16,13,7,50,36,14,61
Falkirk,6881,3,16,10,10,56,43,13,58
Dundee Utd,6881,4,14,11,11,45,41,4,53
Dumbarton,6881,5,11,12,13,51,55,-4,45
Dunfermline,6881,6,10,13,13,52,47,5,43
Raith,6881,7,10,9,17,36,50,-14,39
Queen of S't,6881,8,9,11,16,41,54,-13,38
Ayr,6881,9,8,13,15,32,53,-21,37
St Mirren,6881,10,7,14,15,39,56,-17,35
Hibernian,6882,1,20,12,4,57,24,33,72
Morton,6882,2,16,13,7,51,40,11,61
Dundee Utd,6882,3,17,8,11,57,40,17,59
Falkirk,6882,4,15,11,10,55,42,13,56
Dunfermline,6882,5,11,13,12,51,49,2,46
Queen of S't,6882,6,10,10,16,40,50,-10,40
Dumbarton,6882,7,9,12,15,47,57,-10,39
Ayr,6882,8,9,12,15,33,51,-18,39
St Mirren,6882,9,9,10,17,40,58,-18,37
Raith,6882,10,9,9,18,32,52,-20,36
Falkirk,6883,1,19,10,7,68,37,31,67
Hibernian,6883,2,19,10,7,55,28,27,67
Morton,6883,3,18,11,7,50,36,14,65
Dundee Utd,6883,4,17,10,9,55,40,15,61
Dunfermline,6883,5,10,13,13,46,48,-2,43
Queen of S't,6883,6,11,10,15,44,54,-10,43
Dumbarton,6883,7,9,13,14,51,59,-8,40
Ayr,6883,8,8,12,16,33,52,-19,36
Raith,6883,8,9,9,18,33,52,-19,36
St Mirren,6883,10,6,10,20,35,64,-29,28
Hibernian,6884,1,18,13,5,53,27,26,67
Dundee Utd,6884,2,18,9,9,55,41,14,63
Morton,6884,3,16,10,10,50,39,11,58
Falkirk,6884,4,15,10,11,58,46,12,55
Queen of S't,6884,5,12,11,13,49,49,0,47
Dumbarton,6884,6,9,13,14,49,59,-10,40
St Mirren,6884,7,10,10,16,42,54,-12,40
Raith,6884,8,9,12,15,32,48,-16,39
Ayr,6884,9,9,12,15,39,56,-17,39
Dunfermline,6884,10,8,12,16,44,52,-8,36
Hibernian,6885,1,19,12,5,54,27,27,69
Dundee Utd,6885,2,18,10,8,58,38,20,64
Morton,6885,3,17,10,9,45,33,12,61
Falkirk,6885,4,16,12,8,60,40,20,60
Queen of S't,6885,5,11,11,14,50,52,-2,44
Dunfermline,6885,6,10,13,13,44,46,-2,43
Raith,6885,7,10,10,16,35,52,-17,40
Dumbarton,6885,8,9,10,17,43,59,-16,37
St Mirren,6885,9,8,10,18,39,57,-18,34
Ayr,6885,10,7,12,17,32,56,-24,33
Hibernian,6886,1,19,12,5,59,25,34,69
Falkirk,6886,2,17,9,10,60,40,20,60
Morton,6886,3,16,12,8,49,40,9,60
Dundee Utd,6886,4,16,10,10,50,41,9,58
Queen of S't,6886,5,13,8,15,42,51,-9,47
Dumbarton,6886,6,11,10,15,54,59,-5,43
Dunfermline,6886,7,10,12,14,46,49,-3,42
St Mirren,6886,8,9,10,17,41,57,-16,37
Raith,6886,9,9,10,17,35,55,-20,37
Ayr,6886,10,7,13,16,34,53,-19,34
Hibernian,6887,1,17,14,5,51,24,27,65
Dundee Utd,6887,2,18,9,9,56,43,13,63
Falkirk,6887,3,17,10,9,63,47,16,61
Morton,6887,4,15,13,8,51,42,9,58
Dunfermline,6887,5,12,12,12,52,48,4,48
Queen of S't,6887,6,11,9,16,45,50,-5,42
Dumbarton,6887,7,9,13,14,51,61,-10,40
Raith,6887,8,10,8,18,35,53,-18,38
St Mirren,6887,9,8,13,15,43,55,-12,37
Ayr,6887,10,7,11,18,31,55,-24,32
Hibernian,6888,1,19,12,5,60,28,32,69
Falkirk,6888,2,16,11,9,58,39,19,59
Morton,6888,3,16,11,9,46,36,10,59
Dundee Utd,6888,4,15,11,10,44,38,6,56
Queen of S't,6888,5,15,8,13,50,48,2,53
Dunfermline,6888,6,11,12,13,44,44,0,45
St Mirren,6888,7,9,10,17,43,58,-15,37
Ayr,6888,8,8,13,15,37,55,-18,37
Raith,6888,9,9,10,17,34,54,-20,37
Dumbarton,6888,10,7,12,17,43,59,-16,33
Hibernian,6889,1,20,11,5,58,25,33,71
Morton,6889,2,20,11,5,56,31,25,71
Dundee Utd,6889,3,15,10,11,52,46,6,55
Falkirk,6889,4,13,12,11,55,47,8,51
Queen of S't,6889,5,13,10,13,52,50,2,49
Dunfermline,6889,6,12,12,12,51,49,2,48
Dumbarton,6889,7,10,11,15,48,57,-9,41
Raith,6889,8,9,9,18,37,55,-18,36
Ayr,6889,9,7,13,16,34,62,-28,34
St Mirren,6889,10,6,11,19,35,56,-21,29
Hibernian,6890,1,19,12,5,56,28,28,69
Dundee Utd,6890,2,17,9,10,61,46,15,60
Morton,6890,3,16,11,9,48,36,12,59
Falkirk,6890,4,15,13,8,59,42,17,58
Dumbarton,6890,5,11,12,13,54,58,-4,45
Queen of S't,6890,6,11,10,15,43,54,-11,43
Ayr,6890,7,9,12,15,36,55,-19,39
Dunfermline,6890,8,8,14,14,42,46,-4,38
St Mirren,6890,9,8,12,16,39,54,-15,36
Raith,6890,10,9,9,18,32,51,-19,36
Hibernian,6891,1,19,13,4,52,23,29,70
Dundee Utd,6891,2,17,11,8,56,40,16,62
Morton,6891,3,15,11,10,45,37,8,56
Falkirk,6891,4,15,10,11,58,42,16,55
Queen of S't,6891,5,10,12,14,43,50,-7,42
Dunfermline,6891,6,9,14,13,40,46,-6,41
Dumbarton,6891,7,9,14,13,47,54,-7,41
Raith,6891,8,9,12,15,33,47,-14,39
Ayr,6891,9,8,13,15,37,56,-19,37
St Mirren,6891,10,8,12,16,37,53,-16,36
Hibernian,6892,1,17,12,7,49,24,25,63
Falkirk,6892,2,17,10,9,57,39,18,61
Dundee Utd,6892,3,17,9,10,55,43,12,60
Morton,6892,4,16,11,9,48,40,8,59
Dunfermline,6892,5,11,12,13,44,46,-2,45
Dumbarton,6892,6,11,12,13,51,55,-4,45
Queen of S't,6892,7,10,10,16,42,51,-9,40
Ayr,6892,8,8,15,13,36,53,-17,39
Raith,6892,9,9,11,16,34,48,-14,38
St Mirren,6892,10,7,12,17,38,55,-17,33
Hibernian,6893,1,20,12,4,61,27,34,72
Morton,6893,2,16,13,7,55,37,18,61
Falkirk,6893,3,16,12,8,62,42,20,60
Dundee Utd,6893,4,16,10,10,50,39,11,58
Dumbarton,6893,5,10,12,14,49,58,-9,42
Raith,6893,6,11,9,16,40,51,-11,42
Dunfermline,6893,7,9,14,13,45,51,-6,41
Queen of S't,6893,8,11,8,17,42,53,-11,41
Ayr,6893,9,8,11,17,30,56,-26,35
St Mirren,6893,10,7,11,18,40,60,-20,32
Hibernian,6894,1,18,13,5,54,26,28,67
Morton,6894,2,18,11,7,52,35,17,65
Dundee Utd,6894,3,16,11,9,51,41,10,59
Falkirk,6894,4,15,10,11,54,40,14,55
Dunfermline,6894,5,11,13,12,44,44,0,46
Queen of S't,6894,6,11,10,15,41,50,-9,43
Raith,6894,7,11,8,17,37,49,-12,41
Ayr,6894,8,8,15,13,34,50,-16,39
Dumbarton,6894,9,8,11,17,42,56,-14,35
St Mirren,6894,10,8,10,18,38,56,-18,34
Hibernian,6895,1,18,12,6,51,26,25,66
Morton,6895,2,17,12,7,51,32,19,63
Dundee Utd,6895,3,18,8,10,54,37,17,62
Falkirk,6895,4,17,10,9,62,43,19,61
Dumbarton,6895,5,12,11,13,54,57,-3,47
Dunfermline,6895,6,10,13,13,47,54,-7,43
Queen of S't,6895,7,10,9,17,41,51,-10,39
Ayr,6895,8,9,12,15,32,52,-20,39
Raith,6895,9,10,8,18,31,48,-17,38
St Mirren,6895,10,7,9,20,35,58,-23,30
Hibernian,6896,1,18,12,6,57,29,28,66
Morton,6896,2,18,9,9,52,38,14,63
Falkirk,6896,3,15,10,11,60,48,12,55
Dundee Utd,6896,4,15,9,12,46,40,6,54
Dunfermline,6896,5,12,12,12,49,45,4,48
Queen of S't,6896,6,11,11,14,38,46,-8,44
St Mirren,6896,7,11,9,16,44,58,-14,42
Raith,6896,8,11,8,17,38,53,-15,41
Dumbarton,6896,9,10,10,16,47,56,-9,40
Ayr,6896,10,8,12,16,35,53,-18,36
Morton,6897,1,20,9,7,55,35,20,69
Hibernian,6897,2,19,10,7,52,31,21,67
Falkirk,6897,3,17,10,9,58,38,20,61
Dundee Utd,6897,4,14,10,12,43,41,2,52
Queen of S't,6897,5,13,9,14,48,48,0,48
Dunfermline,6897,6,11,12,13,49,48,1,45
Ayr,6897,7,9,12,15,38,58,-20,39
Dumbarton,6897,8,9,11,16,46,57,-11,38
Raith,6897,9,9,10,17,36,53,-17,37
St Mirren,6897,10,8,9,19,44,60,-16,33
Hibernian,6898,1,19,12,5,54,24,30,69
Dundee Utd,6898,2,18,9,9,54,37,17,63
Morton,6898,3,17,10,9,51,39,12,61
Falkirk,6898,4,14,11,11,55,46,9,53
Dunfermline,6898,5,12,12,12,49,44,5,48
Dumbarton,6898,6,9,13,14,51,59,-8,40
Raith,6898,7,10,10,16,36,50,-14,40
Queen of S't,6898,8,10,9,17,40,52,-12,39
St Mirren,6898,9,9,11,16,41,57,-16,38
Ayr,6898,10,7,13,16,35,58,-23,34
Hibernian,6899,1,18,12,6,52,27,25,66
Falkirk,6899,2,18,10,8,66,41,25,64
Morton,6899,3,17,13,6,55,34,21,64
Dundee Utd,6899,4,13,9,14,47,46,1,48
Dunfermline,6899,5,10,16,10,49,47,2,46
Raith,6899,6,12,8,16,40,46,-6,44
Dumbarton,6899,7,10,10,16,48,58,-10,40
Queen of S't,6899,8,10,10,16,41,51,-10,40
Ayr,6899,9,9,12,15,35,55,-20,39
St Mirren,6899,10,8,10,18,37,65,-28,34
Hibernian,6900,1,18,12,6,55,29,26,66
Morton,6900,2,15,14,7,50,36,14,59
Dundee Utd,6900,3,15,12,9,48,39,9,57
Falkirk,6900,4,15,11,10,60,44,16,56
Dunfermline,6900,5,11,14,11,48,45,3,47
Queen of S't,6900,6,12,11,13,45,47,-2,47
Dumbarton,6900,7,10,12,14,50,57,-7,42
Raith,6900,8,8,12,16,33,49,-16,36
Ayr,6900,9,7,14,15,33,57,-24,35
St Mirren,6900,10,8,10,18,36,55,-19,34
Hibernian,6901,1,18,14,4,59,25,34,68
Falkirk,6901,2,17,11,8,57,37,20,62
Dundee Utd,6901,3,16,9,11,49,43,6,57
Morton,6901,4,14,14,8,47,38,9,56
Queen of S't,6901,5,12,10,14,46,47,-1,46
Dunfermline,6901,6,9,14,13,41,50,-9,41
St Mirren,6901,7,10,10,16,44,54,-10,40
Dumbarton,6901,8,9,12,15,45,57,-12,39
Raith,6901,9,9,10,17,32,50,-18,37
Ayr,6901,10,8,12,16,35,54,-19,36
Hibernian,6902,1,20,12,4,60,26,34,72
Morton,6902,2,17,12,7,47,35,12,63
Falkirk,6902,3,15,10,11,50,38,12,55
Dundee Utd,6902,4,14,13,9,47,39,8,55
Queen of S't,6902,5,13,10,13,49,50,-1,49
Dunfermline,6902,6,10,11,15,45,48,-3,41
Dumbarton,6902,7,10,11,15,50,59,-9,41
St Mirren,6902,8,9,11,16,38,51,-13,38
Raith,6902,9,9,9,18,33,51,-18,36
Ayr,6902,10,8,11,17,34,56,-22,35
Hibernian,6903,1,19,12,5,52,24,28,69
Falkirk,6903,2,18,11,7,60,38,22,65
Morton,6903,3,18,11,7,49,35,14,65
Dundee Utd,6903,4,13,9,14,47,45,2,48
Raith,6903,5,12,11,13,42,44,-2,47
Queen of S't,6903,6,11,9,16,46,53,-7,42
Dunfermline,6903,7,9,12,15,41,49,-8,39
Ayr,6903,8,9,12,15,35,52,-17,39
St Mirren,6903,9,8,12,16,43,57,-14,36
Dumbarton,6903,10,8,11,17,44,62,-18,35
Hibernian,6904,1,20,10,6,59,27,32,70
Morton,6904,2,18,12,6,52,35,17,66
Falkirk,6904,3,16,9,11,62,49,13,57
Dundee Utd,6904,4,15,11,10,48,41,7,56
Dunfermline,6904,5,11,15,10,48,44,4,48
Raith,6904,6,11,10,15,36,48,-12,43
Queen of S't,6904,7,11,9,16,45,51,-6,42
Dumbarton,6904,8,9,11,16,48,59,-11,38
Ayr,6904,9,7,12,17,30,54,-24,33
St Mirren,6904,10,6,13,17,36,56,-20,31
Hibernian,6905,1,20,10,6,57,27,30,70
Morton,6905,2,17,10,9,52,38,14,61
Falkirk,6905,3,16,11,9,59,42,17,59
Dundee Utd,6905,4,14,12,10,47,39,8,54
Dunfermline,6905,5,11,12,13,44,46,-2,45
Queen of S't,6905,6,12,9,15,43,48,-5,45
St Mirren,6905,7,10,10,16,51,52,-1,40
Raith,6905,8,9,12,15,35,52,-17,39
Dumbarton,6905,9,9,11,16,48,62,-14,38
Ayr,6905,10,7,13,16,33,63,-30,34
Hibernian,6906,1,18,14,4,57,27,30,68
Morton,6906,2,17,11,8,49,40,9,62
Dundee Utd,6906,3,16,10,10,54,43,11,58
Falkirk,6906,4,15,10,11,57,42,15,55
Queen of S't,6906,5,13,9,14,48,49,-1,48
Dunfermline,6906,6,11,12,13,49,50,-1,45
St Mirren,6906,7,9,12,15,41,51,-10,39
Ayr,6906,8,8,14,14,37,56,-19,38
Dumbarton,6906,9,8,12,16,46,58,-12,36
Raith,6906,10,9,8,19,32,54,-22,35
Hibernian,6907,1,18,12,6,52,25,27,66
Morton,6907,2,16,11,9,44,33,11,59
Falkirk,6907,3,15,11,10,56,40,16,56
Dundee Utd,6907,4,13,12,11,45,42,3,51
Dunfermline,6907,5,13,11,12,48,43,5,50
Ayr,6907,6,11,12,13,39,52,-13,45
Queen of S't,6907,7,11,10,15,41,48,-7,43
Raith,6907,8,11,10,15,34,48,-14,43
St Mirren,6907,9,8,12,16,37,52,-15,36
Dumbarton,6907,10,8,11,17,44,57,-13,35
Hibernian,6908,1,18,15,3,57,26,31,69
Dundee Utd,6908,2,18,9,9,57,36,21,63
Morton,6908,3,16,13,7,50,34,16,61
Falkirk,6908,4,16,10,10,60,39,21,58
Queen of S't,6908,5,13,9,14,45,49,-4,48
Raith,6908,6,10,11,15,34,46,-12,41
Dunfermline,6908,7,8,13,15,40,52,-12,37
Dumbarton,6908,8,8,12,16,47,59,-12,36
St Mirren,6908,9,8,12,16,36,57,-21,36
Ayr,6908,10,7,12,17,28,56,-28,33
Hibernian,6909,1,20,10,6,63,32,31,70
Morton,6909,2,17,10,9,48,37,11,61
Dundee Utd,6909,3,14,14,8,52,42,10,56
Falkirk,6909,4,15,10,11,57,44,13,55
Dumbarton,6909,5,11,12,13,52,54,-2,45
Dunfermline,6909,6,10,14,12,46,47,-1,44
Queen of S't,6909,7,10,11,15,42,49,-7,41
Raith,6909,8,10,10,16,37,50,-13,40
Ayr,6909,9,9,12,15,35,57,-22,39
St Mirren,6909,10,6,13,17,37,57,-20,31
Hibernian,6910,1,22,10,4,61,23,38,76
Falkirk,6910,2,16,10,10,60,43,17,58
Morton,6910,3,16,10,10,50,43,7,58
Dundee Utd,6910,4,16,9,11,51,40,11,57
Dunfermline,6910,5,11,11,14,47,49,-2,44
Queen of S't,6910,6,11,11,14,46,52,-6,44
Dumbarton,6910,7,10,11,15,52,60,-8,41
St Mirren,6910,8,10,9,17,40,56,-16,39
Raith,6910,9,9,9,18,32,52,-20,36
Ayr,6910,10,8,12,16,34,55,-21,36
Hibernian,6911,1,20,10,6,64,26,38,70
Morton,6911,2,17,11,8,51,40,11,62
Dundee Utd,6911,3,15,11,10,47,38,9,56
Falkirk,6911,4,14,10,12,52,46,6,52
Queen of S't,6911,5,12,11,13,44,49,-5,47
Dunfermline,6911,6,11,12,13,48,50,-2,45
Raith,6911,7,11,8,17,40,51,-11,41
Dumbarton,6911,8,8,14,14,50,61,-11,38
St Mirren,6911,9,9,11,16,42,53,-11,38
Ayr,6911,10,7,14,15,33,57,-24,35
Hibernian,6912,1,20,12,4,63,25,38,72
Morton,6912,2,16,10,10,47,40,7,58
Falkirk,6912,3,16,9,11,59,43,16,57
Dundee Utd,6912,4,13,10,13,44,42,2,49
Dunfermline,6912,5,11,14,11,49,46,3,47
Queen of S't,6912,6,12,8,16,46,52,-6,44
Dumbarton,6912,7,10,12,14,46,53,-7,42
Raith,6912,8,11,8,17,33,51,-18,41
Ayr,6912,9,10,11,15,32,53,-21,41
St Mirren,6912,10,8,12,16,39,53,-14,36
Hibernian,6913,1,20,12,4,57,25,32,72
Falkirk,6913,2,16,12,8,58,40,18,60
Dundee Utd,6913,3,16,11,9,47,38,9,59
Morton,6913,4,14,13,9,45,36,9,55
Dunfermline,6913,5,10,15,11,48,45,3,45
Raith,6913,6,10,11,15,33,45,-12,41
Queen of S't,6913,7,9,12,15,41,50,-9,39
Dumbarton,6913,8,9,11,16,45,55,-10,38
St Mirren,6913,9,9,11,16,40,55,-15,38
Ayr,6913,10,6,14,16,27,52,-25,32
Hibernian,6914,1,21,11,4,58,22,36,74
Dundee Utd,6914,2,16,11,9,51,39,12,59
Morton,6914,3,15,13,8,45,35,10,58
Falkirk,6914,4,15,11,10,56,41,15,56
Queen of S't,6914,5,12,9,15,50,51,-1,45
Dunfermline,6914,6,10,13,13,43,47,-4,43
Raith,6914,7,11,10,15,37,50,-13,43
Dumbarton,6914,8,9,10,17,46,64,-18,37
St Mirren,6914,9,8,11,17,40,55,-15,35
Ayr,6914,10,8,11,17,36,58,-22,35
Morton,6915,1,19,11,6,55,37,18,68
Hibernian,6915,2,17,14,5,54,27,27,65
Falkirk,6915,3,15,12,9,59,43,16,57
Dundee Utd,6915,4,13,11,12,48,43,5,50
Dunfermline,6915,5,11,13,12,47,46,1,46
Raith,6915,6,11,11,14,34,45,-11,44
Queen of S't,6915,7,11,9,16,44,54,-10,42
Ayr,6915,8,9,12,15,36,51,-15,39
St Mirren,6915,9,9,10,17,46,56,-10,37
Dumbarton,6915,10,8,11,17,44,65,-21,35
Hibernian,6916,1,17,13,6,50,28,22,64
Morton,6916,2,17,11,8,52,36,16,62
Dundee Utd,6916,3,17,10,9,56,40,16,61
Falkirk,6916,4,16,10,10,55,38,17,58
Queen of S't,6916,5,13,10,13,51,51,0,49
Dunfermline,6916,6,10,13,13,44,44,0,43
Ayr,6916,7,10,11,15,40,55,-15,41
Raith,6916,8,10,10,16,33,47,-14,40
Dumbarton,6916,9,8,10,18,44,65,-21,34
St Mirren,6916,10,7,12,17,37,58,-21,33
Hibernian,6917,1,19,12,5,57,28,29,69
Morton,6917,2,17,9,10,48,39,9,60
Falkirk,6917,3,14,12,10,60,45,15,54
Dundee Utd,6917,4,14,9,13,46,42,4,51
Queen of S't,6917,5,12,10,14,47,50,-3,46
Dunfermline,6917,6,11,12,13,49,47,2,45
Ayr,6917,7,11,12,13,39,49,-10,45
Dumbarton,6917,8,10,12,14,50,59,-9,42
Raith,6917,9,9,11,16,39,55,-16,38
St Mirren,6917,10,8,11,17,37,58,-21,35
Hibernian,6918,1,19,14,3,60,25,35,71
Morton,6918,2,17,11,8,52,42,10,62
Falkirk,6918,3,15,10,11,53,39,14,55
Dundee Utd,6918,4,14,10,12,46,41,5,52
Dumbarton,6918,5,11,10,15,52,61,-9,43
Queen of S't,6918,6,11,10,15,45,54,-9,43
Dunfermline,6918,7,10,11,15,48,51,-3,41
St Mirren,6918,8,10,10,16,42,52,-10,40
Ayr,6918,9,9,13,14,32,51,-19,40
Raith,6918,10,10,9,17,33,47,-14,39
Morton,6919,1,19,12,5,53,34,19,69
Hibernian,6919,2,18,12,6,52,25,27,66
Dundee Utd,6919,3,16,11,9,55,42,13,59
Falkirk,6919,4,15,11,10,62,40,22,56
Raith,6919,5,13,9,14,41,49,-8,48
Dunfermline,6919,6,9,14,13,39,44,-5,41
Dumbarton,6919,7,9,11,16,49,62,-13,38
Queen of S't,6919,8,9,11,16,41,55,-14,38
St Mirren,6919,9,8,11,17,46,64,-18,35
Ayr,6919,10,7,12,17,36,59,-23,33
Hibernian,6920,1,20,12,4,57,27,30,72
Morton,6920,2,17,13,6,50,33,17,64
Dundee Utd,6920,3,16,10,10,52,40,12,58
Falkirk,6920,4,14,14,8,53,37,16,56
Queen of S't,6920,5,12,10,14,49,51,-2,46
Dunfermline,6920,6,9,15,12,46,49,-3,42
Ayr,6920,7,10,12,14,38,53,-15,42
Raith,6920,8,8,11,17,35,52,-17,35
Dumbarton,6920,9,7,12,17,45,63,-18,33
St Mirren,6920,10,7,11,18,39,59,-20,32
Hibernian,6921,1,19,13,4,56,27,29,70
Falkirk,6921,2,18,9,9,62,40,22,63
Dundee Utd,6921,3,17,11,8,53,38,15,62
Morton,6921,4,15,12,9,46,37,9,57
Dunfermline,6921,5,10,13,13,46,46,0,43
Dumbarton,6921,6,10,12,14,46,53,-7,42
Raith,6921,7,10,10,16,37,49,-12,40
Queen of S't,6921,8,9,9,18,41,59,-18,36
St Mirren,6921,9,8,12,16,36,55,-19,36
Ayr,6921,10,7,13,16,31,50,-19,34
Hibernian,6922,1,20,12,4,58,25,33,72
Dundee Utd,6922,2,19,9,8,55,38,17,66
Morton,6922,3,17,12,7,48,34,14,63
Falkirk,6922,4,14,12,10,55,40,15,54
Queen of S't,6922,5,11,9,16,46,58,-12,42
Raith,6922,6,10,11,15,38,47,-9,41
Dunfermline,6922,7,9,12,15,47,53,-6,39
Dumbarton,6922,8,9,12,15,47,54,-7,39
Ayr,6922,9,7,13,16,31,58,-27,34
St Mirren,6922,10,6,14,16,39,57,-18,32
Hibernian,6923,1,19,13,4,58,27,31,70
Morton,6923,2,17,11,8,52,37,15,62
Dundee Utd,6923,3,16,12,8,45,34,11,60
Falkirk,6923,4,16,11,9,56,38,18,59
Dunfermline,6923,5,10,15,11,49,49,0,45
Queen of S't,6923,6,11,11,14,44,47,-3,44
Raith,6923,7,9,12,15,36,48,-12,39
St Mirren,6923,8,8,11,17,40,60,-20,35
Dumbarton,6923,9,7,12,17,44,59,-15,33
Ayr,6923,10,7,12,17,32,57,-25,33
Hibernian,6924,1,20,12,4,58,27,31,72
Falkirk,6924,2,17,10,9,64,46,18,61
Dundee Utd,6924,3,16,9,11,51,44,7,57
Morton,6924,4,14,12,10,48,40,8,54
Dunfermline,6924,5,10,14,12,47,47,0,44
Raith,6924,6,12,8,16,37,48,-11,44
Queen of S't,6924,7,11,10,15,44,49,-5,43
St Mirren,6924,8,9,12,15,40,54,-14,39
Ayr,6924,9,9,10,17,43,57,-14,37
Dumbarton,6924,10,8,11,17,48,68,-20,35
Hibernian,6925,1,19,13,4,54,27,27,70
Morton,6925,2,18,10,8,53,35,18,64
Dundee Utd,6925,3,18,8,10,55,38,17,62
Falkirk,6925,4,17,10,9,60,38,22,61
Queen of S't,6925,5,12,8,16,51,55,-4,44
Raith,6925,6,11,10,15,34,44,-10,43
Dunfermline,6925,7,8,13,15,44,55,-11,37
Dumbarton,6925,8,9,10,17,45,59,-14,37
St Mirren,6925,9,9,10,17,41,59,-18,37
Ayr,6925,10,8,10,18,30,57,-27,34
Hibernian,6926,1,18,12,6,58,31,27,66
Falkirk,6926,2,16,12,8,61,40,21,60
Dundee Utd,6926,3,15,12,9,49,37,12,57
Morton,6926,4,15,12,9,47,37,10,57
Dunfermline,6926,5,11,15,10,51,45,6,48
Dumbarton,6926,6,9,14,13,48,55,-7,41
Raith,6926,7,11,8,17,33,48,-15,41
Queen of S't,6926,8,10,9,17,45,62,-17,39
St Mirren,6926,9,8,13,15,43,56,-13,37
Ayr,6926,10,8,11,17,33,57,-24,35
Hibernian,6927,1,19,12,5,54,27,27,69
Morton,6927,2,17,11,8,49,36,13,62
Falkirk,6927,3,16,11,9,63,43,20,59
Dundee Utd,6927,4,16,11,9,51,38,13,59
Queen of S't,6927,5,12,10,14,43,45,-2,46
Dunfermline,6927,6,9,14,13,42,45,-3,41
St Mirren,6927,7,9,10,17,44,59,-15,37
Dumbarton,6927,8,8,13,15,47,64,-17,37
Ayr,6927,9,8,12,16,36,54,-18,36
Raith,6927,10,8,12,16,34,52,-18,36
Hibernian,6928,1,19,12,5,54,24,30,69
Morton,6928,2,17,10,9,47,37,10,61
Falkirk,6928,3,16,11,9,55,40,15,59
Dundee Utd,6928,4,16,9,11,52,39,13,57
Queen of S't,6928,5,12,9,15,46,49,-3,45
Dunfermline,6928,6,10,13,13,46,47,-1,43
Ayr,6928,7,10,11,15,36,54,-18,41
Raith,6928,8,10,10,16,35,48,-13,40
St Mirren,6928,9,8,12,16,40,54,-14,36
Dumbarton,6928,10,8,11,17,43,62,-19,35
Hibernian,6929,1,20,12,4,57,28,29,72
Morton,6929,2,17,11,8,50,35,15,62
Dundee Utd,6929,3,18,8,10,55,41,14,62
Falkirk,6929,4,16,10,10,61,41,20,58
St Mirren,6929,5,12,9,15,46,53,-7,45
Queen of S't,6929,6,12,8,16,44,51,-7,44
Dunfermline,6929,7,9,13,14,42,47,-5,40
Raith,6929,8,9,10,17,34,53,-19,37
Dumbarton,6929,9,8,11,17,47,62,-15,35
Ayr,6929,10,7,12,17,34,59,-25,33
Hibernian,6930,1,19,12,5,58,31,27,69
Falkirk,6930,2,18,10,8,64,37,27,64
Morton,6930,3,16,12,8,46,35,11,60
Dundee Utd,6930,4,15,9,12,52,43,9,54
Queen of S't,6930,5,12,9,15,45,52,-7,45
Dunfermline,6930,6,9,14,13,46,47,-1,41
St Mirren,6930,7,10,11,15,44,53,-9,41
Raith,6930,8,11,8,17,36,53,-17,41
Dumbarton,6930,9,8,11,17,44,63,-19,35
Ayr,6930,10,7,14,15,35,56,-21,35
Hibernian,6931,1,20,11,5,57,26,31,71
Morton,6931,2,16,13,7,52,40,12,61
Dundee Utd,6931,3,16,12,8,53,39,14,60
Falkirk,6931,4,16,9,11,57,40,17,57
Queen of S't,6931,5,14,9,13,48,46,2,51
Dunfermline,6931,6,10,12,14,46,50,-4,42
Raith,6931,7,9,11,16,34,48,-14,38
Ayr,6931,8,8,13,15,34,56,-22,37
Dumbarton,6931,9,7,13,16,47,64,-17,34
St Mirren,6931,10,7,11,18,41,60,-19,32
Hibernian,6932,1,22,11,3,61,21,40,77
Morton,6932,2,17,10,9,51,40,11,61
Dundee Utd,6932,3,17,9,10,55,38,17,60
Falkirk,6932,4,15,10,11,54,43,11,55
Queen of S't,6932,5,11,11,14,46,51,-5,44
Dumbarton,6932,6,11,11,14,52,60,-8,44
Dunfermline,6932,7,8,15,13,47,53,-6,39
Raith,6932,8,8,12,16,33,50,-17,36
St Mirren,6932,9,8,11,17,39,57,-18,35
Ayr,6932,10,7,12,17,31,56,-25,33
Hibernian,6933,1,19,13,4,59,31,28,70
Morton,6933,2,17,11,8,57,39,18,62
Dundee Utd,6933,3,16,10,10,50,41,9,58
Falkirk,6933,4,15,11,10,57,43,14,56
Dunfermline,6933,5,11,13,12,50,46,4,46
Raith,6933,6,11,9,16,37,52,-15,42
Ayr,6933,7,10,11,15,38,54,-16,41
Queen of S't,6933,8,10,10,16,42,50,-8,40
Dumbarton,6933,9,9,11,16,51,65,-14,38
St Mirren,6933,10,8,9,19,39,59,-20,33
Hibernian,6934,1,18,15,3,52,23,29,69
Dundee Utd,6934,2,16,11,9,50,39,11,59
Morton,6934,3,15,12,9,48,38,10,57
Falkirk,6934,4,15,11,10,54,38,16,56
Queen of S't,6934,5,12,12,12,47,45,2,48
Raith,6934,6,11,12,13,37,46,-9,45
Dunfermline,6934,7,9,15,12,39,42,-3,42
Dumbarton,6934,8,9,12,15,48,60,-12,39
Ayr,6934,9,6,14,16,36,59,-23,32
St Mirren,6934,10,7,10,19,40,61,-21,31
Hibernian,6935,1,20,11,5,56,25,31,71
Morton,6935,2,19,10,7,52,35,17,67
Dundee Utd,6935,3,18,9,9,56,40,16,63
Falkirk,6935,4,15,9,12,55,41,14,54
Queen of S't,6935,5,12,9,15,46,52,-6,45
Raith,6935,6,12,9,15,38,47,-9,45
Dunfermline,6935,7,9,13,14,46,49,-3,40
Dumbarton,6935,8,9,12,15,52,63,-11,39
St Mirren,6935,9,7,11,18,41,64,-23,32
Ayr,6935,10,6,13,17,33,59,-26,31
Hibernian,6936,1,21,11,4,63,27,36,74
Morton,6936,2,18,10,8,51,38,13,64
Falkirk,6936,3,15,12,9,61,43,18,57
Dundee Utd,6936,4,15,10,11,53,44,9,55
Dunfermline,6936,5,10,15,11,48,48,0,45
Queen of S't,6936,6,11,10,15,46,52,-6,43
Dumbarton,6936,7,9,13,14,49,59,-10,40
Raith,6936,8,10,10,16,37,48,-11,40
Ayr,6936,9,8,14,14,36,58,-22,38
St Mirren,6936,10,6,9,21,37,64,-27,27
Hibernian,6937,1,21,12,3,60,21,39,75
Dundee Utd,6937,2,15,10,11,52,42,10,55
Morton,6937,3,14,13,9,43,38,5,55
Falkirk,6937,4,14,10,12,58,46,12,52
Dunfermline,6937,5,11,14,11,49,46,3,47
Queen of S't,6937,6,11,10,15,44,52,-8,43
Ayr,6937,7,10,13,13,38,51,-13,43
Raith,6937,8,10,9,17,35,54,-19,39
Dumbarton,6937,9,8,13,15,52,64,-12,37
St Mirren,6937,10,8,12,16,37,54,-17,36
Hibernian,6938,1,20,11,5,56,27,29,71
Dundee Utd,6938,2,17,10,9,52,39,13,61
Morton,6938,3,17,9,10,54,40,14,60
Falkirk,6938,4,15,11,10,62,42,20,56
Dumbarton,6938,5,11,12,13,48,52,-4,45
Dunfermline,6938,6,10,13,13,45,49,-4,43
Queen of S't,6938,7,11,10,15,43,49,-6,43
Raith,6938,8,11,9,16,33,51,-18,42
St Mirren,6938,9,9,10,17,45,60,-15,37
Ayr,6938,10,6,11,19,28,57,-29,29
Hibernian,6939,1,19,12,5,55,27,28,69
Dundee Utd,6939,2,18,10,8,57,36,21,64
Morton,6939,3,17,11,8,51,39,12,62
Falkirk,6939,4,14,11,11,52,42,10,53
Queen of S't,6939,5,11,10,15,42,47,-5,43
Dumbarton,6939,6,10,11,15,51,58,-7,41
Dunfermline,6939,7,9,14,13,48,55,-7,41
Ayr,6939,8,9,12,15,36,55,-19,39
Raith,6939,9,9,10,17,33,50,-17,37
St Mirren,6939,10,9,9,18,41,57,-16,36
Hibernian,6940,1,19,11,6,56,29,27,68
Falkirk,6940,2,16,13,7,62,39,23,61
Dundee Utd,6940,3,17,9,10,52,42,10,60
Morton,6940,4,16,10,10,49,38,11,58
Dunfermline,6940,5,12,12,12,50,44,6,48
Queen of S't,6940,6,11,12,13,45,47,-2,45
Raith,6940,7,10,9,17,35,53,-18,39
Dumbarton,6940,8,9,11,16,46,60,-14,38
Ayr,6940,9,8,12,16,34,56,-22,36
St Mirren,6940,10,7,11,18,43,64,-21,32
Hibernian,6941,1,20,11,5,59,25,34,71
Morton,6941,2,19,9,8,55,36,19,66
Dundee Utd,6941,3,16,11,9,52,36,16,59
Falkirk,6941,4,16,10,10,55,38,17,58
Queen of S't,6941,5,12,10,14,46,49,-3,46
Raith,6941,6,12,8,16,35,50,-15,44
Dunfermline,6941,7,9,14,13,43,52,-9,41
Dumbarton,6941,8,8,12,16,47,62,-15,36
Ayr,6941,9,7,13,16,34,54,-20,34
St Mirren,6941,10,7,10,19,36,60,-24,31
Hibernian,6942,1,20,13,3,56,24,32,73
Morton,6942,2,16,13,7,51,34,17,61
Dundee Utd,6942,3,16,10,10,50,40,10,58
Falkirk,6942,4,14,12,10,60,45,15,54
Dumbarton,6942,5,10,13,13,51,55,-4,43
Dunfermline,6942,6,9,13,14,50,52,-2,40
Queen of S't,6942,7,10,10,16,43,53,-10,40
Raith,6942,8,9,12,15,31,47,-16,39
St Mirren,6942,9,9,10,17,38,55,-17,37
Ayr,6942,10,8,12,16,30,55,-25,36
Hibernian,6943,1,22,10,4,62,25,37,76
Dundee Utd,6943,2,17,11,8,57,37,20,62
Falkirk,6943,3,16,9,11,59,45,14,57
Morton,6943,4,15,11,10,49,42,7,56
Dunfermline,6943,5,10,13,13,48,49,-1,43
Queen of S't,6943,6,11,9,16,42,54,-12,42
Raith,6943,7,11,9,16,35,48,-13,42
Dumbarton,6943,8,10,11,15,52,63,-11,41
St Mirren,6943,9,7,13,16,40,54,-14,34
Ayr,6943,10,8,10,18,35,62,-27,34
Hibernian,6944,1,18,13,5,60,29,31,67
Morton,6944,2,18,10,8,53,41,12,64
Falkirk,6944,3,15,12,9,59,43,16,57
Dundee Utd,6944,4,16,9,11,53,41,12,57
Queen of S't,6944,5,13,8,15,53,59,-6,47
Raith,6944,6,10,12,14,40,51,-11,42
Dunfermline,6944,7,9,14,13,47,51,-4,41
Dumbarton,6944,8,8,13,15,49,59,-10,37
Ayr,6944,9,8,13,15,32,55,-23,37
St Mirren,6944,10,7,12,17,37,54,-17,33
Hibernian,6945,1,21,11,4,62,25,37,74
Morton,6945,2,17,11,8,49,37,12,62
Dundee Utd,6945,3,17,8,11,51,38,13,59
Falkirk,6945,4,14,11,11,54,44,10,53
Dunfermline,6945,5,11,13,12,49,46,3,46
Queen of S't,6945,6,11,9,16,46,52,-6,42
Raith,6945,7,10,11,15,37,52,-15,41
Ayr,6945,8,8,13,15,36,57,-21,37
Dumbarton,6945,9,7,14,15,46,60,-14,35
St Mirren,6945,10,8,11,17,43,62,-19,35
Hibernian,6946,1,18,13,5,54,24,30,67
Falkirk,6946,2,18,11,7,62,37,25,65
Morton,6946,3,17,14,5,51,33,18,65
Dundee Utd,6946,4,14,9,13,49,45,4,51
Queen of S't,6946,5,11,12,13,44,46,-2,45
Ayr,6946,6,11,11,14,38,55,-17,44
Dumbarton,6946,7,9,13,14,44,54,-10,40
Raith,6946,8,9,11,16,35,51,-16,38
Dunfermline,6946,9,8,12,16,41,54,-13,36
St Mirren,6946,10,7,10,19,39,58,-19,31
Falkirk,6947,1,18,9,9,64,38,26,63
Hibernian,6947,2,17,12,7,53,29,24,63
Morton,6947,3,17,12,7,49,31,18,63
Dundee Utd,6947,4,16,10,10,52,39,13,58
Queen of S't,6947,5,12,10,14,45,49,-4,46
Raith,6947,6,12,8,16,36,52,-16,44
St Mirren,6947,7,9,12,15,41,55,-14,39
Dunfermline,6947,8,9,11,16,44,54,-10,38
Dumbarton,6947,9,8,13,15,48,58,-10,37
Ayr,6947,10,8,11,17,34,61,-27,35
Hibernian,6948,1,20,11,5,55,25,30,71
Morton,6948,2,17,11,8,48,34,14,62
Falkirk,6948,3,17,9,10,58,42,16,60
Queen of S't,6948,4,15,9,12,51,42,9,54
Dundee Utd,6948,5,14,10,12,46,44,2,52
Dunfermline,6948,6,11,13,12,47,45,2,46
Ayr,6948,7,9,12,15,35,54,-19,39
St Mirren,6948,8,9,9,18,41,56,-15,36
Dumbarton,6948,9,8,11,17,46,63,-17,35
Raith,6948,10,8,9,19,30,52,-22,33
Hibernian,6949,1,20,13,3,60,24,36,73
Dundee Utd,6949,2,19,9,8,53,35,18,66
Morton,6949,3,14,11,11,47,49,-2,53
Falkirk,6949,4,14,10,12,53,43,10,52
Dunfermline,6949,5,10,13,13,47,45,2,43
Queen of S't,6949,6,11,10,15,46,53,-7,43
Dumbarton,6949,7,10,10,16,51,60,-9,40
Ayr,6949,8,9,12,15,38,55,-17,39
Raith,6949,9,10,9,17,36,54,-18,39
St Mirren,6949,10,9,11,16,40,53,-13,38
Hibernian,6950,1,21,11,4,61,24,37,74
Dundee Utd,6950,2,18,9,9,53,36,17,63
Morton,6950,3,16,11,9,45,40,5,59
Falkirk,6950,4,16,10,10,57,44,13,58
Dunfermline,6950,5,12,11,13,46,48,-2,47
Queen of S't,6950,6,11,10,15,46,51,-5,43
Raith,6950,7,11,8,17,38,48,-10,41
St Mirren,6950,8,9,10,17,41,57,-16,37
Ayr,6950,9,7,13,16,35,58,-23,34
Dumbarton,6950,10,7,11,18,47,63,-16,32
Hibernian,6951,1,21,10,5,59,26,33,73
Falkirk,6951,2,17,11,8,62,43,19,62
Dundee Utd,6951,3,17,11,8,58,40,18,62
Morton,6951,4,15,13,8,51,38,13,58
Dunfermline,6951,5,10,15,11,46,47,-1,45
Raith,6951,6,10,10,16,38,51,-13,40
Queen of S't,6951,7,9,12,15,41,54,-13,39
Dumbarton,6951,8,8,14,14,45,55,-10,38
St Mirren,6951,9,7,11,18,39,57,-18,32
Ayr,6951,10,6,13,17,32,60,-28,31
Hibernian,6952,1,18,13,5,56,28,28,67
Dundee Utd,6952,2,16,12,8,54,36,18,60
Morton,6952,3,15,11,10,49,39,10,56
Falkirk,6952,4,15,10,11,53,41,12,55
Dunfermline,6952,5,10,15,11,48,47,1,45
Raith,6952,6,12,9,15,35,46,-11,45
Dumbarton,6952,7,10,13,13,46,52,-6,43
Queen of S't,6952,8,10,11,15,46,54,-8,41
St Mirren,6952,9,9,10,17,37,55,-18,37
Ayr,6952,10,7,12,17,30,56,-26,33
Hibernian,6953,1,21,11,4,56,25,31,74
Falkirk,6953,2,16,10,10,59,43,16,58
Dundee Utd,6953,3,16,9,11,51,40,11,57
Morton,6953,4,14,11,11,46,41,5,53
Dunfermline,6953,5,12,12,12,50,47,3,48
Dumbarton,6953,6,10,11,15,49,61,-12,41
Queen of S't,6953,7,10,9,17,44,53,-9,39
Raith,6953,8,10,9,17,34,51,-17,39
St Mirren,6953,9,8,14,14,44,54,-10,38
Ayr,6953,10,8,14,14,33,51,-18,38
Hibernian,6954,1,20,12,4,61,27,34,72
Morton,6954,2,17,12,7,52,38,14,63
Falkirk,6954,3,17,11,8,59,43,16,62
Dundee Utd,6954,4,16,8,12,52,39,13,56
Queen of S't,6954,5,12,10,14,44,47,-3,46
Dunfermline,6954,6,9,11,16,45,53,-8,38
St Mirren,6954,7,9,11,16,46,55,-9,38
Dumbarton,6954,8,9,11,16,42,56,-14,38
Ayr,6954,9,9,11,16,36,58,-22,38
Raith,6954,10,9,9,18,33,54,-21,36
Hibernian,6955,1,19,12,5,59,28,31,69
Morton,6955,2,18,11,7,52,37,15,65
Falkirk,6955,3,16,11,9,58,44,14,59
Dundee Utd,6955,4,15,11,10,48,43,5,56
Dunfermline,6955,5,10,16,10,47,44,3,46
Queen of S't,6955,6,10,10,16,44,51,-7,40
St Mirren,6955,7,9,12,15,42,52,-10,39
Raith,6955,8,9,10,17,31,49,-18,37
Dumbarton,6955,9,8,12,16,46,57,-11,36
Ayr,6955,10,8,11,17,28,50,-22,35
Hibernian,6956,1,19,13,4,65,32,33,70
Dundee Utd,6956,2,18,8,10,52,38,14,62
Morton,6956,3,16,13,7,49,39,10,61
Falkirk,6956,4,17,9,10,59,41,18,60
Raith,6956,5,12,8,16,37,46,-9,44
Dumbarton,6956,6,10,11,15,52,59,-7,41
Queen of S't,6956,7,10,11,15,46,55,-9,41
Dunfermline,6956,8,8,14,14,40,46,-6,38
Ayr,6956,9,8,12,16,38,59,-21,36
St Mirren,6956,10,7,11,18,38,61,-23,32
Hibernian,6957,1,20,12,4,55,21,34,72
Morton,6957,2,16,11,9,46,35,11,59
Dundee Utd,6957,3,16,9,11,48,41,7,57
Falkirk,6957,4,15,10,11,57,44,13,55
Dunfermline,6957,5,12,12,12,47,45,2,48
Queen of S't,6957,6,12,10,14,44,47,-3,46
Raith,6957,7,11,9,16,35,46,-11,42
Ayr,6957,8,9,13,14,39,54,-15,40
Dumbarton,6957,9,8,11,17,45,59,-14,35
St Mirren,6957,10,8,9,19,37,61,-24,33
Hibernian,6958,1,21,12,3,58,24,34,75
Morton,6958,2,14,13,9,51,42,9,55
Dundee Utd,6958,3,14,13,9,50,42,8,55
Falkirk,6958,4,15,9,12,55,40,15,54
Queen of S't,6958,5,12,9,15,43,48,-5,45
Raith,6958,6,12,8,16,37,47,-10,44
Dumbarton,6958,7,10,12,14,48,56,-8,42
Dunfermline,6958,8,9,14,13,47,52,-5,41
St Mirren,6958,9,9,11,16,43,54,-11,38
Ayr,6958,10,7,13,16,31,58,-27,34
Hibernian,6959,1,19,12,5,56,27,29,69
Falkirk,6959,2,16,11,9,55,37,18,59
Dundee Utd,6959,3,15,12,9,52,36,16,57
Morton,6959,4,14,12,10,44,38,6,54
Dunfermline,6959,5,14,11,11,51,42,9,53
Queen of S't,6959,6,13,10,13,45,46,-1,49
St Mirren,6959,7,10,10,16,44,58,-14,40
Raith,6959,8,9,9,18,30,53,-23,36
Ayr,6959,9,8,11,17,32,57,-25,35
Dumbarton,6959,10,7,12,17,47,62,-15,33
Hibernian,6960,1,20,11,5,56,24,32,71
Morton,6960,2,17,10,9,47,37,10,61
Falkirk,6960,3,14,11,11,60,47,13,53
Dundee Utd,6960,4,14,9,13,49,40,9,51
Queen of S't,6960,5,12,10,14,46,51,-5,46
Dunfermline,6960,6,11,12,13,46,47,-1,45
Raith,6960,7,11,10,15,38,50,-12,43
St Mirren,6960,8,10,11,15,40,51,-11,41
Dumbarton,6960,9,9,12,15,48,59,-11,39
Ayr,6960,10,9,10,17,34,58,-24,37
Hibernian,6961,1,21,11,4,61,27,34,74
Morton,6961,2,17,11,8,52,38,14,62
Dundee Utd,6961,3,17,10,9,50,36,14,61
Falkirk,6961,4,16,10,10,58,44,14,58
Dunfermline,6961,5,11,13,12,48,47,1,46
Queen of S't,6961,6,9,12,15,43,54,-11,39
Raith,6961,7,9,11,16,34,47,-13,38
Dumbarton,6961,8,8,13,15,47,57,-10,37
St Mirren,6961,9,9,10,17,43,60,-17,37
Ayr,6961,10,6,13,17,31,57,-26,31
Hibernian,6962,1,19,12,5,58,26,32,69
Morton,6962,2,18,11,7,55,38,17,65
Dundee Utd,6962,3,16,11,9,50,40,10,59
Falkirk,6962,4,15,11,10,60,47,13,56
Dunfermline,6962,5,10,13,13,49,50,-1,43
Dumbarton,6962,6,11,10,15,50,54,-4,43
Queen of S't,6962,7,11,10,15,45,54,-9,43
Raith,6962,8,10,9,17,34,50,-16,39
Ayr,6962,9,8,13,15,36,56,-20,37
St Mirren,6962,10,6,12,18,39,61,-22,30
Falkirk,6963,1,19,10,7,66,41,25,67
Hibernian,6963,2,18,11,7,58,34,24,65
Dundee Utd,6963,3,16,12,8,50,37,13,60
Morton,6963,4,15,12,9,47,35,12,57
Raith,6963,5,12,9,15,40,52,-12,45
Dumbarton,6963,6,10,11,15,47,59,-12,41
St Mirren,6963,7,10,10,16,43,52,-9,40
Queen of S't,6963,8,10,9,17,46,58,-12,39
Ayr,6963,9,9,11,16,36,53,-17,38
Dunfermline,6963,10,7,13,16,43,55,-12,34
Hibernian,6964,1,19,12,5,54,27,27,69
Morton,6964,2,17,11,8,47,36,11,62
Falkirk,6964,3,16,11,9,61,37,24,59
Dundee Utd,6964,4,16,9,11,47,36,11,57
Queen of S't,6964,5,12,9,15,42,49,-7,45
Raith,6964,6,11,10,15,37,50,-13,43
Dunfermline,6964,7,9,14,13,45,48,-3,41
Dumbarton,6964,8,9,11,16,46,59,-13,38
Ayr,6964,9,9,11,16,36,54,-18,38
St Mirren,6964,10,8,10,18,37,56,-19,34
Hibernian,6965,1,19,13,4,56,27,29,70
Falkirk,6965,2,17,10,9,58,39,19,61
Morton,6965,3,15,14,7,53,34,19,59
Dundee Utd,6965,4,15,10,11,49,46,3,55
Raith,6965,5,12,10,14,40,46,-6,46
Dunfermline,6965,6,10,15,11,48,47,1,45
Ayr,6965,7,9,12,15,36,57,-21,39
Queen of S't,6965,8,10,8,18,48,55,-7,38
Dumbarton,6965,9,8,13,15,50,62,-12,37
St Mirren,6965,10,7,11,18,37,62,-25,32
Dundee Utd,6966,1,18,9,9,58,38,20,63
Hibernian,6966,2,17,12,7,52,32,20,63
Morton,6966,3,17,11,8,52,38,14,62
Falkirk,6966,4,16,11,9,57,41,16,59
Dumbarton,6966,5,12,11,13,52,58,-6,47
Dunfermline,6966,6,10,13,13,45,47,-2,43
Queen of S't,6966,7,11,9,16,41,49,-8,42
Raith,6966,8,10,10,16,36,49,-13,40
Ayr,6966,9,7,13,16,31,53,-22,34
St Mirren,6966,10,7,11,18,41,60,-19,32
Hibernian,6967,1,18,13,5,55,28,27,67
Morton,6967,2,18,10,8,49,33,16,64
Falkirk,6967,3,16,10,10,60,41,19,58
Dundee Utd,6967,4,14,12,10,48,43,5,54
Raith,6967,5,11,12,13,39,45,-6,45
Queen of S't,6967,6,11,11,14,44,47,-3,44
Dunfermline,6967,7,8,15,13,44,50,-6,39
Ayr,6967,8,8,14,14,33,52,-19,38
St Mirren,6967,9,8,12,16,40,58,-18,36
Dumbarton,6967,10,8,11,17,45,60,-15,35
Morton,6968,1,19,10,7,55,33,22,67
Falkirk,6968,2,18,10,8,64,41,23,64
Hibernian,6968,3,18,10,8,53,32,21,64
Dundee Utd,6968,4,16,9,11,51,45,6,57
Dunfermline,6968,5,10,13,13,48,51,-3,43
Dumbarton,6968,6,10,12,14,50,57,-7,42
Ayr,6968,7,10,10,16,33,53,-20,40
Raith,6968,8,10,9,17,32,47,-15,39
Queen of S't,6968,9,10,8,18,44,52,-8,38
St Mirren,6968,10,9,9,18,42,61,-19,36
Hibernian,6969,1,19,13,4,54,25,29,70
Morton,6969,2,16,12,8,50,38,12,60
Falkirk,6969,3,16,10,10,58,41,17,58
Dundee Utd,6969,4,16,9,11,53,41,12,57
Dunfermline,6969,5,13,12,11,49,44,5,51
Queen of S't,6969,6,11,10,15,44,50,-6,43
Raith,6969,7,11,8,17,36,49,-13,41
St Mirren,6969,8,9,10,17,41,57,-16,37
Dumbarton,6969,9,8,12,16,49,60,-11,36
Ayr,6969,10,8,10,18,31,60,-29,34
Hibernian,6970,1,20,12,4,58,27,31,72
Morton,6970,2,17,10,9,52,40,12,61
Dundee Utd,6970,3,17,8,11,53,43,10,59
Falkirk,6970,4,14,11,11,58,47,11,53
Queen of S't,6970,5,14,9,13,59,52,7,51
Dumbarton,6970,6,10,12,14,50,59,-9,42
Dunfermline,6970,7,9,13,14,45,49,-4,40
Raith,6970,8,10,10,16,38,51,-13,40
Ayr,6970,9,8,12,16,34,55,-21,36
St Mirren,6970,10,7,11,18,39,63,-24,32
Hibernian,6971,1,19,11,6,54,26,28,68
Falkirk,6971,2,19,10,7,64,37,27,67
Dundee Utd,6971,3,17,9,10,53,41,12,60
Morton,6971,4,16,11,9,48,37,11,59
Queen of S't,6971,5,12,9,15,44,51,-7,45
Dunfermline,6971,6,11,11,14,46,50,-4,44
Dumbarton,6971,7,9,11,16,51,59,-8,38
Raith,6971,8,10,8,18,34,53,-19,38
St Mirren,6971,9,8,11,17,39,57,-18,35
Ayr,6971,10,8,11,17,31,53,-22,35
Hibernian,6972,1,19,12,5,56,27,29,69
Morton,6972,2,17,12,7,51,35,16,63
Dundee Utd,6972,3,16,11,9,47,37,10,59
Falkirk,6972,4,16,10,10,58,40,18,58
Dunfermline,6972,5,10,13,13,48,50,-2,43
Dumbarton,6972,6,10,12,14,51,56,-5,42
Queen of S't,6972,7,10,10,16,42,53,-11,40
Ayr,6972,8,9,12,15,36,54,-18,39
Raith,6972,9,10,8,18,31,51,-20,38
St Mirren,6972,10,8,10,18,36,53,-17,34
Hibernian,6973,1,19,12,5,57,27,30,69
Falkirk,6973,2,17,11,8,64,42,22,62
Dundee Utd,6973,3,17,10,9,56,45,11,61
Morton,6973,4,15,11,10,48,41,7,56
Dunfermline,6973,5,10,14,12,50,50,0,44
Raith,6973,6,11,9,16,35,45,-10,42
Ayr,6973,7,10,10,16,39,59,-20,40
Queen of S't,6973,8,9,11,16,42,52,-10,38
Dumbarton,6973,9,9,10,17,46,61,-15,37
St Mirren,6973,10,9,10,17,37,52,-15,37
Hibernian,6974,1,18,11,7,53,27,26,65
Falkirk,6974,2,15,12,9,53,39,14,57
Morton,6974,3,14,14,8,45,39,6,56
Dundee Utd,6974,4,14,11,11,48,44,4,53
Dunfermline,6974,5,12,12,12,50,47,3,48
Raith,6974,6,11,10,15,34,45,-11,43
Ayr,6974,7,10,12,14,36,51,-15,42
Queen of S't,6974,8,10,11,15,42,47,-5,41
St Mirren,6974,9,10,10,16,36,48,-12,40
Dumbarton,6974,10,8,13,15,47,57,-10,37
Hibernian,6975,1,21,12,3,60,23,37,75
Morton,6975,2,17,11,8,52,35,17,62
Falkirk,6975,3,15,11,10,64,49,15,56
Dundee Utd,6975,4,14,10,12,44,42,2,52
Dunfermline,6975,5,12,12,12,57,51,6,48
Queen of S't,6975,6,11,11,14,45,50,-5,44
Raith,6975,7,10,9,17,35,52,-17,39
Dumbarton,6975,8,8,14,14,49,59,-10,38
Ayr,6975,9,8,13,15,32,56,-24,37
St Mirren,6975,10,8,9,19,40,61,-21,33
Hibernian,6976,1,19,13,4,56,26,30,70
Falkirk,6976,2,17,10,9,64,40,24,61
Morton,6976,3,16,13,7,47,34,13,61
Dundee Utd,6976,4,16,10,10,54,38,16,58
Dunfermline,6976,5,10,12,14,46,48,-2,42
Ayr,6976,6,10,11,15,32,53,-21,41
Dumbarton,6976,7,9,13,14,46,55,-9,40
Queen of S't,6976,8,10,10,16,44,59,-15,40
Raith,6976,9,9,10,17,34,51,-17,37
St Mirren,6976,10,8,10,18,42,61,-19,34
Hibernian,6977,1,21,10,5,57,27,30,73
Morton,6977,2,17,11,8,47,33,14,62
Dundee Utd,6977,3,16,10,10,54,39,15,58
Falkirk,6977,4,15,11,10,62,42,20,56
Dunfermline,6977,5,11,12,13,47,47,0,45
Queen of S't,6977,6,11,10,15,47,51,-4,43
Ayr,6977,7,10,12,14,34,54,-20,42
St Mirren,6977,8,10,9,17,45,58,-13,39
Raith,6977,9,9,9,18,34,56,-22,36
Dumbarton,6977,10,8,10,18,44,64,-20,34
Hibernian,6978,1,20,11,5,59,25,34,71
Morton,6978,2,18,11,7,52,36,16,65
Falkirk,6978,3,16,9,11,59,48,11,57
Dundee Utd,6978,4,15,11,10,52,39,13,56
Dunfermline,6978,5,13,11,12,52,49,3,50
Raith,6978,6,11,8,17,37,48,-11,41
Queen of S't,6978,7,10,9,17,42,55,-13,39
Ayr,6978,8,9,12,15,36,52,-16,39
Dumbarton,6978,9,9,11,16,49,60,-11,38
St Mirren,6978,10,8,9,19,39,65,-26,33
Hibernian,6979,1,20,12,4,57,26,31,72
Morton,6979,2,18,11,7,49,32,17,65
Dundee Utd,6979,3,16,10,10,52,41,11,58
Falkirk,6979,4,15,12,9,55,41,14,57
Queen of S't,6979,5,14,9,13,48,45,3,51
Dumbarton,6979,6,10,11,15,46,58,-12,41
Dunfermline,6979,7,9,13,14,41,45,-4,40
Raith,6979,8,8,10,18,31,52,-21,34
St Mirren,6979,9,7,12,17,42,59,-17,33
Ayr,6979,10,6,14,16,33,55,-22,32
Morton,6980,1,20,11,5,53,30,23,71
Hibernian,6980,2,17,12,7,49,26,23,63
Falkirk,6980,3,17,9,10,62,40,22,60
Dundee Utd,6980,4,17,9,10,51,36,15,60
Dumbarton,6980,5,10,12,14,45,53,-8,42
Raith,6980,6,11,9,16,39,48,-9,42
Dunfermline,6980,7,9,13,14,43,49,-6,40
Ayr,6980,8,10,10,16,34,54,-20,40
Queen of S't,6980,9,10,9,17,40,55,-15,39
St Mirren,6980,10,7,10,19,37,62,-25,31
Dundee Utd,6981,1,19,9,8,55,36,19,66
Hibernian,6981,2,17,13,6,47,23,24,64
Morton,6981,3,18,10,8,48,31,17,64
Falkirk,6981,4,16,11,9,57,39,18,59
Queen of S't,6981,5,13,11,12,48,47,1,50
Raith,6981,6,11,10,15,37,47,-10,43
Dunfermline,6981,7,9,13,14,42,49,-7,40
Dumbarton,6981,8,8,12,16,47,61,-14,36
St Mirren,6981,9,7,10,19,36,58,-22,31
Ayr,6981,10,6,13,17,27,53,-26,31
Hibernian,6982,1,21,11,4,60,24,36,74
Morton,6982,2,17,12,7,55,39,16,63
Falkirk,6982,3,16,10,10,55,38,17,58
Dundee Utd,6982,4,14,13,9,51,38,13,55
Raith,6982,5,11,10,15,37,51,-14,43
Dunfermline,6982,6,10,12,14,44,46,-2,42
Ayr,6982,7,10,11,15,37,54,-17,41
Queen of S't,6982,8,10,10,16,43,52,-9,40
Dumbarton,6982,9,8,13,15,46,60,-14,37
St Mirren,6982,10,7,10,19,37,63,-26,31
Hibernian,6983,1,19,12,5,57,25,32,69
Morton,6983,2,19,10,7,54,36,18,67
Dundee Utd,6983,3,17,10,9,52,38,14,61
Falkirk,6983,4,15,13,8,55,37,18,58
Dunfermline,6983,5,11,14,11,51,46,5,47
Queen of S't,6983,6,10,11,15,44,54,-10,41
Raith,6983,7,9,11,16,31,50,-19,38
Dumbarton,6983,8,8,12,16,49,63,-14,36
St Mirren,6983,9,8,11,17,39,54,-15,35
Ayr,6983,10,6,12,18,29,58,-29,30
Falkirk,6984,1,19,10,7,62,36,26,67
Hibernian,6984,2,18,12,6,55,29,26,66
Dundee Utd,6984,3,16,11,9,47,38,9,59
Morton,6984,4,15,10,11,51,39,12,55
Queen of S't,6984,5,11,10,15,46,49,-3,43
Dunfermline,6984,6,9,13,14,43,50,-7,40
St Mirren,6984,7,10,10,16,39,50,-11,40
Raith,6984,8,10,10,16,32,48,-16,40
Dumbarton,6984,9,9,11,16,44,60,-16,38
Ayr,6984,10,9,11,16,36,56,-20,38
Hibernian,6985,1,17,16,3,55,26,29,67
Morton,6985,2,15,14,7,47,38,9,59
Dundee Utd,6985,3,15,11,10,48,36,12,56
Falkirk,6985,4,14,13,9,56,42,14,55
Queen of S't,6985,5,12,11,13,50,49,1,47
Dunfermline,6985,6,10,13,13,51,55,-4,43
Raith,6985,7,9,14,13,35,45,-10,41
St Mirren,6985,8,8,14,14,36,48,-12,38
Dumbarton,6985,9,8,11,17,44,58,-14,35
Ayr,6985,10,7,13,16,32,57,-25,34
Hibernian,6986,1,20,13,3,57,24,33,73
Falkirk,6986,2,16,12,8,60,42,18,60
Morton,6986,3,16,11,9,49,39,10,59
Dundee Utd,6986,4,15,11,10,50,39,11,56
Queen of S't,6986,5,11,10,15,47,51,-4,43
St Mirren,6986,6,10,11,15,40,52,-12,41
Raith,6986,7,11,8,17,38,53,-15,41
Dunfermline,6986,8,9,12,15,46,51,-5,39
Ayr,6986,9,9,11,16,34,54,-20,38
Dumbarton,6986,10,7,13,16,44,60,-16,34
Hibernian,6987,1,21,12,3,59,22,37,75
Falkirk,6987,2,17,10,9,56,39,17,61
Dundee Utd,6987,3,17,9,10,53,41,12,60
Morton,6987,4,16,11,9,48,36,12,59
Dunfermline,6987,5,9,14,13,45,50,-5,41
Raith,6987,6,10,10,16,33,50,-17,40
Ayr,6987,7,10,10,16,35,54,-19,40
Queen of S't,6987,8,10,9,17,44,53,-9,39
Dumbarton,6987,9,9,12,15,46,56,-10,39
St Mirren,6987,10,8,9,19,37,55,-18,33
Hibernian,6988,1,18,12,6,54,28,26,66
Morton,6988,2,16,14,6,47,33,14,62
Dundee Utd,6988,3,15,10,11,50,40,10,55
Falkirk,6988,4,14,10,12,52,40,12,52
Dunfermline,6988,5,11,13,12,48,48,0,46
Queen of S't,6988,6,12,9,15,48,56,-8,45
Dumbarton,6988,7,10,12,14,50,56,-6,42
Raith,6988,8,9,13,14,40,52,-12,40
St Mirren,6988,9,8,13,15,38,53,-15,37
Ayr,6988,10,8,12,16,34,55,-21,36
Hibernian,6989,1,19,12,5,59,23,36,69
Dundee Utd,6989,2,17,10,9,55,40,15,61
Falkirk,6989,3,16,11,9,59,37,22,59
Morton,6989,4,13,14,9,45,43,2,53
Queen of S't,6989,5,14,8,14,46,51,-5,50
Dunfermline,6989,6,10,12,14,47,52,-5,42
Raith,6989,7,11,8,17,37,59,-22,41
Dumbarton,6989,8,8,14,14,49,56,-7,38
St Mirren,6989,9,9,11,16,41,54,-13,38
Ayr,6989,10,6,14,16,33,56,-23,32
Hibernian,6990,1,18,13,5,54,26,28,67
Morton,6990,2,18,11,7,56,36,20,65
Dundee Utd,6990,3,16,11,9,47,38,9,59
Falkirk,6990,4,16,9,11,61,42,19,57
Raith,6990,5,12,9,15,38,47,-9,45
Dumbarton,6990,6,10,13,13,52,55,-3,43
Queen of S't,6990,7,11,10,15,43,52,-9,43
Ayr,6990,8,8,13,15,37,57,-20,37
Dunfermline,6990,9,8,12,16,43,54,-11,36
St Mirren,6990,10,7,11,18,39,63,-24,32
Hibernian,6991,1,21,12,3,58,21,37,75
Falkirk,6991,2,17,10,9,54,37,17,61
Morton,6991,3,16,12,8,47,38,9,60
Dundee Utd,6991,4,15,10,11,47,39,8,55
Queen of S't,6991,5,11,9,16,46,53,-7,42
Dunfermline,6991,6,10,11,15,45,50,-5,41
St Mirren,6991,7,10,10,16,42,53,-11,40
Dumbarton,6991,8,9,12,15,48,57,-9,39
Raith,6991,9,10,9,17,34,50,-16,39
Ayr,6991,10,8,11,17,33,56,-23,35
Hibernian,6992,1,19,11,6,53,25,28,68
Falkirk,6992,2,16,13,7,57,37,20,61
Morton,6992,3,17,10,9,50,37,13,61
Dundee Utd,6992,4,16,10,10,54,38,16,58
Queen of S't,6992,5,12,9,15,46,50,-4,45
Raith,6992,6,12,9,15,36,42,-6,45
Ayr,6992,7,9,12,15,33,58,-25,39
Dumbarton,6992,8,9,11,16,46,61,-15,38
St Mirren,6992,9,9,9,18,38,57,-19,36
Dunfermline,6992,10,7,14,15,39,47,-8,35
Hibernian,6993,1,20,12,4,57,23,34,72
Dundee Utd,6993,2,18,8,10,56,38,18,62
Falkirk,6993,3,17,10,9,56,37,19,61
Morton,6993,4,16,11,9,56,41,15,59
Dumbarton,6993,5,11,10,15,49,57,-8,43
Raith,6993,6,11,10,15,35,46,-11,43
Dunfermline,6993,7,9,13,14,44,49,-5,40
Queen of S't,6993,8,10,9,17,39,53,-14,39
Ayr,6993,9,9,10,17,35,60,-25,37
St Mirren,6993,10,7,11,18,37,60,-23,32
Hibernian,6994,1,18,13,5,54,25,29,67
Morton,6994,2,17,14,5,57,37,20,65
Falkirk,6994,3,16,9,11,61,45,16,57
Dundee Utd,6994,4,15,10,11,49,44,5,55
Queen of S't,6994,5,14,8,14,46,46,0,50
Dunfermline,6994,6,9,13,14,46,49,-3,40
Dumbarton,6994,7,10,10,16,47,61,-14,40
Ayr,6994,8,9,12,15,36,55,-19,39
Raith,6994,9,9,10,17,33,49,-16,37
St Mirren,6994,10,8,11,17,39,57,-18,35
Hibernian,6995,1,19,12,5,58,28,30,69
Falkirk,6995,2,16,12,8,60,38,22,60
Morton,6995,3,17,9,10,51,41,10,60
Dundee Utd,6995,4,14,10,12,47,44,3,52
Dunfermline,6995,5,11,13,12,50,48,2,46
Ayr,6995,6,11,11,14,36,51,-15,44
Queen of S't,6995,7,11,9,16,45,55,-10,42
Raith,6995,8,9,12,15,35,46,-11,39
St Mirren,6995,9,9,11,16,42,61,-19,38
Dumbarton,6995,10,8,11,17,49,61,-12,35
Hibernian,6996,1,19,11,6,60,28,32,68
Morton,6996,2,17,12,7,55,38,17,63
Falkirk,6996,3,17,11,8,62,41,21,62
Dundee Utd,6996,4,14,10,12,47,41,6,52
Queen of S't,6996,5,12,10,14,47,51,-4,46
Dumbarton,6996,6,11,11,14,53,56,-3,44
Raith,6996,7,11,10,15,38,53,-15,43
Dunfermline,6996,8,8,15,13,46,55,-9,39
Ayr,6996,9,9,12,15,39,58,-19,39
St Mirren,6996,10,6,10,20,33,59,-26,28
Hibernian,6997,1,20,11,5,62,26,36,71
Falkirk,6997,2,18,9,9,58,41,17,63
Morton,6997,3,16,12,8,49,39,10,60
Dundee Utd,6997,4,16,10,10,52,37,15,58
Queen of S't,6997,5,13,8,15,46,49,-3,47
Dunfermline,6997,6,11,12,13,46,48,-2,45
Raith,6997,7,10,10,16,34,50,-16,40
Ayr,6997,8,8,12,16,33,51,-18,36
St Mirren,6997,9,9,9,18,38,59,-21,36
Dumbarton,6997,10,7,11,18,42,60,-18,32
Hibernian,6998,1,19,10,7,50,27,23,67
Morton,6998,2,18,10,8,53,36,17,64
Dundee Utd,6998,3,16,8,12,56,45,11,56
Falkirk,6998,4,15,9,12,56,44,12,54
Queen of S't,6998,5,12,9,15,44,54,-10,45
Dunfermline,6998,6,11,11,14,50,50,0,44
Ayr,6998,7,11,10,15,36,50,-14,43
Dumbarton,6998,8,10,11,15,51,60,-9,41
St Mirren,6998,9,9,11,16,40,54,-14,38
Raith,6998,10,9,11,16,33,49,-16,38
Hibernian,6999,1,19,13,4,57,25,32,70
Morton,6999,2,17,11,8,49,33,16,62
Dundee Utd,6999,3,16,10,10,49,41,8,58
Falkirk,6999,4,15,10,11,56,40,16,55
Queen of S't,6999,5,12,10,14,50,52,-2,46
Dunfermline,6999,6,10,11,15,44,53,-9,41
Raith,6999,7,10,11,15,36,49,-13,41
Dumbarton,6999,8,9,12,15,46,56,-10,39
St Mirren,6999,9,9,10,17,40,59,-19,37
Ayr,6999,10,8,12,16,37,56,-19,36
Hibernian,7000,1,21,11,4,51,22,29,74
Dundee Utd,7000,2,18,8,10,50,35,15,62
Falkirk,7000,3,16,9,11,54,39,15,57
Morton,7000,4,15,11,10,46,37,9,56
Dunfermline,7000,5,13,11,12,50,46,4,50
Queen of S't,7000,6,11,9,16,42,50,-8,42
St Mirren,7000,7,10,10,16,42,53,-11,40
Raith,7000,8,10,10,16,32,47,-15,40
Dumbarton,7000,9,8,12,16,43,54,-11,36
Ayr,7000,10,7,11,18,31,58,-27,32
Hibernian,7001,1,18,12,6,56,32,24,66
Morton,7001,2,17,12,7,55,35,20,63
Falkirk,7001,3,15,11,10,57,43,14,56
Queen of S't,7001,4,14,8,14,47,51,-4,50
Dunfermline,7001,5,12,13,11,50,47,3,49
Dundee Utd,7001,6,13,10,13,47,45,2,49
Dumbarton,7001,7,9,13,14,47,56,-9,40
Raith,7001,8,8,14,14,31,45,-14,38
Ayr,7001,9,8,13,15,33,52,-19,37
St Mirren,7001,10,7,12,17,38,55,-17,33
Hibernian,7002,1,20,11,5,55,26,29,71
Morton,7002,2,17,10,9,54,39,15,61
Falkirk,7002,3,15,12,9,57,44,13,57
Dundee Utd,7002,4,15,10,11,50,40,10,55
Queen of S't,7002,5,13,9,14,48,51,-3,48
Raith,7002,6,10,12,14,34,45,-11,42
Dunfermline,7002,7,9,14,13,44,51,-7,41
Dumbarton,7002,8,9,13,14,50,57,-7,40
St Mirren,7002,9,7,13,16,37,53,-16,34
Ayr,7002,10,7,12,17,35,58,-23,33
Hibernian,7003,1,21,11,4,62,26,36,74
Dundee Utd,7003,2,16,9,11,48,37,11,57
Falkirk,7003,3,14,13,9,56,40,16,55
Morton,7003,4,15,10,11,50,42,8,55
Dunfermline,7003,5,11,12,13,45,47,-2,45
Queen of S't,7003,6,11,10,15,43,52,-9,43
Raith,7003,7,11,9,16,34,56,-22,42
St Mirren,7003,8,9,12,15,47,57,-10,39
Dumbarton,7003,9,8,13,15,50,59,-9,37
Ayr,7003,10,8,13,15,34,53,-19,37
Hibernian,7004,1,19,12,5,57,27,30,69
Morton,7004,2,17,12,7,53,41,12,63
Dundee Utd,7004,3,17,10,9,56,39,17,61
Falkirk,7004,4,14,12,10,58,43,15,54
Dunfermline,7004,5,10,13,13,49,49,0,43
Raith,7004,6,11,9,16,38,46,-8,42
Queen of S't,7004,7,10,10,16,41,55,-14,40
St Mirren,7004,8,9,12,15,41,53,-12,39
Ayr,7004,9,9,11,16,35,60,-25,38
Dumbarton,7004,10,7,13,16,46,61,-15,34
Hibernian,7005,1,17,12,7,52,32,20,63
Morton,7005,2,17,11,8,52,38,14,62
Falkirk,7005,3,17,9,10,57,43,14,60
Dundee Utd,7005,4,17,9,10,47,34,13,60
Queen of S't,7005,5,12,9,15,50,50,0,45
Dumbarton,7005,6,11,11,14,46,54,-8,44
St Mirren,7005,7,10,10,16,43,52,-9,40
Dunfermline,7005,8,8,15,13,43,52,-9,39
Raith,7005,9,9,11,16,40,52,-12,38
Ayr,7005,10,7,13,16,35,58,-23,34
Morton,7006,1,19,11,6,57,36,21,68
Hibernian,7006,2,18,12,6,50,25,25,66
Falkirk,7006,3,18,10,8,59,39,20,64
Dundee Utd,7006,4,16,8,12,51,38,13,56
Queen of S't,7006,5,12,9,15,46,52,-6,45
Dunfermline,7006,6,10,12,14,48,55,-7,42
Ayr,7006,7,10,11,15,35,53,-18,41
St Mirren,7006,8,9,10,17,39,53,-14,37
Raith,7006,9,9,9,18,33,51,-18,36
Dumbarton,7006,10,7,12,17,44,60,-16,33
Hibernian,7007,1,19,12,5,54,28,26,69
Morton,7007,2,19,11,6,57,32,25,68
Falkirk,7007,3,17,10,9,59,40,19,61
Dundee Utd,7007,4,14,10,12,45,42,3,52
Queen of S't,7007,5,12,9,15,45,48,-3,45
Raith,7007,6,11,10,15,37,49,-12,43
Ayr,7007,7,9,12,15,33,51,-18,39
Dunfermline,7007,8,8,13,15,41,51,-10,37
Dumbarton,7007,9,9,10,17,45,60,-15,37
St Mirren,7007,10,8,11,17,40,55,-15,35
Hibernian,7008,1,18,12,6,60,31,29,66
Morton,7008,2,16,14,6,54,35,19,62
Falkirk,7008,3,15,10,11,57,48,9,55
Dundee Utd,7008,4,15,10,11,48,41,7,55
Queen of S't,7008,5,13,11,12,51,46,5,50
St Mirren,7008,6,10,10,16,39,50,-11,40
Dunfermline,7008,7,8,15,13,43,48,-5,39
Dumbarton,7008,8,9,12,15,48,60,-12,39
Ayr,7008,9,9,12,15,36,58,-22,39
Raith,7008,10,8,12,16,31,50,-19,36
Hibernian,7009,1,20,12,4,64,27,37,72
Morton,7009,2,18,12,6,60,36,24,66
Falkirk,7009,3,14,11,11,54,42,12,53
Dundee Utd,7009,4,12,12,12,46,43,3,48
Queen of S't,7009,5,13,9,14,46,50,-4,48
Dunfermline,7009,6,10,12,14,48,54,-6,42
Ayr,7009,7,10,11,15,34,55,-21,41
Raith,7009,8,10,10,16,34,48,-14,40
St Mirren,7009,9,9,11,16,44,57,-13,38
Dumbarton,7009,10,9,10,17,44,62,-18,37
Hibernian,7010,1,20,13,3,56,19,37,73
Dundee Utd,7010,2,17,8,11,51,37,14,59
Falkirk,7010,3,15,12,9,58,40,18,57
Morton,7010,4,14,13,9,50,42,8,55
Queen of S't,7010,5,12,10,14,44,51,-7,46
Raith,7010,6,11,9,16,35,48,-13,42
Dunfermline,7010,7,8,17,11,42,46,-4,41
Dumbarton,7010,8,8,13,15,49,62,-13,37
Ayr,7010,9,8,12,16,32,52,-20,36
St Mirren,7010,10,8,11,17,39,59,-20,35
Hibernian,7011,1,20,11,5,54,22,32,71
Morton,7011,2,18,10,8,48,32,16,64
Dundee Utd,7011,3,18,9,9,57,38,19,63
Falkirk,7011,4,14,10,12,54,44,10,52
Queen of S't,7011,5,11,9,16,42,53,-11,42
Ayr,7011,6,10,12,14,38,50,-12,42
Dunfermline,7011,7,9,13,14,42,49,-7,40
Raith,7011,8,10,9,17,33,49,-16,39
St Mirren,7011,9,9,11,16,37,51,-14,38
Dumbarton,7011,10,9,10,17,46,63,-17,37
Hibernian,7012,1,20,11,5,61,25,36,71
Falkirk,7012,2,15,10,11,58,42,16,55
Morton,7012,3,15,10,11,44,42,2,55
Dundee Utd,7012,4,13,12,11,47,42,5,51
Queen of S't,7012,5,12,9,15,44,52,-8,45
Ayr,7012,6,11,12,13,40,49,-9,45
Dunfermline,7012,7,10,13,13,46,50,-4,43
St Mirren,7012,8,10,12,14,40,48,-8,42
Dumbarton,7012,9,10,12,14,45,58,-13,42
Raith,7012,10,8,11,17,32,49,-17,35
Hibernian,7013,1,20,12,4,60,27,33,72
Dundee Utd,7013,2,16,11,9,51,39,12,59
Morton,7013,3,15,12,9,44,36,8,57
Falkirk,7013,4,14,12,10,54,40,14,54
Raith,7013,5,13,10,13,45,44,1,49
Dunfermline,7013,6,10,15,11,48,47,1,45
Queen of S't,7013,7,10,11,15,44,53,-9,41
Ayr,7013,8,9,11,16,35,56,-21,38
Dumbarton,7013,9,7,15,14,46,59,-13,36
St Mirren,7013,10,6,11,19,38,64,-26,29
Hibernian,7014,1,17,14,5,52,27,25,65
Morton,7014,2,16,11,9,54,43,11,59
Falkirk,7014,3,15,13,8,59,38,21,58
Dundee Utd,7014,4,15,11,10,52,40,12,56
Raith,7014,5,11,11,14,38,49,-11,44
St Mirren,7014,6,11,10,15,43,52,-9,43
Queen of S't,7014,7,11,9,16,43,51,-8,42
Dumbarton,7014,8,9,12,15,43,53,-10,39
Dunfermline,7014,9,9,11,16,45,56,-11,38
Ayr,7014,10,8,14,14,36,56,-20,38
Morton,7015,1,19,11,6,55,34,21,68
Hibernian,7015,2,18,13,5,51,25,26,67
Falkirk,7015,3,15,12,9,61,44,17,57
Dundee Utd,7015,4,15,10,11,51,42,9,55
Dunfermline,7015,5,12,13,11,48,44,4,49
Raith,7015,6,11,8,17,36,51,-15,41
Dumbarton,7015,7,9,12,15,52,63,-11,39
Queen of S't,7015,8,9,11,16,44,55,-11,38
Ayr,7015,9,9,11,16,38,56,-18,38
St Mirren,7015,10,7,11,18,37,59,-22,32
Hibernian,7016,1,19,10,7,53,30,23,67
Falkirk,7016,2,18,10,8,68,43,25,64
Morton,7016,3,17,11,8,54,39,15,62
Dundee Utd,7016,4,16,11,9,52,39,13,59
Dunfermline,7016,5,10,14,12,48,44,4,44
Queen of S't,7016,6,11,10,15,43,51,-8,43
Dumbarton,7016,7,9,13,14,47,57,-10,40
Raith,7016,8,10,9,17,35,51,-16,39
Ayr,7016,9,7,13,16,31,54,-23,34
St Mirren,7016,10,7,11,18,38,61,-23,32
Hibernian,7017,1,20,11,5,55,22,33,71
Morton,7017,2,19,9,8,54,35,19,66
Dundee Utd,7017,3,19,8,9,57,35,22,65
Falkirk,7017,4,17,11,8,59,36,23,62
Queen of S't,7017,5,11,10,15,43,51,-8,43
Dumbarton,7017,6,10,10,16,49,67,-18,40
Dunfermline,7017,7,9,11,16,43,56,-13,38
Ayr,7017,8,8,13,15,33,49,-16,37
Raith,7017,9,9,8,19,33,54,-21,35
St Mirren,7017,10,7,11,18,37,58,-21,32
Hibernian,7018,1,20,13,3,54,24,30,73
Morton,7018,2,17,11,8,52,39,13,62
Falkirk,7018,3,16,10,10,58,39,19,58
Dundee Utd,7018,4,16,10,10,50,39,11,58
Dunfermline,7018,5,10,14,12,47,50,-3,44
Raith,7018,6,11,10,15,37,45,-8,43
Queen of S't,7018,7,9,11,16,44,55,-11,38
Dumbarton,7018,8,8,13,15,49,60,-11,37
St Mirren,7018,9,9,10,17,39,58,-19,37
Ayr,7018,10,7,12,17,30,51,-21,33
Hibernian,7019,1,19,12,5,58,31,27,69
Dundee Utd,7019,2,19,9,8,51,34,17,66
Morton,7019,3,17,12,7,54,37,17,63
Falkirk,7019,4,15,12,9,54,40,14,57
Queen of S't,7019,5,11,9,16,43,50,-7,42
Raith,7019,6,10,12,14,37,47,-10,42
Dunfermline,7019,7,9,13,14,47,49,-2,40
Dumbarton,7019,8,9,12,15,47,57,-10,39
St Mirren,7019,9,8,10,18,39,58,-19,34
Ayr,7019,10,7,11,18,31,58,-27,32
Hibernian,7020,1,18,12,6,55,31,24,66
Morton,7020,2,19,9,8,52,34,18,66
Dundee Utd,7020,3,15,10,11,50,44,6,55
Falkirk,7020,4,14,11,11,52,41,11,53
Queen of S't,7020,5,15,8,13,50,47,3,53
Dunfermline,7020,6,12,11,13,46,45,1,47
Dumbarton,7020,7,10,11,15,46,53,-7,41
Raith,7020,8,10,9,17,34,49,-15,39
Ayr,7020,9,8,11,17,38,63,-25,35
St Mirren,7020,10,8,10,18,43,59,-16,34
Hibernian,7021,1,18,13,5,52,30,22,67
Morton,7021,2,18,12,6,55,31,24,66
Dundee Utd,7021,3,18,8,10,60,42,18,62
Falkirk,7021,4,15,10,11,60,44,16,55
Dumbarton,7021,5,11,11,14,54,56,-2,44
Queen of S't,7021,6,10,11,15,43,50,-7,41
Dunfermline,7021,7,9,13,14,43,53,-10,40
Raith,7021,8,9,12,15,32,46,-14,39
Ayr,7021,9,8,14,14,36,60,-24,38
St Mirren,7021,10,6,12,18,41,64,-23,30
Dundee Utd,7022,1,19,9,8,55,35,20,66
Hibernian,7022,2,17,12,7,52,30,22,63
Falkirk,7022,3,18,9,9,59,38,21,63
Morton,7022,4,16,12,8,45,33,12,60
Dumbarton,7022,5,10,12,14,50,54,-4,42
Dunfermline,7022,6,10,12,14,47,52,-5,42
Ayr,7022,7,10,10,16,34,52,-18,40
Queen of S't,7022,8,10,9,17,42,53,-11,39
Raith,7022,9,10,9,17,34,51,-17,39
St Mirren,7022,10,7,12,17,35,55,-20,33
Hibernian,7023,1,19,11,6,56,26,30,68
Morton,7023,2,18,11,7,47,37,10,65
Falkirk,7023,3,17,11,8,61,41,20,62
Dundee Utd,7023,4,16,10,10,50,41,9,58
Queen of S't,7023,5,11,9,16,48,52,-4,42
Dumbarton,7023,6,9,12,15,51,58,-7,39
Raith,7023,7,10,9,17,35,51,-16,39
Dunfermline,7023,8,8,14,14,46,48,-2,38
St Mirren,7023,9,9,10,17,45,59,-14,37
Ayr,7023,10,8,13,15,30,56,-26,37
Hibernian,7024,1,19,12,5,58,29,29,69
Falkirk,7024,2,17,11,8,61,41,20,62
Morton,7024,3,16,10,10,53,41,12,58
Dundee Utd,7024,4,13,12,11,44,39,5,51
Dunfermline,7024,5,10,14,12,46,48,-2,44
Queen of S't,7024,6,11,10,15,48,48,0,43
St Mirren,7024,7,10,10,16,43,59,-16,40
Raith,7024,8,10,10,16,36,53,-17,40
Dumbarton,7024,9,9,12,15,51,58,-7,39
Ayr,7024,10,9,11,16,35,59,-24,38
Hibernian,7025,1,20,12,4,54,24,30,72
Falkirk,7025,2,20,9,7,64,33,31,69
Morton,7025,3,18,10,8,50,36,14,64
Dundee Utd,7025,4,15,11,10,48,41,7,56
Queen of S't,7025,5,13,8,15,46,50,-4,47
Raith,7025,6,11,8,17,32,53,-21,41
Dunfermline,7025,7,9,12,15,48,48,0,39
St Mirren,7025,8,8,10,18,43,57,-14,34
Dumbarton,7025,9,7,13,16,40,58,-18,34
Ayr,7025,10,6,13,17,34,59,-25,31
Hibernian,7026,1,19,12,5,56,28,28,69
Morton,7026,2,18,11,7,51,35,16,65
Falkirk,7026,3,16,12,8,57,37,20,60
Dundee Utd,7026,4,12,14,10,46,43,3,50
Queen of S't,7026,5,12,11,13,46,48,-2,47
Dunfermline,7026,6,10,15,11,50,46,4,45
Dumbarton,7026,7,9,11,16,48,57,-9,38
Ayr,7026,8,8,13,15,35,53,-18,37
St Mirren,7026,9,8,11,17,40,54,-14,35
Raith,7026,10,9,8,19,30,58,-28,35
Hibernian,7027,1,21,11,4,60,26,34,74
Morton,7027,2,19,11,6,54,35,19,68
Falkirk,7027,3,18,10,8,61,39,22,64
Dundee Utd,7027,4,14,10,12,45,44,1,52
Queen of S't,7027,5,11,9,16,48,57,-9,42
Ayr,7027,6,9,12,15,34,51,-17,39
Raith,7027,7,10,8,18,38,55,-17,38
Dumbarton,7027,8,8,13,15,49,59,-10,37
Dunfermline,7027,9,8,12,16,41,49,-8,36
St Mirren,7027,10,8,12,16,42,57,-15,36
Hibernian,7028,1,20,13,3,57,24,33,73
Morton,7028,2,16,11,9,47,37,10,59
Dundee Utd,7028,3,16,10,10,52,43,9,58
Falkirk,7028,4,15,11,10,58,37,21,56
Queen of S't,7028,5,12,10,14,47,49,-2,46
Dunfermline,7028,6,10,13,13,43,48,-5,43
St Mirren,7028,7,9,11,16,39,50,-11,38
Ayr,7028,8,9,11,16,35,53,-18,38
Raith,7028,9,9,10,17,33,55,-22,37
Dumbarton,7028,10,8,12,16,45,60,-15,36
Hibernian,7029,1,19,12,5,60,29,31,69
Dundee Utd,7029,2,18,10,8,52,35,17,64
Morton,7029,3,17,12,7,55,39,16,63
Falkirk,7029,4,17,9,10,63,42,21,60
Dunfermline,7029,5,11,14,11,52,50,2,47
Queen of S't,7029,6,11,10,15,45,53,-8,43
Raith,7029,7,10,10,16,36,49,-13,40
Dumbarton,7029,8,8,12,16,47,60,-13,36
St Mirren,7029,9,7,10,19,36,60,-24,31
Ayr,7029,10,6,13,17,29,58,-29,31
Hibernian,7030,1,18,10,8,50,31,19,64
Dundee Utd,7030,2,18,9,9,49,40,9,63
Falkirk,7030,3,17,10,9,62,41,21,61
Morton,7030,4,17,10,9,50,37,13,61
Dunfermline,7030,5,12,12,12,51,46,5,48
Queen of S't,7030,6,13,8,15,44,49,-5,47
Raith,7030,7,11,9,16,36,49,-13,42
St Mirren,7030,8,8,13,15,41,55,-14,37
Dumbarton,7030,9,7,12,17,47,62,-15,33
Ayr,7030,10,7,11,18,33,53,-20,32
Hibernian,7031,1,19,12,5,56,28,28,69
Falkirk,7031,2,19,10,7,67,39,28,67
Morton,7031,3,17,11,8,52,34,18,62
Dundee Utd,7031,4,14,10,12,45,41,4,52
Queen of S't,7031,5,11,11,14,46,50,-4,44
Dumbarton,7031,6,10,13,13,51,54,-3,43
Raith,7031,7,11,8,17,37,53,-16,41
Dunfermline,7031,8,9,13,14,49,55,-6,40
St Mirren,7031,9,8,10,18,39,59,-20,34
Ayr,7031,10,7,12,17,31,60,-29,33
Hibernian,7032,1,19,14,3,56,23,33,71
Morton,7032,2,18,12,6,49,30,19,66
Dundee Utd,7032,3,16,9,11,52,41,11,57
Falkirk,7032,4,14,12,10,58,47,11,54
Queen of S't,7032,5,11,11,14,47,53,-6,44
Dumbarton,7032,6,9,13,14,46,54,-8,40
Raith,7032,7,9,11,16,35,50,-15,38
St Mirren,7032,8,9,11,16,38,54,-16,38
Dunfermline,7032,9,8,13,15,42,50,-8,37
Ayr,7032,10,7,14,15,34,55,-21,35
Hibernian,7033,1,18,13,5,50,25,25,67
Falkirk,7033,2,17,10,9,56,38,18,61
Morton,7033,3,16,11,9,54,35,19,59
Dundee Utd,7033,4,16,10,10,51,39,12,58
Queen of S't,7033,5,12,9,15,50,53,-3,45
Dunfermline,7033,6,10,14,12,42,43,-1,44
Raith,7033,7,10,11,15,38,50,-12,41
Dumbarton,7033,8,9,10,17,45,61,-16,37
St Mirren,7033,9,8,12,16,37,58,-21,36
Ayr,7033,10,7,14,15,34,55,-21,35
Hibernian,7034,1,16,13,7,52,31,21,61
Morton,7034,2,16,12,8,50,37,13,60
Falkirk,7034,3,15,11,10,55,40,15,56
Dundee Utd,7034,4,15,10,11,50,45,5,55
Dunfermline,7034,5,11,14,11,47,45,2,47
Queen of S't,7034,6,11,10,15,46,51,-5,43
Dumbarton,7034,7,10,13,13,50,56,-6,43
Raith,7034,8,11,9,16,35,48,-13,42
St Mirren,7034,9,10,10,16,41,55,-14,40
Ayr,7034,10,8,12,16,36,54,-18,36
Hibernian,7035,1,22,10,4,61,23,38,76
Morton,7035,2,17,9,10,56,39,17,60
Dundee Utd,7035,3,16,11,9,52,42,10,59
Falkirk,7035,4,15,10,11,60,49,11,55
Queen of S't,7035,5,13,10,13,48,48,0,49
Dumbarton,7035,6,10,11,15,46,54,-8,41
Dunfermline,7035,7,9,12,15,45,54,-9,39
Ayr,7035,8,9,11,16,32,53,-21,38
St Mirren,7035,9,8,12,16,39,55,-16,36
Raith,7035,10,8,10,18,31,53,-22,34
Hibernian,7036,1,18,14,4,52,25,27,68
Morton,7036,2,16,14,6,53,40,13,62
Falkirk,7036,3,17,10,9,60,39,21,61
Dundee Utd,7036,4,16,10,10,52,39,13,58
Queen of S't,7036,5,11,12,13,46,51,-5,45
Dunfermline,7036,6,9,16,11,51,47,4,43
Dumbarton,7036,7,8,13,15,45,54,-9,37
Raith,7036,8,9,9,18,33,57,-24,36
St Mirren,7036,9,8,11,17,38,56,-18,35
Ayr,7036,10,7,13,16,31,53,-22,34
Hibernian,7037,1,18,15,3,59,28,31,69
Falkirk,7037,2,18,10,8,60,37,23,64
Morton,7037,3,18,10,8,54,40,14,64
Dundee Utd,7037,4,15,10,11,48,40,8,55
Raith,7037,5,12,9,15,35,45,-10,45
Dunfermline,7037,6,10,13,13,46,49,-3,43
Ayr,7037,7,10,12,14,40,51,-11,42
Queen of S't,7037,8,10,10,16,42,54,-12,40
Dumbarton,7037,9,8,11,17,46,61,-15,35
St Mirren,7037,10,6,10,20,36,61,-25,28
Hibernian,7038,1,19,13,4,52,24,28,70
Dundee Utd,7038,2,17,10,9,52,39,13,61
Falkirk,7038,3,14,12,10,59,45,14,54
Morton,7038,4,14,11,11,46,42,4,53
Queen of S't,7038,5,13,9,14,46,48,-2,48
Raith,7038,6,12,8,16,37,47,-10,44
St Mirren,7038,7,10,12,14,43,53,-10,42
Dumbarton,7038,8,10,11,15,52,60,-8,41
Dunfermline,7038,9,9,13,14,44,48,-4,40
Ayr,7038,10,7,11,18,33,58,-25,32
Hibernian,7039,1,18,13,5,57,27,30,67
Falkirk,7039,2,16,11,9,61,38,23,59
Morton,7039,3,16,11,9,55,45,10,59
Dundee Utd,7039,4,14,12,10,44,40,4,54
Queen of S't,7039,5,12,9,15,46,55,-9,45
Dumbarton,7039,6,10,11,15,49,55,-6,41
Ayr,7039,7,9,14,13,34,52,-18,41
Dunfermline,7039,8,9,13,14,47,53,-6,40
Raith,7039,9,9,12,15,35,48,-13,39
St Mirren,7039,10,8,12,16,39,54,-15,36
Hibernian,7040,1,20,11,5,56,28,28,71
Dundee Utd,7040,2,16,10,10,47,39,8,58
Falkirk,7040,3,15,12,9,60,40,20,57
Morton,7040,4,15,12,9,49,36,13,57
Raith,7040,5,11,10,15,39,50,-11,43
Dumbarton,7040,6,10,12,14,48,53,-5,42
Dunfermline,7040,7,9,14,13,42,47,-5,41
Queen of S't,7040,8,9,13,14,40,49,-9,40
St Mirren,7040,9,9,10,17,37,53,-16,37
Ayr,7040,10,8,12,16,32,55,-23,36
Hibernian,7041,1,22,10,4,55,21,34,76
Dundee Utd,7041,2,17,11,8,56,39,17,62
Falkirk,7041,3,16,10,10,58,41,17,58
Morton,7041,4,15,11,10,48,40,8,56
Dunfermline,7041,5,11,13,12,45,46,-1,46
Queen of S't,7041,6,11,10,15,43,51,-8,43
Dumbarton,7041,7,10,10,16,50,60,-10,40
Raith,7041,8,9,10,17,32,48,-16,37
Ayr,7041,9,8,12,16,33,54,-21,36
St Mirren,7041,10,8,9,19,39,59,-20,33
Hibernian,7042,1,21,11,4,57,24,33,74
Falkirk,7042,2,18,10,8,59,36,23,64
Dundee Utd,7042,3,17,9,10,56,40,16,60
Morton,7042,4,13,12,11,46,40,6,51
Dunfermline,7042,5,9,15,12,42,44,-2,42
Ayr,7042,6,10,11,15,38,53,-15,41
Raith,7042,7,10,10,16,33,50,-17,40
Dumbarton,7042,8,9,11,16,49,60,-11,38
Queen of S't,7042,9,9,11,16,41,54,-13,38
St Mirren,7042,10,8,12,16,37,57,-20,36
Hibernian,7043,1,18,12,6,57,31,26,66
Morton,7043,2,18,11,7,54,34,20,65
Dundee Utd,7043,3,18,9,9,54,38,16,63
Falkirk,7043,4,15,13,8,56,39,17,58
Queen of S't,7043,5,14,9,13,52,52,0,51
Dunfermline,7043,6,9,14,13,49,51,-2,41
Raith,7043,7,10,10,16,37,49,-12,40
St Mirren,7043,8,9,9,18,41,59,-18,36
Dumbarton,7043,9,8,11,17,45,61,-16,35
Ayr,7043,10,6,12,18,33,64,-31,30
Hibernian,7044,1,20,11,5,58,29,29,71
Falkirk,7044,2,18,10,8,61,41,20,64
Morton,7044,3,17,10,9,51,38,13,61
Dundee Utd,7044,4,16,8,12,47,39,8,56
Raith,7044,5,11,11,14,43,47,-4,44
Dunfermline,7044,6,9,14,13,46,50,-4,41
Queen of S't,7044,7,10,10,16,41,51,-10,40
Ayr,7044,8,9,11,16,33,53,-20,38
Dumbarton,7044,9,9,10,17,44,57,-13,37
St Mirren,7044,10,8,11,17,40,59,-19,35
Hibernian,7045,1,21,12,3,61,23,38,75
Falkirk,7045,2,17,11,8,60,40,20,62
Morton,7045,3,13,13,10,47,43,4,52
Dundee Utd,7045,4,14,9,13,49,47,2,51
Queen of S't,7045,5,12,10,14,44,45,-1,46
Dumbarton,7045,6,10,11,15,49,61,-12,41
St Mirren,7045,7,10,10,16,44,58,-14,40
Raith,7045,8,9,12,15,41,54,-13,39
Ayr,7045,9,9,12,15,38,56,-18,39
Dunfermline,7045,10,7,16,13,45,51,-6,37
Hibernian,7046,1,18,13,5,57,29,28,67
Dundee Utd,7046,2,17,10,9,55,41,14,61
Falkirk,7046,3,16,10,10,58,41,17,58
Morton,7046,4,15,12,9,50,40,10,57
Dunfermline,7046,5,11,14,11,48,46,2,47
Queen of S't,7046,6,11,8,17,43,57,-14,41
St Mirren,7046,7,9,12,15,39,52,-13,39
Ayr,7046,8,9,12,15,37,51,-14,39
Raith,7046,9,9,11,16,31,47,-16,38
Dumbarton,7046,10,9,10,17,45,59,-14,37
Morton,7047,1,19,11,6,55,35,20,68
Hibernian,7047,2,18,12,6,48,25,23,66
Falkirk,7047,3,15,13,8,57,39,18,58
Dundee Utd,7047,4,16,10,10,58,49,9,58
Queen of S't,7047,5,13,10,13,49,46,3,49
Dunfermline,7047,6,11,12,13,51,51,0,45
Raith,7047,7,9,11,16,37,51,-14,38
Dumbarton,7047,8,8,12,16,48,62,-14,36
St Mirren,7047,9,7,13,16,41,58,-17,34
Ayr,7047,10,7,10,19,35,63,-28,31
Hibernian,7048,1,18,14,4,52,25,27,68
Dundee Utd,7048,2,17,9,10,53,36,17,60
Morton,7048,3,16,12,8,51,37,14,60
Falkirk,7048,4,15,11,10,56,45,11,56
Queen of S't,7048,5,14,9,13,46,45,1,51
Dunfermline,7048,6,10,14,12,50,50,0,44
Raith,7048,7,11,8,17,35,49,-14,41
Ayr,7048,8,8,12,16,29,55,-26,36
Dumbarton,7048,9,8,11,17,45,61,-16,35
St Mirren,7048,10,8,10,18,42,56,-14,34
Hibernian,7049,1,20,12,4,55,25,30,72
Falkirk,7049,2,17,11,8,59,39,20,62
Morton,7049,3,16,11,9,47,37,10,59
Dundee Utd,7049,4,14,11,11,44,39,5,53
Queen of S't,7049,5,11,11,14,46,51,-5,44
Dunfermline,7049,6,10,13,13,47,46,1,43
Dumbarton,7049,7,10,12,14,48,53,-5,42
Ayr,7049,8,9,12,15,34,52,-18,39
Raith,7049,9,9,11,16,35,52,-17,38
St Mirren,7049,10,7,10,19,37,58,-21,31
Hibernian,7050,1,20,12,4,61,25,36,72
Morton,7050,2,17,11,8,55,38,17,62
Falkirk,7050,3,15,12,9,59,43,16,57
Dundee Utd,7050,4,15,12,9,49,38,11,57
Raith,7050,5,12,11,13,41,47,-6,47
Queen of S't,7050,6,11,12,13,46,48,-2,45
Dumbarton,7050,7,10,12,14,49,57,-8,42
Dunfermline,7050,8,7,13,16,41,58,-17,34
St Mirren,7050,9,7,13,16,37,54,-17,34
Ayr,7050,10,6,12,18,29,59,-30,30
Hibernian,7051,1,21,11,4,58,26,32,74
Morton,7051,2,17,12,7,53,36,17,63
Falkirk,7051,3,16,11,9,63,43,20,59
Dundee Utd,7051,4,16,10,10,54,43,11,58
Queen of S't,7051,5,11,10,15,45,50,-5,43
Dunfermline,7051,6,10,12,14,48,53,-5,42
Raith,7051,7,10,11,15,40,53,-13,41
Dumbarton,7051,8,9,11,16,43,56,-13,38
St Mirren,7051,9,7,12,17,40,61,-21,33
Ayr,7051,10,7,12,17,35,58,-23,33
Hibernian,7052,1,18,13,5,57,29,28,67
Morton,7052,2,18,11,7,51,35,16,65
Falkirk,7052,3,17,9,10,64,45,19,60
Dundee Utd,7052,4,17,9,10,57,44,13,60
Queen of S't,7052,5,12,9,15,46,51,-5,45
Dumbarton,7052,6,11,10,15,49,56,-7,43
Dunfermline,7052,7,10,12,14,47,50,-3,42
St Mirren,7052,8,10,9,17,43,58,-15,39
Raith,7052,9,9,9,18,35,55,-20,36
Ayr,7052,10,6,13,17,37,63,-26,31
Morton,7053,1,16,13,7,45,32,13,61
Hibernian,7053,2,15,14,7,47,26,21,59
Falkirk,7053,3,14,13,9,56,44,12,55
Dundee Utd,7053,4,14,11,11,49,45,4,53
Dunfermline,7053,5,10,15,11,50,46,4,45
Queen of S't,7053,6,11,12,13,45,50,-5,45
St Mirren,7053,7,11,11,14,50,52,-2,44
Raith,7053,8,10,12,14,37,46,-9,42
Ayr,7053,9,9,11,16,38,59,-21,38
Dumbarton,7053,10,9,10,17,50,67,-17,37
Hibernian,7054,1,19,11,6,54,28,26,68
Morton,7054,2,17,11,8,54,43,11,62
Falkirk,7054,3,17,10,9,60,39,21,61
Dundee Utd,7054,4,15,11,10,50,41,9,56
Raith,7054,5,12,8,16,38,49,-11,44
Queen of S't,7054,6,11,9,16,41,54,-13,42
Dunfermline,7054,7,9,13,14,48,51,-3,40
Dumbarton,7054,8,9,12,15,53,59,-6,39
Ayr,7054,9,9,12,15,36,50,-14,39
St Mirren,7054,10,8,11,17,39,59,-20,35
Hibernian,7055,1,17,14,5,54,29,25,65
Morton,7055,2,18,11,7,54,36,18,65
Falkirk,7055,3,16,12,8,58,41,17,60
Dundee Utd,7055,4,16,11,9,56,39,17,59
Queen of S't,7055,5,12,8,16,46,53,-7,44
Dumbarton,7055,6,10,12,14,43,51,-8,42
Raith,7055,7,9,11,16,36,52,-16,38
Dunfermline,7055,8,8,13,15,47,55,-8,37
Ayr,7055,9,8,13,15,35,55,-20,37
St Mirren,7055,10,7,13,16,36,54,-18,34
Hibernian,7056,1,18,13,5,59,33,26,67
Morton,7056,2,17,14,5,51,33,18,65
Falkirk,7056,3,17,12,7,60,37,23,63
Dundee Utd,7056,4,16,10,10,49,37,12,58
Raith,7056,5,9,14,13,34,45,-11,41
Queen of S't,7056,6,10,10,16,46,56,-10,40
Dunfermline,7056,7,8,15,13,43,50,-7,39
Dumbarton,7056,8,7,14,15,48,60,-12,35
Ayr,7056,9,7,14,15,33,57,-24,35
St Mirren,7056,10,7,12,17,44,59,-15,33
Hibernian,7057,1,17,13,6,54,28,26,64
Morton,7057,2,16,15,5,51,33,18,63
Falkirk,7057,3,16,13,7,57,38,19,61
Dundee Utd,7057,4,15,10,11,48,46,2,55
Queen of S't,7057,5,13,8,15,46,51,-5,47
Dunfermline,7057,6,8,15,13,41,45,-4,39
Raith,7057,7,9,12,15,35,47,-12,39
Ayr,7057,8,9,12,15,40,57,-17,39
Dumbarton,7057,9,8,12,16,43,55,-12,36
St Mirren,7057,10,7,14,15,39,54,-15,35
Hibernian,7058,1,21,12,3,55,21,34,75
Morton,7058,2,17,13,6,49,33,16,64
Dundee Utd,7058,3,17,9,10,51,39,12,60
Falkirk,7058,4,14,10,12,53,40,13,52
Queen of S't,7058,5,12,9,15,43,50,-7,45
Dunfermline,7058,6,9,14,13,44,48,-4,41
Dumbarton,7058,7,10,11,15,49,54,-5,41
St Mirren,7058,8,10,9,17,45,58,-13,39
Raith,7058,9,8,11,17,31,50,-19,35
Ayr,7058,10,7,12,17,34,61,-27,33
Hibernian,7059,1,18,13,5,52,26,26,67
Morton,7059,2,19,10,7,54,36,18,67
Dundee Utd,7059,3,16,9,11,60,44,16,57
Falkirk,7059,4,15,11,10,60,46,14,56
Dunfermline,7059,5,11,12,13,49,48,1,45
Queen of S't,7059,6,11,11,14,48,50,-2,44
Dumbarton,7059,7,10,12,14,52,62,-10,42
Ayr,7059,8,9,10,17,34,60,-26,37
Raith,7059,9,8,11,17,35,52,-17,35
St Mirren,7059,10,8,11,17,41,61,-20,35
Hibernian,7060,1,17,11,8,51,29,22,62
Morton,7060,2,17,11,8,49,34,15,62
Falkirk,7060,3,16,11,9,58,39,19,59
Dundee Utd,7060,4,15,9,12,45,38,7,54
Queen of S't,7060,5,14,9,13,48,48,0,51
Dunfermline,7060,6,11,11,14,46,44,2,44
Dumbarton,7060,7,11,11,14,50,58,-8,44
St Mirren,7060,8,10,10,16,44,56,-12,40
Raith,7060,9,9,10,17,35,59,-24,37
Ayr,7060,10,8,11,17,34,55,-21,35
Hibernian,7061,1,19,14,3,52,23,29,71
Morton,7061,2,18,12,6,53,34,19,66
Dundee Utd,7061,3,17,9,10,55,43,12,60
Falkirk,7061,4,15,11,10,59,44,15,56
Queen of S't,7061,5,12,9,15,44,50,-6,45
Dunfermline,7061,6,10,12,14,49,50,-1,42
Raith,7061,7,9,11,16,34,49,-15,38
St Mirren,7061,8,9,10,17,42,57,-15,37
Dumbarton,7061,9,8,11,17,48,63,-15,35
Ayr,7061,10,8,11,17,31,54,-23,35
Hibernian,7062,1,20,11,5,60,30,30,71
Dundee Utd,7062,2,17,10,9,51,40,11,61
Falkirk,7062,3,16,12,8,55,38,17,60
Morton,7062,4,15,11,10,50,41,9,56
Dunfermline,7062,5,11,12,13,48,50,-2,45
Queen of S't,7062,6,12,8,16,47,50,-3,44
Ayr,7062,7,11,11,14,39,53,-14,44
St Mirren,7062,8,8,12,16,39,51,-12,36
Raith,7062,9,9,9,18,33,54,-21,36
Dumbarton,7062,10,8,10,18,45,60,-15,34
Hibernian,7063,1,19,12,5,51,22,29,69
Falkirk,7063,2,19,9,8,67,39,28,66
Morton,7063,3,17,12,7,52,37,15,63
Dundee Utd,7063,4,16,9,11,54,44,10,57
Queen of S't,7063,5,12,9,15,45,54,-9,45
Dunfermline,7063,6,9,14,13,47,51,-4,41
Ayr,7063,7,9,12,15,41,57,-16,39
Dumbarton,7063,8,8,12,16,49,61,-12,36
Raith,7063,9,9,9,18,30,50,-20,36
St Mirren,7063,10,8,10,18,37,58,-21,34
Hibernian,7064,1,20,12,4,60,26,34,72
Dundee Utd,7064,2,17,10,9,52,36,16,61
Morton,7064,3,17,10,9,51,37,14,61
Falkirk,7064,4,13,14,9,55,42,13,53
Queen of S't,7064,5,12,9,15,45,50,-5,45
Dumbarton,7064,6,10,11,15,48,55,-7,41
Dunfermline,7064,7,8,14,14,45,54,-9,38
Raith,7064,8,9,11,16,33,49,-16,38
Ayr,7064,9,8,14,14,31,54,-23,38
St Mirren,7064,10,8,11,17,36,53,-17,35
Hibernian,7065,1,22,10,4,63,24,39,76
Morton,7065,2,17,11,8,54,41,13,62
Falkirk,7065,3,16,10,10,57,42,15,58
Dundee Utd,7065,4,16,9,11,52,41,11,57
Queen of S't,7065,5,12,9,15,45,52,-7,45
Dunfermline,7065,6,8,14,14,45,52,-7,38
Dumbarton,7065,7,9,11,16,49,62,-13,38
St Mirren,7065,8,9,11,16,41,54,-13,38
Raith,7065,9,10,8,18,33,50,-17,38
Ayr,7065,10,9,11,16,34,55,-21,38
Hibernian,7066,1,18,12,6,56,29,27,66
Falkirk,7066,2,17,11,8,55,35,20,62
Dundee Utd,7066,3,18,8,10,48,36,12,62
Morton,7066,4,17,10,9,51,40,11,61
Queen of S't,7066,5,11,11,14,44,48,-4,44
Raith,7066,6,11,11,14,37,46,-9,44
Dumbarton,7066,7,10,12,14,53,60,-7,42
Dunfermline,7066,8,9,13,14,46,52,-6,40
Ayr,7066,9,7,13,16,30,53,-23,34
St Mirren,7066,10,7,9,20,36,57,-21,30
Hibernian,7067,1,18,13,5,58,28,30,67
Morton,7067,2,15,14,7,51,40,11,59
Dundee Utd,7067,3,16,10,10,54,41,13,58
Falkirk,7067,4,15,11,10,55,38,17,56
Dunfermline,7067,5,12,12,12,48,45,3,48
Queen of S't,7067,6,13,9,14,49,52,-3,48
Dumbarton,7067,7,10,11,15,52,66,-14,41
Raith,7067,8,10,8,18,33,48,-15,38
Ayr,7067,9,8,12,16,35,56,-21,36
St Mirren,7067,10,8,10,18,39,60,-21,34
Hibernian,7068,1,20,11,5,58,25,33,71
Morton,7068,2,17,11,8,51,39,12,62
Falkirk,7068,3,15,12,9,58,43,15,57
Dundee Utd,7068,4,13,12,11,46,42,4,51
Dunfermline,7068,5,11,14,11,49,48,1,47
Queen of S't,7068,6,13,8,15,50,54,-4,47
Dumbarton,7068,7,9,12,15,52,62,-10,39
Ayr,7068,8,8,13,15,36,54,-18,37
Raith,7068,9,8,12,16,35,51,-16,36
St Mirren,7068,10,7,13,16,35,52,-17,34
Hibernian,7069,1,21,12,3,62,23,39,75
Dundee Utd,7069,2,17,9,10,54,37,17,60
Falkirk,7069,3,16,11,9,56,40,16,59
Morton,7069,4,16,11,9,49,40,9,59
Queen of S't,7069,5,12,9,15,41,47,-6,45
Dunfermline,7069,6,9,13,14,42,56,-14,40
St Mirren,7069,7,10,9,17,50,61,-11,39
Dumbarton,7069,8,9,11,16,49,54,-5,38
Raith,7069,9,9,10,17,34,51,-17,37
Ayr,7069,10,8,11,17,33,61,-28,35
Hibernian,7070,1,22,10,4,58,23,35,76
Morton,7070,2,17,10,9,51,39,12,61
Falkirk,7070,3,15,11,10,55,40,15,56
Dundee Utd,7070,4,15,11,10,45,38,7,56
Dunfermline,7070,5,11,14,11,45,42,3,47
Dumbarton,7070,6,11,10,15,49,54,-5,43
Queen of S't,7070,7,10,12,14,41,47,-6,42
Raith,7070,8,10,11,15,33,45,-12,41
Ayr,7070,9,6,13,17,30,57,-27,31
St Mirren,7070,10,6,12,18,39,61,-22,30
Hibernian,7071,1,19,11,6,54,23,31,68
Dundee Utd,7071,2,17,11,8,53,39,14,62
Morton,7071,3,15,13,8,47,38,9,58
Falkirk,7071,4,16,9,11,57,44,13,57
Raith,7071,5,12,8,16,37,47,-10,44
Dunfermline,7071,6,10,13,13,46,47,-1,43
St Mirren,7071,7,10,10,16,43,52,-9,40
Queen of S't,7071,8,10,10,16,40,53,-13,40
Dumbarton,7071,9,9,12,15,49,60,-11,39
Ayr,7071,10,7,13,16,32,55,-23,34
Hibernian,7072,1,20,11,5,56,22,34,71
Falkirk,7072,2,16,10,10,56,36,20,58
Dundee Utd,7072,3,16,8,12,48,42,6,56
Morton,7072,4,15,10,11,46,42,4,55
Dunfermline,7072,5,12,12,12,49,43,6,48
Queen of S't,7072,6,13,9,14,45,50,-5,48
Raith,7072,7,12,9,15,36,44,-8,45
Ayr,7072,8,10,10,16,34,58,-24,40
Dumbarton,7072,9,8,11,17,42,58,-16,35
St Mirren,7072,10,8,10,18,39,56,-17,34
Hibernian,7073,1,21,11,4,60,25,35,74
Morton,7073,2,16,11,9,51,40,11,59
Falkirk,7073,3,16,10,10,59,39,20,58
Dundee Utd,7073,4,13,14,9,51,44,7,53
Dunfermline,7073,5,11,11,14,49,50,-1,44
Raith,7073,6,12,8,16,37,49,-12,44
St Mirren,7073,7,11,10,15,44,54,-10,43
Queen of S't,7073,8,10,10,16,43,52,-9,40
Ayr,7073,9,7,14,15,36,56,-20,35
Dumbarton,7073,10,8,11,17,46,67,-21,35
Hibernian,7074,1,19,14,3,56,24,32,71
Falkirk,7074,2,17,10,9,59,43,16,61
Morton,7074,3,16,12,8,51,36,15,60
Dundee Utd,7074,4,15,11,10,50,38,12,56
Queen of S't,7074,5,12,9,15,45,48,-3,45
Dumbarton,7074,6,11,10,15,48,57,-9,43
Raith,7074,7,11,9,16,34,47,-13,42
St Mirren,7074,8,10,10,16,44,55,-11,40
Dunfermline,7074,9,7,13,16,42,57,-15,34
Ayr,7074,10,7,12,17,33,57,-24,33
Hibernian,7075,1,20,10,6,59,25,34,70
Morton,7075,2,19,10,7,53,33,20,67
Falkirk,7075,3,17,11,8,59,40,19,62
Dundee Utd,7075,4,14,12,10,47,39,8,54
Queen of S't,7075,5,10,12,14,47,54,-7,42
Dumbarton,7075,6,9,14,13,49,55,-6,41
Dunfermline,7075,7,9,11,16,42,53,-11,38
Raith,7075,8,9,10,17,33,51,-18,37
Ayr,7075,9,8,13,15,34,55,-21,37
St Mirren,7075,10,8,11,17,41,59,-18,35
Hibernian,7076,1,18,11,7,55,33,22,65
Morton,7076,2,18,10,8,55,41,14,64
Falkirk,7076,3,17,10,9,64,43,21,61
Dundee Utd,7076,4,16,9,11,53,46,7,57
Queen of S't,7076,5,12,10,14,46,49,-3,46
Dunfermline,7076,6,11,12,13,48,48,0,45
Raith,7076,7,11,9,16,36,48,-12,42
St Mirren,7076,8,10,9,17,45,58,-13,39
Dumbarton,7076,9,9,10,17,49,63,-14,37
Ayr,7076,10,7,12,17,31,53,-22,33
Hibernian,7077,1,19,13,4,55,22,33,70
Morton,7077,2,18,11,7,53,36,17,65
Falkirk,7077,3,17,11,8,59,38,21,62
Dundee Utd,7077,4,15,11,10,48,42,6,56
Dunfermline,7077,5,12,11,13,47,45,2,47
Dumbarton,7077,6,9,13,14,48,54,-6,40
Raith,7077,7,10,8,18,34,56,-22,38
Queen of S't,7077,8,9,10,17,40,51,-11,37
Ayr,7077,9,7,14,15,35,56,-21,35
St Mirren,7077,10,7,12,17,44,63,-19,33
Hibernian,7078,1,21,11,4,62,25,37,74
Dundee Utd,7078,2,17,10,9,54,42,12,61
Morton,7078,3,15,13,8,47,39,8,58
Falkirk,7078,4,13,12,11,53,44,9,51
Dumbarton,7078,5,11,12,13,52,55,-3,45
Dunfermline,7078,6,9,15,12,43,45,-2,42
Queen of S't,7078,7,10,10,16,42,55,-13,40
Raith,7078,8,9,10,17,40,52,-12,37
Ayr,7078,9,8,13,15,36,56,-20,37
St Mirren,7078,10,8,12,16,38,54,-16,36
Hibernian,7079,1,19,12,5,56,24,32,69
Morton,7079,2,17,10,9,49,40,9,61
Dundee Utd,7079,3,17,8,11,51,36,15,59
Falkirk,7079,4,15,10,11,62,48,14,55
Queen of S't,7079,5,13,9,14,45,51,-6,48
Raith,7079,6,11,9,16,35,49,-14,42
Dumbarton,7079,7,9,12,15,48,62,-14,39
Ayr,7079,8,9,12,15,38,52,-14,39
Dunfermline,7079,9,8,14,14,44,49,-5,38
St Mirren,7079,10,9,10,17,42,59,-17,37
Hibernian,7080,1,20,11,5,54,24,30,71
Falkirk,7080,2,16,11,9,63,40,23,59
Dundee Utd,7080,3,17,8,11,50,43,7,59
Morton,7080,4,15,10,11,47,51,-4,55
Queen of S't,7080,5,13,8,15,47,46,1,47
Dumbarton,7080,6,10,12,14,50,57,-7,42
Dunfermline,7080,7,10,12,14,44,51,-7,42
Raith,7080,8,10,10,16,35,48,-13,40
Ayr,7080,9,9,11,16,35,53,-18,38
St Mirren,7080,10,7,13,16,40,52,-12,34
Hibernian,7081,1,19,13,4,59,29,30,70
Falkirk,7081,2,16,12,8,62,40,22,60
Morton,7081,3,16,11,9,46,36,10,59
Dundee Utd,7081,4,16,11,9,47,39,8,59
Queen of S't,7081,5,11,11,14,44,49,-5,44
Dumbarton,7081,6,10,12,14,53,58,-5,42
Raith,7081,7,10,11,15,32,46,-14,41
Dunfermline,7081,8,9,12,15,44,49,-5,39
Ayr,7081,9,8,13,15,32,52,-20,37
St Mirren,7081,10,7,10,19,36,57,-21,31
Hibernian,7082,1,19,12,5,54,27,27,69
Falkirk,7082,2,18,10,8,58,35,23,64
Dundee Utd,7082,3,16,10,10,49,39,10,58
Morton,7082,4,15,12,9,48,42,6,57
Ayr,7082,5,10,14,12,37,48,-11,44
Dunfermline,7082,6,9,14,13,47,46,1,41
Queen of S't,7082,7,11,8,17,41,53,-12,41
Dumbarton,7082,8,10,10,16,46,56,-10,40
Raith,7082,9,9,10,17,36,53,-17,37
St Mirren,7082,10,8,10,18,38,55,-17,34
Hibernian,7083,1,20,13,3,58,23,35,73
Morton,7083,2,17,12,7,57,35,22,63
Falkirk,7083,3,16,10,10,56,43,13,58
Dundee Utd,7083,4,14,11,11,49,46,3,53
Queen of S't,7083,5,13,10,13,52,51,1,49
Dunfermline,7083,6,10,14,12,48,53,-5,44
Dumbarton,7083,7,9,13,14,50,59,-9,40
Ayr,7083,8,8,14,14,34,53,-19,38
St Mirren,7083,9,8,9,19,39,59,-20,33
Raith,7083,10,8,8,20,31,52,-21,32
Hibernian,7084,1,20,10,6,59,32,27,70
Morton,7084,2,17,11,8,52,38,14,62
Dundee Utd,7084,3,16,9,11,46,40,6,57
Falkirk,7084,4,15,10,11,62,46,16,55
Queen of S't,7084,5,14,8,14,49,51,-2,50
Dunfermline,7084,6,10,14,12,50,48,2,44
Raith,7084,7,10,10,16,36,48,-12,40
St Mirren,7084,8,9,11,16,47,56,-9,38
Ayr,7084,9,9,10,17,31,56,-25,37
Dumbarton,7084,10,8,11,17,47,64,-17,35
Hibernian,7085,1,22,11,3,62,25,37,77
Morton,7085,2,19,10,7,61,37,24,67
Falkirk,7085,3,16,11,9,57,42,15,59
Dundee Utd,7085,4,14,12,10,50,45,5,54
Queen of S't,7085,5,12,10,14,47,47,0,46
Raith,7085,6,10,10,16,33,47,-14,40
Dunfermline,7085,7,8,13,15,45,55,-10,37
Ayr,7085,8,8,13,15,36,56,-20,37
Dumbarton,7085,9,8,12,16,46,61,-15,36
St Mirren,7085,10,6,12,18,38,60,-22,30
Hibernian,7086,1,19,12,5,54,27,27,69
Morton,7086,2,18,10,8,55,40,15,64
Falkirk,7086,3,17,10,9,61,40,21,61
Dundee Utd,7086,4,15,8,13,49,47,2,53
Dumbarton,7086,5,12,10,14,51,54,-3,46
Dunfermline,7086,6,11,12,13,51,47,4,45
Queen of S't,7086,7,11,10,15,46,51,-5,43
Raith,7086,8,10,8,18,35,54,-19,38
St Mirren,7086,9,8,11,17,41,57,-16,35
Ayr,7086,10,7,13,16,31,57,-26,34
Morton,7087,1,20,9,7,52,36,16,69
Hibernian,7087,2,19,11,6,53,25,28,68
Falkirk,7087,3,18,9,9,58,39,19,63
Dundee Utd,7087,4,12,9,15,42,46,-4,45
Queen of S't,7087,5,11,10,15,45,49,-4,43
Dumbarton,7087,6,11,10,15,48,54,-6,43
Ayr,7087,7,10,12,14,37,50,-13,42
St Mirren,7087,8,10,10,16,40,53,-13,40
Raith,7087,9,10,10,16,39,54,-15,40
Dunfermline,7087,10,8,12,16,43,51,-8,36
Morton,7088,1,17,13,6,54,36,18,64
Hibernian,7088,2,17,12,7,53,29,24,63
Falkirk,7088,3,16,10,10,53,38,15,58
Dundee Utd,7088,4,16,9,11,55,43,12,57
Dunfermline,7088,5,11,14,11,51,51,0,47
Raith,7088,6,11,10,15,38,48,-10,43
Queen of S't,7088,7,11,9,16,45,54,-9,42
Dumbarton,7088,8,9,11,16,47,60,-13,38
St Mirren,7088,9,8,12,16,41,58,-17,36
Ayr,7088,10,8,12,16,36,56,-20,36
Hibernian,7089,1,18,13,5,52,24,28,67
Morton,7089,2,16,11,9,46,35,11,59
Falkirk,7089,3,15,12,9,54,36,18,57
Dundee Utd,7089,4,16,9,11,50,40,10,57
Dunfermline,7089,5,11,12,13,48,48,0,45
Ayr,7089,6,10,13,13,36,49,-13,43
Queen of S't,7089,7,10,9,17,44,55,-11,39
Raith,7089,8,9,12,15,37,52,-15,39
Dumbarton,7089,9,8,14,14,46,57,-11,38
St Mirren,7089,10,9,11,16,41,58,-17,38
Hibernian,7090,1,18,12,6,55,28,27,66
Falkirk,7090,2,18,10,8,60,37,23,64
Dundee Utd,7090,3,18,8,10,53,38,15,62
Morton,7090,4,17,9,10,54,40,14,60
Dunfermline,7090,5,11,12,13,49,48,1,45
Dumbarton,7090,6,10,12,14,48,55,-7,42
Raith,7090,7,11,9,16,35,50,-15,42
Queen of S't,7090,8,10,10,16,43,54,-11,40
St Mirren,7090,9,8,11,17,38,58,-20,35
Ayr,7090,10,7,11,18,35,62,-27,32
Morton,7091,1,20,10,6,51,32,19,70
Hibernian,7091,2,18,11,7,48,25,23,65
Falkirk,7091,3,18,10,8,64,40,24,64
Dundee Utd,7091,4,15,8,13,44,39,5,53
Dunfermline,7091,5,11,13,12,44,44,0,46
Ayr,7091,6,11,11,14,34,49,-15,44
Queen of S't,7091,7,10,8,18,40,51,-11,38
Raith,7091,8,10,8,18,37,51,-14,38
Dumbarton,7091,9,8,12,16,45,58,-13,36
St Mirren,7091,10,8,11,17,35,53,-18,35
Morton,7092,1,19,12,5,59,33,26,69
Hibernian,7092,2,18,13,5,52,28,24,67
Falkirk,7092,3,18,10,8,61,36,25,64
Dundee Utd,7092,4,15,10,11,43,37,6,55
Dumbarton,7092,5,12,10,14,48,54,-6,46
Dunfermline,7092,6,9,14,13,43,47,-4,41
Queen of S't,7092,7,11,8,17,45,52,-7,41
Raith,7092,8,10,8,18,40,57,-17,38
St Mirren,7092,9,8,10,18,37,59,-22,34
Ayr,7092,10,7,11,18,32,57,-25,32
Hibernian,7093,1,19,12,5,54,25,29,69
Morton,7093,2,17,10,9,47,36,11,61
Falkirk,7093,3,15,12,9,57,41,16,57
Dundee Utd,7093,4,15,10,11,52,39,13,55
Queen of S't,7093,5,12,10,14,43,48,-5,46
Dunfermline,7093,6,10,13,13,45,48,-3,43
Raith,7093,7,11,9,16,36,49,-13,42
Dumbarton,7093,8,9,13,14,48,61,-13,40
St Mirren,7093,9,9,10,17,42,56,-14,37
Ayr,7093,10,7,13,16,32,53,-21,34
Hibernian,7094,1,18,12,6,56,28,28,66
Falkirk,7094,2,18,10,8,59,38,21,64
Morton,7094,3,16,12,8,50,36,14,60
Dundee Utd,7094,4,15,11,10,50,42,8,56
Queen of S't,7094,5,12,10,14,48,52,-4,46
Raith,7094,6,11,9,16,38,50,-12,42
Dunfermline,7094,7,9,13,14,47,53,-6,40
Dumbarton,7094,8,9,13,14,46,56,-10,40
St Mirren,7094,9,10,9,17,43,52,-9,39
Ayr,7094,10,6,13,17,30,60,-30,31
Hibernian,7095,1,18,15,3,58,26,32,69
Morton,7095,2,15,15,6,50,36,14,60
Falkirk,7095,3,16,10,10,57,44,13,58
Dundee Utd,7095,4,16,9,11,51,40,11,57
Dunfermline,7095,5,11,13,12,50,46,4,46
Ayr,7095,6,10,13,13,38,50,-12,43
Queen of S't,7095,7,10,12,14,41,47,-6,42
Raith,7095,8,9,11,16,33,49,-16,38
St Mirren,7095,9,8,11,17,38,56,-18,35
Dumbarton,7095,10,7,11,18,42,64,-22,32
Hibernian,7096,1,20,13,3,56,21,35,73
Morton,7096,2,17,11,8,52,41,11,62
Dundee Utd,7096,3,17,9,10,50,40,10,60
Falkirk,7096,4,14,14,8,55,39,16,56
Queen of S't,7096,5,12,10,14,44,45,-1,46
Dunfermline,7096,6,10,13,13,47,47,0,43
Raith,7096,7,10,9,17,32,48,-16,39
Ayr,7096,8,8,13,15,34,53,-19,37
Dumbarton,7096,9,7,13,16,45,60,-15,34
St Mirren,7096,10,7,11,18,39,60,-21,32
Hibernian,7097,1,19,12,5,58,28,30,69
Falkirk,7097,2,17,10,9,62,44,18,61
Morton,7097,3,16,13,7,47,33,14,61
Dundee Utd,7097,4,16,10,10,46,38,8,58
Queen of S't,7097,5,12,8,16,45,52,-7,44
Dunfermline,7097,6,9,15,12,45,46,-1,42
Raith,7097,7,10,12,14,35,45,-10,42
Dumbarton,7097,8,8,13,15,47,60,-13,37
Ayr,7097,9,7,15,14,31,50,-19,36
St Mirren,7097,10,7,10,19,34,54,-20,31
Hibernian,7098,1,20,11,5,57,28,29,71
Morton,7098,2,17,12,7,48,34,14,63
Falkirk,7098,3,17,10,9,58,37,21,61
Dundee Utd,7098,4,17,9,10,55,37,18,60
Queen of S't,7098,5,10,11,15,40,48,-8,41
Dunfermline,7098,6,9,12,15,44,52,-8,39
Raith,7098,7,9,12,15,37,50,-13,39
Ayr,7098,8,9,12,15,36,57,-21,39
Dumbarton,7098,9,8,12,16,42,60,-18,36
St Mirren,7098,10,8,11,17,41,55,-14,35
Dundee Utd,7099,1,19,8,9,49,33,16,65
Hibernian,7099,2,17,12,7,49,26,23,63
Falkirk,7099,3,17,9,10,59,41,18,60
Morton,7099,4,16,11,9,50,42,8,59
Dunfermline,7099,5,11,13,12,50,49,1,46
Queen of S't,7099,6,12,9,15,45,47,-2,45
Dumbarton,7099,7,9,12,15,48,62,-14,39
Raith,7099,8,10,9,17,37,51,-14,39
St Mirren,7099,9,9,10,17,43,55,-12,37
Ayr,7099,10,8,11,17,32,56,-24,35
Hibernian,7100,1,20,11,5,61,30,31,71
Morton,7100,2,17,9,10,57,44,13,60
Falkirk,7100,3,16,11,9,55,40,15,59
Dundee Utd,7100,4,13,10,13,45,46,-1,49
Dunfermline,7100,5,12,11,13,50,49,1,47
Ayr,7100,6,11,12,13,44,54,-10,45
Dumbarton,7100,7,11,11,14,48,55,-7,44
Queen of S't,7100,8,10,11,15,44,54,-10,41
Raith,7100,9,10,9,17,32,48,-16,39
St Mirren,7100,10,8,9,19,42,58,-16,33
Hibernian,7101,1,19,12,5,59,28,31,69
Morton,7101,2,17,13,6,52,34,18,64
Falkirk,7101,3,16,11,9,57,37,20,59
Dundee Utd,7101,4,16,11,9,50,40,10,59
Queen of S't,7101,5,13,9,14,50,55,-5,48
Raith,7101,6,11,9,16,40,54,-14,42
Dunfermline,7101,7,9,14,13,46,49,-3,41
Ayr,7101,8,8,12,16,39,60,-21,36
Dumbarton,7101,9,8,11,17,44,61,-17,35
St Mirren,7101,10,7,10,19,38,57,-19,31
Hibernian,7102,1,18,11,7,56,29,27,65
Morton,7102,2,17,10,9,49,35,14,61
Falkirk,7102,3,16,9,11,57,43,14,57
Dundee Utd,7102,4,15,11,10,56,46,10,56
Queen of S't,7102,5,11,12,13,47,50,-3,45
Dunfermline,7102,6,11,11,14,47,54,-7,44
Dumbarton,7102,7,10,12,14,52,60,-8,42
Raith,7102,8,10,10,16,34,49,-15,40
Ayr,7102,9,9,12,15,42,59,-17,39
St Mirren,7102,10,9,10,17,43,58,-15,37
Hibernian,7103,1,20,11,5,55,23,32,71
Falkirk,7103,2,16,11,9,58,43,15,59
Dundee Utd,7103,3,16,11,9,56,41,15,59
Morton,7103,4,16,11,9,49,38,11,59
Dumbarton,7103,5,12,11,13,51,54,-3,47
Raith,7103,6,12,9,15,38,48,-10,45
Queen of S't,7103,7,10,9,17,44,57,-13,39
Ayr,7103,8,9,11,16,35,54,-19,38
Dunfermline,7103,9,8,13,15,43,53,-10,37
St Mirren,7103,10,7,11,18,36,54,-18,32
Hibernian,7104,1,20,11,5,58,30,28,71
Falkirk,7104,2,16,10,10,61,44,17,58
Morton,7104,3,16,10,10,50,42,8,58
Dundee Utd,7104,4,15,10,11,55,38,17,55
Queen of S't,7104,5,11,11,14,43,46,-3,44
Dumbarton,7104,6,10,13,13,54,59,-5,43
Dunfermline,7104,7,10,13,13,46,52,-6,43
Raith,7104,8,10,10,16,35,47,-12,40
Ayr,7104,9,9,12,15,35,60,-25,39
St Mirren,7104,10,7,12,17,38,57,-19,33
Hibernian,7105,1,19,13,4,55,26,29,70
Dundee Utd,7105,2,18,9,9,53,38,15,63
Morton,7105,3,16,10,10,52,43,9,58
Falkirk,7105,4,15,12,9,56,39,17,57
Dunfermline,7105,5,10,13,13,47,49,-2,43
Queen of S't,7105,6,10,11,15,42,51,-9,41
Raith,7105,7,10,10,16,32,46,-14,40
St Mirren,7105,8,10,9,17,40,55,-15,39
Ayr,7105,9,9,12,15,38,56,-18,39
Dumbarton,7105,10,8,11,17,44,56,-12,35
Hibernian,7106,1,19,13,4,58,27,31,70
Morton,7106,2,17,12,7,50,35,15,63
Dundee Utd,7106,3,16,11,9,55,44,11,59
Falkirk,7106,4,13,11,12,50,42,8,50
Dunfermline,7106,5,12,11,13,47,46,1,47
Queen of S't,7106,6,11,10,15,46,55,-9,43
Raith,7106,7,10,10,16,32,46,-14,40
St Mirren,7106,8,9,12,15,43,52,-9,39
Dumbarton,7106,9,9,11,16,48,59,-11,38
Ayr,7106,10,7,13,16,35,58,-23,34
Hibernian,7107,1,19,12,5,54,26,28,69
Falkirk,7107,2,18,9,9,64,43,21,63
Morton,7107,3,16,13,7,51,35,16,61
Dundee Utd,7107,4,16,9,11,50,44,6,57
Queen of S't,7107,5,11,9,16,48,55,-7,42
Dumbarton,7107,6,9,14,13,47,55,-8,41
Raith,7107,7,10,10,16,37,51,-14,40
Ayr,7107,8,10,10,16,38,57,-19,40
St Mirren,7107,9,9,10,17,41,53,-12,37
Dunfermline,7107,10,8,12,16,41,52,-11,36
Hibernian,7108,1,20,12,4,61,23,38,72
Morton,7108,2,20,9,7,54,34,20,69
Falkirk,7108,3,16,11,9,57,40,17,59
Dundee Utd,7108,4,15,10,11,44,39,5,55
Dunfermline,7108,5,11,12,13,45,47,-2,45
Queen of S't,7108,6,11,10,15,41,45,-4,43
Ayr,7108,7,9,11,16,32,58,-26,38
Dumbarton,7108,8,9,10,17,44,55,-11,37
St Mirren,7108,9,9,10,17,40,56,-16,37
Raith,7108,10,8,9,19,30,51,-21,33
Hibernian,7109,1,22,11,3,58,21,37,77
Morton,7109,2,17,11,8,55,40,15,62
Dundee Utd,7109,3,17,9,10,53,39,14,60
Falkirk,7109,4,16,10,10,59,39,20,58
Dunfermline,7109,5,10,13,13,48,47,1,43
Raith,7109,6,11,9,16,33,46,-13,42
Queen of S't,7109,7,9,11,16,40,56,-16,38
St Mirren,7109,8,9,10,17,39,59,-20,37
Dumbarton,7109,9,7,14,15,44,57,-13,35
Ayr,7109,10,6,14,16,32,57,-25,32
Hibernian,7110,1,20,12,4,63,26,37,72
Morton,7110,2,17,11,8,50,36,14,62
Falkirk,7110,3,16,10,10,60,45,15,58
Dundee Utd,7110,4,15,10,11,48,40,8,55
Dunfermline,7110,5,12,12,12,53,52,1,48
Queen of S't,7110,6,10,10,16,44,54,-10,40
St Mirren,7110,7,10,10,16,45,58,-13,40
Dumbarton,7110,8,10,10,16,50,64,-14,40
Ayr,7110,9,8,12,16,35,54,-19,36
Raith,7110,10,8,11,17,34,53,-19,35
Hibernian,7111,1,20,12,4,56,23,33,72
Morton,7111,2,18,10,8,54,39,15,64
Falkirk,7111,3,15,13,8,54,35,19,58
Dundee Utd,7111,4,15,9,12,48,46,2,54
Queen of S't,7111,5,12,10,14,46,48,-2,46
Dunfermline,7111,6,10,13,13,43,47,-4,43
Raith,7111,7,10,9,17,33,52,-19,39
Dumbarton,7111,8,9,11,16,47,58,-11,38
Ayr,7111,9,9,11,16,33,51,-18,38
St Mirren,7111,10,8,10,18,41,56,-15,34
Hibernian,7112,1,18,12,6,58,31,27,66
Morton,7112,2,16,10,10,46,35,11,58
Falkirk,7112,3,15,12,9,60,45,15,57
Dundee Utd,7112,4,14,11,11,50,40,10,53
Dunfermline,7112,5,11,14,11,46,45,1,47
St Mirren,7112,6,11,11,14,45,52,-7,44
Ayr,7112,7,11,11,14,37,50,-13,44
Raith,7112,8,11,8,17,39,53,-14,41
Queen of S't,7112,9,10,9,17,40,54,-14,39
Dumbarton,7112,10,8,12,16,43,59,-16,36
Hibernian,7113,1,20,12,4,63,29,34,72
Dundee Utd,7113,2,18,10,8,47,34,13,64
Morton,7113,3,15,13,8,50,36,14,58
Falkirk,7113,4,15,10,11,57,44,13,55
Dumbarton,7113,5,10,13,13,54,56,-2,43
Queen of S't,7113,6,10,11,15,48,55,-7,41
Dunfermline,7113,7,9,14,13,44,51,-7,41
Raith,7113,8,10,10,16,38,54,-16,40
St Mirren,7113,9,8,11,17,38,57,-19,35
Ayr,7113,10,6,14,16,29,52,-23,32
Morton,7114,1,18,13,5,54,34,20,67
Hibernian,7114,2,18,12,6,53,27,26,66
Falkirk,7114,3,16,13,7,64,42,22,61
Dundee Utd,7114,4,14,11,11,53,46,7,53
Dunfermline,7114,5,10,15,11,49,45,4,45
Queen of S't,7114,6,12,8,16,44,53,-9,44
Dumbarton,7114,7,9,13,14,48,60,-12,40
St Mirren,7114,8,10,9,17,43,54,-11,39
Ayr,7114,9,7,13,16,30,55,-25,34
Raith,7114,10,8,9,19,32,54,-22,33
Hibernian,7115,1,18,14,4,57,27,30,68
Falkirk,7115,2,18,10,8,60,38,22,64
Morton,7115,3,16,11,9,47,39,8,59
Dundee Utd,7115,4,15,9,12,51,43,8,54
Queen of S't,7115,5,12,9,15,46,48,-2,45
Raith,7115,6,11,9,16,36,47,-11,42
Dunfermline,7115,7,9,13,14,46,51,-5,40
Dumbarton,7115,8,10,10,16,50,62,-12,40
Ayr,7115,9,9,12,15,38,55,-17,39
St Mirren,7115,10,8,11,17,42,63,-21,35
Hibernian,7116,1,18,14,4,55,25,30,68
Morton,7116,2,17,10,9,54,47,7,61
Dundee Utd,7116,3,16,9,11,55,40,15,57
Falkirk,7116,4,14,12,10,56,44,12,54
Queen of S't,7116,5,11,11,14,43,49,-6,44
Raith,7116,6,11,10,15,38,47,-9,43
St Mirren,7116,7,11,10,15,43,53,-10,43
Dumbarton,7116,8,10,10,16,51,64,-13,40
Dunfermline,7116,9,8,15,13,48,50,-2,39
Ayr,7116,10,7,13,16,31,55,-24,34
Hibernian,7117,1,21,11,4,59,25,34,74
Morton,7117,2,17,12,7,46,33,13,63
Dundee Utd,7117,3,15,10,11,51,39,12,55
Falkirk,7117,4,13,11,12,51,43,8,50
Queen of S't,7117,5,11,11,14,43,51,-8,44
Dumbarton,7117,6,10,13,13,48,53,-5,43
Dunfermline,7117,7,10,12,14,48,48,0,42
Raith,7117,8,10,10,16,34,51,-17,40
St Mirren,7117,9,9,11,16,40,51,-11,38
Ayr,7117,10,8,11,17,36,62,-26,35
Hibernian,7118,1,20,12,4,58,27,31,72
Falkirk,7118,2,17,10,9,59,41,18,61
Morton,7118,3,16,11,9,50,39,11,59
Dundee Utd,7118,4,16,10,10,56,42,14,58
Queen of S't,7118,5,13,10,13,49,46,3,49
Dunfermline,7118,6,10,13,13,47,49,-2,43
St Mirren,7118,7,10,10,16,41,54,-13,40
Dumbarton,7118,8,9,12,15,46,57,-11,39
Ayr,7118,9,7,12,17,30,58,-28,33
Raith,7118,10,8,8,20,30,53,-23,32
Hibernian,7119,1,21,11,4,57,24,33,74
Morton,7119,2,19,9,8,56,39,17,66
Falkirk,7119,3,16,9,11,57,45,12,57
Dundee Utd,7119,4,15,10,11,48,37,11,55
Raith,7119,5,12,8,16,40,48,-8,44
Ayr,7119,6,11,11,14,36,50,-14,44
Queen of S't,7119,7,11,9,16,43,50,-7,42
Dumbarton,7119,8,9,11,16,47,59,-12,38
St Mirren,7119,9,9,9,18,41,58,-17,36
Dunfermline,7119,10,8,11,17,43,58,-15,35
Hibernian,7120,1,19,11,6,53,26,27,68
Morton,7120,2,16,11,9,49,37,12,59
Dundee Utd,7120,3,17,8,11,47,39,8,59
Falkirk,7120,4,16,10,10,55,38,17,58
Dunfermline,7120,5,12,11,13,46,43,3,47
Queen of S't,7120,6,12,9,15,40,47,-7,45
Raith,7120,7,11,9,16,37,49,-12,42
Dumbarton,7120,8,9,12,15,43,53,-10,39
Ayr,7120,9,9,11,16,33,50,-17,38
St Mirren,7120,10,8,10,18,37,58,-21,34
Hibernian,7121,1,20,13,3,60,25,35,73
Morton,7121,2,16,13,7,50,35,15,61
Falkirk,7121,3,16,11,9,59,40,19,59
Dundee Utd,7121,4,16,9,11,51,41,10,57
Dunfermline,7121,5,12,12,12,47,46,1,48
Queen of S't,7121,6,11,8,17,44,55,-11,41
Dumbarton,7121,7,9,12,15,51,57,-6,39
Ayr,7121,8,8,13,15,34,53,-19,37
St Mirren,7121,9,8,11,17,35,55,-20,35
Raith,7121,10,8,10,18,34,58,-24,34
Hibernian,7122,1,19,12,5,58,28,30,69
Morton,7122,2,15,13,8,55,44,11,58
Falkirk,7122,3,15,9,12,55,48,7,54
Dundee Utd,7122,4,14,12,10,46,40,6,54
Dunfermline,7122,5,10,14,12,53,53,0,44
Ayr,7122,6,11,11,14,37,53,-16,44
Queen of S't,7122,7,11,10,15,45,51,-6,43
Dumbarton,7122,8,10,12,14,50,60,-10,42
Raith,7122,9,10,9,17,41,51,-10,39
St Mirren,7122,10,9,10,17,41,53,-12,37
Hibernian,7123,1,21,12,3,61,25,36,75
Morton,7123,2,17,10,9,53,39,14,61
Dundee Utd,7123,3,15,10,11,49,41,8,55
Falkirk,7123,4,14,12,10,55,43,12,54
Queen of S't,7123,5,15,8,13,48,45,3,53
Dunfermline,7123,6,10,13,13,50,54,-4,43
St Mirren,7123,7,10,11,15,42,54,-12,41
Raith,7123,8,9,10,17,32,50,-18,37
Dumbarton,7123,9,7,12,17,45,60,-15,33
Ayr,7123,10,7,12,17,32,56,-24,33
Hibernian,7124,1,20,12,4,56,25,31,72
Morton,7124,2,16,13,7,48,36,12,61
Falkirk,7124,3,16,10,10,59,44,15,58
Dundee Utd,7124,4,16,9,11,49,40,9,57
Raith,7124,5,10,13,13,38,48,-10,43
Queen of S't,7124,6,10,10,16,45,53,-8,40
Dunfermline,7124,7,8,15,13,44,50,-6,39
Dumbarton,7124,8,8,13,15,47,61,-14,37
Ayr,7124,9,8,13,15,38,54,-16,37
St Mirren,7124,10,8,12,16,42,55,-13,36
Hibernian,7125,1,19,12,5,53,27,26,69
Morton,7125,2,16,12,8,48,33,15,60
Dundee Utd,7125,3,16,10,10,54,39,15,58
Falkirk,7125,4,13,13,10,56,47,9,52
Dunfermline,7125,5,12,13,11,54,48,6,49
Raith,7125,6,10,10,16,37,51,-14,40
Queen of S't,7125,7,10,10,16,41,56,-15,40
Ayr,7125,8,9,12,15,34,52,-18,39
St Mirren,7125,9,8,14,14,39,51,-12,38
Dumbarton,7125,10,7,14,15,43,55,-12,35
Morton,7126,1,20,10,6,52,29,23,70
Hibernian,7126,2,18,11,7,52,31,21,65
Falkirk,7126,3,16,10,10,60,41,19,58
Dundee Utd,7126,4,15,11,10,48,40,8,56
Queen of S't,7126,5,12,10,14,51,50,1,46
Raith,7126,6,12,9,15,35,45,-10,45
Dumbarton,7126,7,10,11,15,46,56,-10,41
Dunfermline,7126,8,9,13,14,43,48,-5,40
St Mirren,7126,9,7,12,17,38,57,-19,33
Ayr,7126,10,6,13,17,31,59,-28,31
Morton,7127,1,21,9,6,57,36,21,72
Hibernian,7127,2,17,13,6,51,26,25,64
Falkirk,7127,3,18,9,9,62,39,23,63
Dundee Utd,7127,4,16,9,11,53,42,11,57
Queen of S't,7127,5,12,11,13,46,46,0,47
Dunfermline,7127,6,11,12,13,44,45,-1,45
Dumbarton,7127,7,9,12,15,47,57,-10,39
Raith,7127,8,8,11,17,34,57,-23,35
Ayr,7127,9,7,12,17,28,52,-24,33
St Mirren,7127,10,6,12,18,39,61,-22,30
Hibernian,7128,1,16,13,7,51,31,20,61
Falkirk,7128,2,16,11,9,60,43,17,59
Morton,7128,3,16,11,9,51,42,9,59
Dundee Utd,7128,4,15,10,11,48,41,7,55
Dunfermline,7128,5,12,12,12,55,48,7,48
Dumbarton,7128,6,10,13,13,55,60,-5,43
Ayr,7128,7,10,12,14,40,55,-15,42
Raith,7128,8,10,11,15,36,49,-13,41
Queen of S't,7128,9,10,9,17,43,55,-12,39
St Mirren,7128,10,9,10,17,46,61,-15,37
Hibernian,7129,1,19,11,6,54,24,30,68
Dundee Utd,7129,2,18,8,10,54,43,11,62
Falkirk,7129,3,17,10,9,59,43,16,61
Morton,7129,4,15,10,11,48,42,6,55
Ayr,7129,5,12,11,13,40,49,-9,47
Dunfermline,7129,6,11,12,13,49,50,-1,45
Dumbarton,7129,7,9,13,14,46,55,-9,40
Raith,7129,8,9,12,15,35,50,-15,39
Queen of S't,7129,9,9,11,16,44,54,-10,38
St Mirren,7129,10,7,10,19,40,59,-19,31
Hibernian,7130,1,20,10,6,53,24,29,70
Morton,7130,2,19,10,7,57,38,19,67
Falkirk,7130,3,16,11,9,54,38,16,59
Dundee Utd,7130,4,15,9,12,51,40,11,54
Raith,7130,5,11,10,15,38,47,-9,43
Queen of S't,7130,6,11,8,17,42,50,-8,41
Dunfermline,7130,7,9,13,14,46,51,-5,40
St Mirren,7130,8,10,10,16,42,54,-12,40
Ayr,7130,9,9,11,16,32,60,-28,38
Dumbarton,7130,10,8,12,16,47,60,-13,36
Hibernian,7131,1,20,11,5,61,29,32,71
Morton,7131,2,17,11,8,53,38,15,62
Falkirk,7131,3,17,10,9,62,41,21,61
Dundee Utd,7131,4,16,11,9,57,42,15,59
Queen of S't,7131,5,13,10,13,51,48,3,49
Dumbarton,7131,6,10,11,15,51,58,-7,41
Ayr,7131,7,9,12,15,37,58,-21,39
Dunfermline,7131,8,8,13,15,43,52,-9,37
Raith,7131,9,9,9,18,33,52,-19,36
St Mirren,7131,10,7,10,19,36,66,-30,31
Hibernian,7132,1,19,13,4,53,24,29,70
Morton,7132,2,19,11,6,59,37,22,68
Falkirk,7132,3,16,11,9,59,41,18,59
Dundee Utd,7132,4,14,11,11,54,44,10,53
Queen of S't,7132,5,11,11,14,46,50,-4,44
Raith,7132,6,11,9,16,35,50,-15,42
Dunfermline,7132,7,8,15,13,44,52,-8,39
St Mirren,7132,8,9,9,18,42,55,-13,36
Dumbarton,7132,9,7,14,15,46,59,-13,35
Ayr,7132,10,7,14,15,35,61,-26,35
Hibernian,7133,1,18,14,4,58,30,28,68
Morton,7133,2,18,10,8,53,38,15,64
Dundee Utd,7133,3,18,9,9,55,36,19,63
Falkirk,7133,4,15,11,10,57,45,12,56
Dunfermline,7133,5,10,14,12,49,46,3,44
Dumbarton,7133,6,11,10,15,54,58,-4,43
Queen of S't,7133,7,10,12,14,43,52,-9,42
Raith,7133,8,10,10,16,35,48,-13,40
Ayr,7133,9,8,12,16,32,58,-26,36
St Mirren,7133,10,6,10,20,35,60,-25,28
Hibernian,7134,1,17,13,6,59,29,30,64
Morton,7134,2,18,10,8,54,37,17,64
Dundee Utd,7134,3,16,10,10,50,38,12,58
Falkirk,7134,4,14,11,11,56,46,10,53
Queen of S't,7134,5,12,11,13,51,55,-4,47
Dumbarton,7134,6,11,11,14,48,54,-6,44
Dunfermline,7134,7,10,12,14,47,48,-1,42
Raith,7134,8,10,11,15,38,53,-15,41
Ayr,7134,9,9,11,16,34,55,-21,38
St Mirren,7134,10,7,12,17,38,60,-22,33
Hibernian,7135,1,17,13,6,54,28,26,64
Morton,7135,2,18,10,8,51,35,16,64
Dundee Utd,7135,3,16,10,10,55,39,16,58
Falkirk,7135,4,15,12,9,57,44,13,57
Queen of S't,7135,5,12,11,13,47,49,-2,47
Raith,7135,6,10,13,13,36,45,-9,43
Dunfermline,7135,7,9,14,13,45,51,-6,41
Dumbarton,7135,8,8,12,16,45,60,-15,36
St Mirren,7135,9,7,14,15,37,51,-14,35
Ayr,7135,10,7,13,16,34,59,-25,34
Falkirk,7136,1,19,9,8,62,41,21,66
Hibernian,7136,2,17,13,6,52,25,27,64
Morton,7136,3,15,12,9,50,41,9,57
Dundee Utd,7136,4,14,10,12,49,47,2,52
Queen of S't,7136,5,13,10,13,46,44,2,49
Dunfermline,7136,6,12,12,12,52,48,4,48
Ayr,7136,7,9,14,13,37,52,-15,41
Dumbarton,7136,8,9,11,16,46,60,-14,38
Raith,7136,9,9,11,16,34,50,-16,38
St Mirren,7136,10,6,12,18,35,55,-20,30
Hibernian,7137,1,18,13,5,56,27,29,67
Morton,7137,2,18,11,7,50,33,17,65
Falkirk,7137,3,15,13,8,58,39,19,58
Dundee Utd,7137,4,16,8,12,50,40,10,56
Dunfermline,7137,5,11,12,13,44,45,-1,45
St Mirren,7137,6,10,11,15,46,57,-11,41
Dumbarton,7137,7,9,13,14,44,54,-10,40
Ayr,7137,8,9,12,15,34,54,-20,39
Queen of S't,7137,9,9,9,18,38,53,-15,36
Raith,7137,10,8,12,16,36,54,-18,36
Hibernian,7138,1,18,11,7,51,25,26,65
Morton,7138,2,18,10,8,55,39,16,64
Dundee Utd,7138,3,17,9,10,57,42,15,60
Falkirk,7138,4,14,11,11,54,44,10,53
Ayr,7138,5,11,10,15,44,55,-11,43
Dunfermline,7138,6,9,14,13,45,52,-7,41
St Mirren,7138,7,10,11,15,42,54,-12,41
Queen of S't,7138,8,10,10,16,44,53,-9,40
Dumbarton,7138,9,9,13,14,49,60,-11,40
Raith,7138,10,9,11,16,37,54,-17,38
Hibernian,7139,1,19,13,4,60,25,35,70
Morton,7139,2,17,12,7,52,37,15,63
Dundee Utd,7139,3,17,11,8,56,37,19,62
Falkirk,7139,4,14,13,9,54,42,12,55
Queen of S't,7139,5,11,9,16,45,54,-9,42
Dunfermline,7139,6,9,14,13,45,53,-8,41
Dumbarton,7139,7,10,10,16,51,62,-11,40
Raith,7139,8,10,10,16,35,49,-14,40
St Mirren,7139,9,9,11,16,41,52,-11,38
Ayr,7139,10,7,11,18,31,59,-28,32
Hibernian,7140,1,20,13,3,58,25,33,73
Dundee Utd,7140,2,16,12,8,49,32,17,60
Morton,7140,3,16,12,8,49,36,13,60
Falkirk,7140,4,14,10,12,52,43,9,52
Dumbarton,7140,5,10,13,13,49,56,-7,43
Queen of S't,7140,6,11,9,16,45,54,-9,42
Raith,7140,7,11,9,16,36,49,-13,42
Dunfermline,7140,8,10,11,15,47,52,-5,41
St Mirren,7140,9,8,11,17,36,52,-16,35
Ayr,7140,10,7,14,15,33,55,-22,35
Hibernian,7141,1,19,12,5,57,28,29,69
Falkirk,7141,2,18,9,9,58,39,19,63
Morton,7141,3,18,9,9,51,41,10,63
Dundee Utd,7141,4,15,11,10,50,41,9,56
Raith,7141,5,12,9,15,44,47,-3,45
Dumbarton,7141,6,10,12,14,49,53,-4,42
Dunfermline,7141,7,10,11,15,45,53,-8,41
Queen of S't,7141,8,11,8,17,43,55,-12,41
St Mirren,7141,9,8,11,17,41,57,-16,35
Ayr,7141,10,6,14,16,32,56,-24,32
Hibernian,7142,1,19,12,5,55,27,28,69
Dundee Utd,7142,2,19,8,9,62,35,27,65
Morton,7142,3,17,11,8,55,36,19,62
Falkirk,7142,4,16,11,9,55,41,14,59
Queen of S't,7142,5,11,11,14,42,47,-5,44
Dumbarton,7142,6,10,12,14,49,57,-8,42
Raith,7142,7,10,10,16,33,47,-14,40
Dunfermline,7142,8,8,15,13,46,52,-6,39
Ayr,7142,9,8,11,17,31,58,-27,35
St Mirren,7142,10,7,9,20,33,61,-28,30
Hibernian,7143,1,21,10,5,66,30,36,73
Morton,7143,2,19,10,7,55,36,19,67
Dundee Utd,7143,3,15,9,12,55,47,8,54
Falkirk,7143,4,15,9,12,57,52,5,54
Queen of S't,7143,5,12,9,15,45,51,-6,45
Dumbarton,7143,6,10,13,13,51,60,-9,43
Dunfermline,7143,7,10,12,14,48,49,-1,42
St Mirren,7143,8,10,10,16,46,55,-9,40
Raith,7143,9,10,9,17,33,50,-17,39
Ayr,7143,10,6,13,17,36,62,-26,31
Hibernian,7144,1,18,14,4,53,26,27,68
Morton,7144,2,17,11,8,50,38,12,62
Dundee Utd,7144,3,16,10,10,48,43,5,58
Falkirk,7144,4,15,12,9,55,38,17,57
Queen of S't,7144,5,14,8,14,50,46,4,50
Dunfermline,7144,6,11,13,12,51,48,3,46
Raith,7144,7,10,10,16,35,46,-11,40
Dumbarton,7144,8,9,10,17,45,64,-19,37
Ayr,7144,9,8,12,16,33,53,-20,36
St Mirren,7144,10,7,10,19,46,64,-18,31
Hibernian,7145,1,18,12,6,49,25,24,66
Morton,7145,2,16,13,7,47,33,14,61
Dundee Utd,7145,3,17,10,9,51,38,13,61
Falkirk,7145,4,16,11,9,57,40,17,59
Queen of S't,7145,5,12,9,15,45,53,-8,45
Raith,7145,6,11,9,16,34,46,-12,42
Dunfermline,7145,7,9,14,13,45,47,-2,41
Dumbarton,7145,8,10,10,16,47,57,-10,40
Ayr,7145,9,9,10,17,34,55,-21,37
St Mirren,7145,10,8,10,18,39,54,-15,34
Hibernian,7146,1,20,12,4,65,21,44,72
Falkirk,7146,2,18,10,8,62,41,21,64
Morton,7146,3,17,12,7,49,36,13,63
Dundee Utd,7146,4,15,11,10,51,43,8,56
Dunfermline,7146,5,11,12,13,50,52,-2,45
Queen of S't,7146,6,12,8,16,42,50,-8,44
Dumbarton,7146,7,8,13,15,46,56,-10,37
Raith,7146,8,8,11,17,34,52,-18,35
St Mirren,7146,9,7,13,16,41,60,-19,34
Ayr,7146,10,7,12,17,34,63,-29,33
Hibernian,7147,1,20,12,4,62,26,36,72
Falkirk,7147,2,16,11,9,57,38,19,59
Morton,7147,3,16,11,9,54,47,7,59
Dundee Utd,7147,4,15,10,11,49,41,8,55
Dunfermline,7147,5,12,13,11,53,46,7,49
Queen of S't,7147,6,13,8,15,44,48,-4,47
St Mirren,7147,7,10,11,15,44,56,-12,41
Ayr,7147,8,9,10,17,35,56,-21,37
Dumbarton,7147,9,8,10,18,45,65,-20,34
Raith,7147,10,8,10,18,34,54,-20,34
Hibernian,7148,1,20,12,4,56,23,33,72
Morton,7148,2,20,11,5,49,29,20,71
Falkirk,7148,3,17,10,9,59,40,19,61
Dundee Utd,7148,4,16,8,12,49,38,11,56
Queen of S't,7148,5,13,10,13,49,49,0,49
Dumbarton,7148,6,10,12,14,51,59,-8,42
Raith,7148,7,11,8,17,36,50,-14,41
St Mirren,7148,8,8,10,18,40,56,-16,34
Dunfermline,7148,9,7,11,18,39,58,-19,32
Ayr,7148,10,7,10,19,30,56,-26,31
Hibernian,7149,1,18,14,4,59,30,29,68
Falkirk,7149,2,17,11,8,59,41,18,62
Morton,7149,3,16,13,7,53,37,16,61
Dundee Utd,7149,4,14,13,9,49,39,10,55
Ayr,7149,5,10,13,13,39,56,-17,43
Queen of S't,7149,6,10,12,14,47,54,-7,42
Dunfermline,7149,7,9,13,14,49,53,-4,40
St Mirren,7149,8,9,10,17,40,53,-13,37
Raith,7149,9,9,10,17,32,49,-17,37
Dumbarton,7149,10,7,13,16,44,59,-15,34
Hibernian,7150,1,20,13,3,56,24,32,73
Morton,7150,2,17,12,7,50,32,18,63
Falkirk,7150,3,15,13,8,59,42,17,58
Dundee Utd,7150,4,15,10,11,52,45,7,55
Queen of S't,7150,5,11,10,15,43,51,-8,43
Dumbarton,7150,6,10,11,15,50,58,-8,41
Raith,7150,7,10,10,16,35,50,-15,40
Ayr,7150,8,8,14,14,33,51,-18,38
Dunfermline,7150,9,8,12,16,40,47,-7,36
St Mirren,7150,10,8,11,17,43,61,-18,35
Hibernian,7151,1,17,13,6,53,28,25,64
Morton,7151,2,18,10,8,54,40,14,64
Dundee Utd,7151,3,18,9,9,56,37,19,63
Falkirk,7151,4,15,13,8,58,42,16,58
Queen of S't,7151,5,12,10,14,48,50,-2,46
Raith,7151,6,10,11,15,39,51,-12,41
Dunfermline,7151,7,9,12,15,44,53,-9,39
Dumbarton,7151,8,9,11,16,45,57,-12,38
St Mirren,7151,9,9,9,18,41,58,-17,36
Ayr,7151,10,8,12,16,34,56,-22,36
Hibernian,7152,1,19,12,5,54,23,31,69
Dundee Utd,7152,2,17,8,11,54,41,13,59
Falkirk,7152,3,16,9,11,56,41,15,57
Morton,7152,4,15,10,11,45,40,5,55
Dumbarton,7152,5,11,11,14,47,52,-5,44
Ayr,7152,6,11,10,15,37,53,-16,43
Dunfermline,7152,7,10,12,14,43,45,-2,42
Queen of S't,7152,8,11,9,16,42,55,-13,42
St Mirren,7152,9,10,10,16,44,55,-11,40
Raith,7152,10,10,9,17,34,51,-17,39
Hibernian,7153,1,19,13,4,56,24,32,70
Falkirk,7153,2,17,9,10,57,40,17,60
Dundee Utd,7153,3,15,12,9,52,39,13,57
Morton,7153,4,14,13,9,49,38,11,55
Raith,7153,5,12,9,15,35,47,-12,45
Dumbarton,7153,6,10,13,13,47,53,-6,43
Dunfermline,7153,7,10,12,14,44,48,-4,42
Queen of S't,7153,8,10,11,15,42,49,-7,41
St Mirren,7153,9,9,10,17,42,55,-13,37
Ayr,7153,10,6,14,16,31,62,-31,32
Hibernian,7154,1,20,12,4,55,24,31,72
Falkirk,7154,2,17,11,8,63,39,24,62
Morton,7154,3,15,13,8,44,34,10,58
Dundee Utd,7154,4,15,9,12,52,46,6,54
Queen of S't,7154,5,12,9,15,42,49,-7,45
Dunfermline,7154,6,9,15,12,48,52,-4,42
Ayr,7154,7,9,14,13,33,48,-15,41
Raith,7154,8,9,11,16,37,50,-13,38
St Mirren,7154,9,9,9,18,40,57,-17,36
Dumbarton,7154,10,8,11,17,45,60,-15,35
Hibernian,7155,1,21,12,3,58,23,35,75
Morton,7155,2,18,11,7,54,35,19,65
Falkirk,7155,3,16,11,9,58,42,16,59
Dundee Utd,7155,4,15,10,11,49,44,5,55
Raith,7155,5,11,11,14,39,47,-8,44
Dunfermline,7155,6,10,13,13,45,46,-1,43
Queen of S't,7155,7,11,9,16,43,53,-10,42
Dumbarton,7155,8,9,12,15,48,56,-8,39
Ayr,7155,9,7,11,18,35,62,-27,32
St Mirren,7155,10,7,10,19,39,60,-21,31
Hibernian,7156,1,20,12,4,57,23,34,72
Morton,7156,2,19,10,7,55,36,19,67
Falkirk,7156,3,16,11,9,60,42,18,59
Dundee Utd,7156,4,15,10,11,46,37,9,55
Queen of S't,7156,5,11,11,14,47,50,-3,44
Dunfermline,7156,6,10,12,14,44,48,-4,42
Raith,7156,7,10,9,17,36,53,-17,39
Dumbarton,7156,8,9,11,16,49,62,-13,38
St Mirren,7156,9,8,12,16,41,59,-18,36
Ayr,7156,10,7,12,17,31,56,-25,33
Hibernian,7157,1,20,12,4,51,21,30,72
Dundee Utd,7157,2,18,9,9,55,39,16,63
Morton,7157,3,16,13,7,51,36,15,61
Falkirk,7157,4,16,9,11,55,41,14,57
Queen of S't,7157,5,12,9,15,47,51,-4,45
Dumbarton,7157,6,10,12,14,48,54,-6,42
Dunfermline,7157,7,9,13,14,42,49,-7,40
Raith,7157,8,10,8,18,32,47,-15,38
St Mirren,7157,9,9,10,17,36,53,-17,37
Ayr,7157,10,7,11,18,32,58,-26,32
Hibernian,7158,1,19,13,4,53,23,30,70
Morton,7158,2,18,11,7,52,32,20,65
Falkirk,7158,3,15,11,10,61,40,21,56
Dundee Utd,7158,4,14,9,13,46,48,-2,51
Dunfermline,7158,5,11,14,11,50,49,1,47
Queen of S't,7158,6,11,9,16,50,57,-7,42
Ayr,7158,7,10,11,15,34,55,-21,41
Raith,7158,8,10,10,16,34,48,-14,40
Dumbarton,7158,9,9,11,16,46,58,-12,38
St Mirren,7158,10,8,11,17,38,54,-16,35
Hibernian,7159,1,20,11,5,58,28,30,71
Dundee Utd,7159,2,19,9,8,59,41,18,66
Morton,7159,3,16,12,8,47,32,15,60
Falkirk,7159,4,15,11,10,55,41,14,56
Queen of S't,7159,5,13,9,14,49,48,1,48
Raith,7159,6,12,8,16,37,49,-12,44
Dumbarton,7159,7,9,12,15,45,57,-12,39
Dunfermline,7159,8,8,13,15,41,51,-10,37
Ayr,7159,9,8,10,18,35,58,-23,34
St Mirren,7159,10,7,11,18,36,57,-21,32
Hibernian,7160,1,18,13,5,56,26,30,67
Morton,7160,2,16,14,6,50,33,17,62
Dundee Utd,7160,3,17,9,10,57,39,18,60
Falkirk,7160,4,16,9,11,60,50,10,57
Queen of S't,7160,5,13,11,12,47,47,0,50
Dunfermline,7160,6,11,13,12,48,46,2,46
Dumbarton,7160,7,9,11,16,47,62,-15,38
Ayr,7160,8,8,12,16,32,58,-26,36
Raith,7160,9,8,11,17,32,50,-18,35
St Mirren,7160,10,7,11,18,42,60,-18,32
Hibernian,7161,1,20,12,4,56,24,32,72
Dundee Utd,7161,2,16,11,9,54,38,16,59
Falkirk,7161,3,15,12,9,56,44,12,57
Morton,7161,4,15,12,9,48,40,8,57
Queen of S't,7161,5,13,8,15,51,49,2,47
Dunfermline,7161,6,9,13,14,50,52,-2,40
Raith,7161,7,10,10,16,34,47,-13,40
St Mirren,7161,8,9,11,16,45,59,-14,38
Dumbarton,7161,9,9,11,16,48,64,-16,38
Ayr,7161,10,8,12,16,35,60,-25,36
Hibernian,7162,1,17,13,6,54,28,26,64
Morton,7162,2,17,13,6,51,36,15,64
Falkirk,7162,3,17,9,10,61,42,19,60
Dundee Utd,7162,4,17,9,10,48,36,12,60
Raith,7162,5,11,9,16,35,50,-15,42
Dunfermline,7162,6,9,13,14,43,48,-5,40
St Mirren,7162,7,10,10,16,41,52,-11,40
Ayr,7162,8,10,10,16,35,53,-18,40
Queen of S't,7162,9,10,9,17,43,56,-13,39
Dumbarton,7162,10,9,11,16,50,60,-10,38
Hibernian,7163,1,21,12,3,57,22,35,75
Morton,7163,2,17,11,8,54,39,15,62
Dundee Utd,7163,3,17,10,9,53,39,14,61
Falkirk,7163,4,16,10,10,56,44,12,58
Raith,7163,5,13,8,15,37,47,-10,47
Queen of S't,7163,6,12,10,14,44,48,-4,46
Dunfermline,7163,7,9,13,14,48,50,-2,40
Dumbarton,7163,8,9,12,15,53,59,-6,39
St Mirren,7163,9,7,10,19,38,60,-22,31
Ayr,7163,10,6,10,20,28,60,-32,28
Hibernian,7164,1,21,11,4,54,24,30,74
Falkirk,7164,2,17,10,9,60,39,21,61
Morton,7164,3,15,11,10,46,38,8,56
Dundee Utd,7164,4,13,9,14,41,40,1,48
Queen of S't,7164,5,12,11,13,47,48,-1,47
Dunfermline,7164,6,11,12,13,49,51,-2,45
Raith,7164,7,10,12,14,38,52,-14,42
Dumbarton,7164,8,9,11,16,45,56,-11,38
Ayr,7164,9,8,14,14,38,54,-16,38
St Mirren,7164,10,8,11,17,36,52,-16,35
Morton,7165,1,20,11,5,56,30,26,71
Hibernian,7165,2,18,13,5,53,25,28,67
Falkirk,7165,3,17,12,7,57,36,21,63
Dundee Utd,7165,4,15,11,10,46,38,8,56
Queen of S't,7165,5,13,8,15,46,46,0,47
Dunfermline,7165,6,9,14,13,43,47,-4,41
Raith,7165,7,10,10,16,34,49,-15,40
Dumbarton,7165,8,8,12,16,44,59,-15,36
Ayr,7165,9,6,14,16,29,53,-24,32
St Mirren,7165,10,6,11,19,33,58,-25,29
Hibernian,7166,1,20,11,5,65,26,39,71
Morton,7166,2,16,13,7,47,32,15,61
Dundee Utd,7166,3,17,9,10,53,38,15,60
Falkirk,7166,4,17,9,10,61,48,13,60
Raith,7166,5,11,10,15,38,55,-17,43
Dunfermline,7166,6,9,14,13,44,49,-5,41
Queen of S't,7166,7,10,10,16,45,54,-9,40
Dumbarton,7166,8,9,11,16,52,59,-7,38
St Mirren,7166,9,9,10,17,42,57,-15,37
Ayr,7166,10,7,13,16,31,60,-29,34
Hibernian,7167,1,20,12,4,53,22,31,72
Morton,7167,2,17,13,6,52,35,17,64
Falkirk,7167,3,17,10,9,59,37,22,61
Dundee Utd,7167,4,14,11,11,49,44,5,53
Queen of S't,7167,5,13,9,14,51,51,0,48
Dumbarton,7167,6,9,14,13,50,58,-8,41
Raith,7167,7,11,8,17,35,49,-14,41
Dunfermline,7167,8,9,12,15,43,52,-9,39
St Mirren,7167,9,8,9,19,35,56,-21,33
Ayr,7167,10,6,14,16,35,58,-23,32
Hibernian,7168,1,20,10,6,57,31,26,70
Morton,7168,2,19,10,7,59,38,21,67
Falkirk,7168,3,16,11,9,61,42,19,59
Dundee Utd,7168,4,15,11,10,47,38,9,56
Queen of S't,7168,5,12,8,16,44,49,-5,44
Dunfermline,7168,6,10,12,14,45,51,-6,42
Raith,7168,7,11,8,17,38,52,-14,41
Dumbarton,7168,8,10,10,16,48,56,-8,40
St Mirren,7168,9,9,9,18,40,61,-21,36
Ayr,7168,10,8,11,17,36,57,-21,35
Hibernian,7169,1,20,12,4,57,24,33,72
Dundee Utd,7169,2,16,11,9,49,38,11,59
Falkirk,7169,3,15,11,10,57,40,17,56
Morton,7169,4,14,13,9,46,34,12,55
Dunfermline,7169,5,11,12,13,47,49,-2,45
Queen of S't,7169,6,11,11,14,46,50,-4,44
Dumbarton,7169,7,10,12,14,49,57,-8,42
St Mirren,7169,8,9,11,16,44,57,-13,38
Raith,7169,9,9,10,17,31,53,-22,37
Ayr,7169,10,6,15,15,28,52,-24,33
Hibernian,7170,1,20,13,3,57,21,36,73
Dundee Utd,7170,2,17,11,8,54,36,18,62
Morton,7170,3,17,11,8,53,40,13,62
Falkirk,7170,4,17,10,9,58,37,21,61
Queen of S't,7170,5,11,10,15,46,51,-5,43
Dunfermline,7170,6,9,13,14,45,52,-7,40
Ayr,7170,7,9,13,14,34,52,-18,40
Raith,7170,8,9,9,18,32,55,-23,36
St Mirren,7170,9,8,10,18,36,56,-20,34
Dumbarton,7170,10,7,12,17,45,60,-15,33
Hibernian,7171,1,19,13,4,57,25,32,70
Dundee Utd,7171,2,18,9,9,54,37,17,63
Morton,7171,3,16,11,9,48,38,10,59
Falkirk,7171,4,14,10,12,54,45,9,52
Dumbarton,7171,5,11,12,13,50,52,-2,45
Queen of S't,7171,6,12,9,15,43,49,-6,45
Dunfermline,7171,7,11,11,14,48,50,-2,44
Raith,7171,8,11,8,17,33,52,-19,41
Ayr,7171,9,7,14,15,36,56,-20,35
St Mirren,7171,10,7,11,18,38,57,-19,32
Hibernian,7172,1,19,12,5,57,27,30,69
Dundee Utd,7172,2,17,9,10,54,45,9,60
Falkirk,7172,3,16,9,11,61,44,17,57
Morton,7172,4,15,12,9,54,47,7,57
Queen of S't,7172,5,13,8,15,48,51,-3,47
Dunfermline,7172,6,10,13,13,48,48,0,43
Dumbarton,7172,7,10,11,15,48,58,-10,41
Ayr,7172,8,9,12,15,41,56,-15,39
Raith,7172,9,10,9,17,35,54,-19,39
St Mirren,7172,10,8,11,17,39,55,-16,35
Hibernian,7173,1,19,13,4,56,25,31,70
Morton,7173,2,17,12,7,50,36,14,63
Dundee Utd,7173,3,17,10,9,54,37,17,61
Falkirk,7173,4,16,11,9,59,38,21,59
Queen of S't,7173,5,12,9,15,43,50,-7,45
Dunfermline,7173,6,10,13,13,45,53,-8,43
St Mirren,7173,7,10,9,17,40,56,-16,39
Ayr,7173,8,9,11,16,34,51,-17,38
Raith,7173,9,8,11,17,33,50,-17,35
Dumbarton,7173,10,7,11,18,42,60,-18,32
Hibernian,7174,1,20,12,4,54,23,31,72
Morton,7174,2,18,12,6,51,33,18,66
Dundee Utd,7174,3,17,10,9,50,39,11,61
Falkirk,7174,4,16,10,10,55,40,15,58
Dunfermline,7174,5,13,11,12,52,42,10,50
Queen of S't,7174,6,11,8,17,39,54,-15,41
Ayr,7174,7,9,12,15,45,54,-9,39
Raith,7174,8,9,10,17,33,50,-17,37
St Mirren,7174,9,8,9,19,41,64,-23,33
Dumbarton,7174,10,7,10,19,42,63,-21,31
Morton,7175,1,19,10,7,50,34,16,67
Hibernian,7175,2,18,12,6,56,29,27,66
Dundee Utd,7175,3,17,11,8,51,36,15,62
Falkirk,7175,4,17,10,9,58,39,19,61
Queen of S't,7175,5,12,9,15,51,54,-3,45
Dunfermline,7175,6,10,12,14,42,47,-5,42
Ayr,7175,7,10,10,16,34,54,-20,40
Dumbarton,7175,8,8,12,16,46,57,-11,36
Raith,7175,9,9,9,18,33,53,-20,36
St Mirren,7175,10,7,11,18,42,60,-18,32
Hibernian,7176,1,19,11,6,51,24,27,68
Morton,7176,2,17,10,9,47,34,13,61
Dundee Utd,7176,3,17,9,10,53,40,13,60
Falkirk,7176,4,16,11,9,59,43,16,59
Ayr,7176,5,10,13,13,37,50,-13,43
St Mirren,7176,6,11,9,16,44,52,-8,42
Dunfermline,7176,7,10,11,15,46,52,-6,41
Queen of S't,7176,8,10,10,16,40,51,-11,40
Raith,7176,9,9,10,17,33,51,-18,37
Dumbarton,7176,10,8,12,16,45,58,-13,36
Hibernian,7177,1,18,12,6,53,28,25,66
Falkirk,7177,2,18,9,9,63,35,28,63
Dundee Utd,7177,3,15,9,12,47,41,6,54
Morton,7177,4,14,11,11,48,45,3,53
Dunfermline,7177,5,12,12,12,51,48,3,48
Queen of S't,7177,6,12,9,15,42,49,-7,45
Raith,7177,7,12,8,16,38,54,-16,44
St Mirren,7177,8,11,9,16,43,52,-9,42
Dumbarton,7177,9,9,11,16,47,60,-13,38
Ayr,7177,10,8,12,16,39,59,-20,36
Morton,7178,1,19,10,7,51,38,13,67
Hibernian,7178,2,18,11,7,51,31,20,65
Dundee Utd,7178,3,16,11,9,59,42,17,59
Falkirk,7178,4,15,12,9,63,41,22,57
Dumbarton,7178,5,11,10,15,49,58,-9,43
Dunfermline,7178,6,10,12,14,53,51,2,42
Queen of S't,7178,7,11,9,16,45,59,-14,42
Raith,7178,8,10,10,16,34,44,-10,40
Ayr,7178,9,8,12,16,33,52,-19,36
St Mirren,7178,10,8,11,17,41,63,-22,35
Hibernian,7179,1,19,11,6,60,30,30,68
Falkirk,7179,2,18,11,7,60,37,23,65
Morton,7179,3,17,11,8,54,38,16,62
Dundee Utd,7179,4,15,11,10,50,38,12,56
Dunfermline,7179,5,10,13,13,47,50,-3,43
Queen of S't,7179,6,11,10,15,46,54,-8,43
Raith,7179,7,10,9,17,32,49,-17,39
Ayr,7179,8,9,12,15,34,55,-21,39
Dumbarton,7179,9,8,11,17,48,63,-15,35
St Mirren,7179,10,7,13,16,40,57,-17,34
Hibernian,7180,1,17,14,5,56,30,26,65
Morton,7180,2,17,11,8,50,38,12,62
Falkirk,7180,3,17,10,9,62,39,23,61
Dundee Utd,7180,4,14,10,12,47,42,5,52
Queen of S't,7180,5,12,11,13,44,48,-4,47
Dunfermline,7180,6,11,13,12,48,47,1,46
Dumbarton,7180,7,9,14,13,47,54,-7,41
Ayr,7180,8,8,14,14,34,52,-18,38
St Mirren,7180,9,8,11,17,38,56,-18,35
Raith,7180,10,8,10,18,33,53,-20,34
Falkirk,7181,1,19,9,8,63,36,27,66
Hibernian,7181,2,18,10,8,57,33,24,64
Morton,7181,3,16,14,6,49,34,15,62
Dundee Utd,7181,4,15,10,11,50,46,4,55
Queen of S't,7181,5,12,10,14,45,52,-7,46
Dunfermline,7181,6,10,12,14,48,50,-2,42
St Mirren,7181,7,10,11,15,43,52,-9,41
Raith,7181,8,9,10,17,37,56,-19,37
Dumbarton,7181,9,8,12,16,43,55,-12,36
Ayr,7181,10,8,12,16,34,55,-21,36
Hibernian,7182,1,17,14,5,54,29,25,65
Morton,7182,2,18,10,8,55,34,21,64
Falkirk,7182,3,17,9,10,56,39,17,60
Dundee Utd,7182,4,17,9,10,54,41,13,60
Dunfermline,7182,5,10,13,13,50,50,0,43
Dumbarton,7182,6,10,12,14,53,60,-7,42
Queen of S't,7182,7,11,9,16,46,58,-12,42
Raith,7182,8,9,12,15,35,51,-16,39
Ayr,7182,9,8,12,16,39,62,-23,36
St Mirren,7182,10,8,10,18,39,57,-18,34
Hibernian,7183,1,18,13,5,54,23,31,67
Morton,7183,2,18,13,5,52,30,22,67
Dundee Utd,7183,3,15,11,10,50,40,10,56
Falkirk,7183,4,14,12,10,55,45,10,54
Queen of S't,7183,5,12,9,15,46,49,-3,45
Dunfermline,7183,6,9,15,12,43,46,-3,42
Ayr,7183,7,10,11,15,32,53,-21,41
Dumbarton,7183,8,10,10,16,46,59,-13,40
St Mirren,7183,9,8,12,16,40,53,-13,36
Raith,7183,10,9,8,19,31,51,-20,35
Hibernian,7184,1,20,11,5,61,23,38,71
Falkirk,7184,2,18,10,8,60,39,21,64
Morton,7184,3,17,11,8,51,39,12,62
Queen of S't,7184,4,13,10,13,53,49,4,49
Dundee Utd,7184,5,13,9,14,46,45,1,48
Dunfermline,7184,6,11,13,12,47,53,-6,46
Dumbarton,7184,7,9,12,15,51,58,-7,39
Ayr,7184,8,8,14,14,36,55,-19,38
Raith,7184,9,9,10,17,36,56,-20,37
St Mirren,7184,10,7,10,19,36,60,-24,31
Hibernian,7185,1,18,12,6,49,23,26,66
Dundee Utd,7185,2,16,12,8,49,36,13,60
Morton,7185,3,16,12,8,48,37,11,60
Falkirk,7185,4,16,10,10,59,39,20,58
Queen of S't,7185,5,13,10,13,49,51,-2,49
Ayr,7185,6,8,15,13,36,53,-17,39
St Mirren,7185,7,9,11,16,42,55,-13,38
Raith,7185,8,9,11,16,30,47,-17,38
Dunfermline,7185,9,8,13,15,44,52,-8,37
Dumbarton,7185,10,8,12,16,48,61,-13,36
Hibernian,7186,1,20,13,3,59,25,34,73
Falkirk,7186,2,16,12,8,58,37,21,60
Morton,7186,3,15,12,9,48,41,7,57
Dundee Utd,7186,4,15,10,11,50,42,8,55
Raith,7186,5,12,9,15,37,47,-10,45
Queen of S't,7186,6,12,8,16,49,52,-3,44
Dunfermline,7186,7,9,16,11,47,47,0,43
St Mirren,7186,8,9,10,17,37,52,-15,37
Ayr,7186,9,8,11,17,34,62,-28,35
Dumbarton,7186,10,7,13,16,43,57,-14,34
Hibernian,7187,1,20,12,4,57,26,31,72
Morton,7187,2,18,9,9,57,38,19,63
Dundee Utd,7187,3,16,11,9,55,42,13,59
Falkirk,7187,4,13,12,11,53,42,11,51
Queen of S't,7187,5,11,10,15,50,51,-1,43
Raith,7187,6,11,10,15,38,48,-10,43
Dunfermline,7187,7,9,14,13,44,49,-5,41
Dumbarton,7187,8,10,11,15,46,57,-11,41
St Mirren,7187,9,10,10,16,43,55,-12,40
Ayr,7187,10,6,13,17,33,68,-35,31
Hibernian,7188,1,19,11,6,58,32,26,68
Falkirk,7188,2,17,10,9,65,41,24,61
Morton,7188,3,17,10,9,49,40,9,61
Dundee Utd,7188,4,16,9,11,49,38,11,57
Queen of S't,7188,5,13,8,15,45,49,-4,47
Dumbarton,7188,6,10,14,12,50,51,-1,44
Dunfermline,7188,7,9,16,11,46,48,-2,43
Ayr,7188,8,9,11,16,34,54,-20,38
Raith,7188,9,9,10,17,33,50,-17,37
St Mirren,7188,10,6,11,19,33,59,-26,29
Hibernian,7189,1,19,10,7,58,31,27,67
Falkirk,7189,2,17,11,8,65,43,22,62
Morton,7189,3,17,11,8,52,37,15,62
Dundee Utd,7189,4,16,10,10,50,41,9,58
Queen of S't,7189,5,12,8,16,41,55,-14,44
Dunfermline,7189,6,9,15,12,44,45,-1,42
Dumbarton,7189,7,10,11,15,45,54,-9,41
St Mirren,7189,8,10,9,17,47,56,-9,39
Raith,7189,9,10,9,17,38,53,-15,39
Ayr,7189,10,8,10,18,34,59,-25,34
Hibernian,7190,1,18,13,5,53,26,27,67
Morton,7190,2,18,12,6,54,36,18,66
Falkirk,7190,3,18,11,7,64,40,24,65
Dundee Utd,7190,4,15,10,11,53,44,9,55
Queen of S't,7190,5,11,12,13,47,50,-3,45
Ayr,7190,6,10,12,14,36,51,-15,42
Dumbarton,7190,7,9,12,15,49,60,-11,39
Dunfermline,7190,8,8,13,15,46,55,-9,37
Raith,7190,9,8,13,15,32,46,-14,37
St Mirren,7190,10,6,10,20,38,64,-26,28
Hibernian,7191,1,22,10,4,64,24,40,76
Dundee Utd,7191,2,16,8,12,48,37,11,56
Falkirk,7191,3,15,10,11,59,43,16,55
Morton,7191,4,15,10,11,46,44,2,55
Queen of S't,7191,5,14,8,14,47,47,0,50
Dunfermline,7191,6,10,11,15,44,49,-5,41
Dumbarton,7191,7,10,11,15,48,61,-13,41
Ayr,7191,8,10,11,15,34,53,-19,41
St Mirren,7191,9,10,9,17,41,55,-14,39
Raith,7191,10,9,10,17,32,50,-18,37
Hibernian,7192,1,18,13,5,56,25,31,67
Morton,7192,2,18,12,6,51,32,19,66
Dundee Utd,7192,3,16,10,10,51,41,10,58
Falkirk,7192,4,15,12,9,55,42,13,57
Dumbarton,7192,5,11,11,14,52,55,-3,44
Raith,7192,6,11,11,14,36,45,-9,44
Dunfermline,7192,7,9,13,14,46,52,-6,40
Queen of S't,7192,8,10,9,17,45,52,-7,39
St Mirren,7192,9,8,11,17,36,57,-21,35
Ayr,7192,10,8,10,18,31,58,-27,34
Hibernian,7193,1,19,14,3,53,22,31,71
Dundee Utd,7193,2,17,10,9,56,46,10,61
Morton,7193,3,15,12,9,47,38,9,57
Falkirk,7193,4,14,10,12,59,48,11,52
Dumbarton,7193,5,12,11,13,54,56,-2,47
Queen of S't,7193,6,11,9,16,46,53,-7,42
Dunfermline,7193,7,9,14,13,41,48,-7,41
Raith,7193,8,10,10,16,33,48,-15,40
St Mirren,7193,9,9,10,17,44,56,-12,37
Ayr,7193,10,8,12,16,34,52,-18,36
Hibernian,7194,1,18,13,5,56,32,24,67
Morton,7194,2,17,12,7,51,38,13,63
Falkirk,7194,3,17,10,9,64,43,21,61
Dundee Utd,7194,4,16,10,10,54,39,15,58
Dunfermline,7194,5,12,12,12,58,55,3,48
Raith,7194,6,10,11,15,38,50,-12,41
Queen of S't,7194,7,9,12,15,44,57,-13,39
Dumbarton,7194,8,9,11,16,50,61,-11,38
St Mirren,7194,9,9,10,17,42,55,-13,37
Ayr,7194,10,6,13,17,29,56,-27,31
Hibernian,7195,1,19,14,3,55,21,34,71
Morton,7195,2,18,12,6,53,32,21,66
Falkirk,7195,3,18,10,8,62,37,25,64
Dundee Utd,7195,4,13,14,9,48,40,8,53
Dunfermline,7195,5,11,12,13,47,50,-3,45
Queen of S't,7195,6,10,10,16,42,53,-11,40
Raith,7195,7,9,10,17,35,53,-18,37
Ayr,7195,8,7,15,14,32,51,-19,36
Dumbarton,7195,9,8,11,17,47,64,-17,35
St Mirren,7195,10,7,12,17,39,59,-20,33
Hibernian,7196,1,20,11,5,62,34,28,71
Morton,7196,2,16,11,9,51,41,10,59
Falkirk,7196,3,16,10,10,62,43,19,58
Dundee Utd,7196,4,15,13,8,49,39,10,58
Dunfermline,7196,5,10,14,12,49,50,-1,44
Queen of S't,7196,6,12,8,16,48,53,-5,44
Dumbarton,7196,7,10,12,14,49,59,-10,42
St Mirren,7196,8,8,12,16,43,58,-15,36
Ayr,7196,9,7,14,15,38,56,-18,35
Raith,7196,10,8,11,17,33,51,-18,35
Hibernian,7197,1,20,11,5,56,27,29,71
Falkirk,7197,2,18,9,9,60,39,21,63
Morton,7197,3,17,12,7,51,34,17,63
Dundee Utd,7197,4,16,9,11,47,39,8,57
Queen of S't,7197,5,12,8,16,47,50,-3,44
Raith,7197,6,11,10,15,35,49,-14,43
Dunfermline,7197,7,10,12,14,48,50,-2,42
St Mirren,7197,8,9,9,18,45,57,-12,36
Ayr,7197,9,8,12,16,34,54,-20,36
Dumbarton,7197,10,7,12,17,39,63,-24,33
Hibernian,7198,1,20,12,4,59,26,33,72
Falkirk,7198,2,17,9,10,61,44,17,60
Morton,7198,3,16,12,8,46,36,10,60
Dundee Utd,7198,4,15,9,12,52,44,8,54
Dunfermline,7198,5,12,14,10,54,45,9,50
Queen of S't,7198,6,12,9,15,47,54,-7,45
Raith,7198,7,10,9,17,36,54,-18,39
Ayr,7198,8,9,10,17,36,57,-21,37
St Mirren,7198,9,9,9,18,40,58,-18,36
Dumbarton,7198,10,8,11,17,48,61,-13,35
Morton,7199,1,18,11,7,50,36,14,65
Falkirk,7199,2,17,11,8,63,43,20,62
Hibernian,7199,3,16,11,9,50,31,19,59
Dundee Utd,7199,4,16,8,12,53,43,10,56
Raith,7199,5,13,9,14,41,46,-5,48
Dunfermline,7199,6,10,12,14,49,48,1,42
Queen of S't,7199,7,10,11,15,45,56,-11,41
Dumbarton,7199,8,9,12,15,50,60,-10,39
St Mirren,7199,9,10,9,17,38,54,-16,39
Ayr,7199,10,8,12,16,35,57,-22,36
Hibernian,7200,1,19,11,6,56,29,27,68
Morton,7200,2,17,13,6,54,38,16,64
Dundee Utd,7200,3,16,9,11,50,40,10,57
Falkirk,7200,4,15,11,10,53,40,13,56
Queen of S't,7200,5,13,8,15,48,51,-3,47
Dumbarton,7200,6,11,12,13,47,51,-4,45
Dunfermline,7200,7,10,14,12,47,47,0,44
Raith,7200,8,9,11,16,43,57,-14,38
Ayr,7200,9,7,13,16,37,60,-23,34
St Mirren,7200,10,7,10,19,38,60,-22,31
Hibernian,7201,1,20,12,4,63,29,34,72
Falkirk,7201,2,15,12,9,56,43,13,57
Dundee Utd,7201,3,15,10,11,51,41,10,55
Morton,7201,4,14,13,9,45,37,8,55
Dunfermline,7201,5,11,12,13,47,52,-5,45
Queen of S't,7201,6,11,11,14,44,49,-5,44
Dumbarton,7201,7,9,15,12,46,51,-5,42
Raith,7201,8,9,12,15,37,49,-12,39
St Mirren,7201,9,8,12,16,37,52,-15,36
Ayr,7201,10,7,13,16,34,57,-23,34
Hibernian,7202,1,20,11,5,54,26,28,71
Falkirk,7202,2,18,9,9,61,39,22,63
Morton,7202,3,16,12,8,48,36,12,60
Dundee Utd,7202,4,13,11,12,45,42,3,50
Raith,7202,5,12,10,14,40,47,-7,46
Queen of S't,7202,6,12,9,15,44,52,-8,45
Dunfermline,7202,7,9,13,14,43,47,-4,40
Dumbarton,7202,8,9,11,16,43,55,-12,38
Ayr,7202,9,7,15,14,35,55,-20,36
St Mirren,7202,10,8,11,17,40,54,-14,35
Hibernian,7203,1,20,11,5,67,32,35,71
Morton,7203,2,18,10,8,50,36,14,64
Falkirk,7203,3,16,13,7,56,37,19,61
Dundee Utd,7203,4,14,11,11,49,46,3,53
Dunfermline,7203,5,11,13,12,50,47,3,46
Queen of S't,7203,6,11,9,16,45,54,-9,42
Dumbarton,7203,7,9,12,15,48,57,-9,39
Raith,7203,8,9,11,16,33,49,-16,38
Ayr,7203,9,8,13,15,36,57,-21,37
St Mirren,7203,10,6,13,17,40,59,-19,31
Hibernian,7204,1,19,12,5,54,26,28,69
Falkirk,7204,2,16,11,9,58,41,17,59
Dundee Utd,7204,3,17,8,11,57,41,16,59
Morton,7204,4,15,13,8,47,37,10,58
Queen of S't,7204,5,12,11,13,45,47,-2,47
Ayr,7204,6,10,12,14,37,50,-13,42
Dunfermline,7204,7,9,13,14,42,52,-10,40
Raith,7204,8,9,13,14,32,44,-12,40
Dumbarton,7204,9,9,11,16,48,57,-9,38
St Mirren,7204,10,7,10,19,36,61,-25,31
Hibernian,7205,1,19,13,4,60,30,30,70
Morton,7205,2,16,11,9,52,38,14,59
Dundee Utd,7205,3,17,8,11,51,37,14,59
Falkirk,7205,4,15,11,10,60,46,14,56
Raith,7205,5,11,11,14,38,46,-8,44
Dunfermline,7205,6,9,14,13,44,48,-4,41
Dumbarton,7205,7,10,11,15,47,58,-11,41
Queen of S't,7205,8,10,10,16,41,53,-12,40
St Mirren,7205,9,10,9,17,43,56,-13,39
Ayr,7205,10,9,10,17,34,58,-24,37
Hibernian,7206,1,19,12,5,53,24,29,69
Falkirk,7206,2,17,9,10,61,41,20,60
Dundee Utd,7206,3,16,9,11,50,44,6,57
Morton,7206,4,15,11,10,50,40,10,56
Queen of S't,7206,5,12,9,15,46,53,-7,45
St Mirren,7206,6,10,11,15,41,54,-13,41
Dumbarton,7206,7,10,10,16,51,58,-7,40
Dunfermline,7206,8,9,13,14,45,53,-8,40
Raith,7206,9,10,10,16,39,51,-12,40
Ayr,7206,10,9,12,15,38,56,-18,39
Hibernian,7207,1,19,12,5,55,25,30,69
Falkirk,7207,2,17,12,7,61,37,24,63
Dundee Utd,7207,3,16,10,10,54,38,16,58
Morton,7207,4,14,11,11,43,42,1,53
Dumbarton,7207,5,11,11,14,49,56,-7,44
Dunfermline,7207,6,10,13,13,50,50,0,43
Queen of S't,7207,7,11,10,15,40,51,-11,43
Raith,7207,8,9,11,16,33,49,-16,38
Ayr,7207,9,8,13,15,33,52,-19,37
St Mirren,7207,10,9,9,18,40,58,-18,36
Hibernian,7208,1,21,11,4,60,26,34,74
Morton,7208,2,17,11,8,50,35,15,62
Falkirk,7208,3,16,9,11,61,46,15,57
Dundee Utd,7208,4,14,12,10,51,43,8,54
Queen of S't,7208,5,13,9,14,50,48,2,48
Dunfermline,7208,6,10,12,14,45,48,-3,42
Dumbarton,7208,7,9,11,16,46,62,-16,38
Ayr,7208,8,8,14,14,33,54,-21,38
Raith,7208,9,9,10,17,35,52,-17,37
St Mirren,7208,10,8,11,17,41,58,-17,35
Hibernian,7209,1,18,13,5,53,26,27,67
Falkirk,7209,2,16,12,8,60,38,22,60
Morton,7209,3,15,13,8,44,32,12,58
Dundee Utd,7209,4,14,10,12,48,43,5,52
Queen of S't,7209,5,12,12,12,47,46,1,48
Dunfermline,7209,6,12,12,12,46,45,1,48
Ayr,7209,7,9,14,13,36,51,-15,41
Dumbarton,7209,8,9,11,16,50,61,-11,38
Raith,7209,9,8,12,16,30,50,-20,36
St Mirren,7209,10,7,11,18,39,61,-22,32
Hibernian,7210,1,20,12,4,58,27,31,72
Morton,7210,2,17,13,6,55,33,22,64
Falkirk,7210,3,16,10,10,58,41,17,58
Dundee Utd,7210,4,14,11,11,49,45,4,53
Dunfermline,7210,5,10,14,12,45,47,-2,44
Ayr,7210,6,10,12,14,42,53,-11,42
Queen of S't,7210,7,10,10,16,41,51,-10,40
Dumbarton,7210,8,9,11,16,47,61,-14,38
Raith,7210,9,9,10,17,32,49,-17,37
St Mirren,7210,10,9,9,18,39,59,-20,36
Hibernian,7211,1,19,12,5,54,27,27,69
Morton,7211,2,19,11,6,56,36,20,68
Dundee Utd,7211,3,15,13,8,52,40,12,58
Falkirk,7211,4,15,11,10,55,38,17,56
Queen of S't,7211,5,11,11,14,44,49,-5,44
Raith,7211,6,11,8,17,34,52,-18,41
Dunfermline,7211,7,8,15,13,44,48,-4,39
Dumbarton,7211,8,9,12,15,50,59,-9,39
Ayr,7211,9,8,13,15,35,54,-19,37
St Mirren,7211,10,7,10,19,36,57,-21,31
Hibernian,7212,1,20,11,5,59,27,32,71
Morton,7212,2,19,9,8,50,34,16,66
Falkirk,7212,3,16,9,11,56,42,14,57
Dundee Utd,7212,4,15,10,11,53,42,11,55
Queen of S't,7212,5,11,11,14,46,49,-3,44
Dumbarton,7212,6,11,11,14,48,58,-10,44
Raith,7212,7,11,9,16,38,50,-12,42
Dunfermline,7212,8,9,13,14,45,52,-7,40
St Mirren,7212,9,8,10,18,38,58,-20,34
Ayr,7212,10,7,13,16,38,59,-21,34
Hibernian,7213,1,18,11,7,52,28,24,65
Falkirk,7213,2,17,9,10,59,43,16,60
Morton,7213,3,15,14,7,49,36,13,59
Dundee Utd,7213,4,16,9,11,50,41,9,57
Dumbarton,7213,5,12,11,13,51,53,-2,47
Dunfermline,7213,6,10,13,13,49,52,-3,43
Queen of S't,7213,7,10,9,17,45,55,-10,39
Ayr,7213,8,9,12,15,33,51,-18,39
St Mirren,7213,9,9,11,16,41,54,-13,38
Raith,7213,10,9,11,16,33,49,-16,38
Hibernian,7214,1,21,12,3,58,24,34,75
Falkirk,7214,2,17,10,9,68,42,26,61
Dundee Utd,7214,3,16,10,10,51,41,10,58
Morton,7214,4,14,15,7,49,39,10,57
Raith,7214,5,11,9,16,38,50,-12,42
Dumbarton,7214,6,10,11,15,46,60,-14,41
Queen of S't,7214,7,10,10,16,41,51,-10,40
Dunfermline,7214,8,9,12,15,43,49,-6,39
St Mirren,7214,9,9,11,16,46,61,-15,38
Ayr,7214,10,7,12,17,30,53,-23,33
Hibernian,7215,1,18,13,5,56,27,29,67
Falkirk,7215,2,16,12,8,62,40,22,60
Dundee Utd,7215,3,15,12,9,50,41,9,57
Morton,7215,4,15,12,9,46,38,8,57
Dunfermline,7215,5,11,14,11,47,44,3,47
Dumbarton,7215,6,9,14,13,49,57,-8,41
Raith,7215,7,11,8,17,35,47,-12,41
Queen of S't,7215,8,10,9,17,44,60,-16,39
Ayr,7215,9,8,13,15,32,52,-20,37
St Mirren,7215,10,9,9,18,39,54,-15,36
Hibernian,7216,1,20,12,4,57,23,34,72
Falkirk,7216,2,16,10,10,58,44,14,58
Dundee Utd,7216,3,16,10,10,53,41,12,58
Morton,7216,4,15,13,8,51,43,8,58
Queen of S't,7216,5,13,8,15,46,52,-6,47
Dunfermline,7216,6,9,13,14,47,50,-3,40
Dumbarton,7216,7,9,13,14,45,54,-9,40
Ayr,7216,8,9,13,14,33,52,-19,40
Raith,7216,9,9,10,17,35,53,-18,37
St Mirren,7216,10,8,10,18,46,59,-13,34
Hibernian,7217,1,18,11,7,52,26,26,65
Morton,7217,2,17,11,8,54,40,14,62
Dundee Utd,7217,3,16,12,8,54,40,14,60
Falkirk,7217,4,13,13,10,55,44,11,52
Raith,7217,5,13,9,14,42,49,-7,48
Dumbarton,7217,6,10,12,14,50,58,-8,42
Queen of S't,7217,7,10,11,15,42,53,-11,41
Ayr,7217,8,8,14,14,42,58,-16,38
Dunfermline,7217,9,8,13,15,45,54,-9,37
St Mirren,7217,10,8,12,16,40,54,-14,36
Hibernian,7218,1,20,12,4,56,24,32,72
Morton,7218,2,17,12,7,47,34,13,63
Falkirk,7218,3,16,10,10,62,45,17,58
Dundee Utd,7218,4,13,13,10,45,38,7,52
Dumbarton,7218,5,11,13,12,48,51,-3,46
Queen of S't,7218,6,11,10,15,44,50,-6,43
Dunfermline,7218,7,9,15,12,47,49,-2,42
Raith,7218,8,10,10,16,34,48,-14,40
St Mirren,7218,9,7,12,17,39,59,-20,33
Ayr,7218,10,7,11,18,32,56,-24,32
Hibernian,7219,1,21,12,3,61,24,37,75
Falkirk,7219,2,15,13,8,55,38,17,58
Morton,7219,3,15,13,8,51,41,10,58
Dundee Utd,7219,4,15,11,10,51,40,11,56
Queen of S't,7219,5,11,12,13,48,50,-2,45
Dumbarton,7219,6,10,13,13,50,54,-4,43
St Mirren,7219,7,10,10,16,44,58,-14,40
Dunfermline,7219,8,9,12,15,47,54,-7,39
Raith,7219,9,9,10,17,38,56,-18,37
Ayr,7219,10,6,12,18,30,60,-30,30
Hibernian,7220,1,21,11,4,59,26,33,74
Dundee Utd,7220,2,16,11,9,55,39,16,59
Morton,7220,3,14,15,7,49,39,10,57
Falkirk,7220,4,15,9,12,54,48,6,54
Dunfermline,7220,5,10,14,12,45,45,0,44
Queen of S't,7220,6,11,10,15,42,53,-11,43
Ayr,7220,7,10,12,14,40,54,-14,42
Dumbarton,7220,8,8,14,14,48,57,-9,38
Raith,7220,9,9,9,18,36,52,-16,36
St Mirren,7220,10,7,13,16,42,57,-15,34
Hibernian,7221,1,18,13,5,55,26,29,67
Morton,7221,2,15,13,8,48,36,12,58
Falkirk,7221,3,15,12,9,54,40,14,57
Dundee Utd,7221,4,14,9,13,46,47,-1,51
Dunfermline,7221,5,10,16,10,48,46,2,46
Queen of S't,7221,6,12,9,15,42,49,-7,45
Dumbarton,7221,7,10,12,14,48,51,-3,42
Ayr,7221,8,10,12,14,36,52,-16,42
Raith,7221,9,11,8,17,37,48,-11,41
St Mirren,7221,10,7,12,17,38,57,-19,33
Hibernian,7222,1,19,12,5,54,28,26,69
Morton,7222,2,16,13,7,47,37,10,61
Falkirk,7222,3,14,13,9,58,43,15,55
Dundee Utd,7222,4,15,10,11,51,42,9,55
Dunfermline,7222,5,10,14,12,51,45,6,44
Queen of S't,7222,6,11,11,14,43,48,-5,44
Dumbarton,7222,7,10,10,16,49,60,-11,40
Raith,7222,8,10,9,17,34,52,-18,39
St Mirren,7222,9,9,11,16,40,54,-14,38
Ayr,7222,10,8,13,15,37,55,-18,37
Morton,7223,1,20,11,5,54,33,21,71
Hibernian,7223,2,18,11,7,51,27,24,65
Dundee Utd,7223,3,17,11,8,50,37,13,62
Falkirk,7223,4,15,10,11,56,41,15,55
Raith,7223,5,11,10,15,36,47,-11,43
Queen of S't,7223,6,11,9,16,45,50,-5,42
Dunfermline,7223,7,9,12,15,46,52,-6,39
Dumbarton,7223,8,9,12,15,49,60,-11,39
Ayr,7223,9,8,14,14,35,54,-19,38
St Mirren,7223,10,7,10,19,38,59,-21,31
Hibernian,7224,1,19,11,6,53,25,28,68
Morton,7224,2,19,10,7,52,34,18,67
Falkirk,7224,3,16,10,10,61,43,18,58
Dundee Utd,7224,4,16,9,11,49,38,11,57
Dunfermline,7224,5,11,15,10,49,46,3,48
Queen of S't,7224,6,11,10,15,46,55,-9,43
Dumbarton,7224,7,9,11,16,49,60,-11,38
Raith,7224,8,9,11,16,37,54,-17,38
St Mirren,7224,9,9,9,18,42,57,-15,36
Ayr,7224,10,7,12,17,31,57,-26,33
Hibernian,7225,1,18,12,6,52,27,25,66
Dundee Utd,7225,2,18,8,10,55,37,18,62
Morton,7225,3,16,11,9,48,43,5,59
Falkirk,7225,4,15,10,11,59,47,12,55
Raith,7225,5,13,9,14,41,44,-3,48
Queen of S't,7225,6,12,10,14,48,54,-6,46
Dumbarton,7225,7,10,11,15,52,58,-6,41
Dunfermline,7225,8,9,12,15,45,47,-2,39
St Mirren,7225,9,9,9,18,41,57,-16,36
Ayr,7225,10,8,12,16,33,60,-27,36
Hibernian,7226,1,20,10,6,57,27,30,70
Falkirk,7226,2,17,10,9,63,38,25,61
Dundee Utd,7226,3,16,10,10,52,45,7,58
Morton,7226,4,14,11,11,47,41,6,53
Dunfermline,7226,5,11,14,11,48,46,2,47
Queen of S't,7226,6,12,9,15,46,52,-6,45
Raith,7226,7,11,10,15,35,46,-11,43
St Mirren,7226,8,10,10,16,45,58,-13,40
Dumbarton,7226,9,9,11,16,45,58,-13,38
Ayr,7226,10,7,11,18,31,58,-27,32
Hibernian,7227,1,19,12,5,56,27,29,69
Morton,7227,2,16,13,7,48,36,12,61
Falkirk,7227,3,17,9,10,63,44,19,60
Dundee Utd,7227,4,17,8,11,52,42,10,59
Queen of S't,7227,5,12,9,15,45,52,-7,45
Dunfermline,7227,6,10,14,12,51,49,2,44
Raith,7227,7,10,11,15,38,50,-12,41
Dumbarton,7227,8,9,11,16,50,62,-12,38
Ayr,7227,9,8,11,17,31,55,-24,35
St Mirren,7227,10,8,10,18,38,55,-17,34
Hibernian,7228,1,19,11,6,53,26,27,68
Dundee Utd,7228,2,17,10,9,52,37,15,61
Morton,7228,3,17,9,10,51,42,9,60
Falkirk,7228,4,15,12,9,56,45,11,57
Dunfermline,7228,5,11,14,11,45,42,3,47
Raith,7228,6,11,9,16,35,46,-11,42
Queen of S't,7228,7,10,10,16,43,53,-10,40
Ayr,7228,8,8,14,14,36,51,-15,38
Dumbarton,7228,9,8,12,16,45,56,-11,36
St Mirren,7228,10,7,13,16,36,54,-18,34
Hibernian,7229,1,20,10,6,58,28,30,70
Morton,7229,2,17,11,8,52,40,12,62
Falkirk,7229,3,17,10,9,59,40,19,61
Dundee Utd,7229,4,15,10,11,51,42,9,55
Raith,7229,5,12,9,15,36,47,-11,45
Dumbarton,7229,6,10,12,14,48,57,-9,42
Queen of S't,7229,7,10,11,15,48,51,-3,41
Dunfermline,7229,8,9,12,15,45,57,-12,39
St Mirren,7229,9,10,9,17,46,59,-13,39
Ayr,7229,10,7,12,17,34,56,-22,33
Hibernian,7230,1,21,11,4,63,22,41,74
Morton,7230,2,17,11,8,53,40,13,62
Falkirk,7230,3,17,10,9,58,38,20,61
Dundee Utd,7230,4,15,9,12,45,42,3,54
Dunfermline,7230,5,11,11,14,50,48,2,44
Queen of S't,7230,6,11,11,14,44,46,-2,44
Raith,7230,7,10,11,15,33,44,-11,41
Dumbarton,7230,8,9,11,16,42,56,-14,38
St Mirren,7230,9,8,11,17,39,60,-21,35
Ayr,7230,10,8,10,18,33,64,-31,34
Hibernian,7231,1,17,14,5,52,27,25,65
Falkirk,7231,2,16,12,8,58,40,18,60
Morton,7231,3,16,11,9,47,38,9,59
Dundee Utd,7231,4,15,10,11,51,41,10,55
Queen of S't,7231,5,12,10,14,48,53,-5,46
Dunfermline,7231,6,10,15,11,46,48,-2,45
Dumbarton,7231,7,10,11,15,52,61,-9,41
Raith,7231,8,10,10,16,34,46,-12,40
Ayr,7231,9,8,13,15,33,55,-22,37
St Mirren,7231,10,8,10,18,42,54,-12,34
Hibernian,7232,1,21,11,4,60,23,37,74
Dundee Utd,7232,2,17,9,10,57,42,15,60
Morton,7232,3,16,12,8,45,35,10,60
Falkirk,7232,4,15,10,11,57,43,14,55
Dunfermline,7232,5,11,12,13,47,56,-9,45
Queen of S't,7232,6,11,10,15,47,48,-1,43
Dumbarton,7232,7,9,14,13,48,54,-6,41
Raith,7232,8,10,10,16,34,48,-14,40
Ayr,7232,9,8,11,17,38,62,-24,35
St Mirren,7232,10,7,11,18,39,61,-22,32
Hibernian,7233,1,20,11,5,61,28,33,71
Dundee Utd,7233,2,18,10,8,61,36,25,64
Morton,7233,3,17,11,8,53,39,14,62
Falkirk,7233,4,16,11,9,61,46,15,59
Dunfermline,7233,5,11,14,11,45,43,2,47
Raith,7233,6,11,9,16,38,49,-11,42
Queen of S't,7233,7,10,10,16,42,52,-10,40
Dumbarton,7233,8,9,11,16,50,63,-13,38
St Mirren,7233,9,8,9,19,41,61,-20,33
Ayr,7233,10,6,12,18,32,67,-35,30
Hibernian,7234,1,19,10,7,57,31,26,67
Falkirk,7234,2,19,9,8,60,38,22,66
Morton,7234,3,18,10,8,52,34,18,64
Dundee Utd,7234,4,18,9,9,55,40,15,63
Queen of S't,7234,5,10,10,16,43,50,-7,40
Dunfermline,7234,6,9,13,14,44,52,-8,40
Raith,7234,7,10,10,16,36,49,-13,40
St Mirren,7234,8,10,9,17,42,56,-14,39
Dumbarton,7234,9,9,10,17,43,57,-14,37
Ayr,7234,10,7,12,17,35,60,-25,33
Morton,7235,1,18,13,5,50,30,20,67
Hibernian,7235,2,18,12,6,52,29,23,66
Dundee Utd,7235,3,16,9,11,51,41,10,57
Falkirk,7235,4,15,11,10,58,44,14,56
Queen of S't,7235,5,12,9,15,48,53,-5,45
Dunfermline,7235,6,10,14,12,50,47,3,44
Raith,7235,7,10,9,17,34,46,-12,39
Dumbarton,7235,8,9,12,15,46,59,-13,39
Ayr,7235,9,8,12,16,35,58,-23,36
St Mirren,7235,10,8,11,17,39,56,-17,35
Hibernian,7236,1,20,13,3,64,25,39,73
Morton,7236,2,16,14,6,52,39,13,62
Dundee Utd,7236,3,17,9,10,55,35,20,60
Falkirk,7236,4,15,13,8,59,43,16,58
Queen of S't,7236,5,13,10,13,47,49,-2,49
Dunfermline,7236,6,10,15,11,50,51,-1,45
Raith,7236,7,9,9,18,38,60,-22,36
St Mirren,7236,8,8,11,17,44,58,-14,35
Dumbarton,7236,9,7,12,17,51,68,-17,33
Ayr,7236,10,6,12,18,31,63,-32,30
Hibernian,7237,1,19,12,5,56,28,28,69
Morton,7237,2,19,9,8,58,40,18,66
Falkirk,7237,3,17,11,8,65,39,26,62
Dundee Utd,7237,4,15,10,11,47,39,8,55
Dumbarton,7237,5,11,11,14,49,58,-9,44
Queen of S't,7237,6,10,11,15,41,53,-12,41
Dunfermline,7237,7,9,13,14,45,52,-7,40
Raith,7237,8,9,11,16,34,50,-16,38
St Mirren,7237,9,8,12,16,45,55,-10,36
Ayr,7237,10,7,12,17,32,58,-26,33
Hibernian,7238,1,19,11,6,52,25,27,68
Falkirk,7238,2,18,10,8,66,40,26,64
Morton,7238,3,17,12,7,51,35,16,63
Dundee Utd,7238,4,14,9,13,53,48,5,51
Ayr,7238,5,11,11,14,36,50,-14,44
Dunfermline,7238,6,10,11,15,47,52,-5,41
Dumbarton,7238,7,10,11,15,52,61,-9,41
Queen of S't,7238,8,11,8,17,44,60,-16,41
Raith,7238,9,10,10,16,35,48,-13,40
St Mirren,7238,10,8,11,17,36,53,-17,35
Hibernian,7239,1,18,13,5,55,23,32,67
Dundee Utd,7239,2,17,10,9,59,42,17,61
Falkirk,7239,3,16,10,10,58,41,17,58
Morton,7239,4,15,13,8,52,36,16,58
Queen of S't,7239,5,11,11,14,47,53,-6,44
Dumbarton,7239,6,10,12,14,50,57,-7,42
Dunfermline,7239,7,10,11,15,43,56,-13,41
Ayr,7239,8,9,12,15,37,57,-20,39
Raith,7239,9,9,11,16,35,51,-16,38
St Mirren,7239,10,7,13,16,35,55,-20,34
Hibernian,7240,1,19,12,5,53,23,30,69
Dundee Utd,7240,2,18,9,9,51,34,17,63
Morton,7240,3,16,11,9,49,39,10,59
Falkirk,7240,4,14,12,10,53,38,15,54
Dunfermline,7240,5,11,11,14,45,50,-5,44
Raith,7240,6,11,11,14,35,47,-12,44
Queen of S't,7240,7,11,10,15,45,49,-4,43
Dumbarton,7240,8,10,12,14,48,52,-4,42
Ayr,7240,9,8,11,17,30,56,-26,35
St Mirren,7240,10,8,9,19,36,57,-21,33
Hibernian,7241,1,17,14,5,50,24,26,65
Dundee Utd,7241,2,18,9,9,56,38,18,63
Morton,7241,3,16,13,7,54,35,19,61
Falkirk,7241,4,15,12,9,63,44,19,57
Raith,7241,5,12,11,13,45,47,-2,47
Queen of S't,7241,6,12,10,14,44,51,-7,46
Dunfermline,7241,7,8,14,14,45,53,-8,38
St Mirren,7241,8,9,10,17,43,64,-21,37
Ayr,7241,9,7,13,16,32,58,-26,34
Dumbarton,7241,10,7,12,17,45,63,-18,33
Hibernian,7242,1,18,13,5,56,29,27,67
Falkirk,7242,2,16,12,8,55,35,20,60
Dundee Utd,7242,3,17,9,10,50,40,10,60
Morton,7242,4,15,12,9,45,36,9,57
Queen of S't,7242,5,14,10,12,47,47,0,52
Dunfermline,7242,6,8,14,14,41,47,-6,38
Ayr,7242,7,8,14,14,36,54,-18,38
St Mirren,7242,8,8,13,15,42,54,-12,37
Dumbarton,7242,9,8,12,16,48,61,-13,36
Raith,7242,10,9,9,18,30,47,-17,36
Hibernian,7243,1,17,13,6,58,28,30,64
Falkirk,7243,2,15,13,8,59,41,18,58
Morton,7243,3,15,13,8,47,40,7,58
Dundee Utd,7243,4,16,8,12,54,47,7,56
Queen of S't,7243,5,13,10,13,45,47,-2,49
Raith,7243,6,11,11,14,38,47,-9,44
Dunfermline,7243,7,10,13,13,45,48,-3,43
Ayr,7243,8,9,12,15,33,53,-20,39
Dumbarton,7243,9,8,12,16,46,55,-9,36
St Mirren,7243,10,7,13,16,40,59,-19,34
Hibernian,7244,1,20,11,5,52,25,27,71
Morton,7244,2,18,11,7,53,36,17,65
Dundee Utd,7244,3,16,10,10,50,40,10,58
Falkirk,7244,4,15,12,9,56,39,17,57
Dunfermline,7244,5,12,11,13,49,47,2,47
Queen of S't,7244,6,10,10,16,47,56,-9,40
Dumbarton,7244,7,9,11,16,47,58,-11,38
St Mirren,7244,8,9,10,17,38,54,-16,37
Raith,7244,9,9,10,17,32,48,-16,37
Ayr,7244,10,9,10,17,38,59,-21,37
Hibernian,7245,1,19,14,3,57,26,31,71
Morton,7245,2,17,11,8,47,35,12,62
Dundee Utd,7245,3,16,10,10,49,39,10,58
Falkirk,7245,4,15,10,11,63,45,18,55
Queen of S't,7245,5,12,11,13,51,53,-2,47
St Mirren,7245,6,10,12,14,42,51,-9,42
Dunfermline,7245,7,9,14,13,51,51,0,41
Ayr,7245,8,7,15,14,31,50,-19,36
Dumbarton,7245,9,7,13,16,45,63,-18,34
Raith,7245,10,8,10,18,31,54,-23,34
Hibernian,7246,1,20,11,5,59,26,33,71
Morton,7246,2,16,12,8,50,38,12,60
Dundee Utd,7246,3,17,8,11,47,38,9,59
Falkirk,7246,4,14,10,12,55,42,13,52
Raith,7246,5,11,11,14,37,46,-9,44
Queen of S't,7246,6,11,9,16,45,53,-8,42
Ayr,7246,7,10,12,14,35,52,-17,42
Dumbarton,7246,8,10,11,15,51,59,-8,41
St Mirren,7246,9,10,10,16,40,53,-13,40
Dunfermline,7246,10,8,12,16,39,51,-12,36
Hibernian,7247,1,20,12,4,57,24,33,72
Morton,7247,2,17,12,7,52,34,18,63
Falkirk,7247,3,15,9,12,56,44,12,54
Dundee Utd,7247,4,14,10,12,46,42,4,52
Dunfermline,7247,5,10,14,12,47,48,-1,44
Queen of S't,7247,6,11,9,16,44,52,-8,42
Ayr,7247,7,10,11,15,39,58,-19,41
Dumbarton,7247,8,10,10,16,48,57,-9,40
St Mirren,7247,9,10,10,16,39,52,-13,40
Raith,7247,10,10,9,17,32,49,-17,39
Hibernian,7248,1,21,11,4,58,22,36,74
Falkirk,7248,2,17,9,10,56,40,16,60
Dundee Utd,7248,3,17,8,11,49,37,12,59
Morton,7248,4,15,11,10,46,39,7,56
Queen of S't,7248,5,12,9,15,46,49,-3,45
Ayr,7248,6,11,11,14,37,51,-14,44
Dunfermline,7248,7,9,12,15,42,47,-5,39
Raith,7248,8,10,9,17,35,55,-20,39
St Mirren,7248,9,8,13,15,44,53,-9,37
Dumbarton,7248,10,8,11,17,44,64,-20,35
Hibernian,7249,1,18,11,7,57,28,29,65
Falkirk,7249,2,18,10,8,60,37,23,64
Dundee Utd,7249,3,17,11,8,50,35,15,62
Morton,7249,4,16,10,10,54,46,8,58
Dunfermline,7249,5,10,14,12,44,46,-2,44
St Mirren,7249,6,11,9,16,41,51,-10,42
Queen of S't,7249,7,9,12,15,42,53,-11,39
Dumbarton,7249,8,9,11,16,47,60,-13,38
Ayr,7249,9,9,11,16,34,54,-20,38
Raith,7249,10,9,9,18,36,55,-19,36
Hibernian,7250,1,18,12,6,58,31,27,66
Morton,7250,2,17,11,8,54,38,16,62
Dundee Utd,7250,3,17,11,8,48,36,12,62
Falkirk,7250,4,16,10,10,58,43,15,58
Dunfermline,7250,5,11,11,14,50,50,0,44
Queen of S't,7250,6,10,11,15,45,53,-8,41
Raith,7250,7,10,9,17,35,51,-16,39
Ayr,7250,8,8,14,14,35,53,-18,38
Dumbarton,7250,9,8,13,15,46,60,-14,37
St Mirren,7250,10,9,10,17,42,56,-14,37
Hibernian,7251,1,20,12,4,58,23,35,72
Morton,7251,2,17,12,7,51,35,16,63
Falkirk,7251,3,16,9,11,58,45,13,57
Dundee Utd,7251,4,16,9,11,51,42,9,57
Dunfermline,7251,5,12,11,13,52,46,6,47
Queen of S't,7251,6,10,11,15,44,56,-12,41
Dumbarton,7251,7,10,10,16,48,58,-10,40
Raith,7251,8,10,9,17,35,51,-16,39
Ayr,7251,9,8,13,15,36,53,-17,37
St Mirren,7251,10,8,10,18,34,58,-24,34
Hibernian,7252,1,18,12,6,54,28,26,66
Morton,7252,2,18,12,6,55,37,18,66
Falkirk,7252,3,16,9,11,56,43,13,57
Dundee Utd,7252,4,15,11,10,52,41,11,56
Queen of S't,7252,5,12,9,15,48,52,-4,45
Dunfermline,7252,6,10,12,14,49,53,-4,42
Raith,7252,7,11,9,16,37,50,-13,42
Dumbarton,7252,8,10,11,15,54,63,-9,41
St Mirren,7252,9,9,10,17,41,56,-15,37
Ayr,7252,10,8,11,17,34,57,-23,35
Hibernian,7253,1,19,12,5,58,26,32,69
Dundee Utd,7253,2,18,8,10,60,40,20,62
Morton,7253,3,16,12,8,47,36,11,60
Falkirk,7253,4,14,11,11,55,43,12,53
Queen of S't,7253,5,12,10,14,48,51,-3,46
Dunfermline,7253,6,10,13,13,43,49,-6,43
St Mirren,7253,7,10,11,15,42,54,-12,41
Raith,7253,8,9,10,17,36,53,-17,37
Ayr,7253,9,8,13,15,35,57,-22,37
Dumbarton,7253,10,8,12,16,45,60,-15,36
Hibernian,7254,1,21,10,5,54,24,30,73
Morton,7254,2,17,10,9,49,34,15,61
Falkirk,7254,3,17,9,10,61,42,19,60
Dundee Utd,7254,4,14,8,14,49,49,0,50
Dumbarton,7254,5,10,13,13,48,53,-5,43
Queen of S't,7254,6,11,10,15,43,57,-14,43
Dunfermline,7254,7,9,14,13,45,47,-2,41
Ayr,7254,8,10,11,15,37,54,-17,41
St Mirren,7254,9,10,9,17,45,54,-9,39
Raith,7254,10,10,8,18,38,55,-17,38
Hibernian,7255,1,20,12,4,59,20,39,72
Morton,7255,2,16,12,8,54,36,18,60
Dundee Utd,7255,3,16,10,10,48,41,7,58
Falkirk,7255,4,15,11,10,55,40,15,56
Queen of S't,7255,5,12,9,15,43,48,-5,45
Dunfermline,7255,6,10,13,13,47,50,-3,43
Ayr,7255,7,9,13,14,31,47,-16,40
Raith,7255,8,10,10,16,33,54,-21,40
Dumbarton,7255,9,8,12,16,48,60,-12,36
St Mirren,7255,10,8,10,18,39,61,-22,34
Hibernian,7256,1,18,12,6,53,27,26,66
Dundee Utd,7256,2,18,10,8,59,40,19,64
Falkirk,7256,3,17,11,8,58,38,20,62
Morton,7256,4,17,11,8,55,40,15,62
Queen of S't,7256,5,12,11,13,49,52,-3,47
Dunfermline,7256,6,10,12,14,45,51,-6,42
St Mirren,7256,7,9,10,17,41,54,-13,37
Raith,7256,8,9,9,18,30,50,-20,36
Ayr,7256,9,8,12,16,33,58,-25,36
Dumbarton,7256,10,8,10,18,46,59,-13,34
Morton,7257,1,18,12,6,52,33,19,66
Hibernian,7257,2,18,11,7,52,27,25,65
Dundee Utd,7257,3,15,11,10,50,42,8,56
Falkirk,7257,4,15,9,12,57,43,14,54
Dunfermline,7257,5,12,11,13,47,49,-2,47
Raith,7257,6,11,9,16,34,47,-13,42
Dumbarton,7257,7,10,11,15,51,59,-8,41
Ayr,7257,8,10,11,15,36,52,-16,41
Queen of S't,7257,9,10,10,16,43,53,-10,40
St Mirren,7257,10,8,11,17,35,52,-17,35
Hibernian,7258,1,18,12,6,55,27,28,66
Falkirk,7258,2,16,11,9,60,44,16,59
Morton,7258,3,16,11,9,56,47,9,59
Dundee Utd,7258,4,15,9,12,52,46,6,54
Dunfermline,7258,5,11,12,13,46,49,-3,45
Raith,7258,6,12,9,15,40,48,-8,45
Queen of S't,7258,7,11,10,15,42,49,-7,43
Ayr,7258,8,10,12,14,38,54,-16,42
Dumbarton,7258,9,9,13,14,52,57,-5,40
St Mirren,7258,10,8,9,19,43,63,-20,33
Hibernian,7259,1,18,12,6,56,33,23,66
Morton,7259,2,18,12,6,55,34,21,66
Dundee Utd,7259,3,16,10,10,51,39,12,58
Falkirk,7259,4,14,11,11,55,45,10,53
Queen of S't,7259,5,13,9,14,47,51,-4,48
St Mirren,7259,6,11,10,15,44,53,-9,43
Dunfermline,7259,7,9,13,14,43,45,-2,40
Raith,7259,8,10,8,18,38,56,-18,38
Ayr,7259,9,9,11,16,36,55,-19,38
Dumbarton,7259,10,8,12,16,44,58,-14,36
Hibernian,7260,1,20,12,4,59,23,36,72
Dundee Utd,7260,2,18,9,9,49,35,14,63
Falkirk,7260,3,17,10,9,55,39,16,61
Morton,7260,4,17,10,9,49,40,9,61
Ayr,7260,5,10,12,14,39,54,-15,42
Dunfermline,7260,6,10,11,15,43,47,-4,41
Raith,7260,7,10,10,16,35,49,-14,40
Queen of S't,7260,8,10,9,17,41,54,-13,39
St Mirren,7260,9,9,10,17,40,54,-14,37
Dumbarton,7260,10,7,11,18,48,63,-15,32
Hibernian,7261,1,19,11,6,52,24,28,68
Morton,7261,2,17,10,9,50,38,12,61
Dundee Utd,7261,3,15,10,11,46,40,6,55
Falkirk,7261,4,14,12,10,55,38,17,54
Queen of S't,7261,5,15,9,12,45,43,2,54
Dunfermline,7261,6,11,13,12,49,47,2,46
Raith,7261,7,11,10,15,37,49,-12,43
Dumbarton,7261,8,10,10,16,47,59,-12,40
Ayr,7261,9,7,13,16,32,55,-23,34
St Mirren,7261,10,7,10,19,38,58,-20,31
Hibernian,7262,1,17,14,5,54,27,27,65
Morton,7262,2,17,11,8,48,36,12,62
Dundee Utd,7262,3,17,10,9,52,36,16,61
Falkirk,7262,4,16,10,10,58,41,17,58
Dunfermline,7262,5,10,14,12,44,47,-3,44
Queen of S't,7262,6,10,11,15,40,49,-9,41
Raith,7262,7,9,12,15,35,48,-13,39
Dumbarton,7262,8,9,11,16,44,55,-11,38
St Mirren,7262,9,9,10,17,40,57,-17,37
Ayr,7262,10,7,15,14,31,50,-19,36
Hibernian,7263,1,19,12,5,57,27,30,69
Dundee Utd,7263,2,18,9,9,52,33,19,63
Morton,7263,3,16,11,9,51,43,8,59
Falkirk,7263,4,14,14,8,58,42,16,56
Queen of S't,7263,5,11,10,15,42,50,-8,43
Raith,7263,6,10,11,15,35,49,-14,41
Dunfermline,7263,7,9,13,14,46,49,-3,40
Dumbarton,7263,8,9,12,15,48,58,-10,39
Ayr,7263,9,8,13,15,33,54,-21,37
St Mirren,7263,10,7,13,16,39,56,-17,34
Hibernian,7264,1,19,14,3,56,23,33,71
Morton,7264,2,17,11,8,50,35,15,62
Dundee Utd,7264,3,17,9,10,54,39,15,60
Falkirk,7264,4,15,13,8,61,44,17,58
Raith,7264,5,12,8,16,39,51,-12,44
Queen of S't,7264,6,11,10,15,50,55,-5,43
Dunfermline,7264,7,9,14,13,46,52,-6,41
Ayr,7264,8,8,12,16,33,55,-22,36
St Mirren,7264,9,8,11,17,40,57,-17,35
Dumbarton,7264,10,7,12,17,45,63,-18,33
Hibernian,7265,1,19,13,4,52,24,28,70
Morton,7265,2,18,12,6,52,34,18,66
Falkirk,7265,3,18,10,8,64,43,21,64
Dundee Utd,7265,4,16,8,12,47,38,9,56
Queen of S't,7265,5,12,9,15,44,47,-3,45
Dumbarton,7265,6,10,12,14,49,56,-7,42
Raith,7265,7,10,10,16,36,48,-12,40
Dunfermline,7265,8,8,13,15,40,50,-10,37
Ayr,7265,9,8,11,17,29,53,-24,35
St Mirren,7265,10,6,12,18,39,59,-20,30
Hibernian,7266,1,22,11,3,60,21,39,77
Morton,7266,2,18,10,8,52,38,14,64
Dundee Utd,7266,3,18,9,9,55,34,21,63
Falkirk,7266,4,15,11,10,57,43,14,56
Queen of S't,7266,5,12,9,15,43,50,-7,45
Dunfermline,7266,6,10,12,14,50,50,0,42
Raith,7266,7,10,8,18,40,53,-13,38
Dumbarton,7266,8,8,13,15,43,59,-16,37
St Mirren,7266,9,8,10,18,39,60,-21,34
Ayr,7266,10,6,13,17,28,59,-31,31
Hibernian,7267,1,19,11,6,56,27,29,68
Dundee Utd,7267,2,20,8,8,57,33,24,68
Morton,7267,3,16,10,10,51,41,10,58
Falkirk,7267,4,15,10,11,57,45,12,55
Queen of S't,7267,5,11,10,15,44,52,-8,43
St Mirren,7267,6,11,10,15,44,53,-9,43
Dumbarton,7267,7,9,14,13,48,56,-8,41
Raith,7267,8,10,10,16,41,54,-13,40
Dunfermline,7267,9,9,11,16,46,53,-7,38
Ayr,7267,10,6,14,16,29,59,-30,32
Hibernian,7268,1,19,12,5,50,23,27,69
Morton,7268,2,18,9,9,53,35,18,63
Falkirk,7268,3,15,11,10,56,38,18,56
Dundee Utd,7268,4,15,9,12,49,42,7,54
Queen of S't,7268,5,12,9,15,41,47,-6,45
Dunfermline,7268,6,10,13,13,41,43,-2,43
Raith,7268,7,11,10,15,37,47,-10,43
Ayr,7268,8,10,11,15,35,53,-18,41
St Mirren,7268,9,10,10,16,45,55,-10,40
Dumbarton,7268,10,8,10,18,41,65,-24,34
Hibernian,7269,1,18,13,5,53,29,24,67
Morton,7269,2,18,11,7,57,37,20,65
Dundee Utd,7269,3,18,9,9,56,39,17,63
Falkirk,7269,4,16,12,8,58,40,18,60
Queen of S't,7269,5,13,9,14,48,47,1,48
St Mirren,7269,6,10,10,16,40,54,-14,40
Dunfermline,7269,7,8,14,14,45,57,-12,38
Dumbarton,7269,8,8,12,16,50,64,-14,36
Raith,7269,9,9,9,18,33,49,-16,36
Ayr,7269,10,7,11,18,32,56,-24,32
Hibernian,7270,1,20,11,5,58,23,35,71
Morton,7270,2,16,13,7,47,35,12,61
Falkirk,7270,3,15,11,10,55,43,12,56
Dundee Utd,7270,4,14,14,8,45,36,9,56
Queen of S't,7270,5,12,10,14,42,49,-7,46
Dunfermline,7270,6,9,15,12,44,46,-2,42
Dumbarton,7270,7,8,14,14,47,56,-9,38
Raith,7270,8,10,8,18,33,51,-18,38
St Mirren,7270,9,9,10,17,46,56,-10,37
Ayr,7270,10,8,12,16,36,58,-22,36
Hibernian,7271,1,19,13,4,56,24,32,70
Falkirk,7271,2,16,12,8,56,37,19,60
Morton,7271,3,16,11,9,47,38,9,59
Dundee Utd,7271,4,15,11,10,51,38,13,56
Dunfermline,7271,5,10,13,13,51,51,0,43
Queen of S't,7271,6,11,10,15,45,53,-8,43
Raith,7271,7,10,10,16,39,49,-10,40
Dumbarton,7271,8,9,11,16,49,61,-12,38
St Mirren,7271,9,9,10,17,37,58,-21,37
Ayr,7271,10,8,13,15,34,56,-22,37
Hibernian,7272,1,20,11,5,63,28,35,71
Morton,7272,2,18,10,8,53,38,15,64
Dundee Utd,7272,3,16,10,10,51,41,10,58
Falkirk,7272,4,15,11,10,57,40,17,56
Dunfermline,7272,5,10,13,13,47,51,-4,43
Queen of S't,7272,6,11,9,16,43,57,-14,42
Raith,7272,7,11,8,17,40,50,-10,41
Dumbarton,7272,8,9,12,15,46,56,-10,39
St Mirren,7272,9,9,11,16,43,57,-14,38
Ayr,7272,10,8,11,17,35,60,-25,35
Hibernian,7273,1,20,12,4,60,21,39,72
Morton,7273,2,18,11,7,53,36,17,65
Falkirk,7273,3,16,11,9,63,45,18,59
Dundee Utd,7273,4,16,9,11,54,42,12,57
Queen of S't,7273,5,11,10,15,45,52,-7,43
Dumbarton,7273,6,10,11,15,54,61,-7,41
Dunfermline,7273,7,9,13,14,43,52,-9,40
Raith,7273,8,9,10,17,33,51,-18,37
St Mirren,7273,9,9,9,18,38,59,-21,36
Ayr,7273,10,8,12,16,39,63,-24,36
Hibernian,7274,1,19,13,4,56,25,31,70
Dundee Utd,7274,2,18,9,9,54,42,12,63
Morton,7274,3,15,13,8,52,39,13,58
Falkirk,7274,4,15,10,11,57,44,13,55
Queen of S't,7274,5,11,10,15,46,50,-4,43
St Mirren,7274,6,10,10,16,44,55,-11,40
Ayr,7274,7,9,13,14,37,53,-16,40
Raith,7274,8,9,12,15,33,49,-16,39
Dunfermline,7274,9,8,14,14,39,50,-11,38
Dumbarton,7274,10,8,12,16,52,63,-11,36
Hibernian,7275,1,19,12,5,61,28,33,69
Falkirk,7275,2,19,10,7,64,36,28,67
Morton,7275,3,19,10,7,55,33,22,67
Dundee Utd,7275,4,15,11,10,44,41,3,56
Raith,7275,5,11,9,16,39,51,-12,42
Queen of S't,7275,6,10,10,16,40,54,-14,40
Dumbarton,7275,7,9,12,15,50,59,-9,39
Dunfermline,7275,8,8,12,16,45,58,-13,36
Ayr,7275,9,8,12,16,41,60,-19,36
St Mirren,7275,10,7,12,17,42,61,-19,33
Hibernian,7276,1,19,14,3,57,26,31,71
Dundee Utd,7276,2,17,9,10,54,38,16,60
Morton,7276,3,16,12,8,49,37,12,60
Falkirk,7276,4,15,11,10,59,44,15,56
Queen of S't,7276,5,12,9,15,43,50,-7,45
Dunfermline,7276,6,10,12,14,44,51,-7,42
Raith,7276,7,11,9,16,39,51,-12,42
Dumbarton,7276,8,10,11,15,49,54,-5,41
Ayr,7276,9,8,11,17,33,57,-24,35
St Mirren,7276,10,7,12,17,39,58,-19,33
Hibernian,7277,1,20,13,3,55,23,32,73
Falkirk,7277,2,18,10,8,60,37,23,64
Morton,7277,3,17,11,8,49,35,14,62
Dundee Utd,7277,4,16,10,10,47,37,10,58
Queen of S't,7277,5,12,9,15,40,46,-6,45
Dunfermline,7277,6,9,12,15,46,52,-6,39
St Mirren,7277,7,10,9,17,39,54,-15,39
Raith,7277,8,9,10,17,34,51,-17,37
Dumbarton,7277,9,7,13,16,47,60,-13,34
Ayr,7277,10,7,13,16,36,58,-22,34
Hibernian,7278,1,20,12,4,56,26,30,72
Dundee Utd,7278,2,17,10,9,51,38,13,61
Falkirk,7278,3,15,12,9,58,41,17,57
Morton,7278,4,14,12,10,44,37,7,54
Queen of S't,7278,5,13,9,14,48,48,0,48
Dunfermline,7278,6,10,14,12,46,48,-2,44
St Mirren,7278,7,10,9,17,45,56,-11,39
Raith,7278,8,10,8,18,37,53,-16,38
Dumbarton,7278,9,8,13,15,47,58,-11,37
Ayr,7278,10,7,13,16,33,60,-27,34
Hibernian,7279,1,20,12,4,54,24,30,72
Morton,7279,2,17,11,8,51,41,10,62
Falkirk,7279,3,16,11,9,61,40,21,59
Dundee Utd,7279,4,16,10,10,52,41,11,58
Queen of S't,7279,5,13,9,14,47,48,-1,48
Raith,7279,6,11,8,17,38,50,-12,41
Dunfermline,7279,7,9,13,14,44,48,-4,40
Ayr,7279,8,8,13,15,38,60,-22,37
Dumbarton,7279,9,8,11,17,48,63,-15,35
St Mirren,7279,10,8,10,18,43,61,-18,34
Hibernian,7280,1,17,14,5,51,25,26,65
Dundee Utd,7280,2,18,9,9,55,37,18,63
Falkirk,7280,3,14,12,10,51,39,12,54
Morton,7280,4,15,9,12,47,43,4,54
Raith,7280,5,13,9,14,37,45,-8,48
St Mirren,7280,6,11,10,15,42,53,-11,43
Queen of S't,7280,7,10,12,14,42,47,-5,42
Dunfermline,7280,8,9,14,13,48,48,0,41
Dumbarton,7280,9,9,10,17,45,60,-15,37
Ayr,7280,10,8,13,15,32,53,-21,37
Hibernian,7281,1,20,12,4,61,32,29,72
Dundee Utd,7281,2,16,11,9,53,41,12,59
Morton,7281,3,16,11,9,51,42,9,59
Falkirk,7281,4,13,11,12,51,44,7,50
Queen of S't,7281,5,12,10,14,49,48,1,46
Raith,7281,6,12,10,14,40,46,-6,46
Dumbarton,7281,7,10,10,16,50,60,-10,40
Ayr,7281,8,9,12,15,40,55,-15,39
Dunfermline,7281,9,8,13,15,43,54,-11,37
St Mirren,7281,10,8,12,16,43,59,-16,36
Hibernian,7282,1,19,12,5,53,25,28,69
Morton,7282,2,18,11,7,54,39,15,65
Falkirk,7282,3,16,11,9,63,44,19,59
Dundee Utd,7282,4,16,10,10,51,39,12,58
Dunfermline,7282,5,11,12,13,45,48,-3,45
Raith,7282,6,11,9,16,37,50,-13,42
Queen of S't,7282,7,10,10,16,43,52,-9,40
Dumbarton,7282,8,9,11,16,52,57,-5,38
St Mirren,7282,9,8,12,16,40,59,-19,36
Ayr,7282,10,6,14,16,30,55,-25,32
Hibernian,7283,1,19,11,6,54,25,29,68
Morton,7283,2,17,10,9,49,39,10,61
Dundee Utd,7283,3,17,8,11,51,40,11,59
Falkirk,7283,4,15,13,8,58,39,19,58
Queen of S't,7283,5,14,9,13,55,49,6,51
Raith,7283,6,11,8,17,34,49,-15,41
Dunfermline,7283,7,8,14,14,44,52,-8,38
St Mirren,7283,8,9,11,16,41,52,-11,38
Ayr,7283,9,9,11,16,34,53,-19,38
Dumbarton,7283,10,8,11,17,45,67,-22,35
Hibernian,7284,1,21,11,4,59,23,36,74
Dundee Utd,7284,2,18,10,8,51,35,16,64
Falkirk,7284,3,16,11,9,58,42,16,59
Morton,7284,4,14,13,9,43,36,7,55
Raith,7284,5,12,10,14,39,47,-8,46
Queen of S't,7284,6,11,9,16,43,50,-7,42
Dunfermline,7284,7,9,14,13,44,49,-5,41
Dumbarton,7284,8,7,13,16,41,55,-14,34
St Mirren,7284,9,7,13,16,38,54,-16,34
Ayr,7284,10,7,12,17,35,60,-25,33
Hibernian,7285,1,17,14,5,51,25,26,65
Falkirk,7285,2,16,13,7,56,37,19,61
Morton,7285,3,16,11,9,48,40,8,59
Dundee Utd,7285,4,15,10,11,45,38,7,55
Raith,7285,5,12,9,15,42,48,-6,45
Queen of S't,7285,6,11,10,15,43,50,-7,43
St Mirren,7285,7,10,12,14,46,54,-8,42
Dunfermline,7285,8,9,13,14,45,50,-5,40
Ayr,7285,9,7,15,14,38,55,-17,36
Dumbarton,7285,10,8,11,17,47,64,-17,35
Hibernian,7286,1,20,11,5,58,28,30,71
Falkirk,7286,2,17,10,9,61,42,19,61
Dundee Utd,7286,3,17,9,10,50,38,12,60
Morton,7286,4,15,11,10,47,42,5,56
Dunfermline,7286,5,14,11,11,53,45,8,53
Queen of S't,7286,6,10,10,16,40,48,-8,40
Ayr,7286,7,10,10,16,34,50,-16,40
Dumbarton,7286,8,9,11,16,47,60,-13,38
Raith,7286,9,9,10,17,35,53,-18,37
St Mirren,7286,10,7,11,18,37,56,-19,32
Hibernian,7287,1,20,11,5,55,28,27,71
Falkirk,7287,2,17,10,9,60,39,21,61
Dundee Utd,7287,3,16,9,11,49,37,12,57
Morton,7287,4,15,11,10,52,44,8,56
Queen of S't,7287,5,12,9,15,40,46,-6,45
Dunfermline,7287,6,10,14,12,47,47,0,44
Dumbarton,7287,7,10,12,14,51,58,-7,42
Raith,7287,8,10,9,17,34,53,-19,39
St Mirren,7287,9,9,9,18,41,57,-16,36
Ayr,7287,10,8,12,16,36,56,-20,36
Hibernian,7288,1,16,15,5,52,27,25,63
Morton,7288,2,17,11,8,54,37,17,62
Falkirk,7288,3,16,10,10,60,45,15,58
Dundee Utd,7288,4,15,11,10,53,41,12,56
Dunfermline,7288,5,13,12,11,48,45,3,51
Raith,7288,6,10,10,16,36,53,-17,40
Dumbarton,7288,7,9,12,15,50,57,-7,39
Queen of S't,7288,8,9,12,15,40,51,-11,39
Ayr,7288,9,8,13,15,37,58,-21,37
St Mirren,7288,10,8,12,16,38,54,-16,36
Hibernian,7289,1,19,12,5,55,30,25,69
Morton,7289,2,17,13,6,48,31,17,64
Falkirk,7289,3,17,11,8,61,38,23,62
Dundee Utd,7289,4,16,8,12,47,39,8,56
Ayr,7289,5,11,12,13,35,47,-12,45
Queen of S't,7289,6,10,12,14,46,49,-3,42
Dunfermline,7289,7,8,15,13,43,47,-4,39
Raith,7289,8,9,11,16,32,50,-18,38
Dumbarton,7289,9,7,13,16,44,60,-16,34
St Mirren,7289,10,7,11,18,36,56,-20,32
Morton,7290,1,21,10,5,56,31,25,73
Hibernian,7290,2,17,12,7,50,30,20,63
Falkirk,7290,3,16,11,9,62,45,17,59
Dundee Utd,7290,4,14,10,12,44,40,4,52
Dumbarton,7290,5,10,13,13,52,55,-3,43
Dunfermline,7290,6,10,13,13,48,52,-4,43
Raith,7290,7,11,9,16,39,49,-10,42
Queen of S't,7290,8,10,10,16,42,52,-10,40
St Mirren,7290,9,8,11,17,43,58,-15,35
Ayr,7290,10,6,15,15,31,55,-24,33
Hibernian,7291,1,19,12,5,55,26,29,69
Dundee Utd,7291,2,17,10,9,51,35,16,61
Falkirk,7291,3,15,11,10,56,41,15,56
Morton,7291,4,14,12,10,50,43,7,54
Queen of S't,7291,5,12,9,15,46,52,-6,45
Dumbarton,7291,6,11,11,14,48,53,-5,44
Raith,7291,7,11,11,14,38,47,-9,44
Dunfermline,7291,8,10,12,14,50,54,-4,42
Ayr,7291,9,8,14,14,31,52,-21,38
St Mirren,7291,10,7,10,19,36,58,-22,31
Hibernian,7292,1,21,12,3,62,23,39,75
Dundee Utd,7292,2,17,11,8,47,34,13,62
Morton,7292,3,15,11,10,51,38,13,56
Falkirk,7292,4,14,10,12,56,48,8,52
Queen of S't,7292,5,13,9,14,46,46,0,48
Dunfermline,7292,6,11,14,11,51,51,0,47
St Mirren,7292,7,10,11,15,38,49,-11,41
Raith,7292,8,9,10,17,33,53,-20,37
Dumbarton,7292,9,8,10,18,43,60,-17,34
Ayr,7292,10,7,12,17,28,53,-25,33
Hibernian,7293,1,18,13,5,56,30,26,67
Morton,7293,2,18,11,7,52,32,20,65
Falkirk,7293,3,17,10,9,58,38,20,61
Dundee Utd,7293,4,14,11,11,42,34,8,53
Queen of S't,7293,5,11,11,14,47,51,-4,44
Dumbarton,7293,6,11,11,14,50,55,-5,44
Dunfermline,7293,7,9,11,16,47,56,-9,38
Raith,7293,8,9,11,16,37,54,-17,38
Ayr,7293,9,8,14,14,32,55,-23,38
St Mirren,7293,10,8,11,17,39,55,-16,35
Hibernian,7294,1,18,11,7,56,29,27,65
Morton,7294,2,18,10,8,50,32,18,64
Falkirk,7294,3,16,11,9,55,38,17,59
Dundee Utd,7294,4,15,10,11,45,42,3,55
Queen of S't,7294,5,13,10,13,47,49,-2,49
Raith,7294,6,11,9,16,36,51,-15,42
Dunfermline,7294,7,9,14,13,46,48,-2,41
Dumbarton,7294,8,9,11,16,48,60,-12,38
Ayr,7294,9,8,13,15,32,52,-20,37
St Mirren,7294,10,9,9,18,42,56,-14,36
Hibernian,7295,1,21,12,3,63,27,36,75
Dundee Utd,7295,2,18,10,8,55,37,18,64
Falkirk,7295,3,17,10,9,63,43,20,61
Morton,7295,4,15,11,10,51,43,8,56
Raith,7295,5,11,9,16,36,54,-18,42
Queen of S't,7295,6,10,10,16,42,51,-9,40
Dumbarton,7295,7,10,10,16,43,54,-11,40
Dunfermline,7295,8,9,12,15,45,51,-6,39
St Mirren,7295,9,8,11,17,42,60,-18,35
Ayr,7295,10,7,13,16,36,56,-20,34
Hibernian,7296,1,19,12,5,61,26,35,69
Morton,7296,2,17,10,9,48,40,8,61
Dundee Utd,7296,3,17,8,11,52,42,10,59
Falkirk,7296,4,15,13,8,64,45,19,58
Queen of S't,7296,5,12,10,14,45,53,-8,46
Dunfermline,7296,6,9,14,13,48,49,-1,41
Dumbarton,7296,7,10,11,15,47,55,-8,41
Raith,7296,8,10,11,15,33,45,-12,41
Ayr,7296,9,8,11,17,34,57,-23,35
St Mirren,7296,10,8,10,18,36,56,-20,34
Hibernian,7297,1,17,12,7,51,29,22,63
Morton,7297,2,16,11,9,50,39,11,59
Dundee Utd,7297,3,16,9,11,54,41,13,57
Falkirk,7297,4,15,10,11,52,43,9,55
Queen of S't,7297,5,14,8,14,44,48,-4,50
Dunfermline,7297,6,11,12,13,50,48,2,45
Raith,7297,7,11,9,16,35,47,-12,42
Ayr,7297,8,10,12,14,38,52,-14,42
St Mirren,7297,9,10,9,17,41,54,-13,39
Dumbarton,7297,10,8,12,16,44,58,-14,36
Morton,7298,1,19,11,6,56,35,21,68
Hibernian,7298,2,18,12,6,53,26,27,66
Dundee Utd,7298,3,17,10,9,54,37,17,61
Falkirk,7298,4,13,13,10,58,48,10,52
Dunfermline,7298,5,10,13,13,48,50,-2,43
Queen of S't,7298,6,11,10,15,46,51,-5,43
Raith,7298,7,10,10,16,38,52,-14,40
Dumbarton,7298,8,9,12,15,50,62,-12,39
St Mirren,7298,9,8,13,15,41,54,-13,37
Ayr,7298,10,7,12,17,33,62,-29,33
Hibernian,7299,1,20,12,4,59,24,35,72
Falkirk,7299,2,18,10,8,58,36,22,64
Dundee Utd,7299,3,17,10,9,51,36,15,61
Morton,7299,4,14,14,8,46,37,9,56
Queen of S't,7299,5,11,11,14,43,50,-7,44
Raith,7299,6,10,11,15,35,49,-14,41
Dunfermline,7299,7,9,13,14,45,51,-6,40
Dumbarton,7299,8,10,10,16,46,59,-13,40
Ayr,7299,9,8,12,16,33,50,-17,36
St Mirren,7299,10,7,9,20,37,61,-24,30
Hibernian,7300,1,18,11,7,56,33,23,65
Morton,7300,2,17,12,7,46,33,13,63
Dundee Utd,7300,3,16,11,9,59,41,18,59
Falkirk,7300,4,16,11,9,60,43,17,59
Dunfermline,7300,5,11,13,12,48,47,1,46
Queen of S't,7300,6,11,10,15,44,52,-8,43
Raith,7300,7,10,9,17,35,52,-17,39
Dumbarton,7300,8,9,11,16,52,64,-12,38
Ayr,7300,9,8,13,15,39,58,-19,37
St Mirren,7300,10,8,11,17,40,56,-16,35
Hibernian,7301,1,18,13,5,53,26,27,67
Falkirk,7301,2,17,11,8,60,39,21,62
Morton,7301,3,16,13,7,49,35,14,61
Dundee Utd,7301,4,17,10,9,48,36,12,61
Dunfermline,7301,5,11,12,13,45,46,-1,45
Queen of S't,7301,6,11,9,16,46,51,-5,42
Ayr,7301,7,9,12,15,40,54,-14,39
Raith,7301,8,9,10,17,35,56,-21,37
Dumbarton,7301,9,8,12,16,43,57,-14,36
St Mirren,7301,10,7,12,17,42,61,-19,33
Hibernian,7302,1,19,13,4,53,23,30,70
Falkirk,7302,2,17,11,8,62,43,19,62
Morton,7302,3,16,11,9,53,36,17,59
Dundee Utd,7302,4,15,10,11,49,41,8,55
Queen of S't,7302,5,12,9,15,48,52,-4,45
Dunfermline,7302,6,10,13,13,46,48,-2,43
Raith,7302,7,10,9,17,34,49,-15,39
St Mirren,7302,8,9,11,16,41,55,-14,38
Ayr,7302,9,9,11,16,31,56,-25,38
Dumbarton,7302,10,9,10,17,47,61,-14,37
Morton,7303,1,20,10,6,57,31,26,70
Hibernian,7303,2,17,13,6,60,36,24,64
Falkirk,7303,3,15,13,8,63,43,20,58
Dundee Utd,7303,4,16,10,10,46,39,7,58
Dunfermline,7303,5,11,12,13,49,50,-1,45
Queen of S't,7303,6,10,11,15,41,52,-11,41
St Mirren,7303,7,9,11,16,49,60,-11,38
Raith,7303,8,8,12,16,34,52,-18,36
Dumbarton,7303,9,7,14,15,49,61,-12,35
Ayr,7303,10,7,14,15,37,61,-24,35
Hibernian,7304,1,18,12,6,55,28,27,66
Dundee Utd,7304,2,17,9,10,54,38,16,60
Morton,7304,3,15,12,9,50,40,10,57
Falkirk,7304,4,14,12,10,55,45,10,54
Dunfermline,7304,5,12,13,11,48,44,4,49
Queen of S't,7304,6,13,10,13,43,45,-2,49
Raith,7304,7,10,10,16,35,48,-13,40
Dumbarton,7304,8,9,12,15,49,59,-10,39
St Mirren,7304,9,8,13,15,40,56,-16,37
Ayr,7304,10,6,13,17,33,59,-26,31
Morton,7305,1,17,12,7,52,33,19,63
Hibernian,7305,2,16,14,6,52,30,22,62
Falkirk,7305,3,17,10,9,59,40,19,61
Dundee Utd,7305,4,15,11,10,49,42,7,56
Raith,7305,5,12,10,14,37,45,-8,46
Queen of S't,7305,6,11,10,15,41,48,-7,43
Dunfermline,7305,7,10,12,14,47,53,-6,42
Dumbarton,7305,8,9,12,15,48,58,-10,39
Ayr,7305,9,8,14,14,37,54,-17,38
St Mirren,7305,10,8,9,19,43,62,-19,33
Morton,7306,1,18,13,5,59,32,27,67
Hibernian,7306,2,18,13,5,56,29,27,67
Dundee Utd,7306,3,17,10,9,52,40,12,61
Falkirk,7306,4,15,13,8,57,42,15,58
Raith,7306,5,11,11,14,36,45,-9,44
Dunfermline,7306,6,9,14,13,53,54,-1,41
Queen of S't,7306,7,10,11,15,42,55,-13,41
Dumbarton,7306,8,8,13,15,47,62,-15,37
Ayr,7306,9,7,12,17,34,56,-22,33
St Mirren,7306,10,7,10,19,40,61,-21,31
Hibernian,7307,1,20,11,5,52,24,28,71
Falkirk,7307,2,18,10,8,62,40,22,64
Morton,7307,3,15,13,8,44,34,10,58
Dundee Utd,7307,4,14,13,9,53,42,11,55
Queen of S't,7307,5,11,11,14,42,46,-4,44
Dunfermline,7307,6,10,13,13,50,53,-3,43
St Mirren,7307,7,10,11,15,42,55,-13,41
Raith,7307,8,9,10,17,32,48,-16,37
Dumbarton,7307,9,8,12,16,47,60,-13,36
Ayr,7307,10,7,12,17,35,57,-22,33
Hibernian,7308,1,20,10,6,54,27,27,70
Morton,7308,2,18,12,6,50,32,18,66
Falkirk,7308,3,16,10,10,61,42,19,58
Dundee Utd,7308,4,16,10,10,50,37,13,58
Queen of S't,7308,5,12,9,15,43,50,-7,45
Dunfermline,7308,6,10,12,14,45,49,-4,42
St Mirren,7308,7,10,11,15,41,52,-11,41
Dumbarton,7308,8,9,13,14,50,57,-7,40
Raith,7308,9,9,9,18,33,52,-19,36
Ayr,7308,10,6,12,18,27,56,-29,30
Hibernian,7309,1,19,11,6,54,27,27,68
Morton,7309,2,17,9,10,50,42,8,60
Falkirk,7309,3,16,11,9,57,40,17,59
Dundee Utd,7309,4,15,11,10,49,41,8,56
Raith,7309,5,13,8,15,40,45,-5,47
Dunfermline,7309,6,11,13,12,44,45,-1,46
Queen of S't,7309,7,11,9,16,43,50,-7,42
Dumbarton,7309,8,9,13,14,48,55,-7,40
St Mirren,7309,9,9,9,18,43,58,-15,36
Ayr,7309,10,7,12,17,35,60,-25,33
Hibernian,7310,1,19,10,7,55,31,24,67
Dundee Utd,7310,2,19,9,8,54,36,18,66
Falkirk,7310,3,17,10,9,60,42,18,61
Morton,7310,4,16,10,10,49,45,4,58
Queen of S't,7310,5,11,10,15,44,51,-7,43
Dunfermline,7310,6,9,14,13,46,46,0,41
Raith,7310,7,10,11,15,38,47,-9,41
Dumbarton,7310,8,9,10,17,47,62,-15,37
Ayr,7310,9,8,13,15,38,54,-16,37
St Mirren,7310,10,8,11,17,40,57,-17,35
Hibernian,7311,1,19,11,6,55,26,29,68
Morton,7311,2,18,12,6,51,31,20,66
Falkirk,7311,3,18,10,8,63,41,22,64
Dundee Utd,7311,4,14,12,10,48,40,8,54
Queen of S't,7311,5,14,8,14,52,49,3,50
Dunfermline,7311,6,9,12,15,43,55,-12,39
Dumbarton,7311,7,7,15,14,46,57,-11,36
Raith,7311,8,9,9,18,34,53,-19,36
St Mirren,7311,9,8,11,17,40,57,-17,35
Ayr,7311,10,7,14,15,38,61,-23,35
Hibernian,7312,1,20,11,5,56,25,31,71
Dundee Utd,7312,2,17,10,9,57,42,15,61
Falkirk,7312,3,17,10,9,56,43,13,61
Morton,7312,4,16,11,9,52,38,14,59
Queen of S't,7312,5,12,10,14,44,47,-3,46
Raith,7312,6,11,9,16,35,48,-13,42
Ayr,7312,7,10,10,16,34,52,-18,40
Dumbarton,7312,8,9,11,16,47,59,-12,38
Dunfermline,7312,9,8,13,15,40,50,-10,37
St Mirren,7312,10,7,11,18,36,53,-17,32
Hibernian,7313,1,20,12,4,54,22,32,72
Dundee Utd,7313,2,17,9,10,50,40,10,60
Falkirk,7313,3,16,11,9,60,44,16,59
Morton,7313,4,16,10,10,48,38,10,58
Queen of S't,7313,5,12,10,14,51,53,-2,46
Raith,7313,6,12,9,15,39,46,-7,45
Dunfermline,7313,7,10,11,15,50,54,-4,41
St Mirren,7313,8,10,9,17,40,53,-13,39
Ayr,7313,9,8,11,17,30,56,-26,35
Dumbarton,7313,10,7,12,17,47,63,-16,33
Hibernian,7314,1,19,12,5,57,28,29,69
Morton,7314,2,15,14,7,51,40,11,59
Falkirk,7314,3,15,11,10,58,45,13,56
Dundee Utd,7314,4,16,8,12,52,45,7,56
Queen of S't,7314,5,12,11,13,49,51,-2,47
Dunfermline,7314,6,10,14,12,52,49,3,44
Ayr,7314,7,11,10,15,40,54,-14,43
Dumbarton,7314,8,9,13,14,51,59,-8,40
Raith,7314,9,9,9,18,33,51,-18,36
St Mirren,7314,10,8,10,18,43,64,-21,34
Morton,7315,1,20,9,7,55,39,16,69
Hibernian,7315,2,18,13,5,57,25,32,67
Falkirk,7315,3,16,11,9,63,42,21,59
Dundee Utd,7315,4,15,10,11,49,42,7,55
Queen of S't,7315,5,13,8,15,46,51,-5,47
Raith,7315,6,11,9,16,36,50,-14,42
Ayr,7315,7,9,12,15,35,52,-17,39
Dumbarton,7315,8,9,11,16,46,57,-11,38
Dunfermline,7315,9,8,12,16,41,49,-8,36
St Mirren,7315,10,9,9,18,39,60,-21,36
Hibernian,7316,1,19,13,4,53,23,30,70
Morton,7316,2,17,11,8,46,33,13,62
Dundee Utd,7316,3,17,9,10,53,37,16,60
Falkirk,7316,4,16,9,11,58,48,10,57
Queen of S't,7316,5,11,12,13,41,46,-5,45
Dunfermline,7316,6,9,13,14,43,46,-3,40
Dumbarton,7316,7,9,13,14,45,55,-10,40
Raith,7316,8,9,12,15,34,47,-13,39
Ayr,7316,9,8,12,16,33,51,-18,36
St Mirren,7316,10,8,10,18,39,59,-20,34
Hibernian,7317,1,20,12,4,56,27,29,72
Morton,7317,2,15,13,8,51,43,8,58
Dundee Utd,7317,3,15,11,10,53,43,10,56
Falkirk,7317,4,14,11,11,56,46,10,53
Queen of S't,7317,5,12,10,14,41,44,-3,46
Raith,7317,6,11,11,14,39,45,-6,44
Dunfermline,7317,7,10,12,14,47,47,0,42
Dumbarton,7317,8,9,11,16,48,59,-11,38
Ayr,7317,9,7,15,14,31,53,-22,36
St Mirren,7317,10,7,14,15,41,56,-15,35
Hibernian,7318,1,19,13,4,59,27,32,70
Falkirk,7318,2,17,12,7,63,37,26,63
Morton,7318,3,17,11,8,50,40,10,62
Dundee Utd,7318,4,15,12,9,51,41,10,57
Dunfermline,7318,5,11,12,13,46,47,-1,45
Dumbarton,7318,6,10,12,14,50,59,-9,42
Raith,7318,7,9,10,17,33,51,-18,37
Queen of S't,7318,8,9,9,18,43,55,-12,36
St Mirren,7318,9,8,11,17,38,56,-18,35
Ayr,7318,10,6,16,14,33,53,-20,34
Hibernian,7319,1,20,11,5,60,23,37,71
Dundee Utd,7319,2,17,9,10,56,40,16,60
Falkirk,7319,3,16,10,10,55,39,16,58
Morton,7319,4,15,11,10,47,43,4,56
Dunfermline,7319,5,11,12,13,47,48,-1,45
Dumbarton,7319,6,11,11,14,45,51,-6,44
Ayr,7319,7,10,13,13,38,50,-12,43
Queen of S't,7319,8,10,9,17,39,55,-16,39
Raith,7319,9,9,10,17,33,49,-16,37
St Mirren,7319,10,8,10,18,38,60,-22,34
Hibernian,7320,1,19,12,5,55,28,27,69
Morton,7320,2,16,12,8,47,34,13,60
Dundee Utd,7320,3,16,9,11,54,44,10,57
Falkirk,7320,4,14,10,12,58,51,7,52
Queen of S't,7320,5,12,10,14,49,49,0,46
Dunfermline,7320,6,10,14,12,52,53,-1,44
Raith,7320,7,10,11,15,37,48,-11,41
Ayr,7320,8,10,11,15,40,61,-21,41
St Mirren,7320,9,9,11,16,45,54,-9,38
Dumbarton,7320,10,9,10,17,50,65,-15,37
Hibernian,7321,1,21,12,3,61,23,38,75
Morton,7321,2,17,11,8,51,35,16,62
Falkirk,7321,3,16,10,10,58,40,18,58
Dundee Utd,7321,4,15,10,11,51,44,7,55
Queen of S't,7321,5,13,10,13,51,51,0,49
Dumbarton,7321,6,10,11,15,49,61,-12,41
Dunfermline,7321,7,9,13,14,45,50,-5,40
St Mirren,7321,8,8,12,16,38,56,-18,36
Raith,7321,9,9,9,18,31,52,-21,36
Ayr,7321,10,7,12,17,33,56,-23,33
Hibernian,7322,1,21,11,4,58,24,34,74
Morton,7322,2,18,11,7,52,34,18,65
Dundee Utd,7322,3,17,9,10,52,39,13,60
Falkirk,7322,4,14,11,11,54,44,10,53
Queen of S't,7322,5,14,8,14,46,48,-2,50
Dunfermline,7322,6,9,14,13,47,52,-5,41
Raith,7322,7,10,11,15,35,47,-12,41
Dumbarton,7322,8,9,10,17,47,59,-12,37
St Mirren,7322,9,7,12,17,37,54,-17,33
Ayr,7322,10,7,11,18,31,58,-27,32
Hibernian,7323,1,18,12,6,53,29,24,66
Dundee Utd,7323,2,17,8,11,55,40,15,59
Morton,7323,3,15,10,11,48,39,9,55
Falkirk,7323,4,14,10,12,52,44,8,52
Dunfermline,7323,5,13,12,11,52,48,4,51
Queen of S't,7323,6,14,9,13,51,51,0,51
St Mirren,7323,7,11,9,16,45,54,-9,42
Dumbarton,7323,8,9,12,15,45,56,-11,39
Raith,7323,9,10,9,17,32,51,-19,39
Ayr,7323,10,8,11,17,36,57,-21,35
Hibernian,7324,1,20,12,4,53,21,32,72
Morton,7324,2,18,12,6,52,33,19,66
Falkirk,7324,3,17,9,10,56,39,17,60
Dundee Utd,7324,4,15,9,12,52,44,8,54
Queen of S't,7324,5,14,10,12,46,45,1,52
Raith,7324,6,10,10,16,36,50,-14,40
Dumbarton,7324,7,10,10,16,48,64,-16,40
Dunfermline,7324,8,8,13,15,46,57,-11,37
St Mirren,7324,9,8,10,18,40,52,-12,34
Ayr,7324,10,7,11,18,33,57,-24,32
Hibernian,7325,1,19,11,6,53,29,24,68
Morton,7325,2,16,12,8,55,42,13,60
Dundee Utd,7325,3,15,11,10,48,37,11,56
Falkirk,7325,4,14,11,11,58,47,11,53
Dunfermline,7325,5,11,13,12,55,53,2,46
Raith,7325,6,12,10,14,40,47,-7,46
St Mirren,7325,7,11,10,15,44,51,-7,43
Queen of S't,7325,8,10,10,16,46,54,-8,40
Ayr,7325,9,7,15,14,30,50,-20,36
Dumbarton,7325,10,8,11,17,44,63,-19,35
Hibernian,7326,1,19,13,4,58,27,31,70
Morton,7326,2,19,11,6,51,34,17,68
Dundee Utd,7326,3,18,8,10,50,37,13,62
Falkirk,7326,4,15,10,11,53,40,13,55
Queen of S't,7326,5,12,10,14,49,50,-1,46
St Mirren,7326,6,10,10,16,49,55,-6,40
Dumbarton,7326,7,9,12,15,48,60,-12,39
Raith,7326,8,10,8,18,32,49,-17,38
Dunfermline,7326,9,8,12,16,42,50,-8,36
Ayr,7326,10,7,12,17,34,64,-30,33
Hibernian,7327,1,19,14,3,62,26,36,71
Morton,7327,2,17,14,5,56,35,21,65
Dundee Utd,7327,3,16,10,10,48,43,5,58
Falkirk,7327,4,14,10,12,55,43,12,52
Queen of S't,7327,5,12,9,15,48,55,-7,45
Dunfermline,7327,6,9,15,12,46,49,-3,42
Dumbarton,7327,7,10,12,14,49,56,-7,42
St Mirren,7327,8,9,10,17,36,52,-16,37
Raith,7327,9,9,10,17,34,50,-16,37
Ayr,7327,10,8,10,18,35,60,-25,34
Hibernian,7328,1,18,12,6,53,28,25,66
Morton,7328,2,18,11,7,56,41,15,65
Dundee Utd,7328,3,16,10,10,56,45,11,58
Falkirk,7328,4,13,13,10,54,42,12,52
Queen of S't,7328,5,12,10,14,49,50,-1,46
Dumbarton,7328,6,10,11,15,47,57,-10,41
Raith,7328,7,10,10,16,39,53,-14,40
Dunfermline,7328,8,9,12,15,48,51,-3,39
St Mirren,7328,9,9,11,16,40,55,-15,38
Ayr,7328,10,8,14,14,36,56,-20,38
Hibernian,7329,1,18,13,5,56,26,30,67
Falkirk,7329,2,18,10,8,59,36,23,64
Morton,7329,3,15,13,8,52,38,14,58
Dundee Utd,7329,4,13,11,12,42,41,1,50
Dunfermline,7329,5,12,13,11,50,44,6,49
Dumbarton,7329,6,11,11,14,52,56,-4,44
Queen of S't,7329,7,10,12,14,41,48,-7,42
Raith,7329,8,10,11,15,35,49,-14,41
Ayr,7329,9,7,13,16,36,60,-24,34
St Mirren,7329,10,7,11,18,37,62,-25,32
Hibernian,7330,1,18,15,3,56,26,30,69
Morton,7330,2,16,15,5,54,34,20,63
Falkirk,7330,3,14,12,10,59,47,12,54
Dundee Utd,7330,4,14,10,12,47,43,4,52
Queen of S't,7330,5,13,8,15,47,50,-3,47
Dumbarton,7330,6,12,10,14,54,58,-4,46
Raith,7330,7,9,12,15,35,49,-14,39
Dunfermline,7330,8,8,13,15,44,54,-10,37
Ayr,7330,9,8,13,15,36,53,-17,37
St Mirren,7330,10,8,12,16,43,61,-18,36
Hibernian,7331,1,21,12,3,59,25,34,75
Falkirk,7331,2,18,10,8,64,39,25,64
Morton,7331,3,16,11,9,51,39,12,59
Dundee Utd,7331,4,15,10,11,54,44,10,55
Queen of S't,7331,5,12,9,15,49,55,-6,45
Ayr,7331,6,9,13,14,33,54,-21,40
Dunfermline,7331,7,9,12,15,44,54,-10,39
Dumbarton,7331,8,9,11,16,49,60,-11,38
Raith,7331,9,9,10,17,35,49,-14,37
St Mirren,7331,10,8,10,18,38,57,-19,34
Hibernian,7332,1,18,13,5,52,25,27,67
Morton,7332,2,18,10,8,49,36,13,64
Falkirk,7332,3,17,10,9,62,38,24,61
Dundee Utd,7332,4,14,10,12,44,45,-1,52
Queen of S't,7332,5,13,8,15,47,53,-6,47
Dunfermline,7332,6,11,13,12,48,44,4,46
Raith,7332,7,10,11,15,38,50,-12,41
Dumbarton,7332,8,9,12,15,49,57,-8,39
St Mirren,7332,9,9,11,16,40,54,-14,38
Ayr,7332,10,6,12,18,31,58,-27,30
Hibernian,7333,1,20,11,5,57,24,33,71
Falkirk,7333,2,19,10,7,60,38,22,67
Morton,7333,3,16,12,8,51,38,13,60
Dundee Utd,7333,4,16,9,11,48,36,12,57
Queen of S't,7333,5,13,9,14,42,46,-4,48
Dunfermline,7333,6,9,13,14,42,51,-9,40
Raith,7333,7,10,9,17,34,48,-14,39
St Mirren,7333,8,9,9,18,39,55,-16,36
Dumbarton,7333,9,8,11,17,45,58,-13,35
Ayr,7333,10,7,13,16,33,57,-24,34
Hibernian,7334,1,19,12,5,56,29,27,69
Morton,7334,2,16,11,9,50,38,12,59
Falkirk,7334,3,15,13,8,56,39,17,58
Dundee Utd,7334,4,15,9,12,49,43,6,54
Dunfermline,7334,5,12,12,12,52,48,4,48
Raith,7334,6,12,9,15,38,46,-8,45
Queen of S't,7334,7,11,10,15,47,54,-7,43
Dumbarton,7334,8,10,10,16,51,62,-11,40
St Mirren,7334,9,8,12,16,38,54,-16,36
Ayr,7334,10,7,12,17,33,57,-24,33
Hibernian,7335,1,20,10,6,54,24,30,70
Morton,7335,2,19,11,6,48,30,18,68
Falkirk,7335,3,17,9,10,59,40,19,60
Dundee Utd,7335,4,15,8,13,52,42,10,53
Dunfermline,7335,5,12,12,12,46,44,2,48
Raith,7335,6,10,10,16,32,48,-16,40
Queen of S't,7335,7,10,9,17,40,50,-10,39
Ayr,7335,8,9,12,15,36,56,-20,39
Dumbarton,7335,9,9,11,16,47,61,-14,38
St Mirren,7335,10,8,10,18,38,57,-19,34
Hibernian,7336,1,17,13,6,53,30,23,64
Falkirk,7336,2,16,11,9,54,36,18,59
Dundee Utd,7336,3,16,9,11,52,41,11,57
Morton,7336,4,16,9,11,45,39,6,57
Dunfermline,7336,5,11,13,12,48,43,5,46
Raith,7336,6,11,11,14,34,45,-11,44
Ayr,7336,7,11,11,14,36,52,-16,44
Queen of S't,7336,8,11,10,15,46,50,-4,43
Dumbarton,7336,9,9,12,15,48,60,-12,39
St Mirren,7336,10,7,11,18,38,58,-20,32
Hibernian,7337,1,19,12,5,55,26,29,69
Morton,7337,2,18,10,8,49,34,15,64
Falkirk,7337,3,15,10,11,54,41,13,55
Dundee Utd,7337,4,15,10,11,45,41,4,55
Queen of S't,7337,5,12,10,14,46,51,-5,46
Dunfermline,7337,6,10,13,13,42,43,-1,43
St Mirren,7337,7,11,10,15,45,54,-9,43
Dumbarton,7337,8,9,12,15,50,59,-9,39
Raith,7337,9,10,9,17,35,49,-14,39
Ayr,7337,10,8,10,18,36,59,-23,34
Hibernian,7338,1,19,12,5,56,28,28,69
Morton,7338,2,17,11,8,52,37,15,62
Falkirk,7338,3,17,10,9,57,38,19,61
Dundee Utd,7338,4,14,11,11,49,40,9,53
Queen of S't,7338,5,13,9,14,48,51,-3,48
Dunfermline,7338,6,11,11,14,47,50,-3,44
Raith,7338,7,10,10,16,33,45,-12,40
Ayr,7338,8,8,14,14,37,56,-19,38
Dumbarton,7338,9,8,12,16,45,58,-13,36
St Mirren,7338,10,8,10,18,35,56,-21,34
Hibernian,7339,1,19,13,4,55,23,32,70
Morton,7339,2,16,11,9,51,36,15,59
Dundee Utd,7339,3,16,10,10,49,35,14,58
Falkirk,7339,4,15,12,9,57,38,19,57
Dumbarton,7339,5,11,11,14,54,60,-6,44
Raith,7339,6,11,10,15,38,47,-9,43
Queen of S't,7339,7,10,10,16,46,57,-11,40
Dunfermline,7339,8,8,14,14,39,49,-10,38
Ayr,7339,9,9,11,16,34,58,-24,38
St Mirren,7339,10,8,12,16,40,60,-20,36
Hibernian,7340,1,21,12,3,59,25,34,75
Dundee Utd,7340,2,16,11,9,53,42,11,59
Morton,7340,3,15,13,8,48,36,12,58
Falkirk,7340,4,14,14,8,58,43,15,56
Dunfermline,7340,5,10,14,12,50,46,4,44
Dumbarton,7340,6,8,15,13,48,57,-9,39
Raith,7340,7,9,11,16,33,52,-19,38
Queen of S't,7340,8,9,10,17,47,57,-10,37
St Mirren,7340,9,8,12,16,39,54,-15,36
Ayr,7340,10,7,14,15,33,56,-23,35
Hibernian,7341,1,21,11,4,58,26,32,74
Falkirk,7341,2,17,9,10,62,41,21,60
Morton,7341,3,17,9,10,51,41,10,60
Dundee Utd,7341,4,14,11,11,53,45,8,53
Queen of S't,7341,5,12,11,13,47,49,-2,47
Dunfermline,7341,6,11,11,14,50,57,-7,44
Dumbarton,7341,7,9,11,16,49,59,-10,38
St Mirren,7341,8,9,11,16,42,57,-15,38
Raith,7341,9,9,10,17,34,49,-15,37
Ayr,7341,10,8,12,16,34,56,-22,36
Hibernian,7342,1,18,13,5,55,29,26,67
Morton,7342,2,18,12,6,51,34,17,66
Falkirk,7342,3,16,10,10,60,45,15,58
Dundee Utd,7342,4,14,12,10,53,42,11,54
Queen of S't,7342,5,13,9,14,45,49,-4,48
Dunfermline,7342,6,11,12,13,50,48,2,45
Raith,7342,7,10,10,16,35,49,-14,40
Dumbarton,7342,8,9,12,15,51,60,-9,39
St Mirren,7342,9,7,12,17,37,54,-17,33
Ayr,7342,10,7,12,17,31,58,-27,33
Hibernian,7343,1,19,12,5,56,27,29,69
Falkirk,7343,2,17,11,8,60,40,20,62
Morton,7343,3,16,13,7,50,41,9,61
Dundee Utd,7343,4,15,10,11,46,40,6,55
Dunfermline,7343,5,11,14,11,51,46,5,47
Queen of S't,7343,6,12,9,15,50,52,-2,45
Ayr,7343,7,8,14,14,34,53,-19,38
Raith,7343,8,9,10,17,36,53,-17,37
Dumbarton,7343,9,7,13,16,50,65,-15,34
St Mirren,7343,10,7,12,17,40,56,-16,33
Morton,7344,1,18,13,5,50,30,20,67
Hibernian,7344,2,17,13,6,50,27,23,64
Falkirk,7344,3,18,9,9,61,41,20,63
Dundee Utd,7344,4,16,10,10,51,40,11,58
Dunfermline,7344,5,12,12,12,50,47,3,48
Raith,7344,6,10,11,15,37,48,-11,41
Queen of S't,7344,7,10,9,17,40,52,-12,39
St Mirren,7344,8,8,12,16,37,53,-16,36
Dumbarton,7344,9,8,11,17,50,65,-15,35
Ayr,7344,10,7,12,17,33,56,-23,33
Hibernian,7345,1,19,12,5,57,27,30,69
Dundee Utd,7345,2,19,9,8,51,36,15,66
Morton,7345,3,17,10,9,48,38,10,61
Falkirk,7345,4,17,9,10,56,40,16,60
Dumbarton,7345,5,11,11,14,51,53,-2,44
Dunfermline,7345,6,10,11,15,46,48,-2,41
Raith,7345,7,10,9,17,35,50,-15,39
Queen of S't,7345,8,9,11,16,43,56,-13,38
Ayr,7345,9,7,14,15,33,54,-21,35
St Mirren,7345,10,7,12,17,37,55,-18,33
Hibernian,7346,1,18,13,5,53,27,26,67
Morton,7346,2,17,10,9,51,38,13,61
Falkirk,7346,3,14,11,11,56,45,11,53
Dundee Utd,7346,4,14,11,11,52,44,8,53
Raith,7346,5,13,9,14,41,46,-5,48
Queen of S't,7346,6,11,11,14,41,47,-6,44
Dunfermline,7346,7,10,13,13,46,48,-2,43
St Mirren,7346,8,11,9,16,47,56,-9,42
Ayr,7346,9,9,11,16,34,59,-25,38
Dumbarton,7346,10,9,10,17,49,60,-11,37
Morton,7347,1,19,12,5,55,32,23,69
Falkirk,7347,2,17,11,8,57,38,19,62
Hibernian,7347,3,15,14,7,50,35,15,59
Dundee Utd,7347,4,15,11,10,52,41,11,56
Queen of S't,7347,5,15,8,13,52,47,5,53
Dumbarton,7347,6,9,12,15,49,57,-8,39
Dunfermline,7347,7,9,11,16,46,52,-6,38
St Mirren,7347,8,9,11,16,40,55,-15,38
Raith,7347,9,8,12,16,30,47,-17,36
Ayr,7347,10,6,14,16,35,62,-27,32
Morton,7348,1,18,12,6,47,33,14,66
Hibernian,7348,2,17,12,7,50,27,23,63
Falkirk,7348,3,18,9,9,57,39,18,63
Dundee Utd,7348,4,16,10,10,47,36,11,58
Raith,7348,5,12,8,16,39,50,-11,44
Queen of S't,7348,6,11,9,16,42,49,-7,42
Dunfermline,7348,7,9,13,14,48,50,-2,40
Dumbarton,7348,8,9,11,16,47,60,-13,38
St Mirren,7348,9,9,11,16,39,53,-14,38
Ayr,7348,10,8,11,17,32,51,-19,35
Hibernian,7349,1,18,12,6,51,25,26,66
Morton,7349,2,18,11,7,52,35,17,65
Falkirk,7349,3,16,10,10,63,43,20,58
Dundee Utd,7349,4,16,9,11,48,44,4,57
Queen of S't,7349,5,13,8,15,49,51,-2,47
Dumbarton,7349,6,11,11,14,52,56,-4,44
Dunfermline,7349,7,10,13,13,49,51,-2,43
Raith,7349,8,9,10,17,33,49,-16,37
St Mirren,7349,9,8,11,17,41,58,-17,35
Ayr,7349,10,8,11,17,34,60,-26,35
Hibernian,7350,1,20,12,4,59,27,32,72
Morton,7350,2,18,10,8,51,37,14,64
Dundee Utd,7350,3,17,10,9,54,41,13,61
Falkirk,7350,4,15,14,7,58,37,21,59
Dunfermline,7350,5,10,13,13,45,47,-2,43
Queen of S't,7350,6,10,10,16,46,55,-9,40
Ayr,7350,7,9,13,14,36,50,-14,40
Raith,7350,8,9,11,16,34,50,-16,38
Dumbarton,7350,9,7,13,16,49,68,-19,34
St Mirren,7350,10,6,12,18,35,55,-20,30
Hibernian,7351,1,19,13,4,52,24,28,70
Morton,7351,2,17,12,7,51,35,16,63
Falkirk,7351,3,16,10,10,60,42,18,58
Dundee Utd,7351,4,15,10,11,50,40,10,55
Ayr,7351,5,10,13,13,38,51,-13,43
Raith,7351,6,10,12,14,36,46,-10,42
Queen of S't,7351,7,10,11,15,40,48,-8,41
Dumbarton,7351,8,8,14,14,46,56,-10,38
Dunfermline,7351,9,8,12,16,43,57,-14,36
St Mirren,7351,10,8,11,17,36,53,-17,35
Hibernian,7352,1,19,13,4,52,23,29,70
Morton,7352,2,17,10,9,53,38,15,61
Falkirk,7352,3,16,12,8,58,37,21,60
Dundee Utd,7352,4,13,10,13,45,45,0,49
Queen of S't,7352,5,12,11,13,43,43,0,47
Dunfermline,7352,6,10,15,11,48,51,-3,45
Dumbarton,7352,7,10,11,15,49,59,-10,41
Ayr,7352,8,9,12,15,34,54,-20,39
Raith,7352,9,8,12,16,31,47,-16,36
St Mirren,7352,10,8,10,18,37,53,-16,34
Hibernian,7353,1,19,12,5,50,26,24,69
Falkirk,7353,2,18,9,9,66,39,27,63
Dundee Utd,7353,3,16,10,10,50,41,9,58
Morton,7353,4,15,11,10,49,39,10,56
Dunfermline,7353,5,12,13,11,53,46,7,49
Queen of S't,7353,6,11,10,15,44,53,-9,43
Raith,7353,7,10,9,17,36,52,-16,39
Ayr,7353,8,9,11,16,35,56,-21,38
St Mirren,7353,9,9,10,17,44,57,-13,37
Dumbarton,7353,10,8,11,17,42,60,-18,35
Hibernian,7354,1,20,12,4,57,24,33,72
Morton,7354,2,17,10,9,47,39,8,61
Falkirk,7354,3,15,13,8,53,37,16,58
Dundee Utd,7354,4,15,12,9,49,38,11,57
Queen of S't,7354,5,11,10,15,44,53,-9,43
Raith,7354,6,10,12,14,38,48,-10,42
Dunfermline,7354,7,8,14,14,48,52,-4,38
Dumbarton,7354,8,9,11,16,47,58,-11,38
St Mirren,7354,9,9,10,17,37,52,-15,37
Ayr,7354,10,8,12,16,31,50,-19,36
Hibernian,7355,1,20,11,5,53,25,28,71
Morton,7355,2,16,10,10,48,41,7,58
Falkirk,7355,3,15,10,11,51,38,13,55
Dundee Utd,7355,4,14,10,12,48,41,7,52
Queen of S't,7355,5,13,10,13,49,47,2,49
Dumbarton,7355,6,12,12,12,50,51,-1,48
Dunfermline,7355,7,10,12,14,46,49,-3,42
Raith,7355,8,11,9,16,37,48,-11,42
Ayr,7355,9,9,11,16,32,54,-22,38
St Mirren,7355,10,7,11,18,38,58,-20,32
Hibernian,7356,1,18,13,5,55,24,31,67
Morton,7356,2,17,13,6,46,32,14,64
Falkirk,7356,3,16,12,8,57,38,19,60
Dundee Utd,7356,4,16,10,10,50,41,9,58
Queen of S't,7356,5,13,9,14,45,50,-5,48
Raith,7356,6,11,10,15,38,49,-11,43
Dunfermline,7356,7,9,14,13,42,45,-3,41
Dumbarton,7356,8,8,12,16,45,59,-14,36
St Mirren,7356,9,8,10,18,42,57,-15,34
Ayr,7356,10,7,11,18,34,59,-25,32
Hibernian,7357,1,21,11,4,55,23,32,74
Falkirk,7357,2,16,10,10,62,42,20,58
Morton,7357,3,16,10,10,48,36,12,58
Dundee Utd,7357,4,15,11,10,48,40,8,56
Dunfermline,7357,5,11,13,12,49,49,0,46
Raith,7357,6,12,8,16,37,50,-13,44
Queen of S't,7357,7,10,10,16,42,49,-7,40
Dumbarton,7357,8,9,12,15,45,55,-10,39
St Mirren,7357,9,9,10,17,47,63,-16,37
Ayr,7357,10,7,13,16,31,57,-26,34
Hibernian,7358,1,20,12,4,61,28,33,72
Dundee Utd,7358,2,17,9,10,56,39,17,60
Falkirk,7358,3,16,11,9,60,42,18,59
Morton,7358,4,15,12,9,50,41,9,57
Queen of S't,7358,5,12,9,15,43,49,-6,45
Dunfermline,7358,6,9,15,12,47,50,-3,42
Raith,7358,7,11,8,17,34,53,-19,41
Dumbarton,7358,8,9,11,16,55,70,-15,38
St Mirren,7358,9,9,10,17,44,58,-14,37
Ayr,7358,10,8,11,17,39,59,-20,35
Hibernian,7359,1,21,10,5,64,31,33,73
Morton,7359,2,19,10,7,59,35,24,67
Falkirk,7359,3,15,13,8,56,38,18,58
Dundee Utd,7359,4,15,10,11,45,40,5,55
Queen of S't,7359,5,12,9,15,45,49,-4,45
Dunfermline,7359,6,10,12,14,49,55,-6,42
Dumbarton,7359,7,10,11,15,45,55,-10,41
Ayr,7359,8,8,13,15,32,51,-19,37
Raith,7359,9,9,8,19,32,55,-23,35
St Mirren,7359,10,8,10,18,39,57,-18,34
Hibernian,7360,1,19,13,4,59,26,33,70
Falkirk,7360,2,18,10,8,63,39,24,64
Morton,7360,3,17,11,8,53,39,14,62
Dundee Utd,7360,4,15,10,11,48,38,10,55
Dunfermline,7360,5,10,12,14,50,55,-5,42
Dumbarton,7360,6,9,13,14,50,58,-8,40
Queen of S't,7360,7,10,10,16,42,54,-12,40
Raith,7360,8,9,11,16,35,53,-18,38
St Mirren,7360,9,8,12,16,39,55,-16,36
Ayr,7360,10,8,12,16,34,56,-22,36
Hibernian,7361,1,18,13,5,55,26,29,67
Falkirk,7361,2,16,11,9,60,43,17,59
Dundee Utd,7361,3,16,11,9,51,40,11,59
Morton,7361,4,15,12,9,48,40,8,57
Dunfermline,7361,5,10,15,11,48,45,3,45
Queen of S't,7361,6,11,10,15,43,51,-8,43
Raith,7361,7,11,9,16,36,49,-13,42
St Mirren,7361,8,9,12,15,41,51,-10,39
Dumbarton,7361,9,9,10,17,47,60,-13,37
Ayr,7361,10,7,13,16,32,56,-24,34
Hibernian,7362,1,20,11,5,59,25,34,71
Morton,7362,2,19,12,5,54,35,19,69
Falkirk,7362,3,18,9,9,62,39,23,63
Dundee Utd,7362,4,16,11,9,53,38,15,59
Queen of S't,7362,5,12,10,14,43,47,-4,46
Ayr,7362,6,10,12,14,37,56,-19,42
Dunfermline,7362,7,8,14,14,41,47,-6,38
Dumbarton,7362,8,8,12,16,43,57,-14,36
Raith,7362,9,9,8,19,31,53,-22,35
St Mirren,7362,10,6,9,21,35,61,-26,27
Hibernian,7363,1,21,11,4,59,30,29,74
Morton,7363,2,17,13,6,55,35,20,64
Dundee Utd,7363,3,17,9,10,51,40,11,60
Falkirk,7363,4,14,10,12,56,48,8,52
Raith,7363,5,12,10,14,41,47,-6,46
Dumbarton,7363,6,9,13,14,47,56,-9,40
Queen of S't,7363,7,10,9,17,46,56,-10,39
Dunfermline,7363,8,8,14,14,44,50,-6,38
Ayr,7363,9,9,11,16,36,56,-20,38
St Mirren,7363,10,8,10,18,43,60,-17,34
Hibernian,7364,1,18,12,6,52,27,25,66
Morton,7364,2,16,13,7,54,40,14,61
Dundee Utd,7364,3,16,9,11,50,40,10,57
Falkirk,7364,4,14,12,10,55,41,14,54
Queen of S't,7364,5,12,11,13,45,45,0,47
Dunfermline,7364,6,10,14,12,46,46,0,44
Ayr,7364,7,10,12,14,35,55,-20,42
Dumbarton,7364,8,10,11,15,49,58,-9,41
St Mirren,7364,9,8,11,17,39,56,-17,35
Raith,7364,10,8,11,17,33,50,-17,35
Hibernian,7365,1,18,13,5,51,24,27,67
Morton,7365,2,18,11,7,53,35,18,65
Falkirk,7365,3,17,10,9,58,40,18,61
Dundee Utd,7365,4,15,10,11,50,44,6,55
Queen of S't,7365,5,12,9,15,48,47,1,45
Dumbarton,7365,6,10,13,13,48,54,-6,43
Raith,7365,7,11,9,16,38,49,-11,42
Dunfermline,7365,8,8,13,15,45,56,-11,37
St Mirren,7365,9,9,9,18,38,59,-21,36
Ayr,7365,10,8,11,17,33,54,-21,35
Hibernian,7366,1,20,12,4,57,26,31,72
Morton,7366,2,17,10,9,48,35,13,61
Dundee Utd,7366,3,16,10,10,53,41,12,58
Falkirk,7366,4,14,13,9,57,43,14,55
Queen of S't,7366,5,14,10,12,51,45,6,52
Raith,7366,6,10,11,15,38,49,-11,41
Dunfermline,7366,7,9,13,14,43,52,-9,40
Ayr,7366,8,7,15,14,33,54,-21,36
St Mirren,7366,9,8,10,18,41,58,-17,34
Dumbarton,7366,10,8,10,18,43,61,-18,34
Hibernian,7367,1,21,10,5,56,26,30,73
Morton,7367,2,17,12,7,51,36,15,63
Falkirk,7367,3,17,9,10,58,40,18,60
Dundee Utd,7367,4,17,8,11,51,42,9,59
Queen of S't,7367,5,13,9,14,49,49,0,48
Dunfermline,7367,6,10,13,13,48,51,-3,43
Dumbarton,7367,7,9,11,16,47,59,-12,38
Raith,7367,8,9,11,16,33,47,-14,38
Ayr,7367,9,8,10,18,32,57,-25,34
St Mirren,7367,10,8,9,19,37,55,-18,33
Morton,7368,1,19,12,5,53,32,21,69
Hibernian,7368,2,17,14,5,49,24,25,65
Dundee Utd,7368,3,18,8,10,52,37,15,62
Falkirk,7368,4,16,11,9,56,43,13,59
Queen of S't,7368,5,13,8,15,48,50,-2,47
Dunfermline,7368,6,11,13,12,50,49,1,46
Ayr,7368,7,10,11,15,35,52,-17,41
Dumbarton,7368,8,8,11,17,44,56,-12,35
Raith,7368,9,8,8,20,30,51,-21,32
St Mirren,7368,10,7,10,19,36,59,-23,31
Hibernian,7369,1,22,10,4,58,23,35,76
Falkirk,7369,2,18,10,8,56,34,22,64
Dundee Utd,7369,3,16,8,12,51,42,9,56
Morton,7369,4,14,11,11,46,39,7,53
Dunfermline,7369,5,11,12,13,45,48,-3,45
Queen of S't,7369,6,10,10,16,40,48,-8,40
Dumbarton,7369,7,9,12,15,46,56,-10,39
Raith,7369,8,9,12,15,32,45,-13,39
Ayr,7369,9,8,13,15,34,56,-22,37
St Mirren,7369,10,8,12,16,38,55,-17,36
Hibernian,7370,1,19,12,5,58,25,33,69
Falkirk,7370,2,17,10,9,61,43,18,61
Morton,7370,3,17,9,10,48,41,7,60
Dundee Utd,7370,4,16,9,11,48,37,11,57
Dunfermline,7370,5,12,12,12,57,50,7,48
Queen of S't,7370,6,12,10,14,52,54,-2,46
St Mirren,7370,7,10,9,17,41,55,-14,39
Raith,7370,8,10,9,17,37,53,-16,39
Ayr,7370,9,8,12,16,33,58,-25,36
Dumbarton,7370,10,7,12,17,45,64,-19,33
Hibernian,7371,1,19,12,5,50,22,28,69
Morton,7371,2,17,12,7,46,32,14,63
Dundee Utd,7371,3,17,9,10,53,36,17,60
Falkirk,7371,4,16,10,10,55,38,17,58
Queen of S't,7371,5,10,11,15,44,51,-7,41
St Mirren,7371,6,10,10,16,39,52,-13,40
Dumbarton,7371,7,9,12,15,43,53,-10,39
Raith,7371,8,10,9,17,33,52,-19,39
Dunfermline,7371,9,8,14,14,42,51,-9,38
Ayr,7371,10,8,13,15,35,53,-18,37
Hibernian,7372,1,20,13,3,55,22,33,73
Dundee Utd,7372,2,18,9,9,55,37,18,63
Morton,7372,3,16,11,9,51,40,11,59
Falkirk,7372,4,15,10,11,53,41,12,55
Dumbarton,7372,5,12,10,14,49,52,-3,46
Dunfermline,7372,6,10,12,14,46,50,-4,42
Queen of S't,7372,7,11,9,16,44,53,-9,42
Raith,7372,8,9,10,17,33,48,-15,37
St Mirren,7372,9,8,11,17,35,54,-19,35
Ayr,7372,10,7,13,16,34,58,-24,34
Hibernian,7373,1,19,12,5,55,27,28,69
Morton,7373,2,19,10,7,51,35,16,67
Falkirk,7373,3,16,11,9,63,43,20,59
Dundee Utd,7373,4,15,9,12,51,44,7,54
Queen of S't,7373,5,12,8,16,48,49,-1,44
Ayr,7373,6,10,13,13,41,53,-12,43
Dunfermline,7373,7,10,12,14,43,49,-6,42
Raith,7373,8,10,10,16,36,50,-14,40
Dumbarton,7373,9,9,11,16,48,67,-19,38
St Mirren,7373,10,6,12,18,40,59,-19,30
Hibernian,7374,1,20,12,4,60,29,31,72
Dundee Utd,7374,2,17,10,9,51,39,12,61
Morton,7374,3,15,11,10,50,42,8,56
Falkirk,7374,4,15,9,12,58,45,13,54
Queen of S't,7374,5,12,11,13,48,51,-3,47
Dunfermline,7374,6,10,14,12,46,47,-1,44
Dumbarton,7374,7,10,11,15,53,62,-9,41
St Mirren,7374,8,9,11,16,43,55,-12,38
Raith,7374,9,9,9,18,32,49,-17,36
Ayr,7374,10,8,12,16,33,55,-22,36
Hibernian,7375,1,19,12,5,59,27,32,69
Dundee Utd,7375,2,18,9,9,56,40,16,63
Morton,7375,3,16,12,8,52,41,11,60
Falkirk,7375,4,15,12,9,64,42,22,57
Queen of S't,7375,5,12,9,15,43,45,-2,45
Raith,7375,6,12,8,16,34,51,-17,44
Dunfermline,7375,7,9,13,14,47,53,-6,40
St Mirren,7375,8,9,10,17,40,57,-17,37
Ayr,7375,9,8,12,16,31,55,-24,36
Dumbarton,7375,10,8,11,17,47,62,-15,35
Hibernian,7376,1,19,13,4,55,24,31,70
Falkirk,7376,2,18,11,7,63,39,24,65
Dundee Utd,7376,3,17,9,10,51,40,11,60
Morton,7376,4,16,12,8,49,39,10,60
Queen of S't,7376,5,12,10,14,47,49,-2,46
Raith,7376,6,12,10,14,37,44,-7,46
Dunfermline,7376,7,8,14,14,44,49,-5,38
Dumbarton,7376,8,9,11,16,52,63,-11,38
St Mirren,7376,9,8,9,19,38,60,-22,33
Ayr,7376,10,6,11,19,34,63,-29,29
Hibernian,7377,1,19,12,5,54,25,29,69
Morton,7377,2,17,10,9,46,33,13,61
Falkirk,7377,3,17,9,10,61,43,18,60
Dundee Utd,7377,4,15,11,10,55,43,12,56
Raith,7377,5,12,10,14,37,49,-12,46
Ayr,7377,6,11,12,13,42,51,-9,45
Dunfermline,7377,7,10,11,15,48,54,-6,41
Dumbarton,7377,8,10,10,16,46,62,-16,40
Queen of S't,7377,9,10,9,17,43,52,-9,39
St Mirren,7377,10,7,10,19,40,60,-20,31
Hibernian,7378,1,22,10,4,62,24,38,76
Dundee Utd,7378,2,18,10,8,58,37,21,64
Morton,7378,3,17,11,8,46,34,12,62
Falkirk,7378,4,16,11,9,57,41,16,59
Queen of S't,7378,5,10,11,15,40,50,-10,41
Raith,7378,6,9,12,15,35,49,-14,39
Dunfermline,7378,7,8,14,14,45,50,-5,38
Dumbarton,7378,8,8,12,16,47,59,-12,36
Ayr,7378,9,8,12,16,36,58,-22,36
St Mirren,7378,10,8,9,19,37,61,-24,33
Hibernian,7379,1,21,11,4,58,24,34,74
Morton,7379,2,16,13,7,51,38,13,61
Dundee Utd,7379,3,17,9,10,55,41,14,60
Falkirk,7379,4,15,11,10,60,47,13,56
Dumbarton,7379,5,11,11,14,58,62,-4,44
Dunfermline,7379,6,9,14,13,45,47,-2,41
Queen of S't,7379,7,10,10,16,45,55,-10,40
Raith,7379,8,9,11,16,36,52,-16,38
St Mirren,7379,9,9,10,17,41,58,-17,37
Ayr,7379,10,7,12,17,33,58,-25,33
Hibernian,7380,1,17,13,6,52,26,26,64
Morton,7380,2,18,9,9,52,38,14,63
Dundee Utd,7380,3,17,8,11,54,39,15,59
Falkirk,7380,4,15,12,9,59,43,16,57
Dunfermline,7380,5,12,11,13,46,42,4,47
Queen of S't,7380,6,12,11,13,47,48,-1,47
Dumbarton,7380,7,9,13,14,45,58,-13,40
Raith,7380,8,10,9,17,31,50,-19,39
Ayr,7380,9,8,12,16,31,54,-23,36
St Mirren,7380,10,8,10,18,37,56,-19,34
Hibernian,7381,1,20,11,5,59,30,29,71
Dundee Utd,7381,2,16,10,10,50,40,10,58
Morton,7381,3,15,12,9,49,38,11,57
Falkirk,7381,4,14,12,10,57,45,12,54
Dunfermline,7381,5,11,14,11,48,44,4,47
Queen of S't,7381,6,11,12,13,47,48,-1,45
Dumbarton,7381,7,10,11,15,48,59,-11,41
Raith,7381,8,9,10,17,34,54,-20,37
Ayr,7381,9,8,13,15,34,55,-21,37
St Mirren,7381,10,8,11,17,43,56,-13,35
Morton,7382,1,19,11,6,51,34,17,68
Hibernian,7382,2,18,12,6,54,33,21,66
Falkirk,7382,3,15,11,10,55,40,15,56
Dundee Utd,7382,4,13,10,13,45,46,-1,49
Ayr,7382,5,11,10,15,42,54,-12,43
Dumbarton,7382,6,10,12,14,49,55,-6,42
Queen of S't,7382,7,11,9,16,45,53,-8,42
Raith,7382,8,11,9,16,37,50,-13,42
St Mirren,7382,9,10,10,16,46,54,-8,40
Dunfermline,7382,10,8,14,14,40,45,-5,38
Hibernian,7383,1,19,14,3,57,25,32,71
Morton,7383,2,17,11,8,51,37,14,62
Dundee Utd,7383,3,18,8,10,48,38,10,62
Falkirk,7383,4,17,10,9,57,39,18,61
Queen of S't,7383,5,12,9,15,45,48,-3,45
Dunfermline,7383,6,10,12,14,48,52,-4,42
Raith,7383,7,11,9,16,36,49,-13,42
Dumbarton,7383,8,9,11,16,47,60,-13,38
St Mirren,7383,9,7,11,18,38,54,-16,32
Ayr,7383,10,6,13,17,32,57,-25,31
Hibernian,7384,1,17,13,6,52,29,23,64
Falkirk,7384,2,16,12,8,60,39,21,60
Dundee Utd,7384,3,17,9,10,51,37,14,60
Morton,7384,4,16,11,9,44,35,9,59
Dunfermline,7384,5,12,13,11,51,44,7,49
Queen of S't,7384,6,12,9,15,46,51,-5,45
Raith,7384,7,11,10,15,38,50,-12,43
Ayr,7384,8,9,12,15,39,56,-17,39
St Mirren,7384,9,8,10,18,38,60,-22,34
Dumbarton,7384,10,7,11,18,42,60,-18,32
Hibernian,7385,1,20,12,4,60,29,31,72
Morton,7385,2,17,10,9,52,40,12,61
Falkirk,7385,3,16,12,8,60,40,20,60
Dundee Utd,7385,4,16,8,12,48,42,6,56
Queen of S't,7385,5,11,10,15,47,51,-4,43
Dunfermline,7385,6,10,12,14,45,50,-5,42
St Mirren,7385,7,10,11,15,42,51,-9,41
Raith,7385,8,10,10,16,36,51,-15,40
Ayr,7385,9,8,12,16,32,52,-20,36
Dumbarton,7385,10,8,11,17,43,59,-16,35
Hibernian,7386,1,19,12,5,56,25,31,69
Morton,7386,2,17,11,8,52,38,14,62
Dundee Utd,7386,3,18,8,10,55,42,13,62
Falkirk,7386,4,15,12,9,59,42,17,57
Queen of S't,7386,5,13,10,13,46,46,0,49
Dunfermline,7386,6,10,11,15,47,55,-8,41
Ayr,7386,7,9,11,16,37,55,-18,38
Dumbarton,7386,8,8,13,15,49,61,-12,37
St Mirren,7386,9,9,10,17,41,58,-17,37
Raith,7386,10,9,8,19,31,51,-20,35
Hibernian,7387,1,19,14,3,57,25,32,71
Falkirk,7387,2,17,11,8,59,38,21,62
Morton,7387,3,16,14,6,49,32,17,62
Dundee Utd,7387,4,15,11,10,52,39,13,56
Queen of S't,7387,5,13,9,14,49,49,0,48
Ayr,7387,6,9,13,14,35,52,-17,40
Dumbarton,7387,7,9,10,17,48,63,-15,37
Dunfermline,7387,8,8,13,15,42,58,-16,37
Raith,7387,9,8,10,18,31,48,-17,34
St Mirren,7387,10,7,13,16,38,56,-18,34
Hibernian,7388,1,18,13,5,55,25,30,67
Morton,7388,2,18,12,6,56,37,19,66
Dundee Utd,7388,3,17,9,10,51,40,11,60
Falkirk,7388,4,15,11,10,54,38,16,56
Queen of S't,7388,5,13,8,15,47,51,-4,47
Dunfermline,7388,6,10,13,13,48,53,-5,43
Raith,7388,7,9,12,15,36,51,-15,39
Dumbarton,7388,8,8,13,15,46,57,-11,37
St Mirren,7388,9,8,12,16,41,55,-14,36
Ayr,7388,10,6,13,17,31,58,-27,31
Hibernian,7389,1,21,11,4,62,28,34,74
Falkirk,7389,2,15,13,8,61,41,20,58
Morton,7389,3,14,13,9,45,36,9,55
Dundee Utd,7389,4,15,9,12,49,45,4,54
Queen of S't,7389,5,11,12,13,51,50,1,45
Dunfermline,7389,6,9,14,13,46,50,-4,41
Dumbarton,7389,7,9,14,13,49,56,-7,41
Raith,7389,8,9,13,14,34,46,-12,40
Ayr,7389,9,9,12,15,35,57,-22,39
St Mirren,7389,10,7,11,18,35,58,-23,32
Hibernian,7390,1,20,11,5,53,23,30,71
Morton,7390,2,17,11,8,51,41,10,62
Falkirk,7390,3,16,12,8,61,38,23,60
Dundee Utd,7390,4,14,12,10,48,40,8,54
Queen of S't,7390,5,12,10,14,47,51,-4,46
Raith,7390,6,12,9,15,42,48,-6,45
Dunfermline,7390,7,10,13,13,46,51,-5,43
Dumbarton,7390,8,9,12,15,48,57,-9,39
Ayr,7390,9,7,14,15,32,53,-21,35
St Mirren,7390,10,6,10,20,36,62,-26,28
Hibernian,7391,1,22,11,3,57,23,34,77
Falkirk,7391,2,17,10,9,61,42,19,61
Dundee Utd,7391,3,16,9,11,57,45,12,57
Morton,7391,4,16,9,11,46,41,5,57
Dunfermline,7391,5,11,14,11,44,41,3,47
Queen of S't,7391,6,12,9,15,48,53,-5,45
Raith,7391,7,10,8,18,35,51,-16,38
Dumbarton,7391,8,8,13,15,47,59,-12,37
Ayr,7391,9,8,11,17,35,57,-22,35
St Mirren,7391,10,8,10,18,38,56,-18,34
Hibernian,7392,1,20,12,4,60,27,33,72
Falkirk,7392,2,18,9,9,63,44,19,63
Dundee Utd,7392,3,18,8,10,55,37,18,62
Morton,7392,4,17,10,9,54,40,14,61
Dunfermline,7392,5,12,11,13,49,48,1,47
Queen of S't,7392,6,10,11,15,44,52,-8,41
Raith,7392,7,10,10,16,34,50,-16,40
Dumbarton,7392,8,8,12,16,46,61,-15,36
St Mirren,7392,9,8,10,18,37,55,-18,34
Ayr,7392,10,7,11,18,31,59,-28,32
Morton,7393,1,19,10,7,51,35,16,67
Hibernian,7393,2,17,14,5,51,22,29,65
Falkirk,7393,3,16,11,9,55,38,17,59
Dundee Utd,7393,4,16,10,10,51,44,7,58
Queen of S't,7393,5,12,8,16,43,49,-6,44
Dumbarton,7393,6,10,13,13,53,56,-3,43
Dunfermline,7393,7,8,15,13,41,45,-4,39
Raith,7393,8,9,12,15,33,47,-14,39
Ayr,7393,9,8,12,16,34,54,-20,36
St Mirren,7393,10,7,11,18,38,60,-22,32
Hibernian,7394,1,18,12,6,53,28,25,66
Falkirk,7394,2,18,11,7,67,41,26,65
Morton,7394,3,15,15,6,48,33,15,60
Dundee Utd,7394,4,15,10,11,46,41,5,55
Queen of S't,7394,5,12,11,13,47,48,-1,47
Dunfermline,7394,6,10,13,13,48,51,-3,43
Dumbarton,7394,7,9,12,15,46,56,-10,39
Raith,7394,8,10,9,17,38,49,-11,39
St Mirren,7394,9,9,11,16,44,61,-17,38
Ayr,7394,10,6,12,18,31,60,-29,30
Hibernian,7395,1,19,11,6,52,25,27,68
Morton,7395,2,18,12,6,57,31,26,66
Falkirk,7395,3,18,10,8,63,38,25,64
Dundee Utd,7395,4,16,9,11,52,38,14,57
Queen of S't,7395,5,12,11,13,43,47,-4,47
Dunfermline,7395,6,9,16,11,45,45,0,43
St Mirren,7395,7,9,9,18,38,56,-18,36
Raith,7395,8,9,8,19,32,55,-23,35
Ayr,7395,9,8,11,17,31,54,-23,35
Dumbarton,7395,10,8,11,17,45,69,-24,35
Hibernian,7396,1,20,12,4,57,25,32,72
Falkirk,7396,2,16,11,9,60,40,20,59
Morton,7396,3,15,13,8,52,40,12,58
Dundee Utd,7396,4,12,12,12,44,44,0,48
Dunfermline,7396,5,11,14,11,53,51,2,47
Dumbarton,7396,6,11,11,14,49,54,-5,44
Ayr,7396,7,10,13,13,38,51,-13,43
Raith,7396,8,11,8,17,34,47,-13,41
Queen of S't,7396,9,10,9,17,40,51,-11,39
St Mirren,7396,10,7,11,18,36,60,-24,32
Hibernian,7397,1,20,11,5,57,23,34,71
Morton,7397,2,19,11,6,57,32,25,68
Dundee Utd,7397,3,16,11,9,56,41,15,59
Falkirk,7397,4,14,12,10,54,42,12,54
Queen of S't,7397,5,11,9,16,44,56,-12,42
Dumbarton,7397,6,10,11,15,53,64,-11,41
Ayr,7397,7,9,13,14,40,58,-18,40
Dunfermline,7397,8,9,12,15,44,55,-11,39
St Mirren,7397,9,9,10,17,42,57,-15,37
Raith,7397,10,8,10,18,35,54,-19,34
Hibernian,7398,1,20,12,4,53,24,29,72
Falkirk,7398,2,17,11,8,62,39,23,62
Morton,7398,3,15,12,9,43,35,8,57
Dundee Utd,7398,4,14,11,11,44,36,8,53
Queen of S't,7398,5,12,10,14,44,47,-3,46
Ayr,7398,6,11,11,14,36,50,-14,44
Dunfermline,7398,7,9,13,14,41,46,-5,40
St Mirren,7398,8,10,9,17,40,53,-13,39
Dumbarton,7398,9,8,13,15,48,58,-10,37
Raith,7398,10,8,10,18,33,56,-23,34
Hibernian,7399,1,21,11,4,59,24,35,74
Morton,7399,2,16,14,6,58,37,21,62
Falkirk,7399,3,16,10,10,60,39,21,58
Dundee Utd,7399,4,13,13,10,45,40,5,52
Dumbarton,7399,5,11,12,13,50,57,-7,45
Queen of S't,7399,6,11,10,15,48,54,-6,43
Raith,7399,7,11,9,16,39,52,-13,42
St Mirren,7399,8,10,9,17,48,65,-17,39
Dunfermline,7399,9,8,13,15,48,54,-6,37
Ayr,7399,10,7,11,18,32,65,-33,32
Hibernian,7400,1,17,14,5,49,23,26,65
Falkirk,7400,2,15,13,8,58,41,17,58
Morton,7400,3,16,10,10,49,43,6,58
Dundee Utd,7400,4,15,9,12,49,42,7,54
Raith,7400,5,11,11,14,39,46,-7,44
Dumbarton,7400,6,10,13,13,48,54,-6,43
Dunfermline,7400,7,10,12,14,45,48,-3,42
Queen of S't,7400,8,11,8,17,46,52,-6,41
St Mirren,7400,9,10,11,15,42,51,-9,41
Ayr,7400,10,8,13,15,32,57,-25,37
Hibernian,7401,1,21,12,3,56,20,36,75
Falkirk,7401,2,15,13,8,60,43,17,58
Dundee Utd,7401,3,16,10,10,54,38,16,58
Morton,7401,4,15,13,8,48,38,10,58
Queen of S't,7401,5,12,8,16,49,53,-4,44
Raith,7401,6,12,8,16,41,51,-10,44
Dunfermline,7401,7,9,14,13,44,49,-5,41
Ayr,7401,8,8,13,15,33,54,-21,37
Dumbarton,7401,9,8,12,16,48,64,-16,36
St Mirren,7401,10,7,11,18,38,61,-23,32
Hibernian,7402,1,19,13,4,56,26,30,70
Morton,7402,2,18,12,6,54,33,21,66
Falkirk,7402,3,14,13,9,58,42,16,55
Dundee Utd,7402,4,14,11,11,49,42,7,53
Queen of S't,7402,5,12,9,15,48,51,-3,45
Raith,7402,6,11,10,15,35,46,-11,43
Dunfermline,7402,7,9,14,13,44,47,-3,41
Ayr,7402,8,9,11,16,31,58,-27,38
Dumbarton,7402,9,8,13,15,46,56,-10,37
St Mirren,7402,10,7,12,17,40,60,-20,33
Hibernian,7403,1,19,11,6,53,25,28,68
Morton,7403,2,19,11,6,49,32,17,68
Dundee Utd,7403,3,14,12,10,46,40,6,54
Falkirk,7403,4,14,10,12,53,42,11,52
Queen of S't,7403,5,13,8,15,48,52,-4,47
Raith,7403,6,11,10,15,36,47,-11,43
Dunfermline,7403,7,10,12,14,49,51,-2,42
St Mirren,7403,8,10,9,17,43,53,-10,39
Ayr,7403,9,8,13,15,33,50,-17,37
Dumbarton,7403,10,9,10,17,48,66,-18,37
Hibernian,7404,1,19,14,3,64,27,37,71
Dundee Utd,7404,2,17,8,11,53,44,9,59
Morton,7404,3,15,12,9,45,42,3,57
Falkirk,7404,4,14,12,10,54,42,12,54
Dunfermline,7404,5,11,14,11,54,48,6,47
Dumbarton,7404,6,11,10,15,51,57,-6,43
Queen of S't,7404,7,11,10,15,46,52,-6,43
Raith,7404,8,9,12,15,33,48,-15,39
St Mirren,7404,9,8,11,17,37,55,-18,35
Ayr,7404,10,8,11,17,34,56,-22,35
Hibernian,7405,1,17,13,6,52,28,24,64
Falkirk,7405,2,17,11,8,60,39,21,62
Morton,7405,3,16,12,8,50,37,13,60
Dundee Utd,7405,4,15,11,10,54,42,12,56
Dunfermline,7405,5,11,13,12,48,47,1,46
Dumbarton,7405,6,10,12,14,47,53,-6,42
Queen of S't,7405,7,10,12,14,43,49,-6,42
Raith,7405,8,11,9,16,36,52,-16,42
St Mirren,7405,9,9,10,17,39,55,-16,37
Ayr,7405,10,7,11,18,32,59,-27,32
Hibernian,7406,1,18,14,4,54,26,28,68
Morton,7406,2,18,10,8,52,40,12,64
Falkirk,7406,3,15,12,9,58,42,16,57
Dundee Utd,7406,4,16,9,11,57,42,15,57
Queen of S't,7406,5,11,11,14,49,55,-6,44
Dunfermline,7406,6,9,14,13,44,50,-6,41
Dumbarton,7406,7,10,11,15,49,56,-7,41
St Mirren,7406,8,9,11,16,46,55,-9,38
Ayr,7406,9,9,11,16,38,61,-23,38
Raith,7406,10,8,11,17,35,55,-20,35
Hibernian,7407,1,19,11,6,53,27,26,68
Morton,7407,2,18,11,7,55,36,19,65
Dundee Utd,7407,3,17,9,10,60,44,16,60
Falkirk,7407,4,16,9,11,58,40,18,57
Queen of S't,7407,5,13,8,15,47,52,-5,47
Dunfermline,7407,6,11,12,13,47,50,-3,45
Raith,7407,7,11,9,16,39,51,-12,42
Ayr,7407,8,10,11,15,39,56,-17,41
St Mirren,7407,9,8,10,18,39,58,-19,34
Dumbarton,7407,10,7,10,19,42,65,-23,31
Hibernian,7408,1,21,10,5,57,25,32,73
Falkirk,7408,2,17,10,9,62,39,23,61
Dundee Utd,7408,3,16,9,11,49,40,9,57
Morton,7408,4,15,11,10,49,42,7,56
Dunfermline,7408,5,10,15,11,44,44,0,45
Raith,7408,6,12,9,15,35,44,-9,45
Queen of S't,7408,7,11,10,15,45,50,-5,43
Dumbarton,7408,8,10,11,15,51,61,-10,41
St Mirren,7408,9,8,9,19,41,60,-19,33
Ayr,7408,10,7,12,17,32,60,-28,33
Hibernian,7409,1,18,13,5,54,26,28,67
Morton,7409,2,17,13,6,54,36,18,64
Dundee Utd,7409,3,18,9,9,56,41,15,63
Falkirk,7409,4,15,12,9,56,39,17,57
Dunfermline,7409,5,11,13,12,48,47,1,46
Queen of S't,7409,6,10,10,16,41,50,-9,40
Raith,7409,7,10,9,17,36,51,-15,39
Ayr,7409,8,9,11,16,37,58,-21,38
Dumbarton,7409,9,8,12,16,49,63,-14,36
St Mirren,7409,10,8,10,18,40,60,-20,34
Falkirk,7410,1,17,10,9,61,39,22,61
Hibernian,7410,2,16,13,7,50,28,22,61
Dundee Utd,7410,3,16,10,10,52,42,10,58
Morton,7410,4,14,12,10,45,38,7,54
Dunfermline,7410,5,11,14,11,46,46,0,47
Queen of S't,7410,6,12,8,16,47,53,-6,44
Raith,7410,7,12,8,16,40,53,-13,44
St Mirren,7410,8,10,11,15,36,48,-12,41
Ayr,7410,9,9,11,16,36,52,-16,38
Dumbarton,7410,10,8,13,15,46,60,-14,37
Hibernian,7411,1,20,12,4,59,24,35,72
Dundee Utd,7411,2,17,9,10,55,45,10,60
Falkirk,7411,3,16,11,9,60,43,17,59
Morton,7411,4,14,13,9,49,42,7,55
Dunfermline,7411,5,10,13,13,47,47,0,43
Queen of S't,7411,6,10,12,14,43,49,-6,42
Raith,7411,7,10,11,15,34,48,-14,41
St Mirren,7411,8,10,10,16,45,56,-11,40
Dumbarton,7411,9,9,10,17,44,58,-14,37
Ayr,7411,10,7,13,16,35,59,-24,34
Hibernian,7412,1,20,12,4,61,27,34,72
Falkirk,7412,2,15,11,10,58,43,15,56
Morton,7412,3,13,16,7,45,36,9,55
Dundee Utd,7412,4,13,12,11,42,39,3,51
Dunfermline,7412,5,11,13,12,53,46,7,46
Queen of S't,7412,6,11,11,14,46,51,-5,44
Raith,7412,7,11,10,15,37,49,-12,43
Dumbarton,7412,8,9,13,14,49,59,-10,40
St Mirren,7412,9,8,12,16,38,56,-18,36
Ayr,7412,10,7,14,15,33,56,-23,35
Hibernian,7413,1,19,11,6,60,32,28,68
Morton,7413,2,19,11,6,54,32,22,68
Falkirk,7413,3,16,10,10,57,43,14,58
Dundee Utd,7413,4,14,10,12,46,41,5,52
Dunfermline,7413,5,12,11,13,47,49,-2,47
Queen of S't,7413,6,12,8,16,47,50,-3,44
Dumbarton,7413,7,9,12,15,48,59,-11,39
St Mirren,7413,8,9,11,16,42,54,-12,38
Raith,7413,9,10,8,18,34,54,-20,38
Ayr,7413,10,7,14,15,32,53,-21,35
Hibernian,7414,1,20,13,3,64,26,38,73
Falkirk,7414,2,18,10,8,61,40,21,64
Morton,7414,3,16,12,8,48,36,12,60
Dundee Utd,7414,4,15,10,11,54,45,9,55
Dunfermline,7414,5,11,13,12,47,47,0,46
Queen of S't,7414,6,11,10,15,47,54,-7,43
Raith,7414,7,10,12,14,35,45,-10,42
Dumbarton,7414,8,8,12,16,45,58,-13,36
St Mirren,7414,9,7,11,18,38,61,-23,32
Ayr,7414,10,6,13,17,32,59,-27,31
Hibernian,7415,1,21,11,4,57,25,32,74
Morton,7415,2,18,11,7,53,35,18,65
Falkirk,7415,3,16,10,10,59,41,18,58
Dundee Utd,7415,4,14,10,12,48,44,4,52
Queen of S't,7415,5,12,11,13,47,49,-2,47
Dumbarton,7415,6,10,12,14,48,56,-8,42
St Mirren,7415,7,10,9,17,39,55,-16,39
Ayr,7415,8,9,11,16,34,53,-19,38
Dunfermline,7415,9,8,12,16,39,47,-8,36
Raith,7415,10,9,9,18,32,51,-19,36
Hibernian,7416,1,21,11,4,61,26,35,74
Falkirk,7416,2,17,11,8,57,39,18,62
Morton,7416,3,15,14,7,50,36,14,59
Dundee Utd,7416,4,14,12,10,49,42,7,54
Dunfermline,7416,5,12,12,12,45,43,2,48
Raith,7416,6,11,9,16,37,50,-13,42
Queen of S't,7416,7,10,10,16,45,54,-9,40
St Mirren,7416,8,9,11,16,41,53,-12,38
Dumbarton,7416,9,7,12,17,46,61,-15,33
Ayr,7416,10,7,12,17,36,63,-27,33
Hibernian,7417,1,19,11,6,56,27,29,68
Falkirk,7417,2,16,10,10,56,41,15,58
Morton,7417,3,15,13,8,49,35,14,58
Dundee Utd,7417,4,15,11,10,49,40,9,56
Dunfermline,7417,5,10,13,13,48,48,0,43
Dumbarton,7417,6,10,13,13,49,55,-6,43
Queen of S't,7417,7,11,9,16,42,50,-8,42
St Mirren,7417,8,10,11,15,40,55,-15,41
Raith,7417,9,9,10,17,37,53,-16,37
Ayr,7417,10,8,13,15,36,58,-22,37
Hibernian,7418,1,18,13,5,52,25,27,67
Falkirk,7418,2,18,11,7,61,36,25,65
Morton,7418,3,17,11,8,52,33,19,62
Dundee Utd,7418,4,14,11,11,49,46,3,53
Queen of S't,7418,5,12,10,14,50,51,-1,46
Raith,7418,6,11,10,15,36,46,-10,43
Dunfermline,7418,7,9,13,14,42,48,-6,40
Ayr,7418,8,8,15,13,34,53,-19,39
Dumbarton,7418,9,7,13,16,47,61,-14,34
St Mirren,7418,10,8,9,19,38,62,-24,33
Morton,7419,1,21,9,6,63,33,30,72
Hibernian,7419,2,20,11,5,58,28,30,71
Falkirk,7419,3,17,9,10,57,43,14,60
Dundee Utd,7419,4,15,10,11,48,41,7,55
Queen of S't,7419,5,11,10,15,46,52,-6,43
Dumbarton,7419,6,9,12,15,50,60,-10,39
Dunfermline,7419,7,8,13,15,47,56,-9,37
Ayr,7419,8,8,13,15,39,57,-18,37
Raith,7419,9,9,10,17,35,55,-20,37
St Mirren,7419,10,8,11,17,38,56,-18,35
Hibernian,7420,1,21,12,3,62,26,36,75
Morton,7420,2,18,10,8,53,38,15,64
Dundee Utd,7420,3,17,10,9,55,37,18,61
Falkirk,7420,4,16,10,10,56,38,18,58
Queen of S't,7420,5,11,9,16,40,49,-9,42
Raith,7420,6,11,9,16,34,49,-15,42
Dunfermline,7420,7,9,13,14,42,50,-8,40
St Mirren,7420,8,9,10,17,45,53,-8,37
Dumbarton,7420,9,9,10,17,44,62,-18,37
Ayr,7420,10,7,11,18,34,63,-29,32
Hibernian,7421,1,20,11,5,55,28,27,71
Morton,7421,2,20,9,7,53,34,19,69
Dundee Utd,7421,3,15,9,12,46,39,7,54
Falkirk,7421,4,14,11,11,53,43,10,53
Queen of S't,7421,5,13,9,14,45,47,-2,48
Dunfermline,7421,6,10,12,14,49,53,-4,42
Dumbarton,7421,7,10,12,14,51,59,-8,42
Raith,7421,8,11,8,17,35,47,-12,41
Ayr,7421,9,8,11,17,35,53,-18,35
St Mirren,7421,10,8,10,18,37,56,-19,34
Hibernian,7422,1,21,12,3,58,26,32,75
Morton,7422,2,18,12,6,47,30,17,66
Dundee Utd,7422,3,16,9,11,48,38,10,57
Falkirk,7422,4,15,10,11,54,42,12,55
Dunfermline,7422,5,10,14,12,46,47,-1,44
Dumbarton,7422,6,11,10,15,52,58,-6,43
Queen of S't,7422,7,10,10,16,44,51,-7,40
Raith,7422,8,10,9,17,38,50,-12,39
Ayr,7422,9,8,13,15,30,49,-19,37
St Mirren,7422,10,6,11,19,35,61,-26,29
Morton,7423,1,19,12,5,58,32,26,69
Hibernian,7423,2,19,11,6,55,28,27,68
Falkirk,7423,3,15,12,9,57,39,18,57
Dundee Utd,7423,4,15,9,12,47,41,6,54
Dunfermline,7423,5,10,15,11,47,45,2,45
Queen of S't,7423,6,11,11,14,46,47,-1,44
St Mirren,7423,7,10,10,16,43,59,-16,40
Raith,7423,8,9,12,15,33,45,-12,39
Dumbarton,7423,9,8,12,16,42,62,-20,36
Ayr,7423,10,6,12,18,27,57,-30,30
Hibernian,7424,1,18,12,6,56,26,30,66
Morton,7424,2,19,9,8,52,36,16,66
Falkirk,7424,3,18,10,8,63,38,25,64
Dundee Utd,7424,4,18,10,8,51,35,16,64
Raith,7424,5,12,8,16,39,50,-11,44
Queen of S't,7424,6,11,9,16,47,59,-12,42
St Mirren,7424,7,10,10,16,42,57,-15,40
Dunfermline,7424,8,8,13,15,43,48,-5,37
Dumbarton,7424,9,7,13,16,42,57,-15,34
Ayr,7424,10,6,12,18,29,58,-29,30
Hibernian,7425,1,19,11,6,56,31,25,68
Morton,7425,2,19,9,8,51,37,14,66
Falkirk,7425,3,16,10,10,62,41,21,58
Dundee Utd,7425,4,15,11,10,51,38,13,56
Queen of S't,7425,5,13,10,13,47,50,-3,49
Dunfermline,7425,6,11,12,13,49,48,1,45
Dumbarton,7425,7,10,12,14,48,57,-9,42
Raith,7425,8,10,10,16,38,50,-12,40
Ayr,7425,9,8,11,17,33,58,-25,35
St Mirren,7425,10,6,10,20,36,61,-25,28
Hibernian,7426,1,17,13,6,53,30,23,64
Morton,7426,2,15,14,7,50,36,14,59
Falkirk,7426,3,15,13,8,57,40,17,58
Dundee Utd,7426,4,14,10,12,45,42,3,52
Queen of S't,7426,5,12,11,13,49,51,-2,47
St Mirren,7426,6,11,11,14,47,49,-2,44
Dunfermline,7426,7,10,13,13,47,45,2,43
Dumbarton,7426,8,9,13,14,47,55,-8,40
Raith,7426,9,10,9,17,35,52,-17,39
Ayr,7426,10,7,13,16,31,61,-30,34
Morton,7427,1,18,12,6,51,32,19,66
Dundee Utd,7427,2,18,9,9,53,39,14,63
Hibernian,7427,3,15,14,7,50,29,21,59
Falkirk,7427,4,15,12,9,55,40,15,57
Raith,7427,5,10,12,14,33,43,-10,42
Dunfermline,7427,6,9,14,13,43,50,-7,41
Queen of S't,7427,7,10,11,15,43,52,-9,41
St Mirren,7427,8,10,10,16,43,54,-11,40
Dumbarton,7427,9,9,11,16,46,57,-11,38
Ayr,7427,10,7,13,16,32,53,-21,34
Morton,7428,1,18,11,7,52,34,18,65
Hibernian,7428,2,17,12,7,53,28,25,63
Dundee Utd,7428,3,18,8,10,60,43,17,62
Falkirk,7428,4,16,10,10,56,42,14,58
Queen of S't,7428,5,14,10,12,49,46,3,52
Dunfermline,7428,6,10,13,13,46,48,-2,43
Dumbarton,7428,7,11,10,15,46,54,-8,43
Ayr,7428,8,9,11,16,34,57,-23,38
Raith,7428,9,8,9,19,30,49,-19,33
St Mirren,7428,10,7,10,19,37,62,-25,31
Hibernian,7429,1,21,12,3,56,21,35,75
Morton,7429,2,16,11,9,49,35,14,59
Dundee Utd,7429,3,15,10,11,46,39,7,55
Falkirk,7429,4,14,12,10,51,39,12,54
Dunfermline,7429,5,11,12,13,48,48,0,45
Raith,7429,6,10,11,15,37,51,-14,41
Queen of S't,7429,7,10,10,16,47,53,-6,40
Dumbarton,7429,8,10,10,16,46,62,-16,40
Ayr,7429,9,9,12,15,36,55,-19,39
St Mirren,7429,10,8,12,16,38,51,-13,36
Hibernian,7430,1,20,11,5,58,27,31,71
Morton,7430,2,17,10,9,51,39,12,61
Dundee Utd,7430,3,17,9,10,52,37,15,60
Falkirk,7430,4,15,10,11,54,41,13,55
Queen of S't,7430,5,13,10,13,47,48,-1,49
Dunfermline,7430,6,10,13,13,46,48,-2,43
St Mirren,7430,7,11,9,16,42,53,-11,42
Dumbarton,7430,8,9,11,16,49,60,-11,38
Raith,7430,9,9,8,19,35,53,-18,35
Ayr,7430,10,8,11,17,35,63,-28,35
Hibernian,7431,1,22,11,3,61,23,38,77
Dundee Utd,7431,2,17,9,10,54,38,16,60
Morton,7431,3,16,12,8,54,40,14,60
Falkirk,7431,4,16,9,11,58,49,9,57
Queen of S't,7431,5,11,11,14,46,54,-8,44
Raith,7431,6,10,10,16,37,51,-14,40
Dunfermline,7431,7,8,14,14,48,53,-5,38
Dumbarton,7431,8,9,10,17,53,66,-13,37
St Mirren,7431,9,9,10,17,40,56,-16,37
Ayr,7431,10,9,10,17,36,57,-21,37
Hibernian,7432,1,17,14,5,53,27,26,65
Morton,7432,2,17,12,7,51,37,14,63
Dundee Utd,7432,3,17,11,8,58,41,17,62
Falkirk,7432,4,15,11,10,56,43,13,56
Queen of S't,7432,5,11,12,13,47,48,-1,45
Dunfermline,7432,6,8,16,12,44,47,-3,40
Dumbarton,7432,7,9,11,16,48,59,-11,38
Raith,7432,8,10,8,18,31,51,-20,38
St Mirren,7432,9,9,10,17,41,58,-17,37
Ayr,7432,10,8,13,15,38,56,-18,37
Hibernian,7433,1,20,12,4,65,27,38,72
Morton,7433,2,16,14,6,51,34,17,62
Falkirk,7433,3,16,11,9,61,47,14,59
Dundee Utd,7433,4,14,10,12,46,44,2,52
Queen of S't,7433,5,13,10,13,52,49,3,49
Dunfermline,7433,6,9,15,12,43,48,-5,42
Dumbarton,7433,7,10,11,15,50,57,-7,41
Raith,7433,8,10,8,18,34,51,-17,38
St Mirren,7433,9,9,10,17,41,60,-19,37
Ayr,7433,10,7,11,18,33,59,-26,32
Hibernian,7434,1,19,12,5,54,25,29,69
Dundee Utd,7434,2,18,9,9,52,36,16,63
Falkirk,7434,3,16,9,11,60,45,15,57
Morton,7434,4,14,13,9,41,34,7,55
Dunfermline,7434,5,11,13,12,46,44,2,46
Raith,7434,6,12,8,16,36,44,-8,44
Queen of S't,7434,7,10,11,15,40,52,-12,41
Dumbarton,7434,8,9,11,16,45,54,-9,38
St Mirren,7434,9,9,11,16,38,53,-15,38
Ayr,7434,10,7,13,16,30,55,-25,34
Morton,7435,1,18,13,5,51,32,19,67
Hibernian,7435,2,17,12,7,53,31,22,63
Falkirk,7435,3,16,11,9,61,43,18,59
Dundee Utd,7435,4,16,10,10,50,41,9,58
Raith,7435,5,10,12,14,33,44,-11,42
Dunfermline,7435,6,9,14,13,47,48,-1,41
Queen of S't,7435,7,11,8,17,44,52,-8,41
Dumbarton,7435,8,9,13,14,50,57,-7,40
Ayr,7435,9,8,12,16,36,58,-22,36
St Mirren,7435,10,8,11,17,39,58,-19,35
Hibernian,7436,1,19,13,4,60,27,33,70
Morton,7436,2,19,9,8,55,35,20,66
Falkirk,7436,3,17,9,10,64,47,17,60
Dundee Utd,7436,4,16,8,12,51,41,10,56
St Mirren,7436,5,11,9,16,46,57,-11,42
Dumbarton,7436,6,10,11,15,48,60,-12,41
Raith,7436,7,10,10,16,38,50,-12,40
Dunfermline,7436,8,9,12,15,47,58,-11,39
Ayr,7436,9,9,11,16,35,54,-19,38
Queen of S't,7436,10,9,10,17,43,58,-15,37
Hibernian,7437,1,18,13,5,55,27,28,67
Morton,7437,2,18,10,8,55,37,18,64
Dundee Utd,7437,3,16,9,11,52,40,12,57
Falkirk,7437,4,15,10,11,57,46,11,55
Queen of S't,7437,5,11,12,13,45,49,-4,45
Dunfermline,7437,6,11,12,13,47,52,-5,45
Raith,7437,7,10,11,15,40,49,-9,41
St Mirren,7437,8,9,10,17,37,53,-16,37
Ayr,7437,9,8,13,15,32,53,-21,37
Dumbarton,7437,10,8,12,16,48,62,-14,36
Hibernian,7438,1,19,13,4,56,28,28,70
Dundee Utd,7438,2,18,8,10,57,42,15,62
Falkirk,7438,3,15,11,10,61,46,15,56
Morton,7438,4,15,11,10,50,43,7,56
Raith,7438,5,12,11,13,40,45,-5,47
Queen of S't,7438,6,12,9,15,47,51,-4,45
Dunfermline,7438,7,10,13,13,47,49,-2,43
Dumbarton,7438,8,9,11,16,50,62,-12,38
Ayr,7438,9,8,14,14,35,53,-18,38
St Mirren,7438,10,6,11,19,43,67,-24,29
Hibernian,7439,1,22,10,4,52,22,30,76
Morton,7439,2,18,11,7,52,32,20,65
Falkirk,7439,3,16,10,10,58,41,17,58
Dundee Utd,7439,4,16,9,11,51,41,10,57
Dunfermline,7439,5,10,13,13,43,43,0,43
Queen of S't,7439,6,11,9,16,45,53,-8,42
Raith,7439,7,10,10,16,37,51,-14,40
Ayr,7439,8,9,11,16,38,56,-18,38
Dumbarton,7439,9,9,10,17,46,63,-17,37
St Mirren,7439,10,8,9,19,39,59,-20,33
Hibernian,7440,1,19,11,6,56,29,27,68
Dundee Utd,7440,2,18,8,10,54,38,16,62
Morton,7440,3,16,13,7,51,39,12,61
Falkirk,7440,4,16,10,10,58,42,16,58
Dunfermline,7440,5,11,14,11,47,45,2,47
Raith,7440,6,10,11,15,33,47,-14,41
Queen of S't,7440,7,10,9,17,40,50,-10,39
St Mirren,7440,8,9,11,16,46,58,-12,38
Ayr,7440,9,9,11,16,36,57,-21,38
Dumbarton,7440,10,8,10,18,48,64,-16,34
Morton,7441,1,19,12,5,58,36,22,69
Hibernian,7441,2,18,12,6,57,27,30,66
Falkirk,7441,3,16,10,10,58,41,17,58
Dundee Utd,7441,4,14,12,10,55,49,6,54
Queen of S't,7441,5,12,10,14,47,51,-4,46
Dumbarton,7441,6,10,11,15,49,65,-16,41
Ayr,7441,7,9,13,14,41,55,-14,40
Dunfermline,7441,8,8,14,14,49,55,-6,38
Raith,7441,9,9,11,16,36,52,-16,38
St Mirren,7441,10,6,13,17,37,56,-19,31
Hibernian,7442,1,19,13,4,60,27,33,70
Morton,7442,2,16,11,9,48,40,8,59
Falkirk,7442,3,16,10,10,58,40,18,58
Dundee Utd,7442,4,16,9,11,49,40,9,57
Dunfermline,7442,5,11,13,12,48,49,-1,46
Queen of S't,7442,6,11,9,16,43,51,-8,42
St Mirren,7442,7,11,9,16,40,54,-14,42
Ayr,7442,8,10,11,15,34,50,-16,41
Raith,7442,9,9,11,16,35,49,-14,38
Dumbarton,7442,10,7,12,17,45,60,-15,33
Hibernian,7443,1,19,10,7,57,29,28,67
Morton,7443,2,17,12,7,56,39,17,63
Falkirk,7443,3,15,9,12,56,49,7,54
Queen of S't,7443,4,13,9,14,48,47,1,48
Dunfermline,7443,5,12,11,13,47,47,0,47
Dundee Utd,7443,6,12,10,14,44,47,-3,46
Raith,7443,7,12,10,14,41,49,-8,46
Dumbarton,7443,8,10,11,15,50,57,-7,41
St Mirren,7443,9,10,10,16,48,59,-11,40
Ayr,7443,10,9,10,17,34,58,-24,37
Hibernian,7444,1,19,12,5,56,24,32,69
Morton,7444,2,19,10,7,53,37,16,67
Dundee Utd,7444,3,18,8,10,52,37,15,62
Falkirk,7444,4,16,11,9,58,38,20,59
Dunfermline,7444,5,11,13,12,45,43,2,46
Queen of S't,7444,6,12,9,15,48,54,-6,45
St Mirren,7444,7,9,9,18,43,63,-20,36
Raith,7444,8,8,11,17,33,51,-18,35
Ayr,7444,9,7,14,15,35,57,-22,35
Dumbarton,7444,10,7,11,18,45,64,-19,32
Hibernian,7445,1,18,14,4,54,26,28,68
Falkirk,7445,2,16,11,9,61,41,20,59
Morton,7445,3,16,11,9,53,44,9,59
Dundee Utd,7445,4,15,10,11,47,41,6,55
Dumbarton,7445,5,12,11,13,51,53,-2,47
Raith,7445,6,12,10,14,44,48,-4,46
Dunfermline,7445,7,9,13,14,51,55,-4,40
Queen of S't,7445,8,10,9,17,45,59,-14,39
Ayr,7445,9,9,12,15,38,58,-20,39
St Mirren,7445,10,7,11,18,38,57,-19,32
Hibernian,7446,1,20,12,4,57,27,30,72
Morton,7446,2,17,12,7,53,37,16,63
Dundee Utd,7446,3,15,10,11,49,40,9,55
Falkirk,7446,4,15,9,12,56,43,13,54
Queen of S't,7446,5,14,8,14,46,45,1,50
Dunfermline,7446,6,11,12,13,48,47,1,45
Dumbarton,7446,7,11,11,14,50,58,-8,44
Raith,7446,8,9,9,18,34,53,-19,36
St Mirren,7446,9,8,11,17,41,62,-21,35
Ayr,7446,10,8,10,18,34,56,-22,34
Hibernian,7447,1,20,11,5,60,22,38,71
Morton,7447,2,19,11,6,56,35,21,68
Falkirk,7447,3,17,10,9,63,45,18,61
Dundee Utd,7447,4,15,10,11,50,42,8,55
Dunfermline,7447,5,11,13,12,48,48,0,46
Queen of S't,7447,6,10,10,16,38,53,-15,40
Dumbarton,7447,7,9,12,15,46,55,-9,39
Raith,7447,8,9,10,17,34,52,-18,37
Ayr,7447,9,8,12,16,32,53,-21,36
St Mirren,7447,10,7,11,18,37,59,-22,32
Hibernian,7448,1,21,11,4,62,26,36,74
Falkirk,7448,2,16,11,9,55,38,17,59
Morton,7448,3,15,12,9,49,39,10,57
Dundee Utd,7448,4,15,10,11,50,40,10,55
Queen of S't,7448,5,12,10,14,44,50,-6,46
Raith,7448,6,10,11,15,40,50,-10,41
Dunfermline,7448,7,8,16,12,48,52,-4,40
St Mirren,7448,8,10,10,16,41,56,-15,40
Ayr,7448,9,8,13,15,35,57,-22,37
Dumbarton,7448,10,7,12,17,48,64,-16,33
Hibernian,7449,1,17,15,4,53,27,26,66
Morton,7449,2,15,13,8,45,35,10,58
Falkirk,7449,3,15,11,10,63,44,19,56
Dundee Utd,7449,4,13,13,10,48,45,3,52
Queen of S't,7449,5,11,12,13,48,51,-3,45
Dunfermline,7449,6,9,15,12,45,48,-3,42
Ayr,7449,7,9,15,12,35,50,-15,42
Dumbarton,7449,8,10,11,15,52,64,-12,41
Raith,7449,9,10,10,16,34,50,-16,40
St Mirren,7449,10,9,9,18,44,53,-9,36
Hibernian,7450,1,20,11,5,60,31,29,71
Morton,7450,2,17,10,9,46,37,9,61
Falkirk,7450,3,15,12,9,63,46,17,57
Dundee Utd,7450,4,15,9,12,51,43,8,54
Queen of S't,7450,5,13,9,14,47,48,-1,48
Dunfermline,7450,6,10,11,15,43,50,-7,41
St Mirren,7450,7,10,10,16,41,54,-13,40
Ayr,7450,8,9,13,14,34,50,-16,40
Raith,7450,9,10,9,17,36,50,-14,39
Dumbarton,7450,10,8,12,16,47,59,-12,36
Hibernian,7451,1,19,12,5,55,24,31,69
Morton,7451,2,19,12,5,53,33,20,69
Falkirk,7451,3,18,9,9,62,41,21,63
Dundee Utd,7451,4,17,8,11,52,38,14,59
Queen of S't,7451,5,12,8,16,45,51,-6,44
Dumbarton,7451,6,10,11,15,46,55,-9,41
Dunfermline,7451,7,9,13,14,43,50,-7,40
Raith,7451,8,10,9,17,33,47,-14,39
Ayr,7451,9,8,12,16,34,57,-23,36
St Mirren,7451,10,6,10,20,37,64,-27,28
Hibernian,7452,1,19,12,5,60,27,33,69
Morton,7452,2,18,12,6,54,33,21,66
Dundee Utd,7452,3,16,10,10,53,42,11,58
Falkirk,7452,4,14,14,8,53,39,14,56
Queen of S't,7452,5,11,11,14,41,48,-7,44
Dumbarton,7452,6,10,10,16,47,61,-14,40
Dunfermline,7452,7,8,15,13,43,49,-6,39
St Mirren,7452,8,9,12,15,49,59,-10,39
Raith,7452,9,8,12,16,32,48,-16,36
Ayr,7452,10,7,12,17,33,59,-26,33
Hibernian,7453,1,19,12,5,58,29,29,69
Falkirk,7453,2,16,12,8,60,41,19,60
Morton,7453,3,15,15,6,47,33,14,60
Dundee Utd,7453,4,13,11,12,49,47,2,50
Queen of S't,7453,5,12,10,14,48,48,0,46
Ayr,7453,6,9,13,14,36,53,-17,40
Raith,7453,7,10,10,16,33,52,-19,40
Dunfermline,7453,8,8,15,13,43,46,-3,39
St Mirren,7453,9,9,11,16,40,54,-14,38
Dumbarton,7453,10,8,13,15,48,59,-11,37
Hibernian,7454,1,19,12,5,58,23,35,69
Falkirk,7454,2,17,11,8,60,41,19,62
Dundee Utd,7454,3,16,11,9,52,38,14,59
Morton,7454,4,15,12,9,46,40,6,57
Queen of S't,7454,5,12,9,15,48,55,-7,45
Dunfermline,7454,6,10,13,13,44,49,-5,43
Raith,7454,7,10,11,15,33,45,-12,41
Ayr,7454,8,9,12,15,40,59,-19,39
Dumbarton,7454,9,9,11,16,50,62,-12,38
St Mirren,7454,10,7,10,19,41,60,-19,31
Hibernian,7455,1,21,10,5,61,29,32,73
Dundee Utd,7455,2,18,9,9,59,42,17,63
Falkirk,7455,3,16,9,11,57,42,15,57
Morton,7455,4,15,12,9,53,43,10,57
Dunfermline,7455,5,11,12,13,51,54,-3,45
Dumbarton,7455,6,10,11,15,47,59,-12,41
Queen of S't,7455,7,10,10,16,43,51,-8,40
Raith,7455,8,10,9,17,37,52,-15,39
St Mirren,7455,9,9,10,17,42,57,-15,37
Ayr,7455,10,8,12,16,33,54,-21,36
Hibernian,7456,1,20,13,3,57,23,34,73
Morton,7456,2,16,14,6,49,34,15,62
Falkirk,7456,3,16,11,9,57,44,13,59
Dundee Utd,7456,4,15,12,9,48,40,8,57
Dunfermline,7456,5,10,13,13,48,49,-1,43
Dumbarton,7456,6,10,12,14,52,57,-5,42
Queen of S't,7456,7,10,10,16,43,51,-8,40
Raith,7456,8,9,11,16,37,50,-13,38
St Mirren,7456,9,8,11,17,38,54,-16,35
Ayr,7456,10,6,13,17,34,61,-27,31
Hibernian,7457,1,19,14,3,56,24,32,71
Morton,7457,2,16,12,8,50,37,13,60
Falkirk,7457,3,15,10,11,60,46,14,55
Dundee Utd,7457,4,15,10,11,48,39,9,55
Queen of S't,7457,5,12,11,13,50,48,2,47
Raith,7457,6,12,11,13,35,42,-7,47
Dunfermline,7457,7,10,15,11,49,47,2,45
St Mirren,7457,8,9,10,17,36,56,-20,37
Ayr,7457,9,7,12,17,32,59,-27,33
Dumbarton,7457,10,7,11,18,44,62,-18,32
Hibernian,7458,1,18,13,5,53,25,28,67
Falkirk,7458,2,17,11,8,63,40,23,62
Dundee Utd,7458,3,17,10,9,57,38,19,61
Morton,7458,4,16,12,8,52,39,13,60
Queen of S't,7458,5,10,11,15,44,53,-9,41
Ayr,7458,6,8,15,13,34,51,-17,39
Dunfermline,7458,7,8,14,14,46,57,-11,38
Raith,7458,8,9,11,16,34,49,-15,38
St Mirren,7458,9,9,11,16,41,57,-16,38
Dumbarton,7458,10,7,14,15,45,60,-15,35
Hibernian,7459,1,20,12,4,56,22,34,72
Morton,7459,2,16,12,8,46,36,10,60
Falkirk,7459,3,14,14,8,54,38,16,56
Dundee Utd,7459,4,15,11,10,46,35,11,56
Queen of S't,7459,5,11,12,13,49,48,1,45
Dunfermline,7459,6,10,14,12,45,43,2,44
Raith,7459,7,10,10,16,35,53,-18,40
Dumbarton,7459,8,8,13,15,44,59,-15,37
St Mirren,7459,9,8,12,16,41,52,-11,36
Ayr,7459,10,7,12,17,29,59,-30,33
Hibernian,7460,1,22,11,3,62,26,36,77
Dundee Utd,7460,2,19,9,8,55,32,23,66
Falkirk,7460,3,17,10,9,59,40,19,61
Morton,7460,4,16,10,10,51,38,13,58
Dumbarton,7460,5,10,12,14,49,55,-6,42
Queen of S't,7460,6,11,9,16,43,54,-11,42
Dunfermline,7460,7,10,11,15,44,48,-4,41
Raith,7460,8,11,8,17,37,49,-12,41
Ayr,7460,9,7,11,18,33,62,-29,32
St Mirren,7460,10,6,11,19,38,67,-29,29
Hibernian,7461,1,19,12,5,59,31,28,69
Morton,7461,2,16,13,7,55,39,16,61
Falkirk,7461,3,16,10,10,59,43,16,58
Dundee Utd,7461,4,16,10,10,53,42,11,58
Dunfermline,7461,5,10,14,12,50,47,3,44
Dumbarton,7461,6,10,13,13,52,58,-6,43
St Mirren,7461,7,10,10,16,45,58,-13,40
Ayr,7461,8,10,10,16,34,57,-23,40
Queen of S't,7461,9,10,9,17,38,49,-11,39
Raith,7461,10,8,9,19,32,53,-21,33
Hibernian,7462,1,23,10,3,59,22,37,79
Morton,7462,2,17,12,7,57,39,18,63
Dundee Utd,7462,3,15,11,10,51,42,9,56
Falkirk,7462,4,15,10,11,56,44,12,55
Queen of S't,7462,5,11,11,14,45,52,-7,44
Dumbarton,7462,6,9,12,15,52,62,-10,39
Dunfermline,7462,7,8,13,15,44,54,-10,37
St Mirren,7462,8,9,10,17,40,55,-15,37
Ayr,7462,9,8,13,15,38,53,-15,37
Raith,7462,10,9,10,17,34,53,-19,37
Hibernian,7463,1,17,15,4,54,27,27,66
Morton,7463,2,18,10,8,51,36,15,64
Dundee Utd,7463,3,17,9,10,55,42,13,60
Falkirk,7463,4,14,11,11,53,43,10,53
Dunfermline,7463,5,10,13,13,48,49,-1,43
Queen of S't,7463,6,10,12,14,45,51,-6,42
Ayr,7463,7,10,12,14,37,54,-17,42
Dumbarton,7463,8,9,13,14,44,52,-8,40
Raith,7463,9,9,10,17,34,50,-16,37
St Mirren,7463,10,8,11,17,39,56,-17,35
Hibernian,7464,1,20,11,5,59,25,34,71
Morton,7464,2,17,11,8,49,38,11,62
Falkirk,7464,3,17,10,9,59,39,20,61
Dundee Utd,7464,4,14,10,12,48,42,6,52
Queen of S't,7464,5,11,10,15,45,52,-7,43
Raith,7464,6,10,11,15,37,52,-15,41
Dunfermline,7464,7,9,13,14,42,45,-3,40
St Mirren,7464,8,9,13,14,42,51,-9,40
Dumbarton,7464,9,9,10,17,43,59,-16,37
Ayr,7464,10,8,13,15,34,55,-21,37
Hibernian,7465,1,20,12,4,58,26,32,72
Falkirk,7465,2,17,11,8,57,38,19,62
Dundee Utd,7465,3,17,9,10,51,38,13,60
Morton,7465,4,15,12,9,45,39,6,57
Raith,7465,5,11,10,15,38,48,-10,43
Dunfermline,7465,6,10,11,15,47,54,-7,41
Queen of S't,7465,7,10,9,17,46,55,-9,39
St Mirren,7465,8,10,9,17,41,56,-15,39
Dumbarton,7465,9,9,11,16,51,58,-7,38
Ayr,7465,10,8,12,16,34,56,-22,36
Hibernian,7466,1,19,12,5,59,30,29,69
Falkirk,7466,2,17,11,8,60,41,19,62
Morton,7466,3,17,9,10,51,40,11,60
Dundee Utd,7466,4,15,10,11,50,41,9,55
Dunfermline,7466,5,12,12,12,50,45,5,48
Queen of S't,7466,6,12,9,15,42,49,-7,45
Raith,7466,7,10,11,15,34,46,-12,41
St Mirren,7466,8,9,10,17,41,56,-15,37
Ayr,7466,9,8,12,16,32,56,-24,36
Dumbarton,7466,10,8,10,18,44,59,-15,34
Hibernian,7467,1,22,11,3,59,23,36,77
Dundee Utd,7467,2,18,8,10,52,39,13,62
Morton,7467,3,16,13,7,45,33,12,61
Falkirk,7467,4,17,9,10,59,39,20,60
Dunfermline,7467,5,10,12,14,47,47,0,42
Dumbarton,7467,6,9,12,15,51,61,-10,39
Queen of S't,7467,7,10,9,17,41,56,-15,39
Raith,7467,8,9,10,17,30,49,-19,37
Ayr,7467,9,8,12,16,29,51,-22,36
St Mirren,7467,10,8,10,18,41,56,-15,34
Hibernian,7468,1,19,13,4,62,30,32,70
Morton,7468,2,17,11,8,50,38,12,62
Falkirk,7468,3,14,12,10,56,44,12,54
Dundee Utd,7468,4,14,9,13,46,43,3,51
Dunfermline,7468,5,12,12,12,52,48,4,48
Queen of S't,7468,6,11,10,15,46,54,-8,43
Ayr,7468,7,10,12,14,36,51,-15,42
Raith,7468,8,10,11,15,41,54,-13,41
Dumbarton,7468,9,8,12,16,48,59,-11,36
St Mirren,7468,10,8,12,16,41,57,-16,36
Hibernian,7469,1,18,12,6,54,30,24,66
Morton,7469,2,17,12,7,57,40,17,63
Falkirk,7469,3,16,9,11,54,39,15,57
Queen of S't,7469,4,14,8,14,49,47,2,50
Dundee Utd,7469,5,13,10,13,44,38,6,49
Dumbarton,7469,6,12,12,12,52,51,1,48
Ayr,7469,7,11,11,14,35,52,-17,44
Dunfermline,7469,8,8,14,14,44,51,-7,38
Raith,7469,9,9,11,16,31,48,-17,38
St Mirren,7469,10,7,11,18,36,60,-24,32
Hibernian,7470,1,18,15,3,57,24,33,69
Falkirk,7470,2,17,11,8,61,41,20,62
Morton,7470,3,16,12,8,47,38,9,60
Dundee Utd,7470,4,12,10,14,40,39,1,46
Queen of S't,7470,5,11,11,14,43,50,-7,44
Dunfermline,7470,6,10,13,13,49,48,1,43
Raith,7470,7,10,11,15,36,49,-13,41
Dumbarton,7470,8,9,13,14,51,58,-7,40
Ayr,7470,9,8,14,14,35,55,-20,38
St Mirren,7470,10,9,10,17,36,53,-17,37
Hibernian,7471,1,19,13,4,54,25,29,70
Dundee Utd,7471,2,17,8,11,56,40,16,59
Falkirk,7471,3,14,11,11,52,45,7,53
Morton,7471,4,14,11,11,44,42,2,53
Dumbarton,7471,5,12,11,13,58,57,1,47
Raith,7471,6,12,11,13,40,43,-3,47
Dunfermline,7471,7,10,12,14,48,51,-3,42
Queen of S't,7471,8,11,8,17,41,52,-11,41
Ayr,7471,9,10,10,16,37,56,-19,40
St Mirren,7471,10,8,11,17,40,59,-19,35
Hibernian,7472,1,20,12,4,53,22,31,72
Morton,7472,2,19,11,6,53,32,21,68
Falkirk,7472,3,18,10,8,64,42,22,64
Dundee Utd,7472,4,16,9,11,48,39,9,57
Queen of S't,7472,5,12,9,15,46,51,-5,45
Dunfermline,7472,6,10,11,15,47,51,-4,41
Dumbarton,7472,7,9,11,16,53,63,-10,38
Ayr,7472,8,8,11,17,31,55,-24,35
St Mirren,7472,9,8,10,18,36,56,-20,34
Raith,7472,10,8,10,18,30,50,-20,34
Hibernian,7473,1,18,13,5,56,30,26,67
Dundee Utd,7473,2,16,10,10,51,39,12,58
Morton,7473,3,14,14,8,47,38,9,56
Falkirk,7473,4,14,11,11,51,41,10,53
Queen of S't,7473,5,14,8,14,44,47,-3,50
Dunfermline,7473,6,10,14,12,47,45,2,44
St Mirren,7473,7,9,12,15,42,51,-9,39
Raith,7473,8,9,12,15,32,46,-14,39
Dumbarton,7473,9,8,13,15,45,59,-14,37
Ayr,7473,10,8,13,15,39,58,-19,37
Hibernian,7474,1,19,12,5,53,25,28,69
Morton,7474,2,19,9,8,54,36,18,66
Falkirk,7474,3,17,10,9,60,44,16,61
Dundee Utd,7474,4,15,10,11,49,42,7,55
Queen of S't,7474,5,12,9,15,50,56,-6,45
Dunfermline,7474,6,8,16,12,46,47,-1,40
Dumbarton,7474,7,9,13,14,48,57,-9,40
Raith,7474,8,9,10,17,35,51,-16,37
Ayr,7474,9,8,13,15,38,57,-19,37
St Mirren,7474,10,7,12,17,36,54,-18,33
Hibernian,7475,1,20,12,4,55,21,34,72
Morton,7475,2,19,9,8,47,33,14,66
Falkirk,7475,3,16,11,9,57,41,16,59
Dundee Utd,7475,4,14,10,12,47,42,5,52
Queen of S't,7475,5,12,11,13,42,47,-5,47
Dunfermline,7475,6,10,13,13,51,47,4,43
Raith,7475,7,10,8,18,34,49,-15,38
Ayr,7475,8,9,11,16,32,54,-22,38
Dumbarton,7475,9,8,13,15,44,55,-11,37
St Mirren,7475,10,8,10,18,39,59,-20,34
Hibernian,7476,1,20,11,5,54,24,30,71
Falkirk,7476,2,19,9,8,66,39,27,66
Morton,7476,3,16,10,10,53,42,11,58
Dundee Utd,7476,4,14,10,12,47,41,6,52
Queen of S't,7476,5,13,8,15,43,49,-6,47
Dumbarton,7476,6,11,12,13,47,52,-5,45
St Mirren,7476,7,10,11,15,38,50,-12,41
Dunfermline,7476,8,8,13,15,42,50,-8,37
Raith,7476,9,9,9,18,33,51,-18,36
Ayr,7476,10,8,11,17,38,63,-25,35
Hibernian,7477,1,18,11,7,55,27,28,65
Dundee Utd,7477,2,17,10,9,51,38,13,61
Falkirk,7477,3,16,11,9,54,37,17,59
Morton,7477,4,16,10,10,49,42,7,58
Queen of S't,7477,5,14,8,14,45,47,-2,50
Dunfermline,7477,6,11,13,12,44,46,-2,46
Dumbarton,7477,7,10,11,15,51,55,-4,41
Raith,7477,8,9,11,16,31,47,-16,38
Ayr,7477,9,7,14,15,33,54,-21,35
St Mirren,7477,10,8,9,19,38,58,-20,33
Hibernian,7478,1,17,13,6,51,28,23,64
Morton,7478,2,17,10,9,46,34,12,61
Falkirk,7478,3,15,10,11,56,40,16,55
Dundee Utd,7478,4,15,10,11,45,38,7,55
Queen of S't,7478,5,12,11,13,47,51,-4,47
Raith,7478,6,12,10,14,39,46,-7,46
Dunfermline,7478,7,10,14,12,47,46,1,44
Dumbarton,7478,8,9,13,14,48,55,-7,40
St Mirren,7478,9,10,10,16,41,57,-16,40
Ayr,7478,10,6,13,17,32,57,-25,31
Hibernian,7479,1,21,12,3,59,24,35,75
Dundee Utd,7479,2,17,9,10,56,39,17,60
Falkirk,7479,3,16,10,10,56,42,14,58
Morton,7479,4,15,10,11,49,40,9,55
Queen of S't,7479,5,13,9,14,50,52,-2,48
Dunfermline,7479,6,10,13,13,50,55,-5,43
Raith,7479,7,11,8,17,35,47,-12,41
Ayr,7479,8,9,11,16,34,58,-24,38
St Mirren,7479,9,9,10,17,43,55,-12,37
Dumbarton,7479,10,8,10,18,42,62,-20,34
Hibernian,7480,1,18,12,6,52,27,25,66
Morton,7480,2,17,12,7,47,32,15,63
Falkirk,7480,3,17,10,9,64,40,24,61
Dundee Utd,7480,4,16,11,9,52,41,11,59
Dunfermline,7480,5,12,12,12,48,45,3,48
Queen of S't,7480,6,12,9,15,48,53,-5,45
Ayr,7480,7,8,13,15,39,58,-19,37
Dumbarton,7480,8,8,12,16,51,63,-12,36
Raith,7480,9,9,9,18,33,54,-21,36
St Mirren,7480,10,8,10,18,42,63,-21,34
Hibernian,7481,1,18,12,6,54,28,26,66
Morton,7481,2,17,11,8,46,35,11,62
Falkirk,7481,3,16,11,9,58,40,18,59
Dundee Utd,7481,4,16,9,11,54,39,15,57
Dunfermline,7481,5,11,11,14,47,48,-1,44
Queen of S't,7481,6,11,11,14,41,49,-8,44
St Mirren,7481,7,10,12,14,45,53,-8,42
Dumbarton,7481,8,9,12,15,46,57,-11,39
Raith,7481,9,8,12,16,29,45,-16,36
Ayr,7481,10,8,11,17,34,60,-26,35
Hibernian,7482,1,19,14,3,59,25,34,71
Morton,7482,2,15,14,7,46,38,8,59
Dundee Utd,7482,3,16,10,10,48,37,11,58
Falkirk,7482,4,15,11,10,60,41,19,56
Queen of S't,7482,5,10,11,15,42,51,-9,41
Dunfermline,7482,6,8,16,12,45,51,-6,40
Raith,7482,7,10,10,16,38,52,-14,40
Ayr,7482,8,9,13,14,35,52,-17,40
Dumbarton,7482,9,7,15,14,43,54,-11,36
St Mirren,7482,10,8,12,16,40,55,-15,36
Hibernian,7483,1,18,12,6,61,32,29,66
Morton,7483,2,17,12,7,50,35,15,63
Falkirk,7483,3,16,10,10,63,47,16,58
Dundee Utd,7483,4,16,10,10,52,44,8,58
Queen of S't,7483,5,14,9,13,49,45,4,51
Raith,7483,6,11,9,16,37,51,-14,42
Dumbarton,7483,7,9,12,15,46,59,-13,39
Dunfermline,7483,8,7,16,13,46,52,-6,37
Ayr,7483,9,8,12,16,36,57,-21,36
St Mirren,7483,10,7,12,17,42,60,-18,33
Hibernian,7484,1,20,12,4,58,25,33,72
Falkirk,7484,2,18,10,8,62,38,24,64
Morton,7484,3,17,11,8,51,35,16,62
Dundee Utd,7484,4,18,8,10,50,37,13,62
Queen of S't,7484,5,12,9,15,43,48,-5,45
Dunfermline,7484,6,9,12,15,44,55,-11,39
Dumbarton,7484,7,9,11,16,50,59,-9,38
St Mirren,7484,8,9,10,17,45,58,-13,37
Ayr,7484,9,8,12,16,36,62,-26,36
Raith,7484,10,8,9,19,32,54,-22,33
Hibernian,7485,1,18,12,6,53,27,26,66
Dundee Utd,7485,2,18,8,10,51,36,15,62
Morton,7485,3,16,11,9,46,35,11,59
Falkirk,7485,4,16,10,10,59,43,16,58
Queen of S't,7485,5,12,10,14,44,49,-5,46
Raith,7485,6,12,10,14,39,46,-7,46
Dunfermline,7485,7,8,14,14,42,52,-10,38
Dumbarton,7485,8,9,11,16,47,59,-12,38
St Mirren,7485,9,9,11,16,38,50,-12,38
Ayr,7485,10,7,13,16,29,51,-22,34
Hibernian,7486,1,19,13,4,58,28,30,70
Morton,7486,2,18,11,7,50,36,14,65
Falkirk,7486,3,15,11,10,55,40,15,56
Dundee Utd,7486,4,14,11,11,43,39,4,53
Raith,7486,5,12,9,15,40,46,-6,45
Queen of S't,7486,6,10,12,14,41,52,-11,42
Dunfermline,7486,7,9,13,14,46,47,-1,40
Dumbarton,7486,8,9,12,15,48,59,-11,39
St Mirren,7486,9,10,9,17,43,54,-11,39
Ayr,7486,10,7,13,16,32,55,-23,34
Hibernian,7487,1,20,11,5,60,29,31,71
Morton,7487,2,18,10,8,51,36,15,64
Dundee Utd,7487,3,16,9,11,53,44,9,57
Falkirk,7487,4,15,10,11,56,44,12,55
Queen of S't,7487,5,13,9,14,48,48,0,48
Dunfermline,7487,6,10,16,10,49,47,2,46
Raith,7487,7,10,8,18,31,48,-17,38
St Mirren,7487,8,9,10,17,41,59,-18,37
Dumbarton,7487,9,8,12,16,43,55,-12,36
Ayr,7487,10,8,11,17,34,56,-22,35
Falkirk,7488,1,20,9,7,64,35,29,69
Hibernian,7488,2,18,12,6,52,25,27,66
Morton,7488,3,18,10,8,52,37,15,64
Dundee Utd,7488,4,18,9,9,48,34,14,63
Queen of S't,7488,5,10,10,16,42,55,-13,40
Ayr,7488,6,9,11,16,34,50,-16,38
Dunfermline,7488,7,8,13,15,40,49,-9,37
St Mirren,7488,8,9,10,17,37,52,-15,37
Raith,7488,9,9,10,17,32,49,-17,37
Dumbarton,7488,10,8,12,16,45,60,-15,36
Hibernian,7489,1,18,13,5,54,27,27,67
Morton,7489,2,16,14,6,52,36,16,62
Dundee Utd,7489,3,16,10,10,52,37,15,58
Falkirk,7489,4,15,9,12,53,42,11,54
Queen of S't,7489,5,13,10,13,45,48,-3,49
Dumbarton,7489,6,11,11,14,48,54,-6,44
Raith,7489,7,11,11,14,38,48,-10,44
Ayr,7489,8,9,11,16,38,58,-20,38
Dunfermline,7489,9,8,13,15,43,50,-7,37
St Mirren,7489,10,7,10,19,36,59,-23,31
Hibernian,7490,1,18,13,5,51,25,26,67
Morton,7490,2,17,12,7,51,35,16,63
Falkirk,7490,3,17,11,8,56,35,21,62
Dundee Utd,7490,4,16,8,12,45,44,1,56
Queen of S't,7490,5,12,10,14,48,48,0,46
Dunfermline,7490,6,9,14,13,42,44,-2,41
St Mirren,7490,7,10,10,16,48,59,-11,40
Raith,7490,8,9,11,16,34,46,-12,38
Ayr,7490,9,7,14,15,35,57,-22,35
Dumbarton,7490,10,7,13,16,44,61,-17,34
Hibernian,7491,1,17,13,6,53,31,22,64
Dundee Utd,7491,2,17,11,8,58,39,19,62
Falkirk,7491,3,16,12,8,62,42,20,60
Morton,7491,4,15,14,7,52,39,13,59
Dunfermline,7491,5,10,14,12,47,47,0,44
Queen of S't,7491,6,11,10,15,45,51,-6,43
Raith,7491,7,10,11,15,39,51,-12,41
St Mirren,7491,8,9,11,16,40,55,-15,38
Dumbarton,7491,9,8,11,17,49,65,-16,35
Ayr,7491,10,7,13,16,34,59,-25,34
Hibernian,7492,1,19,12,5,57,25,32,69
Morton,7492,2,16,12,8,54,43,11,60
Falkirk,7492,3,15,13,8,60,40,20,58
Dundee Utd,7492,4,14,12,10,48,40,8,54
Queen of S't,7492,5,12,11,13,48,49,-1,47
Dunfermline,7492,6,8,17,11,44,46,-2,41
St Mirren,7492,7,10,10,16,43,57,-14,40
Dumbarton,7492,8,9,11,16,51,63,-12,38
Raith,7492,9,10,8,18,39,53,-14,38
Ayr,7492,10,8,12,16,32,60,-28,36
Hibernian,7493,1,21,11,4,57,26,31,74
Falkirk,7493,2,17,10,9,61,40,21,61
Morton,7493,3,17,10,9,50,39,11,61
Dundee Utd,7493,4,14,10,12,47,41,6,52
Queen of S't,7493,5,12,9,15,45,54,-9,45
Dumbarton,7493,6,10,13,13,50,54,-4,43
Dunfermline,7493,7,10,11,15,47,54,-7,41
Raith,7493,8,11,8,17,43,51,-8,41
Ayr,7493,9,8,12,16,38,59,-21,36
St Mirren,7493,10,8,10,18,42,62,-20,34
Hibernian,7494,1,21,11,4,60,22,38,74
Morton,7494,2,18,10,8,51,37,14,64
Dundee Utd,7494,3,17,10,9,53,38,15,61
Falkirk,7494,4,16,10,10,66,44,22,58
Queen of S't,7494,5,13,8,15,49,54,-5,47
Raith,7494,6,10,9,17,35,54,-19,39
Dumbarton,7494,7,9,11,16,49,60,-11,38
Dunfermline,7494,8,8,13,15,41,54,-13,37
St Mirren,7494,9,9,10,17,40,58,-18,37
Ayr,7494,10,7,12,17,37,60,-23,33
Hibernian,7495,1,19,12,5,58,26,32,69
Morton,7495,2,18,10,8,49,34,15,64
Falkirk,7495,3,16,11,9,57,40,17,59
Dundee Utd,7495,4,14,11,11,48,43,5,53
Queen of S't,7495,5,11,11,14,43,47,-4,44
Raith,7495,6,11,11,14,33,45,-12,44
Dumbarton,7495,7,10,12,14,47,54,-7,42
Dunfermline,7495,8,8,14,14,43,48,-5,38
Ayr,7495,9,9,11,16,31,51,-20,38
St Mirren,7495,10,7,11,18,40,61,-21,32
Hibernian,7496,1,18,13,5,52,26,26,67
Morton,7496,2,16,14,6,51,34,17,62
Dundee Utd,7496,3,16,10,10,50,43,7,58
Falkirk,7496,4,15,12,9,58,42,16,57
Queen of S't,7496,5,11,11,14,49,51,-2,44
Dunfermline,7496,6,9,16,11,45,46,-1,43
Dumbarton,7496,7,10,12,14,52,59,-7,42
Raith,7496,8,8,12,16,33,50,-17,36
Ayr,7496,9,8,12,16,31,55,-24,36
St Mirren,7496,10,8,10,18,45,60,-15,34
Hibernian,7497,1,17,12,7,53,29,24,63
Falkirk,7497,2,17,10,9,67,44,23,61
Morton,7497,3,16,12,8,49,37,12,60
Dundee Utd,7497,4,15,9,12,42,39,3,54
Dunfermline,7497,5,10,14,12,48,47,1,44
Queen of S't,7497,6,11,11,14,46,52,-6,44
Raith,7497,7,11,10,15,36,45,-9,43
Dumbarton,7497,8,9,15,12,55,59,-4,42
Ayr,7497,9,8,12,16,35,56,-21,36
St Mirren,7497,10,8,11,17,40,63,-23,35
Morton,7498,1,18,11,7,55,40,15,65
Hibernian,7498,2,16,15,5,53,30,23,63
Falkirk,7498,3,16,11,9,57,43,14,59
Dundee Utd,7498,4,15,10,11,55,41,14,55
Queen of S't,7498,5,14,9,13,53,48,5,51
Raith,7498,6,11,9,16,36,52,-16,42
Dumbarton,7498,7,9,12,15,48,61,-13,39
Dunfermline,7498,8,8,14,14,42,48,-6,38
Ayr,7498,9,8,12,16,33,56,-23,36
St Mirren,7498,10,8,11,17,44,57,-13,35
Hibernian,7499,1,20,12,4,55,24,31,72
Falkirk,7499,2,17,11,8,58,39,19,62
Morton,7499,3,16,12,8,48,35,13,60
Dundee Utd,7499,4,14,10,12,48,44,4,52
Queen of S't,7499,5,11,11,14,43,46,-3,44
Dumbarton,7499,6,10,13,13,51,55,-4,43
Raith,7499,7,10,9,17,34,47,-13,39
Ayr,7499,8,9,12,15,34,56,-22,39
Dunfermline,7499,9,8,14,14,39,49,-10,38
St Mirren,7499,10,8,10,18,39,54,-15,34
Hibernian,7500,1,18,14,4,52,23,29,68
Morton,7500,2,15,15,6,45,32,13,60
Dundee Utd,7500,3,16,11,9,48,37,11,59
Falkirk,7500,4,15,13,8,58,37,21,58
Dunfermline,7500,5,10,14,12,45,45,0,44
St Mirren,7500,6,11,9,16,41,53,-12,42
Queen of S't,7500,7,10,10,16,40,52,-12,40
Ayr,7500,8,9,13,14,36,54,-18,40
Dumbarton,7500,9,8,12,16,47,60,-13,36
Raith,7500,10,8,9,19,29,48,-19,33
Hibernian,7501,1,20,11,5,57,26,31,71
Morton,7501,2,17,12,7,53,38,15,63
Falkirk,7501,3,15,10,11,56,45,11,55
Dundee Utd,7501,4,13,11,12,49,45,4,50
Queen of S't,7501,5,14,8,14,52,49,3,50
Dunfermline,7501,6,9,16,11,44,44,0,43
Ayr,7501,7,8,15,13,33,50,-17,39
Dumbarton,7501,8,8,14,14,48,56,-8,38
St Mirren,7501,9,9,10,17,46,58,-12,37
Raith,7501,10,9,9,18,34,61,-27,36
Hibernian,7502,1,20,12,4,56,28,28,72
Morton,7502,2,16,13,7,54,39,15,61
Falkirk,7502,3,15,11,10,59,40,19,56
Dundee Utd,7502,4,15,9,12,52,44,8,54
Queen of S't,7502,5,11,12,13,46,50,-4,45
Dumbarton,7502,6,9,14,13,44,54,-10,41
Raith,7502,7,10,11,15,35,48,-13,41
Dunfermline,7502,8,9,13,14,45,52,-7,40
Ayr,7502,9,9,11,16,34,56,-22,38
St Mirren,7502,10,8,10,18,42,56,-14,34
Hibernian,7503,1,21,11,4,65,27,38,74
Morton,7503,2,17,11,8,50,34,16,62
Falkirk,7503,3,17,10,9,63,42,21,61
Dundee Utd,7503,4,14,9,13,51,48,3,51
Queen of S't,7503,5,13,9,14,46,49,-3,48
Dumbarton,7503,6,10,12,14,48,56,-8,42
Ayr,7503,7,9,12,15,35,57,-22,39
Dunfermline,7503,8,8,14,14,45,51,-6,38
Raith,7503,9,9,10,17,35,54,-19,37
St Mirren,7503,10,7,12,17,42,62,-20,33
Hibernian,7504,1,17,13,6,49,24,25,64
Dundee Utd,7504,2,17,9,10,55,41,14,60
Morton,7504,3,15,14,7,51,36,15,59
Falkirk,7504,4,16,10,10,58,40,18,58
Queen of S't,7504,5,12,9,15,47,50,-3,45
Dunfermline,7504,6,11,11,14,49,52,-3,44
Raith,7504,7,11,10,15,39,50,-11,43
St Mirren,7504,8,10,10,16,42,54,-12,40
Ayr,7504,9,9,11,16,36,54,-18,38
Dumbarton,7504,10,8,11,17,46,71,-25,35
Hibernian,7505,1,19,14,3,56,23,33,71
Morton,7505,2,17,12,7,54,39,15,63
Falkirk,7505,3,16,11,9,58,41,17,59
Dundee Utd,7505,4,14,11,11,51,43,8,53
Raith,7505,5,12,9,15,41,49,-8,45
Queen of S't,7505,6,12,8,16,45,53,-8,44
St Mirren,7505,7,10,10,16,44,56,-12,40
Dunfermline,7505,8,9,12,15,51,59,-8,39
Ayr,7505,9,9,11,16,39,56,-17,38
Dumbarton,7505,10,8,10,18,46,66,-20,34
Hibernian,7506,1,20,11,5,57,29,28,71
Dundee Utd,7506,2,17,10,9,58,42,16,61
Morton,7506,3,17,10,9,55,40,15,61
Falkirk,7506,4,16,10,10,59,43,16,58
Raith,7506,5,12,8,16,39,49,-10,44
Dunfermline,7506,6,10,12,14,46,53,-7,42
Dumbarton,7506,7,10,11,15,46,58,-12,41
Queen of S't,7506,8,10,8,18,44,54,-10,38
St Mirren,7506,9,8,12,16,41,57,-16,36
Ayr,7506,10,8,12,16,32,52,-20,36
Hibernian,7507,1,21,10,5,62,27,35,73
Falkirk,7507,2,18,10,8,61,37,24,64
Morton,7507,3,17,10,9,49,39,10,61
Dundee Utd,7507,4,17,9,10,56,41,15,60
Queen of S't,7507,5,12,10,14,47,50,-3,46
St Mirren,7507,6,11,9,16,46,53,-7,42
Dunfermline,7507,7,8,14,14,46,52,-6,38
Raith,7507,8,10,8,18,33,50,-17,38
Dumbarton,7507,9,8,10,18,44,66,-22,34
Ayr,7507,10,7,12,17,29,58,-29,33
Hibernian,7508,1,20,11,5,60,32,28,71
Morton,7508,2,16,11,9,57,44,13,59
Falkirk,7508,3,15,10,11,55,43,12,55
Dunfermline,7508,4,13,12,11,48,41,7,51
Dundee Utd,7508,5,14,9,13,46,47,-1,51
Queen of S't,7508,6,13,9,14,56,49,7,48
Raith,7508,7,11,9,16,35,50,-15,42
Dumbarton,7508,8,10,11,15,51,61,-10,41
St Mirren,7508,9,9,9,18,41,59,-18,36
Ayr,7508,10,8,11,17,35,58,-23,35
Hibernian,7509,1,19,12,5,52,24,28,69
Falkirk,7509,2,17,12,7,60,39,21,63
Dundee Utd,7509,3,17,11,8,51,37,14,62
Morton,7509,4,15,11,10,45,35,10,56
Queen of S't,7509,5,12,9,15,45,50,-5,45
Dunfermline,7509,6,10,11,15,42,50,-8,41
Dumbarton,7509,7,9,12,15,48,57,-9,39
St Mirren,7509,8,9,12,15,39,50,-11,39
Raith,7509,9,9,11,16,33,47,-14,38
Ayr,7509,10,7,11,18,30,56,-26,32
Hibernian,7510,1,20,12,4,58,27,31,72
Morton,7510,2,19,12,5,59,35,24,69
Falkirk,7510,3,15,12,9,57,41,16,57
Dundee Utd,7510,4,15,11,10,48,39,9,56
Queen of S't,7510,5,12,9,15,46,51,-5,45
Dunfermline,7510,6,10,13,13,48,49,-1,43
Raith,7510,7,11,9,16,44,55,-11,42
Dumbarton,7510,8,8,11,17,47,64,-17,35
Ayr,7510,9,7,12,17,36,60,-24,33
St Mirren,7510,10,7,11,18,38,60,-22,32
Hibernian,7511,1,20,10,6,58,26,32,70
Falkirk,7511,2,17,11,8,56,37,19,62
Dundee Utd,7511,3,17,10,9,51,37,14,61
Morton,7511,4,16,12,8,53,37,16,60
Dumbarton,7511,5,10,11,15,52,58,-6,41
Queen of S't,7511,6,11,8,17,44,53,-9,41
Raith,7511,7,11,8,17,33,47,-14,41
Dunfermline,7511,8,9,13,14,42,48,-6,40
Ayr,7511,9,8,12,16,36,59,-23,36
St Mirren,7511,10,7,13,16,39,62,-23,34
Hibernian,7512,1,18,12,6,55,26,29,66
Morton,7512,2,17,10,9,49,37,12,61
Falkirk,7512,3,15,10,11,55,41,14,55
Dundee Utd,7512,4,15,9,12,49,41,8,54
Queen of S't,7512,5,13,10,13,47,51,-4,49
Dunfermline,7512,6,11,13,12,48,46,2,46
Raith,7512,7,12,8,16,35,48,-13,44
Ayr,7512,8,11,11,14,37,56,-19,44
St Mirren,7512,9,9,10,17,46,57,-11,37
Dumbarton,7512,10,7,11,18,43,61,-18,32
Hibernian,7513,1,23,10,3,62,25,37,79
Dundee Utd,7513,2,18,10,8,54,36,18,64
Falkirk,7513,3,16,11,9,61,43,18,59
Morton,7513,4,14,12,10,47,42,5,54
Dunfermline,7513,5,10,13,13,47,52,-5,43
Queen of S't,7513,6,11,8,17,45,51,-6,41
Raith,7513,7,10,10,16,39,51,-12,40
Dumbarton,7513,8,8,12,16,48,59,-11,36
St Mirren,7513,9,8,11,17,34,56,-22,35
Ayr,7513,10,7,13,16,30,52,-22,34
Hibernian,7514,1,18,14,4,52,23,29,68
Falkirk,7514,2,18,10,8,59,37,22,64
Morton,7514,3,15,14,7,56,43,13,59
Dundee Utd,7514,4,13,10,13,47,51,-4,49
Queen of S't,7514,5,11,12,13,48,46,2,45
Raith,7514,6,11,11,14,39,48,-9,44
Dunfermline,7514,7,9,15,12,49,49,0,42
Ayr,7514,8,9,13,14,37,53,-16,40
Dumbarton,7514,9,8,11,17,43,61,-18,35
St Mirren,7514,10,7,12,17,42,61,-19,33
Hibernian,7515,1,21,10,5,56,24,32,73
Falkirk,7515,2,18,10,8,62,36,26,64
Morton,7515,3,18,9,9,52,38,14,63
Dundee Utd,7515,4,15,9,12,47,44,3,54
Ayr,7515,5,12,10,14,41,47,-6,46
Queen of S't,7515,6,11,10,15,49,55,-6,43
Dunfermline,7515,7,9,12,15,43,49,-6,39
Dumbarton,7515,8,9,11,16,50,67,-17,38
Raith,7515,9,9,10,17,36,55,-19,37
St Mirren,7515,10,7,11,18,38,59,-21,32
Hibernian,7516,1,19,11,6,58,27,31,68
Morton,7516,2,15,15,6,50,37,13,60
Dundee Utd,7516,3,16,10,10,56,43,13,58
Falkirk,7516,4,15,11,10,60,42,18,56
Queen of S't,7516,5,12,9,15,47,50,-3,45
Dunfermline,7516,6,11,12,13,48,53,-5,45
Dumbarton,7516,7,9,12,15,50,60,-10,39
Raith,7516,8,9,11,16,35,52,-17,38
Ayr,7516,9,9,11,16,38,63,-25,38
St Mirren,7516,10,9,10,17,43,58,-15,37
Hibernian,7517,1,18,11,7,52,29,23,65
Morton,7517,2,17,12,7,51,34,17,63
Dundee Utd,7517,3,16,11,9,51,39,12,59
Falkirk,7517,4,15,10,11,56,43,13,55
Queen of S't,7517,5,12,9,15,47,55,-8,45
Dunfermline,7517,6,9,14,13,45,46,-1,41
Ayr,7517,7,9,14,13,38,51,-13,41
Dumbarton,7517,8,9,13,14,46,57,-11,40
Raith,7517,9,9,11,16,35,53,-18,38
St Mirren,7517,10,9,9,18,41,55,-14,36
Hibernian,7518,1,18,11,7,54,33,21,65
Morton,7518,2,17,11,8,56,40,16,62
Falkirk,7518,3,17,9,10,60,41,19,60
Dundee Utd,7518,4,16,10,10,54,44,10,58
Queen of S't,7518,5,12,10,14,45,47,-2,46
Dunfermline,7518,6,10,12,14,45,47,-2,42
Dumbarton,7518,7,10,11,15,52,60,-8,41
Raith,7518,8,9,11,16,33,48,-15,38
St Mirren,7518,9,9,10,17,39,58,-19,37
Ayr,7518,10,8,13,15,35,55,-20,37
Hibernian,7519,1,19,14,3,53,23,30,71
Morton,7519,2,18,10,8,57,37,20,64
Falkirk,7519,3,16,10,10,55,41,14,58
Dundee Utd,7519,4,15,9,12,48,43,5,54
Dunfermline,7519,5,12,12,12,45,43,2,48
Queen of S't,7519,6,13,8,15,47,49,-2,47
Raith,7519,7,9,11,16,36,50,-14,38
Ayr,7519,8,9,11,16,35,56,-21,38
St Mirren,7519,9,8,11,17,41,58,-17,35
Dumbarton,7519,10,8,10,18,43,60,-17,34
Hibernian,7520,1,21,11,4,54,23,31,74
Morton,7520,2,16,13,7,51,37,14,61
Falkirk,7520,3,15,10,11,53,38,15,55
Dundee Utd,7520,4,14,11,11,49,43,6,53
Dumbarton,7520,5,12,11,13,52,51,1,47
Raith,7520,6,11,10,15,37,48,-11,43
Dunfermline,7520,7,10,12,14,45,50,-5,42
Queen of S't,7520,8,10,10,16,43,51,-8,40
Ayr,7520,9,8,13,15,35,58,-23,37
St Mirren,7520,10,7,11,18,39,59,-20,32
Hibernian,7521,1,21,12,3,62,22,40,75
Morton,7521,2,17,12,7,45,35,10,63
Falkirk,7521,3,16,9,11,60,41,19,57
Dundee Utd,7521,4,15,11,10,51,42,9,56
Dumbarton,7521,5,10,12,14,55,59,-4,42
Queen of S't,7521,6,11,9,16,44,56,-12,42
Dunfermline,7521,7,9,13,14,46,50,-4,40
Raith,7521,8,10,9,17,35,55,-20,39
St Mirren,7521,9,9,9,18,40,57,-17,36
Ayr,7521,10,7,14,15,34,55,-21,35
Hibernian,7522,1,17,15,4,52,27,25,66
Morton,7522,2,16,14,6,49,34,15,62
Dundee Utd,7522,3,17,9,10,53,40,13,60
Falkirk,7522,4,15,11,10,57,42,15,56
Queen of S't,7522,5,12,9,15,46,50,-4,45
Raith,7522,6,12,9,15,41,50,-9,45
Dumbarton,7522,7,10,11,15,50,56,-6,41
Ayr,7522,8,9,12,15,34,55,-21,39
Dunfermline,7522,9,8,13,15,44,54,-10,37
St Mirren,7522,10,7,11,18,41,59,-18,32
Falkirk,7523,1,19,9,8,66,40,26,66
Hibernian,7523,2,18,12,6,52,27,25,66
Morton,7523,3,18,11,7,49,32,17,65
Dundee Utd,7523,4,14,13,9,49,36,13,55
Queen of S't,7523,5,12,10,14,49,51,-2,46
Dunfermline,7523,6,9,13,14,41,48,-7,40
Raith,7523,7,9,11,16,33,48,-15,38
Ayr,7523,8,8,13,15,33,53,-20,37
Dumbarton,7523,9,8,12,16,45,61,-16,36
St Mirren,7523,10,7,12,17,37,58,-21,33
Hibernian,7524,1,20,10,6,54,27,27,70
Morton,7524,2,17,11,8,50,34,16,62
Dundee Utd,7524,3,18,8,10,50,39,11,62
Falkirk,7524,4,16,9,11,59,42,17,57
Queen of S't,7524,5,14,9,13,50,48,2,51
St Mirren,7524,6,10,10,16,46,57,-11,40
Dumbarton,7524,7,9,11,16,48,62,-14,38
Dunfermline,7524,8,8,13,15,41,52,-11,37
Raith,7524,9,9,9,18,33,48,-15,36
Ayr,7524,10,8,12,16,36,58,-22,36
Hibernian,7525,1,20,11,5,60,27,33,71
Morton,7525,2,17,11,8,53,38,15,62
Falkirk,7525,3,15,12,9,53,39,14,57
Dundee Utd,7525,4,15,9,12,48,44,4,54
Dunfermline,7525,5,11,12,13,53,47,6,45
Dumbarton,7525,6,10,12,14,49,56,-7,42
Queen of S't,7525,7,10,11,15,45,53,-8,41
Ayr,7525,8,10,10,16,35,55,-20,40
Raith,7525,9,9,11,16,33,55,-22,38
St Mirren,7525,10,8,11,17,39,54,-15,35
Morton,7526,1,18,11,7,55,38,17,65
Hibernian,7526,2,17,11,8,53,31,22,62
Dundee Utd,7526,3,15,12,9,53,42,11,57
Falkirk,7526,4,13,15,8,55,40,15,54
Raith,7526,5,13,9,14,44,49,-5,48
Dunfermline,7526,6,9,15,12,50,54,-4,42
Queen of S't,7526,7,11,9,16,45,52,-7,42
St Mirren,7526,8,10,10,16,41,55,-14,40
Dumbarton,7526,9,9,12,15,45,56,-11,39
Ayr,7526,10,7,12,17,34,58,-24,33
Hibernian,7527,1,18,12,6,55,28,27,66
Morton,7527,2,16,11,9,49,41,8,59
Falkirk,7527,3,16,10,10,56,38,18,58
Dundee Utd,7527,4,15,13,8,45,34,11,58
Queen of S't,7527,5,14,9,13,56,47,9,51
Dunfermline,7527,6,11,14,11,47,48,-1,47
Raith,7527,7,10,9,17,33,52,-19,39
Dumbarton,7527,8,9,10,17,48,62,-14,37
Ayr,7527,9,8,12,16,34,58,-24,36
St Mirren,7527,10,8,10,18,42,57,-15,34
Morton,7528,1,19,11,6,59,37,22,68
Dundee Utd,7528,2,18,9,9,58,35,23,63
Hibernian,7528,3,16,13,7,52,30,22,61
Falkirk,7528,4,17,9,10,55,39,16,60
Queen of S't,7528,5,14,8,14,45,45,0,50
Dunfermline,7528,6,10,12,14,43,54,-11,42
St Mirren,7528,7,9,12,15,44,53,-9,39
Raith,7528,8,9,10,17,35,49,-14,37
Dumbarton,7528,9,8,10,18,42,62,-20,34
Ayr,7528,10,7,12,17,32,61,-29,33
Hibernian,7529,1,17,12,7,53,34,19,63
Dundee Utd,7529,2,16,11,9,48,36,12,59
Falkirk,7529,3,16,10,10,60,44,16,58
Morton,7529,4,15,12,9,46,37,9,57
St Mirren,7529,5,12,10,14,46,49,-3,46
Dunfermline,7529,6,10,15,11,51,48,3,45
Raith,7529,7,10,12,14,34,45,-11,42
Ayr,7529,8,9,13,14,35,51,-16,40
Queen of S't,7529,9,9,10,17,39,54,-15,37
Dumbarton,7529,10,8,11,17,46,60,-14,35
Hibernian,7530,1,19,12,5,57,31,26,69
Falkirk,7530,2,17,11,8,61,39,22,62
Morton,7530,3,16,11,9,57,43,14,59
Dundee Utd,7530,4,14,9,13,52,47,5,51
Dumbarton,7530,5,11,13,12,49,53,-4,46
Dunfermline,7530,6,11,11,14,59,53,6,44
Queen of S't,7530,7,11,10,15,45,57,-12,43
Ayr,7530,8,9,11,16,38,58,-20,38
St Mirren,7530,9,8,12,16,42,58,-16,36
Raith,7530,10,8,12,16,31,52,-21,36
Hibernian,7531,1,17,13,6,53,28,25,64
Dundee Utd,7531,2,16,11,9,58,42,16,59
Morton,7531,3,15,12,9,49,41,8,57
Falkirk,7531,4,14,13,9,56,41,15,55
Raith,7531,5,13,10,13,38,45,-7,49
Dumbarton,7531,6,10,13,13,56,58,-2,43
Queen of S't,7531,7,11,10,15,43,49,-6,43
Dunfermline,7531,8,10,12,14,44,50,-6,42
St Mirren,7531,9,8,12,16,41,55,-14,36
Ayr,7531,10,6,14,16,29,58,-29,32
Hibernian,7532,1,19,14,3,57,25,32,71
Morton,7532,2,16,13,7,50,35,15,61
Dundee Utd,7532,3,15,13,8,54,41,13,58
Falkirk,7532,4,14,12,10,55,42,13,54
Queen of S't,7532,5,12,12,12,43,44,-1,48
Dunfermline,7532,6,10,13,13,49,48,1,43
Dumbarton,7532,7,9,11,16,46,59,-13,38
Raith,7532,8,9,11,16,31,45,-14,38
Ayr,7532,9,7,13,16,32,59,-27,34
St Mirren,7532,10,7,12,17,38,57,-19,33
Hibernian,7533,1,21,12,3,61,25,36,75
Morton,7533,2,17,10,9,54,38,16,61
Dundee Utd,7533,3,17,9,10,51,40,11,60
Falkirk,7533,4,14,10,12,53,46,7,52
Queen of S't,7533,5,14,9,13,51,48,3,51
Dunfermline,7533,6,11,13,12,48,48,0,46
St Mirren,7533,7,9,10,17,42,57,-15,37
Raith,7533,8,9,10,17,31,49,-18,37
Dumbarton,7533,9,8,11,17,42,58,-16,35
Ayr,7533,10,7,12,17,30,54,-24,33
Hibernian,7534,1,21,12,3,60,21,39,75
Dundee Utd,7534,2,18,9,9,58,39,19,63
Falkirk,7534,3,15,11,10,55,43,12,56
Morton,7534,4,14,14,8,47,39,8,56
Queen of S't,7534,5,12,9,15,48,51,-3,45
Dunfermline,7534,6,10,13,13,48,50,-2,43
Dumbarton,7534,7,10,11,15,50,63,-13,41
St Mirren,7534,8,9,10,17,41,58,-17,37
Raith,7534,9,8,11,17,33,49,-16,35
Ayr,7534,10,6,14,16,30,57,-27,32
Hibernian,7535,1,18,14,4,55,29,26,68
Dundee Utd,7535,2,17,9,10,51,37,14,60
Falkirk,7535,3,16,10,10,61,41,20,58
Morton,7535,4,15,12,9,48,40,8,57
Dunfermline,7535,5,12,12,12,52,48,4,48
Queen of S't,7535,6,11,10,15,42,48,-6,43
St Mirren,7535,7,9,12,15,37,50,-13,39
Raith,7535,8,9,11,16,33,50,-17,38
Dumbarton,7535,9,8,12,16,42,55,-13,36
Ayr,7535,10,7,14,15,35,58,-23,35
Hibernian,7536,1,20,11,5,55,27,28,71
Dundee Utd,7536,2,18,8,10,56,42,14,62
Morton,7536,3,17,10,9,51,36,15,61
Falkirk,7536,4,16,10,10,58,41,17,58
Dunfermline,7536,5,11,11,14,48,47,1,44
Queen of S't,7536,6,11,9,16,45,51,-6,42
Dumbarton,7536,7,9,12,15,48,58,-10,39
Ayr,7536,8,9,11,16,38,58,-20,38
St Mirren,7536,9,9,10,17,38,53,-15,37
Raith,7536,10,9,10,17,33,57,-24,37
Hibernian,7537,1,19,12,5,52,24,28,69
Falkirk,7537,2,17,11,8,61,37,24,62
Dundee Utd,7537,3,17,9,10,57,45,12,60
Morton,7537,4,16,10,10,51,44,7,58
Dunfermline,7537,5,13,11,12,55,47,8,50
Raith,7537,6,12,10,14,40,48,-8,46
Ayr,7537,7,9,12,15,37,54,-17,39
Queen of S't,7537,8,9,10,17,40,55,-15,37
Dumbarton,7537,9,8,12,16,47,65,-18,36
St Mirren,7537,10,7,9,20,39,60,-21,30
Hibernian,7538,1,19,11,6,55,25,30,68
Morton,7538,2,17,12,7,51,37,14,63
Falkirk,7538,3,15,11,10,59,43,16,56
Dundee Utd,7538,4,13,11,12,48,44,4,50
Dunfermline,7538,5,12,12,12,45,44,1,48
Ayr,7538,6,9,15,12,39,49,-10,42
Dumbarton,7538,7,10,11,15,46,55,-9,41
Queen of S't,7538,8,10,11,15,41,52,-11,41
St Mirren,7538,9,9,11,16,44,58,-14,38
Raith,7538,10,8,11,17,33,54,-21,35
Morton,7539,1,19,9,8,52,34,18,66
Hibernian,7539,2,18,11,7,56,31,25,65
Falkirk,7539,3,17,11,8,59,37,22,62
Dundee Utd,7539,4,16,8,12,53,44,9,56
Queen of S't,7539,5,14,8,14,45,47,-2,50
Dunfermline,7539,6,10,12,14,45,50,-5,42
Raith,7539,7,11,8,17,37,50,-13,41
Ayr,7539,8,9,11,16,33,55,-22,38
St Mirren,7539,9,9,10,17,37,56,-19,37
Dumbarton,7539,10,8,10,18,43,56,-13,34
Hibernian,7540,1,19,11,6,56,29,27,68
Falkirk,7540,2,18,9,9,57,39,18,63
Morton,7540,3,17,12,7,56,42,14,63
Dundee Utd,7540,4,17,8,11,51,42,9,59
Dunfermline,7540,5,11,11,14,52,53,-1,44
Queen of S't,7540,6,11,9,16,46,52,-6,42
Raith,7540,7,10,10,16,34,47,-13,40
Dumbarton,7540,8,9,12,15,48,57,-9,39
Ayr,7540,9,7,14,15,34,56,-22,35
St Mirren,7540,10,7,12,17,40,57,-17,33
Hibernian,7541,1,20,12,4,61,28,33,72
Falkirk,7541,2,17,11,8,65,37,28,62
Dundee Utd,7541,3,16,10,10,51,39,12,58
Morton,7541,4,14,13,9,49,40,9,55
Dunfermline,7541,5,11,13,12,54,50,4,46
Raith,7541,6,12,9,15,38,53,-15,45
Queen of S't,7541,7,11,8,17,42,55,-13,41
Dumbarton,7541,8,9,11,16,47,59,-12,38
Ayr,7541,9,8,12,16,34,55,-21,36
St Mirren,7541,10,7,11,18,35,60,-25,32
Hibernian,7542,1,21,10,5,60,23,37,73
Dundee Utd,7542,2,18,10,8,56,34,22,64
Morton,7542,3,16,12,8,47,34,13,60
Falkirk,7542,4,15,11,10,58,41,17,56
Dunfermline,7542,5,11,12,13,46,45,1,45
Dumbarton,7542,6,9,13,14,46,58,-12,40
Queen of S't,7542,7,10,9,17,42,55,-13,39
Raith,7542,8,9,10,17,33,53,-20,37
St Mirren,7542,9,8,12,16,38,58,-20,36
Ayr,7542,10,7,13,16,32,57,-25,34
Hibernian,7543,1,20,11,5,57,24,33,71
Falkirk,7543,2,15,12,9,56,41,15,57
Morton,7543,3,15,11,10,49,40,9,56
Dundee Utd,7543,4,15,9,12,48,40,8,54
Dunfermline,7543,5,13,11,12,50,47,3,50
Queen of S't,7543,6,12,9,15,49,56,-7,45
Raith,7543,7,12,9,15,39,47,-8,45
Ayr,7543,8,9,10,17,34,60,-26,37
St Mirren,7543,9,8,12,16,38,52,-14,36
Dumbarton,7543,10,7,14,15,42,55,-13,35
Hibernian,7544,1,19,12,5,56,25,31,69
Morton,7544,2,18,11,7,54,36,18,65
Falkirk,7544,3,18,9,9,64,39,25,63
Dundee Utd,7544,4,16,10,10,51,41,10,58
Dunfermline,7544,5,11,13,12,47,48,-1,46
Queen of S't,7544,6,10,11,15,45,57,-12,41
Ayr,7544,7,9,12,15,35,53,-18,39
Dumbarton,7544,8,8,14,14,48,57,-9,38
Raith,7544,9,8,10,18,33,53,-20,34
St Mirren,7544,10,6,12,18,37,61,-24,30
Hibernian,7545,1,22,11,3,66,27,39,77
Morton,7545,2,17,12,7,52,37,15,63
Falkirk,7545,3,15,11,10,57,42,15,56
Dundee Utd,7545,4,15,11,10,55,48,7,56
Raith,7545,5,12,8,16,40,50,-10,44
Queen of S't,7545,6,11,10,15,48,57,-9,43
Dunfermline,7545,7,9,14,13,46,49,-3,41
Dumbarton,7545,8,7,14,15,46,58,-12,35
Ayr,7545,9,7,14,15,32,55,-23,35
St Mirren,7545,10,7,11,18,43,62,-19,32
Hibernian,7546,1,19,12,5,53,27,26,69
Dundee Utd,7546,2,17,10,9,56,38,18,61
Falkirk,7546,3,15,10,11,56,41,15,55
Morton,7546,4,13,14,9,42,35,7,53
Queen of S't,7546,5,13,8,15,44,49,-5,47
Dunfermline,7546,6,11,13,12,48,46,2,46
Raith,7546,7,11,10,15,34,46,-12,43
Dumbarton,7546,8,9,12,15,48,58,-10,39
St Mirren,7546,9,8,11,17,36,53,-17,35
Ayr,7546,10,7,14,15,31,55,-24,35
Hibernian,7547,1,20,10,6,56,27,29,70
Morton,7547,2,19,11,6,57,37,20,68
Falkirk,7547,3,17,10,9,59,41,18,61
Dundee Utd,7547,4,16,11,9,58,44,14,59
Queen of S't,7547,5,13,9,14,46,48,-2,48
Raith,7547,6,11,10,15,39,49,-10,43
Dumbarton,7547,7,10,10,16,47,57,-10,40
Dunfermline,7547,8,8,14,14,45,51,-6,38
Ayr,7547,9,6,12,18,32,63,-31,30
St Mirren,7547,10,6,11,19,36,58,-22,29
Hibernian,7548,1,19,11,6,56,25,31,68
Morton,7548,2,18,11,7,55,43,12,65
Falkirk,7548,3,16,10,10,58,43,15,58
Dundee Utd,7548,4,15,10,11,49,42,7,55
Dunfermline,7548,5,11,13,12,49,45,4,46
Ayr,7548,6,10,13,13,34,47,-13,43
Queen of S't,7548,7,10,10,16,45,52,-7,40
St Mirren,7548,8,10,10,16,45,53,-8,40
Raith,7548,9,9,11,16,33,51,-18,38
Dumbarton,7548,10,7,11,18,46,69,-23,32
Hibernian,7549,1,21,11,4,62,31,31,74
Dundee Utd,7549,2,16,11,9,53,41,12,59
Morton,7549,3,16,11,9,53,45,8,59
Falkirk,7549,4,15,10,11,57,43,14,55
Queen of S't,7549,5,11,11,14,47,50,-3,44
Ayr,7549,6,10,13,13,38,55,-17,43
Dunfermline,7549,7,9,15,12,52,51,1,42
Raith,7549,8,10,10,16,38,52,-14,40
Dumbarton,7549,9,9,12,15,49,55,-6,39
St Mirren,7549,10,6,10,20,38,64,-26,28
Hibernian,7550,1,20,11,5,56,25,31,71
Morton,7550,2,16,14,6,47,32,15,62
Falkirk,7550,3,16,10,10,55,39,16,58
Dundee Utd,7550,4,15,11,10,46,37,9,56
Queen of S't,7550,5,13,9,14,51,48,3,48
Dunfermline,7550,6,9,14,13,42,46,-4,41
Raith,7550,7,10,9,17,36,51,-15,39
St Mirren,7550,8,9,11,16,37,54,-17,38
Ayr,7550,9,9,11,16,36,57,-21,38
Dumbarton,7550,10,7,12,17,43,60,-17,33
Hibernian,7551,1,18,12,6,52,27,25,66
Morton,7551,2,17,13,6,54,36,18,64
Falkirk,7551,3,15,12,9,54,38,16,57
Dundee Utd,7551,4,13,11,12,49,46,3,50
Queen of S't,7551,5,13,11,12,48,47,1,50
Raith,7551,6,12,9,15,42,54,-12,45
Dunfermline,7551,7,10,12,14,48,51,-3,42
Ayr,7551,8,10,11,15,38,56,-18,41
Dumbarton,7551,9,8,12,16,47,58,-11,36
St Mirren,7551,10,7,11,18,37,56,-19,32
Hibernian,7552,1,20,11,5,62,27,35,71
Morton,7552,2,18,11,7,49,34,15,65
Falkirk,7552,3,17,11,8,68,42,26,62
Dundee Utd,7552,4,12,12,12,49,47,2,48
Dunfermline,7552,5,10,13,13,48,48,0,43
Ayr,7552,6,10,12,14,36,50,-14,42
Queen of S't,7552,7,10,11,15,46,54,-8,41
Raith,7552,8,10,10,16,32,48,-16,40
Dumbarton,7552,9,9,12,15,46,61,-15,39
St Mirren,7552,10,6,13,17,39,64,-25,31
Hibernian,7553,1,20,12,4,64,27,37,72
Morton,7553,2,17,11,8,48,35,13,62
Falkirk,7553,3,15,12,9,56,42,14,57
Dundee Utd,7553,4,13,11,12,43,40,3,50
Dunfermline,7553,5,12,13,11,49,41,8,49
Queen of S't,7553,6,11,11,14,45,52,-7,44
Dumbarton,7553,7,9,14,13,46,52,-6,41
Raith,7553,8,10,10,16,34,53,-19,40
St Mirren,7553,9,8,13,15,42,54,-12,37
Ayr,7553,10,6,11,19,31,62,-31,29
Hibernian,7554,1,18,14,4,55,26,29,68
Morton,7554,2,16,14,6,54,39,15,62
Dundee Utd,7554,3,16,10,10,47,37,10,58
Falkirk,7554,4,15,12,9,58,42,16,57
Dunfermline,7554,5,11,13,12,49,48,1,46
Queen of S't,7554,6,10,11,15,49,53,-4,41
Ayr,7554,7,9,12,15,32,52,-20,39
Dumbarton,7554,8,8,13,15,48,62,-14,37
Raith,7554,9,9,10,17,35,49,-14,37
St Mirren,7554,10,8,11,17,35,54,-19,35
Hibernian,7555,1,20,13,3,61,27,34,73
Falkirk,7555,2,15,11,10,61,44,17,56
Morton,7555,3,14,14,8,49,40,9,56
Dundee Utd,7555,4,13,13,10,40,36,4,52
Dunfermline,7555,5,12,12,12,50,45,5,48
Raith,7555,6,10,12,14,38,48,-10,42
Dumbarton,7555,7,9,12,15,44,57,-13,39
Ayr,7555,8,7,17,12,31,48,-17,38
Queen of S't,7555,9,9,10,17,38,52,-14,37
St Mirren,7555,10,7,14,15,40,55,-15,35
Hibernian,7556,1,19,13,4,61,27,34,70
Morton,7556,2,17,11,8,49,36,13,62
Falkirk,7556,3,16,10,10,61,43,18,58
Dundee Utd,7556,4,15,9,12,46,40,6,54
Dumbarton,7556,5,12,11,13,48,51,-3,47
Queen of S't,7556,6,12,10,14,44,49,-5,46
Dunfermline,7556,7,10,14,12,50,50,0,44
St Mirren,7556,8,9,9,18,40,58,-18,36
Ayr,7556,9,8,11,17,33,56,-23,35
Raith,7556,10,8,10,18,38,60,-22,34
Falkirk,7557,1,20,9,7,61,34,27,69
Hibernian,7557,2,19,11,6,53,25,28,68
Morton,7557,3,17,13,6,48,33,15,64
Dundee Utd,7557,4,18,9,9,50,35,15,63
Raith,7557,5,10,11,15,37,51,-14,41
Queen of S't,7557,6,10,10,16,44,52,-8,40
Dumbarton,7557,7,9,11,16,47,59,-12,38
Ayr,7557,8,8,12,16,34,56,-22,36
Dunfermline,7557,9,7,13,16,43,52,-9,34
St Mirren,7557,10,7,11,18,39,59,-20,32
Hibernian,7558,1,19,12,5,58,25,33,69
Morton,7558,2,16,14,6,46,33,13,62
Falkirk,7558,3,16,11,9,63,43,20,59
Dundee Utd,7558,4,13,11,12,46,43,3,50
Queen of S't,7558,5,12,8,16,47,58,-11,44
Dunfermline,7558,6,9,14,13,43,46,-3,41
St Mirren,7558,7,10,11,15,46,54,-8,41
Ayr,7558,8,8,15,13,34,50,-16,39
Raith,7558,9,10,9,17,34,53,-19,39
Dumbarton,7558,10,8,13,15,46,58,-12,37
Hibernian,7559,1,18,12,6,49,26,23,66
Morton,7559,2,18,10,8,51,35,16,64
Falkirk,7559,3,15,13,8,57,40,17,58
Dundee Utd,7559,4,15,11,10,51,42,9,56
Dunfermline,7559,5,11,12,13,50,48,2,45
Raith,7559,6,11,11,14,35,43,-8,44
Queen of S't,7559,7,11,9,16,44,53,-9,42
Ayr,7559,8,9,11,16,34,53,-19,38
Dumbarton,7559,9,8,12,16,49,63,-14,36
St Mirren,7559,10,8,11,17,41,58,-17,35
Hibernian,7560,1,19,12,5,55,28,27,69
Morton,7560,2,17,9,10,52,40,12,60
Falkirk,7560,3,16,11,9,60,40,20,59
Dundee Utd,7560,4,14,10,12,46,42,4,52
Queen of S't,7560,5,12,9,15,44,50,-6,45
Dumbarton,7560,6,11,11,14,56,60,-4,44
Raith,7560,7,10,11,15,37,53,-16,41
Dunfermline,7560,8,9,13,14,46,50,-4,40
Ayr,7560,9,9,12,15,38,56,-18,39
St Mirren,7560,10,9,10,17,44,59,-15,37
Hibernian,7561,1,20,11,5,55,26,29,71
Morton,7561,2,17,10,9,48,36,12,61
Falkirk,7561,3,15,11,10,56,43,13,56
Dundee Utd,7561,4,15,8,13,47,40,7,53
Dunfermline,7561,5,11,13,12,46,44,2,46
Raith,7561,6,12,9,15,39,44,-5,45
Queen of S't,7561,7,11,9,16,42,51,-9,42
Dumbarton,7561,8,10,10,16,47,60,-13,40
Ayr,7561,9,9,12,15,38,58,-20,39
St Mirren,7561,10,8,11,17,37,53,-16,35
Hibernian,7562,1,18,11,7,55,27,28,65
Falkirk,7562,2,17,12,7,59,36,23,63
Dundee Utd,7562,3,17,10,9,55,41,14,61
Morton,7562,4,15,13,8,48,35,13,58
Ayr,7562,5,13,11,12,44,48,-4,50
Dunfermline,7562,6,11,14,11,49,47,2,47
Raith,7562,7,10,9,17,34,53,-19,39
Queen of S't,7562,8,10,8,18,46,60,-14,38
Dumbarton,7562,9,7,12,17,42,65,-23,33
St Mirren,7562,10,7,10,19,38,58,-20,31
Hibernian,7563,1,20,11,5,56,26,30,71
Dundee Utd,7563,2,17,11,8,58,39,19,62
Morton,7563,3,17,10,9,49,35,14,61
Falkirk,7563,4,16,10,10,60,44,16,58
Dunfermline,7563,5,11,13,12,52,46,6,46
Queen of S't,7563,6,11,10,15,42,49,-7,43
Raith,7563,7,11,8,17,37,55,-18,41
Dumbarton,7563,8,8,13,15,44,62,-18,37
St Mirren,7563,9,9,9,18,43,58,-15,36
Ayr,7563,10,7,11,18,33,60,-27,32
Hibernian,7564,1,18,10,8,49,30,19,64
Morton,7564,2,18,9,9,58,43,15,63
Falkirk,7564,3,16,11,9,56,37,19,59
Dundee Utd,7564,4,16,10,10,50,40,10,58
Queen of S't,7564,5,11,12,13,44,48,-4,45
St Mirren,7564,6,11,9,16,43,56,-13,42
Dumbarton,7564,7,10,11,15,46,54,-8,41
Dunfermline,7564,8,9,12,15,42,47,-5,39
Ayr,7564,9,9,12,15,37,55,-18,39
Raith,7564,10,10,8,18,38,53,-15,38
Hibernian,7565,1,20,11,5,56,24,32,71
Morton,7565,2,17,12,7,48,33,15,63
Falkirk,7565,3,16,10,10,53,38,15,58
Dundee Utd,7565,4,16,9,11,52,42,10,57
Queen of S't,7565,5,11,10,15,43,52,-9,43
Dunfermline,7565,6,9,13,14,44,49,-5,40
Dumbarton,7565,7,9,12,15,51,61,-10,39
St Mirren,7565,8,10,9,17,44,56,-12,39
Ayr,7565,9,9,12,15,38,56,-18,39
Raith,7565,10,8,12,16,30,48,-18,36
Hibernian,7566,1,16,13,7,51,31,20,61
Morton,7566,2,16,11,9,47,36,11,59
Dundee Utd,7566,3,16,9,11,49,42,7,57
Falkirk,7566,4,15,11,10,60,40,20,56
Queen of S't,7566,5,13,9,14,47,48,-1,48
Raith,7566,6,10,12,14,38,47,-9,42
Ayr,7566,7,10,11,15,38,54,-16,41
Dunfermline,7566,8,8,16,12,44,50,-6,40
Dumbarton,7566,9,9,13,14,49,60,-11,40
St Mirren,7566,10,9,11,16,38,53,-15,38
Hibernian,7567,1,20,12,4,56,20,36,72
Morton,7567,2,18,11,7,51,38,13,65
Falkirk,7567,3,15,11,10,55,39,16,56
Dundee Utd,7567,4,15,10,11,51,41,10,55
Dunfermline,7567,5,9,14,13,45,51,-6,41
Dumbarton,7567,6,10,11,15,44,56,-12,41
Ayr,7567,7,10,11,15,40,54,-14,41
St Mirren,7567,8,10,10,16,47,55,-8,40
Queen of S't,7567,9,10,8,18,39,55,-16,38
Raith,7567,10,10,8,18,34,53,-19,38
Hibernian,7568,1,19,11,6,57,28,29,68
Morton,7568,2,17,11,8,50,34,16,62
Falkirk,7568,3,14,11,11,53,40,13,53
Dundee Utd,7568,4,14,10,12,49,44,5,52
Ayr,7568,5,12,11,13,41,50,-9,47
Queen of S't,7568,6,11,10,15,47,53,-6,43
Dumbarton,7568,7,10,11,15,46,54,-8,41
Dunfermline,7568,8,9,13,14,42,52,-10,40
Raith,7568,9,10,10,16,36,48,-12,40
St Mirren,7568,10,10,10,16,38,56,-18,40
Morton,7569,1,19,11,6,58,33,25,68
Hibernian,7569,2,18,12,6,54,27,27,66
Falkirk,7569,3,17,9,10,57,44,13,60
Dundee Utd,7569,4,14,11,11,46,42,4,53
Queen of S't,7569,5,11,10,15,43,47,-4,43
Dumbarton,7569,6,11,10,15,53,58,-5,43
Raith,7569,7,10,10,16,38,51,-13,40
Dunfermline,7569,8,8,15,13,44,49,-5,39
Ayr,7569,9,9,11,16,30,53,-23,38
St Mirren,7569,10,9,9,18,40,59,-19,36
Hibernian,7570,1,20,10,6,60,27,33,70
Dundee Utd,7570,2,16,11,9,53,42,11,59
Falkirk,7570,3,15,10,11,59,47,12,55
Morton,7570,4,13,12,11,45,41,4,51
Dunfermline,7570,5,10,16,10,48,46,2,46
St Mirren,7570,6,12,9,15,48,53,-5,45
Queen of S't,7570,7,12,9,15,46,53,-7,45
Ayr,7570,8,9,12,15,38,55,-17,39
Raith,7570,9,10,9,17,35,52,-17,39
Dumbarton,7570,10,9,10,17,45,61,-16,37
Hibernian,7571,1,19,12,5,55,28,27,69
Dundee Utd,7571,2,17,10,9,55,39,16,61
Falkirk,7571,3,17,9,10,62,44,18,60
Morton,7571,4,14,12,10,48,41,7,54
Dunfermline,7571,5,13,12,11,49,44,5,51
Queen of S't,7571,6,11,8,17,48,54,-6,41
St Mirren,7571,7,10,11,15,44,50,-6,41
Raith,7571,8,10,10,16,36,51,-15,40
Dumbarton,7571,9,8,11,17,46,67,-21,35
Ayr,7571,10,8,11,17,36,61,-25,35
Morton,7572,1,20,10,6,56,34,22,70
Hibernian,7572,2,18,12,6,57,28,29,66
Dundee Utd,7572,3,18,8,10,55,39,16,62
Falkirk,7572,4,16,10,10,59,41,18,58
Dunfermline,7572,5,10,11,15,46,51,-5,41
Dumbarton,7572,6,10,10,16,45,60,-15,40
Ayr,7572,7,10,10,16,36,55,-19,40
St Mirren,7572,8,10,9,17,42,55,-13,39
Queen of S't,7572,9,10,8,18,44,56,-12,38
Raith,7572,10,10,8,18,37,58,-21,38
Hibernian,7573,1,19,12,5,58,29,29,69
Dundee Utd,7573,2,18,10,8,57,39,18,64
Morton,7573,3,16,13,7,56,42,14,61
Falkirk,7573,4,15,10,11,53,43,10,55
Dunfermline,7573,5,10,14,12,52,49,3,44
Queen of S't,7573,6,10,11,15,43,50,-7,41
Dumbarton,7573,7,9,13,14,45,57,-12,40
Raith,7573,8,9,11,16,36,50,-14,38
Ayr,7573,9,8,14,14,38,56,-18,38
St Mirren,7573,10,6,12,18,37,60,-23,30
Hibernian,7574,1,20,10,6,63,34,29,70
Morton,7574,2,17,10,9,53,41,12,61
Falkirk,7574,3,17,9,10,60,42,18,60
Dundee Utd,7574,4,17,9,10,48,38,10,60
Dumbarton,7574,5,11,12,13,53,56,-3,45
Queen of S't,7574,6,12,9,15,45,53,-8,45
Dunfermline,7574,7,11,11,14,54,54,0,44
Raith,7574,8,9,11,16,35,49,-14,38
St Mirren,7574,9,8,10,18,41,61,-20,34
Ayr,7574,10,7,11,18,33,57,-24,32
Hibernian,7575,1,18,12,6,54,32,22,66
Morton,7575,2,18,10,8,51,37,14,64
Falkirk,7575,3,15,13,8,62,43,19,58
Dundee Utd,7575,4,15,10,11,48,37,11,55
Queen of S't,7575,5,12,11,13,45,47,-2,47
Raith,7575,6,12,9,15,36,49,-13,45
Dunfermline,7575,7,10,12,14,48,51,-3,42
Ayr,7575,8,9,11,16,34,51,-17,38
Dumbarton,7575,9,8,11,17,48,61,-13,35
St Mirren,7575,10,7,13,16,39,57,-18,34
Hibernian,7576,1,19,13,4,60,24,36,70
Falkirk,7576,2,18,9,9,64,39,25,63
Morton,7576,3,16,13,7,49,38,11,61
Dundee Utd,7576,4,14,11,11,51,45,6,53
Queen of S't,7576,5,13,9,14,48,48,0,48
Ayr,7576,6,10,11,15,38,54,-16,41
Raith,7576,7,11,8,17,35,51,-16,41
Dumbarton,7576,8,9,11,16,49,64,-15,38
Dunfermline,7576,9,8,12,16,42,53,-11,36
St Mirren,7576,10,8,11,17,39,59,-20,35
Hibernian,7577,1,19,10,7,53,25,28,67
Falkirk,7577,2,17,11,8,56,36,20,62
Dundee Utd,7577,3,16,9,11,51,38,13,57
Morton,7577,4,15,11,10,51,43,8,56
Dumbarton,7577,5,12,10,14,50,57,-7,46
Raith,7577,6,11,9,16,33,47,-14,42
St Mirren,7577,7,10,11,15,41,53,-12,41
Queen of S't,7577,8,10,10,16,37,46,-9,40
Dunfermline,7577,9,9,12,15,44,51,-7,39
Ayr,7577,10,9,11,16,33,53,-20,38
Hibernian,7578,1,19,12,5,59,26,33,69
Morton,7578,2,18,11,7,61,38,23,65
Falkirk,7578,3,17,9,10,60,40,20,60
Dundee Utd,7578,4,16,11,9,51,39,12,59
Queen of S't,7578,5,13,10,13,47,49,-2,49
Dunfermline,7578,6,9,13,14,41,55,-14,40
Raith,7578,7,9,11,16,40,51,-11,38
Dumbarton,7578,8,8,13,15,47,58,-11,37
St Mirren,7578,9,8,10,18,39,60,-21,34
Ayr,7578,10,6,14,16,32,61,-29,32
Hibernian,7579,1,18,11,7,56,30,26,65
Morton,7579,2,18,11,7,52,34,18,65
Falkirk,7579,3,16,12,8,57,38,19,60
Dundee Utd,7579,4,15,10,11,48,41,7,55
Ayr,7579,5,11,12,13,38,50,-12,45
Dumbarton,7579,6,9,13,14,47,59,-12,40
Dunfermline,7579,7,8,15,13,43,49,-6,39
Queen of S't,7579,8,10,9,17,41,50,-9,39
St Mirren,7579,9,10,9,17,39,53,-14,39
Raith,7579,10,10,8,18,36,53,-17,38
Morton,7580,1,18,10,8,55,38,17,64
Hibernian,7580,2,16,15,5,48,26,22,63
Falkirk,7580,3,17,11,8,62,38,24,62
Dundee Utd,7580,4,17,9,10,52,37,15,60
Dunfermline,7580,5,11,13,12,47,47,0,46
Queen of S't,7580,6,12,10,14,48,52,-4,46
Raith,7580,7,10,10,16,37,50,-13,40
Dumbarton,7580,8,9,11,16,48,61,-13,38
St Mirren,7580,9,8,9,19,36,59,-23,33
Ayr,7580,10,7,12,17,31,56,-25,33
Hibernian,7581,1,20,12,4,59,26,33,72
Morton,7581,2,15,15,6,53,38,15,60
Falkirk,7581,3,16,11,9,57,41,16,59
Dundee Utd,7581,4,14,12,10,53,42,11,54
Dunfermline,7581,5,10,14,12,46,47,-1,44
Dumbarton,7581,6,10,12,14,51,58,-7,42
Queen of S't,7581,7,11,9,16,39,49,-10,42
St Mirren,7581,8,9,12,15,43,56,-13,39
Raith,7581,9,9,10,17,37,52,-15,37
Ayr,7581,10,7,11,18,36,65,-29,32
Hibernian,7582,1,20,11,5,57,24,33,71
Morton,7582,2,19,12,5,55,33,22,69
Dundee Utd,7582,3,16,10,10,48,42,6,58
Falkirk,7582,4,16,9,11,55,40,15,57
Queen of S't,7582,5,14,8,14,50,52,-2,50
Dunfermline,7582,6,9,13,14,43,47,-4,40
Dumbarton,7582,7,9,12,15,48,59,-11,39
Raith,7582,8,9,9,18,36,53,-17,36
St Mirren,7582,9,8,10,18,38,56,-18,34
Ayr,7582,10,8,10,18,35,59,-24,34
Hibernian,7583,1,18,14,4,55,24,31,68
Morton,7583,2,17,13,6,50,36,14,64
Falkirk,7583,3,16,11,9,61,40,21,59
Dundee Utd,7583,4,15,9,12,53,42,11,54
Queen of S't,7583,5,12,8,16,44,48,-4,44
Dunfermline,7583,6,9,14,13,43,47,-4,41
Raith,7583,7,10,10,16,36,53,-17,40
Ayr,7583,8,9,12,15,35,55,-20,39
Dumbarton,7583,9,8,13,15,48,66,-18,37
St Mirren,7583,10,8,12,16,39,53,-14,36
Hibernian,7584,1,21,11,4,59,26,33,74
Morton,7584,2,15,12,9,50,37,13,57
Falkirk,7584,3,15,11,10,55,41,14,56
Dundee Utd,7584,4,15,9,12,45,41,4,54
Dunfermline,7584,5,11,11,14,45,48,-3,44
St Mirren,7584,6,11,10,15,42,51,-9,43
Ayr,7584,7,11,10,15,39,54,-15,43
Queen of S't,7584,8,11,9,16,47,55,-8,42
Raith,7584,9,10,10,16,35,49,-14,40
Dumbarton,7584,10,8,11,17,47,62,-15,35
Hibernian,7585,1,19,11,6,57,27,30,68
Falkirk,7585,2,17,11,8,54,34,20,62
Morton,7585,3,16,13,7,47,33,14,61
Dundee Utd,7585,4,16,10,10,51,38,13,58
Dumbarton,7585,5,11,11,14,49,54,-5,44
Raith,7585,6,11,11,14,37,45,-8,44
Queen of S't,7585,7,11,9,16,44,56,-12,42
Dunfermline,7585,8,9,14,13,39,45,-6,41
Ayr,7585,9,7,12,17,34,58,-24,33
St Mirren,7585,10,7,10,19,34,56,-22,31
Morton,7586,1,18,13,5,54,33,21,67
Hibernian,7586,2,17,12,7,55,30,25,63
Falkirk,7586,3,17,11,8,59,37,22,62
Dundee Utd,7586,4,17,9,10,56,44,12,60
Queen of S't,7586,5,11,8,17,43,54,-11,41
Raith,7586,6,11,8,17,37,53,-16,41
Ayr,7586,7,9,12,15,44,60,-16,39
St Mirren,7586,8,9,11,16,44,58,-14,38
Dumbarton,7586,9,9,11,16,48,63,-15,38
Dunfermline,7586,10,8,13,15,43,51,-8,37
Hibernian,7587,1,19,11,6,58,30,28,68
Morton,7587,2,18,10,8,52,38,14,64
Falkirk,7587,3,15,10,11,56,46,10,55
Dundee Utd,7587,4,15,10,11,55,46,9,55
Raith,7587,5,13,9,14,40,47,-7,48
Queen of S't,7587,6,12,9,15,46,50,-4,45
Dunfermline,7587,7,10,12,14,44,48,-4,42
Dumbarton,7587,8,10,10,16,49,58,-9,40
St Mirren,7587,9,10,9,17,45,59,-14,39
Ayr,7587,10,7,12,17,32,55,-23,33
Hibernian,7588,1,18,14,4,53,23,30,68
Falkirk,7588,2,18,10,8,61,37,24,64
Morton,7588,3,16,13,7,46,32,14,61
Dundee Utd,7588,4,14,11,11,48,42,6,53
Queen of S't,7588,5,12,10,14,45,52,-7,46
Ayr,7588,6,10,13,13,37,51,-14,43
Dumbarton,7588,7,9,13,14,47,56,-9,40
Dunfermline,7588,8,8,12,16,39,49,-10,36
Raith,7588,9,9,9,18,34,52,-18,36
St Mirren,7588,10,8,11,17,41,57,-16,35
Hibernian,7589,1,22,10,4,65,30,35,76
Dundee Utd,7589,2,18,10,8,51,35,16,64
Morton,7589,3,16,14,6,55,38,17,62
Falkirk,7589,4,16,11,9,59,41,18,59
Queen of S't,7589,5,12,10,14,47,49,-2,46
Ayr,7589,6,8,13,15,34,51,-17,37
Dumbarton,7589,7,8,12,16,43,62,-19,36
Dunfermline,7589,8,7,14,15,43,53,-10,35
Raith,7589,9,9,8,19,33,54,-21,35
St Mirren,7589,10,7,12,17,37,54,-17,33
Hibernian,7590,1,21,11,4,59,23,36,74
Falkirk,7590,2,16,11,9,58,36,22,59
Dundee Utd,7590,3,16,8,12,45,41,4,56
Morton,7590,4,13,16,7,46,36,10,55
Dunfermline,7590,5,11,13,12,45,44,1,46
Raith,7590,6,11,10,15,33,44,-11,43
St Mirren,7590,7,10,10,16,42,53,-11,40
Queen of S't,7590,8,10,9,17,43,63,-20,39
Dumbarton,7590,9,9,11,16,50,57,-7,38
Ayr,7590,10,8,11,17,38,62,-24,35
Hibernian,7591,1,21,10,5,56,27,29,73
Falkirk,7591,2,16,11,9,59,42,17,59
Dundee Utd,7591,3,16,10,10,50,36,14,58
Morton,7591,4,15,13,8,46,37,9,58
Queen of S't,7591,5,12,9,15,50,55,-5,45
Dunfermline,7591,6,9,13,14,46,48,-2,40
St Mirren,7591,7,10,10,16,40,56,-16,40
Raith,7591,8,10,9,17,35,50,-15,39
Dumbarton,7591,9,8,14,14,51,60,-9,38
Ayr,7591,10,7,13,16,36,58,-22,34
Hibernian,7592,1,18,13,5,56,29,27,67
Morton,7592,2,18,11,7,63,34,29,65
Falkirk,7592,3,16,11,9,58,40,18,59
Dundee Utd,7592,4,16,9,11,49,41,8,57
Queen of S't,7592,5,11,11,14,47,48,-1,44
Raith,7592,6,9,13,14,36,48,-12,40
Dumbarton,7592,7,10,10,16,45,59,-14,40
St Mirren,7592,8,9,11,16,41,55,-14,38
Ayr,7592,9,8,13,15,35,58,-23,37
Dunfermline,7592,10,8,12,16,46,64,-18,36
Hibernian,7593,1,19,14,3,55,24,31,71
Dundee Utd,7593,2,17,9,10,51,38,13,60
Morton,7593,3,15,12,9,47,36,11,57
Falkirk,7593,4,15,11,10,57,41,16,56
Raith,7593,5,12,10,14,38,48,-10,46
Queen of S't,7593,6,12,8,16,48,52,-4,44
Dunfermline,7593,7,10,11,15,46,52,-6,41
Ayr,7593,8,8,14,14,34,56,-22,38
St Mirren,7593,9,9,10,17,46,59,-13,37
Dumbarton,7593,10,8,11,17,44,60,-16,35
Hibernian,7594,1,20,11,5,59,25,34,71
Morton,7594,2,18,11,7,50,34,16,65
Falkirk,7594,3,17,11,8,60,38,22,62
Dundee Utd,7594,4,17,10,9,54,37,17,61
Dunfermline,7594,5,11,13,12,53,54,-1,46
Queen of S't,7594,6,11,9,16,42,55,-13,42
Ayr,7594,7,9,11,16,38,55,-17,38
Raith,7594,8,9,10,17,34,53,-19,37
St Mirren,7594,9,8,9,19,38,58,-20,33
Dumbarton,7594,10,7,11,18,45,64,-19,32
Hibernian,7595,1,19,10,7,53,28,25,67
Dundee Utd,7595,2,17,10,9,52,36,16,61
Morton,7595,3,16,11,9,49,36,13,59
Falkirk,7595,4,14,12,10,52,40,12,54
Queen of S't,7595,5,12,9,15,44,51,-7,45
Ayr,7595,6,11,11,14,37,50,-13,44
Dunfermline,7595,7,10,13,13,46,47,-1,43
Raith,7595,8,11,10,15,33,44,-11,43
Dumbarton,7595,9,10,10,16,48,60,-12,40
St Mirren,7595,10,7,10,19,34,56,-22,31
Hibernian,7596,1,20,11,5,58,27,31,71
Morton,7596,2,18,10,8,51,37,14,64
Dundee Utd,7596,3,16,9,11,53,43,10,57
Falkirk,7596,4,15,10,11,60,47,13,55
Queen of S't,7596,5,12,10,14,54,54,0,46
Dunfermline,7596,6,11,11,14,50,55,-5,44
Raith,7596,7,11,10,15,41,52,-11,43
Dumbarton,7596,8,9,10,17,51,64,-13,37
St Mirren,7596,9,9,10,17,44,60,-16,37
Ayr,7596,10,8,11,17,34,57,-23,35
Hibernian,7597,1,19,11,6,55,29,26,68
Morton,7597,2,17,13,6,57,38,19,64
Falkirk,7597,3,15,11,10,54,41,13,56
Dundee Utd,7597,4,15,11,10,53,41,12,56
Queen of S't,7597,5,13,8,15,47,52,-5,47
Dunfermline,7597,6,11,11,14,52,53,-1,44
Raith,7597,7,10,11,15,39,51,-12,41
St Mirren,7597,8,9,11,16,45,55,-10,38
Ayr,7597,9,8,12,16,32,55,-23,36
Dumbarton,7597,10,8,11,17,48,67,-19,35
Hibernian,7598,1,17,12,7,52,29,23,63
Morton,7598,2,17,10,9,53,39,14,61
Falkirk,7598,3,16,12,8,58,39,19,60
Dundee Utd,7598,4,17,9,10,51,40,11,60
Dunfermline,7598,5,11,13,12,48,45,3,46
Dumbarton,7598,6,10,12,14,47,56,-9,42
Raith,7598,7,10,12,14,36,48,-12,42
Queen of S't,7598,8,9,11,16,46,56,-10,38
St Mirren,7598,9,9,10,17,39,55,-16,37
Ayr,7598,10,7,13,16,34,57,-23,34
Hibernian,7599,1,18,12,6,53,26,27,66
Morton,7599,2,19,9,8,50,37,13,66
Falkirk,7599,3,18,11,7,59,37,22,65
Dundee Utd,7599,4,15,11,10,49,41,8,56
Queen of S't,7599,5,12,8,16,49,52,-3,44
Dunfermline,7599,6,9,14,13,46,48,-2,41
Raith,7599,7,10,10,16,35,52,-17,40
Dumbarton,7599,8,9,12,15,48,58,-10,39
Ayr,7599,9,8,13,15,36,54,-18,37
St Mirren,7599,10,7,10,19,39,59,-20,31
Hibernian,7600,1,19,13,4,61,28,33,70
Morton,7600,2,17,10,9,50,42,8,61
Dundee Utd,7600,3,16,10,10,54,41,13,58
Falkirk,7600,4,15,11,10,61,43,18,56
Queen of S't,7600,5,12,10,14,46,49,-3,46
Dunfermline,7600,6,9,14,13,45,49,-4,41
Raith,7600,7,10,10,16,33,45,-12,40
Ayr,7600,8,9,13,14,38,57,-19,40
Dumbarton,7600,9,8,13,15,49,61,-12,37
St Mirren,7600,10,8,10,18,40,62,-22,34
Hibernian,7601,1,18,14,4,52,26,26,68
Morton,7601,2,15,12,9,46,37,9,57
Falkirk,7601,3,15,10,11,54,43,11,55
Dundee Utd,7601,4,14,10,12,44,40,4,52
Raith,7601,5,12,10,14,38,44,-6,46
Dunfermline,7601,6,11,12,13,45,44,1,45
Queen of S't,7601,7,11,11,14,42,47,-5,44
Dumbarton,7601,8,10,13,13,49,51,-2,43
St Mirren,7601,9,10,11,15,39,53,-14,41
Ayr,7601,10,6,13,17,29,53,-24,31
Hibernian,7602,1,19,12,5,59,25,34,69
Falkirk,7602,2,17,10,9,62,40,22,61
Morton,7602,3,17,10,9,49,42,7,61
Dundee Utd,7602,4,15,10,11,46,40,6,55
Dunfermline,7602,5,13,11,12,52,44,8,50
Queen of S't,7602,6,12,8,16,47,56,-9,44
Raith,7602,7,10,10,16,38,53,-15,40
Dumbarton,7602,8,9,11,16,49,62,-13,38
Ayr,7602,9,8,13,15,33,53,-20,37
St Mirren,7602,10,8,9,19,42,62,-20,33
Hibernian,7603,1,18,12,6,56,30,26,66
Morton,7603,2,18,10,8,56,42,14,64
Dundee Utd,7603,3,17,9,10,54,35,19,60
Falkirk,7603,4,16,10,10,59,43,16,58
Dunfermline,7603,5,12,12,12,48,46,2,48
Dumbarton,7603,6,10,12,14,52,60,-8,42
Queen of S't,7603,7,10,10,16,41,48,-7,40
Raith,7603,8,10,10,16,38,51,-13,40
Ayr,7603,9,8,13,15,36,60,-24,37
St Mirren,7603,10,7,10,19,37,62,-25,31
Hibernian,7604,1,19,12,5,54,26,28,69
Morton,7604,2,18,12,6,51,34,17,66
Falkirk,7604,3,16,12,8,58,38,20,60
Dundee Utd,7604,4,16,11,9,49,34,15,59
Queen of S't,7604,5,13,9,14,49,55,-6,48
Dunfermline,7604,6,9,14,13,49,51,-2,41
Dumbarton,7604,7,9,11,16,43,56,-13,38
Raith,7604,8,9,10,17,35,51,-16,37
St Mirren,7604,9,8,10,18,35,54,-19,34
Ayr,7604,10,7,11,18,29,53,-24,32
Hibernian,7605,1,20,12,4,59,22,37,72
Morton,7605,2,16,13,7,55,40,15,61
Dundee Utd,7605,3,16,11,9,52,39,13,59
Falkirk,7605,4,16,10,10,59,40,19,58
Queen of S't,7605,5,11,11,14,49,57,-8,44
St Mirren,7605,6,10,11,15,47,60,-13,41
Dunfermline,7605,7,8,15,13,41,47,-6,39
Ayr,7605,8,8,14,14,34,53,-19,38
Dumbarton,7605,9,8,11,17,46,64,-18,35
Raith,7605,10,8,10,18,35,55,-20,34
Hibernian,7606,1,20,12,4,58,25,33,72
Morton,7606,2,17,12,7,50,36,14,63
Falkirk,7606,3,15,11,10,57,41,16,56
Dundee Utd,7606,4,15,10,11,53,43,10,55
Dunfermline,7606,5,12,12,12,45,41,4,48
Queen of S't,7606,6,12,9,15,46,54,-8,45
Raith,7606,7,10,9,17,34,50,-16,39
Ayr,7606,8,9,12,15,37,57,-20,39
Dumbarton,7606,9,8,11,17,50,63,-13,35
St Mirren,7606,10,7,12,17,42,62,-20,33
Hibernian,7607,1,18,12,6,57,29,28,66
Morton,7607,2,17,14,5,50,33,17,65
Dundee Utd,7607,3,17,9,10,55,40,15,60
Falkirk,7607,4,14,10,12,60,50,10,52
Dunfermline,7607,5,11,12,13,49,48,1,45
Raith,7607,6,12,8,16,40,48,-8,44
Queen of S't,7607,7,11,9,16,46,56,-10,42
Dumbarton,7607,8,9,12,15,47,56,-9,39
Ayr,7607,9,9,11,16,38,58,-20,38
St Mirren,7607,10,8,11,17,37,61,-24,35
Morton,7608,1,19,11,6,54,33,21,68
Hibernian,7608,2,17,11,8,54,30,24,62
Dundee Utd,7608,3,17,11,8,51,36,15,62
Falkirk,7608,4,14,13,9,55,40,15,55
Queen of S't,7608,5,12,11,13,45,47,-2,47
Dunfermline,7608,6,9,15,12,45,51,-6,42
Raith,7608,7,9,12,15,32,45,-13,39
Ayr,7608,8,9,12,15,34,49,-15,39
St Mirren,7608,9,8,11,17,38,55,-17,35
Dumbarton,7608,10,7,11,18,43,65,-22,32
Hibernian,7609,1,19,12,5,56,28,28,69
Morton,7609,2,18,11,7,55,35,20,65
Falkirk,7609,3,17,9,10,54,37,17,60
Dundee Utd,7609,4,16,10,10,51,39,12,58
Queen of S't,7609,5,13,9,14,48,50,-2,48
Dumbarton,7609,6,10,12,14,49,61,-12,42
Dunfermline,7609,7,9,12,15,45,55,-10,39
Raith,7609,8,10,9,17,33,48,-15,39
St Mirren,7609,9,8,10,18,45,56,-11,34
Ayr,7609,10,6,14,16,30,57,-27,32
Morton,7610,1,19,10,7,57,36,21,67
Hibernian,7610,2,18,11,7,53,28,25,65
Falkirk,7610,3,15,10,11,60,47,13,55
Dundee Utd,7610,4,15,9,12,53,49,4,54
Raith,7610,5,12,9,15,34,44,-10,45
Queen of S't,7610,6,11,10,15,44,53,-9,43
Dunfermline,7610,7,10,12,14,48,50,-2,42
Ayr,7610,8,10,11,15,45,62,-17,41
Dumbarton,7610,9,9,13,14,51,58,-7,40
St Mirren,7610,10,9,9,18,42,60,-18,36
Morton,7611,1,21,9,6,57,31,26,72
Hibernian,7611,2,19,10,7,58,28,30,67
Falkirk,7611,3,17,10,9,64,39,25,61
Dundee Utd,7611,4,16,9,11,50,43,7,57
Queen of S't,7611,5,12,10,14,44,48,-4,46
Dunfermline,7611,6,10,11,15,44,50,-6,41
Dumbarton,7611,7,10,10,16,52,62,-10,40
Raith,7611,8,10,9,17,33,54,-21,39
St Mirren,7611,9,8,10,18,42,64,-22,34
Ayr,7611,10,7,12,17,30,55,-25,33
Hibernian,7612,1,20,11,5,56,25,31,71
Dundee Utd,7612,2,19,8,9,51,37,14,65
Falkirk,7612,3,17,9,10,59,39,20,60
Morton,7612,4,16,11,9,51,39,12,59
Queen of S't,7612,5,13,8,15,46,52,-6,47
Dunfermline,7612,6,10,12,14,46,50,-4,42
Raith,7612,7,10,10,16,33,48,-15,40
St Mirren,7612,8,9,9,18,38,53,-15,36
Ayr,7612,9,8,12,16,35,55,-20,36
Dumbarton,7612,10,8,10,18,43,60,-17,34
Hibernian,7613,1,20,10,6,56,28,28,70
Morton,7613,2,19,9,8,56,41,15,66
Falkirk,7613,3,16,13,7,57,37,20,61
Dundee Utd,7613,4,16,10,10,50,39,11,58
Dunfermline,7613,5,9,14,13,46,48,-2,41
Queen of S't,7613,6,10,10,16,40,47,-7,40
Raith,7613,7,9,13,14,34,46,-12,40
Ayr,7613,8,8,13,15,34,54,-20,37
Dumbarton,7613,9,8,12,16,42,57,-15,36
St Mirren,7613,10,7,12,17,39,57,-18,33
Hibernian,7614,1,20,12,4,52,22,30,72
Morton,7614,2,18,10,8,58,38,20,64
Falkirk,7614,3,15,14,7,57,37,20,59
Dundee Utd,7614,4,12,11,13,45,44,1,47
Dunfermline,7614,5,11,14,11,45,46,-1,47
Queen of S't,7614,6,11,10,15,44,50,-6,43
Raith,7614,7,11,9,16,36,48,-12,42
Dumbarton,7614,8,9,12,15,48,59,-11,39
Ayr,7614,9,8,12,16,33,55,-22,36
St Mirren,7614,10,7,12,17,38,57,-19,33
Hibernian,7615,1,20,12,4,57,22,35,72
Morton,7615,2,17,13,6,55,34,21,64
Falkirk,7615,3,17,10,9,69,50,19,61
Dundee Utd,7615,4,15,9,12,52,50,2,54
Queen of S't,7615,5,12,9,15,46,54,-8,45
Raith,7615,6,12,8,16,39,50,-11,44
Dunfermline,7615,7,9,14,13,46,47,-1,41
Dumbarton,7615,8,8,13,15,52,63,-11,37
Ayr,7615,9,8,11,17,32,56,-24,35
St Mirren,7615,10,7,11,18,35,57,-22,32
Hibernian,7616,1,21,10,5,65,27,38,73
Morton,7616,2,18,11,7,53,34,19,65
Falkirk,7616,3,16,9,11,61,46,15,57
Queen of S't,7616,4,14,8,14,47,48,-1,50
Dundee Utd,7616,5,13,10,13,47,51,-4,49
Dunfermline,7616,6,10,13,13,47,47,0,43
St Mirren,7616,7,10,10,16,40,58,-18,40
Raith,7616,8,9,11,16,32,49,-17,38
Ayr,7616,9,9,11,16,37,56,-19,38
Dumbarton,7616,10,8,11,17,45,58,-13,35
Hibernian,7617,1,21,11,4,59,24,35,74
Morton,7617,2,17,10,9,50,38,12,61
Falkirk,7617,3,15,12,9,62,41,21,57
Dundee Utd,7617,4,16,9,11,47,42,5,57
Queen of S't,7617,5,13,8,15,46,48,-2,47
Dumbarton,7617,6,10,12,14,47,58,-11,42
Dunfermline,7617,7,9,13,14,45,53,-8,40
Raith,7617,8,9,12,15,37,50,-13,39
Ayr,7617,9,8,12,16,30,53,-23,36
St Mirren,7617,10,7,11,18,43,59,-16,32
Morton,7618,1,18,10,8,49,35,14,64
Hibernian,7618,2,17,11,8,50,29,21,62
Falkirk,7618,3,17,10,9,58,41,17,61
Dundee Utd,7618,4,15,9,12,47,41,6,54
Dunfermline,7618,5,10,14,12,50,48,2,44
Queen of S't,7618,6,11,11,14,40,46,-6,44
Raith,7618,7,11,10,15,38,47,-9,43
St Mirren,7618,8,9,11,16,41,55,-14,38
Ayr,7618,9,8,14,14,34,51,-17,38
Dumbarton,7618,10,7,14,15,42,56,-14,35
Hibernian,7619,1,19,10,7,59,28,31,67
Dundee Utd,7619,2,17,9,10,56,40,16,60
Falkirk,7619,3,16,10,10,59,44,15,58
Morton,7619,4,16,10,10,47,42,5,58
Dunfermline,7619,5,13,11,12,51,46,5,50
Raith,7619,6,12,9,15,36,47,-11,45
Queen of S't,7619,7,11,10,15,43,50,-7,43
Ayr,7619,8,9,12,15,34,56,-22,39
St Mirren,7619,9,9,10,17,46,59,-13,37
Dumbarton,7619,10,7,11,18,46,65,-19,32
Hibernian,7620,1,18,14,4,51,24,27,68
Morton,7620,2,17,12,7,50,36,14,63
Falkirk,7620,3,16,11,9,58,42,16,59
Dundee Utd,7620,4,16,11,9,55,40,15,59
Dunfermline,7620,5,10,13,13,48,54,-6,43
Queen of S't,7620,6,11,9,16,45,52,-7,42
Ayr,7620,7,9,14,13,39,55,-16,41
Dumbarton,7620,8,9,10,17,50,59,-9,37
Raith,7620,9,8,12,16,34,50,-16,36
St Mirren,7620,10,8,10,18,36,54,-18,34
Hibernian,7621,1,20,12,4,55,22,33,72
Morton,7621,2,16,13,7,52,34,18,61
Falkirk,7621,3,15,10,11,54,40,14,55
Dundee Utd,7621,4,14,10,12,49,44,5,52
Queen of S't,7621,5,13,9,14,45,47,-2,48
Dunfermline,7621,6,10,13,13,46,50,-4,43
Ayr,7621,7,10,12,14,33,48,-15,42
Dumbarton,7621,8,10,11,15,45,54,-9,41
St Mirren,7621,9,8,11,17,36,56,-20,35
Raith,7621,10,8,11,17,30,50,-20,35
Hibernian,7622,1,17,12,7,51,26,25,63
Dundee Utd,7622,2,18,9,9,56,38,18,63
Falkirk,7622,3,17,11,8,63,39,24,62
Morton,7622,4,16,12,8,47,34,13,60
Dunfermline,7622,5,11,12,13,46,48,-2,45
Queen of S't,7622,6,11,10,15,44,53,-9,43
Raith,7622,7,11,9,16,35,49,-14,42
St Mirren,7622,8,8,12,16,39,55,-16,36
Dumbarton,7622,9,7,14,15,42,57,-15,35
Ayr,7622,10,7,13,16,30,54,-24,34
Hibernian,7623,1,19,12,5,57,31,26,69
Morton,7623,2,17,13,6,58,39,19,64
Falkirk,7623,3,17,10,9,59,37,22,61
Dundee Utd,7623,4,16,10,10,54,39,15,58
Dunfermline,7623,5,10,14,12,44,44,0,44
Queen of S't,7623,6,11,9,16,44,52,-8,42
Raith,7623,7,10,8,18,32,54,-22,38
Dumbarton,7623,8,7,15,14,48,60,-12,36
St Mirren,7623,9,9,9,18,44,60,-16,36
Ayr,7623,10,8,12,16,34,58,-24,36
Hibernian,7624,1,21,11,4,56,24,32,74
Morton,7624,2,15,13,8,47,37,10,58
Falkirk,7624,3,15,10,11,57,41,16,55
Dundee Utd,7624,4,15,10,11,50,45,5,55
Dunfermline,7624,5,13,13,10,49,42,7,52
Queen of S't,7624,6,12,11,13,47,47,0,47
Ayr,7624,7,9,11,16,34,54,-20,38
Dumbarton,7624,8,8,13,15,45,57,-12,37
Raith,7624,9,8,11,17,30,49,-19,35
St Mirren,7624,10,6,13,17,38,57,-19,31
Morton,7625,1,17,11,8,49,38,11,62
Hibernian,7625,2,16,12,8,49,28,21,60
Dundee Utd,7625,3,16,11,9,49,37,12,59
Falkirk,7625,4,13,14,9,53,40,13,53
Dunfermline,7625,5,12,13,11,50,43,7,49
Queen of S't,7625,6,11,10,15,42,48,-6,43
Raith,7625,7,11,10,15,37,48,-11,43
St Mirren,7625,8,11,9,16,38,51,-13,42
Ayr,7625,9,10,10,16,39,53,-14,40
Dumbarton,7625,10,8,10,18,46,66,-20,34
Hibernian,7626,1,19,14,3,58,26,32,71
Morton,7626,2,19,11,6,54,34,20,68
Dundee Utd,7626,3,17,9,10,50,38,12,60
Falkirk,7626,4,15,12,9,55,37,18,57
Queen of S't,7626,5,11,9,16,41,50,-9,42
Dunfermline,7626,6,8,15,13,44,49,-5,39
Dumbarton,7626,7,9,11,16,47,60,-13,38
St Mirren,7626,8,8,12,16,36,52,-16,36
Ayr,7626,9,8,12,16,33,54,-21,36
Raith,7626,10,8,11,17,32,50,-18,35
Hibernian,7627,1,20,11,5,55,24,31,71
Morton,7627,2,20,9,7,51,31,20,69
Falkirk,7627,3,19,10,7,62,34,28,67
Dundee Utd,7627,4,17,10,9,48,36,12,61
Dunfermline,7627,5,9,13,14,42,45,-3,40
Queen of S't,7627,6,10,10,16,42,52,-10,40
Raith,7627,7,9,11,16,34,49,-15,38
St Mirren,7627,8,9,9,18,39,57,-18,36
Dumbarton,7627,9,7,12,17,43,61,-18,33
Ayr,7627,10,6,13,17,29,56,-27,31
Hibernian,7628,1,20,12,4,61,21,40,72
Falkirk,7628,2,17,12,7,59,39,20,63
Morton,7628,3,15,13,8,49,38,11,58
Dundee Utd,7628,4,13,12,11,41,36,5,51
Dunfermline,7628,5,9,16,11,46,49,-3,43
Queen of S't,7628,6,11,10,15,42,50,-8,43
Raith,7628,7,11,10,15,36,49,-13,43
St Mirren,7628,8,9,11,16,43,57,-14,38
Ayr,7628,9,8,12,16,33,53,-20,36
Dumbarton,7628,10,8,10,18,46,64,-18,34
Hibernian,7629,1,20,12,4,52,24,28,72
Morton,7629,2,17,9,10,53,39,14,60
Dundee Utd,7629,3,16,9,11,56,45,11,57
Falkirk,7629,4,14,14,8,56,39,17,56
Ayr,7629,5,11,10,15,43,52,-9,43
Dumbarton,7629,6,10,11,15,53,67,-14,41
Queen of S't,7629,7,10,10,16,43,56,-13,40
St Mirren,7629,8,10,10,16,42,56,-14,40
Raith,7629,9,10,9,17,38,53,-15,39
Dunfermline,7629,10,8,14,14,46,51,-5,38
Hibernian,7630,1,19,13,4,58,25,33,70
Falkirk,7630,2,18,10,8,63,39,24,64
Dundee Utd,7630,3,17,9,10,49,35,14,60
Morton,7630,4,15,12,9,48,39,9,57
Queen of S't,7630,5,12,10,14,45,48,-3,46
Dunfermline,7630,6,10,13,13,52,56,-4,43
Raith,7630,7,10,10,16,34,49,-15,40
Dumbarton,7630,8,9,11,16,45,60,-15,38
Ayr,7630,9,8,11,17,35,57,-22,35
St Mirren,7630,10,7,11,18,36,57,-21,32
Hibernian,7631,1,18,12,6,59,34,25,66
Morton,7631,2,18,10,8,55,38,17,64
Falkirk,7631,3,17,10,9,65,44,21,61
Dundee Utd,7631,4,15,11,10,53,44,9,56
Ayr,7631,5,11,12,13,41,53,-12,45
Dunfermline,7631,6,9,15,12,51,49,2,42
Raith,7631,7,11,8,17,37,53,-16,41
Dumbarton,7631,8,10,10,16,47,63,-16,40
Queen of S't,7631,9,9,10,17,48,63,-15,37
St Mirren,7631,10,8,10,18,42,57,-15,34
Hibernian,7632,1,19,13,4,55,24,31,70
Dundee Utd,7632,2,16,11,9,53,41,12,59
Falkirk,7632,3,15,11,10,54,39,15,56
Morton,7632,4,14,12,10,49,42,7,54
Raith,7632,5,12,10,14,38,45,-7,46
Dumbarton,7632,6,10,12,14,50,58,-8,42
Dunfermline,7632,7,9,14,13,45,50,-5,41
Queen of S't,7632,8,11,8,17,38,53,-15,41
St Mirren,7632,9,9,11,16,42,53,-11,38
Ayr,7632,10,8,12,16,37,56,-19,36
Hibernian,7633,1,22,10,4,61,23,38,76
Morton,7633,2,19,9,8,50,36,14,66
Falkirk,7633,3,16,11,9,58,41,17,59
Dundee Utd,7633,4,16,9,11,56,42,14,57
Raith,7633,5,12,8,16,37,50,-13,44
Dunfermline,7633,6,9,14,13,48,49,-1,41
Dumbarton,7633,7,9,13,14,51,58,-7,40
Queen of S't,7633,8,10,10,16,41,50,-9,40
St Mirren,7633,9,8,10,18,40,61,-21,34
Ayr,7633,10,6,12,18,33,65,-32,30
Hibernian,7634,1,21,12,3,59,21,38,75
Morton,7634,2,19,10,7,53,35,18,67
Dundee Utd,7634,3,15,11,10,54,41,13,56
Falkirk,7634,4,15,10,11,56,44,12,55
Queen of S't,7634,5,11,10,15,44,50,-6,43
St Mirren,7634,6,10,10,16,40,56,-16,40
Raith,7634,7,10,10,16,35,52,-17,40
Dunfermline,7634,8,9,12,15,41,52,-11,39
Dumbarton,7634,9,9,11,16,49,57,-8,38
Ayr,7634,10,6,14,16,32,55,-23,32
Hibernian,7635,1,17,14,5,55,27,28,65
Morton,7635,2,18,10,8,51,38,13,64
Dundee Utd,7635,3,17,10,9,49,36,13,61
Falkirk,7635,4,15,11,10,54,39,15,56
Dunfermline,7635,5,10,13,13,50,51,-1,43
Queen of S't,7635,6,11,10,15,47,54,-7,43
Dumbarton,7635,7,9,14,13,46,54,-8,41
Raith,7635,8,10,11,15,38,50,-12,41
Ayr,7635,9,8,12,16,33,53,-20,36
St Mirren,7635,10,7,11,18,37,58,-21,32
Morton,7636,1,18,11,7,56,35,21,65
Hibernian,7636,2,17,11,8,50,26,24,62
Falkirk,7636,3,17,10,9,63,45,18,61
Dundee Utd,7636,4,13,11,12,46,45,1,50
Dunfermline,7636,5,12,11,13,50,52,-2,47
Queen of S't,7636,6,13,8,15,49,51,-2,47
Dumbarton,7636,7,10,11,15,52,63,-11,41
Ayr,7636,8,9,14,13,38,54,-16,41
St Mirren,7636,9,9,10,17,40,57,-17,37
Raith,7636,10,9,9,18,33,49,-16,36
Hibernian,7637,1,20,11,5,61,26,35,71
Falkirk,7637,2,17,11,8,61,42,19,62
Morton,7637,3,17,10,9,49,41,8,61
Dundee Utd,7637,4,16,9,11,56,40,16,57
Dunfermline,7637,5,13,12,11,54,45,9,51
Queen of S't,7637,6,12,10,14,48,52,-4,46
Raith,7637,7,10,10,16,34,48,-14,40
St Mirren,7637,8,8,11,17,44,64,-20,35
Dumbarton,7637,9,8,10,18,46,68,-22,34
Ayr,7637,10,7,10,19,36,63,-27,31
Hibernian,7638,1,21,11,4,57,23,34,74
Morton,7638,2,17,12,7,51,37,14,63
Falkirk,7638,3,15,12,9,58,41,17,57
Dundee Utd,7638,4,14,12,10,49,41,8,54
Queen of S't,7638,5,11,11,14,47,54,-7,44
Raith,7638,6,11,9,16,38,49,-11,42
Dunfermline,7638,7,9,12,15,43,51,-8,39
Dumbarton,7638,8,9,12,15,45,55,-10,39
Ayr,7638,9,8,12,16,36,56,-20,36
St Mirren,7638,10,7,13,16,36,53,-17,34
Hibernian,7639,1,19,13,4,53,24,29,70
Morton,7639,2,16,12,8,49,41,8,60
Falkirk,7639,3,16,10,10,62,43,19,58
Dundee Utd,7639,4,13,11,12,46,44,2,50
Ayr,7639,5,11,13,12,42,50,-8,46
Dunfermline,7639,6,10,14,12,44,43,1,44
Queen of S't,7639,7,11,11,14,45,51,-6,44
Dumbarton,7639,8,9,12,15,49,61,-12,39
Raith,7639,9,9,10,17,38,53,-15,37
St Mirren,7639,10,7,12,17,41,59,-18,33
Hibernian,7640,1,18,13,5,51,24,27,67
Morton,7640,2,17,11,8,50,37,13,62
Falkirk,7640,3,16,12,8,57,40,17,60
Dundee Utd,7640,4,17,8,11,50,39,11,59
Dunfermline,7640,5,10,15,11,43,46,-3,45
St Mirren,7640,6,11,10,15,43,49,-6,43
Queen of S't,7640,7,10,9,17,41,51,-10,39
Raith,7640,8,10,9,17,34,50,-16,39
Dumbarton,7640,9,8,12,16,44,54,-10,36
Ayr,7640,10,8,11,17,30,53,-23,35
Hibernian,7641,1,20,11,5,53,26,27,71
Falkirk,7641,2,17,11,8,68,41,27,62
Dundee Utd,7641,3,16,11,9,51,42,9,59
Morton,7641,4,16,10,10,51,37,14,58
Queen of S't,7641,5,11,9,16,40,50,-10,42
Dumbarton,7641,6,9,14,13,47,56,-9,41
Dunfermline,7641,7,8,15,13,48,50,-2,39
Raith,7641,8,10,9,17,32,49,-17,39
St Mirren,7641,9,8,13,15,40,56,-16,37
Ayr,7641,10,7,13,16,29,52,-23,34
Hibernian,7642,1,19,12,5,64,28,36,69
Dundee Utd,7642,2,15,11,10,46,38,8,56
Morton,7642,3,14,12,10,45,38,7,54
Falkirk,7642,4,14,11,11,53,52,1,53
Raith,7642,5,13,9,14,42,47,-5,48
Queen of S't,7642,6,11,11,14,43,48,-5,44
Dunfermline,7642,7,10,13,13,45,46,-1,43
Ayr,7642,8,8,15,13,31,50,-19,39
St Mirren,7642,9,9,11,16,43,53,-10,38
Dumbarton,7642,10,9,11,16,45,57,-12,38
Hibernian,7643,1,18,12,6,56,32,24,66
Falkirk,7643,2,16,11,9,59,38,21,59
Dundee Utd,7643,3,16,10,10,47,37,10,58
Morton,7643,4,15,11,10,47,43,4,56
Dunfermline,7643,5,12,12,12,51,47,4,48
Queen of S't,7643,6,11,12,13,46,46,0,45
Dumbarton,7643,7,9,13,14,51,57,-6,40
Ayr,7643,8,9,12,15,35,55,-20,39
St Mirren,7643,9,9,11,16,40,51,-11,38
Raith,7643,10,9,8,19,29,55,-26,35
Hibernian,7644,1,20,11,5,62,28,34,71
Morton,7644,2,16,10,10,47,43,4,58
Dundee Utd,7644,3,16,9,11,52,37,15,57
Falkirk,7644,4,15,11,10,57,40,17,56
Queen of S't,7644,5,13,9,14,45,48,-3,48
Dunfermline,7644,6,10,13,13,45,50,-5,43
Raith,7644,7,10,11,15,39,54,-15,41
St Mirren,7644,8,9,12,15,45,55,-10,39
Ayr,7644,9,9,12,15,36,53,-17,39
Dumbarton,7644,10,7,12,17,46,66,-20,33
Hibernian,7645,1,20,12,4,62,30,32,72
Dundee Utd,7645,2,17,9,10,56,40,16,60
Morton,7645,3,16,11,9,48,39,9,59
Falkirk,7645,4,15,11,10,57,44,13,56
Queen of S't,7645,5,12,9,15,46,51,-5,45
Dunfermline,7645,6,9,14,13,46,50,-4,41
Ayr,7645,7,10,11,15,38,56,-18,41
Raith,7645,8,10,8,18,34,49,-15,38
Dumbarton,7645,9,8,13,15,46,57,-11,37
St Mirren,7645,10,9,10,17,43,60,-17,37
Hibernian,7646,1,19,12,5,55,23,32,69
Morton,7646,2,19,12,5,52,30,22,69
Dundee Utd,7646,3,16,10,10,53,42,11,58
Falkirk,7646,4,14,10,12,56,48,8,52
Queen of S't,7646,5,11,11,14,46,48,-2,44
Raith,7646,6,11,9,16,35,50,-15,42
Dunfermline,7646,7,9,13,14,45,50,-5,40
Dumbarton,7646,8,9,13,14,47,58,-11,40
Ayr,7646,9,9,12,15,35,50,-15,39
St Mirren,7646,10,7,10,19,38,63,-25,31
Hibernian,7647,1,19,12,5,55,27,28,69
Morton,7647,2,16,12,8,50,37,13,60
Falkirk,7647,3,15,12,9,53,37,16,57
Dundee Utd,7647,4,15,11,10,47,39,8,56
Queen of S't,7647,5,13,8,15,43,49,-6,47
Dunfermline,7647,6,10,13,13,47,49,-2,43
Raith,7647,7,11,9,16,36,47,-11,42
Dumbarton,7647,8,9,12,15,45,55,-10,39
St Mirren,7647,9,9,10,17,41,54,-13,37
Ayr,7647,10,8,11,17,33,56,-23,35
Hibernian,7648,1,17,14,5,52,25,27,65
Morton,7648,2,18,11,7,49,34,15,65
Falkirk,7648,3,17,11,8,57,38,19,62
Dundee Utd,7648,4,14,10,12,48,40,8,52
Dunfermline,7648,5,11,13,12,50,47,3,46
Queen of S't,7648,6,11,11,14,47,51,-4,44
Dumbarton,7648,7,10,12,14,49,60,-11,42
Raith,7648,8,11,9,16,34,48,-14,42
Ayr,7648,9,7,14,15,33,54,-21,35
St Mirren,7648,10,6,11,19,36,58,-22,29
Hibernian,7649,1,17,13,6,53,28,25,64
Morton,7649,2,16,13,7,52,38,14,61
Falkirk,7649,3,14,13,9,60,43,17,55
Dundee Utd,7649,4,14,12,10,52,40,12,54
Queen of S't,7649,5,13,10,13,42,45,-3,49
Dunfermline,7649,6,9,14,13,45,55,-10,41
St Mirren,7649,7,10,11,15,42,54,-12,41
Ayr,7649,8,9,13,14,34,50,-16,40
Raith,7649,9,10,9,17,33,50,-17,39
Dumbarton,7649,10,8,12,16,46,56,-10,36
Hibernian,7650,1,18,14,4,55,26,29,68
Falkirk,7650,2,17,11,8,56,36,20,62
Morton,7650,3,16,10,10,51,40,11,58
Dundee Utd,7650,4,14,10,12,46,41,5,52
Dumbarton,7650,5,13,11,12,55,49,6,50
Dunfermline,7650,6,11,11,14,48,51,-3,44
Queen of S't,7650,7,11,9,16,46,56,-10,42
Raith,7650,8,10,10,16,37,48,-11,40
Ayr,7650,9,7,14,15,34,61,-27,35
St Mirren,7650,10,7,12,17,36,56,-20,33
Hibernian,7651,1,20,13,3,54,20,34,73
Dundee Utd,7651,2,17,10,9,49,36,13,61
Morton,7651,3,15,11,10,47,41,6,56
Falkirk,7651,4,14,11,11,54,43,11,53
Queen of S't,7651,5,11,10,15,42,48,-6,43
Ayr,7651,6,9,14,13,39,51,-12,41
Raith,7651,7,10,11,15,37,50,-13,41
Dunfermline,7651,8,8,16,12,42,46,-4,40
Dumbarton,7651,9,9,13,14,46,53,-7,40
St Mirren,7651,10,7,11,18,38,60,-22,32
Falkirk,7652,1,18,10,8,61,37,24,64
Morton,7652,2,18,10,8,56,42,14,64
Hibernian,7652,3,16,14,6,58,34,24,62
Dundee Utd,7652,4,17,10,9,49,37,12,61
Dunfermline,7652,5,11,12,13,49,49,0,45
Queen of S't,7652,6,11,10,15,46,54,-8,43
Raith,7652,7,11,8,17,39,56,-17,41
St Mirren,7652,8,10,9,17,43,56,-13,39
Ayr,7652,9,7,13,16,38,59,-21,34
Dumbarton,7652,10,7,12,17,48,63,-15,33
Hibernian,7653,1,20,12,4,57,26,31,72
Morton,7653,2,17,12,7,52,37,15,63
Dundee Utd,7653,3,17,9,10,49,36,13,60
Falkirk,7653,4,16,10,10,54,39,15,58
Dunfermline,7653,5,10,12,14,45,49,-4,42
Raith,7653,6,10,11,15,35,47,-12,41
Queen of S't,7653,7,10,9,17,41,54,-13,39
St Mirren,7653,8,9,11,16,41,55,-14,38
Dumbarton,7653,9,9,10,17,48,59,-11,37
Ayr,7653,10,9,10,17,36,56,-20,37
Hibernian,7654,1,18,12,6,53,28,25,66
Morton,7654,2,16,15,5,50,34,16,63
Dundee Utd,7654,3,17,9,10,51,38,13,60
Falkirk,7654,4,15,11,10,58,41,17,56
Queen of S't,7654,5,12,10,14,48,49,-1,46
Dumbarton,7654,6,10,12,14,49,57,-8,42
Dunfermline,7654,7,9,14,13,46,46,0,41
Raith,7654,8,10,11,15,36,50,-14,41
Ayr,7654,9,7,13,16,32,54,-22,34
St Mirren,7654,10,7,11,18,36,62,-26,32
Hibernian,7655,1,21,11,4,55,21,34,74
Dundee Utd,7655,2,17,11,8,52,36,16,62
Morton,7655,3,17,10,9,50,38,12,61
Falkirk,7655,4,16,11,9,55,39,16,59
Dunfermline,7655,5,10,13,13,44,45,-1,43
Queen of S't,7655,6,11,9,16,42,49,-7,42
Dumbarton,7655,7,9,12,15,50,60,-10,39
Raith,7655,8,9,10,17,35,51,-16,37
St Mirren,7655,9,7,12,17,40,59,-19,33
Ayr,7655,10,6,15,15,35,60,-25,33
Hibernian,7656,1,22,11,3,65,23,42,77
Falkirk,7656,2,16,11,9,59,43,16,59
Morton,7656,3,16,11,9,50,45,5,59
Dundee Utd,7656,4,16,8,12,56,44,12,56
Queen of S't,7656,5,12,8,16,44,47,-3,44
Dunfermline,7656,6,11,11,14,49,54,-5,44
Dumbarton,7656,7,9,12,15,45,54,-9,39
Ayr,7656,8,9,12,15,36,58,-22,39
Raith,7656,9,9,9,18,33,55,-22,36
St Mirren,7656,10,8,11,17,42,56,-14,35
Hibernian,7657,1,23,10,3,62,22,40,79
Falkirk,7657,2,18,10,8,60,40,20,64
Morton,7657,3,18,9,9,54,39,15,63
Dundee Utd,7657,4,14,12,10,46,37,9,54
Queen of S't,7657,5,12,8,16,47,54,-7,44
Raith,7657,6,10,10,16,34,49,-15,40
Dunfermline,7657,7,8,14,14,44,50,-6,38
Ayr,7657,8,9,11,16,38,55,-17,38
Dumbarton,7657,9,8,12,16,46,64,-18,36
St Mirren,7657,10,6,12,18,36,57,-21,30
Hibernian,7658,1,22,11,3,60,21,39,77
Morton,7658,2,16,11,9,52,39,13,59
Falkirk,7658,3,16,9,11,59,46,13,57
Dundee Utd,7658,4,14,11,11,52,43,9,53
Queen of S't,7658,5,13,9,14,50,53,-3,48
Dumbarton,7658,6,10,11,15,49,65,-16,41
Dunfermline,7658,7,9,12,15,44,53,-9,39
St Mirren,7658,8,9,11,16,45,58,-13,38
Raith,7658,9,9,10,17,34,48,-14,37
Ayr,7658,10,7,15,14,31,50,-19,36
Hibernian,7659,1,17,15,4,51,25,26,66
Falkirk,7659,2,17,11,8,60,40,20,62
Morton,7659,3,16,11,9,50,39,11,59
Dundee Utd,7659,4,16,8,12,50,40,10,56
Raith,7659,5,10,12,14,35,46,-11,42
Dumbarton,7659,6,10,11,15,50,58,-8,41
Queen of S't,7659,7,10,10,16,44,53,-9,40
Dunfermline,7659,8,8,16,12,43,52,-9,40
Ayr,7659,9,9,12,15,33,50,-17,39
St Mirren,7659,10,9,10,17,40,53,-13,37
Morton,7660,1,17,12,7,53,36,17,63
Hibernian,7660,2,16,14,6,49,28,21,62
Dundee Utd,7660,3,17,8,11,55,41,14,59
Falkirk,7660,4,15,10,11,56,43,13,55
Dunfermline,7660,5,12,13,11,49,45,4,49
Queen of S't,7660,6,12,9,15,48,55,-7,45
Raith,7660,7,11,9,16,38,52,-14,42
Ayr,7660,8,10,11,15,44,60,-16,41
Dumbarton,7660,9,9,11,16,49,61,-12,38
St Mirren,7660,10,8,9,19,41,61,-20,33
Hibernian,7661,1,19,12,5,55,27,28,69
Morton,7661,2,18,11,7,51,35,16,65
Falkirk,7661,3,17,10,9,57,39,18,61
Dundee Utd,7661,4,15,11,10,46,42,4,56
Queen of S't,7661,5,13,9,14,52,48,4,48
Dumbarton,7661,6,10,12,14,48,55,-7,42
Dunfermline,7661,7,9,13,14,42,48,-6,40
St Mirren,7661,8,9,10,17,37,54,-17,37
Raith,7661,9,9,9,18,34,51,-17,36
Ayr,7661,10,7,11,18,33,56,-23,32
Hibernian,7662,1,18,12,6,50,24,26,66
Falkirk,7662,2,16,13,7,61,40,21,61
Morton,7662,3,15,12,9,43,38,5,57
Dundee Utd,7662,4,15,10,11,52,48,4,55
Dunfermline,7662,5,11,15,10,53,44,9,48
Queen of S't,7662,6,12,9,15,46,51,-5,45
St Mirren,7662,7,11,10,15,42,51,-9,43
Raith,7662,8,11,9,16,36,48,-12,42
Dumbarton,7662,9,8,12,16,46,62,-16,36
Ayr,7662,10,7,10,19,35,58,-23,31
Hibernian,7663,1,19,11,6,54,27,27,68
Morton,7663,2,17,12,7,59,37,22,63
Falkirk,7663,3,18,9,9,62,41,21,63
Dundee Utd,7663,4,17,9,10,54,41,13,60
Raith,7663,5,12,9,15,39,49,-10,45
Queen of S't,7663,6,11,10,15,44,51,-7,43
Dunfermline,7663,7,9,12,15,46,57,-11,39
Ayr,7663,8,9,12,15,34,52,-18,39
Dumbarton,7663,9,8,12,16,48,61,-13,36
St Mirren,7663,10,7,10,19,39,63,-24,31
Hibernian,7664,1,20,12,4,58,24,34,72
Morton,7664,2,16,13,7,53,38,15,61
Dundee Utd,7664,3,16,8,12,54,46,8,56
Falkirk,7664,4,14,11,11,58,45,13,53
Dunfermline,7664,5,11,14,11,51,49,2,47
Dumbarton,7664,6,10,13,13,51,55,-4,43
Ayr,7664,7,10,12,14,38,53,-15,42
Queen of S't,7664,8,10,9,17,41,56,-15,39
Raith,7664,9,9,10,17,33,50,-17,37
St Mirren,7664,10,8,10,18,38,59,-21,34
Hibernian,7665,1,18,14,4,53,25,28,68
Dundee Utd,7665,2,18,10,8,57,39,18,64
Falkirk,7665,3,16,10,10,62,45,17,58
Morton,7665,4,16,10,10,52,41,11,58
Dunfermline,7665,5,11,13,12,50,49,1,46
Queen of S't,7665,6,11,9,16,45,54,-9,42
Ayr,7665,7,10,12,14,40,55,-15,42
Raith,7665,8,9,11,16,36,51,-15,38
Dumbarton,7665,9,8,12,16,47,61,-14,36
St Mirren,7665,10,7,11,18,35,57,-22,32
Hibernian,7666,1,19,11,6,62,28,34,68
Morton,7666,2,18,13,5,58,34,24,67
Falkirk,7666,3,15,10,11,63,53,10,55
Dundee Utd,7666,4,13,11,12,52,45,7,50
Raith,7666,5,11,11,14,37,49,-12,44
Ayr,7666,6,10,12,14,40,54,-14,42
Queen of S't,7666,7,10,10,16,45,53,-8,40
Dumbarton,7666,8,10,10,16,45,61,-16,40
Dunfermline,7666,9,8,15,13,46,52,-6,39
St Mirren,7666,10,8,13,15,41,60,-19,37
Hibernian,7667,1,17,16,3,53,24,29,67
Falkirk,7667,2,17,10,9,60,39,21,61
Dundee Utd,7667,3,17,10,9,54,39,15,61
Morton,7667,4,15,11,10,46,36,10,56
Dunfermline,7667,5,10,15,11,43,43,0,45
Queen of S't,7667,6,10,12,14,45,50,-5,42
Raith,7667,7,10,11,15,37,50,-13,41
St Mirren,7667,8,8,13,15,44,54,-10,37
Dumbarton,7667,9,7,13,16,44,64,-20,34
Ayr,7667,10,7,13,16,33,60,-27,34
Hibernian,7668,1,19,12,5,53,26,27,69
Morton,7668,2,16,11,9,51,38,13,59
Falkirk,7668,3,15,13,8,56,37,19,58
Dundee Utd,7668,4,14,10,12,43,40,3,52
Dunfermline,7668,5,11,14,11,51,46,5,47
Queen of S't,7668,6,11,10,15,41,51,-10,43
Raith,7668,7,10,11,15,35,44,-9,41
Ayr,7668,8,8,14,14,32,51,-19,38
Dumbarton,7668,9,8,13,15,43,61,-18,37
St Mirren,7668,10,8,12,16,42,53,-11,36
Hibernian,7669,1,20,11,5,60,28,32,71
Morton,7669,2,16,11,9,49,38,11,59
Falkirk,7669,3,16,10,10,59,42,17,58
Dundee Utd,7669,4,16,10,10,55,45,10,58
Queen of S't,7669,5,11,10,15,47,54,-7,43
Dunfermline,7669,6,9,15,12,46,54,-8,42
St Mirren,7669,7,10,10,16,49,58,-9,40
Dumbarton,7669,8,9,11,16,50,61,-11,38
Ayr,7669,9,8,14,14,35,54,-19,38
Raith,7669,10,9,10,17,39,55,-16,37
Hibernian,7670,1,19,14,3,53,21,32,71
Morton,7670,2,16,12,8,50,37,13,60
Dundee Utd,7670,3,15,11,10,50,39,11,56
Falkirk,7670,4,14,11,11,60,45,15,53
Queen of S't,7670,5,13,10,13,52,54,-2,49
Dunfermline,7670,6,10,13,13,45,48,-3,43
Raith,7670,7,9,12,15,38,50,-12,39
Dumbarton,7670,8,9,11,16,47,57,-10,38
Ayr,7670,9,8,13,15,32,56,-24,37
St Mirren,7670,10,7,13,16,40,60,-20,34
Hibernian,7671,1,20,11,5,57,24,33,71
Morton,7671,2,17,10,9,48,38,10,61
Falkirk,7671,3,16,9,11,56,45,11,57
Queen of S't,7671,4,14,10,12,50,45,5,52
Dundee Utd,7671,5,14,9,13,44,41,3,51
Dunfermline,7671,6,10,13,13,47,51,-4,43
Ayr,7671,7,10,12,14,38,52,-14,42
St Mirren,7671,8,10,10,16,42,54,-12,40
Dumbarton,7671,9,9,11,16,50,59,-9,38
Raith,7671,10,8,9,19,31,54,-23,33
Morton,7672,1,18,12,6,54,31,23,66
Hibernian,7672,2,17,13,6,53,30,23,64
Falkirk,7672,3,15,12,9,53,38,15,57
Dundee Utd,7672,4,15,12,9,47,36,11,57
Queen of S't,7672,5,10,12,14,44,48,-4,42
Dunfermline,7672,6,9,14,13,46,49,-3,41
Raith,7672,7,10,11,15,33,46,-13,41
Dumbarton,7672,8,9,13,14,45,57,-12,40
Ayr,7672,9,9,11,16,34,56,-22,38
St Mirren,7672,10,7,12,17,38,56,-18,33
Hibernian,7673,1,19,13,4,57,24,33,70
Dundee Utd,7673,2,17,11,8,60,39,21,62
Morton,7673,3,16,11,9,48,39,9,59
Falkirk,7673,4,14,11,11,58,46,12,53
Queen of S't,7673,5,11,12,13,44,49,-5,45
Dunfermline,7673,6,9,15,12,48,52,-4,42
Dumbarton,7673,7,9,12,15,48,59,-11,39
St Mirren,7673,8,9,11,16,40,52,-12,38
Raith,7673,9,8,12,16,32,49,-17,36
Ayr,7673,10,8,12,16,31,57,-26,36
Hibernian,7674,1,19,12,5,58,26,32,69
Dundee Utd,7674,2,19,9,8,53,38,15,66
Morton,7674,3,14,15,7,50,40,10,57
Falkirk,7674,4,15,10,11,54,43,11,55
Queen of S't,7674,5,13,9,14,48,48,0,48
Raith,7674,6,12,9,15,37,50,-13,45
Dunfermline,7674,7,9,13,14,48,50,-2,40
Dumbarton,7674,8,7,16,13,45,54,-9,37
Ayr,7674,9,7,13,16,29,53,-24,34
St Mirren,7674,10,6,12,18,34,54,-20,30
Hibernian,7675,1,18,11,7,53,29,24,65
Dundee Utd,7675,2,18,9,9,57,42,15,63
Morton,7675,3,15,13,8,45,34,11,58
Falkirk,7675,4,16,9,11,56,44,12,57
Dunfermline,7675,5,10,15,11,49,47,2,45
Queen of S't,7675,6,12,9,15,49,50,-1,45
Raith,7675,7,10,12,14,35,46,-11,42
Ayr,7675,8,9,12,15,38,53,-15,39
St Mirren,7675,9,8,12,16,37,53,-16,36
Dumbarton,7675,10,7,12,17,44,65,-21,33
Hibernian,7676,1,19,12,5,56,27,29,69
Dundee Utd,7676,2,17,10,9,54,36,18,61
Falkirk,7676,3,16,11,9,56,37,19,59
Morton,7676,4,16,11,9,47,37,10,59
Queen of S't,7676,5,12,8,16,47,55,-8,44
Raith,7676,6,11,9,16,36,48,-12,42
Dunfermline,7676,7,9,13,14,44,50,-6,40
Dumbarton,7676,8,9,13,14,47,56,-9,40
St Mirren,7676,9,10,10,16,42,52,-10,40
Ayr,7676,10,7,11,18,31,62,-31,32
Hibernian,7677,1,18,12,6,55,27,28,66
Morton,7677,2,18,11,7,46,35,11,65
Falkirk,7677,3,15,10,11,56,43,13,55
Dundee Utd,7677,4,14,13,9,49,42,7,55
Dunfermline,7677,5,12,14,10,52,42,10,50
Queen of S't,7677,6,11,10,15,43,50,-7,43
Raith,7677,7,10,10,16,35,48,-13,40
Ayr,7677,8,9,12,15,36,51,-15,39
Dumbarton,7677,9,8,12,16,45,60,-15,36
St Mirren,7677,10,7,12,17,38,57,-19,33
Hibernian,7678,1,20,11,5,54,29,25,71
Morton,7678,2,17,11,8,51,38,13,62
Dundee Utd,7678,3,17,9,10,58,43,15,60
Falkirk,7678,4,16,10,10,58,41,17,58
Queen of S't,7678,5,12,10,14,50,52,-2,46
Dumbarton,7678,6,10,13,13,48,56,-8,43
Ayr,7678,7,9,12,15,35,54,-19,39
St Mirren,7678,8,9,10,17,42,57,-15,37
Raith,7678,9,9,9,18,35,53,-18,36
Dunfermline,7678,10,8,11,17,40,48,-8,35
Hibernian,7679,1,18,13,5,54,25,29,67
Morton,7679,2,18,12,6,49,32,17,66
Dundee Utd,7679,3,18,9,9,53,37,16,63
Falkirk,7679,4,16,11,9,58,41,17,59
Dunfermline,7679,5,11,13,12,49,48,1,46
Raith,7679,6,10,10,16,36,49,-13,40
Dumbarton,7679,7,9,11,16,44,58,-14,38
Queen of S't,7679,8,9,10,17,42,55,-13,37
St Mirren,7679,9,8,10,18,43,60,-17,34
Ayr,7679,10,6,15,15,32,55,-23,33
Hibernian,7680,1,18,12,6,55,29,26,66
Morton,7680,2,17,11,8,53,37,16,62
Dundee Utd,7680,3,17,9,10,57,41,16,60
Falkirk,7680,4,15,10,11,63,45,18,55
Queen of S't,7680,5,14,10,12,48,43,5,52
Dunfermline,7680,6,10,12,14,50,55,-5,42
Raith,7680,7,11,8,17,35,50,-15,41
Ayr,7680,8,9,12,15,34,54,-20,39
Dumbarton,7680,9,8,12,16,45,60,-15,36
St Mirren,7680,10,7,12,17,38,64,-26,33
Hibernian,7681,1,20,12,4,59,26,33,72
Morton,7681,2,15,12,9,47,37,10,57
Dundee Utd,7681,3,15,10,11,52,40,12,55
Falkirk,7681,4,14,11,11,56,41,15,53
Dunfermline,7681,5,11,13,12,47,46,1,46
Ayr,7681,6,10,13,13,36,52,-16,43
Dumbarton,7681,7,10,12,14,44,52,-8,42
Queen of S't,7681,8,10,11,15,43,53,-10,41
Raith,7681,9,9,12,15,34,48,-14,39
St Mirren,7681,10,7,12,17,38,61,-23,33
Hibernian,7682,1,21,12,3,60,23,37,75
Falkirk,7682,2,16,11,9,55,38,17,59
Morton,7682,3,15,13,8,46,37,9,58
Dundee Utd,7682,4,15,10,11,46,39,7,55
Dunfermline,7682,5,10,14,12,47,47,0,44
Queen of S't,7682,6,12,8,16,46,53,-7,44
St Mirren,7682,7,9,12,15,41,54,-13,39
Raith,7682,8,10,9,17,32,49,-17,39
Dumbarton,7682,9,9,11,16,46,59,-13,38
Ayr,7682,10,8,10,18,34,54,-20,34
Hibernian,7683,1,19,12,5,55,27,28,69
Morton,7683,2,19,10,7,55,37,18,67
Dundee Utd,7683,3,17,10,9,50,36,14,61
Falkirk,7683,4,16,10,10,57,40,17,58
Queen of S't,7683,5,13,10,13,50,50,0,49
Raith,7683,6,11,11,14,37,47,-10,44
Ayr,7683,7,9,11,16,38,57,-19,38
Dunfermline,7683,8,7,13,16,40,51,-11,34
Dumbarton,7683,9,8,10,18,48,65,-17,34
St Mirren,7683,10,8,9,19,36,56,-20,33
Hibernian,7684,1,20,13,3,53,22,31,73
Dundee Utd,7684,2,18,9,9,57,39,18,63
Falkirk,7684,3,16,11,9,58,42,16,59
Morton,7684,4,15,12,9,49,41,8,57
Queen of S't,7684,5,11,10,15,45,51,-6,43
Raith,7684,6,10,11,15,38,52,-14,41
Dunfermline,7684,7,8,14,14,42,51,-9,38
Ayr,7684,8,9,11,16,37,57,-20,38
St Mirren,7684,9,9,10,17,45,55,-10,37
Dumbarton,7684,10,7,13,16,48,62,-14,34
Hibernian,7685,1,19,11,6,56,30,26,68
Dundee Utd,7685,2,16,11,9,50,40,10,59
Morton,7685,3,16,10,10,50,41,9,58
Falkirk,7685,4,15,11,10,56,43,13,56
Queen of S't,7685,5,13,8,15,49,52,-3,47
Raith,7685,6,12,8,16,39,50,-11,44
Dunfermline,7685,7,9,14,13,51,52,-1,41
Dumbarton,7685,8,10,11,15,52,64,-12,41
Ayr,7685,9,9,11,16,39,57,-18,38
St Mirren,7685,10,9,9,18,41,54,-13,36
Hibernian,7686,1,18,14,4,51,21,30,68
Falkirk,7686,2,17,10,9,60,42,18,61
Dundee Utd,7686,3,16,11,9,51,41,10,59
Morton,7686,4,14,12,10,44,41,3,54
Dunfermline,7686,5,10,15,11,49,47,2,45
Raith,7686,6,11,9,16,38,52,-14,42
Queen of S't,7686,7,10,11,15,43,52,-9,41
Dumbarton,7686,8,9,12,15,48,57,-9,39
Ayr,7686,9,9,11,16,39,56,-17,38
St Mirren,7686,10,9,9,18,40,54,-14,36
Hibernian,7687,1,18,13,5,54,25,29,67
Morton,7687,2,18,10,8,49,33,16,64
Dundee Utd,7687,3,16,10,10,49,39,10,58
Falkirk,7687,4,14,12,10,54,43,11,54
Dunfermline,7687,5,13,12,11,48,44,4,51
Queen of S't,7687,6,12,9,15,47,49,-2,45
Ayr,7687,7,10,12,14,38,52,-14,42
Raith,7687,8,9,10,17,31,47,-16,37
Dumbarton,7687,9,8,11,17,48,64,-16,35
St Mirren,7687,10,8,9,19,38,60,-22,33
Hibernian,7688,1,19,13,4,55,23,32,70
Morton,7688,2,19,11,6,54,35,19,68
Falkirk,7688,3,17,10,9,62,39,23,61
Dundee Utd,7688,4,17,9,10,52,39,13,60
Queen of S't,7688,5,13,9,14,46,52,-6,48
Raith,7688,6,10,9,17,35,51,-16,39
Dunfermline,7688,7,8,13,15,43,51,-8,37
Ayr,7688,8,8,12,16,31,50,-19,36
St Mirren,7688,9,8,11,17,38,55,-17,35
Dumbarton,7688,10,7,11,18,43,64,-21,32
Hibernian,7689,1,22,11,3,59,25,34,77
Falkirk,7689,2,18,9,9,63,39,24,63
Morton,7689,3,16,13,7,47,33,14,61
Dundee Utd,7689,4,15,10,11,48,38,10,55
Ayr,7689,5,9,13,14,31,48,-17,40
Dunfermline,7689,6,8,15,13,44,47,-3,39
Queen of S't,7689,7,10,9,17,46,55,-9,39
Raith,7689,8,10,9,17,33,51,-18,39
Dumbarton,7689,9,8,12,16,44,61,-17,36
St Mirren,7689,10,8,11,17,38,56,-18,35
Hibernian,7690,1,20,12,4,56,25,31,72
Morton,7690,2,18,12,6,56,36,20,66
Falkirk,7690,3,16,10,10,60,43,17,58
Dundee Utd,7690,4,15,12,9,47,38,9,57
Dunfermline,7690,5,12,11,13,50,45,5,47
Queen of S't,7690,6,10,11,15,42,52,-10,41
Raith,7690,7,10,9,17,38,57,-19,39
Ayr,7690,8,8,13,15,33,53,-20,37
Dumbarton,7690,9,8,11,17,46,60,-14,35
St Mirren,7690,10,8,9,19,39,58,-19,33
Hibernian,7691,1,20,12,4,58,24,34,72
Falkirk,7691,2,18,9,9,59,39,20,63
Morton,7691,3,17,12,7,50,35,15,63
Dundee Utd,7691,4,14,11,11,49,39,10,53
Queen of S't,7691,5,14,9,13,51,46,5,51
Dunfermline,7691,6,9,14,13,41,48,-7,41
Raith,7691,7,10,10,16,36,50,-14,40
Ayr,7691,8,8,12,16,33,58,-25,36
St Mirren,7691,9,7,12,17,37,56,-19,33
Dumbarton,7691,10,7,11,18,42,61,-19,32
Hibernian,7692,1,19,12,5,60,31,29,69
Morton,7692,2,17,11,8,52,40,12,62
Dundee Utd,7692,3,17,10,9,53,36,17,61
Falkirk,7692,4,15,11,10,56,44,12,56
Queen of S't,7692,5,12,9,15,47,51,-4,45
Dunfermline,7692,6,10,13,13,52,48,4,43
Ayr,7692,7,9,13,14,36,52,-16,40
Raith,7692,7,10,10,16,36,52,-16,40
Dumbarton,7692,9,7,13,16,46,63,-17,34
St Mirren,7692,10,7,12,17,36,57,-21,33
Hibernian,7693,1,18,13,5,51,24,27,67
Morton,7693,2,17,11,8,47,37,10,62
Falkirk,7693,3,16,12,8,59,40,19,60
Dundee Utd,7693,4,17,9,10,52,42,10,60
Ayr,7693,5,11,12,13,38,50,-12,45
Dunfermline,7693,6,10,13,13,52,47,5,43
Queen of S't,7693,7,10,11,15,42,52,-10,41
Raith,7693,8,9,10,17,37,56,-19,37
Dumbarton,7693,9,8,11,17,46,59,-13,35
St Mirren,7693,10,8,10,18,37,54,-17,34
Hibernian,7694,1,19,11,6,55,26,29,68
Morton,7694,2,17,12,7,47,35,12,63
Falkirk,7694,3,17,11,8,62,40,22,62
Dundee Utd,7694,4,15,9,12,46,42,4,54
Dunfermline,7694,5,10,12,14,47,49,-2,42
Ayr,7694,6,10,12,14,36,49,-13,42
Dumbarton,7694,7,10,11,15,49,58,-9,41
Raith,7694,8,10,11,15,34,47,-13,41
Queen of S't,7694,9,10,10,16,41,52,-11,40
St Mirren,7694,10,7,11,18,39,58,-19,32
Hibernian,7695,1,18,12,6,53,25,28,66
Morton,7695,2,16,13,7,51,37,14,61
Falkirk,7695,3,16,10,10,61,40,21,58
Dundee Utd,7695,4,16,8,12,51,45,6,56
Queen of S't,7695,5,12,9,15,46,52,-6,45
Dunfermline,7695,6,10,13,13,45,48,-3,43
Raith,7695,7,11,8,17,39,50,-11,41
Dumbarton,7695,8,9,12,15,50,64,-14,39
Ayr,7695,9,9,12,15,36,57,-21,39
St Mirren,7695,10,8,13,15,39,53,-14,37
Hibernian,7696,1,22,11,3,61,22,39,77
Morton,7696,2,17,9,10,51,42,9,60
Falkirk,7696,3,15,11,10,56,40,16,56
Dundee Utd,7696,4,14,11,11,50,46,4,53
Queen of S't,7696,5,13,9,14,48,45,3,48
Dumbarton,7696,6,9,13,14,49,57,-8,40
Ayr,7696,7,9,12,15,39,56,-17,39
Raith,7696,8,10,9,17,35,57,-22,39
St Mirren,7696,9,9,11,16,42,54,-12,38
Dunfermline,7696,10,8,12,16,45,57,-12,36
Hibernian,7697,1,18,12,6,52,28,24,66
Morton,7697,2,18,12,6,54,34,20,66
Falkirk,7697,3,16,11,9,56,39,17,59
Dundee Utd,7697,4,17,8,11,55,43,12,59
Dumbarton,7697,5,11,11,14,51,54,-3,44
Queen of S't,7697,6,11,9,16,43,51,-8,42
Dunfermline,7697,7,10,12,14,45,54,-9,42
Ayr,7697,8,10,11,15,38,54,-16,41
St Mirren,7697,9,8,10,18,40,57,-17,34
Raith,7697,10,8,10,18,32,52,-20,34
Hibernian,7698,1,21,11,4,57,23,34,74
Morton,7698,2,18,11,7,52,37,15,65
Falkirk,7698,3,16,11,9,56,41,15,59
Dundee Utd,7698,4,14,10,12,48,43,5,52
Queen of S't,7698,5,12,9,15,46,51,-5,45
Dunfermline,7698,6,10,12,14,49,51,-2,42
Dumbarton,7698,7,10,12,14,48,55,-7,42
Raith,7698,8,11,9,16,41,52,-11,42
Ayr,7698,9,8,12,16,33,56,-23,36
St Mirren,7698,10,7,9,20,33,54,-21,30
Morton,7699,1,20,10,6,56,31,25,70
Hibernian,7699,2,19,11,6,56,32,24,68
Falkirk,7699,3,16,9,11,59,39,20,57
Dundee Utd,7699,4,15,10,11,47,41,6,55
Queen of S't,7699,5,12,8,16,48,52,-4,44
Raith,7699,6,12,8,16,35,48,-13,44
Dunfermline,7699,7,10,12,14,41,46,-5,42
Ayr,7699,8,9,13,14,35,53,-18,40
Dumbarton,7699,9,8,11,17,47,63,-16,35
St Mirren,7699,10,8,10,18,40,59,-19,34
Hibernian,7700,1,19,10,7,59,32,27,67
Falkirk,7700,2,16,10,10,57,42,15,58
Morton,7700,3,16,10,10,51,39,12,58
Dundee Utd,7700,4,15,10,11,48,43,5,55
Dunfermline,7700,5,12,13,11,55,48,7,49
Dumbarton,7700,6,11,11,14,47,53,-6,44
Queen of S't,7700,7,11,8,17,46,57,-11,41
Raith,7700,8,10,11,15,35,48,-13,41
Ayr,7700,9,8,14,14,35,52,-17,38
St Mirren,7700,10,8,11,17,37,56,-19,35
Hibernian,7701,1,19,13,4,54,24,30,70
Morton,7701,2,18,12,6,52,35,17,66
Falkirk,7701,3,17,10,9,58,37,21,61
Dundee Utd,7701,4,16,9,11,54,43,11,57
Queen of S't,7701,5,11,10,15,46,52,-6,43
Raith,7701,6,11,10,15,37,48,-11,43
Dumbarton,7701,7,10,12,14,49,55,-6,42
Dunfermline,7701,8,9,13,14,47,52,-5,40
Ayr,7701,9,7,12,17,30,57,-27,33
St Mirren,7701,10,7,9,20,34,58,-24,30
Hibernian,7702,1,20,12,4,57,25,32,72
Morton,7702,2,17,12,7,50,32,18,63
Dundee Utd,7702,3,18,9,9,53,40,13,63
Falkirk,7702,4,17,9,10,56,39,17,60
Raith,7702,5,12,9,15,38,46,-8,45
Queen of S't,7702,6,10,10,16,41,49,-8,40
Dumbarton,7702,7,10,10,16,47,63,-16,40
Dunfermline,7702,8,9,12,15,44,50,-6,39
Ayr,7702,9,8,11,17,37,57,-20,35
St Mirren,7702,10,7,10,19,36,58,-22,31
Hibernian,7703,1,20,10,6,59,26,33,70
Morton,7703,2,18,12,6,52,35,17,66
Falkirk,7703,3,15,12,9,59,42,17,57
Dundee Utd,7703,4,15,12,9,50,39,11,57
Queen of S't,7703,5,12,10,14,49,53,-4,46
Dunfermline,7703,6,9,13,14,46,50,-4,40
Dumbarton,7703,7,9,12,15,46,57,-11,39
Ayr,7703,8,9,11,16,32,54,-22,38
St Mirren,7703,9,8,12,16,43,61,-18,36
Raith,7703,10,8,10,18,32,51,-19,34
Hibernian,7704,1,18,14,4,53,27,26,68
Morton,7704,2,16,13,7,52,38,14,61
Dundee Utd,7704,3,16,10,10,54,42,12,58
Falkirk,7704,4,13,12,11,60,51,9,51
Queen of S't,7704,5,13,9,14,48,51,-3,48
Raith,7704,6,11,11,14,38,47,-9,44
Dunfermline,7704,7,9,14,13,48,49,-1,41
Dumbarton,7704,8,10,10,16,49,56,-7,40
Ayr,7704,9,9,11,16,32,56,-24,38
St Mirren,7704,10,8,10,18,37,54,-17,34
Hibernian,7705,1,19,12,5,53,26,27,69
Morton,7705,2,18,11,7,55,39,16,65
Falkirk,7705,3,16,11,9,62,39,23,59
Dundee Utd,7705,4,16,10,10,53,39,14,58
Dunfermline,7705,5,10,13,13,47,49,-2,43
Ayr,7705,6,10,12,14,40,56,-16,42
Raith,7705,7,10,11,15,36,47,-11,41
Queen of S't,7705,8,10,8,18,42,58,-16,38
Dumbarton,7705,9,9,10,17,47,64,-17,37
St Mirren,7705,10,7,12,17,35,53,-18,33
Hibernian,7706,1,21,12,3,57,22,35,75
Dundee Utd,7706,2,17,10,9,55,41,14,61
Falkirk,7706,3,16,11,9,62,40,22,59
Morton,7706,4,15,13,8,50,38,12,58
Queen of S't,7706,5,12,10,14,46,49,-3,46
Dunfermline,7706,6,10,12,14,47,55,-8,42
Dumbarton,7706,7,9,12,15,51,62,-11,39
Raith,7706,8,10,9,17,32,50,-18,39
Ayr,7706,9,7,12,17,34,57,-23,33
St Mirren,7706,10,7,11,18,37,57,-20,32
Hibernian,7707,1,17,15,4,52,27,25,66
Morton,7707,2,17,11,8,48,32,16,62
Dundee Utd,7707,3,16,10,10,49,37,12,58
Falkirk,7707,4,15,10,11,58,45,13,55
Dumbarton,7707,5,11,12,13,50,54,-4,45
Dunfermline,7707,6,10,13,13,46,50,-4,43
Queen of S't,7707,7,10,12,14,45,52,-7,42
Raith,7707,8,11,9,16,35,49,-14,42
Ayr,7707,9,9,11,16,34,54,-20,38
St Mirren,7707,10,7,11,18,38,55,-17,32
Hibernian,7708,1,20,11,5,61,27,34,71
Morton,7708,2,17,11,8,50,38,12,62
Dundee Utd,7708,3,16,8,12,48,43,5,56
Falkirk,7708,4,15,10,11,57,43,14,55
Dumbarton,7708,5,11,12,13,47,50,-3,45
Queen of S't,7708,6,12,9,15,45,48,-3,45
Dunfermline,7708,7,10,11,15,46,52,-6,41
Raith,7708,8,11,8,17,40,56,-16,41
Ayr,7708,9,9,11,16,36,57,-21,38
St Mirren,7708,10,8,11,17,41,57,-16,35
Hibernian,7709,1,17,14,5,53,31,22,65
Morton,7709,2,16,13,7,50,37,13,61
Dundee Utd,7709,3,16,11,9,54,37,17,59
Falkirk,7709,4,15,10,11,54,44,10,55
Queen of S't,7709,5,12,11,13,45,45,0,47
Dunfermline,7709,6,9,15,12,48,51,-3,42
Raith,7709,7,9,13,14,32,44,-12,40
Dumbarton,7709,8,9,11,16,49,60,-11,38
St Mirren,7709,9,9,10,17,38,54,-16,37
Ayr,7709,10,6,16,14,32,52,-20,34
Hibernian,7710,1,19,14,3,55,23,32,71
Morton,7710,2,18,11,7,51,35,16,65
Dundee Utd,7710,3,18,10,8,56,36,20,64
Falkirk,7710,4,16,9,11,57,42,15,57
Dunfermline,7710,5,10,14,12,41,42,-1,44
Queen of S't,7710,6,10,11,15,43,50,-7,41
St Mirren,7710,7,8,12,16,40,57,-17,36
Raith,7710,8,9,9,18,33,52,-19,36
Dumbarton,7710,9,8,11,17,47,63,-16,35
Ayr,7710,10,7,13,16,32,55,-23,34
Hibernian,7711,1,19,12,5,56,26,30,69
Morton,7711,2,17,11,8,47,36,11,62
Falkirk,7711,3,15,14,7,57,37,20,59
Dundee Utd,7711,4,16,11,9,53,38,15,59
Queen of S't,7711,5,13,10,13,50,49,1,49
Dunfermline,7711,6,10,11,15,48,50,-2,41
Dumbarton,7711,7,10,11,15,48,58,-10,41
Raith,7711,8,8,11,17,33,51,-18,35
Ayr,7711,9,7,13,16,35,64,-29,34
St Mirren,7711,10,7,12,17,40,58,-18,33
Hibernian,7712,1,21,11,4,60,23,37,74
Morton,7712,2,18,9,9,50,39,11,63
Dundee Utd,7712,3,16,12,8,55,40,15,60
Falkirk,7712,4,15,13,8,57,39,18,58
Queen of S't,7712,5,12,11,13,45,47,-2,47
Dumbarton,7712,6,9,11,16,45,57,-12,38
Raith,7712,7,9,11,16,32,47,-15,38
Dunfermline,7712,8,8,13,15,42,53,-11,37
Ayr,7712,9,8,13,15,31,52,-21,37
St Mirren,7712,10,7,10,19,36,56,-20,31
Hibernian,7713,1,19,12,5,54,24,30,69
Dundee Utd,7713,2,17,9,10,49,36,13,60
Morton,7713,3,16,11,9,47,35,12,59
Falkirk,7713,4,16,10,10,57,40,17,58
Dunfermline,7713,5,11,12,13,45,47,-2,45
Dumbarton,7713,6,10,13,13,48,54,-6,43
Queen of S't,7713,7,11,8,17,44,53,-9,41
Raith,7713,8,11,8,17,34,49,-15,41
St Mirren,7713,9,10,10,16,43,54,-11,40
Ayr,7713,10,7,11,18,29,58,-29,32
Morton,7714,1,17,14,5,53,37,16,65
Hibernian,7714,2,16,14,6,56,33,23,62
Falkirk,7714,3,16,10,10,60,41,19,58
Dundee Utd,7714,4,16,10,10,53,40,13,58
Queen of S't,7714,5,13,10,13,52,49,3,49
Dumbarton,7714,6,10,11,15,49,57,-8,41
Raith,7714,7,10,11,15,38,54,-16,41
Dunfermline,7714,8,8,14,14,45,52,-7,38
Ayr,7714,9,8,12,16,34,59,-25,36
St Mirren,7714,10,8,10,18,40,58,-18,34
Hibernian,7715,1,19,14,3,56,24,32,71
Morton,7715,2,18,12,6,48,30,18,66
Dundee Utd,7715,3,16,11,9,50,40,10,59
Falkirk,7715,4,15,11,10,56,41,15,56
Dunfermline,7715,5,11,12,13,50,49,1,45
Queen of S't,7715,6,11,11,14,46,49,-3,44
Dumbarton,7715,7,9,12,15,48,58,-10,39
Ayr,7715,8,8,11,17,30,54,-24,35
Raith,7715,9,8,10,18,31,50,-19,34
St Mirren,7715,10,8,10,18,40,60,-20,34
Hibernian,7716,1,19,12,5,55,22,33,69
Morton,7716,2,17,9,10,46,41,5,60
Falkirk,7716,3,16,11,9,59,40,19,59
Dundee Utd,7716,4,14,11,11,47,40,7,53
Queen of S't,7716,5,12,10,14,44,48,-4,46
Dunfermline,7716,6,10,13,13,45,49,-4,43
St Mirren,7716,7,10,11,15,47,54,-7,41
Raith,7716,8,10,11,15,36,49,-13,41
Dumbarton,7716,9,8,12,16,45,59,-14,36
Ayr,7716,10,8,12,16,32,54,-22,36
Hibernian,7717,1,20,10,6,55,27,28,70
Morton,7717,2,16,12,8,49,36,13,60
Dundee Utd,7717,3,16,10,10,48,39,9,58
Falkirk,7717,4,16,9,11,56,40,16,57
Dunfermline,7717,5,10,15,11,43,42,1,45
Ayr,7717,6,9,14,13,33,46,-13,41
Queen of S't,7717,7,10,10,16,42,53,-11,40
Raith,7717,8,10,10,16,31,48,-17,40
St Mirren,7717,9,9,10,17,39,54,-15,37
Dumbarton,7717,10,8,12,16,47,58,-11,36
Hibernian,7718,1,20,10,6,59,30,29,70
Dundee Utd,7718,2,17,9,10,51,39,12,60
Morton,7718,3,16,12,8,49,39,10,60
Falkirk,7718,4,15,11,10,57,41,16,56
Queen of S't,7718,5,12,9,15,49,51,-2,45
Raith,7718,6,10,10,16,36,49,-13,40
Dunfermline,7718,7,9,12,15,49,55,-6,39
St Mirren,7718,8,10,9,17,45,55,-10,39
Dumbarton,7718,9,9,12,15,46,61,-15,39
Ayr,7718,10,9,12,15,30,51,-21,39
Hibernian,7719,1,19,13,4,57,26,31,70
Morton,7719,2,16,12,8,50,36,14,60
Dundee Utd,7719,3,16,11,9,50,39,11,59
Falkirk,7719,4,13,10,13,54,49,5,49
Queen of S't,7719,5,12,9,15,46,50,-4,45
Raith,7719,6,12,9,15,34,52,-18,45
St Mirren,7719,7,10,11,15,41,50,-9,41
Dunfermline,7719,8,9,13,14,50,50,0,40
Dumbarton,7719,9,9,11,16,51,63,-12,38
Ayr,7719,10,8,13,15,38,56,-18,37
Hibernian,7720,1,20,11,5,57,29,28,71
Morton,7720,2,17,13,6,52,36,16,64
Falkirk,7720,3,18,9,9,67,43,24,63
Dundee Utd,7720,4,15,9,12,52,45,7,54
Dunfermline,7720,5,10,12,14,53,56,-3,42
Queen of S't,7720,6,10,11,15,44,51,-7,41
Ayr,7720,7,10,11,15,37,55,-18,41
Raith,7720,8,10,9,17,33,50,-17,39
Dumbarton,7720,9,8,12,16,45,57,-12,36
St Mirren,7720,10,9,9,18,38,56,-18,36
Hibernian,7721,1,20,12,4,58,25,33,72
Morton,7721,2,16,11,9,47,35,12,59
Falkirk,7721,3,15,11,10,57,45,12,56
Dundee Utd,7721,4,12,12,12,43,45,-2,48
Dunfermline,7721,5,11,12,13,49,45,4,45
Ayr,7721,6,11,11,14,40,55,-15,44
Dumbarton,7721,7,10,11,15,53,59,-6,41
Raith,7721,8,11,8,17,37,54,-17,41
St Mirren,7721,9,10,10,16,47,55,-8,40
Queen of S't,7721,10,10,10,16,40,53,-13,40
Morton,7722,1,18,12,6,52,34,18,66
Hibernian,7722,2,17,14,5,52,27,25,65
Falkirk,7722,3,18,11,7,61,37,24,65
Dundee Utd,7722,4,15,9,12,47,42,5,54
Raith,7722,5,11,11,14,36,47,-11,44
Queen of S't,7722,6,10,12,14,40,46,-6,42
Dumbarton,7722,7,9,13,14,48,56,-8,40
Dunfermline,7722,8,7,15,14,40,48,-8,36
St Mirren,7722,9,6,15,15,42,58,-16,33
Ayr,7722,10,6,14,16,28,51,-23,32
Hibernian,7723,1,18,14,4,55,23,32,68
Morton,7723,2,15,15,6,51,36,15,60
Falkirk,7723,3,15,10,11,57,45,12,55
Dundee Utd,7723,4,15,10,11,47,39,8,55
Queen of S't,7723,5,13,9,14,48,49,-1,48
Dunfermline,7723,6,10,15,11,50,46,4,45
St Mirren,7723,7,10,11,15,44,56,-12,41
Raith,7723,8,9,10,17,36,51,-15,37
Ayr,7723,9,8,13,15,36,58,-22,37
Dumbarton,7723,10,7,13,16,47,68,-21,34
Hibernian,7724,1,18,12,6,54,27,27,66
Morton,7724,2,16,13,7,51,38,13,61
Dundee Utd,7724,3,16,11,9,53,40,13,59
Falkirk,7724,4,15,11,10,55,41,14,56
Dunfermline,7724,5,11,14,11,47,44,3,47
Queen of S't,7724,6,12,9,15,47,49,-2,45
Raith,7724,7,10,10,16,33,52,-19,40
Dumbarton,7724,8,8,13,15,46,61,-15,37
St Mirren,7724,9,9,9,18,43,56,-13,36
Ayr,7724,10,8,12,16,34,55,-21,36
Hibernian,7725,1,19,12,5,53,23,30,69
Falkirk,7725,2,16,11,9,58,41,17,59
Morton,7725,3,16,11,9,49,37,12,59
Dundee Utd,7725,4,16,10,10,53,40,13,58
Raith,7725,5,12,9,15,35,47,-12,45
Queen of S't,7725,6,12,8,16,44,51,-7,44
Dumbarton,7725,7,11,10,15,53,58,-5,43
Dunfermline,7725,8,10,13,13,48,53,-5,43
Ayr,7725,9,9,12,15,39,53,-14,39
St Mirren,7725,10,6,10,20,39,68,-29,28
Hibernian,7726,1,18,11,7,52,28,24,65
Morton,7726,2,17,11,8,49,37,12,62
Falkirk,7726,3,17,10,9,61,41,20,61
Dundee Utd,7726,4,16,10,10,50,39,11,58
Dunfermline,7726,5,11,13,12,51,47,4,46
Queen of S't,7726,6,12,10,14,49,49,0,46
Raith,7726,7,11,10,15,37,48,-11,43
Dumbarton,7726,8,8,13,15,43,54,-11,37
St Mirren,7726,9,8,10,18,35,57,-22,34
Ayr,7726,10,7,12,17,30,57,-27,33
Dundee Utd,7727,1,19,9,8,57,32,25,66
Hibernian,7727,2,18,12,6,49,28,21,66
Morton,7727,3,16,12,8,49,36,13,60
Falkirk,7727,4,16,10,10,57,42,15,58
Queen of S't,7727,5,12,10,14,44,50,-6,46
Dunfermline,7727,6,10,13,13,42,46,-4,43
Raith,7727,7,9,12,15,36,53,-17,39
Ayr,7727,8,9,11,16,39,56,-17,38
Dumbarton,7727,9,8,11,17,49,67,-18,35
St Mirren,7727,10,8,10,18,42,54,-12,34
Hibernian,7728,1,21,11,4,61,27,34,74
Morton,7728,2,18,10,8,49,35,14,64
Falkirk,7728,3,16,11,9,60,39,21,59
Dundee Utd,7728,4,14,11,11,51,44,7,53
Queen of S't,7728,5,13,9,14,47,46,1,48
Ayr,7728,6,10,10,16,37,60,-23,40
Dunfermline,7728,7,9,12,15,47,58,-11,39
Dumbarton,7728,8,9,11,16,46,59,-13,38
St Mirren,7728,9,8,12,16,45,59,-14,36
Raith,7728,10,8,11,17,34,50,-16,35
Hibernian,7729,1,21,10,5,59,30,29,73
Morton,7729,2,17,10,9,55,39,16,61
Falkirk,7729,3,16,11,9,56,38,18,59
Dundee Utd,7729,4,16,9,11,51,42,9,57
Dumbarton,7729,5,12,10,14,50,54,-4,46
Raith,7729,6,12,9,15,40,49,-9,45
Ayr,7729,7,10,11,15,40,59,-19,41
Queen of S't,7729,8,10,10,16,40,49,-9,40
Dunfermline,7729,9,8,13,15,43,53,-10,37
St Mirren,7729,10,7,9,20,41,62,-21,30
Hibernian,7730,1,19,12,5,59,28,31,69
Falkirk,7730,2,18,10,8,65,40,25,64
Morton,7730,3,16,13,7,51,37,14,61
Dundee Utd,7730,4,14,11,11,46,38,8,53
Dunfermline,7730,5,10,12,14,46,50,-4,42
Raith,7730,6,11,9,16,38,53,-15,42
St Mirren,7730,7,10,11,15,46,56,-10,41
Queen of S't,7730,8,10,11,15,45,58,-13,41
Dumbarton,7730,9,9,11,16,45,58,-13,38
Ayr,7730,10,7,12,17,35,58,-23,33
Hibernian,7731,1,20,11,5,59,29,30,71
Morton,7731,2,17,12,7,55,40,15,63
Dundee Utd,7731,3,16,11,9,56,40,16,59
Falkirk,7731,4,14,12,10,56,41,15,54
Queen of S't,7731,5,12,10,14,47,51,-4,46
Dunfermline,7731,6,9,13,14,43,52,-9,40
St Mirren,7731,7,9,12,15,42,54,-12,39
Dumbarton,7731,8,9,11,16,48,62,-14,38
Ayr,7731,9,8,13,15,34,53,-19,37
Raith,7731,10,9,9,18,34,52,-18,36
Morton,7732,1,19,11,6,56,35,21,68
Hibernian,7732,2,18,10,8,54,31,23,64
Dundee Utd,7732,3,18,9,9,52,38,14,63
Falkirk,7732,4,17,10,9,57,37,20,61
Ayr,7732,5,10,13,13,39,53,-14,43
Queen of S't,7732,6,11,9,16,46,52,-6,42
Dumbarton,7732,7,9,11,16,50,60,-10,38
Raith,7732,8,9,10,17,37,53,-16,37
Dunfermline,7732,9,8,12,16,39,54,-15,36
St Mirren,7732,10,8,11,17,39,56,-17,35
Hibernian,7733,1,18,13,5,59,28,31,67
Falkirk,7733,2,17,11,8,56,39,17,62
Morton,7733,3,15,14,7,47,35,12,59
Dundee Utd,7733,4,16,11,9,48,38,10,59
Queen of S't,7733,5,12,9,15,45,52,-7,45
Dunfermline,7733,6,10,14,12,48,48,0,44
St Mirren,7733,7,10,11,15,41,50,-9,41
Dumbarton,7733,8,8,13,15,47,55,-8,37
Raith,7733,9,9,10,17,34,51,-17,37
Ayr,7733,10,7,10,19,34,63,-29,31
Hibernian,7734,1,20,12,4,64,23,41,72
Dundee Utd,7734,2,17,11,8,53,37,16,62
Morton,7734,3,16,10,10,47,39,8,58
Falkirk,7734,4,14,12,10,53,38,15,54
Queen of S't,7734,5,12,10,14,44,49,-5,46
Raith,7734,6,11,10,15,42,51,-9,43
Dumbarton,7734,7,10,11,15,47,58,-11,41
St Mirren,7734,8,10,10,16,40,58,-18,40
Dunfermline,7734,9,7,15,14,43,54,-11,36
Ayr,7734,10,6,13,17,34,60,-26,31
Falkirk,7735,1,19,10,7,66,35,31,67
Hibernian,7735,2,18,12,6,60,27,33,66
Morton,7735,3,17,10,9,51,42,9,61
Dundee Utd,7735,4,16,11,9,49,35,14,59
Queen of S't,7735,5,12,10,14,45,51,-6,46
Dunfermline,7735,6,11,12,13,44,46,-2,45
Raith,7735,7,9,11,16,35,51,-16,38
Dumbarton,7735,8,9,10,17,45,57,-12,37
Ayr,7735,9,8,12,16,34,56,-22,36
St Mirren,7735,10,7,10,19,36,65,-29,31
Hibernian,7736,1,18,12,6,57,32,25,66
Morton,7736,2,17,12,7,56,37,19,63
Falkirk,7736,3,17,11,8,60,37,23,62
Dundee Utd,7736,4,14,12,10,51,39,12,54
Ayr,7736,5,12,11,13,43,54,-11,47
Raith,7736,6,11,9,16,36,49,-13,42
Dunfermline,7736,7,9,14,13,47,55,-8,41
Queen of S't,7736,8,10,10,16,46,54,-8,40
Dumbarton,7736,9,8,11,17,46,65,-19,35
St Mirren,7736,10,7,12,17,38,58,-20,33
Hibernian,7737,1,18,13,5,55,26,29,67
Dundee Utd,7737,2,16,11,9,49,38,11,59
Falkirk,7737,3,15,13,8,56,39,17,58
Morton,7737,4,15,10,11,44,38,6,55
Queen of S't,7737,5,11,11,14,45,49,-4,44
Ayr,7737,6,10,13,13,35,51,-16,43
Dunfermline,7737,7,9,14,13,47,49,-2,41
Raith,7737,8,10,11,15,33,46,-13,41
Dumbarton,7737,9,8,12,16,47,60,-13,36
St Mirren,7737,10,8,12,16,37,52,-15,36
Hibernian,7738,1,20,11,5,53,26,27,71
Morton,7738,2,18,11,7,52,35,17,65
Dundee Utd,7738,3,18,9,9,57,38,19,63
Falkirk,7738,4,17,10,9,64,45,19,61
Queen of S't,7738,5,13,8,15,45,49,-4,47
Dunfermline,7738,6,9,13,14,47,51,-4,40
Raith,7738,7,10,8,18,32,49,-17,38
Ayr,7738,8,9,11,16,31,49,-18,38
Dumbarton,7738,9,7,12,17,49,67,-18,33
St Mirren,7738,10,8,9,19,38,59,-21,33
Hibernian,7739,1,18,13,5,56,25,31,67
Morton,7739,2,17,12,7,51,36,15,63
Falkirk,7739,3,16,11,9,58,44,14,59
Dundee Utd,7739,4,17,8,11,53,43,10,59
Queen of S't,7739,5,11,11,14,42,46,-4,44
Dunfermline,7739,6,9,15,12,43,47,-4,42
Raith,7739,7,9,12,15,34,49,-15,39
Ayr,7739,8,9,12,15,36,52,-16,39
St Mirren,7739,9,8,12,16,43,57,-14,36
Dumbarton,7739,10,8,10,18,47,64,-17,34
Hibernian,7740,1,20,11,5,57,26,31,71
Morton,7740,2,18,9,9,50,35,15,63
Dundee Utd,7740,3,17,9,10,49,38,11,60
Falkirk,7740,4,16,10,10,56,39,17,58
Queen of S't,7740,5,12,8,16,43,58,-15,44
Ayr,7740,6,10,11,15,37,51,-14,41
Dumbarton,7740,7,10,10,16,52,60,-8,40
Raith,7740,8,10,9,17,35,48,-13,39
St Mirren,7740,9,10,9,17,41,55,-14,39
Dunfermline,7740,10,8,12,16,44,54,-10,36
Hibernian,7741,1,20,11,5,56,22,34,71
Falkirk,7741,2,16,9,11,60,46,14,57
Morton,7741,3,15,11,10,47,35,12,56
Dundee Utd,7741,4,14,9,13,50,45,5,51
Queen of S't,7741,5,13,10,13,47,50,-3,49
Ayr,7741,6,11,11,14,35,50,-15,44
Dunfermline,7741,7,10,12,14,47,51,-4,42
Dumbarton,7741,8,10,11,15,49,55,-6,41
St Mirren,7741,9,10,9,17,39,56,-17,39
Raith,7741,10,10,9,17,33,53,-20,39
Hibernian,7742,1,17,15,4,53,26,27,66
Falkirk,7742,2,16,12,8,57,38,19,60
Morton,7742,3,15,13,8,48,38,10,58
Dundee Utd,7742,4,15,9,12,47,42,5,54
Queen of S't,7742,5,12,9,15,42,48,-6,45
Dumbarton,7742,6,10,12,14,48,52,-4,42
Raith,7742,7,10,12,14,36,45,-9,42
Dunfermline,7742,8,9,12,15,46,52,-6,39
St Mirren,7742,9,9,11,16,38,55,-17,38
Ayr,7742,10,8,13,15,34,53,-19,37
Hibernian,7743,1,19,12,5,53,25,28,69
Morton,7743,2,17,11,8,48,35,13,62
Dundee Utd,7743,3,17,9,10,52,37,15,60
Falkirk,7743,4,13,13,10,56,47,9,52
Queen of S't,7743,5,13,10,13,44,45,-1,49
Dunfermline,7743,6,10,14,12,48,49,-1,44
Raith,7743,7,10,11,15,42,51,-9,41
Ayr,7743,8,7,14,15,34,53,-19,35
St Mirren,7743,9,8,11,17,37,59,-22,35
Dumbarton,7743,10,7,13,16,42,55,-13,34
Hibernian,7744,1,20,12,4,57,22,35,72
Morton,7744,2,19,10,7,53,39,14,67
Dundee Utd,7744,3,17,9,10,54,42,12,60
Falkirk,7744,4,13,13,10,53,40,13,52
Raith,7744,5,12,10,14,39,42,-3,46
Queen of S't,7744,6,11,9,16,44,55,-11,42
Dumbarton,7744,7,9,13,14,50,57,-7,40
Ayr,7744,8,9,11,16,32,55,-23,38
Dunfermline,7744,9,8,13,15,46,56,-10,37
St Mirren,7744,10,6,12,18,36,56,-20,30
Hibernian,7745,1,18,14,4,56,25,31,68
Morton,7745,2,17,11,8,50,39,11,62
Falkirk,7745,3,15,10,11,59,48,11,55
Dundee Utd,7745,4,14,13,9,50,40,10,55
Queen of S't,7745,5,12,10,14,45,52,-7,46
Dunfermline,7745,6,10,12,14,46,48,-2,42
Raith,7745,7,11,9,16,36,48,-12,42
Dumbarton,7745,8,9,12,15,48,57,-9,39
St Mirren,7745,9,9,11,16,41,54,-13,38
Ayr,7745,10,7,14,15,33,53,-20,35
Dundee Utd,7746,1,19,9,8,63,40,23,66
Hibernian,7746,2,17,12,7,51,27,24,63
Morton,7746,3,17,10,9,55,42,13,61
Falkirk,7746,4,14,13,9,55,40,15,55
Dumbarton,7746,5,11,12,13,52,57,-5,45
Dunfermline,7746,6,10,12,14,48,54,-6,42
Queen of S't,7746,7,10,10,16,40,53,-13,40
St Mirren,7746,8,9,11,16,39,53,-14,38
Raith,7746,9,9,11,16,31,47,-16,38
Ayr,7746,10,8,12,16,35,56,-21,36
Hibernian,7747,1,21,11,4,60,25,35,74
Falkirk,7747,2,17,11,8,59,38,21,62
Morton,7747,3,15,13,8,48,38,10,58
Dundee Utd,7747,4,15,10,11,49,42,7,55
Dumbarton,7747,5,11,12,13,51,55,-4,45
Queen of S't,7747,6,11,9,16,45,54,-9,42
Ayr,7747,7,9,13,14,35,53,-18,40
Raith,7747,8,9,12,15,37,50,-13,39
St Mirren,7747,9,8,11,17,42,59,-17,35
Dunfermline,7747,10,7,12,17,43,55,-12,33
Hibernian,7748,1,20,12,4,57,24,33,72
Morton,7748,2,16,13,7,49,36,13,61
Falkirk,7748,3,15,9,12,57,44,13,54
Dundee Utd,7748,4,14,11,11,44,40,4,53
Queen of S't,7748,5,12,9,15,46,53,-7,45
Dunfermline,7748,6,10,13,13,41,43,-2,43
Raith,7748,7,10,11,15,36,48,-12,41
St Mirren,7748,8,10,10,16,46,58,-12,40
Dumbarton,7748,9,9,12,15,48,58,-10,39
Ayr,7748,10,8,12,16,36,56,-20,36
Hibernian,7749,1,19,13,4,52,24,28,70
Falkirk,7749,2,18,10,8,61,40,21,64
Morton,7749,3,17,12,7,51,33,18,63
Dundee Utd,7749,4,15,10,11,55,46,9,55
Queen of S't,7749,5,11,10,15,45,50,-5,43
Dumbarton,7749,6,10,11,15,51,62,-11,41
Dunfermline,7749,7,8,15,13,45,54,-9,39
Raith,7749,8,9,12,15,33,47,-14,39
St Mirren,7749,9,8,11,17,41,54,-13,35
Ayr,7749,10,7,12,17,31,55,-24,33
Hibernian,7750,1,19,13,4,54,24,30,70
Falkirk,7750,2,18,9,9,62,40,22,63
Morton,7750,3,17,12,7,51,36,15,63
Dundee Utd,7750,4,17,9,10,48,40,8,60
Dunfermline,7750,5,10,13,13,48,50,-2,43
Queen of S't,7750,6,10,11,15,42,52,-10,41
Raith,7750,7,9,12,15,36,50,-14,39
Dumbarton,7750,8,8,11,17,47,61,-14,35
St Mirren,7750,9,8,11,17,46,60,-14,35
Ayr,7750,10,7,13,16,36,57,-21,34
Hibernian,7751,1,16,13,7,49,31,18,61
Morton,7751,2,16,12,8,50,37,13,60
Falkirk,7751,3,16,11,9,56,38,18,59
Dundee Utd,7751,4,16,11,9,53,42,11,59
Queen of S't,7751,5,13,10,13,46,46,0,49
St Mirren,7751,6,10,11,15,38,50,-12,41
Dunfermline,7751,7,8,16,12,44,48,-4,40
Ayr,7751,8,9,12,15,38,54,-16,39
Dumbarton,7751,9,8,14,14,46,55,-9,38
Raith,7751,10,8,10,18,31,50,-19,34
Hibernian,7752,1,19,11,6,59,29,30,68
Morton,7752,2,17,11,8,55,40,15,62
Falkirk,7752,3,17,10,9,60,42,18,61
Dundee Utd,7752,4,15,11,10,54,45,9,56
Queen of S't,7752,5,11,11,14,46,55,-9,44
Dunfermline,7752,6,9,15,12,46,48,-2,42
Raith,7752,7,11,9,16,37,46,-9,42
St Mirren,7752,8,9,11,16,41,55,-14,38
Dumbarton,7752,9,8,12,16,48,61,-13,36
Ayr,7752,10,7,13,16,31,56,-25,34
Hibernian,7753,1,21,10,5,58,23,35,73
Morton,7753,2,19,10,7,53,35,18,67
Falkirk,7753,3,18,10,8,69,41,28,64
Dundee Utd,7753,4,16,9,11,51,42,9,57
Dunfermline,7753,5,11,11,14,47,50,-3,44
Queen of S't,7753,6,11,10,15,44,54,-10,43
Raith,7753,7,10,9,17,37,55,-18,39
Dumbarton,7753,8,8,12,16,47,63,-16,36
Ayr,7753,9,8,12,16,34,55,-21,36
St Mirren,7753,10,7,9,20,37,59,-22,30
Hibernian,7754,1,19,12,5,56,27,29,69
Dundee Utd,7754,2,17,10,9,57,39,18,61
Morton,7754,3,17,10,9,48,36,12,61
Falkirk,7754,4,15,11,10,56,42,14,56
Raith,7754,5,12,10,14,40,48,-8,46
Dunfermline,7754,6,9,13,14,44,48,-4,40
Queen of S't,7754,7,10,10,16,45,52,-7,40
Dumbarton,7754,8,9,13,14,51,61,-10,40
Ayr,7754,9,7,15,14,34,59,-25,36
St Mirren,7754,10,8,10,18,43,62,-19,34
Hibernian,7755,1,18,14,4,53,24,29,68
Dundee Utd,7755,2,17,11,8,55,41,14,62
Falkirk,7755,3,16,11,9,60,43,17,59
Morton,7755,4,14,14,8,44,37,7,56
Dunfermline,7755,5,11,14,11,48,46,2,47
Raith,7755,6,11,9,16,37,49,-12,42
Queen of S't,7755,7,9,13,14,44,51,-7,40
Dumbarton,7755,8,8,13,15,51,60,-9,37
Ayr,7755,9,8,11,17,37,60,-23,35
St Mirren,7755,10,7,12,17,39,57,-18,33
Hibernian,7756,1,19,12,5,61,28,33,69
Morton,7756,2,17,11,8,48,36,12,62
Falkirk,7756,3,16,9,11,57,41,16,57
Dundee Utd,7756,4,16,8,12,47,38,9,56
Queen of S't,7756,5,14,8,14,48,50,-2,50
Dunfermline,7756,6,10,13,13,41,45,-4,43
Raith,7756,7,11,10,15,37,48,-11,43
Ayr,7756,8,9,12,15,36,55,-19,39
Dumbarton,7756,9,9,11,16,45,58,-13,38
St Mirren,7756,10,7,10,19,36,57,-21,31
Hibernian,7757,1,19,10,7,60,27,33,67
Morton,7757,2,17,12,7,51,34,17,63
Falkirk,7757,3,14,11,11,55,46,9,53
Dundee Utd,7757,4,14,11,11,47,42,5,53
Queen of S't,7757,5,12,11,13,49,51,-2,47
Dunfermline,7757,6,11,11,14,47,47,0,44
Dumbarton,7757,7,10,13,13,52,57,-5,43
St Mirren,7757,8,10,10,16,39,57,-18,40
Raith,7757,9,9,10,17,33,50,-17,37
Ayr,7757,10,8,13,15,35,57,-22,37
Hibernian,7758,1,19,11,6,53,26,27,68
Morton,7758,2,17,12,7,53,36,17,63
Falkirk,7758,3,16,10,10,57,40,17,58
Dundee Utd,7758,4,14,12,10,51,43,8,54
Queen of S't,7758,5,13,9,14,49,51,-2,48
Raith,7758,6,12,9,15,38,48,-10,45
Dunfermline,7758,7,9,14,13,43,47,-4,41
St Mirren,7758,8,8,12,16,40,56,-16,36
Dumbarton,7758,9,7,14,15,50,63,-13,35
Ayr,7758,10,8,11,17,34,58,-24,35
Morton,7759,1,19,11,6,53,34,19,68
Falkirk,7759,2,18,9,9,67,44,23,63
Hibernian,7759,3,17,12,7,55,34,21,63
Dundee Utd,7759,4,15,10,11,48,39,9,55
Dunfermline,7759,5,12,11,13,49,50,-1,47
Ayr,7759,6,10,12,14,37,52,-15,42
Queen of S't,7759,7,10,11,15,47,54,-7,41
Dumbarton,7759,8,8,13,15,48,61,-13,37
Raith,7759,9,9,10,17,36,51,-15,37
St Mirren,7759,10,7,11,18,38,59,-21,32
Hibernian,7760,1,18,11,7,56,32,24,65
Morton,7760,2,18,10,8,54,40,14,64
Falkirk,7760,3,16,13,7,57,36,21,61
Dundee Utd,7760,4,16,11,9,50,35,15,59
Queen of S't,7760,5,13,8,15,48,51,-3,47
Dunfermline,7760,6,9,13,14,42,49,-7,40
Dumbarton,7760,7,10,10,16,51,59,-8,40
Ayr,7760,8,9,11,16,34,57,-23,38
Raith,7760,9,8,12,16,36,52,-16,36
St Mirren,7760,10,8,11,17,43,60,-17,35
Hibernian,7761,1,20,11,5,59,27,32,71
Morton,7761,2,18,10,8,53,35,18,64
Falkirk,7761,3,18,9,9,61,37,24,63
Dundee Utd,7761,4,15,8,13,47,42,5,53
Queen of S't,7761,5,13,11,12,45,43,2,50
Ayr,7761,6,9,12,15,37,55,-18,39
Dunfermline,7761,7,9,11,16,41,49,-8,38
Raith,7761,8,9,11,16,34,50,-16,38
Dumbarton,7761,9,8,13,15,42,54,-12,37
St Mirren,7761,10,8,10,18,37,64,-27,34
Hibernian,7762,1,20,13,3,59,24,35,73
Falkirk,7762,2,17,10,9,59,43,16,61
Morton,7762,3,16,12,8,51,38,13,60
Dundee Utd,7762,4,16,10,10,49,39,10,58
Queen of S't,7762,5,10,12,14,42,50,-8,42
Dunfermline,7762,6,9,14,13,45,48,-3,41
Dumbarton,7762,7,9,12,15,48,57,-9,39
Raith,7762,8,8,13,15,36,51,-15,37
Ayr,7762,9,8,12,16,35,55,-20,36
St Mirren,7762,10,8,10,18,41,60,-19,34
Hibernian,7763,1,20,12,4,57,22,35,72
Dundee Utd,7763,2,17,9,10,54,39,15,60
Morton,7763,3,16,11,9,46,33,13,59
Falkirk,7763,4,15,11,10,58,42,16,56
Dunfermline,7763,5,12,12,12,49,50,-1,48
Dumbarton,7763,6,11,11,14,52,58,-6,44
Queen of S't,7763,7,10,12,14,45,50,-5,42
Raith,7763,8,9,11,16,35,52,-17,38
Ayr,7763,9,7,12,17,32,56,-24,33
St Mirren,7763,10,8,9,19,35,61,-26,33
Hibernian,7764,1,22,11,3,59,22,37,77
Morton,7764,2,18,11,7,54,36,18,65
Falkirk,7764,3,16,12,8,61,41,20,60
Dundee Utd,7764,4,14,9,13,46,45,1,51
Queen of S't,7764,5,12,10,14,49,51,-2,46
Dumbarton,7764,6,10,12,14,55,59,-4,42
Ayr,7764,7,10,11,15,40,56,-16,41
Dunfermline,7764,8,8,13,15,45,55,-10,37
Raith,7764,9,8,10,18,33,55,-22,34
St Mirren,7764,10,8,9,19,43,65,-22,33
Hibernian,7765,1,20,11,5,54,22,32,71
Dundee Utd,7765,2,18,9,9,55,39,16,63
Morton,7765,3,16,12,8,49,36,13,60
Falkirk,7765,4,15,11,10,55,40,15,56
Raith,7765,5,11,9,16,36,48,-12,42
Queen of S't,7765,6,10,10,16,42,52,-10,40
Dumbarton,7765,7,9,12,15,46,56,-10,39
St Mirren,7765,8,9,12,15,39,52,-13,39
Dunfermline,7765,9,8,13,15,44,56,-12,37
Ayr,7765,10,8,13,15,32,51,-19,37
Hibernian,7766,1,20,11,5,57,24,33,71
Morton,7766,2,19,10,7,51,34,17,67
Dundee Utd,7766,3,17,9,10,52,35,17,60
Falkirk,7766,4,15,12,9,57,42,15,57
Queen of S't,7766,5,11,11,14,45,49,-4,44
Dumbarton,7766,6,10,12,14,50,55,-5,42
Raith,7766,7,10,11,15,35,48,-13,41
Dunfermline,7766,8,9,12,15,42,48,-6,39
Ayr,7766,9,8,11,17,30,58,-28,35
St Mirren,7766,10,6,11,19,37,63,-26,29
Hibernian,7767,1,21,11,4,61,24,37,74
Dundee Utd,7767,2,17,11,8,55,40,15,62
Morton,7767,3,17,11,8,49,36,13,62
Falkirk,7767,4,15,9,12,54,44,10,54
Dumbarton,7767,5,11,12,13,50,52,-2,45
Queen of S't,7767,6,10,12,14,41,49,-8,42
Dunfermline,7767,7,10,11,15,47,50,-3,41
Raith,7767,8,10,10,16,36,52,-16,40
Ayr,7767,9,7,13,16,34,56,-22,34
St Mirren,7767,10,7,10,19,36,60,-24,31
Hibernian,7768,1,18,14,4,54,24,30,68
Falkirk,7768,2,16,13,7,61,39,22,61
Morton,7768,3,16,12,8,49,39,10,60
Dundee Utd,7768,4,14,11,11,45,42,3,53
Queen of S't,7768,5,14,10,12,48,46,2,52
Dumbarton,7768,6,10,12,14,51,58,-7,42
St Mirren,7768,7,10,10,16,44,54,-10,40
Dunfermline,7768,8,8,14,14,48,52,-4,38
Raith,7768,9,8,10,18,31,51,-20,34
Ayr,7768,10,7,12,17,29,55,-26,33
Hibernian,7769,1,21,10,5,59,25,34,73
Morton,7769,2,16,11,9,51,38,13,59
Dundee Utd,7769,3,16,10,10,51,42,9,58
Falkirk,7769,4,16,9,11,57,43,14,57
Raith,7769,5,13,9,14,39,47,-8,48
St Mirren,7769,6,11,9,16,47,54,-7,42
Dumbarton,7769,7,10,11,15,53,60,-7,41
Dunfermline,7769,8,9,13,14,44,47,-3,40
Queen of S't,7769,9,10,10,16,42,54,-12,40
Ayr,7769,10,7,10,19,32,65,-33,31
Hibernian,7770,1,20,12,4,55,25,30,72
Morton,7770,2,17,11,8,48,33,15,62
Falkirk,7770,3,17,9,10,69,44,25,60
Dundee Utd,7770,4,16,10,10,48,38,10,58
Queen of S't,7770,5,12,9,15,44,48,-4,45
Ayr,7770,6,11,11,14,37,48,-11,44
Dunfermline,7770,7,9,12,15,46,52,-6,39
Raith,7770,8,10,9,17,34,56,-22,39
Dumbarton,7770,9,9,11,16,46,60,-14,38
St Mirren,7770,10,7,10,19,39,62,-23,31
Hibernian,7771,1,21,11,4,60,25,35,74
Morton,7771,2,19,11,6,53,33,20,68
Dundee Utd,7771,3,15,13,8,49,35,14,58
Falkirk,7771,4,14,10,12,54,48,6,52
Queen of S't,7771,5,11,10,15,48,51,-3,43
Dunfermline,7771,6,10,13,13,47,52,-5,43
Raith,7771,7,11,9,16,40,48,-8,42
Ayr,7771,8,8,13,15,34,50,-16,37
St Mirren,7771,9,8,11,17,37,57,-20,35
Dumbarton,7771,10,7,11,18,43,66,-23,32
Hibernian,7772,1,20,12,4,60,26,34,72
Morton,7772,2,16,11,9,48,41,7,59
Dundee Utd,7772,3,16,10,10,56,41,15,58
Falkirk,7772,4,14,12,10,55,42,13,54
Queen of S't,7772,5,13,10,13,45,47,-2,49
Dumbarton,7772,6,11,10,15,52,57,-5,43
Dunfermline,7772,7,9,13,14,44,58,-14,40
Raith,7772,8,10,9,17,37,51,-14,39
St Mirren,7772,9,9,11,16,42,55,-13,38
Ayr,7772,10,8,10,18,34,55,-21,34
Hibernian,7773,1,18,11,7,52,29,23,65
Morton,7773,2,17,9,10,52,41,11,60
Dundee Utd,7773,3,16,10,10,50,41,9,58
Falkirk,7773,4,15,12,9,59,43,16,57
Raith,7773,5,12,9,15,38,46,-8,45
Ayr,7773,6,11,12,13,36,50,-14,45
Queen of S't,7773,7,11,11,14,44,49,-5,44
Dunfermline,7773,8,10,11,15,45,50,-5,41
Dumbarton,7773,9,10,11,15,49,56,-7,41
St Mirren,7773,10,7,10,19,37,57,-20,31
Hibernian,7774,1,17,12,7,50,26,24,63
Falkirk,7774,2,17,11,8,57,38,19,62
Morton,7774,3,16,14,6,50,34,16,62
Dundee Utd,7774,4,14,11,11,51,42,9,53
Raith,7774,5,11,11,14,36,47,-11,44
Dunfermline,7774,6,9,15,12,46,46,0,42
Dumbarton,7774,7,10,12,14,49,57,-8,42
Ayr,7774,8,9,12,15,36,52,-16,39
Queen of S't,7774,9,10,8,18,42,58,-16,38
St Mirren,7774,10,8,12,16,43,60,-17,36
Hibernian,7775,1,21,10,5,63,24,39,73
Falkirk,7775,2,17,11,8,64,42,22,62
Morton,7775,3,15,11,10,48,39,9,56
Dundee Utd,7775,4,13,15,8,52,42,10,54
Queen of S't,7775,5,12,9,15,47,51,-4,45
Dumbarton,7775,6,10,13,13,49,53,-4,43
Dunfermline,7775,7,9,14,13,44,52,-8,41
Raith,7775,8,10,9,17,37,51,-14,39
Ayr,7775,9,8,12,16,34,61,-27,36
St Mirren,7775,10,7,12,17,37,60,-23,33
Hibernian,7776,1,19,13,4,52,25,27,70
Morton,7776,2,17,11,8,53,35,18,62
Falkirk,7776,3,16,11,9,58,40,18,59
Dundee Utd,7776,4,14,10,12,44,42,2,52
Dunfermline,7776,5,13,12,11,50,41,9,51
Raith,7776,6,11,9,16,38,55,-17,42
Queen of S't,7776,7,10,10,16,40,51,-11,40
Ayr,7776,8,9,13,14,38,54,-16,40
St Mirren,7776,9,9,9,18,39,54,-15,36
Dumbarton,7776,10,7,12,17,43,58,-15,33
Falkirk,7777,1,18,11,7,63,38,25,65
Dundee Utd,7777,2,17,10,9,62,38,24,61
Hibernian,7777,3,16,13,7,49,30,19,61
Morton,7777,4,15,11,10,51,40,11,56
Dunfermline,7777,5,10,14,12,44,51,-7,44
Raith,7777,6,11,11,14,37,47,-10,44
Ayr,7777,7,10,12,14,36,50,-14,42
Queen of S't,7777,8,10,11,15,44,53,-9,41
Dumbarton,7777,9,8,11,17,49,65,-16,35
St Mirren,7777,10,8,10,18,38,61,-23,34
Morton,7778,1,18,11,7,47,32,15,65
Hibernian,7778,2,17,10,9,50,29,21,61
Dundee Utd,7778,3,17,9,10,50,39,11,60
Falkirk,7778,4,14,9,13,54,43,11,51
Queen of S't,7778,5,13,9,14,44,48,-4,48
Dunfermline,7778,6,11,12,13,44,46,-2,45
Raith,7778,7,12,8,16,35,45,-10,44
St Mirren,7778,8,11,9,16,47,54,-7,42
Dumbarton,7778,9,10,10,16,47,59,-12,40
Ayr,7778,10,7,13,16,34,57,-23,34
Hibernian,7779,1,19,13,4,60,27,33,70
Morton,7779,2,17,12,7,54,39,15,63
Dundee Utd,7779,3,18,8,10,53,40,13,62
Falkirk,7779,4,15,11,10,57,41,16,56
Queen of S't,7779,5,13,11,12,47,48,-1,50
Dunfermline,7779,6,9,13,14,43,48,-5,40
Raith,7779,7,10,10,16,33,45,-12,40
Dumbarton,7779,8,8,14,14,47,58,-11,38
Ayr,7779,9,7,14,15,33,52,-19,35
St Mirren,7779,10,6,10,20,37,66,-29,28
Hibernian,7780,1,18,14,4,59,27,32,68
Falkirk,7780,2,17,9,10,56,38,18,60
Morton,7780,3,16,12,8,52,41,11,60
Dundee Utd,7780,4,17,9,10,51,40,11,60
Queen of S't,7780,5,12,8,16,45,51,-6,44
St Mirren,7780,6,10,11,15,41,52,-11,41
Ayr,7780,7,9,13,14,35,52,-17,40
Dumbarton,7780,8,9,11,16,46,57,-11,38
Dunfermline,7780,9,8,13,15,43,49,-6,37
Raith,7780,10,9,10,17,34,55,-21,37
Hibernian,7781,1,21,10,5,57,24,33,73
Morton,7781,2,19,11,6,51,33,18,68
Falkirk,7781,3,17,10,9,55,37,18,61
Dundee Utd,7781,4,14,11,11,48,40,8,53
Dunfermline,7781,5,10,12,14,45,48,-3,42
Queen of S't,7781,6,10,12,14,42,50,-8,42
Raith,7781,7,9,11,16,33,48,-15,38
Dumbarton,7781,8,8,13,15,47,58,-11,37
St Mirren,7781,9,9,10,17,41,58,-17,37
Ayr,7781,10,7,12,17,32,55,-23,33
Hibernian,7782,1,20,12,4,60,23,37,72
Morton,7782,2,20,10,6,52,36,16,70
Dundee Utd,7782,3,16,10,10,50,39,11,58
Falkirk,7782,4,15,12,9,55,37,18,57
Queen of S't,7782,5,11,10,15,43,50,-7,43
Dunfermline,7782,6,9,13,14,43,45,-2,40
Raith,7782,7,9,11,16,36,53,-17,38
Ayr,7782,8,8,12,16,34,56,-22,36
Dumbarton,7782,9,8,11,17,47,64,-17,35
St Mirren,7782,10,8,11,17,46,63,-17,35
Hibernian,7783,1,21,12,3,61,25,36,75
Dundee Utd,7783,2,17,9,10,50,37,13,60
Morton,7783,3,16,10,10,48,39,9,58
Falkirk,7783,4,14,12,10,53,41,12,54
Queen of S't,7783,5,10,12,14,44,50,-6,42
Dumbarton,7783,6,10,12,14,48,55,-7,42
Raith,7783,7,10,10,16,36,51,-15,40
Ayr,7783,8,10,10,16,36,55,-19,40
Dunfermline,7783,9,8,15,13,42,47,-5,39
St Mirren,7783,10,7,12,17,38,56,-18,33
Hibernian,7784,1,18,11,7,50,24,26,65
Morton,7784,2,18,9,9,52,40,12,63
Dundee Utd,7784,3,16,11,9,47,36,11,59
Falkirk,7784,4,15,9,12,58,42,16,54
Queen of S't,7784,5,13,10,13,45,49,-4,49
Dunfermline,7784,6,10,13,13,46,47,-1,43
Dumbarton,7784,7,10,12,14,51,55,-4,42
Ayr,7784,8,9,12,15,35,51,-16,39
St Mirren,7784,9,10,9,17,40,58,-18,39
Raith,7784,10,9,8,19,32,54,-22,35
Hibernian,7785,1,18,12,6,57,28,29,66
Morton,7785,2,18,9,9,50,37,13,63
Falkirk,7785,3,15,12,9,62,45,17,57
Dundee Utd,7785,4,16,9,11,49,43,6,57
Queen of S't,7785,5,14,8,14,49,51,-2,50
St Mirren,7785,6,10,11,15,41,52,-11,41
Raith,7785,7,10,10,16,38,52,-14,40
Dunfermline,7785,8,9,11,16,42,49,-7,38
Ayr,7785,9,9,11,16,33,55,-22,38
Dumbarton,7785,10,8,13,15,47,56,-9,37
Hibernian,7786,1,20,11,5,57,26,31,71
Morton,7786,2,18,11,7,48,31,17,65
Falkirk,7786,3,16,11,9,61,44,17,59
Dundee Utd,7786,4,15,10,11,51,42,9,55
Queen of S't,7786,5,14,8,14,51,49,2,50
Dunfermline,7786,6,10,12,14,47,52,-5,42
Raith,7786,7,10,11,15,34,48,-14,41
Ayr,7786,8,9,13,14,33,51,-18,40
Dumbarton,7786,9,8,10,18,48,64,-16,34
St Mirren,7786,10,7,9,20,38,61,-23,30
Hibernian,7787,1,16,15,5,52,27,25,63
Dundee Utd,7787,2,17,10,9,52,39,13,61
Falkirk,7787,3,16,12,8,61,37,24,60
Morton,7787,4,14,14,8,48,40,8,56
Dunfermline,7787,5,11,14,11,49,46,3,47
Raith,7787,6,10,12,14,42,50,-8,42
St Mirren,7787,7,10,11,15,43,56,-13,41
Queen of S't,7787,8,10,9,17,43,58,-15,39
Dumbarton,7787,9,8,13,15,49,61,-12,37
Ayr,7787,10,7,12,17,31,56,-25,33
Hibernian,7788,1,19,14,3,55,24,31,71
Dundee Utd,7788,2,17,10,9,54,37,17,61
Falkirk,7788,3,16,10,10,57,42,15,58
Morton,7788,4,14,14,8,45,34,11,56
Queen of S't,7788,5,12,9,15,45,49,-4,45
Dunfermline,7788,6,9,14,13,50,49,1,41
Ayr,7788,7,8,14,14,37,55,-18,38
Raith,7788,8,10,8,18,33,53,-20,38
St Mirren,7788,9,8,13,15,34,50,-16,37
Dumbarton,7788,10,8,12,16,43,60,-17,36
Hibernian,7789,1,20,12,4,58,27,31,72
Dundee Utd,7789,2,18,9,9,52,41,11,63
Morton,7789,3,16,11,9,50,39,11,59
Falkirk,7789,4,14,11,11,59,48,11,53
Queen of S't,7789,5,12,9,15,46,50,-4,45
Raith,7789,6,11,12,13,40,46,-6,45
Dumbarton,7789,7,10,10,16,51,55,-4,40
Dunfermline,7789,8,8,15,13,43,52,-9,39
Ayr,7789,9,8,12,16,33,53,-20,36
St Mirren,7789,10,6,13,17,38,59,-21,31
Hibernian,7790,1,20,12,4,54,24,30,72
Morton,7790,2,19,10,7,55,37,18,67
Falkirk,7790,3,16,13,7,57,36,21,61
Dundee Utd,7790,4,15,11,10,49,41,8,56
Queen of S't,7790,5,11,10,15,43,48,-5,43
Dunfermline,7790,6,9,15,12,46,48,-2,42
Dumbarton,7790,7,9,12,15,49,59,-10,39
Raith,7790,8,10,9,17,36,53,-17,39
Ayr,7790,9,7,12,17,34,58,-24,33
St Mirren,7790,10,7,10,19,43,62,-19,31
Hibernian,7791,1,20,12,4,59,26,33,72
Falkirk,7791,2,17,11,8,67,43,24,62
Morton,7791,3,15,12,9,45,38,7,57
Dundee Utd,7791,4,15,9,12,48,39,9,54
Dunfermline,7791,5,11,11,14,49,51,-2,44
St Mirren,7791,6,11,10,15,45,55,-10,43
Raith,7791,7,11,10,15,36,47,-11,43
Ayr,7791,8,9,12,15,34,52,-18,39
Dumbarton,7791,9,9,11,16,47,63,-16,38
Queen of S't,7791,10,9,8,19,39,55,-16,35
Hibernian,7792,1,19,12,5,53,25,28,69
Dundee Utd,7792,2,17,10,9,63,42,21,61
Falkirk,7792,3,16,11,9,58,45,13,59
Morton,7792,4,14,11,11,45,38,7,53
Dunfermline,7792,5,11,13,12,49,51,-2,46
Queen of S't,7792,6,12,9,15,44,48,-4,45
Ayr,7792,7,11,10,15,37,54,-17,43
Dumbarton,7792,8,9,12,15,50,60,-10,39
Raith,7792,9,9,10,17,31,49,-18,37
St Mirren,7792,10,8,10,18,38,56,-18,34
Falkirk,7793,1,18,10,8,57,37,20,64
Hibernian,7793,2,17,12,7,50,28,22,63
Dundee Utd,7793,3,17,9,10,54,42,12,60
Morton,7793,4,16,11,9,50,38,12,59
Queen of S't,7793,5,13,9,14,50,49,1,48
Raith,7793,6,10,11,15,36,45,-9,41
Dunfermline,7793,7,8,15,13,41,47,-6,39
Dumbarton,7793,8,9,12,15,45,57,-12,39
St Mirren,7793,9,9,10,17,40,56,-16,37
Ayr,7793,10,7,13,16,34,58,-24,34
Hibernian,7794,1,20,12,4,55,25,30,72
Dundee Utd,7794,2,15,13,8,47,36,11,58
Falkirk,7794,3,16,9,11,59,42,17,57
Morton,7794,4,15,10,11,47,38,9,55
Queen of S't,7794,5,12,10,14,48,53,-5,46
Raith,7794,6,11,10,15,36,46,-10,43
Dumbarton,7794,7,10,11,15,51,60,-9,41
Dunfermline,7794,8,9,13,14,44,49,-5,40
Ayr,7794,9,8,14,14,33,52,-19,38
St Mirren,7794,10,8,10,18,36,55,-19,34
Morton,7795,1,18,11,7,57,39,18,65
Hibernian,7795,2,17,12,7,55,31,24,63
Falkirk,7795,3,17,10,9,58,37,21,61
Dundee Utd,7795,4,17,10,9,54,37,17,61
Queen of S't,7795,5,12,9,15,45,53,-8,45
Dunfermline,7795,6,10,11,15,48,50,-2,41
Ayr,7795,7,9,14,13,33,51,-18,41
Raith,7795,8,10,10,16,36,53,-17,40
Dumbarton,7795,9,8,11,17,48,62,-14,35
St Mirren,7795,10,8,10,18,40,61,-21,34
Hibernian,7796,1,20,12,4,54,25,29,72
Morton,7796,2,16,12,8,49,35,14,60
Falkirk,7796,3,16,9,11,53,41,12,57
Dundee Utd,7796,4,15,10,11,50,41,9,55
Queen of S't,7796,5,12,8,16,47,53,-6,44
Dunfermline,7796,6,10,13,13,41,43,-2,43
Dumbarton,7796,7,10,13,13,50,55,-5,43
Raith,7796,8,10,10,16,37,51,-14,40
Ayr,7796,9,9,12,15,37,54,-17,39
St Mirren,7796,10,7,11,18,39,59,-20,32
Morton,7797,1,19,12,5,58,34,24,69
Hibernian,7797,2,18,11,7,54,33,21,65
Falkirk,7797,3,17,10,9,58,38,20,61
Dundee Utd,7797,4,13,12,11,49,44,5,51
Queen of S't,7797,5,12,11,13,47,46,1,47
Dunfermline,7797,6,10,12,14,47,52,-5,42
Ayr,7797,7,9,13,14,36,53,-17,40
St Mirren,7797,8,9,10,17,39,58,-19,37
Dumbarton,7797,9,8,12,16,45,57,-12,36
Raith,7797,10,9,9,18,29,47,-18,36
Hibernian,7798,1,18,14,4,54,23,31,68
Dundee Utd,7798,2,17,9,10,51,36,15,60
Morton,7798,3,14,14,8,48,38,10,56
Falkirk,7798,4,14,11,11,55,43,12,53
Dunfermline,7798,5,11,14,11,47,44,3,47
Queen of S't,7798,6,12,11,13,46,47,-1,47
Ayr,7798,7,11,11,14,37,51,-14,44
St Mirren,7798,8,9,10,17,39,55,-16,37
Dumbarton,7798,9,8,11,17,42,62,-20,35
Raith,7798,10,8,11,17,32,52,-20,35
Hibernian,7799,1,19,14,3,56,22,34,71
Morton,7799,2,17,12,7,49,35,14,63
Falkirk,7799,3,17,11,8,56,36,20,62
Dundee Utd,7799,4,16,10,10,53,42,11,58
Queen of S't,7799,5,10,13,13,45,50,-5,43
Dunfermline,7799,6,9,13,14,48,53,-5,40
St Mirren,7799,7,9,11,16,41,54,-13,38
Raith,7799,8,9,9,18,35,51,-16,36
Ayr,7799,9,8,12,16,34,54,-20,36
Dumbarton,7799,10,7,13,16,44,64,-20,34
Hibernian,7800,1,18,13,5,55,30,25,67
Morton,7800,2,18,11,7,56,38,18,65
Falkirk,7800,3,18,10,8,60,36,24,64
Dundee Utd,7800,4,15,10,11,50,42,8,55
Queen of S't,7800,5,12,11,13,49,51,-2,47
Dunfermline,7800,6,11,12,13,52,51,1,45
Raith,7800,7,10,8,18,38,55,-17,38
Dumbarton,7800,8,8,12,16,49,65,-16,36
St Mirren,7800,9,8,11,17,42,56,-14,35
Ayr,7800,10,7,12,17,30,57,-27,33
Morton,7801,1,16,15,5,49,32,17,63
Hibernian,7801,2,16,13,7,50,28,22,61
Falkirk,7801,3,16,10,10,57,41,16,58
Dundee Utd,7801,4,16,9,11,46,38,8,57
Queen of S't,7801,5,13,8,15,42,47,-5,47
Dunfermline,7801,6,10,13,13,44,45,-1,43
Dumbarton,7801,7,10,11,15,47,56,-9,41
St Mirren,7801,8,10,10,16,44,54,-10,40
Ayr,7801,9,8,13,15,33,51,-18,37
Raith,7801,10,9,10,17,32,52,-20,37
Hibernian,7802,1,21,11,4,64,26,38,74
Morton,7802,2,18,10,8,54,38,16,64
Falkirk,7802,3,16,10,10,55,43,12,58
Dundee Utd,7802,4,14,8,14,51,48,3,50
Queen of S't,7802,5,13,9,14,47,49,-2,48
Dumbarton,7802,6,10,11,15,49,57,-8,41
Raith,7802,7,10,10,16,34,47,-13,40
Dunfermline,7802,8,9,12,15,45,53,-8,39
Ayr,7802,9,9,12,15,41,57,-16,39
St Mirren,7802,10,9,9,18,40,62,-22,36
Hibernian,7803,1,19,11,6,62,32,30,68
Dundee Utd,7803,2,16,12,8,54,40,14,60
Morton,7803,3,16,12,8,48,37,11,60
Falkirk,7803,4,14,12,10,55,43,12,54
Dunfermline,7803,5,11,13,12,50,48,2,46
Raith,7803,6,12,9,15,38,48,-10,45
Ayr,7803,7,9,14,13,31,46,-15,41
Queen of S't,7803,8,10,9,17,44,54,-10,39
Dumbarton,7803,9,9,11,16,44,57,-13,38
St Mirren,7803,10,7,11,18,35,56,-21,32
Morton,7804,1,19,10,7,52,36,16,67
Hibernian,7804,2,18,12,6,58,31,27,66
Falkirk,7804,3,18,10,8,66,38,28,64
Dundee Utd,7804,4,17,8,11,52,40,12,59
Raith,7804,5,10,11,15,36,47,-11,41
Queen of S't,7804,6,11,8,17,43,56,-13,41
Ayr,7804,7,10,10,16,35,56,-21,40
Dumbarton,7804,8,9,11,16,51,61,-10,38
St Mirren,7804,9,9,10,17,41,59,-18,37
Dunfermline,7804,10,8,12,16,41,51,-10,36
Hibernian,7805,1,19,12,5,51,22,29,69
Morton,7805,2,18,13,5,54,33,21,67
Falkirk,7805,3,18,9,9,61,38,23,63
Dundee Utd,7805,4,17,8,11,52,35,17,59
Queen of S't,7805,5,13,9,14,43,50,-7,48
Raith,7805,6,9,11,16,35,49,-14,38
Dunfermline,7805,7,8,12,16,39,53,-14,36
Ayr,7805,8,8,12,16,34,61,-27,36
Dumbarton,7805,9,8,11,17,48,62,-14,35
St Mirren,7805,10,8,11,17,38,52,-14,35
Hibernian,7806,1,20,10,6,57,29,28,70
Morton,7806,2,17,10,9,51,41,10,61
Falkirk,7806,3,17,9,10,59,43,16,60
Dundee Utd,7806,4,14,8,14,42,39,3,50
Queen of S't,7806,5,12,10,14,46,49,-3,46
Dumbarton,7806,6,11,12,13,56,52,4,45
Dunfermline,7806,7,11,12,13,51,55,-4,45
Raith,7806,8,10,10,16,34,47,-13,40
Ayr,7806,9,10,10,16,33,50,-17,40
St Mirren,7806,10,7,11,18,35,59,-24,32
Hibernian,7807,1,20,12,4,54,24,30,72
Dundee Utd,7807,2,17,10,9,53,40,13,61
Falkirk,7807,3,15,10,11,59,45,14,55
Morton,7807,4,13,12,11,41,37,4,51
Dumbarton,7807,5,10,13,13,46,52,-6,43
St Mirren,7807,6,11,10,15,42,50,-8,43
Queen of S't,7807,7,11,10,15,48,58,-10,43
Dunfermline,7807,8,10,12,14,47,47,0,42
Ayr,7807,9,9,11,16,39,61,-22,38
Raith,7807,10,9,10,17,32,47,-15,37
Hibernian,7808,1,21,11,4,65,26,39,74
Morton,7808,2,15,13,8,49,38,11,58
Falkirk,7808,3,16,9,11,55,45,10,57
Dundee Utd,7808,4,16,9,11,50,41,9,57
Queen of S't,7808,5,14,8,14,51,50,1,50
Dumbarton,7808,6,10,12,14,50,54,-4,42
Dunfermline,7808,7,9,14,13,48,49,-1,41
Raith,7808,8,10,9,17,35,58,-23,39
Ayr,7808,9,9,10,17,36,60,-24,37
St Mirren,7808,10,7,11,18,37,55,-18,32
Hibernian,7809,1,18,14,4,52,26,26,68
Morton,7809,2,18,11,7,55,37,18,65
Falkirk,7809,3,16,12,8,61,37,24,60
Dundee Utd,7809,4,14,10,12,47,40,7,52
Ayr,7809,5,11,12,13,43,51,-8,45
Dunfermline,7809,6,9,14,13,46,52,-6,41
Queen of S't,7809,7,11,8,17,42,56,-14,41
Dumbarton,7809,8,10,10,16,50,61,-11,40
Raith,7809,9,9,10,17,32,49,-17,37
St Mirren,7809,10,8,11,17,37,56,-19,35
Hibernian,7810,1,20,13,3,57,23,34,73
Morton,7810,2,17,11,8,51,35,16,62
Falkirk,7810,3,16,11,9,60,44,16,59
Dundee Utd,7810,4,16,11,9,53,38,15,59
Queen of S't,7810,5,12,10,14,43,48,-5,46
Dunfermline,7810,6,10,12,14,46,54,-8,42
Raith,7810,7,9,10,17,32,49,-17,37
St Mirren,7810,8,8,12,16,45,59,-14,36
Dumbarton,7810,9,8,11,17,47,61,-14,35
Ayr,7810,10,7,13,16,31,54,-23,34
Hibernian,7811,1,19,12,5,59,25,34,69
Morton,7811,2,16,12,8,51,38,13,60
Dundee Utd,7811,3,15,13,8,47,35,12,58
Falkirk,7811,4,15,12,9,56,41,15,57
Queen of S't,7811,5,11,10,15,44,50,-6,43
Dumbarton,7811,6,10,12,14,50,58,-8,42
Dunfermline,7811,7,9,13,14,47,52,-5,40
Raith,7811,8,10,10,16,33,49,-16,40
Ayr,7811,9,9,13,14,37,54,-17,40
St Mirren,7811,10,7,11,18,37,59,-22,32
Hibernian,7812,1,20,10,6,55,27,28,70
Morton,7812,2,17,10,9,52,39,13,61
Dundee Utd,7812,3,16,9,11,51,41,10,57
Falkirk,7812,4,15,10,11,57,44,13,55
Dunfermline,7812,5,11,12,13,48,47,1,45
Queen of S't,7812,6,11,10,15,43,47,-4,43
Ayr,7812,7,10,12,14,39,55,-16,42
St Mirren,7812,8,10,9,17,46,58,-12,39
Dumbarton,7812,9,9,12,15,50,63,-13,39
Raith,7812,10,10,8,18,35,55,-20,38
Hibernian,7813,1,17,13,6,54,32,22,64
Morton,7813,2,16,11,9,51,39,12,59
Falkirk,7813,3,16,10,10,56,40,16,58
Dundee Utd,7813,4,16,10,10,51,37,14,58
Dunfermline,7813,5,12,13,11,51,47,4,49
Raith,7813,6,12,8,16,37,47,-10,44
Queen of S't,7813,7,11,10,15,42,51,-9,43
Dumbarton,7813,8,10,11,15,53,64,-11,41
St Mirren,7813,9,8,11,17,39,57,-18,35
Ayr,7813,10,8,11,17,34,54,-20,35
Hibernian,7814,1,21,11,4,60,23,37,74
Morton,7814,2,18,12,6,53,35,18,66
Dundee Utd,7814,3,16,9,11,51,42,9,57
Falkirk,7814,4,14,10,12,55,45,10,52
Queen of S't,7814,5,12,11,13,48,47,1,47
St Mirren,7814,6,10,10,16,46,58,-12,40
Dunfermline,7814,7,9,12,15,47,54,-7,39
Ayr,7814,8,9,11,16,36,60,-24,38
Dumbarton,7814,9,9,10,17,49,63,-14,37
Raith,7814,10,9,10,17,35,53,-18,37
Hibernian,7815,1,19,13,4,57,26,31,70
Falkirk,7815,2,16,9,11,56,41,15,57
Dundee Utd,7815,3,15,10,11,49,40,9,55
Morton,7815,4,15,10,11,46,39,7,55
Queen of S't,7815,5,14,8,14,47,51,-4,50
Dumbarton,7815,6,11,12,13,50,55,-5,45
Raith,7815,7,11,9,16,36,47,-11,42
Dunfermline,7815,8,9,13,14,47,56,-9,40
St Mirren,7815,9,9,10,17,38,53,-15,37
Ayr,7815,10,7,14,15,34,52,-18,35
Hibernian,7816,1,21,11,4,60,25,35,74
Morton,7816,2,18,9,9,52,36,16,63
Dundee Utd,7816,3,17,9,10,54,36,18,60
Falkirk,7816,4,15,11,10,56,40,16,56
Dunfermline,7816,5,11,13,12,47,49,-2,46
Dumbarton,7816,6,10,12,14,48,58,-10,42
Queen of S't,7816,7,10,9,17,46,55,-9,39
Raith,7816,8,9,11,16,34,46,-12,38
St Mirren,7816,9,8,11,17,36,59,-23,35
Ayr,7816,10,7,12,17,31,60,-29,33
Hibernian,7817,1,21,11,4,65,25,40,74
Morton,7817,2,16,12,8,46,39,7,60
Dundee Utd,7817,3,16,10,10,52,42,10,58
Falkirk,7817,4,15,10,11,63,51,12,55
Queen of S't,7817,5,12,8,16,53,57,-4,44
Dunfermline,7817,6,10,12,14,44,50,-6,42
Ayr,7817,7,9,13,14,39,54,-15,40
Raith,7817,8,10,10,16,33,53,-20,40
Dumbarton,7817,9,9,11,16,50,59,-9,38
St Mirren,7817,10,7,13,16,41,56,-15,34
Hibernian,7818,1,17,14,5,52,27,25,65
Morton,7818,2,17,12,7,51,38,13,63
Dundee Utd,7818,3,16,10,10,55,45,10,58
Falkirk,7818,4,15,10,11,58,44,14,55
Queen of S't,7818,5,14,8,14,50,49,1,50
Dunfermline,7818,6,11,14,11,50,47,3,47
Dumbarton,7818,7,9,12,15,50,61,-11,39
St Mirren,7818,8,9,11,16,41,55,-14,38
Raith,7818,9,8,10,18,35,54,-19,34
Ayr,7818,10,7,13,16,32,54,-22,34
Hibernian,7819,1,19,14,3,54,24,30,71
Dundee Utd,7819,2,16,11,9,53,36,17,59
Falkirk,7819,3,15,12,9,57,42,15,57
Morton,7819,4,15,12,9,48,37,11,57
Queen of S't,7819,5,12,10,14,46,51,-5,46
Dunfermline,7819,6,11,12,13,44,46,-2,45
Raith,7819,7,11,9,16,38,49,-11,42
Dumbarton,7819,8,9,11,16,48,62,-14,38
Ayr,7819,9,8,12,16,31,54,-23,36
St Mirren,7819,10,8,9,19,38,56,-18,33
Hibernian,7820,1,18,14,4,53,25,28,68
Morton,7820,2,19,11,6,57,34,23,68
Dundee Utd,7820,3,18,10,8,53,36,17,64
Falkirk,7820,4,15,10,11,54,43,11,55
Queen of S't,7820,5,10,10,16,45,54,-9,40
St Mirren,7820,6,10,10,16,43,53,-10,40
Ayr,7820,7,9,12,15,36,52,-16,39
Dunfermline,7820,8,8,14,14,44,52,-8,38
Raith,7820,9,10,8,18,37,54,-17,38
Dumbarton,7820,10,8,11,17,48,67,-19,35
Hibernian,7821,1,20,12,4,64,28,36,72
Falkirk,7821,2,17,9,10,60,41,19,60
Dundee Utd,7821,3,17,9,10,50,37,13,60
Morton,7821,4,15,13,8,47,35,12,58
Queen of S't,7821,5,12,11,13,45,45,0,47
Dunfermline,7821,6,10,15,11,46,47,-1,45
Dumbarton,7821,7,9,11,16,48,59,-11,38
Ayr,7821,8,9,11,16,32,54,-22,38
Raith,7821,9,9,11,16,31,54,-23,38
St Mirren,7821,10,6,10,20,36,59,-23,28
Hibernian,7822,1,20,12,4,57,25,32,72
Falkirk,7822,2,15,14,7,54,35,19,59
Morton,7822,3,16,11,9,48,39,9,59
Dundee Utd,7822,4,15,11,10,48,39,9,56
Queen of S't,7822,5,13,8,15,46,46,0,47
St Mirren,7822,6,11,10,15,45,51,-6,43
Ayr,7822,7,9,11,16,34,53,-19,38
Dunfermline,7822,8,7,16,13,42,49,-7,37
Dumbarton,7822,9,8,12,16,45,62,-17,36
Raith,7822,10,8,11,17,33,53,-20,35
Hibernian,7823,1,18,13,5,51,26,25,67
Dundee Utd,7823,2,18,9,9,52,38,14,63
Falkirk,7823,3,16,12,8,61,41,20,60
Morton,7823,4,16,12,8,46,33,13,60
Raith,7823,5,11,11,14,37,46,-9,44
Dunfermline,7823,6,9,15,12,47,47,0,42
Dumbarton,7823,7,9,13,14,48,58,-10,40
Ayr,7823,8,8,13,15,36,57,-21,37
Queen of S't,7823,9,9,9,18,40,52,-12,36
St Mirren,7823,10,7,11,18,36,56,-20,32
Hibernian,7824,1,19,10,7,53,25,28,67
Morton,7824,2,17,12,7,50,35,15,63
Dundee Utd,7824,3,17,10,9,50,36,14,61
Falkirk,7824,4,16,11,9,58,39,19,59
Raith,7824,5,11,10,15,40,51,-11,43
Dumbarton,7824,6,10,12,14,48,54,-6,42
Queen of S't,7824,7,10,10,16,39,51,-12,40
Dunfermline,7824,8,7,16,13,42,49,-7,37
St Mirren,7824,9,8,11,17,38,57,-19,35
Ayr,7824,10,7,14,15,30,51,-21,35
Hibernian,7825,1,20,13,3,63,30,33,73
Morton,7825,2,18,10,8,52,33,19,64
Dundee Utd,7825,3,18,9,9,53,37,16,63
Falkirk,7825,4,14,13,9,57,43,14,55
Dunfermline,7825,5,10,15,11,47,48,-1,45
Queen of S't,7825,6,10,12,14,50,58,-8,42
Ayr,7825,7,8,12,16,33,55,-22,36
St Mirren,7825,8,8,11,17,39,55,-16,35
Raith,7825,9,8,11,17,35,54,-19,35
Dumbarton,7825,10,7,12,17,45,61,-16,33
Hibernian,7826,1,20,11,5,56,27,29,71
Falkirk,7826,2,18,9,9,59,38,21,63
Dundee Utd,7826,3,16,9,11,46,36,10,57
Morton,7826,4,15,11,10,46,38,8,56
Dumbarton,7826,5,12,10,14,52,57,-5,46
Queen of S't,7826,6,11,8,17,48,57,-9,41
Ayr,7826,7,10,11,15,39,53,-14,41
Raith,7826,8,10,11,15,38,52,-14,41
St Mirren,7826,9,9,11,16,38,54,-16,38
Dunfermline,7826,10,7,13,16,43,53,-10,34
Hibernian,7827,1,20,12,4,61,28,33,72
Morton,7827,2,19,10,7,53,36,17,67
Falkirk,7827,3,16,10,10,57,41,16,58
Dundee Utd,7827,4,16,9,11,52,43,9,57
Dunfermline,7827,5,11,13,12,47,43,4,46
Queen of S't,7827,6,11,11,14,46,52,-6,44
Dumbarton,7827,7,9,12,15,49,57,-8,39
Ayr,7827,8,8,11,17,31,55,-24,35
Raith,7827,9,8,10,18,32,52,-20,34
St Mirren,7827,10,7,12,17,39,60,-21,33
Morton,7828,1,18,11,7,54,36,18,65
Hibernian,7828,2,17,12,7,52,29,23,63
Dundee Utd,7828,3,16,12,8,52,38,14,60
Falkirk,7828,4,15,11,10,55,38,17,56
Dunfermline,7828,5,10,14,12,47,46,1,44
Queen of S't,7828,6,10,12,14,40,47,-7,42
Dumbarton,7828,7,10,12,14,50,59,-9,42
Raith,7828,8,10,8,18,32,51,-19,38
Ayr,7828,9,8,13,15,34,54,-20,37
St Mirren,7828,10,9,9,18,39,57,-18,36
Hibernian,7829,1,18,14,4,55,27,28,68
Morton,7829,2,16,13,7,50,37,13,61
Dundee Utd,7829,3,14,11,11,50,42,8,53
Falkirk,7829,4,14,10,12,58,48,10,52
Dunfermline,7829,5,11,14,11,49,44,5,47
Queen of S't,7829,6,12,11,13,49,51,-2,47
Raith,7829,7,9,13,14,38,51,-13,40
Dumbarton,7829,8,9,11,16,48,60,-12,38
St Mirren,7829,9,9,11,16,43,56,-13,38
Ayr,7829,10,7,14,15,32,56,-24,35
Hibernian,7830,1,18,14,4,61,29,32,68
Morton,7830,2,17,12,7,50,33,17,63
Dundee Utd,7830,3,17,11,8,54,40,14,62
Falkirk,7830,4,17,10,9,63,44,19,61
Dunfermline,7830,5,10,13,13,47,47,0,43
Queen of S't,7830,6,11,10,15,45,54,-9,43
Dumbarton,7830,7,9,11,16,48,62,-14,38
St Mirren,7830,8,8,12,16,40,54,-14,36
Raith,7830,9,9,9,18,35,55,-20,36
Ayr,7830,10,7,12,17,37,62,-25,33
Hibernian,7831,1,20,11,5,58,25,33,71
Morton,7831,2,17,11,8,53,40,13,62
Falkirk,7831,3,16,10,10,59,44,15,58
Dundee Utd,7831,4,15,11,10,51,40,11,56
Dunfermline,7831,5,10,13,13,49,49,0,43
Queen of S't,7831,6,11,10,15,47,55,-8,43
Dumbarton,7831,7,9,13,14,49,60,-11,40
Raith,7831,8,10,10,16,36,50,-14,40
Ayr,7831,9,9,11,16,33,56,-23,38
St Mirren,7831,10,7,12,17,39,55,-16,33
Hibernian,7832,1,19,11,6,61,29,32,68
Morton,7832,2,17,12,7,50,36,14,63
Dundee Utd,7832,3,17,9,10,53,40,13,60
Falkirk,7832,4,15,10,11,52,41,11,55
Queen of S't,7832,5,13,9,14,46,52,-6,48
Dumbarton,7832,6,10,12,14,52,59,-7,42
Dunfermline,7832,7,8,15,13,48,53,-5,39
Raith,7832,8,9,11,16,30,46,-16,38
Ayr,7832,9,8,14,14,33,51,-18,38
St Mirren,7832,10,8,9,19,40,58,-18,33
Hibernian,7833,1,19,11,6,52,26,26,68
Morton,7833,2,18,11,7,51,34,17,65
Dundee Utd,7833,3,15,10,11,48,44,4,55
Falkirk,7833,4,14,10,12,55,46,9,52
Dunfermline,7833,5,13,11,12,52,52,0,50
Dumbarton,7833,6,10,13,13,56,56,0,43
Queen of S't,7833,7,11,8,17,45,57,-12,41
St Mirren,7833,8,9,11,16,39,52,-13,38
Ayr,7833,9,9,11,16,39,53,-14,38
Raith,7833,10,10,8,18,35,52,-17,38
Morton,7834,1,22,9,5,58,33,25,75
Hibernian,7834,2,17,13,6,48,26,22,64
Falkirk,7834,3,14,13,9,55,39,16,55
Dundee Utd,7834,4,13,10,13,45,44,1,49
Raith,7834,5,12,10,14,35,44,-9,46
Dunfermline,7834,6,11,12,13,53,53,0,45
St Mirren,7834,7,9,11,16,43,52,-9,38
Queen of S't,7834,8,9,10,17,39,50,-11,37
Dumbarton,7834,9,8,13,15,45,57,-12,37
Ayr,7834,10,8,13,15,31,54,-23,37
Hibernian,7835,1,18,13,5,60,31,29,67
Falkirk,7835,2,17,10,9,62,43,19,61
Morton,7835,3,16,12,8,46,35,11,60
Dundee Utd,7835,4,14,10,12,47,44,3,52
Dumbarton,7835,5,11,12,13,52,55,-3,45
Raith,7835,6,10,11,15,36,49,-13,41
Dunfermline,7835,7,9,13,14,43,47,-4,40
Queen of S't,7835,8,10,10,16,41,51,-10,40
St Mirren,7835,9,9,11,16,43,56,-13,38
Ayr,7835,10,7,16,13,35,54,-19,37
Hibernian,7836,1,21,11,4,60,22,38,74
Falkirk,7836,2,16,10,10,60,48,12,58
Morton,7836,3,15,12,9,46,38,8,57
Dundee Utd,7836,4,15,11,10,47,36,11,56
Queen of S't,7836,5,13,8,15,43,50,-7,47
Raith,7836,6,12,9,15,43,47,-4,45
Dunfermline,7836,7,10,14,12,47,49,-2,44
St Mirren,7836,8,8,11,17,37,57,-20,35
Dumbarton,7836,9,7,13,16,46,61,-15,34
Ayr,7836,10,7,13,16,28,49,-21,34
Hibernian,7837,1,22,10,4,64,25,39,76
Morton,7837,2,18,11,7,59,34,25,65
Dundee Utd,7837,3,16,10,10,50,38,12,58
Falkirk,7837,4,14,12,10,53,40,13,54
Queen of S't,7837,5,11,10,15,45,53,-8,43
Raith,7837,6,11,9,16,36,52,-16,42
St Mirren,7837,7,10,10,16,37,55,-18,40
Dumbarton,7837,8,9,12,15,48,59,-11,39
Dunfermline,7837,9,8,14,14,45,55,-10,38
Ayr,7837,10,6,12,18,33,59,-26,30
Hibernian,7838,1,19,12,5,55,24,31,69
Morton,7838,2,18,10,8,50,36,14,64
Dundee Utd,7838,3,16,9,11,48,39,9,57
Falkirk,7838,4,14,11,11,53,42,11,53
Dunfermline,7838,5,11,13,12,47,46,1,46
Raith,7838,6,11,10,15,38,49,-11,43
Queen of S't,7838,7,10,10,16,43,54,-11,40
Dumbarton,7838,8,9,12,15,43,55,-12,39
Ayr,7838,9,9,11,16,33,51,-18,38
St Mirren,7838,10,9,10,17,41,55,-14,37
Hibernian,7839,1,19,13,4,55,26,29,70
Morton,7839,2,17,10,9,51,39,12,61
Falkirk,7839,3,17,9,10,57,41,16,60
Dundee Utd,7839,4,13,11,12,44,41,3,50
Queen of S't,7839,5,13,10,13,48,47,1,49
Raith,7839,6,11,10,15,36,48,-12,43
Dunfermline,7839,7,10,12,14,44,49,-5,42
Ayr,7839,8,9,12,15,32,49,-17,39
St Mirren,7839,9,9,10,17,44,57,-13,37
Dumbarton,7839,10,8,11,17,45,59,-14,35
Hibernian,7840,1,19,13,4,56,24,32,70
Morton,7840,2,16,12,8,49,37,12,60
Falkirk,7840,3,15,11,10,59,41,18,56
Dundee Utd,7840,4,15,11,10,53,42,11,56
Dunfermline,7840,5,10,13,13,45,48,-3,43
Dumbarton,7840,6,10,12,14,46,53,-7,42
Raith,7840,7,10,11,15,37,51,-14,41
St Mirren,7840,8,10,10,16,39,54,-15,40
Queen of S't,7840,9,9,12,15,42,53,-11,39
Ayr,7840,10,7,13,16,34,57,-23,34
Morton,7841,1,19,11,6,52,31,21,68
Falkirk,7841,2,19,9,8,70,38,32,66
Hibernian,7841,3,17,14,5,54,27,27,65
Dundee Utd,7841,4,15,9,12,49,46,3,54
Queen of S't,7841,5,11,10,15,44,50,-6,43
Raith,7841,6,10,11,15,37,49,-12,41
Dunfermline,7841,7,8,13,15,45,55,-10,37
Ayr,7841,8,8,13,15,31,52,-21,37
St Mirren,7841,9,9,10,17,42,65,-23,37
Dumbarton,7841,10,8,12,16,45,56,-11,36
Hibernian,7842,1,22,11,3,63,24,39,77
Morton,7842,2,17,11,8,50,35,15,62
Dundee Utd,7842,3,15,12,9,52,42,10,57
Falkirk,7842,4,14,11,11,55,43,12,53
Queen of S't,7842,5,14,8,14,45,46,-1,50
Dunfermline,7842,6,11,13,12,45,43,2,46
St Mirren,7842,7,9,10,17,47,61,-14,37
Raith,7842,8,9,9,18,33,52,-19,36
Dumbarton,7842,9,7,13,16,46,60,-14,34
Ayr,7842,10,7,12,17,33,63,-30,33
Hibernian,7843,1,17,14,5,54,26,28,65
Falkirk,7843,2,18,10,8,61,40,21,64
Morton,7843,3,17,12,7,51,35,16,63
Dundee Utd,7843,4,17,10,9,53,36,17,61
Queen of S't,7843,5,11,13,12,44,47,-3,46
Ayr,7843,6,9,13,14,36,54,-18,40
Dunfermline,7843,7,8,13,15,42,52,-10,37
St Mirren,7843,8,8,11,17,39,53,-14,35
Dumbarton,7843,9,8,11,17,47,63,-16,35
Raith,7843,10,8,11,17,34,55,-21,35
Hibernian,7844,1,19,12,5,60,25,35,69
Morton,7844,2,17,12,7,50,37,13,63
Falkirk,7844,3,16,10,10,58,44,14,58
Dundee Utd,7844,4,15,11,10,53,42,11,56
Raith,7844,5,13,10,13,38,45,-7,49
Queen of S't,7844,6,10,10,16,43,51,-8,40
Dunfermline,7844,7,8,15,13,48,56,-8,39
St Mirren,7844,8,9,10,17,40,56,-16,37
Dumbarton,7844,9,8,12,16,46,59,-13,36
Ayr,7844,10,8,12,16,35,56,-21,36
Hibernian,7845,1,21,11,4,56,24,32,74
Dundee Utd,7845,2,18,9,9,50,34,16,63
Morton,7845,3,15,14,7,50,36,14,59
Falkirk,7845,4,16,10,10,56,40,16,58
Queen of S't,7845,5,12,9,15,42,48,-6,45
Dumbarton,7845,6,10,11,15,47,57,-10,41
Raith,7845,7,10,9,17,34,50,-16,39
Dunfermline,7845,8,7,15,14,43,49,-6,36
Ayr,7845,9,8,12,16,32,55,-23,36
St Mirren,7845,10,8,10,18,38,55,-17,34
Hibernian,7846,1,23,10,3,61,21,40,79
Falkirk,7846,2,18,10,8,62,40,22,64
Morton,7846,3,17,10,9,51,37,14,61
Dundee Utd,7846,4,15,11,10,53,42,11,56
Queen of S't,7846,5,11,10,15,48,55,-7,43
Dunfermline,7846,6,8,15,13,46,51,-5,39
Ayr,7846,7,9,10,17,37,62,-25,37
Raith,7846,8,9,9,18,39,56,-17,36
Dumbarton,7846,9,7,14,15,49,64,-15,35
St Mirren,7846,10,8,11,17,44,62,-18,35
Hibernian,7847,1,17,14,5,53,25,28,65
Morton,7847,2,15,12,9,47,42,5,57
Falkirk,7847,3,14,12,10,59,44,15,54
Dundee Utd,7847,4,15,9,12,51,42,9,54
Dunfermline,7847,5,12,12,12,47,47,0,48
Queen of S't,7847,6,12,11,13,47,49,-2,47
Ayr,7847,7,10,12,14,34,51,-17,42
Dumbarton,7847,8,10,10,16,52,61,-9,40
St Mirren,7847,9,10,9,17,44,58,-14,39
Raith,7847,10,9,11,16,36,51,-15,38
Hibernian,7848,1,19,12,5,58,27,31,69
Dundee Utd,7848,2,16,11,9,56,42,14,59
Morton,7848,3,16,11,9,52,39,13,59
Falkirk,7848,4,14,12,10,55,42,13,54
Queen of S't,7848,5,13,11,12,55,50,5,50
Dunfermline,7848,6,10,14,12,45,48,-3,44
Dumbarton,7848,7,10,12,14,50,62,-12,42
Raith,7848,8,9,11,16,34,51,-17,38
Ayr,7848,9,8,12,16,37,58,-21,36
St Mirren,7848,10,6,12,18,38,61,-23,30
Hibernian,7849,1,19,13,4,58,25,33,70
Morton,7849,2,18,10,8,52,36,16,64
Falkirk,7849,3,16,12,8,62,39,23,60
Dundee Utd,7849,4,17,8,11,51,42,9,59
Queen of S't,7849,5,12,9,15,43,51,-8,45
Raith,7849,6,11,9,16,35,50,-15,42
Dunfermline,7849,7,8,14,14,43,50,-7,38
Dumbarton,7849,8,9,11,16,48,57,-9,38
St Mirren,7849,9,8,11,17,38,58,-20,35
Ayr,7849,10,8,11,17,37,59,-22,35
Hibernian,7850,1,20,12,4,56,23,33,72
Morton,7850,2,16,12,8,49,39,10,60
Falkirk,7850,3,16,10,10,55,40,15,58
Dundee Utd,7850,4,15,9,12,47,41,6,54
Dumbarton,7850,5,11,11,14,53,59,-6,44
Queen of S't,7850,6,11,10,15,43,52,-9,43
Ayr,7850,7,10,11,15,38,52,-14,41
Dunfermline,7850,8,8,14,14,42,50,-8,38
Raith,7850,9,9,11,16,35,50,-15,38
St Mirren,7850,10,9,10,17,42,54,-12,37
Hibernian,7851,1,17,14,5,53,28,25,65
Falkirk,7851,2,17,10,9,60,40,20,61
Dundee Utd,7851,3,16,11,9,53,41,12,59
Morton,7851,4,14,12,10,44,40,4,54
Queen of S't,7851,5,13,10,13,48,49,-1,49
Dunfermline,7851,6,10,15,11,45,42,3,45
Dumbarton,7851,7,10,11,15,48,57,-9,41
Ayr,7851,8,8,15,13,36,53,-17,39
Raith,7851,9,9,9,18,35,51,-16,36
St Mirren,7851,10,7,11,18,42,63,-21,32
Hibernian,7852,1,20,12,4,57,24,33,72
Falkirk,7852,2,18,10,8,58,35,23,64
Dundee Utd,7852,3,16,10,10,51,40,11,58
Morton,7852,4,14,13,9,45,38,7,55
Queen of S't,7852,5,12,9,15,46,54,-8,45
St Mirren,7852,6,10,11,15,44,53,-9,41
Dumbarton,7852,7,9,12,15,45,55,-10,39
Dunfermline,7852,8,8,13,15,44,52,-8,37
Ayr,7852,9,8,13,15,30,52,-22,37
Raith,7852,10,9,9,18,32,49,-17,36
Hibernian,7853,1,18,13,5,55,30,25,67
Morton,7853,2,18,10,8,52,33,19,64
Dundee Utd,7853,3,15,10,11,44,38,6,55
Falkirk,7853,4,15,9,12,58,42,16,54
Queen of S't,7853,5,13,9,14,43,48,-5,48
Dunfermline,7853,6,11,12,13,45,44,1,45
Dumbarton,7853,7,10,12,14,43,50,-7,42
St Mirren,7853,8,10,9,17,46,57,-11,39
Ayr,7853,9,8,13,15,34,53,-19,37
Raith,7853,10,9,9,18,31,56,-25,36
Hibernian,7854,1,21,12,3,60,20,40,75
Morton,7854,2,17,12,7,53,37,16,63
Dundee Utd,7854,3,17,9,10,57,43,14,60
Falkirk,7854,4,16,11,9,55,39,16,59
Queen of S't,7854,5,11,9,16,43,51,-8,42
Raith,7854,6,9,14,13,35,45,-10,41
Dunfermline,7854,7,9,13,14,43,52,-9,40
Dumbarton,7854,8,8,14,14,46,56,-10,38
St Mirren,7854,9,7,12,17,38,58,-20,33
Ayr,7854,10,6,12,18,33,62,-29,30
Hibernian,7855,1,20,10,6,60,29,31,70
Dundee Utd,7855,2,16,10,10,53,43,10,58
Morton,7855,3,16,10,10,52,42,10,58
Queen of S't,7855,4,15,8,13,54,48,6,53
Falkirk,7855,5,14,9,13,56,46,10,51
Dunfermline,7855,6,10,12,14,49,54,-5,42
Raith,7855,7,11,9,16,37,52,-15,42
Dumbarton,7855,8,10,11,15,53,62,-9,41
St Mirren,7855,9,10,10,16,42,56,-14,40
Ayr,7855,10,7,13,16,32,56,-24,34
Hibernian,7856,1,21,11,4,55,23,32,74
Morton,7856,2,18,9,9,55,39,16,63
Dundee Utd,7856,3,17,11,8,50,37,13,62
Falkirk,7856,4,16,10,10,58,42,16,58
Queen of S't,7856,5,12,10,14,47,46,1,46
Dunfermline,7856,6,11,12,13,47,48,-1,45
Dumbarton,7856,7,9,11,16,44,62,-18,38
Raith,7856,8,9,10,17,33,50,-17,37
St Mirren,7856,9,8,10,18,39,55,-16,34
Ayr,7856,10,6,12,18,31,57,-26,30
Morton,7857,1,19,12,5,56,32,24,69
Hibernian,7857,2,18,10,8,53,29,24,64
Dundee Utd,7857,3,15,12,9,54,44,10,57
Falkirk,7857,4,15,11,10,62,44,18,56
Queen of S't,7857,5,13,9,14,47,49,-2,48
Dunfermline,7857,6,10,12,14,45,53,-8,42
St Mirren,7857,7,10,10,16,48,59,-11,40
Dumbarton,7857,8,9,12,15,49,59,-10,39
Raith,7857,9,9,10,17,35,56,-21,37
Ayr,7857,10,7,12,17,34,58,-24,33
Falkirk,7858,1,19,9,8,64,37,27,66
Hibernian,7858,2,18,12,6,55,29,26,66
Dundee Utd,7858,3,17,9,10,52,39,13,60
Morton,7858,4,16,11,9,48,36,12,59
Queen of S't,7858,5,12,10,14,48,49,-1,46
Dumbarton,7858,6,11,11,14,50,59,-9,44
Raith,7858,7,11,9,16,34,48,-14,42
Dunfermline,7858,8,8,13,15,42,50,-8,37
St Mirren,7858,9,8,11,17,40,55,-15,35
Ayr,7858,10,7,11,18,32,63,-31,32
Hibernian,7859,1,19,13,4,61,25,36,70
Morton,7859,2,18,11,7,48,34,14,65
Dundee Utd,7859,3,18,8,10,51,38,13,62
Falkirk,7859,4,16,11,9,58,39,19,59
Queen of S't,7859,5,12,9,15,44,54,-10,45
Dunfermline,7859,6,9,14,13,43,48,-5,41
Raith,7859,7,10,11,15,36,50,-14,41
Dumbarton,7859,8,8,12,16,45,56,-11,36
St Mirren,7859,9,7,13,16,40,56,-16,34
Ayr,7859,10,6,12,18,31,57,-26,30
Hibernian,7860,1,19,12,5,60,26,34,69
Dundee Utd,7860,2,18,9,9,54,38,16,63
Morton,7860,3,15,14,7,51,40,11,59
Falkirk,7860,4,16,10,10,58,45,13,58
Queen of S't,7860,5,11,9,16,47,56,-9,42
Raith,7860,6,10,11,15,34,49,-15,41
St Mirren,7860,7,9,12,15,41,53,-12,39
Ayr,7860,8,9,12,15,33,48,-15,39
Dunfermline,7860,9,8,13,15,42,52,-10,37
Dumbarton,7860,10,8,12,16,50,63,-13,36
Hibernian,7861,1,18,14,4,50,22,28,68
Dundee Utd,7861,2,17,11,8,52,36,16,62
Morton,7861,3,16,13,7,49,35,14,61
Falkirk,7861,4,16,11,9,58,39,19,59
Queen of S't,7861,5,11,10,15,40,49,-9,43
Dumbarton,7861,6,10,12,14,48,57,-9,42
Raith,7861,7,11,9,16,39,51,-12,42
Dunfermline,7861,8,9,12,15,43,50,-7,39
St Mirren,7861,9,8,10,18,40,57,-17,34
Ayr,7861,10,7,12,17,32,55,-23,33
Hibernian,7862,1,19,13,4,52,23,29,70
Morton,7862,2,17,11,8,54,34,20,62
Falkirk,7862,3,15,13,8,56,39,17,58
Dundee Utd,7862,4,14,10,12,46,39,7,52
Queen of S't,7862,5,12,11,13,44,47,-3,47
Dumbarton,7862,6,11,12,13,47,51,-4,45
Ayr,7862,7,9,12,15,34,58,-24,39
Raith,7862,8,9,11,16,41,50,-9,38
Dunfermline,7862,9,9,11,16,43,54,-11,38
St Mirren,7862,10,7,12,17,40,62,-22,33
Hibernian,7863,1,19,14,3,54,24,30,71
Dundee Utd,7863,2,17,9,10,49,39,10,60
Morton,7863,3,16,11,9,46,37,9,59
Falkirk,7863,4,14,10,12,54,43,11,52
Dumbarton,7863,5,11,11,14,49,53,-4,44
Raith,7863,6,11,11,14,36,45,-9,44
Queen of S't,7863,7,11,9,16,42,51,-9,42
Dunfermline,7863,8,9,12,15,46,52,-6,39
Ayr,7863,9,9,11,16,35,52,-17,38
St Mirren,7863,10,8,12,16,39,54,-15,36
Hibernian,7864,1,20,13,3,63,24,39,73
Falkirk,7864,2,17,11,8,58,39,19,62
Morton,7864,3,17,11,8,48,35,13,62
Dundee Utd,7864,4,15,9,12,49,40,9,54
Queen of S't,7864,5,12,11,13,52,55,-3,47
Dunfermline,7864,6,11,12,13,49,50,-1,45
St Mirren,7864,7,9,11,16,40,52,-12,38
Raith,7864,8,9,10,17,31,51,-20,37
Dumbarton,7864,9,8,11,17,41,57,-16,35
Ayr,7864,10,6,13,17,32,60,-28,31
Hibernian,7865,1,19,12,5,52,25,27,69
Morton,7865,2,17,12,7,52,35,17,63
Falkirk,7865,3,15,10,11,56,47,9,55
Dundee Utd,7865,4,14,10,12,48,43,5,52
Dunfermline,7865,5,11,13,12,50,48,2,46
Queen of S't,7865,6,12,10,14,45,51,-6,46
Dumbarton,7865,7,10,12,14,48,55,-7,42
St Mirren,7865,8,9,12,15,43,56,-13,39
Raith,7865,9,9,10,17,37,50,-13,37
Ayr,7865,10,8,11,17,33,54,-21,35
Hibernian,7866,1,19,10,7,59,30,29,67
Morton,7866,2,17,12,7,57,37,20,63
Falkirk,7866,3,17,9,10,64,48,16,60
Dundee Utd,7866,4,15,11,10,57,41,16,56
Dunfermline,7866,5,11,14,11,51,46,5,47
Queen of S't,7866,6,12,9,15,41,51,-10,45
Dumbarton,7866,7,9,11,16,48,61,-13,38
Raith,7866,8,9,11,16,31,46,-15,38
Ayr,7866,9,9,11,16,32,59,-27,38
St Mirren,7866,10,8,10,18,37,58,-21,34
Hibernian,7867,1,20,12,4,55,23,32,72
Morton,7867,2,17,11,8,49,36,13,62
Dundee Utd,7867,3,16,11,9,47,37,10,59
Falkirk,7867,4,15,11,10,56,42,14,56
Queen of S't,7867,5,12,9,15,48,53,-5,45
Dunfermline,7867,6,10,13,13,44,46,-2,43
Raith,7867,7,11,9,16,42,50,-8,42
Dumbarton,7867,8,9,10,17,44,58,-14,37
St Mirren,7867,9,9,9,18,40,58,-18,36
Ayr,7867,10,7,13,16,32,54,-22,34
Hibernian,7868,1,19,11,6,59,30,29,68
Morton,7868,2,19,9,8,50,38,12,66
Falkirk,7868,3,15,13,8,59,41,18,58
Dundee Utd,7868,4,16,10,10,49,38,11,58
Queen of S't,7868,5,13,8,15,52,56,-4,47
Dunfermline,7868,6,9,12,15,48,54,-6,39
Dumbarton,7868,7,9,12,15,47,55,-8,39
Raith,7868,8,10,9,17,35,51,-16,39
Ayr,7868,9,9,11,16,32,52,-20,38
St Mirren,7868,10,7,13,16,39,55,-16,34
Hibernian,7869,1,19,13,4,58,26,32,70
Morton,7869,2,15,13,8,53,42,11,58
Dundee Utd,7869,3,16,10,10,50,40,10,58
Falkirk,7869,4,14,10,12,56,47,9,52
Dunfermline,7869,5,13,13,10,50,42,8,52
Queen of S't,7869,6,11,10,15,46,53,-7,43
Raith,7869,7,11,10,15,36,50,-14,43
Ayr,7869,8,9,13,14,38,52,-14,40
Dumbarton,7869,9,8,11,17,50,66,-16,35
St Mirren,7869,10,6,13,17,42,61,-19,31
Hibernian,7870,1,19,12,5,53,27,26,69
Morton,7870,2,17,11,8,54,37,17,62
Dundee Utd,7870,3,16,10,10,49,39,10,58
Falkirk,7870,4,14,12,10,56,42,14,54
Dunfermline,7870,5,12,11,13,48,46,2,47
Dumbarton,7870,6,10,13,13,46,53,-7,43
Queen of S't,7870,7,11,9,16,46,52,-6,42
Ayr,7870,8,9,12,15,33,53,-20,39
Raith,7870,9,8,11,17,33,53,-20,35
St Mirren,7870,10,7,13,16,40,56,-16,34
Hibernian,7871,1,19,12,5,58,28,30,69
Morton,7871,2,19,10,7,53,33,20,67
Falkirk,7871,3,17,10,9,57,40,17,61
Dundee Utd,7871,4,15,11,10,48,40,8,56
Queen of S't,7871,5,12,9,15,44,48,-4,45
Dumbarton,7871,6,10,11,15,49,57,-8,41
Ayr,7871,7,9,12,15,37,59,-22,39
Raith,7871,8,9,10,17,36,49,-13,37
Dunfermline,7871,9,7,15,14,40,48,-8,36
St Mirren,7871,10,8,10,18,36,56,-20,34
Hibernian,7872,1,19,13,4,53,23,30,70
Morton,7872,2,16,12,8,49,35,14,60
Dundee Utd,7872,3,17,9,10,53,43,10,60
Falkirk,7872,4,16,11,9,61,40,21,59
Dunfermline,7872,5,12,12,12,49,46,3,48
Raith,7872,6,10,10,16,31,45,-14,40
Queen of S't,7872,7,10,9,17,46,58,-12,39
Dumbarton,7872,8,9,11,16,50,61,-11,38
Ayr,7872,9,8,12,16,33,54,-21,36
St Mirren,7872,10,8,11,17,36,56,-20,35
Hibernian,7873,1,21,12,3,60,25,35,75
Morton,7873,2,17,12,7,56,41,15,63
Falkirk,7873,3,15,11,10,55,40,15,56
Dundee Utd,7873,4,15,9,12,54,44,10,54
Queen of S't,7873,5,12,8,16,46,55,-9,44
St Mirren,7873,6,11,9,16,40,52,-12,42
Dunfermline,7873,7,9,14,13,44,50,-6,41
Raith,7873,8,10,11,15,36,47,-11,41
Dumbarton,7873,9,8,12,16,46,56,-10,36
Ayr,7873,10,8,10,18,34,61,-27,34
Hibernian,7874,1,21,11,4,54,21,33,74
Morton,7874,2,15,13,8,48,35,13,58
Falkirk,7874,3,15,11,10,60,42,18,56
Dundee Utd,7874,4,15,10,11,49,42,7,55
Queen of S't,7874,5,13,10,13,45,48,-3,49
Dumbarton,7874,6,10,12,14,47,58,-11,42
St Mirren,7874,7,10,10,16,45,55,-10,40
Dunfermline,7874,8,7,15,14,44,51,-7,36
Ayr,7874,9,7,15,14,33,51,-18,36
Raith,7874,10,9,9,18,30,52,-22,36
Hibernian,7875,1,19,13,4,58,25,33,70
Morton,7875,2,17,14,5,55,38,17,65
Falkirk,7875,3,17,10,9,64,42,22,61
Dundee Utd,7875,4,15,12,9,53,46,7,57
Queen of S't,7875,5,11,11,14,45,49,-4,44
Dunfermline,7875,6,8,16,12,50,50,0,40
Raith,7875,7,10,9,17,37,57,-20,39
Dumbarton,7875,8,8,13,15,52,64,-12,37
St Mirren,7875,9,8,12,16,47,62,-15,36
Ayr,7875,10,6,12,18,33,61,-28,30
Hibernian,7876,1,19,12,5,60,28,32,69
Morton,7876,2,16,12,8,50,38,12,60
Falkirk,7876,3,16,11,9,60,41,19,59
Dundee Utd,7876,4,14,11,11,48,45,3,53
Dunfermline,7876,5,12,12,12,48,48,0,48
Dumbarton,7876,6,12,10,14,50,54,-4,46
Raith,7876,7,11,8,17,40,53,-13,41
Queen of S't,7876,8,9,11,16,45,55,-10,38
Ayr,7876,9,8,12,16,37,56,-19,36
St Mirren,7876,10,8,11,17,38,58,-20,35
Hibernian,7877,1,20,12,4,58,22,36,72
Falkirk,7877,2,18,9,9,60,38,22,63
Morton,7877,3,17,11,8,49,38,11,62
Dundee Utd,7877,4,14,12,10,49,41,8,54
Dunfermline,7877,5,11,12,13,48,49,-1,45
Raith,7877,6,11,10,15,39,47,-8,43
Queen of S't,7877,7,11,10,15,44,53,-9,43
Dumbarton,7877,8,9,10,17,48,60,-12,37
St Mirren,7877,9,7,12,17,38,57,-19,33
Ayr,7877,10,6,14,16,29,57,-28,32
Hibernian,7878,1,20,12,4,56,25,31,72
Morton,7878,2,17,11,8,50,35,15,62
Falkirk,7878,3,16,11,9,58,38,20,59
Dundee Utd,7878,4,15,11,10,50,42,8,56
Dunfermline,7878,5,12,12,12,52,43,9,48
Queen of S't,7878,6,12,9,15,46,49,-3,45
Dumbarton,7878,7,9,10,17,43,58,-15,37
St Mirren,7878,8,9,9,18,44,62,-18,36
Raith,7878,9,9,9,18,32,55,-23,36
Ayr,7878,10,8,12,16,32,56,-24,36
Hibernian,7879,1,17,16,3,50,22,28,67
Morton,7879,2,17,13,6,49,32,17,64
Falkirk,7879,3,17,9,10,65,42,23,60
Dundee Utd,7879,4,16,9,11,53,42,11,57
Queen of S't,7879,5,13,10,13,47,46,1,49
Raith,7879,6,10,9,17,35,50,-15,39
Dunfermline,7879,7,8,14,14,42,50,-8,38
Ayr,7879,8,8,13,15,32,55,-23,37
Dumbarton,7879,9,8,12,16,49,67,-18,36
St Mirren,7879,10,8,11,17,40,56,-16,35
Falkirk,7880,1,19,9,8,62,38,24,66
Morton,7880,2,16,13,7,53,41,12,61
Hibernian,7880,3,16,12,8,55,33,22,60
Dundee Utd,7880,4,17,9,10,55,38,17,60
Ayr,7880,5,11,11,14,39,53,-14,44
Dumbarton,7880,6,9,13,14,44,53,-9,40
Queen of S't,7880,7,10,10,16,41,51,-10,40
St Mirren,7880,8,9,12,15,39,55,-16,39
Raith,7880,9,9,11,16,37,53,-16,38
Dunfermline,7880,10,7,14,15,46,56,-10,35
Hibernian,7881,1,18,11,7,54,30,24,65
Dundee Utd,7881,2,19,8,9,54,34,20,65
Morton,7881,3,17,10,9,51,36,15,61
Queen of S't,7881,4,14,9,13,47,45,2,51
Falkirk,7881,5,13,11,12,53,45,8,50
Raith,7881,6,11,10,15,35,46,-11,43
Dumbarton,7881,7,10,12,14,50,60,-10,42
Dunfermline,7881,8,9,14,13,45,51,-6,41
St Mirren,7881,9,10,10,16,41,51,-10,40
Ayr,7881,10,6,11,19,29,61,-32,29
Hibernian,7882,1,18,13,5,52,27,25,67
Falkirk,7882,2,17,11,8,62,36,26,62
Morton,7882,3,17,9,10,52,35,17,60
Dundee Utd,7882,4,16,11,9,48,37,11,59
Queen of S't,7882,5,12,9,15,45,54,-9,45
Ayr,7882,6,10,12,14,36,54,-18,42
Dunfermline,7882,7,9,14,13,47,55,-8,41
St Mirren,7882,8,9,10,17,41,53,-12,37
Dumbarton,7882,9,8,12,16,45,59,-14,36
Raith,7882,10,9,9,18,35,53,-18,36
Hibernian,7883,1,20,10,6,62,27,35,70
Morton,7883,2,18,12,6,54,35,19,66
Dundee Utd,7883,3,16,10,10,50,37,13,58
Falkirk,7883,4,15,12,9,56,44,12,57
Dumbarton,7883,5,11,12,13,50,56,-6,45
Queen of S't,7883,6,12,9,15,48,56,-8,45
Raith,7883,7,10,10,16,38,51,-13,40
Dunfermline,7883,8,9,11,16,42,50,-8,38
St Mirren,7883,9,8,11,17,41,55,-14,35
Ayr,7883,10,7,11,18,33,63,-30,32
Hibernian,7884,1,18,13,5,54,26,28,67
Morton,7884,2,17,12,7,50,36,14,63
Falkirk,7884,3,16,11,9,57,39,18,59
Dundee Utd,7884,4,16,9,11,53,43,10,57
Dunfermline,7884,5,12,12,12,56,52,4,48
Queen of S't,7884,6,12,9,15,50,55,-5,45
Raith,7884,7,10,11,15,34,48,-14,41
Dumbarton,7884,8,9,11,16,52,63,-11,38
Ayr,7884,9,7,13,16,33,58,-25,34
St Mirren,7884,10,7,11,18,37,56,-19,32
Hibernian,7885,1,18,12,6,55,26,29,66
Dundee Utd,7885,2,17,10,9,52,39,13,61
Morton,7885,3,16,12,8,50,39,11,60
Falkirk,7885,4,15,11,10,54,39,15,56
Dunfermline,7885,5,12,13,11,50,46,4,49
Queen of S't,7885,6,11,11,14,46,50,-4,44
St Mirren,7885,7,9,11,16,44,56,-12,38
Raith,7885,8,9,11,16,32,50,-18,38
Ayr,7885,9,9,11,16,33,54,-21,38
Dumbarton,7885,10,7,12,17,46,63,-17,33
Hibernian,7886,1,20,11,5,62,25,37,71
Dundee Utd,7886,2,18,10,8,56,34,22,64
Morton,7886,3,17,12,7,54,35,19,63
Falkirk,7886,4,16,11,9,59,40,19,59
Queen of S't,7886,5,12,9,15,54,54,0,45
Dumbarton,7886,6,9,12,15,46,60,-14,39
Raith,7886,7,9,12,15,33,48,-15,39
Ayr,7886,8,7,15,14,32,57,-25,36
Dunfermline,7886,9,7,13,16,44,62,-18,34
St Mirren,7886,10,7,11,18,35,60,-25,32
Hibernian,7887,1,19,13,4,63,30,33,70
Dundee Utd,7887,2,16,11,9,57,40,17,59
Morton,7887,3,15,13,8,53,41,12,58
Falkirk,7887,4,15,12,9,55,40,15,57
Dunfermline,7887,5,9,16,11,48,49,-1,43
Raith,7887,6,11,9,16,40,49,-9,42
Queen of S't,7887,7,11,9,16,44,54,-10,42
Dumbarton,7887,8,10,10,16,49,60,-11,40
St Mirren,7887,9,9,11,16,41,62,-21,38
Ayr,7887,10,7,12,17,32,57,-25,33
Hibernian,7888,1,18,12,6,53,28,25,66
Morton,7888,2,16,12,8,50,38,12,60
Falkirk,7888,3,15,13,8,61,41,20,58
Dundee Utd,7888,4,15,10,11,48,39,9,55
Queen of S't,7888,5,14,8,14,46,49,-3,50
Dunfermline,7888,6,9,15,12,43,45,-2,42
Dumbarton,7888,7,10,11,15,52,61,-9,41
St Mirren,7888,8,10,9,17,48,60,-12,39
Ayr,7888,9,9,12,15,33,52,-19,39
Raith,7888,10,8,10,18,32,53,-21,34
Hibernian,7889,1,17,14,5,54,29,25,65
Morton,7889,2,17,13,6,50,35,15,64
Falkirk,7889,3,14,12,10,58,43,15,54
Dundee Utd,7889,4,14,11,11,49,43,6,53
Queen of S't,7889,5,13,10,13,53,50,3,49
Dumbarton,7889,6,10,11,15,53,60,-7,41
Raith,7889,7,10,11,15,35,49,-14,41
Dunfermline,7889,8,9,13,14,46,55,-9,40
Ayr,7889,9,8,13,15,33,53,-20,37
St Mirren,7889,10,8,12,16,41,55,-14,36
Hibernian,7890,1,17,16,3,55,25,30,67
Morton,7890,2,17,12,7,50,32,18,63
Falkirk,7890,3,16,11,9,57,37,20,59
Queen of S't,7890,4,14,8,14,49,51,-2,50
Dundee Utd,7890,5,13,8,15,42,44,-2,47
Dunfermline,7890,6,10,13,13,48,51,-3,43
Ayr,7890,7,10,12,14,36,54,-18,42
Raith,7890,8,10,9,17,35,52,-17,39
Dumbarton,7890,9,9,11,16,50,62,-12,38
St Mirren,7890,10,9,10,17,41,55,-14,37
Hibernian,7891,1,21,11,4,58,20,38,74
Morton,7891,2,18,9,9,50,37,13,63
Dunfermline,7891,3,13,12,11,48,43,5,51
Dundee Utd,7891,4,14,9,13,45,41,4,51
Falkirk,7891,5,13,11,12,54,48,6,50
Queen of S't,7891,6,11,11,14,46,55,-9,44
St Mirren,7891,7,10,9,17,44,57,-13,39
Ayr,7891,8,9,12,15,38,55,-17,39
Raith,7891,9,10,9,17,34,51,-17,39
Dumbarton,7891,10,9,11,16,49,59,-10,38
Hibernian,7892,1,21,11,4,59,27,32,74
Morton,7892,2,17,10,9,59,42,17,61
Dundee Utd,7892,3,16,9,11,54,41,13,57
Falkirk,7892,4,14,12,10,55,44,11,54
Queen of S't,7892,5,12,11,13,46,48,-2,47
Raith,7892,6,12,10,14,39,44,-5,46
Dunfermline,7892,7,9,14,13,46,49,-3,41
Ayr,7892,8,9,10,17,35,61,-26,37
St Mirren,7892,9,8,11,17,38,57,-19,35
Dumbarton,7892,10,8,10,18,43,61,-18,34
Hibernian,7893,1,19,11,6,53,25,28,68
Morton,7893,2,17,12,7,49,32,17,63
Falkirk,7893,3,17,11,8,58,39,19,62
Dundee Utd,7893,4,14,9,13,48,45,3,51
Dunfermline,7893,5,10,15,11,48,44,4,45
Queen of S't,7893,6,11,11,14,49,55,-6,44
St Mirren,7893,7,11,10,15,46,53,-7,43
Raith,7893,8,9,10,17,35,52,-17,37
Dumbarton,7893,9,8,12,16,47,59,-12,36
Ayr,7893,10,8,11,17,32,61,-29,35
Hibernian,7894,1,17,15,4,54,26,28,66
Morton,7894,2,18,12,6,56,32,24,66
Dundee Utd,7894,3,16,10,10,50,40,10,58
Falkirk,7894,4,15,12,9,61,42,19,57
Dunfermline,7894,5,10,15,11,47,46,1,45
Queen of S't,7894,6,11,9,16,43,52,-9,42
Raith,7894,7,10,11,15,35,48,-13,41
Dumbarton,7894,8,8,11,17,44,61,-17,35
St Mirren,7894,9,7,14,15,36,53,-17,35
Ayr,7894,10,8,11,17,34,60,-26,35
Hibernian,7895,1,21,11,4,59,27,32,74
Falkirk,7895,2,16,11,9,61,42,19,59
Morton,7895,3,15,11,10,47,44,3,56
Dundee Utd,7895,4,14,12,10,47,39,8,54
Queen of S't,7895,5,11,9,16,45,52,-7,42
Ayr,7895,6,10,12,14,39,54,-15,42
Raith,7895,7,10,11,15,37,50,-13,41
Dumbarton,7895,8,9,13,14,45,53,-8,40
Dunfermline,7895,9,8,14,14,42,50,-8,38
St Mirren,7895,10,8,12,16,41,52,-11,36
Morton,7896,1,19,10,7,58,34,24,67
Hibernian,7896,2,16,14,6,50,29,21,62
Falkirk,7896,3,16,12,8,59,40,19,60
Dundee Utd,7896,4,15,10,11,46,40,6,55
Queen of S't,7896,5,12,9,15,47,51,-4,45
St Mirren,7896,6,10,11,15,41,53,-12,41
Ayr,7896,7,10,11,15,37,56,-19,41
Dunfermline,7896,8,9,12,15,44,53,-9,39
Raith,7896,9,10,8,18,34,50,-16,38
Dumbarton,7896,10,8,13,15,48,58,-10,37
Hibernian,7897,1,21,12,3,63,23,40,75
Morton,7897,2,17,13,6,50,35,15,64
Falkirk,7897,3,16,12,8,57,37,20,60
Dundee Utd,7897,4,14,12,10,46,35,11,54
Raith,7897,5,11,9,16,35,49,-14,42
Queen of S't,7897,6,10,11,15,43,52,-9,41
Dumbarton,7897,7,9,13,14,51,63,-12,40
Ayr,7897,8,8,13,15,33,51,-18,37
Dunfermline,7897,9,7,14,15,44,57,-13,35
St Mirren,7897,10,7,11,18,37,57,-20,32
Hibernian,7898,1,22,10,4,57,20,37,76
Falkirk,7898,2,16,10,10,57,47,10,58
Morton,7898,3,15,12,9,46,36,10,57
Dundee Utd,7898,4,15,10,11,48,39,9,55
Dunfermline,7898,5,13,11,12,53,44,9,50
Queen of S't,7898,6,10,10,16,43,54,-11,40
St Mirren,7898,7,10,9,17,39,51,-12,39
Ayr,7898,8,9,12,15,33,51,-18,39
Raith,7898,9,9,11,16,33,52,-19,38
Dumbarton,7898,10,7,13,16,44,59,-15,34
Hibernian,7899,1,19,10,7,53,28,25,67
Dundee Utd,7899,2,16,11,9,54,42,12,59
Morton,7899,3,16,11,9,50,40,10,59
Falkirk,7899,4,16,10,10,55,40,15,58
Queen of S't,7899,5,11,12,13,45,49,-4,45
Dumbarton,7899,6,10,13,13,51,56,-5,43
Dunfermline,7899,7,9,14,13,47,49,-2,41
Raith,7899,8,11,8,17,36,46,-10,41
St Mirren,7899,9,10,10,16,42,57,-15,40
Ayr,7899,10,6,13,17,31,57,-26,31
Hibernian,7900,1,18,13,5,54,30,24,67
Morton,7900,2,16,14,6,51,35,16,62
Falkirk,7900,3,17,10,9,58,39,19,61
Dundee Utd,7900,4,16,10,10,52,42,10,58
Dunfermline,7900,5,11,13,12,51,46,5,46
Queen of S't,7900,6,11,9,16,45,52,-7,42
Dumbarton,7900,7,9,12,15,47,58,-11,39
Raith,7900,8,10,9,17,38,54,-16,39
Ayr,7900,9,8,12,16,33,54,-21,36
St Mirren,7900,10,8,10,18,40,59,-19,34
Hibernian,7901,1,19,13,4,54,23,31,70
Dundee Utd,7901,2,17,10,9,56,39,17,61
Falkirk,7901,3,16,10,10,57,42,15,58
Morton,7901,4,15,10,11,48,42,6,55
Dunfermline,7901,5,12,12,12,51,48,3,48
Queen of S't,7901,6,11,10,15,46,52,-6,43
Dumbarton,7901,7,9,12,15,46,58,-12,39
Raith,7901,8,10,9,17,34,48,-14,39
Ayr,7901,9,8,14,14,34,53,-19,38
St Mirren,7901,10,8,10,18,37,58,-21,34
Hibernian,7902,1,20,12,4,59,27,32,72
Morton,7902,2,19,9,8,54,39,15,66
Falkirk,7902,3,16,10,10,58,43,15,58
Queen of S't,7902,4,15,8,13,56,52,4,53
Dundee Utd,7902,5,14,10,12,52,43,9,52
Dunfermline,7902,6,9,13,14,51,52,-1,40
Ayr,7902,7,9,12,15,38,57,-19,39
Dumbarton,7902,8,9,11,16,47,61,-14,38
St Mirren,7902,9,8,11,17,36,53,-17,35
Raith,7902,10,9,8,19,31,55,-24,35
Hibernian,7903,1,19,13,4,54,25,29,70
Falkirk,7903,2,17,11,8,60,41,19,62
Morton,7903,3,17,10,9,48,35,13,61
Dundee Utd,7903,4,16,10,10,47,40,7,58
Dumbarton,7903,5,12,12,12,51,50,1,48
Queen of S't,7903,6,11,10,15,41,47,-6,43
Dunfermline,7903,7,9,12,15,44,48,-4,39
Raith,7903,8,9,10,17,34,52,-18,37
Ayr,7903,9,8,11,17,35,56,-21,35
St Mirren,7903,10,8,9,19,39,59,-20,33
Hibernian,7904,1,21,11,4,60,26,34,74
Morton,7904,2,18,11,7,57,34,23,65
Dundee Utd,7904,3,16,9,11,51,42,9,57
Falkirk,7904,4,14,10,12,53,41,12,52
Queen of S't,7904,5,11,12,13,49,55,-6,45
Dunfermline,7904,6,10,13,13,43,45,-2,43
Raith,7904,7,10,10,16,38,53,-15,40
Ayr,7904,8,9,12,15,34,54,-20,39
Dumbarton,7904,9,8,12,16,45,58,-13,36
St Mirren,7904,10,8,10,18,40,62,-22,34
Hibernian,7905,1,21,11,4,60,27,33,74
Morton,7905,2,17,12,7,50,34,16,63
Falkirk,7905,3,17,11,8,66,43,23,62
Dundee Utd,7905,4,14,10,12,51,47,4,52
Queen of S't,7905,5,13,9,14,48,49,-1,48
Dunfermline,7905,6,9,14,13,47,51,-4,41
Dumbarton,7905,7,9,12,15,46,58,-12,39
St Mirren,7905,8,9,10,17,44,62,-18,37
Raith,7905,9,8,10,18,33,52,-19,34
Ayr,7905,10,6,15,15,30,52,-22,33
Hibernian,7906,1,19,11,6,55,26,29,68
Morton,7906,2,19,11,6,54,32,22,68
Falkirk,7906,3,15,12,9,57,39,18,57
Dundee Utd,7906,4,14,12,10,45,38,7,54
Raith,7906,5,11,12,13,43,47,-4,45
Dunfermline,7906,6,10,13,13,46,49,-3,43
Dumbarton,7906,7,9,14,13,49,57,-8,41
Queen of S't,7906,8,9,9,18,42,56,-14,36
Ayr,7906,9,8,12,16,33,59,-26,36
St Mirren,7906,10,7,12,17,39,60,-21,33
Hibernian,7907,1,20,11,5,54,28,26,71
Morton,7907,2,17,13,6,56,37,19,64
Falkirk,7907,3,17,10,9,61,41,20,61
Dundee Utd,7907,4,14,10,12,48,39,9,52
Queen of S't,7907,5,11,10,15,48,55,-7,43
Dumbarton,7907,6,10,11,15,52,58,-6,41
Raith,7907,7,10,11,15,37,50,-13,41
Dunfermline,7907,8,8,15,13,43,50,-7,39
Ayr,7907,9,8,14,14,35,56,-21,38
St Mirren,7907,10,7,11,18,41,61,-20,32
Hibernian,7908,1,21,10,5,63,25,38,73
Dundee Utd,7908,2,17,11,8,51,34,17,62
Falkirk,7908,3,16,10,10,57,41,16,58
Morton,7908,4,15,11,10,47,45,2,56
Dunfermline,7908,5,10,14,12,48,45,3,44
Queen of S't,7908,6,11,10,15,43,54,-11,43
Dumbarton,7908,7,10,12,14,54,60,-6,42
St Mirren,7908,8,9,11,16,45,59,-14,38
Raith,7908,9,9,8,19,34,55,-21,35
Ayr,7908,10,8,11,17,35,59,-24,35
Hibernian,7909,1,19,12,5,55,26,29,69
Morton,7909,2,18,11,7,54,36,18,65
Dundee Utd,7909,3,16,10,10,52,39,13,58
Falkirk,7909,4,15,10,11,54,43,11,55
Queen of S't,7909,5,12,9,15,46,48,-2,45
Dumbarton,7909,6,11,10,15,48,56,-8,43
Raith,7909,7,10,11,15,37,48,-11,41
Dunfermline,7909,8,9,11,16,41,51,-10,38
St Mirren,7909,9,9,11,16,39,51,-12,38
Ayr,7909,10,8,11,17,36,64,-28,35
Hibernian,7910,1,19,11,6,52,26,26,68
Falkirk,7910,2,16,10,10,60,42,18,58
Dundee Utd,7910,3,15,10,11,52,43,9,55
Morton,7910,4,14,11,11,44,40,4,53
Dunfermline,7910,5,12,13,11,53,49,4,49
Queen of S't,7910,6,12,10,14,46,48,-2,46
Ayr,7910,7,9,13,14,41,56,-15,40
St Mirren,7910,8,9,12,15,42,56,-14,39
Raith,7910,9,10,9,17,37,54,-17,39
Dumbarton,7910,10,7,15,14,50,63,-13,36
Hibernian,7911,1,20,12,4,58,25,33,72
Morton,7911,2,17,10,9,50,35,15,61
Dundee Utd,7911,3,16,11,9,54,37,17,59
Falkirk,7911,4,16,9,11,55,46,9,57
Dunfermline,7911,5,11,12,13,46,46,0,45
Queen of S't,7911,6,11,12,13,43,47,-4,45
Raith,7911,7,11,9,16,36,49,-13,42
Ayr,7911,8,8,14,14,31,52,-21,38
St Mirren,7911,9,8,10,18,39,58,-19,34
Dumbarton,7911,10,7,11,18,42,59,-17,32
Hibernian,7912,1,17,15,4,52,23,29,66
Morton,7912,2,18,11,7,53,37,16,65
Dundee Utd,7912,3,16,11,9,54,43,11,59
Falkirk,7912,4,14,14,8,53,37,16,56
Queen of S't,7912,5,12,10,14,44,50,-6,46
Dunfermline,7912,6,10,14,12,50,46,4,44
Raith,7912,7,11,9,16,33,46,-13,42
Dumbarton,7912,8,10,11,15,49,60,-11,41
Ayr,7912,9,8,11,17,35,57,-22,35
St Mirren,7912,10,6,10,20,37,61,-24,28
Hibernian,7913,1,19,12,5,58,27,31,69
Dundee Utd,7913,2,17,11,8,59,41,18,62
Falkirk,7913,3,16,11,9,59,41,18,59
Morton,7913,4,15,11,10,47,40,7,56
Queen of S't,7913,5,12,9,15,44,50,-6,45
Dumbarton,7913,6,10,12,14,56,58,-2,42
Raith,7913,7,10,11,15,36,47,-11,41
Dunfermline,7913,8,8,15,13,42,49,-7,39
Ayr,7913,9,8,13,15,37,59,-22,37
St Mirren,7913,10,7,11,18,35,61,-26,32
Hibernian,7914,1,20,12,4,53,23,30,72
Morton,7914,2,18,11,7,54,35,19,65
Falkirk,7914,3,15,12,9,57,40,17,57
Dundee Utd,7914,4,13,12,11,49,46,3,51
Dunfermline,7914,5,11,13,12,49,48,1,46
Queen of S't,7914,6,10,13,13,45,50,-5,43
Ayr,7914,7,9,13,14,36,52,-16,40
Dumbarton,7914,8,8,14,14,47,56,-9,38
St Mirren,7914,9,8,10,18,38,56,-18,34
Raith,7914,10,8,10,18,31,53,-22,34
Hibernian,7915,1,19,12,5,55,28,27,69
Morton,7915,2,18,11,7,57,35,22,65
Falkirk,7915,3,15,10,11,59,44,15,55
Dundee Utd,7915,4,13,10,13,44,45,-1,49
Dunfermline,7915,5,11,13,12,45,50,-5,46
Queen of S't,7915,6,12,9,15,46,47,-1,45
St Mirren,7915,7,10,11,15,44,54,-10,41
Dumbarton,7915,8,10,10,16,49,63,-14,40
Raith,7915,9,10,9,17,34,49,-15,39
Ayr,7915,10,9,11,16,35,53,-18,38
Hibernian,7916,1,18,11,7,57,31,26,65
Falkirk,7916,2,18,10,8,63,41,22,64
Dundee Utd,7916,3,17,9,10,51,39,12,60
Morton,7916,4,14,13,9,49,42,7,55
Dunfermline,7916,5,10,14,12,45,46,-1,44
Queen of S't,7916,6,10,12,14,45,50,-5,42
Ayr,7916,7,10,11,15,34,55,-21,41
St Mirren,7916,8,9,11,16,42,52,-10,38
Dumbarton,7916,9,8,13,15,47,59,-12,37
Raith,7916,10,9,10,17,32,50,-18,37
Hibernian,7917,1,20,11,5,59,28,31,71
Dundee Utd,7917,2,19,9,8,59,37,22,66
Morton,7917,3,15,13,8,52,41,11,58
Falkirk,7917,4,13,12,11,54,46,8,51
Dunfermline,7917,5,10,14,12,44,46,-2,44
Raith,7917,6,11,10,15,39,48,-9,43
Queen of S't,7917,7,10,11,15,44,52,-8,41
St Mirren,7917,8,9,11,16,40,55,-15,38
Dumbarton,7917,9,8,12,16,46,58,-12,36
Ayr,7917,10,7,13,16,35,61,-26,34
Morton,7918,1,19,10,7,56,38,18,67
Hibernian,7918,2,17,12,7,53,28,25,63
Falkirk,7918,3,16,10,10,59,39,20,58
Dundee Utd,7918,4,16,9,11,51,40,11,57
Dunfermline,7918,5,12,13,11,47,44,3,49
St Mirren,7918,6,11,10,15,44,55,-11,43
Queen of S't,7918,7,10,10,16,41,51,-10,40
Dumbarton,7918,8,9,11,16,47,59,-12,38
Ayr,7918,9,9,11,16,35,59,-24,38
Raith,7918,10,8,10,18,34,54,-20,34
Hibernian,7919,1,19,14,3,61,23,38,71
Morton,7919,2,18,11,7,57,38,19,65
Falkirk,7919,3,16,11,9,55,40,15,59
Dundee Utd,7919,4,15,10,11,50,43,7,55
Queen of S't,7919,5,13,10,13,50,51,-1,49
Dunfermline,7919,6,10,11,15,45,49,-4,41
Dumbarton,7919,7,9,11,16,50,59,-9,38
Ayr,7919,8,8,13,15,36,57,-21,37
St Mirren,7919,9,8,12,16,37,56,-19,36
Raith,7919,10,8,9,19,32,57,-25,33
Hibernian,7920,1,19,11,6,53,24,29,68
Morton,7920,2,19,10,7,54,30,24,67
Falkirk,7920,3,17,10,9,61,41,20,61
Dundee Utd,7920,4,16,11,9,52,41,11,59
Dunfermline,7920,5,12,11,13,51,48,3,47
Queen of S't,7920,6,11,11,14,42,50,-8,44
St Mirren,7920,7,10,10,16,44,56,-12,40
Raith,7920,8,9,9,18,34,55,-21,36
Ayr,7920,9,7,12,17,30,57,-27,33
Dumbarton,7920,10,7,11,18,44,63,-19,32
Hibernian,7921,1,17,14,5,54,29,25,65
Falkirk,7921,2,17,11,8,61,38,23,62
Dundee Utd,7921,3,16,11,9,49,39,10,59
Morton,7921,4,15,10,11,46,40,6,55
Queen of S't,7921,5,11,12,13,47,52,-5,45
Dunfermline,7921,6,9,16,11,46,48,-2,43
Ayr,7921,7,10,12,14,42,52,-10,42
St Mirren,7921,8,10,11,15,43,55,-12,41
Dumbarton,7921,9,8,12,16,49,64,-15,36
Raith,7921,10,8,9,19,34,54,-20,33
Hibernian,7922,1,19,12,5,63,29,34,69
Morton,7922,2,17,13,6,53,35,18,64
Dundee Utd,7922,3,18,9,9,54,37,17,63
Falkirk,7922,4,17,10,9,66,44,22,61
Queen of S't,7922,5,12,10,14,46,52,-6,46
Dunfermline,7922,6,9,12,15,43,52,-9,39
Raith,7922,7,9,10,17,33,49,-16,37
Dumbarton,7922,8,8,12,16,43,63,-20,36
Ayr,7922,9,7,14,15,33,53,-20,35
St Mirren,7922,10,8,10,18,37,57,-20,34
Hibernian,7923,1,19,10,7,56,30,26,67
Falkirk,7923,2,16,11,9,56,39,17,59
Dundee Utd,7923,3,15,12,9,49,41,8,57
Morton,7923,4,15,12,9,51,45,6,57
Dunfermline,7923,5,11,13,12,51,49,2,46
Queen of S't,7923,6,12,10,14,47,49,-2,46
Dumbarton,7923,7,10,12,14,55,59,-4,42
Raith,7923,8,11,9,16,38,54,-16,42
St Mirren,7923,9,8,10,18,43,57,-14,34
Ayr,7923,10,7,13,16,38,61,-23,34
Hibernian,7924,1,18,12,6,55,27,28,66
Morton,7924,2,17,10,9,51,39,12,61
Falkirk,7924,3,17,9,10,54,44,10,60
Dundee Utd,7924,4,15,11,10,49,41,8,56
Dunfermline,7924,5,12,12,12,48,46,2,48
Queen of S't,7924,6,11,11,14,43,46,-3,44
Dumbarton,7924,7,10,12,14,48,54,-6,42
Raith,7924,8,10,10,16,38,46,-8,40
Ayr,7924,9,9,10,17,34,58,-24,37
St Mirren,7924,10,7,11,18,37,56,-19,32
Morton,7925,1,18,12,6,52,32,20,66
Hibernian,7925,2,17,14,5,51,30,21,65
Dundee Utd,7925,3,18,9,9,55,41,14,63
Falkirk,7925,4,15,12,9,55,37,18,57
Dunfermline,7925,5,10,14,12,44,42,2,44
Queen of S't,7925,6,11,9,16,43,53,-10,42
Raith,7925,7,10,11,15,34,50,-16,41
Ayr,7925,8,9,10,17,37,54,-17,37
Dumbarton,7925,9,8,12,16,49,61,-12,36
St Mirren,7925,10,8,9,19,44,64,-20,33
Hibernian,7926,1,18,13,5,52,25,27,67
Falkirk,7926,2,16,13,7,61,40,21,61
Dundee Utd,7926,3,17,10,9,52,34,18,61
Morton,7926,4,15,13,8,46,37,9,58
Queen of S't,7926,5,11,12,13,45,50,-5,45
Raith,7926,6,10,11,15,35,47,-12,41
Dunfermline,7926,7,9,13,14,45,53,-8,40
St Mirren,7926,8,9,10,17,38,54,-16,37
Dumbarton,7926,9,8,12,16,45,55,-10,36
Ayr,7926,10,8,11,17,32,56,-24,35
Hibernian,7927,1,18,12,6,55,28,27,66
Morton,7927,2,16,14,6,57,41,16,62
Dundee Utd,7927,3,15,11,10,48,38,10,56
Falkirk,7927,4,14,13,9,54,37,17,55
Dunfermline,7927,5,12,13,11,48,45,3,49
Queen of S't,7927,6,11,9,16,41,49,-8,42
Raith,7927,7,11,9,16,37,52,-15,42
Dumbarton,7927,8,9,11,16,45,57,-12,38
St Mirren,7927,9,8,12,16,41,55,-14,36
Ayr,7927,10,8,12,16,33,57,-24,36
Hibernian,7928,1,21,11,4,64,29,35,74
Falkirk,7928,2,16,11,9,59,40,19,59
Morton,7928,3,16,11,9,53,40,13,59
Dundee Utd,7928,4,14,11,11,46,41,5,53
Queen of S't,7928,5,11,10,15,44,50,-6,43
Raith,7928,6,11,9,16,37,52,-15,42
Dumbarton,7928,7,9,13,14,44,53,-9,40
Ayr,7928,8,9,13,14,37,55,-18,40
Dunfermline,7928,9,8,13,15,43,53,-10,37
St Mirren,7928,10,9,10,17,43,57,-14,37
Morton,7929,1,19,12,5,58,37,21,69
Hibernian,7929,2,16,14,6,52,28,24,62
Falkirk,7929,3,15,11,10,53,40,13,56
Dundee Utd,7929,4,15,11,10,50,38,12,56
Dunfermline,7929,5,11,12,13,48,46,2,45
Queen of S't,7929,6,11,10,15,42,51,-9,43
Ayr,7929,7,9,14,13,34,49,-15,41
Dumbarton,7929,8,9,13,14,48,55,-7,40
Raith,7929,9,9,11,16,36,50,-14,38
St Mirren,7929,10,6,12,18,35,62,-27,30
Hibernian,7930,1,21,10,5,60,26,34,73
Dundee Utd,7930,2,18,8,10,54,35,19,62
Morton,7930,3,16,11,9,47,37,10,59
Falkirk,7930,4,14,12,10,59,45,14,54
Queen of S't,7930,5,11,10,15,46,54,-8,43
St Mirren,7930,6,10,11,15,41,54,-13,41
Dunfermline,7930,7,9,13,14,47,53,-6,40
Raith,7930,8,10,9,17,35,51,-16,39
Ayr,7930,9,9,11,16,35,56,-21,38
Dumbarton,7930,10,8,13,15,48,61,-13,37
Hibernian,7931,1,18,13,5,53,26,27,67
Morton,7931,2,18,10,8,53,37,16,64
Dundee Utd,7931,3,17,8,11,51,39,12,59
Falkirk,7931,4,16,10,10,57,42,15,58
Queen of S't,7931,5,13,9,14,45,50,-5,48
Dunfermline,7931,6,11,12,13,48,49,-1,45
Dumbarton,7931,7,9,11,16,48,57,-9,38
Raith,7931,8,10,8,18,37,52,-15,38
Ayr,7931,9,9,11,16,36,56,-20,38
St Mirren,7931,10,8,10,18,38,58,-20,34
Hibernian,7932,1,19,12,5,56,24,32,69
Falkirk,7932,2,19,9,8,66,39,27,66
Morton,7932,3,16,12,8,48,36,12,60
Dundee Utd,7932,4,16,10,10,50,40,10,58
Dunfermline,7932,5,10,13,13,46,46,0,43
Raith,7932,6,11,8,17,33,53,-20,41
Dumbarton,7932,7,9,12,15,46,58,-12,39
Queen of S't,7932,8,10,8,18,42,59,-17,38
St Mirren,7932,9,8,12,16,44,60,-16,36
Ayr,7932,10,8,12,16,39,55,-16,36
Hibernian,7933,1,18,13,5,58,30,28,67
Dundee Utd,7933,2,17,9,10,51,39,12,60
Morton,7933,3,16,12,8,49,37,12,60
Falkirk,7933,4,15,11,10,60,47,13,56
Queen of S't,7933,5,13,9,14,45,47,-2,48
Dumbarton,7933,6,10,14,12,48,52,-4,44
Dunfermline,7933,7,8,15,13,42,47,-5,39
St Mirren,7933,8,9,10,17,42,58,-16,37
Ayr,7933,9,8,13,15,30,51,-21,37
Raith,7933,10,8,10,18,33,50,-17,34
Hibernian,7934,1,19,12,5,58,28,30,69
Morton,7934,2,18,10,8,53,32,21,64
Dundee Utd,7934,3,17,10,9,52,42,10,61
Falkirk,7934,4,14,11,11,56,46,10,53
Dumbarton,7934,5,11,11,14,49,54,-5,44
Queen of S't,7934,6,11,10,15,44,50,-6,43
Dunfermline,7934,7,9,14,13,45,50,-5,41
St Mirren,7934,8,10,10,16,42,57,-15,40
Raith,7934,9,9,10,17,34,51,-17,37
Ayr,7934,10,8,10,18,30,53,-23,34
Hibernian,7935,1,19,13,4,58,28,30,70
Morton,7935,2,16,13,7,49,35,14,61
Dundee Utd,7935,3,16,9,11,46,40,6,57
Falkirk,7935,4,14,11,11,61,47,14,53
Dunfermline,7935,5,10,14,12,43,44,-1,44
Queen of S't,7935,6,11,10,15,42,49,-7,43
Dumbarton,7935,7,10,12,14,51,57,-6,42
Ayr,7935,8,8,14,14,36,50,-14,38
Raith,7935,9,8,14,14,33,48,-15,38
St Mirren,7935,10,7,12,17,41,62,-21,33
Hibernian,7936,1,18,12,6,58,26,32,66
Morton,7936,2,16,10,10,52,45,7,58
Falkirk,7936,3,15,11,10,57,42,15,56
Dundee Utd,7936,4,16,8,12,49,45,4,56
Dunfermline,7936,5,11,14,11,48,46,2,47
Dumbarton,7936,6,12,11,13,55,56,-1,47
Raith,7936,7,11,11,14,37,47,-10,44
Queen of S't,7936,8,11,10,15,47,50,-3,43
St Mirren,7936,9,9,10,17,45,57,-12,37
Ayr,7936,10,6,13,17,30,64,-34,31
Hibernian,7937,1,17,16,3,53,23,30,67
Dundee Utd,7937,2,17,9,10,54,40,14,60
Morton,7937,3,15,11,10,47,41,6,56
Falkirk,7937,4,14,11,11,55,45,10,53
Dunfermline,7937,5,11,14,11,44,40,4,47
Queen of S't,7937,6,13,8,15,50,54,-4,47
Dumbarton,7937,7,10,13,13,51,54,-3,43
Raith,7937,8,10,10,16,35,51,-16,40
St Mirren,7937,9,8,12,16,41,57,-16,36
Ayr,7937,10,7,12,17,34,59,-25,33
Hibernian,7938,1,19,10,7,59,29,30,67
Falkirk,7938,2,17,11,8,57,39,18,62
Morton,7938,3,17,11,8,52,35,17,62
Dundee Utd,7938,4,15,9,12,50,42,8,54
Dunfermline,7938,5,12,13,11,46,45,1,49
Queen of S't,7938,6,11,9,16,40,50,-10,42
Ayr,7938,7,10,12,14,39,56,-17,42
Raith,7938,8,10,10,16,36,49,-13,40
Dumbarton,7938,9,9,10,17,43,54,-11,37
St Mirren,7938,10,6,13,17,33,56,-23,31
Hibernian,7939,1,21,11,4,58,22,36,74
Dundee Utd,7939,2,18,8,10,53,39,14,62
Falkirk,7939,3,17,9,10,60,42,18,60
Morton,7939,4,15,13,8,50,39,11,58
Dunfermline,7939,5,12,12,12,49,45,4,48
Queen of S't,7939,6,12,8,16,44,51,-7,44
Raith,7939,7,10,9,17,35,53,-18,39
St Mirren,7939,8,9,10,17,42,60,-18,37
Dumbarton,7939,9,7,13,16,50,65,-15,34
Ayr,7939,10,7,11,18,34,59,-25,32
Hibernian,7940,1,20,11,5,58,24,34,71
Morton,7940,2,17,10,9,54,38,16,61
Dundee Utd,7940,3,17,8,11,46,38,8,59
Falkirk,7940,4,15,11,10,56,43,13,56
Queen of S't,7940,5,11,11,14,48,51,-3,44
Ayr,7940,6,11,11,14,39,55,-16,44
Dunfermline,7940,7,10,13,13,47,52,-5,43
Raith,7940,8,10,11,15,42,55,-13,41
Dumbarton,7940,9,9,11,16,44,58,-14,38
St Mirren,7940,10,7,9,20,36,56,-20,30
Hibernian,7941,1,19,14,3,57,25,32,71
Falkirk,7941,2,16,10,10,61,43,18,58
Morton,7941,3,15,13,8,49,38,11,58
Dundee Utd,7941,4,16,10,10,49,40,9,58
Dunfermline,7941,5,11,11,14,45,49,-4,44
Ayr,7941,6,11,11,14,39,52,-13,44
Queen of S't,7941,7,10,10,16,45,54,-9,40
St Mirren,7941,8,9,12,15,41,54,-13,39
Dumbarton,7941,9,8,13,15,47,58,-11,37
Raith,7941,10,9,8,19,34,54,-20,35
Morton,7942,1,18,10,8,49,36,13,64
Hibernian,7942,2,17,11,8,53,30,23,62
Falkirk,7942,3,16,9,11,62,43,19,57
Dundee Utd,7942,4,14,12,10,48,38,10,54
Raith,7942,5,14,8,14,37,45,-8,50
Queen of S't,7942,6,13,10,13,47,46,1,49
Dunfermline,7942,7,10,14,12,47,47,0,44
St Mirren,7942,8,10,11,15,42,54,-12,41
Dumbarton,7942,9,7,12,17,47,65,-18,33
Ayr,7942,10,6,13,17,33,61,-28,31
Hibernian,7943,1,19,11,6,54,27,27,68
Morton,7943,2,18,12,6,56,34,22,66
Dundee Utd,7943,3,16,11,9,52,38,14,59
Falkirk,7943,4,14,11,11,61,49,12,53
Queen of S't,7943,5,12,10,14,47,52,-5,46
Dumbarton,7943,6,10,13,13,53,58,-5,43
Dunfermline,7943,7,10,11,15,51,56,-5,41
Raith,7943,8,10,9,17,39,58,-19,39
St Mirren,7943,9,9,10,17,40,56,-16,37
Ayr,7943,10,7,12,17,35,60,-25,33
Hibernian,7944,1,20,12,4,58,25,33,72
Dundee Utd,7944,2,16,10,10,54,42,12,58
Morton,7944,3,14,13,9,51,42,9,55
Falkirk,7944,4,14,12,10,55,43,12,54
Dunfermline,7944,5,10,16,10,51,49,2,46
Queen of S't,7944,6,12,10,14,45,50,-5,46
Dumbarton,7944,7,10,11,15,49,58,-9,41
St Mirren,7944,8,9,11,16,43,57,-14,38
Raith,7944,9,8,12,16,35,51,-16,36
Ayr,7944,10,8,11,17,36,60,-24,35
Hibernian,7945,1,18,13,5,55,27,28,67
Morton,7945,2,18,10,8,49,37,12,64
Dundee Utd,7945,3,16,11,9,49,39,10,59
Falkirk,7945,4,14,10,12,52,41,11,52
Dunfermline,7945,5,11,12,13,49,50,-1,45
Raith,7945,6,11,10,15,41,50,-9,43
St Mirren,7945,7,10,11,15,42,52,-10,41
Dumbarton,7945,8,9,12,15,49,57,-8,39
Queen of S't,7945,9,10,9,17,42,54,-12,39
Ayr,7945,10,7,14,15,32,53,-21,35
Hibernian,7946,1,18,14,4,55,25,30,68
Morton,7946,2,18,12,6,51,33,18,66
Dundee Utd,7946,3,17,9,10,51,38,13,60
Falkirk,7946,4,15,12,9,53,40,13,57
Queen of S't,7946,5,12,9,15,44,49,-5,45
Dunfermline,7946,6,10,12,14,49,53,-4,42
Ayr,7946,7,9,11,16,37,58,-21,38
Raith,7946,8,9,10,17,37,53,-16,37
St Mirren,7946,9,8,12,16,42,56,-14,36
Dumbarton,7946,10,7,13,16,45,59,-14,34
Hibernian,7947,1,19,12,5,56,28,28,69
Dundee Utd,7947,2,17,10,9,54,39,15,61
Morton,7947,3,16,12,8,53,38,15,60
Falkirk,7947,4,16,11,9,58,39,19,59
Queen of S't,7947,5,14,8,14,44,45,-1,50
Dumbarton,7947,6,10,11,15,48,57,-9,41
Raith,7947,7,9,12,15,35,49,-14,39
Dunfermline,7947,8,8,13,15,41,52,-11,37
Ayr,7947,9,8,12,16,31,55,-24,36
St Mirren,7947,10,6,13,17,36,54,-18,31
Hibernian,7948,1,20,11,5,56,26,30,71
Morton,7948,2,18,12,6,50,33,17,66
Falkirk,7948,3,16,11,9,57,40,17,59
Dundee Utd,7948,4,15,10,11,54,40,14,55
Raith,7948,5,11,9,16,36,48,-12,42
Ayr,7948,6,10,12,14,37,53,-16,42
Dunfermline,7948,7,9,13,14,42,46,-4,40
Queen of S't,7948,8,10,9,17,39,53,-14,39
Dumbarton,7948,9,9,12,15,48,63,-15,39
St Mirren,7948,10,7,11,18,42,59,-17,32
Hibernian,7949,1,21,11,4,58,24,34,74
Falkirk,7949,2,17,9,10,63,44,19,60
Dundee Utd,7949,3,17,8,11,52,42,10,59
Morton,7949,4,14,13,9,46,36,10,55
Dunfermline,7949,5,10,13,13,50,52,-2,43
Raith,7949,6,11,10,15,37,48,-11,43
Queen of S't,7949,7,11,8,17,50,53,-3,41
Dumbarton,7949,8,9,11,16,48,61,-13,38
Ayr,7949,9,9,11,16,33,59,-26,38
St Mirren,7949,10,9,10,17,37,55,-18,37
Hibernian,7950,1,19,10,7,56,29,27,67
Falkirk,7950,2,17,10,9,62,42,20,61
Morton,7950,3,16,11,9,51,39,12,59
Dundee Utd,7950,4,15,8,13,52,45,7,53
Dumbarton,7950,5,11,11,14,54,60,-6,44
Ayr,7950,6,10,13,13,41,54,-13,43
Dunfermline,7950,7,10,12,14,48,52,-4,42
Raith,7950,8,11,9,16,43,54,-11,42
Queen of S't,7950,9,11,8,17,46,58,-12,41
St Mirren,7950,10,9,10,17,37,57,-20,37
Hibernian,7951,1,17,13,6,55,29,26,64
Morton,7951,2,17,13,6,57,39,18,64
Falkirk,7951,3,15,11,10,59,43,16,56
Dundee Utd,7951,4,14,11,11,49,44,5,53
Queen of S't,7951,5,13,9,14,50,50,0,48
Dunfermline,7951,6,11,11,14,49,52,-3,44
Raith,7951,7,10,11,15,37,47,-10,41
Dumbarton,7951,8,9,13,14,51,59,-8,40
St Mirren,7951,9,8,12,16,37,54,-17,36
Ayr,7951,10,8,12,16,32,59,-27,36
Hibernian,7952,1,21,11,4,55,22,33,74
Morton,7952,2,18,11,7,56,35,21,65
Falkirk,7952,3,16,11,9,61,43,18,59
Dundee Utd,7952,4,16,11,9,54,38,16,59
Queen of S't,7952,5,11,11,14,49,50,-1,44
St Mirren,7952,6,10,9,17,42,54,-12,39
Raith,7952,7,10,9,17,37,55,-18,39
Dumbarton,7952,8,8,12,16,46,62,-16,36
Dunfermline,7952,9,7,15,14,40,59,-19,36
Ayr,7952,10,7,12,17,35,57,-22,33
Hibernian,7953,1,19,13,4,56,24,32,70
Morton,7953,2,18,10,8,53,35,18,64
Dundee Utd,7953,3,18,9,9,49,35,14,63
Falkirk,7953,4,15,13,8,60,41,19,58
Dunfermline,7953,5,9,14,13,46,50,-4,41
Dumbarton,7953,6,10,10,16,49,61,-12,40
Raith,7953,7,10,9,17,37,53,-16,39
St Mirren,7953,8,9,11,16,44,53,-9,38
Queen of S't,7953,9,9,9,18,41,57,-16,36
Ayr,7953,10,8,12,16,31,57,-26,36
Hibernian,7954,1,19,11,6,55,30,25,68
Morton,7954,2,17,13,6,51,34,17,64
Dundee Utd,7954,3,16,9,11,47,37,10,57
Falkirk,7954,4,15,11,10,53,39,14,56
Raith,7954,5,12,10,14,37,45,-8,46
Queen of S't,7954,6,12,9,15,43,48,-5,45
Ayr,7954,7,9,13,14,37,53,-16,40
Dunfermline,7954,8,7,15,14,39,48,-9,36
Dumbarton,7954,9,8,12,16,45,60,-15,36
St Mirren,7954,10,8,11,17,45,58,-13,35
Hibernian,7955,1,20,11,5,58,27,31,71
Morton,7955,2,17,12,7,50,35,15,63
Falkirk,7955,3,16,12,8,58,40,18,60
Dundee Utd,7955,4,16,10,10,52,40,12,58
Queen of S't,7955,5,12,8,16,45,51,-6,44
Dunfermline,7955,6,8,16,12,43,47,-4,40
Dumbarton,7955,7,9,13,14,49,60,-11,40
Raith,7955,8,10,8,18,35,49,-14,38
Ayr,7955,9,9,11,16,31,56,-25,38
St Mirren,7955,10,7,11,18,41,57,-16,32
Hibernian,7956,1,20,13,3,60,27,33,73
Morton,7956,2,15,12,9,46,37,9,57
Falkirk,7956,3,15,11,10,53,37,16,56
Dundee Utd,7956,4,15,10,11,50,40,10,55
Queen of S't,7956,5,13,10,13,46,47,-1,49
Ayr,7956,6,10,12,14,35,52,-17,42
Dunfermline,7956,7,8,15,13,45,50,-5,39
Dumbarton,7956,8,9,12,15,47,60,-13,39
Raith,7956,9,9,12,15,36,49,-13,39
St Mirren,7956,10,7,11,18,35,54,-19,32
Hibernian,7957,1,18,11,7,56,29,27,65
Falkirk,7957,2,17,11,8,57,38,19,62
Dundee Utd,7957,3,17,10,9,54,42,12,61
Morton,7957,4,16,11,9,54,38,16,59
Dunfermline,7957,5,12,13,11,52,46,6,49
Queen of S't,7957,6,11,9,16,42,53,-11,42
Raith,7957,7,10,10,16,36,49,-13,40
Dumbarton,7957,8,8,13,15,48,60,-12,37
St Mirren,7957,9,9,10,17,41,57,-16,37
Ayr,7957,10,7,12,17,32,60,-28,33
Hibernian,7958,1,23,10,3,59,21,38,79
Dundee Utd,7958,2,17,11,8,50,33,17,62
Morton,7958,3,17,9,10,45,37,8,60
Falkirk,7958,4,14,11,11,55,43,12,53
Dumbarton,7958,5,11,10,15,50,56,-6,43
Raith,7958,6,11,9,16,35,49,-14,42
Queen of S't,7958,7,10,11,15,44,53,-9,41
Dunfermline,7958,8,9,12,15,42,48,-6,39
Ayr,7958,9,8,11,17,29,51,-22,35
St Mirren,7958,10,8,10,18,36,54,-18,34
Morton,7959,1,18,11,7,53,34,19,65
Hibernian,7959,2,17,12,7,52,27,25,63
Falkirk,7959,3,15,13,8,53,37,16,58
Dundee Utd,7959,4,16,9,11,53,43,10,57
Queen of S't,7959,5,14,9,13,45,45,0,51
Dunfermline,7959,6,9,13,14,45,54,-9,40
Dumbarton,7959,7,9,12,15,48,60,-12,39
Ayr,7959,8,9,11,16,35,53,-18,38
St Mirren,7959,9,9,10,17,41,56,-15,37
Raith,7959,10,9,10,17,35,51,-16,37
Hibernian,7960,1,20,11,5,53,26,27,71
Dundee Utd,7960,2,18,9,9,53,35,18,63
Falkirk,7960,3,16,11,9,59,37,22,59
Morton,7960,4,15,12,9,45,35,10,57
Queen of S't,7960,5,12,8,16,50,59,-9,44
Dumbarton,7960,6,10,12,14,53,57,-4,42
St Mirren,7960,7,9,11,16,42,54,-12,38
Dunfermline,7960,8,9,11,16,43,56,-13,38
Raith,7960,9,9,10,17,32,51,-19,37
Ayr,7960,10,7,15,14,33,53,-20,36
Hibernian,7961,1,19,12,5,58,30,28,69
Morton,7961,2,15,13,8,51,41,10,58
Dundee Utd,7961,3,16,9,11,47,39,8,57
Falkirk,7961,4,15,10,11,54,41,13,55
Dunfermline,7961,5,13,12,11,49,42,7,51
Raith,7961,6,11,10,15,36,45,-9,43
Dumbarton,7961,7,10,10,16,46,57,-11,40
Ayr,7961,8,9,11,16,37,57,-20,38
Queen of S't,7961,9,9,10,17,42,55,-13,37
St Mirren,7961,9,8,13,15,42,55,-13,37
Falkirk,7962,1,17,12,7,62,38,24,63
Hibernian,7962,2,16,13,7,51,29,22,61
Dundee Utd,7962,3,17,10,9,51,37,14,61
Morton,7962,4,17,10,9,48,34,14,61
Dumbarton,7962,5,11,10,15,51,58,-7,43
Queen of S't,7962,6,11,9,16,47,54,-7,42
Dunfermline,7962,7,9,14,13,44,49,-5,41
Ayr,7962,8,10,11,15,34,55,-21,41
St Mirren,7962,9,9,11,16,42,56,-14,38
Raith,7962,10,8,10,18,32,52,-20,34
Hibernian,7963,1,18,13,5,50,27,23,67
Falkirk,7963,2,16,12,8,58,39,19,60
Morton,7963,3,16,11,9,49,37,12,59
Dundee Utd,7963,4,16,10,10,50,41,9,58
Dunfermline,7963,5,11,13,12,45,44,1,46
Queen of S't,7963,6,11,11,14,40,45,-5,44
Ayr,7963,7,8,15,13,42,55,-13,39
Raith,7963,8,10,9,17,34,49,-15,39
Dumbarton,7963,9,8,11,17,51,65,-14,35
St Mirren,7963,10,8,11,17,43,60,-17,35
Hibernian,7964,1,20,10,6,61,28,33,70
Morton,7964,2,19,11,6,53,31,22,68
Dundee Utd,7964,3,17,9,10,49,36,13,60
Falkirk,7964,4,14,11,11,58,45,13,53
Queen of S't,7964,5,14,8,14,45,50,-5,50
Dunfermline,7964,6,10,12,14,43,54,-11,42
Ayr,7964,7,10,11,15,37,53,-16,41
Raith,7964,8,10,9,17,38,53,-15,39
St Mirren,7964,9,8,10,18,45,62,-17,34
Dumbarton,7964,10,7,11,18,48,65,-17,32
Hibernian,7965,1,18,13,5,52,24,28,67
Morton,7965,2,16,13,7,50,35,15,61
Dundee Utd,7965,3,17,9,10,53,43,10,60
Falkirk,7965,4,14,12,10,56,44,12,54
Queen of S't,7965,5,13,10,13,45,46,-1,49
Raith,7965,6,11,9,16,33,47,-14,42
Dunfermline,7965,7,9,14,13,45,48,-3,41
Ayr,7965,8,8,14,14,32,50,-18,38
St Mirren,7965,9,9,9,18,38,55,-17,36
Dumbarton,7965,10,8,11,17,50,62,-12,35
Hibernian,7966,1,17,12,7,52,27,25,63
Morton,7966,2,16,14,6,48,36,12,62
Dundee Utd,7966,3,15,13,8,51,39,12,58
Falkirk,7966,4,15,11,10,58,44,14,56
Dunfermline,7966,5,10,14,12,51,48,3,44
Queen of S't,7966,6,11,10,15,49,59,-10,43
Ayr,7966,7,9,13,14,38,51,-13,40
Raith,7966,8,10,10,16,35,51,-16,40
St Mirren,7966,9,8,13,15,41,52,-11,37
Dumbarton,7966,10,9,10,17,49,65,-16,37
Hibernian,7967,1,18,12,6,55,28,27,66
Morton,7967,2,17,10,9,54,44,10,61
Falkirk,7967,3,15,12,9,58,41,17,57
Dundee Utd,7967,4,15,10,11,48,38,10,55
Dunfermline,7967,5,10,15,11,48,46,2,45
St Mirren,7967,6,11,10,15,45,51,-6,43
Queen of S't,7967,7,11,10,15,42,51,-9,43
Raith,7967,8,10,10,16,36,50,-14,40
Ayr,7967,9,9,11,16,33,55,-22,38
Dumbarton,7967,10,8,12,16,47,62,-15,36
Hibernian,7968,1,18,14,4,53,27,26,68
Falkirk,7968,2,18,10,8,61,38,23,64
Morton,7968,3,17,11,8,50,37,13,62
Dundee Utd,7968,4,16,8,12,52,44,8,56
Dunfermline,7968,5,12,13,11,47,44,3,49
Queen of S't,7968,6,12,9,15,46,52,-6,45
Raith,7968,7,10,9,17,36,49,-13,39
Dumbarton,7968,8,9,11,16,51,59,-8,38
St Mirren,7968,9,8,9,19,36,58,-22,33
Ayr,7968,10,6,14,16,34,58,-24,32
Hibernian,7969,1,20,12,4,62,26,36,72
Morton,7969,2,18,12,6,55,36,19,66
Falkirk,7969,3,18,10,8,65,39,26,64
Dundee Utd,7969,4,15,11,10,51,40,11,56
Dunfermline,7969,5,10,15,11,49,48,1,45
Queen of S't,7969,6,10,9,17,44,53,-9,39
Raith,7969,7,10,8,18,35,56,-21,38
St Mirren,7969,8,8,11,17,41,63,-22,35
Dumbarton,7969,9,7,13,16,47,64,-17,34
Ayr,7969,10,7,13,16,34,58,-24,34
Hibernian,7970,1,20,10,6,57,28,29,70
Morton,7970,2,17,11,8,48,35,13,62
Falkirk,7970,3,16,10,10,58,42,16,58
Dundee Utd,7970,4,14,11,11,51,45,6,53
Queen of S't,7970,5,13,9,14,48,52,-4,48
Dunfermline,7970,6,10,13,13,43,47,-4,43
Dumbarton,7970,7,10,10,16,50,56,-6,40
Raith,7970,8,10,9,17,38,53,-15,39
Ayr,7970,9,9,11,16,35,55,-20,38
St Mirren,7970,10,8,12,16,42,57,-15,36
Hibernian,7971,1,18,12,6,53,29,24,66
Morton,7971,2,17,13,6,56,35,21,64
Dundee Utd,7971,3,15,12,9,51,39,12,57
Falkirk,7971,4,15,10,11,55,46,9,55
Queen of S't,7971,5,11,12,13,46,48,-2,45
Dunfermline,7971,6,10,13,13,54,56,-2,43
Ayr,7971,7,10,13,13,38,52,-14,43
Raith,7971,8,10,9,17,36,50,-14,39
Dumbarton,7971,9,9,11,16,52,64,-12,38
St Mirren,7971,10,8,9,19,37,59,-22,33
Hibernian,7972,1,18,14,4,52,23,29,68
Dundee Utd,7972,2,17,10,9,53,38,15,61
Morton,7972,3,16,12,8,51,37,14,60
Falkirk,7972,4,16,10,10,56,40,16,58
Queen of S't,7972,5,12,11,13,43,45,-2,47
Raith,7972,6,12,8,16,36,47,-11,44
St Mirren,7972,7,9,11,16,44,55,-11,38
Dumbarton,7972,8,9,11,16,48,64,-16,38
Dunfermline,7972,9,8,12,16,41,49,-8,36
Ayr,7972,10,8,11,17,32,58,-26,35
Hibernian,7973,1,21,11,4,59,26,33,74
Dundee Utd,7973,2,18,8,10,51,38,13,62
Falkirk,7973,3,16,11,9,58,38,20,59
Morton,7973,4,15,14,7,49,37,12,59
Dunfermline,7973,5,10,14,12,44,43,1,44
Dumbarton,7973,6,9,13,14,47,53,-6,40
Queen of S't,7973,7,10,8,18,39,53,-14,38
Raith,7973,8,9,11,16,34,50,-16,38
St Mirren,7973,9,8,11,17,39,56,-17,35
Ayr,7973,10,8,11,17,29,55,-26,35
Hibernian,7974,1,17,13,6,58,30,28,64
Falkirk,7974,2,18,10,8,62,42,20,64
Morton,7974,3,16,12,8,49,36,13,60
Dundee Utd,7974,4,13,9,14,42,45,-3,48
Queen of S't,7974,5,13,8,15,46,54,-8,47
Dunfermline,7974,6,11,12,13,49,48,1,45
Raith,7974,7,12,9,15,42,54,-12,45
Ayr,7974,8,11,10,15,39,52,-13,43
Dumbarton,7974,9,8,12,16,48,60,-12,36
St Mirren,7974,10,7,13,16,42,56,-14,34
Hibernian,7975,1,17,13,6,51,27,24,64
Falkirk,7975,2,18,9,9,60,38,22,63
Morton,7975,3,15,15,6,46,32,14,60
Dundee Utd,7975,4,16,10,10,48,37,11,58
Queen of S't,7975,5,11,9,16,49,61,-12,42
Dumbarton,7975,6,9,13,14,50,59,-9,40
Raith,7975,7,10,10,16,37,49,-12,40
Dunfermline,7975,8,8,15,13,41,46,-5,39
St Mirren,7975,9,9,12,15,42,52,-10,39
Ayr,7975,10,7,14,15,33,56,-23,35
Hibernian,7976,1,20,11,5,60,27,33,71
Morton,7976,2,16,10,10,47,39,8,58
Falkirk,7976,3,15,10,11,58,42,16,55
Dundee Utd,7976,4,15,10,11,47,37,10,55
Queen of S't,7976,5,12,10,14,48,54,-6,46
Dunfermline,7976,6,11,12,13,44,45,-1,45
Raith,7976,7,11,10,15,36,49,-13,43
Dumbarton,7976,8,10,11,15,46,56,-10,41
Ayr,7976,9,8,13,15,36,56,-20,37
St Mirren,7976,10,8,11,17,34,51,-17,35
Hibernian,7977,1,19,12,5,51,23,28,69
Morton,7977,2,16,12,8,50,39,11,60
Dundee Utd,7977,3,16,10,10,51,40,11,58
Falkirk,7977,4,16,9,11,58,43,15,57
Queen of S't,7977,5,12,10,14,44,49,-5,46
Dunfermline,7977,6,10,15,11,47,48,-1,45
Ayr,7977,7,9,13,14,37,52,-15,40
Raith,7977,8,10,9,17,35,50,-15,39
Dumbarton,7977,9,9,11,16,52,63,-11,38
St Mirren,7977,10,7,11,18,37,55,-18,32
Morton,7978,1,18,12,6,51,37,14,66
Hibernian,7978,2,18,11,7,55,29,26,65
Dundee Utd,7978,3,16,12,8,52,36,16,60
Falkirk,7978,4,15,11,10,61,47,14,56
Queen of S't,7978,5,12,11,13,48,48,0,47
Dunfermline,7978,6,10,13,13,49,48,1,43
St Mirren,7978,7,8,13,15,43,53,-10,37
Dumbarton,7978,8,8,12,16,45,63,-18,36
Ayr,7978,9,8,12,16,35,53,-18,36
Raith,7978,10,9,9,18,33,58,-25,36
Hibernian,7979,1,20,11,5,58,29,29,71
Dundee Utd,7979,2,17,9,10,51,39,12,60
Morton,7979,3,16,11,9,49,38,11,59
Falkirk,7979,4,16,10,10,56,40,16,58
Queen of S't,7979,5,13,10,13,47,49,-2,49
Dunfermline,7979,6,10,13,13,47,45,2,43
Dumbarton,7979,7,9,11,16,47,58,-11,38
Raith,7979,8,10,8,18,35,51,-16,38
St Mirren,7979,9,9,9,18,39,58,-19,36
Ayr,7979,10,8,12,16,34,56,-22,36
Hibernian,7980,1,20,11,5,55,26,29,71
Falkirk,7980,2,15,13,8,60,42,18,58
Dundee Utd,7980,3,15,11,10,49,39,10,56
Morton,7980,4,14,11,11,45,40,5,53
Raith,7980,5,12,10,14,38,45,-7,46
Dunfermline,7980,6,10,14,12,49,51,-2,44
Queen of S't,7980,7,10,12,14,43,49,-6,42
Dumbarton,7980,8,10,11,15,50,58,-8,41
St Mirren,7980,9,10,10,16,43,55,-12,40
Ayr,7980,10,7,11,18,29,56,-27,32
Hibernian,7981,1,18,13,5,57,30,27,67
Dundee Utd,7981,2,18,9,9,57,38,19,63
Falkirk,7981,3,16,11,9,58,43,15,59
Morton,7981,4,15,10,11,47,43,4,55
Dunfermline,7981,5,10,13,13,44,46,-2,43
Dumbarton,7981,6,11,10,15,51,60,-9,43
Ayr,7981,7,10,13,13,41,53,-12,43
Queen of S't,7981,8,10,11,15,47,52,-5,41
Raith,7981,9,10,9,17,37,50,-13,39
St Mirren,7981,10,7,11,18,40,64,-24,32
Hibernian,7982,1,19,11,6,55,26,29,68
Morton,7982,2,17,10,9,48,34,14,61
Falkirk,7982,3,15,12,9,59,45,14,57
Dundee Utd,7982,4,15,8,13,55,47,8,53
Dunfermline,7982,5,12,14,10,48,42,6,50
Queen of S't,7982,6,11,11,14,48,53,-5,44
Raith,7982,7,10,11,15,35,48,-13,41
Ayr,7982,8,10,11,15,37,56,-19,41
Dumbarton,7982,9,10,10,16,51,63,-12,40
St Mirren,7982,10,7,10,19,42,64,-22,31
Morton,7983,1,17,14,5,51,34,17,65
Hibernian,7983,2,17,13,6,51,27,24,64
Falkirk,7983,3,16,11,9,56,39,17,59
Dundee Utd,7983,4,16,10,10,49,38,11,58
Dunfermline,7983,5,10,13,13,48,50,-2,43
Dumbarton,7983,6,10,12,14,51,56,-5,42
Queen of S't,7983,7,11,9,16,42,50,-8,42
Raith,7983,8,9,13,14,36,49,-13,40
St Mirren,7983,9,8,11,17,40,58,-18,35
Ayr,7983,10,7,12,17,29,52,-23,33
Hibernian,7984,1,19,11,6,53,23,30,68
Falkirk,7984,2,17,10,9,60,43,17,61
Morton,7984,3,16,12,8,48,35,13,60
Dundee Utd,7984,4,16,11,9,52,41,11,59
Dumbarton,7984,5,11,12,13,55,57,-2,45
Queen of S't,7984,6,12,8,16,49,53,-4,44
Ayr,7984,7,10,11,15,39,58,-19,41
Raith,7984,8,10,9,17,37,56,-19,39
Dunfermline,7984,9,8,13,15,40,49,-9,37
St Mirren,7984,10,7,11,18,43,61,-18,32
Hibernian,7985,1,18,11,7,55,29,26,65
Morton,7985,2,15,13,8,46,37,9,58
Falkirk,7985,3,14,12,10,55,41,14,54
Dundee Utd,7985,4,14,11,11,48,40,8,53
Dunfermline,7985,5,11,13,12,45,45,0,46
Queen of S't,7985,6,12,10,14,48,49,-1,46
Raith,7985,7,11,10,15,40,49,-9,43
Ayr,7985,8,10,11,15,36,55,-19,41
Dumbarton,7985,9,9,12,15,47,61,-14,39
St Mirren,7985,10,9,11,16,43,57,-14,38
Hibernian,7986,1,19,12,5,56,32,24,69
Dundee Utd,7986,2,18,8,10,49,38,11,62
Morton,7986,3,15,12,9,51,39,12,57
Falkirk,7986,4,15,11,10,56,39,17,56
Queen of S't,7986,5,11,11,14,41,47,-6,44
Raith,7986,6,11,10,15,37,46,-9,43
Dunfermline,7986,7,9,15,12,51,48,3,42
St Mirren,7986,8,11,9,16,44,57,-13,42
Ayr,7986,9,8,12,16,32,56,-24,36
Dumbarton,7986,10,7,12,17,43,58,-15,33
Hibernian,7987,1,18,14,4,59,27,32,68
Dundee Utd,7987,2,16,10,10,46,38,8,58
Morton,7987,3,14,15,7,49,40,9,57
Falkirk,7987,4,14,11,11,52,43,9,53
Dunfermline,7987,5,12,13,11,49,42,7,49
Queen of S't,7987,6,11,10,15,45,50,-5,43
Raith,7987,7,9,12,15,33,47,-14,39
Dumbarton,7987,8,9,11,16,49,60,-11,38
St Mirren,7987,9,9,11,16,43,59,-16,38
Ayr,7987,10,7,15,14,36,55,-19,36
Hibernian,7988,1,20,12,4,59,27,32,72
Dundee Utd,7988,2,18,10,8,54,40,14,64
Morton,7988,3,17,9,10,55,40,15,60
Falkirk,7988,4,14,11,11,55,44,11,53
Dunfermline,7988,5,10,13,13,46,52,-6,43
Raith,7988,6,11,10,15,38,47,-9,43
Dumbarton,7988,7,9,13,14,50,58,-8,40
Queen of S't,7988,8,10,9,17,44,54,-10,39
St Mirren,7988,9,9,10,17,39,55,-16,37
Ayr,7988,10,8,11,17,35,58,-23,35
Hibernian,7989,1,19,14,3,56,26,30,71
Dundee Utd,7989,2,16,11,9,50,38,12,59
Morton,7989,3,15,13,8,49,38,11,58
Falkirk,7989,4,14,10,12,56,49,7,52
Queen of S't,7989,5,13,8,15,49,50,-1,47
Raith,7989,6,11,11,14,38,47,-9,44
Dunfermline,7989,7,10,13,13,48,50,-2,43
St Mirren,7989,8,9,10,17,40,55,-15,37
Ayr,7989,9,8,13,15,36,51,-15,37
Dumbarton,7989,10,8,11,17,43,61,-18,35
Hibernian,7990,1,20,10,6,64,28,36,70
Morton,7990,2,16,11,9,51,44,7,59
Falkirk,7990,3,14,11,11,56,49,7,53
Dundee Utd,7990,4,15,8,13,52,45,7,53
Queen of S't,7990,5,14,9,13,52,47,5,51
Ayr,7990,6,11,10,15,41,58,-17,43
Dunfermline,7990,7,9,14,13,44,51,-7,41
St Mirren,7990,8,10,11,15,43,55,-12,41
Raith,7990,9,9,11,16,34,49,-15,38
Dumbarton,7990,10,8,13,15,48,59,-11,37
Hibernian,7991,1,20,12,4,55,22,33,72
Morton,7991,2,17,13,6,45,30,15,64
Falkirk,7991,3,15,12,9,53,38,15,57
Dundee Utd,7991,4,15,9,12,49,38,11,54
Queen of S't,7991,5,12,11,13,43,45,-2,47
Dunfermline,7991,6,9,12,15,42,51,-9,39
Dumbarton,7991,7,9,12,15,48,59,-11,39
Raith,7991,8,10,9,17,35,53,-18,39
St Mirren,7991,9,9,10,17,46,57,-11,37
Ayr,7991,10,7,14,15,35,58,-23,35
Hibernian,7992,1,20,11,5,57,24,33,71
Falkirk,7992,2,18,10,8,63,41,22,64
Morton,7992,3,16,12,8,51,38,13,60
Dundee Utd,7992,4,16,9,11,51,40,11,57
Queen of S't,7992,5,13,9,14,49,51,-2,48
Dumbarton,7992,6,10,12,14,46,52,-6,42
Dunfermline,7992,7,9,13,14,48,55,-7,40
Raith,7992,8,9,10,17,36,54,-18,37
Ayr,7992,9,7,13,16,32,57,-25,34
St Mirren,7992,10,6,13,17,36,57,-21,31
Hibernian,7993,1,21,11,4,58,25,33,74
Falkirk,7993,2,17,9,10,58,41,17,60
Morton,7993,3,15,11,10,45,38,7,56
Ayr,7993,4,13,10,13,40,49,-9,49
Dundee Utd,7993,5,12,11,13,44,47,-3,47
Queen of S't,7993,6,12,10,14,44,48,-4,46
Dunfermline,7993,7,11,12,13,48,45,3,45
Raith,7993,8,9,11,16,37,55,-18,38
Dumbarton,7993,9,8,12,16,46,59,-13,36
St Mirren,7993,10,8,11,17,45,58,-13,35
Hibernian,7994,1,20,11,5,56,24,32,71
Morton,7994,2,19,11,6,52,34,18,68
Dundee Utd,7994,3,17,8,11,55,44,11,59
Falkirk,7994,4,15,11,10,59,43,16,56
Dumbarton,7994,5,10,12,14,53,57,-4,42
Raith,7994,6,10,11,15,36,48,-12,41
Dunfermline,7994,7,9,12,15,39,45,-6,39
Queen of S't,7994,8,10,9,17,40,54,-14,39
Ayr,7994,9,9,11,16,38,59,-21,38
St Mirren,7994,10,8,10,18,42,62,-20,34
Hibernian,7995,1,19,12,5,56,28,28,69
Morton,7995,2,18,10,8,54,37,17,64
Dundee Utd,7995,3,16,9,11,49,40,9,57
Falkirk,7995,4,15,11,10,56,41,15,56
Dunfermline,7995,5,11,11,14,44,46,-2,44
Queen of S't,7995,6,11,11,14,45,52,-7,44
Dumbarton,7995,7,10,12,14,49,57,-8,42
Raith,7995,8,10,10,16,32,46,-14,40
Ayr,7995,9,7,15,14,31,52,-21,36
St Mirren,7995,10,8,9,19,42,59,-17,33
Hibernian,7996,1,19,12,5,53,24,29,69
Falkirk,7996,2,18,10,8,57,36,21,64
Morton,7996,3,16,12,8,46,32,14,60
Dundee Utd,7996,4,16,11,9,52,39,13,59
Dunfermline,7996,5,11,14,11,44,44,0,47
Queen of S't,7996,6,11,9,16,44,54,-10,42
Raith,7996,7,9,10,17,37,54,-17,37
Dumbarton,7996,8,7,14,15,43,54,-11,35
St Mirren,7996,9,7,13,16,37,55,-18,34
Ayr,7996,10,7,13,16,33,54,-21,34
Hibernian,7997,1,20,12,4,59,23,36,72
Morton,7997,2,17,12,7,54,41,13,63
Falkirk,7997,3,16,11,9,60,43,17,59
Dundee Utd,7997,4,14,12,10,45,42,3,54
Queen of S't,7997,5,13,9,14,51,48,3,48
Dumbarton,7997,6,9,12,15,46,58,-12,39
Dunfermline,7997,7,8,14,14,46,53,-7,38
Raith,7997,8,9,11,16,34,51,-17,38
St Mirren,7997,9,9,10,17,44,57,-13,37
Ayr,7997,10,7,13,16,33,56,-23,34
Dundee Utd,7998,1,18,9,9,50,37,13,63
Falkirk,7998,2,17,10,9,65,41,24,61
Hibernian,7998,3,16,13,7,53,32,21,61
Morton,7998,4,16,13,7,51,36,15,61
Raith,7998,5,13,9,14,45,45,0,48
Dumbarton,7998,6,11,10,15,49,59,-10,43
Queen of S't,7998,7,11,8,17,42,53,-11,41
Dunfermline,7998,8,9,11,16,41,52,-11,38
St Mirren,7998,9,9,11,16,46,62,-16,38
Ayr,7998,10,7,12,17,35,60,-25,33
Hibernian,7999,1,22,11,3,62,26,36,77
Dundee Utd,7999,2,15,13,8,54,41,13,58
Falkirk,7999,3,15,11,10,55,39,16,56
Morton,7999,4,14,13,9,45,39,6,55
Queen of S't,7999,5,12,11,13,47,49,-2,47
Dumbarton,7999,6,11,11,14,51,56,-5,44
Dunfermline,7999,7,9,14,13,49,51,-2,41
Raith,7999,8,11,8,17,36,52,-16,41
St Mirren,7999,9,7,11,18,39,57,-18,32
Ayr,7999,10,7,11,18,31,59,-28,32
Hibernian,8000,1,18,12,6,51,25,26,66
Morton,8000,2,19,9,8,51,35,16,66
Falkirk,8000,3,17,10,9,59,41,18,61
Dundee Utd,8000,4,16,9,11,56,44,12,57
Queen of S't,8000,5,14,8,14,48,47,1,50
Dunfermline,8000,6,10,12,14,46,50,-4,42
Dumbarton,8000,7,10,10,16,50,62,-12,40
Raith,8000,8,9,10,17,32,49,-17,37
St Mirren,8000,9,8,12,16,38,52,-14,36
Ayr,8000,10,7,12,17,32,58,-26,33
Hibernian,8001,1,20,11,5,56,24,32,71
Morton,8001,2,17,11,8,49,36,13,62
Falkirk,8001,3,16,12,8,60,41,19,60
Dundee Utd,8001,4,15,9,12,44,38,6,54
Queen of S't,8001,5,12,9,15,45,49,-4,45
Dunfermline,8001,6,10,12,14,51,52,-1,42
Ayr,8001,7,9,13,14,34,50,-16,40
Raith,8001,8,10,10,16,36,56,-20,40
Dumbarton,8001,9,9,12,15,48,58,-10,39
St Mirren,8001,10,7,11,18,35,54,-19,32
Hibernian,8002,1,19,13,4,56,22,34,70
Dundee Utd,8002,2,20,8,8,56,35,21,68
Morton,8002,3,17,10,9,46,37,9,61
Falkirk,8002,4,13,13,10,56,44,12,52
Queen of S't,8002,5,11,10,15,42,52,-10,43
Dunfermline,8002,6,9,14,13,41,45,-4,41
Raith,8002,7,9,12,15,34,46,-12,39
St Mirren,8002,8,9,11,16,38,51,-13,38
Dumbarton,8002,9,9,11,16,45,59,-14,38
Ayr,8002,10,7,12,17,33,56,-23,33
Hibernian,8003,1,18,12,6,53,27,26,66
Falkirk,8003,2,17,11,8,58,39,19,62
Morton,8003,3,15,15,6,53,36,17,60
Dundee Utd,8003,4,16,11,9,48,35,13,59
Queen of S't,8003,5,12,12,12,45,46,-1,48
Dunfermline,8003,6,9,13,14,45,52,-7,40
Dumbarton,8003,7,8,12,16,48,59,-11,36
St Mirren,8003,8,8,12,16,37,53,-16,36
Raith,8003,9,8,12,16,33,51,-18,36
Ayr,8003,10,6,16,14,33,55,-22,34
Hibernian,8004,1,18,12,6,53,26,27,66
Morton,8004,2,17,12,7,52,35,17,63
Dundee Utd,8004,3,17,10,9,51,37,14,61
Falkirk,8004,4,16,10,10,55,39,16,58
Queen of S't,8004,5,12,9,15,45,51,-6,45
Ayr,8004,6,9,14,13,34,48,-14,41
Dunfermline,8004,7,9,12,15,43,50,-7,39
Dumbarton,8004,8,9,11,16,48,63,-15,38
Raith,8004,9,9,10,17,34,50,-16,37
St Mirren,8004,10,8,12,16,41,57,-16,36
Hibernian,8005,1,20,12,4,58,27,31,72
Morton,8005,2,16,13,7,52,36,16,61
Falkirk,8005,3,16,10,10,54,38,16,58
Dundee Utd,8005,4,15,10,11,45,41,4,55
Dunfermline,8005,5,11,13,12,49,47,2,46
Queen of S't,8005,6,11,10,15,44,50,-6,43
Raith,8005,7,10,10,16,35,48,-13,40
St Mirren,8005,8,9,10,17,48,58,-10,37
Dumbarton,8005,9,8,12,16,47,60,-13,36
Ayr,8005,10,8,12,16,36,63,-27,36
Hibernian,8006,1,21,11,4,59,23,36,74
Morton,8006,2,16,13,7,51,35,16,61
Dundee Utd,8006,3,17,9,10,50,38,12,60
Falkirk,8006,4,16,9,11,62,49,13,57
Queen of S't,8006,5,11,10,15,42,45,-3,43
Raith,8006,6,11,10,15,37,49,-12,43
Dunfermline,8006,7,8,14,14,46,55,-9,38
St Mirren,8006,8,8,12,16,39,51,-12,36
Dumbarton,8006,9,8,12,16,47,64,-17,36
Ayr,8006,10,8,12,16,33,57,-24,36
Hibernian,8007,1,22,11,3,57,20,37,77
Falkirk,8007,2,15,10,11,54,43,11,55
Morton,8007,3,14,13,9,47,36,11,55
Dundee Utd,8007,4,13,12,11,46,39,7,51
Dunfermline,8007,5,11,15,10,44,41,3,48
Queen of S't,8007,6,12,10,14,44,49,-5,46
St Mirren,8007,7,11,10,15,43,52,-9,43
Dumbarton,8007,8,8,12,16,43,59,-16,36
Ayr,8007,9,7,15,14,32,53,-21,36
Raith,8007,10,8,10,18,29,47,-18,34
Hibernian,8008,1,20,10,6,58,29,29,70
Morton,8008,2,17,10,9,47,34,13,61
Dundee Utd,8008,3,17,9,10,50,37,13,60
Falkirk,8008,4,15,9,12,56,44,12,54
Dunfermline,8008,5,10,13,13,46,47,-1,43
Queen of S't,8008,6,11,10,15,41,51,-10,43
Raith,8008,7,11,8,17,37,50,-13,41
Dumbarton,8008,8,9,12,15,48,55,-7,39
St Mirren,8008,9,10,9,17,40,54,-14,39
Ayr,8008,10,9,12,15,34,56,-22,39
Hibernian,8009,1,19,13,4,60,30,30,70
Morton,8009,2,17,14,5,56,37,19,65
Falkirk,8009,3,16,11,9,57,39,18,59
Dundee Utd,8009,4,16,10,10,56,39,17,58
Dumbarton,8009,5,11,11,14,49,59,-10,44
Dunfermline,8009,6,10,12,14,46,46,0,42
Queen of S't,8009,7,11,8,17,45,54,-9,41
Raith,8009,8,10,10,16,38,51,-13,40
St Mirren,8009,9,8,11,17,39,57,-18,35
Ayr,8009,10,7,10,19,31,65,-34,31
Hibernian,8010,1,20,11,5,57,26,31,71
Dundee Utd,8010,2,16,12,8,51,36,15,60
Morton,8010,3,14,13,9,43,38,5,55
Falkirk,8010,4,14,11,11,61,49,12,53
Queen of S't,8010,5,12,10,14,46,50,-4,46
Dunfermline,8010,6,10,13,13,49,49,0,43
Raith,8010,7,11,9,16,36,51,-15,42
Dumbarton,8010,8,9,13,14,50,57,-7,40
St Mirren,8010,9,9,11,16,39,55,-16,38
Ayr,8010,10,7,13,16,32,53,-21,34
Hibernian,8011,1,18,13,5,55,29,26,67
Morton,8011,2,17,11,8,54,37,17,62
Dundee Utd,8011,3,16,11,9,56,42,14,59
Falkirk,8011,4,14,13,9,57,45,12,55
Dunfermline,8011,5,13,11,12,53,49,4,50
Raith,8011,6,10,12,14,37,50,-13,42
Queen of S't,8011,7,10,11,15,50,53,-3,41
Dumbarton,8011,8,10,10,16,48,62,-14,40
Ayr,8011,9,7,13,16,34,61,-27,34
St Mirren,8011,10,7,11,18,39,55,-16,32
Hibernian,8012,1,19,12,5,60,27,33,69
Falkirk,8012,2,18,10,8,64,40,24,64
Morton,8012,3,17,12,7,54,35,19,63
Dundee Utd,8012,4,14,10,12,47,47,0,52
Queen of S't,8012,5,13,9,14,51,53,-2,48
Dunfermline,8012,6,10,13,13,48,52,-4,43
Dumbarton,8012,7,9,11,16,48,62,-14,38
Ayr,8012,8,8,14,14,31,49,-18,38
St Mirren,8012,9,9,9,18,39,55,-16,36
Raith,8012,10,9,8,19,33,55,-22,35
Hibernian,8013,1,18,15,3,51,23,28,69
Morton,8013,2,16,13,7,47,35,12,61
Dundee Utd,8013,3,16,11,9,51,37,14,59
Falkirk,8013,4,16,10,10,54,38,16,58
Queen of S't,8013,5,11,10,15,41,47,-6,43
Raith,8013,6,10,11,15,34,44,-10,41
Dunfermline,8013,7,9,13,14,43,50,-7,40
St Mirren,8013,8,9,13,14,42,52,-10,40
Dumbarton,8013,9,8,11,17,46,59,-13,35
Ayr,8013,10,8,11,17,32,56,-24,35
Hibernian,8014,1,19,11,6,56,29,27,68
Morton,8014,2,19,9,8,51,37,14,66
Falkirk,8014,3,17,10,9,61,39,22,61
Dundee Utd,8014,4,16,10,10,56,40,16,58
Queen of S't,8014,5,11,10,15,45,54,-9,43
Dunfermline,8014,6,10,12,14,46,49,-3,42
Raith,8014,7,10,10,16,36,52,-16,40
Dumbarton,8014,8,9,11,16,51,62,-11,38
St Mirren,8014,9,8,12,16,42,58,-16,36
Ayr,8014,10,7,13,16,34,58,-24,34
Hibernian,8015,1,20,13,3,60,23,37,73
Dundee Utd,8015,2,18,10,8,54,36,18,64
Falkirk,8015,3,18,9,9,62,43,19,63
Morton,8015,4,17,10,9,50,35,15,61
Queen of S't,8015,5,12,8,16,50,53,-3,44
St Mirren,8015,6,10,9,17,42,61,-19,39
Dumbarton,8015,7,9,11,16,50,60,-10,38
Dunfermline,8015,8,8,13,15,42,55,-13,37
Raith,8015,9,9,10,17,33,52,-19,37
Ayr,8015,10,6,13,17,32,57,-25,31
Hibernian,8016,1,18,13,5,53,27,26,67
Dundee Utd,8016,2,17,9,10,55,40,15,60
Morton,8016,3,16,11,9,49,38,11,59
Falkirk,8016,4,15,11,10,57,43,14,56
Dumbarton,8016,5,12,10,14,56,57,-1,46
Dunfermline,8016,6,10,14,12,48,47,1,44
Queen of S't,8016,7,11,9,16,43,54,-11,42
Ayr,8016,8,9,11,16,34,57,-23,38
St Mirren,8016,9,9,10,17,42,58,-16,37
Raith,8016,10,9,10,17,33,49,-16,37
Hibernian,8017,1,20,11,5,57,25,32,71
Morton,8017,2,16,12,8,50,33,17,60
Dundee Utd,8017,3,16,12,8,52,37,15,60
Falkirk,8017,4,15,11,10,57,43,14,56
Queen of S't,8017,5,13,8,15,47,54,-7,47
Dunfermline,8017,6,9,15,12,44,48,-4,42
Raith,8017,7,10,9,17,38,51,-13,39
Ayr,8017,8,9,11,16,31,55,-24,38
St Mirren,8017,9,9,10,17,42,57,-15,37
Dumbarton,8017,10,7,13,16,48,63,-15,34
Hibernian,8018,1,21,11,4,61,24,37,74
Falkirk,8018,2,18,10,8,60,37,23,64
Morton,8018,3,18,10,8,52,37,15,64
Dundee Utd,8018,4,15,8,13,47,46,1,53
Queen of S't,8018,5,13,8,15,46,49,-3,47
Dunfermline,8018,6,10,14,12,46,48,-2,44
Raith,8018,7,10,9,17,38,52,-14,39
Dumbarton,8018,8,9,11,16,48,59,-11,38
Ayr,8018,9,9,10,17,37,58,-21,37
St Mirren,8018,10,7,9,20,39,64,-25,30
Hibernian,8019,1,20,12,4,57,25,32,72
Morton,8019,2,17,10,9,50,41,9,61
Dundee Utd,8019,3,16,9,11,46,40,6,57
Falkirk,8019,4,15,10,11,56,41,15,55
Queen of S't,8019,5,12,10,14,45,48,-3,46
Raith,8019,6,11,9,16,37,49,-12,42
Ayr,8019,7,10,11,15,38,54,-16,41
Dunfermline,8019,8,9,13,14,48,51,-3,40
St Mirren,8019,9,10,10,16,43,56,-13,40
Dumbarton,8019,10,7,12,17,45,60,-15,33
Hibernian,8020,1,20,11,5,55,24,31,71
Morton,8020,2,18,9,9,52,37,15,63
Falkirk,8020,3,16,12,8,55,38,17,60
Dundee Utd,8020,4,15,11,10,51,40,11,56
Dunfermline,8020,5,13,12,11,50,45,5,51
Ayr,8020,6,10,11,15,33,50,-17,41
Queen of S't,8020,7,9,10,17,38,52,-14,37
Dumbarton,8020,8,8,12,16,45,57,-12,36
Raith,8020,9,9,9,18,31,47,-16,36
St Mirren,8020,10,9,9,18,38,58,-20,36
Hibernian,8021,1,18,12,6,52,26,26,66
Morton,8021,2,17,10,9,50,38,12,61
Falkirk,8021,3,16,10,10,56,38,18,58
Dundee Utd,8021,4,14,8,14,45,48,-3,50
Dunfermline,8021,5,12,12,12,49,46,3,48
Queen of S't,8021,6,13,9,14,44,47,-3,48
Raith,8021,7,10,11,15,34,47,-13,41
Ayr,8021,8,10,11,15,36,51,-15,41
Dumbarton,8021,9,9,13,14,48,60,-12,40
St Mirren,8021,10,8,10,18,39,52,-13,34
Hibernian,8022,1,20,11,5,56,27,29,71
Morton,8022,2,18,9,9,51,37,14,63
Falkirk,8022,3,15,11,10,60,47,13,56
Dundee Utd,8022,4,13,13,10,45,41,4,52
Queen of S't,8022,5,14,9,13,53,48,5,51
Dunfermline,8022,6,11,12,13,49,51,-2,45
Dumbarton,8022,7,9,12,15,55,63,-8,39
Raith,8022,8,10,8,18,37,51,-14,38
St Mirren,8022,9,8,12,16,39,58,-19,36
Ayr,8022,10,7,13,16,31,53,-22,34
Hibernian,8023,1,19,13,4,59,30,29,70
Morton,8023,2,18,10,8,60,38,22,64
Dundee Utd,8023,3,18,8,10,58,41,17,62
Falkirk,8023,4,14,12,10,58,46,12,54
Dunfermline,8023,5,10,14,12,47,48,-1,44
Queen of S't,8023,6,11,9,16,43,51,-8,42
Dumbarton,8023,7,10,11,15,49,59,-10,41
Raith,8023,8,10,11,15,37,52,-15,41
St Mirren,8023,9,7,12,17,41,60,-19,33
Ayr,8023,10,6,14,16,35,62,-27,32
Hibernian,8024,1,19,11,6,58,29,29,68
Morton,8024,2,15,14,7,48,35,13,59
Falkirk,8024,3,15,10,11,59,49,10,55
Dundee Utd,8024,4,15,10,11,49,39,10,55
Dunfermline,8024,5,12,13,11,56,53,3,49
Raith,8024,6,11,10,15,35,45,-10,43
St Mirren,8024,7,9,13,14,43,54,-11,40
Queen of S't,8024,8,10,10,16,40,51,-11,40
Ayr,8024,9,9,12,15,33,50,-17,39
Dumbarton,8024,10,8,11,17,49,65,-16,35
Hibernian,8025,1,19,12,5,56,25,31,69
Morton,8025,2,17,12,7,55,40,15,63
Falkirk,8025,3,17,10,9,55,40,15,61
Dundee Utd,8025,4,17,9,10,60,46,14,60
Queen of S't,8025,5,11,10,15,46,50,-4,43
Raith,8025,6,10,11,15,36,47,-11,41
Dunfermline,8025,7,9,13,14,47,52,-5,40
St Mirren,8025,8,8,12,16,38,50,-12,36
Ayr,8025,9,8,12,16,33,57,-24,36
Dumbarton,8025,10,7,13,16,45,64,-19,34
Hibernian,8026,1,19,12,5,61,29,32,69
Morton,8026,2,16,12,8,51,37,14,60
Falkirk,8026,3,15,10,11,52,42,10,55
Dundee Utd,8026,4,15,9,12,51,42,9,54
Dunfermline,8026,5,12,13,11,51,47,4,49
Queen of S't,8026,6,13,9,14,45,49,-4,48
St Mirren,8026,7,9,12,15,41,54,-13,39
Raith,8026,8,10,9,17,34,51,-17,39
Dumbarton,8026,9,9,11,16,46,57,-11,38
Ayr,8026,10,8,11,17,32,56,-24,35
Morton,8027,1,21,9,6,55,34,21,72
Falkirk,8027,2,18,9,9,61,43,18,63
Hibernian,8027,3,16,13,7,49,30,19,61
Dundee Utd,8027,4,16,9,11,53,40,13,57
Queen of S't,8027,5,12,11,13,45,47,-2,47
Raith,8027,6,10,11,15,37,49,-12,41
Dunfermline,8027,7,9,12,15,45,47,-2,39
Ayr,8027,8,9,12,15,34,53,-19,39
Dumbarton,8027,9,8,12,16,42,54,-12,36
St Mirren,8027,10,7,10,19,36,60,-24,31
Hibernian,8028,1,19,13,4,53,24,29,70
Morton,8028,2,19,10,7,49,30,19,67
Falkirk,8028,3,15,10,11,57,46,11,55
Dundee Utd,8028,4,14,11,11,49,42,7,53
Queen of S't,8028,5,13,9,14,48,52,-4,48
Ayr,8028,6,10,11,15,33,50,-17,41
Dunfermline,8028,7,9,13,14,46,47,-1,40
Dumbarton,8028,8,9,11,16,46,57,-11,38
St Mirren,8028,9,9,11,16,40,53,-13,38
Raith,8028,10,8,11,17,31,51,-20,35
Hibernian,8029,1,17,13,6,59,32,27,64
Falkirk,8029,2,16,12,8,56,37,19,60
Morton,8029,3,16,11,9,52,41,11,59
Dundee Utd,8029,4,15,10,11,50,44,6,55
Dunfermline,8029,5,12,13,11,53,45,8,49
Queen of S't,8029,6,12,10,14,48,49,-1,46
Raith,8029,7,11,9,16,35,50,-15,42
St Mirren,8029,8,9,10,17,41,57,-16,37
Dumbarton,8029,9,8,12,16,48,66,-18,36
Ayr,8029,10,8,12,16,32,53,-21,36
Hibernian,8030,1,19,13,4,58,26,32,70
Dundee Utd,8030,2,18,8,10,49,39,10,62
Morton,8030,3,16,12,8,47,36,11,60
Falkirk,8030,4,15,10,11,59,43,16,55
Queen of S't,8030,5,14,9,13,51,48,3,51
Dumbarton,8030,6,10,11,15,51,59,-8,41
Ayr,8030,7,9,13,14,35,50,-15,40
Dunfermline,8030,8,9,12,15,46,52,-6,39
Raith,8030,9,9,8,19,34,58,-24,35
St Mirren,8030,10,7,12,17,39,58,-19,33
Hibernian,8031,1,19,12,5,55,22,33,69
Dundee Utd,8031,2,18,9,9,56,39,17,63
Morton,8031,3,16,11,9,51,39,12,59
Falkirk,8031,4,16,10,10,58,41,17,58
Dunfermline,8031,5,10,13,13,47,50,-3,43
Raith,8031,6,11,10,15,37,48,-11,43
Dumbarton,8031,7,10,10,16,48,58,-10,40
Queen of S't,8031,8,10,10,16,45,55,-10,40
St Mirren,8031,9,9,10,17,42,56,-14,37
Ayr,8031,10,7,13,16,32,63,-31,34
Hibernian,8032,1,21,10,5,58,25,33,73
Morton,8032,2,19,11,6,53,31,22,68
Falkirk,8032,3,16,11,9,63,45,18,59
Dundee Utd,8032,4,13,11,12,41,42,-1,50
Dunfermline,8032,5,11,11,14,45,46,-1,44
Queen of S't,8032,6,11,10,15,43,52,-9,43
Raith,8032,7,11,10,15,35,47,-12,43
Dumbarton,8032,8,10,12,14,45,54,-9,42
Ayr,8032,9,7,12,17,29,51,-22,33
St Mirren,8032,10,7,10,19,36,55,-19,31
Morton,8033,1,20,10,6,54,31,23,70
Hibernian,8033,2,18,13,5,54,27,27,67
Falkirk,8033,3,14,13,9,52,38,14,55
Dundee Utd,8033,4,15,10,11,48,41,7,55
Ayr,8033,5,11,11,14,37,54,-17,44
Dunfermline,8033,6,9,13,14,41,46,-5,40
Queen of S't,8033,7,9,13,14,41,49,-8,40
Raith,8033,8,10,9,17,33,45,-12,39
Dumbarton,8033,9,8,14,14,46,57,-11,38
St Mirren,8033,10,8,10,18,39,57,-18,34
Hibernian,8034,1,22,10,4,57,25,32,76
Morton,8034,2,17,10,9,53,39,14,61
Falkirk,8034,3,16,11,9,63,45,18,59
Dundee Utd,8034,4,15,11,10,52,44,8,56
Queen of S't,8034,5,12,10,14,47,50,-3,46
Dunfermline,8034,6,10,12,14,45,49,-4,42
Raith,8034,7,11,9,16,37,50,-13,42
St Mirren,8034,8,9,10,17,41,56,-15,37
Dumbarton,8034,9,8,11,17,50,64,-14,35
Ayr,8034,10,7,12,17,32,55,-23,33
Hibernian,8035,1,19,12,5,57,28,29,69
Falkirk,8035,2,19,10,7,67,37,30,67
Morton,8035,3,19,9,8,58,35,23,66
Dundee Utd,8035,4,16,9,11,48,40,8,57
Queen of S't,8035,5,13,9,14,44,48,-4,48
Dunfermline,8035,6,10,13,13,44,45,-1,43
Raith,8035,7,9,9,18,33,54,-21,36
Ayr,8035,8,8,12,16,32,53,-21,36
Dumbarton,8035,9,8,10,18,44,63,-19,34
St Mirren,8035,10,7,11,18,37,61,-24,32
Hibernian,8036,1,20,11,5,54,25,29,71
Falkirk,8036,2,18,10,8,61,40,21,64
Morton,8036,3,17,13,6,48,34,14,64
Dundee Utd,8036,4,14,10,12,52,42,10,52
Queen of S't,8036,5,10,11,15,45,52,-7,41
Dumbarton,8036,6,10,11,15,49,58,-9,41
Ayr,8036,7,9,13,14,35,51,-16,40
Dunfermline,8036,8,8,14,14,42,48,-6,38
Raith,8036,9,9,11,16,36,51,-15,38
St Mirren,8036,10,8,10,18,40,61,-21,34
Hibernian,8037,1,18,12,6,58,28,30,66
Falkirk,8037,2,17,12,7,62,39,23,63
Morton,8037,3,18,9,9,55,42,13,63
Dundee Utd,8037,4,17,9,10,55,42,13,60
Dunfermline,8037,5,12,11,13,52,51,1,47
Queen of S't,8037,6,12,9,15,46,53,-7,45
Ayr,8037,7,9,12,15,37,58,-21,39
Dumbarton,8037,8,8,12,16,44,56,-12,36
St Mirren,8037,9,8,11,17,39,58,-19,35
Raith,8037,10,8,9,19,37,58,-21,33
Hibernian,8038,1,19,14,3,56,26,30,71
Morton,8038,2,17,11,8,50,36,14,62
Dundee Utd,8038,3,17,9,10,49,38,11,60
Falkirk,8038,4,15,13,8,58,41,17,58
Queen of S't,8038,5,12,11,13,46,47,-1,47
Dunfermline,8038,6,10,13,13,48,52,-4,43
Raith,8038,7,9,11,16,36,53,-17,38
St Mirren,8038,8,9,10,17,44,55,-11,37
Dumbarton,8038,9,8,10,18,48,64,-16,34
Ayr,8038,10,7,12,17,32,55,-23,33
Morton,8039,1,18,12,6,56,37,19,66
Hibernian,8039,2,17,14,5,52,27,25,65
Falkirk,8039,3,16,10,10,57,38,19,58
Dundee Utd,8039,4,15,9,12,52,40,12,54
Queen of S't,8039,5,14,9,13,49,46,3,51
Dunfermline,8039,6,10,13,13,44,46,-2,43
Raith,8039,7,10,10,16,35,55,-20,40
Dumbarton,8039,8,8,13,15,46,59,-13,37
St Mirren,8039,9,8,11,17,40,61,-21,35
Ayr,8039,10,8,11,17,31,53,-22,35
Hibernian,8040,1,18,12,6,59,30,29,66
Falkirk,8040,2,17,11,8,59,38,21,62
Morton,8040,3,15,12,9,50,42,8,57
Queen of S't,8040,4,16,8,12,55,47,8,56
Dundee Utd,8040,5,14,12,10,48,42,6,54
Dunfermline,8040,6,10,12,14,49,49,0,42
Dumbarton,8040,7,9,11,16,46,62,-16,38
St Mirren,8040,8,9,11,16,39,55,-16,38
Ayr,8040,9,8,13,15,33,52,-19,37
Raith,8040,10,9,8,19,36,57,-21,35
Hibernian,8041,1,21,11,4,62,26,36,74
Dundee Utd,8041,2,17,10,9,51,38,13,61
Morton,8041,3,16,10,10,53,44,9,58
Falkirk,8041,4,16,9,11,57,45,12,57
Raith,8041,5,13,8,15,38,46,-8,47
Queen of S't,8041,6,12,8,16,46,52,-6,44
Dumbarton,8041,7,10,11,15,49,57,-8,41
Ayr,8041,8,8,13,15,33,55,-22,37
Dunfermline,8041,9,8,12,16,42,51,-9,36
St Mirren,8041,10,8,10,18,37,54,-17,34
Hibernian,8042,1,17,14,5,54,29,25,65
Morton,8042,2,17,14,5,53,30,23,65
Falkirk,8042,3,17,10,9,61,41,20,61
Dundee Utd,8042,4,16,11,9,49,38,11,59
Queen of S't,8042,5,12,9,15,46,50,-4,45
Raith,8042,6,11,9,16,38,49,-11,42
Dumbarton,8042,7,10,11,15,51,61,-10,41
Ayr,8042,8,8,13,15,31,51,-20,37
Dunfermline,8042,9,7,13,16,42,54,-12,34
St Mirren,8042,10,8,10,18,40,62,-22,34
Hibernian,8043,1,19,13,4,57,26,31,70
Falkirk,8043,2,17,10,9,63,39,24,61
Dundee Utd,8043,3,17,10,9,50,37,13,61
Morton,8043,4,17,9,10,51,41,10,60
Queen of S't,8043,5,10,12,14,49,55,-6,42
Dunfermline,8043,6,10,11,15,52,55,-3,41
Dumbarton,8043,7,10,11,15,50,65,-15,41
Ayr,8043,8,9,12,15,39,56,-17,39
Raith,8043,9,9,11,16,36,53,-17,38
St Mirren,8043,10,7,11,18,34,54,-20,32
Hibernian,8044,1,19,11,6,54,26,28,68
Dundee Utd,8044,2,18,9,9,55,41,14,63
Morton,8044,3,16,10,10,51,44,7,58
Falkirk,8044,4,15,12,9,54,38,16,57
Dunfermline,8044,5,13,11,12,49,42,7,50
Raith,8044,6,12,10,14,38,49,-11,46
Queen of S't,8044,7,10,9,17,44,55,-11,39
Ayr,8044,8,8,12,16,35,57,-22,36
Dumbarton,8044,9,8,11,17,47,62,-15,35
St Mirren,8044,10,7,13,16,37,50,-13,34
Hibernian,8045,1,19,12,5,61,27,34,69
Falkirk,8045,2,17,12,7,57,36,21,63
Morton,8045,3,15,13,8,46,36,10,58
Dundee Utd,8045,4,16,9,11,51,43,8,57
Ayr,8045,5,10,13,13,43,56,-13,43
Dunfermline,8045,6,10,12,14,44,47,-3,42
Queen of S't,8045,7,11,8,17,44,53,-9,41
Raith,8045,8,10,9,17,36,53,-17,39
St Mirren,8045,9,9,11,16,40,57,-17,38
Dumbarton,8045,10,7,13,16,47,61,-14,34
Hibernian,8046,1,18,13,5,55,27,28,67
Morton,8046,2,17,12,7,57,38,19,63
Falkirk,8046,3,16,9,11,57,45,12,57
Dundee Utd,8046,4,16,8,12,52,44,8,56
Dunfermline,8046,5,11,13,12,50,51,-1,46
Queen of S't,8046,6,12,9,15,50,55,-5,45
Raith,8046,7,10,11,15,32,46,-14,41
Dumbarton,8046,8,10,10,16,51,62,-11,40
Ayr,8046,9,9,12,15,36,53,-17,39
St Mirren,8046,10,7,11,18,41,60,-19,32
Hibernian,8047,1,20,10,6,51,25,26,70
Morton,8047,2,17,11,8,50,37,13,62
Falkirk,8047,3,16,10,10,58,40,18,58
Dundee Utd,8047,4,16,10,10,48,38,10,58
Queen of S't,8047,5,13,8,15,45,50,-5,47
Ayr,8047,6,10,12,14,35,48,-13,42
Dunfermline,8047,7,9,13,14,46,50,-4,40
Dumbarton,8047,8,9,13,14,48,54,-6,40
St Mirren,8047,9,9,10,17,38,54,-16,37
Raith,8047,10,8,9,19,31,54,-23,33
Morton,8048,1,19,11,6,58,35,23,68
Hibernian,8048,2,19,10,7,53,30,23,67
Falkirk,8048,3,18,9,9,62,40,22,63
Dundee Utd,8048,4,17,9,10,54,42,12,60
Dumbarton,8048,5,10,14,12,53,57,-4,44
Dunfermline,8048,6,9,13,14,43,48,-5,40
Queen of S't,8048,7,10,9,17,46,57,-11,39
Raith,8048,8,10,8,18,34,53,-19,38
St Mirren,8048,9,8,11,17,44,63,-19,35
Ayr,8048,10,7,12,17,34,56,-22,33
Morton,8049,1,17,14,5,48,31,17,65
Hibernian,8049,2,16,15,5,52,27,25,63
Falkirk,8049,3,16,11,9,58,42,16,59
Dundee Utd,8049,4,14,12,10,52,42,10,54
Ayr,8049,5,11,12,13,44,53,-9,45
Queen of S't,8049,6,11,10,15,44,54,-10,43
Raith,8049,7,11,9,16,34,46,-12,42
Dunfermline,8049,8,9,14,13,48,50,-2,41
Dumbarton,8049,9,9,11,16,45,59,-14,38
St Mirren,8049,10,7,10,19,37,58,-21,31
Hibernian,8050,1,21,12,3,61,25,36,75
Morton,8050,2,17,13,6,55,38,17,64
Falkirk,8050,3,17,10,9,63,43,20,61
Queen of S't,8050,4,13,8,15,46,48,-2,47
Dundee Utd,8050,5,12,10,14,46,50,-4,46
Dunfermline,8050,6,9,13,14,44,49,-5,40
Dumbarton,8050,7,9,13,14,49,58,-9,40
St Mirren,8050,8,9,11,16,45,56,-11,38
Raith,8050,9,9,10,17,33,56,-23,37
Ayr,8050,10,8,12,16,36,55,-19,36
Hibernian,8051,1,20,11,5,56,23,33,71
Morton,8051,2,17,9,10,46,40,6,60
Dundee Utd,8051,3,16,10,10,49,39,10,58
Falkirk,8051,4,13,13,10,54,42,12,52
Queen of S't,8051,5,11,11,14,44,52,-8,44
St Mirren,8051,6,11,10,15,44,51,-7,43
Dunfermline,8051,7,9,15,12,46,48,-2,42
Raith,8051,8,10,11,15,39,47,-8,41
Ayr,8051,9,10,10,16,35,54,-19,40
Dumbarton,8051,10,8,10,18,45,62,-17,34
Hibernian,8052,1,19,12,5,56,28,28,69
Falkirk,8052,2,17,12,7,61,38,23,63
Dundee Utd,8052,3,17,10,9,51,37,14,61
Morton,8052,4,14,15,7,48,37,11,57
Queen of S't,8052,5,11,10,15,42,49,-7,43
Dunfermline,8052,6,9,13,14,46,51,-5,40
Raith,8052,7,10,10,16,35,50,-15,40
St Mirren,8052,8,9,10,17,39,56,-17,37
Dumbarton,8052,9,8,12,16,46,57,-11,36
Ayr,8052,10,8,12,16,30,51,-21,36
Hibernian,8053,1,21,11,4,56,28,28,74
Dundee Utd,8053,2,17,10,9,51,38,13,61
Falkirk,8053,3,15,11,10,53,37,16,56
Morton,8053,4,14,13,9,50,40,10,55
Dunfermline,8053,5,12,13,11,49,44,5,49
Queen of S't,8053,6,11,9,16,45,54,-9,42
Ayr,8053,7,10,10,16,37,56,-19,40
Raith,8053,8,10,9,17,36,53,-17,39
Dumbarton,8053,9,8,12,16,45,57,-12,36
St Mirren,8053,10,8,10,18,42,57,-15,34
Hibernian,8054,1,18,15,3,57,24,33,69
Morton,8054,2,17,10,9,51,39,12,61
Dundee Utd,8054,3,16,10,10,51,43,8,58
Falkirk,8054,4,14,12,10,55,42,13,54
Queen of S't,8054,5,14,9,13,51,46,5,51
Dunfermline,8054,6,10,13,13,51,50,1,43
Raith,8054,7,10,11,15,34,49,-15,41
Dumbarton,8054,8,10,10,16,47,56,-9,40
Ayr,8054,9,8,11,17,30,57,-27,35
St Mirren,8054,10,8,9,19,40,61,-21,33
Hibernian,8055,1,18,12,6,50,28,22,66
Dundee Utd,8055,2,16,11,9,52,41,11,59
Morton,8055,3,16,10,10,48,41,7,58
Falkirk,8055,4,14,13,9,55,39,16,55
Dunfermline,8055,5,13,12,11,52,44,8,51
Raith,8055,6,12,9,15,40,47,-7,45
Queen of S't,8055,7,11,10,15,44,50,-6,43
St Mirren,8055,8,9,11,16,44,59,-15,38
Ayr,8055,9,8,12,16,34,52,-18,36
Dumbarton,8055,10,8,10,18,46,64,-18,34
Hibernian,8056,1,18,14,4,50,22,28,68
Morton,8056,2,18,10,8,57,41,16,64
Falkirk,8056,3,17,11,8,56,36,20,62
Dundee Utd,8056,4,16,8,12,55,45,10,56
Queen of S't,8056,5,11,11,14,48,54,-6,44
Raith,8056,6,10,12,14,36,49,-13,42
Dunfermline,8056,7,9,13,14,48,51,-3,40
Dumbarton,8056,8,9,12,15,46,57,-11,39
Ayr,8056,9,9,11,16,33,52,-19,38
St Mirren,8056,10,7,10,19,39,61,-22,31
Morton,8057,1,19,12,5,55,30,25,69
Hibernian,8057,2,17,13,6,54,29,25,64
Falkirk,8057,3,18,10,8,64,42,22,64
Dundee Utd,8057,4,16,9,11,50,37,13,57
Queen of S't,8057,5,12,10,14,49,52,-3,46
Ayr,8057,6,10,11,15,35,53,-18,41
Dunfermline,8057,7,9,12,15,42,51,-9,39
Dumbarton,8057,8,9,10,17,46,60,-14,37
Raith,8057,9,9,10,17,32,52,-20,37
St Mirren,8057,10,8,9,19,43,64,-21,33
Hibernian,8058,1,18,12,6,55,33,22,66
Morton,8058,2,15,13,8,51,38,13,58
Dundee Utd,8058,3,16,9,11,49,40,9,57
Falkirk,8058,4,15,10,11,58,44,14,55
Dunfermline,8058,5,11,13,12,48,49,-1,46
Queen of S't,8058,6,12,9,15,45,53,-8,45
Dumbarton,8058,7,10,12,14,53,59,-6,42
St Mirren,8058,8,10,10,16,43,55,-12,40
Raith,8058,9,10,10,16,39,52,-13,40
Ayr,8058,10,9,10,17,37,55,-18,37
Hibernian,8059,1,20,13,3,56,24,32,73
Morton,8059,2,18,11,7,57,37,20,65
Dundee Utd,8059,3,18,8,10,58,41,17,62
Falkirk,8059,4,14,12,10,54,40,14,54
Raith,8059,5,11,10,15,36,47,-11,43
Queen of S't,8059,6,10,12,14,44,51,-7,42
Dumbarton,8059,7,9,12,15,48,59,-11,39
Dunfermline,8059,8,9,11,16,42,52,-10,38
St Mirren,8059,9,9,9,18,42,63,-21,36
Ayr,8059,10,6,14,16,33,56,-23,32
Hibernian,8060,1,19,11,6,58,28,30,68
Falkirk,8060,2,17,10,9,64,42,22,61
Morton,8060,3,16,13,7,49,32,17,61
Dundee Utd,8060,4,16,10,10,53,38,15,58
Raith,8060,5,13,8,15,44,51,-7,47
Dunfermline,8060,6,10,14,12,46,51,-5,44
Queen of S't,8060,7,10,9,17,42,59,-17,39
Dumbarton,8060,8,8,12,16,45,62,-17,36
Ayr,8060,9,8,12,16,34,59,-25,36
St Mirren,8060,10,8,11,17,40,53,-13,35
Hibernian,8061,1,22,11,3,60,24,36,77
Falkirk,8061,2,17,10,9,61,40,21,61
Dundee Utd,8061,3,17,10,9,54,39,15,61
Morton,8061,4,17,10,9,50,36,14,61
Raith,8061,5,11,9,16,39,51,-12,42
Dunfermline,8061,6,9,12,15,45,52,-7,39
Queen of S't,8061,7,10,8,18,40,55,-15,38
Dumbarton,8061,8,8,12,16,45,60,-15,36
St Mirren,8061,9,8,12,16,40,57,-17,36
Ayr,8061,10,8,12,16,37,57,-20,36
Morton,8062,1,19,11,6,53,32,21,68
Hibernian,8062,2,18,13,5,56,27,29,67
Dundee Utd,8062,3,16,9,11,54,43,11,57
Falkirk,8062,4,15,11,10,58,42,16,56
Queen of S't,8062,5,13,10,13,50,48,2,49
Raith,8062,6,10,12,14,37,46,-9,42
Dunfermline,8062,7,9,12,15,46,59,-13,39
Ayr,8062,8,9,12,15,38,55,-17,39
Dumbarton,8062,9,8,13,15,48,61,-13,37
St Mirren,8062,10,6,11,19,39,66,-27,29
Hibernian,8063,1,18,13,5,53,27,26,67
Morton,8063,2,17,13,6,52,35,17,64
Falkirk,8063,3,17,10,9,63,42,21,61
Dundee Utd,8063,4,16,10,10,50,40,10,58
Dunfermline,8063,5,10,13,13,48,51,-3,43
Queen of S't,8063,6,11,9,16,46,57,-11,42
Ayr,8063,7,9,13,14,35,50,-15,40
St Mirren,8063,8,8,12,16,41,55,-14,36
Raith,8063,9,8,12,16,33,48,-15,36
Dumbarton,8063,10,8,11,17,44,60,-16,35
Hibernian,8064,1,19,12,5,51,25,26,69
Falkirk,8064,2,18,9,9,58,39,19,63
Dundee Utd,8064,3,18,8,10,56,40,16,62
Morton,8064,4,14,14,8,46,36,10,56
Raith,8064,5,13,8,15,38,46,-8,47
Dunfermline,8064,6,11,12,13,47,46,1,45
Queen of S't,8064,7,11,10,15,43,50,-7,43
Dumbarton,8064,8,8,12,16,45,61,-16,36
St Mirren,8064,9,8,10,18,41,57,-16,34
Ayr,8064,10,7,11,18,31,56,-25,32
Falkirk,8065,1,17,11,8,63,39,24,62
Hibernian,8065,2,17,11,8,52,32,20,62
Morton,8065,3,17,11,8,52,40,12,62
Dundee Utd,8065,4,14,11,11,46,46,0,53
Queen of S't,8065,5,14,9,13,52,46,6,51
Dunfermline,8065,6,11,13,12,49,48,1,46
Raith,8065,7,11,8,17,37,54,-17,41
St Mirren,8065,8,10,9,17,48,58,-10,39
Dumbarton,8065,9,9,12,15,47,57,-10,39
Ayr,8065,10,6,13,17,34,60,-26,31
Hibernian,8066,1,20,12,4,59,23,36,72
Morton,8066,2,16,12,8,50,37,13,60
Falkirk,8066,3,15,14,7,60,40,20,59
Dundee Utd,8066,4,14,11,11,50,44,6,53
Dunfermline,8066,5,9,16,11,47,48,-1,43
Queen of S't,8066,6,10,11,15,44,54,-10,41
Dumbarton,8066,7,9,13,14,44,54,-10,40
Ayr,8066,8,9,12,15,35,56,-21,39
Raith,8066,9,9,11,16,33,47,-14,38
St Mirren,8066,10,8,10,18,40,59,-19,34
Hibernian,8067,1,19,12,5,55,25,30,69
Morton,8067,2,19,10,7,58,36,22,67
Falkirk,8067,3,17,11,8,63,37,26,62
Dundee Utd,8067,4,17,10,9,61,43,18,61
Queen of S't,8067,5,13,8,15,47,49,-2,47
Dumbarton,8067,6,10,11,15,54,62,-8,41
Raith,8067,7,11,8,17,37,56,-19,41
St Mirren,8067,8,9,9,18,41,64,-23,36
Dunfermline,8067,9,8,11,17,42,52,-10,35
Ayr,8067,10,7,10,19,30,64,-34,31
Falkirk,8068,1,19,10,7,60,35,25,67
Hibernian,8068,2,17,14,5,55,27,28,65
Dundee Utd,8068,3,17,10,9,58,42,16,61
Morton,8068,4,14,14,8,47,37,10,56
Ayr,8068,5,11,12,13,38,51,-13,45
Raith,8068,6,10,12,14,36,46,-10,42
Queen of S't,8068,7,10,11,15,41,55,-14,41
Dunfermline,8068,8,8,15,13,48,50,-2,39
Dumbarton,8068,9,8,12,16,45,58,-13,36
St Mirren,8068,10,6,10,20,35,62,-27,28
Hibernian,8069,1,21,11,4,55,24,31,74
Morton,8069,2,17,11,8,48,36,12,62
Dundee Utd,8069,3,15,11,10,49,40,9,56
Falkirk,8069,4,14,12,10,54,38,16,54
Dunfermline,8069,5,12,12,12,54,49,5,48
Queen of S't,8069,6,13,9,14,46,48,-2,48
Raith,8069,7,11,10,15,36,46,-10,43
Dumbarton,8069,8,9,10,17,42,60,-18,37
St Mirren,8069,9,7,12,17,37,53,-16,33
Ayr,8069,10,6,12,18,28,55,-27,30
Hibernian,8070,1,20,10,6,55,25,30,70
Morton,8070,2,17,9,10,52,38,14,60
Falkirk,8070,3,14,11,11,52,42,10,53
Dundee Utd,8070,4,14,11,11,48,43,5,53
Queen of S't,8070,5,14,9,13,50,50,0,51
Dunfermline,8070,6,12,12,12,48,48,0,48
Dumbarton,8070,7,10,11,15,51,57,-6,41
Ayr,8070,8,10,11,15,40,56,-16,41
St Mirren,8070,9,8,12,16,40,54,-14,36
Raith,8070,10,9,8,19,33,56,-23,35
Hibernian,8071,1,18,12,6,53,28,25,66
Dundee Utd,8071,2,17,10,9,54,39,15,61
Falkirk,8071,3,16,11,9,60,39,21,59
Morton,8071,4,15,11,10,46,38,8,56
Dunfermline,8071,5,13,13,10,55,43,12,52
Queen of S't,8071,6,12,10,14,46,49,-3,46
Raith,8071,7,9,10,17,31,52,-21,37
Dumbarton,8071,8,8,12,16,42,61,-19,36
St Mirren,8071,9,8,11,17,41,56,-15,35
Ayr,8071,10,6,16,14,34,57,-23,34
Hibernian,8072,1,16,16,4,53,25,28,64
Morton,8072,2,16,14,6,51,35,16,62
Dundee Utd,8072,3,16,9,11,55,46,9,57
Falkirk,8072,4,13,13,10,55,42,13,52
Dunfermline,8072,5,10,15,11,46,49,-3,45
Queen of S't,8072,6,11,11,14,50,55,-5,44
Dumbarton,8072,7,9,12,15,45,53,-8,39
Raith,8072,8,9,12,15,40,53,-13,39
Ayr,8072,9,8,14,14,38,57,-19,38
St Mirren,8072,10,9,10,17,38,56,-18,37
Hibernian,8073,1,23,10,3,58,20,38,79
Morton,8073,2,18,11,7,55,36,19,65
Dundee Utd,8073,3,17,9,10,53,38,15,60
Falkirk,8073,4,15,11,10,56,41,15,56
Dunfermline,8073,5,11,12,13,44,44,0,45
Queen of S't,8073,6,11,9,16,41,50,-9,42
Raith,8073,7,11,9,16,35,48,-13,42
Dumbarton,8073,8,8,11,17,47,62,-15,35
St Mirren,8073,9,8,10,18,40,61,-21,34
Ayr,8073,10,7,10,19,29,58,-29,31
Hibernian,8074,1,20,11,5,60,26,34,71
Morton,8074,2,18,10,8,52,37,15,64
Falkirk,8074,3,16,10,10,56,40,16,58
Dundee Utd,8074,4,15,10,11,51,44,7,55
Queen of S't,8074,5,11,10,15,46,57,-11,43
Dunfermline,8074,6,10,12,14,46,49,-3,42
Dumbarton,8074,7,10,11,15,52,58,-6,41
St Mirren,8074,8,10,9,17,41,52,-11,39
Raith,8074,9,10,9,17,32,51,-19,39
Ayr,8074,10,8,12,16,35,57,-22,36
Hibernian,8075,1,18,13,5,56,26,30,67
Falkirk,8075,2,17,10,9,56,39,17,61
Morton,8075,3,16,12,8,54,39,15,60
Dundee Utd,8075,4,17,9,10,54,41,13,60
Queen of S't,8075,5,12,9,15,43,49,-6,45
Dunfermline,8075,6,11,11,14,46,49,-3,44
Ayr,8075,7,10,11,15,32,54,-22,41
Dumbarton,8075,8,9,12,15,48,59,-11,39
Raith,8075,9,9,10,17,33,49,-16,37
St Mirren,8075,10,7,11,18,43,60,-17,32
Hibernian,8076,1,18,13,5,51,28,23,67
Dundee Utd,8076,2,19,8,9,54,35,19,65
Morton,8076,3,18,10,8,55,37,18,64
Falkirk,8076,4,17,10,9,63,43,20,61
Dunfermline,8076,5,11,12,13,44,46,-2,45
Queen of S't,8076,6,11,10,15,43,49,-6,43
Dumbarton,8076,7,10,11,15,49,60,-11,41
Raith,8076,8,8,11,17,33,49,-16,35
Ayr,8076,9,7,13,16,29,52,-23,34
St Mirren,8076,10,7,10,19,37,59,-22,31
Hibernian,8077,1,18,13,5,50,26,24,67
Morton,8077,2,18,11,7,51,36,15,65
Falkirk,8077,3,18,10,8,66,40,26,64
Dundee Utd,8077,4,14,11,11,51,46,5,53
Queen of S't,8077,5,13,9,14,45,46,-1,48
Dunfermline,8077,6,9,14,13,46,49,-3,41
Raith,8077,7,10,10,16,38,47,-9,40
St Mirren,8077,8,8,12,16,41,55,-14,36
Dumbarton,8077,9,8,11,17,48,65,-17,35
Ayr,8077,10,8,11,17,34,60,-26,35
Hibernian,8078,1,19,12,5,55,26,29,69
Morton,8078,2,17,13,6,53,36,17,64
Dundee Utd,8078,3,17,10,9,52,38,14,61
Falkirk,8078,4,15,10,11,55,41,14,55
Queen of S't,8078,5,15,8,13,49,47,2,53
Raith,8078,6,11,9,16,37,49,-12,42
Ayr,8078,7,9,12,15,35,54,-19,39
Dumbarton,8078,8,9,10,17,50,65,-15,37
Dunfermline,8078,9,8,12,16,45,54,-9,36
St Mirren,8078,10,7,10,19,36,57,-21,31
Hibernian,8079,1,20,11,5,58,25,33,71
Morton,8079,2,18,12,6,49,30,19,66
Falkirk,8079,3,16,11,9,58,42,16,59
Dundee Utd,8079,4,14,10,12,52,44,8,52
Queen of S't,8079,5,12,11,13,46,47,-1,47
Dunfermline,8079,6,10,12,14,45,47,-2,42
Ayr,8079,7,9,13,14,38,55,-17,40
Raith,8079,8,9,10,17,33,50,-17,37
Dumbarton,8079,9,8,12,16,49,65,-16,36
St Mirren,8079,10,7,12,17,38,61,-23,33
Hibernian,8080,1,19,13,4,53,25,28,70
Falkirk,8080,2,16,11,9,61,45,16,59
Morton,8080,3,15,13,8,46,37,9,58
Dundee Utd,8080,4,15,10,11,50,40,10,55
Dunfermline,8080,5,11,13,12,44,44,0,46
Dumbarton,8080,6,10,13,13,51,53,-2,43
Queen of S't,8080,7,10,10,16,41,52,-11,40
Ayr,8080,8,8,13,15,38,57,-19,37
St Mirren,8080,9,8,12,16,40,55,-15,36
Raith,8080,10,8,12,16,32,48,-16,36
Hibernian,8081,1,18,12,6,53,27,26,66
Morton,8081,2,18,10,8,56,36,20,64
Falkirk,8081,3,17,11,8,65,38,27,62
Dundee Utd,8081,4,15,11,10,52,45,7,56
Dunfermline,8081,5,12,12,12,44,47,-3,48
Queen of S't,8081,6,11,10,15,51,52,-1,43
Ayr,8081,7,9,12,15,37,53,-16,39
Dumbarton,8081,8,8,14,14,48,66,-18,38
Raith,8081,9,9,10,17,34,54,-20,37
St Mirren,8081,10,6,12,18,40,62,-22,30
Hibernian,8082,1,21,12,3,59,24,35,75
Falkirk,8082,2,18,11,7,62,37,25,65
Dundee Utd,8082,3,16,10,10,50,39,11,58
Morton,8082,4,16,10,10,46,42,4,58
Dunfermline,8082,5,10,12,14,45,55,-10,42
Queen of S't,8082,6,10,10,16,42,51,-9,40
St Mirren,8082,7,9,12,15,44,54,-10,39
Raith,8082,8,9,10,17,37,51,-14,37
Dumbarton,8082,9,8,12,16,49,60,-11,36
Ayr,8082,10,8,11,17,35,56,-21,35
Hibernian,8083,1,22,10,4,58,24,34,76
Morton,8083,2,17,11,8,51,34,17,62
Falkirk,8083,3,16,11,9,59,42,17,59
Dundee Utd,8083,4,15,12,9,54,41,13,57
Queen of S't,8083,5,12,10,14,47,51,-4,46
Raith,8083,6,10,12,14,37,45,-8,42
Dunfermline,8083,7,9,13,14,44,52,-8,40
Ayr,8083,8,7,14,15,33,55,-22,35
St Mirren,8083,9,8,10,18,39,59,-20,34
Dumbarton,8083,10,7,11,18,42,61,-19,32
Hibernian,8084,1,21,11,4,55,22,33,74
Morton,8084,2,17,11,8,54,35,19,62
Dundee Utd,8084,3,16,11,9,49,41,8,59
Falkirk,8084,4,15,12,9,57,43,14,57
Queen of S't,8084,5,11,11,14,45,48,-3,44
Dunfermline,8084,6,10,13,13,49,52,-3,43
Ayr,8084,7,8,15,13,33,51,-18,39
Dumbarton,8084,8,9,11,16,48,59,-11,38
Raith,8084,9,8,10,18,32,51,-19,34
St Mirren,8084,10,7,11,18,38,58,-20,32
Hibernian,8085,1,21,11,4,60,25,35,74
Morton,8085,2,18,10,8,52,37,15,64
Dundee Utd,8085,3,16,11,9,50,36,14,59
Falkirk,8085,4,14,9,13,54,50,4,51
Dumbarton,8085,5,12,11,13,51,54,-3,47
Dunfermline,8085,6,11,11,14,51,49,2,44
Raith,8085,7,10,9,17,35,52,-17,39
Ayr,8085,8,9,12,15,32,52,-20,39
Queen of S't,8085,9,9,10,17,45,57,-12,37
St Mirren,8085,10,8,10,18,39,57,-18,34
Hibernian,8086,1,21,12,3,59,20,39,75
Falkirk,8086,2,17,9,10,61,41,20,60
Morton,8086,3,16,12,8,53,39,14,60
Dundee Utd,8086,4,17,9,10,53,41,12,60
Queen of S't,8086,5,12,9,15,46,48,-2,45
Raith,8086,6,12,8,16,35,49,-14,44
Dumbarton,8086,7,10,10,16,49,61,-12,40
Dunfermline,8086,8,7,15,14,40,47,-7,36
St Mirren,8086,9,9,9,18,39,58,-19,36
Ayr,8086,10,7,11,18,32,63,-31,32
Hibernian,8087,1,22,11,3,58,22,36,77
Morton,8087,2,16,11,9,47,34,13,59
Falkirk,8087,3,15,11,10,56,44,12,56
Dundee Utd,8087,4,15,11,10,52,45,7,56
Dunfermline,8087,5,9,14,13,45,48,-3,41
Queen of S't,8087,6,10,10,16,45,54,-9,40
Ayr,8087,7,9,13,14,36,51,-15,40
Dumbarton,8087,8,8,14,14,50,61,-11,38
St Mirren,8087,9,8,13,15,39,52,-13,37
Raith,8087,10,9,10,17,35,52,-17,37
Morton,8088,1,19,11,6,52,33,19,68
Hibernian,8088,2,17,14,5,54,29,25,65
Falkirk,8088,3,17,10,9,68,39,29,61
Dundee Utd,8088,4,17,9,10,54,37,17,60
Queen of S't,8088,5,12,9,15,44,53,-9,45
Dumbarton,8088,6,10,11,15,46,53,-7,41
Dunfermline,8088,7,9,12,15,42,50,-8,39
St Mirren,8088,8,9,10,17,40,58,-18,37
Raith,8088,9,9,10,17,31,53,-22,37
Ayr,8088,10,6,14,16,30,56,-26,32
Morton,8089,1,17,13,6,48,32,16,64
Hibernian,8089,2,17,11,8,51,30,21,62
Falkirk,8089,3,17,10,9,60,37,23,61
Dundee Utd,8089,4,17,9,10,48,37,11,60
Dunfermline,8089,5,12,13,11,45,43,2,49
Queen of S't,8089,6,12,8,16,49,51,-2,44
Dumbarton,8089,7,9,13,14,45,55,-10,40
Raith,8089,8,10,10,16,34,53,-19,40
Ayr,8089,9,8,11,17,36,56,-20,35
St Mirren,8089,10,7,10,19,38,60,-22,31
Hibernian,8090,1,20,12,4,63,27,36,72
Morton,8090,2,18,9,9,54,39,15,63
Falkirk,8090,3,16,11,9,58,42,16,59
Dundee Utd,8090,4,16,9,11,54,45,9,57
Queen of S't,8090,5,12,11,13,46,49,-3,47
Raith,8090,6,10,12,14,39,49,-10,42
Dumbarton,8090,7,10,11,15,49,59,-10,41
Dunfermline,8090,8,9,11,16,46,51,-5,38
Ayr,8090,9,7,13,16,32,56,-24,34
St Mirren,8090,10,7,11,18,40,64,-24,32
Hibernian,8091,1,17,12,7,52,31,21,63
Dundee Utd,8091,2,17,8,11,54,42,12,59
Falkirk,8091,3,14,14,8,59,42,17,56
Morton,8091,4,15,11,10,50,39,11,56
Queen of S't,8091,5,13,10,13,44,46,-2,49
Raith,8091,6,11,12,13,39,45,-6,45
Dunfermline,8091,7,10,14,12,45,51,-6,44
St Mirren,8091,8,10,12,14,46,54,-8,42
Dumbarton,8091,9,8,12,16,45,59,-14,36
Ayr,8091,10,7,11,18,30,55,-25,32
Hibernian,8092,1,22,10,4,62,22,40,76
Dundee Utd,8092,2,18,8,10,58,42,16,62
Morton,8092,3,17,10,9,49,40,9,61
Falkirk,8092,4,16,11,9,60,41,19,59
Queen of S't,8092,5,10,12,14,45,52,-7,42
Raith,8092,6,10,12,14,39,49,-10,42
Dunfermline,8092,7,9,14,13,50,55,-5,41
Dumbarton,8092,8,10,11,15,49,58,-9,41
St Mirren,8092,9,8,9,19,39,64,-25,33
Ayr,8092,10,6,11,19,32,60,-28,29
Hibernian,8093,1,20,10,6,52,24,28,70
Dundee Utd,8093,2,17,9,10,48,36,12,60
Falkirk,8093,3,16,9,11,57,43,14,57
Morton,8093,4,15,12,9,49,43,6,57
Dunfermline,8093,5,13,12,11,57,44,13,51
Queen of S't,8093,6,12,8,16,43,53,-10,44
Dumbarton,8093,7,9,14,13,48,55,-7,41
Ayr,8093,8,9,11,16,34,51,-17,38
St Mirren,8093,9,7,13,16,35,52,-17,34
Raith,8093,10,8,10,18,34,56,-22,34
Hibernian,8094,1,21,11,4,59,22,37,74
Dundee Utd,8094,2,19,8,9,55,37,18,65
Morton,8094,3,18,10,8,53,33,20,64
Falkirk,8094,4,16,9,11,57,42,15,57
Queen of S't,8094,5,12,8,16,46,53,-7,44
Dumbarton,8094,6,10,10,16,48,59,-11,40
Raith,8094,7,10,10,16,33,50,-17,40
Dunfermline,8094,8,9,11,16,46,59,-13,38
Ayr,8094,9,8,11,17,34,59,-25,35
St Mirren,8094,10,8,10,18,38,55,-17,34
Hibernian,8095,1,19,13,4,55,22,33,70
Falkirk,8095,2,18,10,8,59,36,23,64
Morton,8095,3,16,13,7,48,34,14,61
Dundee Utd,8095,4,16,10,10,50,39,11,58
Queen of S't,8095,5,12,9,15,44,50,-6,45
Dumbarton,8095,6,10,11,15,52,63,-11,41
Raith,8095,7,9,11,16,31,50,-19,38
Dunfermline,8095,8,8,13,15,41,48,-7,37
St Mirren,8095,9,7,14,15,41,53,-12,35
Ayr,8095,10,6,14,16,32,58,-26,32
Hibernian,8096,1,22,10,4,59,21,38,76
Falkirk,8096,2,15,13,8,55,40,15,58
Dundee Utd,8096,3,15,9,12,52,45,7,54
Morton,8096,4,14,12,10,46,39,7,54
Queen of S't,8096,5,13,9,14,49,48,1,48
Dunfermline,8096,6,9,15,12,44,49,-5,42
St Mirren,8096,7,10,10,16,40,50,-10,40
Raith,8096,8,10,10,16,36,48,-12,40
Dumbarton,8096,9,8,12,16,44,62,-18,36
Ayr,8096,10,8,12,16,32,55,-23,36
Hibernian,8097,1,21,11,4,60,21,39,74
Morton,8097,2,16,10,10,47,41,6,58
Falkirk,8097,3,15,11,10,62,50,12,56
Dundee Utd,8097,4,15,11,10,47,39,8,56
Dumbarton,8097,5,12,11,13,52,54,-2,47
Dunfermline,8097,6,10,13,13,49,48,1,43
Queen of S't,8097,7,10,11,15,46,57,-11,41
Raith,8097,8,10,9,17,39,53,-14,39
Ayr,8097,9,9,12,15,34,55,-21,39
St Mirren,8097,10,7,11,18,35,53,-18,32
Hibernian,8098,1,19,10,7,56,29,27,67
Morton,8098,2,18,10,8,56,38,18,64
Falkirk,8098,3,15,13,8,59,43,16,58
Dundee Utd,8098,4,15,10,11,51,44,7,55
Dunfermline,8098,5,10,14,12,44,45,-1,44
Raith,8098,6,11,10,15,37,48,-11,43
Queen of S't,8098,7,10,11,15,46,54,-8,41
St Mirren,8098,8,9,11,16,40,55,-15,38
Dumbarton,8098,9,7,16,13,46,56,-10,37
Ayr,8098,10,7,13,16,33,56,-23,34
Hibernian,8099,1,21,11,4,59,24,35,74
Falkirk,8099,2,16,11,9,56,40,16,59
Morton,8099,3,16,10,10,46,34,12,58
Dundee Utd,8099,4,15,11,10,49,40,9,56
Dunfermline,8099,5,12,12,12,45,41,4,48
Queen of S't,8099,6,11,11,14,43,52,-9,44
Dumbarton,8099,7,9,11,16,47,58,-11,38
St Mirren,8099,8,9,10,17,39,56,-17,37
Ayr,8099,9,9,10,17,38,58,-20,37
Raith,8099,10,9,9,18,35,54,-19,36
Hibernian,8100,1,19,12,5,59,29,30,69
Dundee Utd,8100,2,19,8,9,58,34,24,65
Morton,8100,3,16,11,9,47,40,7,59
Falkirk,8100,4,15,10,11,56,43,13,55
Queen of S't,8100,5,12,10,14,47,50,-3,46
Dunfermline,8100,6,9,14,13,48,51,-3,41
Dumbarton,8100,7,10,10,16,52,63,-11,40
Raith,8100,8,10,10,16,39,52,-13,40
Ayr,8100,9,9,10,17,32,58,-26,37
St Mirren,8100,10,9,9,18,41,59,-18,36
Hibernian,8101,1,19,11,6,58,29,29,68
Morton,8101,2,17,13,6,56,36,20,64
Falkirk,8101,3,17,9,10,64,40,24,60
Dundee Utd,8101,4,16,9,11,54,43,11,57
Dumbarton,8101,5,11,10,15,49,59,-10,43
Dunfermline,8101,6,9,14,13,49,58,-9,41
St Mirren,8101,7,10,10,16,44,56,-12,40
Queen of S't,8101,8,10,9,17,42,58,-16,39
Raith,8101,9,9,11,16,35,53,-18,38
Ayr,8101,10,7,14,15,37,56,-19,35
Hibernian,8102,1,19,14,3,53,21,32,71
Falkirk,8102,2,16,10,10,59,42,17,58
Morton,8102,3,15,13,8,53,38,15,58
Dundee Utd,8102,4,15,9,12,54,42,12,54
Dunfermline,8102,5,11,13,12,50,54,-4,46
Queen of S't,8102,6,11,12,13,42,47,-5,45
Ayr,8102,7,9,13,14,32,54,-22,40
St Mirren,8102,8,9,12,15,44,54,-10,39
Raith,8102,9,8,13,15,33,48,-15,37
Dumbarton,8102,10,7,11,18,45,65,-20,32
Hibernian,8103,1,21,11,4,57,25,32,74
Morton,8103,2,16,12,8,52,40,12,60
Dundee Utd,8103,3,17,8,11,56,42,14,59
Falkirk,8103,4,16,10,10,58,41,17,58
Dunfermline,8103,5,10,14,12,48,49,-1,44
Queen of S't,8103,6,11,9,16,43,52,-9,42
Raith,8103,7,10,11,15,37,48,-11,41
Ayr,8103,8,9,11,16,32,52,-20,38
Dumbarton,8103,9,8,11,17,46,62,-16,35
St Mirren,8103,10,8,11,17,41,59,-18,35
Hibernian,8104,1,19,13,4,54,26,28,70
Dundee Utd,8104,2,18,8,10,54,44,10,62
Falkirk,8104,3,16,10,10,58,41,17,58
Morton,8104,4,15,12,9,47,38,9,57
Queen of S't,8104,5,12,9,15,44,45,-1,45
Dumbarton,8104,6,10,13,13,47,49,-2,43
Raith,8104,7,10,9,17,31,47,-16,39
St Mirren,8104,8,9,11,16,39,53,-14,38
Ayr,8104,9,9,11,16,37,55,-18,38
Dunfermline,8104,10,7,14,15,41,54,-13,35
Hibernian,8105,1,21,11,4,63,30,33,74
Falkirk,8105,2,18,10,8,61,34,27,64
Morton,8105,3,16,14,6,51,35,16,62
Dundee Utd,8105,4,15,11,10,48,39,9,56
Raith,8105,5,11,11,14,38,47,-9,44
Queen of S't,8105,6,11,9,16,48,57,-9,42
Dumbarton,8105,7,9,12,15,46,59,-13,39
Dunfermline,8105,8,7,15,14,38,47,-9,36
Ayr,8105,9,7,13,16,36,58,-22,34
St Mirren,8105,10,7,10,19,40,63,-23,31
Hibernian,8106,1,20,12,4,57,21,36,72
Dundee Utd,8106,2,17,10,9,59,38,21,61
Falkirk,8106,3,15,12,9,59,45,14,57
Morton,8106,4,14,13,9,46,41,5,55
Queen of S't,8106,5,12,11,13,45,49,-4,47
Dumbarton,8106,6,10,13,13,50,56,-6,43
Dunfermline,8106,7,9,12,15,46,49,-3,39
Raith,8106,8,9,11,16,35,53,-18,38
Ayr,8106,9,7,15,14,36,60,-24,36
St Mirren,8106,10,7,11,18,36,57,-21,32
Hibernian,8107,1,19,12,5,53,25,28,69
Morton,8107,2,18,9,9,50,35,15,63
Dundee Utd,8107,3,17,10,9,54,37,17,61
Falkirk,8107,4,14,12,10,57,47,10,54
Dunfermline,8107,5,11,13,12,48,50,-2,46
Raith,8107,6,11,11,14,38,45,-7,44
Dumbarton,8107,7,10,11,15,55,60,-5,41
St Mirren,8107,8,9,10,17,38,58,-20,37
Queen of S't,8107,9,9,9,18,43,57,-14,36
Ayr,8107,10,8,11,17,37,59,-22,35
Hibernian,8108,1,18,15,3,56,26,30,69
Falkirk,8108,2,18,9,9,60,40,20,63
Morton,8108,3,16,13,7,52,42,10,61
Dundee Utd,8108,4,15,10,11,48,42,6,55
Queen of S't,8108,5,11,10,15,44,49,-5,43
Ayr,8108,6,10,12,14,38,51,-13,42
Raith,8108,7,9,12,15,35,48,-13,39
Dunfermline,8108,8,8,14,14,44,52,-8,38
Dumbarton,8108,9,8,13,15,52,62,-10,37
St Mirren,8108,10,7,12,17,40,57,-17,33
Hibernian,8109,1,18,12,6,54,27,27,66
Falkirk,8109,2,17,9,10,67,41,26,60
Morton,8109,3,16,12,8,54,41,13,60
Dundee Utd,8109,4,15,10,11,47,37,10,55
Queen of S't,8109,5,14,8,14,48,49,-1,50
Dunfermline,8109,6,12,12,12,52,52,0,48
Dumbarton,8109,7,10,10,16,49,63,-14,40
Raith,8109,8,10,9,17,39,56,-17,39
St Mirren,8109,9,9,10,17,44,62,-18,37
Ayr,8109,10,7,12,17,32,58,-26,33
Morton,8110,1,17,12,7,50,38,12,63
Dundee Utd,8110,2,18,8,10,60,38,22,62
Hibernian,8110,3,16,14,6,51,29,22,62
Falkirk,8110,4,15,11,10,51,42,9,56
Dunfermline,8110,5,13,11,12,48,43,5,50
Queen of S't,8110,6,10,11,15,44,51,-7,41
Raith,8110,7,10,10,16,32,44,-12,40
St Mirren,8110,8,9,11,16,42,58,-16,38
Ayr,8110,9,9,11,16,38,58,-20,38
Dumbarton,8110,10,7,13,16,45,60,-15,34
Hibernian,8111,1,19,10,7,55,28,27,67
Morton,8111,2,17,10,9,51,38,13,61
Falkirk,8111,3,16,10,10,59,42,17,58
Dundee Utd,8111,4,15,10,11,52,43,9,55
Dumbarton,8111,5,11,12,13,53,53,0,45
Dunfermline,8111,6,11,11,14,46,52,-6,44
Queen of S't,8111,7,11,10,15,46,52,-6,43
Raith,8111,8,11,8,17,36,51,-15,41
Ayr,8111,9,9,12,15,34,55,-21,39
St Mirren,8111,10,8,11,17,37,55,-18,35
Hibernian,8112,1,19,12,5,52,23,29,69
Morton,8112,2,16,13,7,48,35,13,61
Falkirk,8112,3,15,11,10,56,41,15,56
Dundee Utd,8112,4,14,12,10,53,44,9,54
Raith,8112,5,11,10,15,36,46,-10,43
Dunfermline,8112,6,9,13,14,44,50,-6,40
Queen of S't,8112,7,10,10,16,43,53,-10,40
Ayr,8112,8,8,16,12,36,49,-13,40
St Mirren,8112,9,10,10,16,39,54,-15,40
Dumbarton,8112,10,9,11,16,44,56,-12,38
Hibernian,8113,1,20,12,4,57,27,30,72
Falkirk,8113,2,17,10,9,66,40,26,61
Morton,8113,3,16,10,10,50,39,11,58
Dundee Utd,8113,4,14,14,8,52,41,11,56
Queen of S't,8113,5,11,10,15,45,54,-9,43
Dumbarton,8113,6,10,11,15,48,58,-10,41
Raith,8113,7,10,10,16,36,49,-13,40
Dunfermline,8113,8,9,12,15,44,51,-7,39
Ayr,8113,9,8,13,15,38,58,-20,37
St Mirren,8113,10,8,12,16,38,57,-19,36
Hibernian,8114,1,19,13,4,54,25,29,70
Morton,8114,2,17,11,8,56,36,20,62
Falkirk,8114,3,16,9,11,57,43,14,57
Dundee Utd,8114,4,15,9,12,52,42,10,54
Raith,8114,5,12,11,13,36,43,-7,47
Queen of S't,8114,6,11,10,15,45,53,-8,43
Dunfermline,8114,7,9,13,14,43,54,-11,40
Dumbarton,8114,8,10,10,16,47,59,-12,40
St Mirren,8114,9,10,9,17,42,54,-12,39
Ayr,8114,10,8,11,17,33,56,-23,35
Morton,8115,1,18,13,5,54,34,20,67
Hibernian,8115,2,17,14,5,54,28,26,65
Falkirk,8115,3,17,11,8,65,39,26,62
Dundee Utd,8115,4,14,12,10,53,42,11,54
Queen of S't,8115,5,13,9,14,49,52,-3,48
Dunfermline,8115,6,10,12,14,48,52,-4,42
St Mirren,8115,7,10,9,17,43,58,-15,39
Dumbarton,8115,8,9,11,16,45,62,-17,38
Raith,8115,9,9,8,19,30,51,-21,35
Ayr,8115,10,7,13,16,31,54,-23,34
Hibernian,8116,1,19,12,5,52,24,28,69
Falkirk,8116,2,17,10,9,61,39,22,61
Dundee Utd,8116,3,16,9,11,51,38,13,57
Morton,8116,4,14,12,10,49,43,6,54
Raith,8116,5,13,9,14,40,48,-8,48
Queen of S't,8116,6,12,10,14,44,49,-5,46
Dumbarton,8116,7,10,12,14,50,56,-6,42
Dunfermline,8116,8,8,14,14,47,56,-9,38
Ayr,8116,9,8,13,15,33,55,-22,37
St Mirren,8116,10,7,11,18,39,58,-19,32
Hibernian,8117,1,16,14,6,56,30,26,62
Falkirk,8117,2,16,11,9,60,41,19,59
Morton,8117,3,15,14,7,49,39,10,59
Dundee Utd,8117,4,15,10,11,55,45,10,55
Dunfermline,8117,5,10,14,12,48,52,-4,44
Ayr,8117,6,10,14,12,39,50,-11,44
Queen of S't,8117,7,10,11,15,43,52,-9,41
Raith,8117,8,10,11,15,33,44,-11,41
Dumbarton,8117,9,9,12,15,48,57,-9,39
St Mirren,8117,10,9,9,18,39,60,-21,36
Hibernian,8118,1,21,11,4,62,24,38,74
Morton,8118,2,15,13,8,48,38,10,58
Dundee Utd,8118,3,15,11,10,48,37,11,56
Falkirk,8118,4,15,10,11,54,41,13,55
Dunfermline,8118,5,11,13,12,46,46,0,46
Queen of S't,8118,6,11,10,15,48,54,-6,43
Raith,8118,7,10,9,17,39,52,-13,39
St Mirren,8118,8,10,9,17,44,59,-15,39
Ayr,8118,9,9,12,15,35,56,-21,39
Dumbarton,8118,10,8,12,16,43,60,-17,36
Hibernian,8119,1,17,13,6,55,31,24,64
Morton,8119,2,18,10,8,57,39,18,64
Falkirk,8119,3,16,12,8,60,41,19,60
Dundee Utd,8119,4,16,9,11,52,43,9,57
Queen of S't,8119,5,12,9,15,46,48,-2,45
Ayr,8119,6,11,10,15,42,54,-12,43
Dunfermline,8119,7,9,12,15,47,58,-11,39
Dumbarton,8119,8,9,12,15,46,59,-13,39
St Mirren,8119,9,8,13,15,37,52,-15,37
Raith,8119,10,9,10,17,34,51,-17,37
Falkirk,8120,1,20,9,7,61,33,28,69
Hibernian,8120,2,19,12,5,55,28,27,69
Morton,8120,3,18,12,6,59,40,19,66
Dundee Utd,8120,4,16,9,11,54,40,14,57
Queen of S't,8120,5,13,9,14,47,52,-5,48
Dunfermline,8120,6,9,13,14,43,50,-7,40
Dumbarton,8120,7,9,10,17,48,61,-13,37
St Mirren,8120,8,9,9,18,48,63,-15,36
Raith,8120,9,8,10,18,34,53,-19,34
Ayr,8120,10,6,13,17,34,63,-29,31
Hibernian,8121,1,18,12,6,58,31,27,66
Morton,8121,2,16,12,8,52,36,16,60
Dundee Utd,8121,3,16,11,9,52,40,12,59
Falkirk,8121,4,16,10,10,55,42,13,58
Raith,8121,5,12,9,15,38,49,-11,45
Dumbarton,8121,6,10,12,14,53,62,-9,42
Queen of S't,8121,7,10,10,16,42,52,-10,40
St Mirren,8121,8,9,12,15,42,54,-12,39
Ayr,8121,9,8,14,14,35,53,-18,38
Dunfermline,8121,10,8,12,16,43,51,-8,36
Hibernian,8122,1,20,10,6,57,28,29,70
Morton,8122,2,17,13,6,55,37,18,64
Falkirk,8122,3,16,11,9,56,38,18,59
Dundee Utd,8122,4,16,11,9,52,38,14,59
Queen of S't,8122,5,12,8,16,45,54,-9,44
St Mirren,8122,6,10,11,15,45,53,-8,41
Dumbarton,8122,7,10,10,16,46,58,-12,40
Raith,8122,8,10,10,16,32,49,-17,40
Dunfermline,8122,9,8,12,16,45,53,-8,36
Ayr,8122,10,7,12,17,31,56,-25,33
Hibernian,8123,1,19,12,5,56,23,33,69
Morton,8123,2,17,13,6,47,29,18,64
Falkirk,8123,3,15,11,10,55,42,13,56
Dundee Utd,8123,4,13,10,13,46,43,3,49
Queen of S't,8123,5,13,9,14,50,53,-3,48
Dunfermline,8123,6,10,14,12,44,45,-1,44
Dumbarton,8123,7,11,11,14,49,57,-8,44
Raith,8123,8,9,11,16,37,54,-17,38
Ayr,8123,9,9,10,17,36,58,-22,37
St Mirren,8123,10,8,11,17,40,56,-16,35
Hibernian,8124,1,21,11,4,56,21,35,74
Morton,8124,2,15,13,8,48,38,10,58
Dundee Utd,8124,3,14,13,9,44,34,10,55
Falkirk,8124,4,14,10,12,51,43,8,52
Queen of S't,8124,5,11,12,13,46,50,-4,45
Dunfermline,8124,6,10,13,13,46,47,-1,43
Dumbarton,8124,7,9,14,13,50,54,-4,41
Raith,8124,8,10,10,16,36,53,-17,40
Ayr,8124,9,7,15,14,32,53,-21,36
St Mirren,8124,10,8,11,17,39,55,-16,35
Hibernian,8125,1,20,11,5,58,24,34,71
Dundee Utd,8125,2,16,10,10,55,42,13,58
Morton,8125,3,16,10,10,51,39,12,58
Falkirk,8125,4,14,12,10,57,46,11,54
Dunfermline,8125,5,12,12,12,50,50,0,48
Raith,8125,6,11,10,15,40,48,-8,43
Queen of S't,8125,7,11,10,15,49,60,-11,43
Dumbarton,8125,8,8,13,15,45,59,-14,37
St Mirren,8125,9,9,10,17,43,61,-18,37
Ayr,8125,10,8,12,16,37,56,-19,36
Hibernian,8126,1,20,10,6,55,27,28,70
Morton,8126,2,17,12,7,49,36,13,63
Dundee Utd,8126,3,16,10,10,48,39,9,58
Falkirk,8126,4,15,12,9,60,40,20,57
Dunfermline,8126,5,11,12,13,44,44,0,45
Queen of S't,8126,6,11,11,14,47,49,-2,44
Ayr,8126,7,10,12,14,37,51,-14,42
Raith,8126,8,10,8,18,33,54,-21,38
St Mirren,8126,9,8,10,18,39,55,-16,34
Dumbarton,8126,10,7,13,16,44,61,-17,34
Hibernian,8127,1,21,11,4,56,23,33,74
Dundee Utd,8127,2,17,10,9,55,39,16,61
Falkirk,8127,3,17,9,10,58,42,16,60
Morton,8127,4,15,10,11,46,36,10,55
Dunfermline,8127,5,12,11,13,47,47,0,47
Queen of S't,8127,6,11,9,16,46,51,-5,42
Raith,8127,7,11,9,16,35,53,-18,42
St Mirren,8127,8,9,10,17,43,54,-11,37
Ayr,8127,9,8,12,16,34,58,-24,36
Dumbarton,8127,10,8,11,17,45,62,-17,35
Hibernian,8128,1,20,12,4,62,26,36,72
Morton,8128,2,16,13,7,49,37,12,61
Dundee Utd,8128,3,16,9,11,53,42,11,57
Falkirk,8128,4,14,11,11,52,43,9,53
Queen of S't,8128,5,12,10,14,52,48,4,46
Raith,8128,6,12,8,16,36,44,-8,44
Dunfermline,8128,7,10,11,15,43,51,-8,41
St Mirren,8128,8,9,11,16,41,58,-17,38
Dumbarton,8128,9,8,13,15,46,58,-12,37
Ayr,8128,10,8,12,16,39,66,-27,36
Hibernian,8129,1,18,12,6,50,23,27,66
Falkirk,8129,2,17,11,8,61,39,22,62
Morton,8129,3,15,13,8,47,37,10,58
Dundee Utd,8129,4,15,11,10,49,40,9,56
Queen of S't,8129,5,14,8,14,47,48,-1,50
Dunfermline,8129,6,11,12,13,44,47,-3,45
Dumbarton,8129,7,9,12,15,51,62,-11,39
Raith,8129,8,10,9,17,35,50,-15,39
St Mirren,8129,9,8,12,16,41,56,-15,36
Ayr,8129,10,7,12,17,35,58,-23,33
Hibernian,8130,1,18,15,3,53,22,31,69
Dundee Utd,8130,2,18,9,9,52,37,15,63
Morton,8130,3,16,13,7,52,35,17,61
Falkirk,8130,4,16,10,10,57,40,17,58
Queen of S't,8130,5,12,9,15,44,51,-7,45
Dumbarton,8130,6,10,11,15,57,64,-7,41
St Mirren,8130,7,9,12,15,41,55,-14,39
Raith,8130,8,10,9,17,32,49,-17,39
Dunfermline,8130,9,8,12,16,44,56,-12,36
Ayr,8130,10,7,12,17,32,55,-23,33
Hibernian,8131,1,18,13,5,51,26,25,67
Morton,8131,2,19,10,7,56,34,22,67
Falkirk,8131,3,18,10,8,60,37,23,64
Dundee Utd,8131,4,15,10,11,43,38,5,55
Queen of S't,8131,5,13,9,14,47,47,0,48
Ayr,8131,6,10,12,14,35,50,-15,42
Dunfermline,8131,7,9,13,14,47,50,-3,40
Raith,8131,8,8,13,15,36,52,-16,37
St Mirren,8131,9,7,12,17,38,58,-20,33
Dumbarton,8131,10,7,10,19,46,67,-21,31
Hibernian,8132,1,19,11,6,56,30,26,68
Morton,8132,2,16,12,8,54,40,14,60
Falkirk,8132,3,15,11,10,60,44,16,56
Dundee Utd,8132,4,14,11,11,49,42,7,53
Queen of S't,8132,5,12,12,12,45,46,-1,48
Dunfermline,8132,6,10,13,13,49,50,-1,43
Raith,8132,7,11,10,15,40,53,-13,43
Dumbarton,8132,8,10,11,15,50,57,-7,41
Ayr,8132,9,10,11,15,34,54,-20,41
St Mirren,8132,10,7,10,19,39,60,-21,31
Hibernian,8133,1,19,12,5,59,28,31,69
Morton,8133,2,18,11,7,50,32,18,65
Falkirk,8133,3,15,12,9,55,39,16,57
Dundee Utd,8133,4,15,11,10,50,41,9,56
Raith,8133,5,13,8,15,37,43,-6,47
Dunfermline,8133,6,11,11,14,46,45,1,44
Dumbarton,8133,7,11,10,15,49,58,-9,43
Queen of S't,8133,8,11,10,15,45,55,-10,43
Ayr,8133,9,8,11,17,37,62,-25,35
St Mirren,8133,10,6,10,20,35,60,-25,28
Hibernian,8134,1,19,12,5,54,27,27,69
Morton,8134,2,18,10,8,56,36,20,64
Dundee Utd,8134,3,17,8,11,54,42,12,59
Falkirk,8134,4,16,10,10,61,43,18,58
Queen of S't,8134,5,12,9,15,48,52,-4,45
Dumbarton,8134,6,10,11,15,46,55,-9,41
Raith,8134,7,10,10,16,33,48,-15,40
Dunfermline,8134,8,9,11,16,47,55,-8,38
Ayr,8134,9,8,13,15,34,58,-24,37
St Mirren,8134,10,7,14,15,38,55,-17,35
Hibernian,8135,1,19,14,3,57,22,35,71
Morton,8135,2,18,10,8,51,33,18,64
Falkirk,8135,3,14,12,10,55,41,14,54
Dundee Utd,8135,4,13,10,13,49,48,1,49
Dumbarton,8135,5,12,11,13,51,53,-2,47
Dunfermline,8135,6,11,12,13,48,45,3,45
Queen of S't,8135,7,11,12,13,44,50,-6,45
Ayr,8135,8,9,12,15,40,58,-18,39
Raith,8135,9,10,9,17,32,57,-25,39
St Mirren,8135,10,7,10,19,34,54,-20,31
Hibernian,8136,1,19,13,4,58,25,33,70
Morton,8136,2,18,12,6,53,34,19,66
Falkirk,8136,3,16,10,10,59,47,12,58
Dundee Utd,8136,4,15,10,11,54,40,14,55
Queen of S't,8136,5,12,9,15,43,54,-11,45
Dunfermline,8136,6,10,14,12,48,46,2,44
Raith,8136,7,10,11,15,35,46,-11,41
Dumbarton,8136,8,8,11,17,47,62,-15,35
St Mirren,8136,9,7,14,15,39,55,-16,35
Ayr,8136,10,7,12,17,33,60,-27,33
Hibernian,8137,1,21,11,4,67,31,36,74
Dundee Utd,8137,2,17,10,9,55,38,17,61
Morton,8137,3,15,11,10,46,41,5,56
Falkirk,8137,4,13,11,12,52,45,7,50
Queen of S't,8137,5,13,9,14,48,47,1,48
Dunfermline,8137,6,12,11,13,48,47,1,47
Raith,8137,7,10,13,13,36,45,-9,43
Dumbarton,8137,8,8,12,16,45,63,-18,36
St Mirren,8137,9,8,11,17,43,60,-17,35
Ayr,8137,10,8,11,17,37,60,-23,35
Hibernian,8138,1,18,14,4,50,22,28,68
Falkirk,8138,2,17,12,7,64,35,29,63
Morton,8138,3,17,12,7,51,35,16,63
Dundee Utd,8138,4,17,10,9,55,38,17,61
Queen of S't,8138,5,12,10,14,46,54,-8,46
Raith,8138,6,11,8,17,34,49,-15,41
Dunfermline,8138,7,8,13,15,43,52,-9,37
Dumbarton,8138,8,8,13,15,46,58,-12,37
St Mirren,8138,9,9,9,18,37,55,-18,36
Ayr,8138,10,6,13,17,35,63,-28,31
Hibernian,8139,1,19,10,7,58,29,29,67
Morton,8139,2,18,11,7,56,38,18,65
Falkirk,8139,3,15,11,10,62,49,13,56
Dundee Utd,8139,4,16,8,12,54,43,11,56
Queen of S't,8139,5,13,9,14,47,49,-2,48
Dunfermline,8139,6,11,13,12,43,43,0,46
St Mirren,8139,7,11,10,15,46,54,-8,43
Raith,8139,8,9,10,17,31,48,-17,37
Ayr,8139,9,8,11,17,31,55,-24,35
Dumbarton,8139,10,7,13,16,45,65,-20,34
Hibernian,8140,1,18,14,4,57,24,33,68
Morton,8140,2,17,11,8,50,36,14,62
Falkirk,8140,3,16,13,7,61,39,22,61
Dundee Utd,8140,4,14,11,11,49,43,6,53
Queen of S't,8140,5,12,9,15,50,56,-6,45
Raith,8140,6,11,10,15,41,52,-11,43
Dumbarton,8140,7,10,12,14,49,59,-10,42
Dunfermline,8140,8,8,15,13,48,53,-5,39
Ayr,8140,9,8,12,16,29,52,-23,36
St Mirren,8140,10,8,9,19,37,57,-20,33
Hibernian,8141,1,17,14,5,54,26,28,65
Morton,8141,2,14,14,8,48,39,9,56
Falkirk,8141,3,14,12,10,52,42,10,54
Dundee Utd,8141,4,14,10,12,49,42,7,52
Queen of S't,8141,5,13,11,12,47,47,0,50
Dumbarton,8141,6,12,10,14,48,57,-9,46
Raith,8141,7,10,12,14,37,51,-14,42
Ayr,8141,8,10,10,16,34,52,-18,40
Dunfermline,8141,9,8,15,13,44,48,-4,39
St Mirren,8141,10,9,10,17,43,52,-9,37
Hibernian,8142,1,21,11,4,61,27,34,74
Falkirk,8142,2,17,9,10,60,42,18,60
Dundee Utd,8142,3,17,8,11,55,44,11,59
Morton,8142,4,15,12,9,47,37,10,57
Raith,8142,5,12,9,15,39,48,-9,45
Dunfermline,8142,6,9,14,13,46,52,-6,41
Queen of S't,8142,7,10,9,17,43,53,-10,39
Dumbarton,8142,8,8,13,15,48,61,-13,37
Ayr,8142,9,8,13,15,34,55,-21,37
St Mirren,8142,10,8,12,16,42,56,-14,36
Hibernian,8143,1,17,13,6,50,25,25,64
Falkirk,8143,2,17,11,8,61,39,22,62
Morton,8143,3,15,11,10,45,40,5,56
Dundee Utd,8143,4,15,10,11,50,42,8,55
Queen of S't,8143,5,12,10,14,45,52,-7,46
Dunfermline,8143,6,9,14,13,48,51,-3,41
Raith,8143,7,10,11,15,38,47,-9,41
St Mirren,8143,8,10,10,16,39,53,-14,40
Dumbarton,8143,9,9,12,15,51,57,-6,39
Ayr,8143,10,8,14,14,35,56,-21,38
Hibernian,8144,1,18,12,6,52,25,27,66
Morton,8144,2,15,12,9,47,36,11,57
Falkirk,8144,3,15,10,11,51,36,15,55
Dundee Utd,8144,4,12,12,12,42,40,2,48
Dunfermline,8144,5,11,13,12,49,51,-2,46
Queen of S't,8144,6,12,10,14,46,50,-4,46
Ayr,8144,7,11,11,14,34,49,-15,44
Dumbarton,8144,8,11,10,15,47,56,-9,43
Raith,8144,9,11,10,15,34,44,-10,43
St Mirren,8144,10,8,12,16,37,52,-15,36
Hibernian,8145,1,22,10,4,59,24,35,76
Morton,8145,2,18,9,9,47,34,13,63
Falkirk,8145,3,16,9,11,57,44,13,57
Dundee Utd,8145,4,14,11,11,45,37,8,53
Dunfermline,8145,5,11,12,13,46,46,0,45
Queen of S't,8145,6,12,9,15,43,49,-6,45
Dumbarton,8145,7,10,11,15,51,60,-9,41
Ayr,8145,8,9,12,15,35,54,-19,39
St Mirren,8145,9,9,11,16,46,55,-9,38
Raith,8145,10,8,8,20,32,58,-26,32
Hibernian,8146,1,21,10,5,57,26,31,73
Morton,8146,2,18,10,8,53,36,17,64
Falkirk,8146,3,18,9,9,59,39,20,63
Dundee Utd,8146,4,13,11,12,46,42,4,50
Dunfermline,8146,5,10,12,14,46,51,-5,42
Queen of S't,8146,6,10,10,16,42,50,-8,40
St Mirren,8146,7,10,10,16,40,54,-14,40
Raith,8146,8,10,9,17,35,51,-16,39
Dumbarton,8146,9,9,11,16,46,58,-12,38
Ayr,8146,10,8,14,14,33,50,-17,38
Hibernian,8147,1,19,14,3,58,24,34,71
Dundee Utd,8147,2,17,10,9,57,38,19,61
Falkirk,8147,3,15,13,8,58,41,17,58
Morton,8147,4,15,13,8,56,41,15,58
Queen of S't,8147,5,12,10,14,45,46,-1,46
Ayr,8147,6,10,13,13,37,52,-15,43
Dunfermline,8147,7,8,14,14,44,56,-12,38
Dumbarton,8147,8,8,13,15,49,59,-10,37
Raith,8147,9,9,9,18,31,53,-22,36
St Mirren,8147,10,7,11,18,38,63,-25,32
Hibernian,8148,1,18,14,4,56,27,29,68
Morton,8148,2,17,14,5,52,36,16,65
Dundee Utd,8148,3,17,9,10,57,41,16,60
Falkirk,8148,4,15,12,9,59,45,14,57
Dunfermline,8148,5,8,16,12,44,49,-5,40
Raith,8148,6,9,13,14,38,52,-14,40
Queen of S't,8148,7,10,9,17,46,53,-7,39
Ayr,8148,8,9,11,16,41,60,-19,38
St Mirren,8148,9,8,12,16,45,57,-12,36
Dumbarton,8148,10,8,12,16,46,64,-18,36
Hibernian,8149,1,20,13,3,56,21,35,73
Morton,8149,2,16,11,9,47,35,12,59
Dundee Utd,8149,3,16,9,11,54,42,12,57
Falkirk,8149,4,15,11,10,59,44,15,56
Dumbarton,8149,5,11,11,14,52,55,-3,44
Queen of S't,8149,6,11,8,17,44,55,-11,41
Raith,8149,7,10,11,15,33,45,-12,41
St Mirren,8149,8,9,12,15,45,56,-11,39
Ayr,8149,9,9,12,15,33,58,-25,39
Dunfermline,8149,10,8,12,16,42,54,-12,36
Hibernian,8150,1,22,11,3,60,26,34,77
Falkirk,8150,2,17,10,9,61,43,18,61
Morton,8150,3,16,12,8,52,41,11,60
Dundee Utd,8150,4,15,9,12,55,47,8,54
Queen of S't,8150,5,12,9,15,48,52,-4,45
Dunfermline,8150,6,10,13,13,47,47,0,43
Raith,8150,7,10,9,17,37,47,-10,39
Dumbarton,8150,8,9,12,15,45,57,-12,39
Ayr,8150,9,8,12,16,34,54,-20,36
St Mirren,8150,10,8,9,19,37,62,-25,33
Hibernian,8151,1,18,12,6,53,30,23,66
Morton,8151,2,18,12,6,51,33,18,66
Falkirk,8151,3,17,11,8,60,40,20,62
Dundee Utd,8151,4,14,11,11,48,40,8,53
Queen of S't,8151,5,12,9,15,48,50,-2,45
Raith,8151,6,11,10,15,41,50,-9,43
Dunfermline,8151,7,8,14,14,42,50,-8,38
Dumbarton,8151,8,8,14,14,49,60,-11,38
Ayr,8151,9,8,13,15,36,59,-23,37
St Mirren,8151,10,7,12,17,40,56,-16,33
Hibernian,8152,1,20,12,4,57,25,32,72
Morton,8152,2,18,12,6,56,36,20,66
Falkirk,8152,3,16,10,10,61,44,17,58
Dundee Utd,8152,4,16,10,10,54,42,12,58
Queen of S't,8152,5,10,12,14,41,48,-7,42
Dunfermline,8152,6,9,13,14,47,49,-2,40
Raith,8152,7,9,11,16,33,49,-16,38
Dumbarton,8152,8,8,13,15,45,58,-13,37
Ayr,8152,9,7,16,13,35,53,-18,37
St Mirren,8152,10,6,13,17,39,64,-25,31
Morton,8153,1,18,12,6,55,34,21,66
Hibernian,8153,2,17,14,5,55,26,29,65
Falkirk,8153,3,14,12,10,57,44,13,54
Dundee Utd,8153,4,14,12,10,48,41,7,54
Dunfermline,8153,5,11,14,11,49,49,0,47
Queen of S't,8153,6,12,10,14,48,53,-5,46
Dumbarton,8153,7,8,15,13,48,55,-7,39
St Mirren,8153,8,8,13,15,42,54,-12,37
Raith,8153,9,9,9,18,30,52,-22,36
Ayr,8153,10,7,13,16,31,55,-24,34
Hibernian,8154,1,18,14,4,60,32,28,68
Morton,8154,2,17,10,9,51,39,12,61
Dundee Utd,8154,3,14,12,10,50,42,8,54
Falkirk,8154,4,13,14,9,60,46,14,53
Queen of S't,8154,5,12,9,15,48,53,-5,45
Dunfermline,8154,6,9,15,12,46,48,-2,42
Raith,8154,7,10,11,15,35,50,-15,41
Ayr,8154,8,9,13,14,36,53,-17,40
St Mirren,8154,9,8,13,15,43,54,-11,37
Dumbarton,8154,10,8,13,15,44,56,-12,37
Hibernian,8155,1,19,11,6,55,32,23,68
Morton,8155,2,15,11,10,49,39,10,56
Falkirk,8155,3,14,13,9,60,42,18,55
Dundee Utd,8155,4,15,8,13,49,47,2,53
Queen of S't,8155,5,12,12,12,48,49,-1,48
Dunfermline,8155,6,11,14,11,46,46,0,47
Ayr,8155,7,10,11,15,37,52,-15,41
St Mirren,8155,8,10,10,16,50,57,-7,40
Dumbarton,8155,9,9,11,16,49,60,-11,38
Raith,8155,10,9,11,16,32,51,-19,38
Hibernian,8156,1,23,10,3,65,23,42,79
Falkirk,8156,2,16,12,8,57,38,19,60
Morton,8156,3,16,12,8,53,39,14,60
Dundee Utd,8156,4,14,10,12,47,44,3,52
Dunfermline,8156,5,11,12,13,47,50,-3,45
Queen of S't,8156,6,12,9,15,45,49,-4,45
St Mirren,8156,7,8,13,15,43,54,-11,37
Dumbarton,8156,8,8,12,16,45,61,-16,36
Raith,8156,9,8,12,16,32,51,-19,36
Ayr,8156,10,8,10,18,36,61,-25,34
Hibernian,8157,1,18,14,4,54,24,30,68
Morton,8157,2,17,12,7,56,37,19,63
Falkirk,8157,3,15,12,9,59,43,16,57
Dundee Utd,8157,4,14,13,9,53,45,8,55
Dumbarton,8157,5,11,12,13,54,56,-2,45
Queen of S't,8157,6,10,13,13,43,49,-6,43
Dunfermline,8157,7,8,15,13,45,50,-5,39
Raith,8157,8,9,11,16,31,50,-19,38
Ayr,8157,9,6,16,14,32,53,-21,34
St Mirren,8157,10,6,14,16,37,57,-20,32
Hibernian,8158,1,19,13,4,54,23,31,70
Dundee Utd,8158,2,17,9,10,56,41,15,60
Morton,8158,3,15,13,8,46,34,12,58
Falkirk,8158,4,15,12,9,56,40,16,57
Dunfermline,8158,5,11,14,11,53,45,8,47
Raith,8158,6,11,11,14,35,45,-10,44
Dumbarton,8158,7,10,12,14,44,58,-14,42
Queen of S't,8158,8,10,10,16,41,52,-11,40
Ayr,8158,9,7,12,17,32,58,-26,33
St Mirren,8158,10,7,10,19,36,57,-21,31
Hibernian,8159,1,19,12,5,55,25,30,69
Morton,8159,2,17,12,7,48,33,15,63
Falkirk,8159,3,17,10,9,61,41,20,61
Dundee Utd,8159,4,16,9,11,51,41,10,57
Queen of S't,8159,5,12,9,15,45,49,-4,45
Raith,8159,6,10,11,15,37,49,-12,41
Dunfermline,8159,7,9,13,14,44,48,-4,40
Dumbarton,8159,8,9,11,16,45,59,-14,38
St Mirren,8159,9,8,12,16,39,54,-15,36
Ayr,8159,10,8,11,17,33,59,-26,35
Hibernian,8160,1,20,12,4,60,29,31,72
Morton,8160,2,16,13,7,51,40,11,61
Falkirk,8160,3,16,10,10,62,45,17,58
Dundee Utd,8160,4,14,10,12,46,46,0,52
Queen of S't,8160,5,12,10,14,47,55,-8,46
St Mirren,8160,6,11,10,15,45,52,-7,43
Dunfermline,8160,7,9,14,13,51,51,0,41
Dumbarton,8160,8,10,11,15,53,59,-6,41
Raith,8160,9,10,9,17,37,51,-14,39
Ayr,8160,10,7,11,18,35,59,-24,32
Hibernian,8161,1,18,11,7,58,31,27,65
Morton,8161,2,18,11,7,52,36,16,65
Falkirk,8161,3,17,10,9,67,44,23,61
Dunfermline,8161,4,13,12,11,51,44,7,51
Dundee Utd,8161,5,14,8,14,46,48,-2,50
Queen of S't,8161,6,12,8,16,49,57,-8,44
Ayr,8161,7,10,11,15,37,52,-15,41
Dumbarton,8161,8,9,13,14,51,57,-6,40
Raith,8161,9,10,10,16,34,48,-14,40
St Mirren,8161,10,6,12,18,37,65,-28,30
Hibernian,8162,1,19,13,4,55,24,31,70
Morton,8162,2,16,12,8,47,40,7,60
Dundee Utd,8162,3,15,10,11,46,38,8,55
Falkirk,8162,4,14,11,11,59,40,19,53
Queen of S't,8162,5,13,10,13,45,51,-6,49
Dunfermline,8162,6,9,16,11,44,42,2,43
Ayr,8162,7,10,11,15,35,55,-20,41
St Mirren,8162,8,10,9,17,40,54,-14,39
Dumbarton,8162,9,9,11,16,47,58,-11,38
Raith,8162,10,8,11,17,31,47,-16,35
Hibernian,8163,1,19,13,4,63,27,36,70
Dundee Utd,8163,2,17,10,9,52,37,15,61
Falkirk,8163,3,15,14,7,61,41,20,59
Morton,8163,4,16,11,9,49,39,10,59
Dunfermline,8163,5,11,11,14,44,49,-5,44
Queen of S't,8163,6,10,11,15,39,47,-8,41
Raith,8163,7,10,11,15,35,49,-14,41
St Mirren,8163,8,9,10,17,41,58,-17,37
Dumbarton,8163,9,8,12,16,46,61,-15,36
Ayr,8163,10,8,11,17,35,57,-22,35
Hibernian,8164,1,20,12,4,59,24,35,72
Dundee Utd,8164,2,17,9,10,56,42,14,60
Morton,8164,3,15,10,11,48,41,7,55
Falkirk,8164,4,14,11,11,54,46,8,53
Dunfermline,8164,5,12,12,12,47,47,0,48
Queen of S't,8164,6,12,10,14,46,48,-2,46
Raith,8164,7,12,9,15,36,44,-8,45
Dumbarton,8164,8,9,11,16,44,61,-17,38
St Mirren,8164,9,8,11,17,42,55,-13,35
Ayr,8164,10,8,11,17,30,54,-24,35
Hibernian,8165,1,19,10,7,58,31,27,67
Morton,8165,2,18,9,9,47,39,8,63
Falkirk,8165,3,16,10,10,57,42,15,58
Dundee Utd,8165,4,15,13,8,47,34,13,58
Raith,8165,5,13,10,13,43,46,-3,49
Dumbarton,8165,6,10,11,15,46,55,-9,41
Dunfermline,8165,7,9,13,14,45,46,-1,40
Queen of S't,8165,8,10,10,16,40,50,-10,40
Ayr,8165,9,8,14,14,34,54,-20,38
St Mirren,8165,10,7,10,19,39,59,-20,31
Hibernian,8166,1,21,10,5,59,25,34,73
Morton,8166,2,16,12,8,56,44,12,60
Falkirk,8166,3,16,11,9,57,39,18,59
Dundee Utd,8166,4,14,9,13,46,43,3,51
Dunfermline,8166,5,12,13,11,49,47,2,49
St Mirren,8166,6,10,10,16,45,55,-10,40
Queen of S't,8166,7,10,10,16,40,51,-11,40
Raith,8166,8,9,12,15,33,47,-14,39
Dumbarton,8166,9,9,11,16,50,60,-10,38
Ayr,8166,10,8,12,16,36,60,-24,36
Hibernian,8167,1,20,12,4,54,23,31,72
Dundee Utd,8167,2,17,9,10,54,42,12,60
Morton,8167,3,15,14,7,48,35,13,59
Falkirk,8167,4,16,10,10,61,41,20,58
Dunfermline,8167,5,10,14,12,50,50,0,44
Dumbarton,8167,6,11,11,14,49,54,-5,44
Queen of S't,8167,7,11,9,16,46,54,-8,42
Raith,8167,8,11,9,16,35,54,-19,42
Ayr,8167,9,7,13,16,34,57,-23,34
St Mirren,8167,10,6,11,19,35,56,-21,29
Hibernian,8168,1,20,11,5,57,25,32,71
Morton,8168,2,18,11,7,56,38,18,65
Falkirk,8168,3,16,9,11,60,45,15,57
Dundee Utd,8168,4,16,8,12,53,46,7,56
Queen of S't,8168,5,13,9,14,54,54,0,48
Dumbarton,8168,6,11,10,15,53,61,-8,43
Dunfermline,8168,7,10,12,14,49,54,-5,42
Raith,8168,8,10,8,18,37,54,-17,38
Ayr,8168,9,9,11,16,36,59,-23,38
St Mirren,8168,10,8,9,19,38,57,-19,33
Morton,8169,1,20,10,6,55,36,19,70
Hibernian,8169,2,17,12,7,54,30,24,63
Dundee Utd,8169,3,14,12,10,48,40,8,54
Falkirk,8169,4,13,11,12,52,44,8,50
Dunfermline,8169,5,11,13,12,55,51,4,46
Queen of S't,8169,6,12,9,15,48,55,-7,45
St Mirren,8169,7,11,11,14,47,51,-4,44
Raith,8169,8,11,9,16,35,48,-13,42
Dumbarton,8169,9,9,11,16,44,57,-13,38
Ayr,8169,10,6,14,16,31,57,-26,32
Hibernian,8170,1,20,12,4,57,27,30,72
Morton,8170,2,18,11,7,51,34,17,65
Dundee Utd,8170,3,17,10,9,48,37,11,61
Falkirk,8170,4,15,13,8,56,38,18,58
St Mirren,8170,5,11,10,15,48,54,-6,43
Dunfermline,8170,6,9,15,12,42,42,0,42
Ayr,8170,7,9,10,17,34,56,-22,37
Queen of S't,8170,8,9,9,18,39,54,-15,36
Dumbarton,8170,9,8,11,17,48,62,-14,35
Raith,8170,10,8,11,17,31,50,-19,35
Hibernian,8171,1,20,11,5,60,27,33,71
Falkirk,8171,2,17,10,9,60,41,19,61
Morton,8171,3,17,10,9,51,43,8,61
Dundee Utd,8171,4,16,10,10,54,41,13,58
Queen of S't,8171,5,12,10,14,49,49,0,46
Raith,8171,6,11,9,16,38,51,-13,42
Dunfermline,8171,7,9,13,14,48,54,-6,40
Dumbarton,8171,8,9,11,16,50,62,-12,38
St Mirren,8171,9,9,10,17,42,60,-18,37
Ayr,8171,10,7,12,17,34,58,-24,33
Hibernian,8172,1,18,12,6,54,28,26,66
Morton,8172,2,17,10,9,51,36,15,61
Falkirk,8172,3,16,12,8,62,43,19,60
Dundee Utd,8172,4,17,9,10,52,38,14,60
Ayr,8172,5,12,11,13,36,50,-14,47
Queen of S't,8172,6,11,10,15,47,53,-6,43
Dumbarton,8172,7,8,14,14,44,54,-10,38
St Mirren,8172,8,9,10,17,41,54,-13,37
Dunfermline,8172,9,7,15,14,46,57,-11,36
Raith,8172,10,9,9,18,32,52,-20,36
Hibernian,8173,1,19,12,5,56,26,30,69
Morton,8173,2,17,11,8,46,32,14,62
Dundee Utd,8173,3,17,8,11,52,40,12,59
Falkirk,8173,4,15,11,10,59,43,16,56
Queen of S't,8173,5,13,9,14,47,51,-4,48
Raith,8173,6,12,8,16,42,51,-9,44
Dunfermline,8173,7,10,12,14,46,52,-6,42
Dumbarton,8173,8,10,12,14,51,58,-7,42
St Mirren,8173,9,7,12,17,36,55,-19,33
Ayr,8173,10,6,13,17,32,59,-27,31
Hibernian,8174,1,20,13,3,60,23,37,73
Morton,8174,2,17,11,8,49,36,13,62
Falkirk,8174,3,15,11,10,58,41,17,56
Dundee Utd,8174,4,15,10,11,47,41,6,55
Queen of S't,8174,5,13,9,14,51,49,2,48
Dunfermline,8174,6,9,14,13,43,47,-4,41
Dumbarton,8174,7,9,13,14,49,57,-8,40
St Mirren,8174,8,9,10,17,43,61,-18,37
Raith,8174,9,9,9,18,33,54,-21,36
Ayr,8174,10,7,14,15,32,56,-24,35
Hibernian,8175,1,19,14,3,54,21,33,71
Morton,8175,2,17,12,7,50,34,16,63
Dundee Utd,8175,3,18,9,9,56,41,15,63
Falkirk,8175,4,17,10,9,65,45,20,61
Queen of S't,8175,5,11,9,16,44,52,-8,42
Raith,8175,6,10,12,14,33,44,-11,42
Dumbarton,8175,7,10,11,15,50,60,-10,41
Dunfermline,8175,8,9,12,15,44,52,-8,39
St Mirren,8175,9,8,11,17,42,62,-20,35
Ayr,8175,10,6,10,20,31,58,-27,28
Hibernian,8176,1,19,13,4,54,24,30,70
Falkirk,8176,2,17,11,8,66,41,25,62
Morton,8176,3,15,12,9,47,35,12,57
Dundee Utd,8176,4,15,11,10,48,38,10,56
Queen of S't,8176,5,13,8,15,46,52,-6,47
Dumbarton,8176,6,11,11,14,51,60,-9,44
Dunfermline,8176,7,8,15,13,48,53,-5,39
Ayr,8176,8,9,12,15,33,55,-22,39
Raith,8176,9,8,12,16,32,47,-15,36
St Mirren,8176,10,7,11,18,35,55,-20,32
Hibernian,8177,1,18,13,5,52,25,27,67
Morton,8177,2,18,11,7,58,34,24,65
Dundee Utd,8177,3,17,10,9,53,42,11,61
Falkirk,8177,4,15,11,10,56,41,15,56
Queen of S't,8177,5,12,9,15,42,47,-5,45
Dunfermline,8177,6,9,14,13,42,48,-6,41
St Mirren,8177,7,9,13,14,46,52,-6,40
Raith,8177,8,10,9,17,32,51,-19,39
Dumbarton,8177,9,8,14,14,49,58,-9,38
Ayr,8177,10,6,12,18,29,61,-32,30
Hibernian,8178,1,19,12,5,55,26,29,69
Falkirk,8178,2,17,11,8,62,38,24,62
Morton,8178,3,17,11,8,46,32,14,62
Dundee Utd,8178,4,17,8,11,54,43,11,59
Dunfermline,8178,5,10,13,13,47,49,-2,43
Queen of S't,8178,6,11,10,15,46,55,-9,43
Dumbarton,8178,7,9,11,16,48,60,-12,38
Raith,8178,8,9,11,16,34,52,-18,38
St Mirren,8178,9,9,10,17,41,57,-16,37
Ayr,8178,10,8,11,17,35,56,-21,35
Hibernian,8179,1,19,13,4,56,26,30,70
Morton,8179,2,16,12,8,49,37,12,60
Falkirk,8179,3,15,11,10,56,42,14,56
Dundee Utd,8179,4,15,10,11,49,40,9,55
Dunfermline,8179,5,10,15,11,47,47,0,45
St Mirren,8179,6,12,9,15,48,53,-5,45
Queen of S't,8179,7,10,9,17,43,57,-14,39
Raith,8179,8,10,9,17,35,49,-14,39
Ayr,8179,9,9,12,15,36,54,-18,39
Dumbarton,8179,10,8,12,16,45,59,-14,36
Morton,8180,1,19,11,6,57,34,23,68
Hibernian,8180,2,17,12,7,55,35,20,63
Falkirk,8180,3,15,12,9,58,43,15,57
Dundee Utd,8180,4,16,9,11,55,44,11,57
Queen of S't,8180,5,12,11,13,47,51,-4,47
Dumbarton,8180,6,11,12,13,55,57,-2,45
Dunfermline,8180,7,9,14,13,47,52,-5,41
Raith,8180,8,10,10,16,37,50,-13,40
St Mirren,8180,9,8,10,18,41,60,-19,34
Ayr,8180,10,6,13,17,34,60,-26,31
Hibernian,8181,1,19,11,6,56,27,29,68
Morton,8181,2,19,10,7,52,31,21,67
Falkirk,8181,3,16,12,8,63,42,21,60
Dundee Utd,8181,4,16,10,10,55,39,16,58
Dunfermline,8181,5,11,14,11,46,45,1,47
St Mirren,8181,6,10,11,15,44,56,-12,41
Queen of S't,8181,7,10,9,17,43,56,-13,39
Raith,8181,8,9,10,17,30,51,-21,37
Dumbarton,8181,9,8,12,16,46,62,-16,36
Ayr,8181,10,7,11,18,31,57,-26,32
Hibernian,8182,1,21,10,5,59,24,35,73
Falkirk,8182,2,16,11,9,56,43,13,59
Morton,8182,3,16,11,9,48,38,10,59
Dundee Utd,8182,4,15,10,11,54,44,10,55
Queen of S't,8182,5,14,9,13,48,46,2,51
Raith,8182,6,11,10,15,37,46,-9,43
St Mirren,8182,7,10,11,15,41,52,-11,41
Dunfermline,8182,8,9,13,14,45,49,-4,40
Ayr,8182,9,7,12,17,33,63,-30,33
Dumbarton,8182,10,7,11,18,43,59,-16,32
Hibernian,8183,1,19,11,6,54,30,24,68
Morton,8183,2,17,10,9,54,37,17,61
Falkirk,8183,3,15,11,10,61,43,18,56
Queen of S't,8183,4,14,9,13,46,46,0,51
Dundee Utd,8183,5,13,11,12,48,46,2,50
Dunfermline,8183,6,12,11,13,45,45,0,47
Raith,8183,7,11,9,16,39,50,-11,42
Ayr,8183,8,9,13,14,32,51,-19,40
St Mirren,8183,9,9,10,17,45,60,-15,37
Dumbarton,8183,10,8,11,17,48,64,-16,35
Hibernian,8184,1,19,14,3,53,20,33,71
Falkirk,8184,2,17,11,8,60,35,25,62
Dundee Utd,8184,3,16,9,11,55,39,16,57
Morton,8184,4,15,11,10,44,36,8,56
Queen of S't,8184,5,11,11,14,41,50,-9,44
Ayr,8184,6,11,11,14,36,51,-15,44
Dumbarton,8184,7,9,12,15,48,60,-12,39
Raith,8184,8,9,11,16,33,50,-17,38
Dunfermline,8184,9,7,15,14,45,55,-10,36
St Mirren,8184,10,8,11,17,37,56,-19,35
Morton,8185,1,20,9,7,59,33,26,69
Hibernian,8185,2,17,13,6,53,30,23,64
Falkirk,8185,3,15,12,9,53,37,16,57
Dundee Utd,8185,4,14,13,9,49,42,7,55
Dunfermline,8185,5,10,13,13,45,47,-2,43
Ayr,8185,6,9,15,12,35,49,-14,42
Raith,8185,7,11,9,16,33,49,-16,42
Queen of S't,8185,8,10,11,15,43,48,-5,41
Dumbarton,8185,9,8,11,17,43,62,-19,35
St Mirren,8185,10,8,10,18,43,59,-16,34
Hibernian,8186,1,18,12,6,55,31,24,66
Falkirk,8186,2,17,11,8,64,39,25,62
Morton,8186,3,17,11,8,51,38,13,62
Dundee Utd,8186,4,14,10,12,49,46,3,52
Ayr,8186,5,11,12,13,38,51,-13,45
Raith,8186,6,11,11,14,36,46,-10,44
Dunfermline,8186,7,9,13,14,46,50,-4,40
Dumbarton,8186,8,9,13,14,45,53,-8,40
Queen of S't,8186,9,9,11,16,45,57,-12,38
St Mirren,8186,10,8,10,18,41,59,-18,34
Hibernian,8187,1,21,12,3,58,24,34,75
Dundee Utd,8187,2,16,10,10,51,40,11,58
Morton,8187,3,15,11,10,46,39,7,56
Falkirk,8187,4,15,10,11,52,40,12,55
Queen of S't,8187,5,12,10,14,46,48,-2,46
Dunfermline,8187,6,9,14,13,44,48,-4,41
Raith,8187,7,10,11,15,34,47,-13,41
Dumbarton,8187,8,9,12,15,47,57,-10,39
St Mirren,8187,9,9,10,17,40,54,-14,37
Ayr,8187,10,8,12,16,34,55,-21,36
Hibernian,8188,1,20,13,3,62,22,40,73
Dundee Utd,8188,2,18,9,9,55,36,19,63
Falkirk,8188,3,16,11,9,61,42,19,59
Morton,8188,4,14,13,9,42,35,7,55
Dumbarton,8188,5,11,10,15,52,58,-6,43
Raith,8188,6,11,8,17,33,51,-18,41
Queen of S't,8188,7,10,9,17,43,59,-16,39
Ayr,8188,8,9,12,15,36,53,-17,39
Dunfermline,8188,9,8,13,15,42,50,-8,37
St Mirren,8188,10,9,10,17,37,57,-20,37
Hibernian,8189,1,18,13,5,53,26,27,67
Falkirk,8189,2,16,10,10,59,40,19,58
Morton,8189,3,15,13,8,47,40,7,58
Dundee Utd,8189,4,13,12,11,43,44,-1,51
Dumbarton,8189,5,12,12,12,52,52,0,48
Queen of S't,8189,6,12,9,15,47,51,-4,45
Dunfermline,8189,7,9,13,14,45,50,-5,40
Raith,8189,8,10,10,16,37,52,-15,40
Ayr,8189,9,8,14,14,35,51,-16,38
St Mirren,8189,10,9,10,17,47,59,-12,37
Hibernian,8190,1,21,10,5,54,26,28,73
Falkirk,8190,2,17,10,9,63,43,20,61
Morton,8190,3,16,11,9,51,39,12,59
Dundee Utd,8190,4,15,9,12,48,41,7,54
Queen of S't,8190,5,12,9,15,42,50,-8,45
Dunfermline,8190,6,10,12,14,47,50,-3,42
St Mirren,8190,7,10,10,16,43,54,-11,40
Raith,8190,8,10,10,16,37,53,-16,40
Dumbarton,8190,9,9,11,16,48,58,-10,38
Ayr,8190,10,9,10,17,37,56,-19,37
Morton,8191,1,19,11,6,51,31,20,68
Hibernian,8191,2,18,11,7,53,28,25,65
Falkirk,8191,3,17,9,10,60,42,18,60
Dundee Utd,8191,4,15,12,9,50,40,10,57
Queen of S't,8191,5,12,10,14,44,48,-4,46
Dunfermline,8191,6,10,13,13,45,49,-4,43
Dumbarton,8191,7,9,11,16,48,58,-10,38
Ayr,8191,8,8,13,15,34,55,-21,37
St Mirren,8191,9,8,11,17,42,57,-15,35
Raith,8191,10,8,11,17,35,54,-19,35
Hibernian,8192,1,21,11,4,60,24,36,74
Falkirk,8192,2,17,11,8,56,36,20,62
Morton,8192,3,17,10,9,50,38,12,61
Dundee Utd,8192,4,16,9,11,55,41,14,57
Queen of S't,8192,5,11,10,15,47,50,-3,43
Dunfermline,8192,6,9,14,13,44,49,-5,41
Raith,8192,7,10,10,16,36,48,-12,40
Ayr,8192,8,9,13,14,35,56,-21,40
Dumbarton,8192,9,9,11,16,49,62,-13,38
St Mirren,8192,10,7,9,20,35,63,-28,30
Hibernian,8193,1,19,12,5,54,27,27,69
Dundee Utd,8193,2,17,9,10,52,40,12,60
Falkirk,8193,3,16,11,9,55,40,15,59
Morton,8193,4,15,10,11,47,41,6,55
Queen of S't,8193,5,13,11,12,51,45,6,50
Dumbarton,8193,6,9,13,14,47,56,-9,40
Raith,8193,7,10,10,16,36,48,-12,40
Dunfermline,8193,8,9,12,15,43,52,-9,39
St Mirren,8193,9,9,10,17,41,55,-14,37
Ayr,8193,10,7,14,15,32,54,-22,35
Hibernian,8194,1,21,10,5,55,25,30,73
Morton,8194,2,15,12,9,47,39,8,57
Dundee Utd,8194,3,15,11,10,52,42,10,56
Falkirk,8194,4,13,12,11,52,41,11,51
Queen of S't,8194,5,14,8,14,46,46,0,50
Dunfermline,8194,6,12,12,12,50,47,3,48
Raith,8194,7,11,10,15,35,45,-10,43
Dumbarton,8194,8,8,13,15,45,53,-8,37
Ayr,8194,9,8,12,16,30,53,-23,36
St Mirren,8194,10,8,10,18,39,60,-21,34
Hibernian,8195,1,17,14,5,55,30,25,65
Morton,8195,2,18,11,7,57,37,20,65
Falkirk,8195,3,16,11,9,61,39,22,59
Dundee Utd,8195,4,15,10,11,49,46,3,55
Queen of S't,8195,5,12,11,13,45,49,-4,47
Raith,8195,6,12,9,15,38,46,-8,45
Dunfermline,8195,7,10,13,13,47,48,-1,43
Ayr,8195,8,9,11,16,39,55,-16,38
St Mirren,8195,9,8,12,16,38,60,-22,36
Dumbarton,8195,10,7,10,19,44,63,-19,31
Hibernian,8196,1,20,11,5,62,23,39,71
Morton,8196,2,18,10,8,50,40,10,64
Dundee Utd,8196,3,18,8,10,51,35,16,62
Falkirk,8196,4,15,9,12,54,43,11,54
Queen of S't,8196,5,13,8,15,44,52,-8,47
Dunfermline,8196,6,10,14,12,46,47,-1,44
Dumbarton,8196,7,10,12,14,50,56,-6,42
Raith,8196,8,10,8,18,31,48,-17,38
Ayr,8196,9,9,10,17,35,56,-21,37
St Mirren,8196,10,7,10,19,36,59,-23,31
Hibernian,8197,1,19,11,6,56,31,25,68
Falkirk,8197,2,18,9,9,62,37,25,63
Morton,8197,3,17,10,9,52,38,14,61
Dundee Utd,8197,4,17,9,10,50,37,13,60
Queen of S't,8197,5,13,8,15,45,48,-3,47
Raith,8197,6,11,9,16,33,46,-13,42
Dunfermline,8197,7,10,11,15,43,47,-4,41
Ayr,8197,8,9,12,15,30,49,-19,39
Dumbarton,8197,9,8,11,17,46,62,-16,35
St Mirren,8197,10,8,10,18,39,61,-22,34
Hibernian,8198,1,19,11,6,53,26,27,68
Morton,8198,2,17,12,7,48,33,15,63
Falkirk,8198,3,16,10,10,60,40,20,58
Dundee Utd,8198,4,16,9,11,52,39,13,57
Queen of S't,8198,5,13,8,15,47,52,-5,47
Dumbarton,8198,6,11,10,15,50,62,-12,43
Dunfermline,8198,7,10,12,14,44,45,-1,42
Raith,8198,8,9,12,15,33,47,-14,39
St Mirren,8198,9,9,10,17,37,58,-21,37
Ayr,8198,10,7,12,17,31,53,-22,33
Hibernian,8199,1,19,14,3,56,23,33,71
Morton,8199,2,16,11,9,45,37,8,59
Falkirk,8199,3,16,10,10,58,43,15,58
Dundee Utd,8199,4,15,10,11,55,46,9,55
Dunfermline,8199,5,11,14,11,47,44,3,47
Queen of S't,8199,6,12,9,15,51,56,-5,45
Raith,8199,7,12,8,16,38,47,-9,44
Ayr,8199,8,9,10,17,39,60,-21,37
Dumbarton,8199,9,8,11,17,44,62,-18,35
St Mirren,8199,10,7,13,16,41,56,-15,34
Hibernian,8200,1,20,12,4,59,23,36,72
Dundee Utd,8200,2,18,10,8,54,36,18,64
Morton,8200,3,15,12,9,46,38,8,57
Falkirk,8200,4,14,11,11,58,47,11,53
Queen of S't,8200,5,12,10,14,43,47,-4,46
Dunfermline,8200,6,9,15,12,42,47,-5,42
St Mirren,8200,7,10,10,16,41,55,-14,40
Dumbarton,8200,8,9,11,16,45,56,-11,38
Ayr,8200,9,8,12,16,33,56,-23,36
Raith,8200,10,8,11,17,35,51,-16,35
Hibernian,8201,1,18,11,7,51,26,25,65
Dundee Utd,8201,2,17,11,8,50,36,14,62
Morton,8201,3,17,11,8,46,34,12,62
Falkirk,8201,4,16,11,9,62,41,21,59
Dunfermline,8201,5,12,12,12,52,49,3,48
Queen of S't,8201,6,12,9,15,43,51,-8,45
Raith,8201,7,11,11,14,38,49,-11,44
Ayr,8201,8,9,12,15,36,52,-16,39
Dumbarton,8201,9,7,10,19,45,61,-16,31
St Mirren,8201,10,7,10,19,35,59,-24,31
Hibernian,8202,1,21,10,5,63,25,38,73
Morton,8202,2,17,11,8,52,40,12,62
Falkirk,8202,3,17,9,10,59,44,15,60
Dundee Utd,8202,4,14,10,12,48,47,1,52
Queen of S't,8202,5,12,10,14,43,48,-5,46
Ayr,8202,6,11,11,14,39,49,-10,44
Dunfermline,8202,7,9,14,13,48,49,-1,41
Dumbarton,8202,8,10,10,16,47,58,-11,40
Raith,8202,9,10,10,16,33,49,-16,40
St Mirren,8202,10,7,9,20,39,62,-23,30
Hibernian,8203,1,20,12,4,60,29,31,72
Falkirk,8203,2,16,13,7,59,39,20,61
Dundee Utd,8203,3,17,9,10,59,39,20,60
Morton,8203,4,14,13,9,48,42,6,55
Queen of S't,8203,5,11,10,15,48,55,-7,43
Dunfermline,8203,6,8,16,12,47,50,-3,40
Dumbarton,8203,7,9,13,14,46,55,-9,40
Ayr,8203,8,9,12,15,34,56,-22,39
Raith,8203,9,8,11,17,32,48,-16,35
St Mirren,8203,10,8,11,17,39,59,-20,35
Hibernian,8204,1,19,12,5,54,24,30,69
Morton,8204,2,17,11,8,48,35,13,62
Dundee Utd,8204,3,17,9,10,56,41,15,60
Falkirk,8204,4,14,12,10,57,44,13,54
Dunfermline,8204,5,12,13,11,51,45,6,49
Raith,8204,6,11,8,17,33,45,-12,41
Ayr,8204,7,10,11,15,37,56,-19,41
Dumbarton,8204,8,10,10,16,47,58,-11,40
Queen of S't,8204,9,9,10,17,41,56,-15,37
St Mirren,8204,10,8,10,18,37,57,-20,34
Hibernian,8205,1,20,11,5,61,27,34,71
Falkirk,8205,2,16,11,9,56,39,17,59
Dundee Utd,8205,3,16,9,11,49,39,10,57
Dunfermline,8205,4,13,13,10,52,44,8,52
Morton,8205,5,14,10,12,48,45,3,52
Raith,8205,6,11,9,16,37,49,-12,42
Queen of S't,8205,7,10,9,17,46,60,-14,39
St Mirren,8205,8,10,9,17,42,58,-16,39
Ayr,8205,9,9,12,15,31,49,-18,39
Dumbarton,8205,10,9,11,16,47,59,-12,38
Hibernian,8206,1,19,12,5,54,27,27,69
Morton,8206,2,17,11,8,59,41,18,62
Dundee Utd,8206,3,16,9,11,60,48,12,57
Falkirk,8206,4,15,11,10,56,42,14,56
Queen of S't,8206,5,12,9,15,46,50,-4,45
Ayr,8206,6,11,12,13,39,54,-15,45
Raith,8206,7,11,10,15,38,48,-10,43
Dunfermline,8206,8,10,12,14,51,54,-3,42
Dumbarton,8206,9,9,12,15,48,59,-11,39
St Mirren,8206,10,6,10,20,37,65,-28,28
Hibernian,8207,1,17,11,8,54,31,23,62
Morton,8207,2,17,11,8,49,35,14,62
Falkirk,8207,3,16,10,10,59,42,17,58
Dundee Utd,8207,4,16,10,10,48,38,10,58
Dunfermline,8207,5,12,13,11,53,45,8,49
Queen of S't,8207,6,13,9,14,50,55,-5,48
Raith,8207,7,11,11,14,39,50,-11,44
Dumbarton,8207,8,9,11,16,44,57,-13,38
St Mirren,8207,9,9,9,18,39,54,-15,36
Ayr,8207,10,7,11,18,29,57,-28,32
Hibernian,8208,1,20,12,4,58,24,34,72
Dundee Utd,8208,2,18,9,9,53,38,15,63
Falkirk,8208,3,15,13,8,57,40,17,58
Morton,8208,4,15,11,10,46,39,7,56
Queen of S't,8208,5,12,9,15,45,50,-5,45
Raith,8208,6,10,11,15,36,47,-11,41
Dumbarton,8208,7,10,11,15,45,59,-14,41
Dunfermline,8208,8,9,13,14,44,47,-3,40
Ayr,8208,9,8,11,17,31,58,-27,35
St Mirren,8208,10,7,12,17,42,55,-13,33
Hibernian,8209,1,19,13,4,55,25,30,70
Falkirk,8209,2,17,10,9,57,38,19,61
Dundee Utd,8209,3,17,10,9,55,40,15,61
Morton,8209,4,17,10,9,50,39,11,61
Dunfermline,8209,5,12,12,12,49,49,0,48
Queen of S't,8209,6,11,10,15,50,53,-3,43
Raith,8209,7,11,9,16,40,50,-10,42
St Mirren,8209,8,9,9,18,43,59,-16,36
Dumbarton,8209,9,7,12,17,46,63,-17,33
Ayr,8209,10,6,13,17,33,62,-29,31
Hibernian,8210,1,18,12,6,52,26,26,66
Morton,8210,2,16,11,9,46,34,12,59
Dundee Utd,8210,3,16,8,12,48,41,7,56
Falkirk,8210,4,14,10,12,54,44,10,52
Dumbarton,8210,5,11,13,12,51,51,0,46
Dunfermline,8210,6,10,14,12,46,48,-2,44
Queen of S't,8210,7,11,10,15,43,50,-7,43
Ayr,8210,8,10,12,14,34,49,-15,42
Raith,8210,9,10,10,16,33,48,-15,40
St Mirren,8210,10,9,10,17,38,54,-16,37
Hibernian,8211,1,18,15,3,53,22,31,69
Dundee Utd,8211,2,18,9,9,54,35,19,63
Morton,8211,3,16,13,7,48,32,16,61
Falkirk,8211,4,17,9,10,63,47,16,60
Dumbarton,8211,5,11,10,15,48,57,-9,43
Queen of S't,8211,6,11,10,15,43,53,-10,43
Raith,8211,7,11,8,17,37,52,-15,41
Dunfermline,8211,8,8,14,14,44,50,-6,38
Ayr,8211,9,8,11,17,31,55,-24,35
St Mirren,8211,10,7,11,18,38,56,-18,32
Hibernian,8212,1,16,14,6,49,26,23,62
Morton,8212,2,17,11,8,50,35,15,62
Falkirk,8212,3,14,13,9,55,41,14,55
Dundee Utd,8212,4,15,10,11,48,40,8,55
Queen of S't,8212,5,12,12,12,50,50,0,48
Dunfermline,8212,6,11,13,12,48,49,-1,46
St Mirren,8212,7,10,10,16,42,54,-12,40
Ayr,8212,8,9,13,14,34,51,-17,40
Raith,8212,9,10,8,18,36,54,-18,38
Dumbarton,8212,10,9,10,17,48,60,-12,37
Hibernian,8213,1,20,12,4,56,23,33,72
Morton,8213,2,18,10,8,58,40,18,64
Falkirk,8213,3,16,10,10,59,41,18,58
Dundee Utd,8213,4,14,9,13,47,44,3,51
Queen of S't,8213,5,13,9,14,49,51,-2,48
Raith,8213,6,12,9,15,39,49,-10,45
Dunfermline,8213,7,10,11,15,44,54,-10,41
St Mirren,8213,8,10,9,17,42,54,-12,39
Ayr,8213,9,8,13,15,36,56,-20,37
Dumbarton,8213,10,8,10,18,47,65,-18,34
Hibernian,8214,1,18,12,6,54,30,24,66
Morton,8214,2,16,12,8,50,37,13,60
Dundee Utd,8214,3,15,12,9,48,38,10,57
Falkirk,8214,4,14,11,11,57,46,11,53
Queen of S't,8214,5,12,10,14,50,52,-2,46
Raith,8214,6,12,10,14,40,49,-9,46
Dunfermline,8214,7,9,13,14,47,53,-6,40
Dumbarton,8214,8,9,13,14,51,58,-7,40
St Mirren,8214,9,9,11,16,42,56,-14,38
Ayr,8214,10,7,14,15,36,56,-20,35
Hibernian,8215,1,19,12,5,59,30,29,69
Falkirk,8215,2,17,10,9,60,40,20,61
Morton,8215,3,16,12,8,50,38,12,60
Dundee Utd,8215,4,15,11,10,48,40,8,56
Dunfermline,8215,5,10,13,13,43,44,-1,43
Dumbarton,8215,6,11,10,15,51,56,-5,43
Raith,8215,7,9,13,14,33,48,-15,40
Ayr,8215,8,8,14,14,37,55,-18,38
St Mirren,8215,9,8,12,16,43,58,-15,36
Queen of S't,8215,10,9,9,18,39,54,-15,36
Hibernian,8216,1,19,14,3,58,23,35,71
Falkirk,8216,2,15,11,10,56,41,15,56
Dundee Utd,8216,3,15,11,10,47,37,10,56
Morton,8216,4,14,13,9,44,38,6,55
Dunfermline,8216,5,11,12,13,46,48,-2,45
Queen of S't,8216,6,11,10,15,44,51,-7,43
Raith,8216,7,10,10,16,38,53,-15,40
Ayr,8216,8,9,13,14,37,56,-19,40
St Mirren,8216,9,9,11,16,48,59,-11,38
Dumbarton,8216,10,9,11,16,46,58,-12,38
Hibernian,8217,1,21,11,4,57,24,33,74
Morton,8217,2,18,10,8,54,37,17,64
Falkirk,8217,3,16,11,9,64,45,19,59
Dundee Utd,8217,4,15,10,11,48,40,8,55
Queen of S't,8217,5,12,9,15,46,54,-8,45
Dumbarton,8217,6,9,13,14,48,57,-9,40
Dunfermline,8217,7,9,12,15,44,54,-10,39
Raith,8217,8,10,9,17,35,51,-16,39
St Mirren,8217,9,9,11,16,44,57,-13,38
Ayr,8217,10,7,12,17,29,50,-21,33
Hibernian,8218,1,20,12,4,52,22,30,72
Falkirk,8218,2,16,11,9,55,39,16,59
Morton,8218,3,16,10,10,54,39,15,58
Dundee Utd,8218,4,15,10,11,50,43,7,55
Raith,8218,5,13,9,14,37,45,-8,48
Queen of S't,8218,6,12,11,13,50,50,0,47
Dunfermline,8218,7,9,13,14,45,49,-4,40
Dumbarton,8218,8,9,13,14,49,59,-10,40
Ayr,8218,9,7,13,16,32,55,-23,34
St Mirren,8218,10,7,10,19,35,58,-23,31
Hibernian,8219,1,19,11,6,59,27,32,68
Morton,8219,2,18,10,8,51,35,16,64
Falkirk,8219,3,17,10,9,57,39,18,61
Dundee Utd,8219,4,15,10,11,50,42,8,55
Queen of S't,8219,5,11,11,14,44,51,-7,44
Dumbarton,8219,6,10,13,13,47,53,-6,43
Raith,8219,7,11,9,16,34,45,-11,42
Dunfermline,8219,8,9,14,13,43,49,-6,41
St Mirren,8219,9,9,10,17,41,56,-15,37
Ayr,8219,10,7,10,19,31,60,-29,31
Hibernian,8220,1,21,11,4,59,24,35,74
Morton,8220,2,16,13,7,51,37,14,61
Falkirk,8220,3,15,11,10,54,38,16,56
Dundee Utd,8220,4,15,10,11,51,42,9,55
Dunfermline,8220,5,11,13,12,45,47,-2,46
Queen of S't,8220,6,11,12,13,42,46,-4,45
Raith,8220,7,9,10,17,33,50,-17,37
Ayr,8220,8,8,13,15,36,55,-19,37
Dumbarton,8220,9,8,12,16,44,57,-13,36
St Mirren,8220,10,8,11,17,37,56,-19,35
Hibernian,8221,1,18,12,6,52,24,28,66
Falkirk,8221,2,17,11,8,64,41,23,62
Morton,8221,3,14,16,6,48,34,14,58
Dundee Utd,8221,4,15,10,11,50,41,9,55
Queen of S't,8221,5,14,8,14,55,50,5,50
St Mirren,8221,6,10,10,16,42,56,-14,40
Dunfermline,8221,7,8,15,13,42,48,-6,39
Ayr,8221,8,9,12,15,31,53,-22,39
Raith,8221,9,9,11,16,33,52,-19,38
Dumbarton,8221,10,8,11,17,45,63,-18,35
Morton,8222,1,20,9,7,59,34,25,69
Hibernian,8222,2,19,11,6,57,29,28,68
Dundee Utd,8222,3,17,9,10,51,40,11,60
Falkirk,8222,4,16,10,10,58,43,15,58
Dunfermline,8222,5,11,12,13,45,50,-5,45
Queen of S't,8222,6,11,9,16,46,52,-6,42
St Mirren,8222,7,9,11,16,41,54,-13,38
Dumbarton,8222,8,9,11,16,49,64,-15,38
Raith,8222,9,8,11,17,35,53,-18,35
Ayr,8222,10,7,13,16,34,56,-22,34
Hibernian,8223,1,17,12,7,54,31,23,63
Morton,8223,2,17,12,7,60,41,19,63
Dundee Utd,8223,3,16,11,9,50,37,13,59
Falkirk,8223,4,15,12,9,60,45,15,57
Queen of S't,8223,5,11,11,14,43,48,-5,44
Raith,8223,6,10,12,14,35,46,-11,42
Dunfermline,8223,7,10,11,15,48,52,-4,41
Dumbarton,8223,8,10,11,15,52,60,-8,41
St Mirren,8223,9,9,11,16,43,59,-16,38
Ayr,8223,10,7,13,16,35,61,-26,34
Hibernian,8224,1,21,12,3,59,23,36,75
Morton,8224,2,16,12,8,53,39,14,60
Dundee Utd,8224,3,16,10,10,48,38,10,58
Falkirk,8224,4,15,11,10,58,45,13,56
Queen of S't,8224,5,11,11,14,47,49,-2,44
Raith,8224,6,11,11,14,34,44,-10,44
Ayr,8224,7,8,15,13,35,54,-19,39
Dumbarton,8224,8,9,11,16,50,62,-12,38
Dunfermline,8224,9,8,11,17,42,55,-13,35
St Mirren,8224,10,8,10,18,39,56,-17,34
Hibernian,8225,1,21,11,4,59,23,36,74
Falkirk,8225,2,19,10,7,64,35,29,67
Dundee Utd,8225,3,16,10,10,51,39,12,58
Morton,8225,4,14,11,11,45,42,3,53
Dunfermline,8225,5,10,13,13,46,46,0,43
Queen of S't,8225,6,11,10,15,44,53,-9,43
Ayr,8225,7,9,11,16,31,55,-24,38
St Mirren,8225,8,9,10,17,41,56,-15,37
Raith,8225,9,9,10,17,33,50,-17,37
Dumbarton,8225,10,8,12,16,48,63,-15,36
Hibernian,8226,1,21,12,3,64,23,41,75
Morton,8226,2,16,13,7,51,39,12,61
Falkirk,8226,3,16,12,8,59,41,18,60
Dundee Utd,8226,4,15,11,10,50,39,11,56
Queen of S't,8226,5,13,8,15,44,48,-4,47
Dunfermline,8226,6,10,14,12,46,46,0,44
Dumbarton,8226,7,9,12,15,43,56,-13,39
Raith,8226,8,9,9,18,34,53,-19,36
St Mirren,8226,9,8,11,17,42,59,-17,35
Ayr,8226,10,6,12,18,31,60,-29,30
Hibernian,8227,1,20,13,3,55,23,32,73
Falkirk,8227,2,18,9,9,64,42,22,63
Dundee Utd,8227,3,16,12,8,51,37,14,60
Morton,8227,4,16,12,8,48,35,13,60
Raith,8227,5,11,9,16,37,51,-14,42
Queen of S't,8227,6,10,8,18,42,57,-15,38
Dunfermline,8227,7,8,13,15,48,55,-7,37
Dumbarton,8227,8,9,10,17,50,61,-11,37
St Mirren,8227,9,8,13,15,37,53,-16,37
Ayr,8227,10,8,13,15,32,50,-18,37
Hibernian,8228,1,21,11,4,61,25,36,74
Morton,8228,2,16,10,10,47,34,13,58
Falkirk,8228,3,14,13,9,60,46,14,55
Dundee Utd,8228,4,14,12,10,47,36,11,54
Queen of S't,8228,5,12,11,13,48,49,-1,47
Dunfermline,8228,6,11,13,12,42,45,-3,46
Dumbarton,8228,7,11,10,15,52,59,-7,43
Raith,8228,8,11,10,15,37,50,-13,43
Ayr,8228,9,8,10,18,34,60,-26,34
St Mirren,8228,10,7,10,19,38,62,-24,31
Hibernian,8229,1,18,13,5,54,29,25,67
Morton,8229,2,17,14,5,52,33,19,65
Falkirk,8229,3,15,10,11,62,49,13,55
Dundee Utd,8229,4,15,10,11,55,48,7,55
Queen of S't,8229,5,15,9,12,52,44,8,54
Dumbarton,8229,6,10,13,13,54,58,-4,43
Raith,8229,7,10,9,17,37,50,-13,39
St Mirren,8229,8,9,11,16,40,55,-15,38
Dunfermline,8229,9,7,14,15,43,57,-14,35
Ayr,8229,10,7,11,18,31,57,-26,32
Hibernian,8230,1,19,11,6,56,28,28,68
Morton,8230,2,19,10,7,55,36,19,67
Dundee Utd,8230,3,16,11,9,53,40,13,59
Falkirk,8230,4,14,13,9,58,41,17,55
Queen of S't,8230,5,12,12,12,44,46,-2,48
Raith,8230,6,11,12,13,35,42,-7,45
St Mirren,8230,7,9,10,17,37,54,-17,37
Dumbarton,8230,8,8,12,16,51,63,-12,36
Dunfermline,8230,9,7,13,16,45,57,-12,34
Ayr,8230,10,7,12,17,29,56,-27,33
Hibernian,8231,1,21,10,5,58,27,31,73
Falkirk,8231,2,17,9,10,59,39,20,60
Morton,8231,3,16,12,8,52,36,16,60
Dundee Utd,8231,4,14,12,10,53,43,10,54
Queen of S't,8231,5,14,9,13,51,49,2,51
Dumbarton,8231,6,10,11,15,46,58,-12,41
Raith,8231,7,9,11,16,33,49,-16,38
Ayr,8231,8,9,11,16,37,59,-22,38
Dunfermline,8231,9,8,13,15,43,51,-8,37
St Mirren,8231,10,7,12,17,36,57,-21,33
Hibernian,8232,1,19,13,4,56,26,30,70
Falkirk,8232,2,16,9,11,57,41,16,57
Morton,8232,3,15,12,9,47,39,8,57
Dundee Utd,8232,4,14,12,10,47,40,7,54
Dumbarton,8232,5,12,11,13,49,55,-6,47
Dunfermline,8232,6,11,12,13,52,48,4,45
Queen of S't,8232,7,11,11,14,44,49,-5,44
Ayr,8232,8,8,15,13,44,58,-14,39
Raith,8232,9,8,12,16,31,49,-18,36
St Mirren,8232,10,7,11,18,37,59,-22,32
Hibernian,8233,1,18,15,3,55,26,29,69
Morton,8233,2,16,12,8,47,35,12,60
Dundee Utd,8233,3,16,10,10,53,40,13,58
Falkirk,8233,4,15,10,11,58,47,11,55
Dunfermline,8233,5,12,12,12,46,44,2,48
Queen of S't,8233,6,12,8,16,44,49,-5,44
Raith,8233,7,10,10,16,33,46,-13,40
St Mirren,8233,8,9,11,16,46,52,-6,38
Dumbarton,8233,9,8,12,16,45,62,-17,36
Ayr,8233,10,8,12,16,34,60,-26,36
Hibernian,8234,1,17,13,6,49,25,24,64
Morton,8234,2,17,11,8,52,39,13,62
Dundee Utd,8234,3,16,10,10,50,36,14,58
Falkirk,8234,4,13,12,11,51,42,9,51
Queen of S't,8234,5,12,12,12,46,46,0,48
St Mirren,8234,6,10,12,14,44,53,-9,42
Raith,8234,7,11,9,16,37,46,-9,42
Dumbarton,8234,8,9,12,15,46,61,-15,39
Ayr,8234,9,9,12,15,32,51,-19,39
Dunfermline,8234,10,8,13,15,43,51,-8,37
Hibernian,8235,1,18,15,3,58,25,33,69
Morton,8235,2,16,13,7,50,40,10,61
Falkirk,8235,3,15,11,10,57,40,17,56
Dundee Utd,8235,4,14,11,11,46,39,7,53
Queen of S't,8235,5,13,11,12,48,48,0,50
Raith,8235,6,12,10,14,37,47,-10,46
Dunfermline,8235,7,9,12,15,46,53,-7,39
Dumbarton,8235,8,8,12,16,46,59,-13,36
St Mirren,8235,9,9,9,18,39,55,-16,36
Ayr,8235,10,6,16,14,32,53,-21,34
Hibernian,8236,1,19,10,7,52,28,24,67
Morton,8236,2,18,10,8,51,35,16,64
Falkirk,8236,3,15,10,11,54,43,11,55
Dundee Utd,8236,4,14,12,10,52,44,8,54
Dunfermline,8236,5,12,13,11,50,44,6,49
Queen of S't,8236,6,12,10,14,44,46,-2,46
Dumbarton,8236,7,10,11,15,52,60,-8,41
Raith,8236,8,9,12,15,34,46,-12,39
St Mirren,8236,9,7,13,16,38,57,-19,34
Ayr,8236,10,7,13,16,32,56,-24,34
Hibernian,8237,1,18,12,6,54,30,24,66
Morton,8237,2,18,11,7,55,37,18,65
Dundee Utd,8237,3,16,11,9,51,38,13,59
Falkirk,8237,4,15,13,8,55,38,17,58
Dunfermline,8237,5,10,15,11,46,44,2,45
Queen of S't,8237,6,10,10,16,41,50,-9,40
Raith,8237,7,9,12,15,38,50,-12,39
St Mirren,8237,8,9,10,17,39,56,-17,37
Dumbarton,8237,9,8,12,16,45,57,-12,36
Ayr,8237,10,8,12,16,35,59,-24,36
Hibernian,8238,1,18,12,6,53,27,26,66
Morton,8238,2,17,11,8,54,39,15,62
Dundee Utd,8238,3,17,9,10,47,35,12,60
Falkirk,8238,4,15,13,8,57,40,17,58
Raith,8238,5,13,8,15,38,46,-8,47
Dunfermline,8238,6,9,13,14,45,50,-5,40
Queen of S't,8238,7,10,10,16,41,50,-9,40
Ayr,8238,8,10,10,16,35,55,-20,40
Dumbarton,8238,9,9,12,15,47,56,-9,39
St Mirren,8238,10,8,10,18,37,56,-19,34
Hibernian,8239,1,19,14,3,55,23,32,71
Morton,8239,2,16,11,9,47,36,11,59
Dundee Utd,8239,3,16,8,12,51,43,8,56
Falkirk,8239,4,14,12,10,55,42,13,54
Dumbarton,8239,5,12,12,12,48,50,-2,48
Dunfermline,8239,6,10,13,13,50,51,-1,43
Queen of S't,8239,7,11,10,15,43,50,-7,43
Raith,8239,8,10,9,17,38,53,-15,39
St Mirren,8239,9,8,12,16,39,57,-18,36
Ayr,8239,10,7,13,16,32,53,-21,34
Hibernian,8240,1,18,12,6,52,25,27,66
Morton,8240,2,18,10,8,50,36,14,64
Falkirk,8240,3,17,10,9,58,41,17,61
Dundee Utd,8240,4,15,12,9,46,34,12,57
Queen of S't,8240,5,12,11,13,46,48,-2,47
Raith,8240,6,11,10,15,33,44,-11,43
Dunfermline,8240,7,9,14,13,42,47,-5,41
Ayr,8240,8,8,14,14,32,49,-17,38
St Mirren,8240,9,8,10,18,37,53,-16,34
Dumbarton,8240,10,7,11,18,45,64,-19,32
Hibernian,8241,1,17,13,6,52,27,25,64
Morton,8241,2,17,11,8,51,36,15,62
Falkirk,8241,3,15,10,11,59,44,15,55
Dundee Utd,8241,4,15,10,11,49,45,4,55
Queen of S't,8241,5,13,9,14,47,46,1,48
Ayr,8241,6,10,13,13,39,52,-13,43
Dunfermline,8241,7,10,12,14,43,47,-4,42
Raith,8241,8,10,11,15,35,49,-14,41
Dumbarton,8241,9,10,10,16,50,61,-11,40
St Mirren,8241,10,8,11,17,39,57,-18,35
Hibernian,8242,1,18,15,3,59,25,34,69
Falkirk,8242,2,18,10,8,59,36,23,64
Morton,8242,3,17,12,7,51,37,14,63
Dundee Utd,8242,4,16,9,11,55,46,9,57
Queen of S't,8242,5,12,9,15,46,53,-7,45
Ayr,8242,6,9,13,14,37,54,-17,40
Dunfermline,8242,7,9,12,15,47,54,-7,39
St Mirren,8242,8,10,9,17,45,63,-18,39
Raith,8242,9,9,9,18,31,49,-18,36
Dumbarton,8242,10,8,10,18,48,61,-13,34
Hibernian,8243,1,18,13,5,55,27,28,67
Falkirk,8243,2,18,11,7,64,40,24,65
Morton,8243,3,16,9,11,52,42,10,57
Dundee Utd,8243,4,15,11,10,50,41,9,56
Dunfermline,8243,5,11,14,11,53,55,-2,47
Raith,8243,6,11,10,15,37,46,-9,43
Queen of S't,8243,7,11,8,17,44,52,-8,41
St Mirren,8243,8,9,11,16,43,58,-15,38
Ayr,8243,9,8,12,16,31,52,-21,36
Dumbarton,8243,10,8,11,17,48,64,-16,35
Hibernian,8244,1,21,11,4,60,23,37,74
Morton,8244,2,17,9,10,49,41,8,60
Falkirk,8244,3,15,10,11,53,45,8,55
Dundee Utd,8244,4,14,11,11,50,41,9,53
Queen of S't,8244,5,14,10,12,50,44,6,52
Dunfermline,8244,6,11,13,12,48,44,4,46
Dumbarton,8244,7,10,11,15,51,55,-4,41
Raith,8244,8,9,11,16,33,51,-18,38
St Mirren,8244,9,9,9,18,39,57,-18,36
Ayr,8244,10,6,13,17,31,63,-32,31
Hibernian,8245,1,19,14,3,57,27,30,71
Morton,8245,2,17,13,6,52,36,16,64
Falkirk,8245,3,15,12,9,56,40,16,57
Dundee Utd,8245,4,15,8,13,52,39,13,53
Queen of S't,8245,5,13,8,15,45,48,-3,47
Dumbarton,8245,6,11,11,14,45,52,-7,44
Raith,8245,7,10,10,16,37,49,-12,40
Dunfermline,8245,8,8,14,14,44,50,-6,38
Ayr,8245,9,8,12,16,35,59,-24,36
St Mirren,8245,10,8,10,18,38,61,-23,34
Hibernian,8246,1,19,12,5,55,25,30,69
Morton,8246,2,17,11,8,52,36,16,62
Falkirk,8246,3,15,13,8,57,39,18,58
Dundee Utd,8246,4,13,12,11,48,44,4,51
Queen of S't,8246,5,11,11,14,46,53,-7,44
Dunfermline,8246,6,9,16,11,48,47,1,43
Raith,8246,7,11,10,15,38,49,-11,43
St Mirren,8246,8,9,11,16,39,53,-14,38
Ayr,8246,9,8,14,14,35,56,-21,38
Dumbarton,8246,10,7,12,17,47,63,-16,33
Hibernian,8247,1,21,11,4,61,25,36,74
Morton,8247,2,16,11,9,50,41,9,59
Falkirk,8247,3,16,10,10,63,42,21,58
Dundee Utd,8247,4,15,12,9,50,41,9,57
Dumbarton,8247,5,10,13,13,51,55,-4,43
Dunfermline,8247,6,9,14,13,47,53,-6,41
Ayr,8247,7,9,12,15,33,51,-18,39
Queen of S't,8247,8,9,11,16,45,57,-12,38
St Mirren,8247,9,9,11,16,40,52,-12,38
Raith,8247,10,8,11,17,31,54,-23,35
Hibernian,8248,1,20,12,4,53,23,30,72
Morton,8248,2,16,14,6,50,33,17,62
Dundee Utd,8248,3,15,12,9,52,42,10,57
Falkirk,8248,4,14,12,10,59,44,15,54
Queen of S't,8248,5,12,10,14,48,49,-1,46
Dunfermline,8248,6,10,13,13,45,47,-2,43
Raith,8248,7,9,12,15,35,52,-17,39
Dumbarton,8248,8,8,14,14,46,57,-11,38
Ayr,8248,9,7,13,16,33,53,-20,34
St Mirren,8248,10,7,12,17,39,60,-21,33
Hibernian,8249,1,18,12,6,53,27,26,66
Falkirk,8249,2,18,11,7,62,35,27,65
Morton,8249,3,15,13,8,47,35,12,58
Dundee Utd,8249,4,13,13,10,47,43,4,52
Queen of S't,8249,5,13,10,13,48,46,2,49
Raith,8249,6,11,8,17,32,51,-19,41
St Mirren,8249,7,10,10,16,43,52,-9,40
Dunfermline,8249,8,7,16,13,42,49,-7,37
Dumbarton,8249,9,9,10,17,44,61,-17,37
Ayr,8249,10,8,13,15,34,53,-19,37
Hibernian,8250,1,18,12,6,53,26,27,66
Morton,8250,2,17,14,5,52,35,17,65
Falkirk,8250,3,17,10,9,59,41,18,61
Dundee Utd,8250,4,15,9,12,46,40,6,54
Queen of S't,8250,5,13,9,14,45,46,-1,48
Dunfermline,8250,6,10,11,15,45,51,-6,41
Ayr,8250,7,9,13,14,36,52,-16,40
Dumbarton,8250,8,9,11,16,47,58,-11,38
St Mirren,8250,9,9,10,17,39,54,-15,37
Raith,8250,10,9,9,18,37,56,-19,36
Hibernian,8251,1,20,11,5,55,25,30,71
Morton,8251,2,18,10,8,50,37,13,64
Falkirk,8251,3,16,11,9,57,40,17,59
Dundee Utd,8251,4,14,10,12,50,45,5,52
Queen of S't,8251,5,14,10,12,45,43,2,52
Dunfermline,8251,6,10,14,12,45,46,-1,44
Dumbarton,8251,7,10,12,14,48,53,-5,42
St Mirren,8251,8,8,11,17,36,53,-17,35
Raith,8251,9,9,8,19,32,52,-20,35
Ayr,8251,10,7,11,18,29,53,-24,32
Hibernian,8252,1,19,11,6,56,31,25,68
Morton,8252,2,18,10,8,51,35,16,64
Dundee Utd,8252,3,18,9,9,51,36,15,63
Falkirk,8252,4,15,10,11,57,43,14,55
Dunfermline,8252,5,10,13,13,49,50,-1,43
Queen of S't,8252,6,11,9,16,42,51,-9,42
Raith,8252,7,11,9,16,38,51,-13,42
Ayr,8252,8,10,11,15,36,55,-19,41
Dumbarton,8252,9,8,12,16,48,60,-12,36
St Mirren,8252,10,7,12,17,42,58,-16,33
Hibernian,8253,1,20,13,3,58,24,34,73
Morton,8253,2,18,11,7,53,37,16,65
Dundee Utd,8253,3,17,11,8,56,35,21,62
Falkirk,8253,4,16,9,11,59,45,14,57
Dunfermline,8253,5,10,12,14,48,50,-2,42
Queen of S't,8253,6,9,11,16,44,54,-10,38
Dumbarton,8253,7,9,11,16,49,65,-16,38
Raith,8253,8,9,10,17,33,49,-16,37
Ayr,8253,9,8,13,15,34,53,-19,37
St Mirren,8253,10,9,9,18,42,64,-22,36
Hibernian,8254,1,19,14,3,56,22,34,71
Morton,8254,2,16,14,6,54,36,18,62
Falkirk,8254,3,16,11,9,59,42,17,59
Dundee Utd,8254,4,15,10,11,48,40,8,55
Queen of S't,8254,5,11,11,14,46,50,-4,44
Dunfermline,8254,6,10,12,14,42,51,-9,42
Ayr,8254,7,9,12,15,32,53,-21,39
Raith,8254,8,9,11,16,34,49,-15,38
St Mirren,8254,9,8,13,15,40,55,-15,37
Dumbarton,8254,10,8,10,18,44,57,-13,34
Hibernian,8255,1,19,13,4,55,26,29,70
Dundee Utd,8255,2,19,8,9,55,36,19,65
Morton,8255,3,17,11,8,46,34,12,62
Falkirk,8255,4,13,13,10,56,44,12,52
Dumbarton,8255,5,12,11,13,55,57,-2,47
Dunfermline,8255,6,9,14,13,46,50,-4,41
Queen of S't,8255,7,10,11,15,45,54,-9,41
Raith,8255,8,9,11,16,35,50,-15,38
St Mirren,8255,9,9,10,17,41,59,-18,37
Ayr,8255,10,7,10,19,35,59,-24,31
Hibernian,8256,1,19,12,5,56,24,32,69
Dundee Utd,8256,2,16,12,8,55,39,16,60
Morton,8256,3,15,13,8,50,41,9,58
Falkirk,8256,4,14,9,13,51,44,7,51
Queen of S't,8256,5,14,9,13,49,49,0,51
Dunfermline,8256,6,11,12,13,48,46,2,45
Raith,8256,7,10,10,16,36,50,-14,40
Ayr,8256,8,9,12,15,36,55,-19,39
Dumbarton,8256,9,8,13,15,45,59,-14,37
St Mirren,8256,10,8,10,18,39,58,-19,34
Hibernian,8257,1,19,11,6,58,26,32,68
Morton,8257,2,17,12,7,50,34,16,63
Dundee Utd,8257,3,18,9,9,49,35,14,63
Falkirk,8257,4,16,10,10,58,42,16,58
Dunfermline,8257,5,10,13,13,44,46,-2,43
Queen of S't,8257,6,11,10,15,44,53,-9,43
Dumbarton,8257,7,10,12,14,48,54,-6,42
Raith,8257,8,11,9,16,36,47,-11,42
St Mirren,8257,9,9,9,18,40,58,-18,36
Ayr,8257,10,6,11,19,29,61,-32,29
Hibernian,8258,1,19,14,3,57,24,33,71
Dundee Utd,8258,2,19,8,9,57,41,16,65
Morton,8258,3,17,12,7,53,34,19,63
Falkirk,8258,4,16,11,9,59,40,19,59
Dunfermline,8258,5,9,15,12,47,50,-3,42
Queen of S't,8258,6,10,10,16,44,55,-11,40
Dumbarton,8258,7,9,12,15,48,57,-9,39
Raith,8258,8,9,11,16,34,52,-18,38
Ayr,8258,9,7,13,16,31,55,-24,34
St Mirren,8258,10,7,10,19,40,62,-22,31
Hibernian,8259,1,19,11,6,59,27,32,68
Morton,8259,2,18,10,8,54,37,17,64
Dundee Utd,8259,3,16,11,9,48,37,11,59
Falkirk,8259,4,15,12,9,59,43,16,57
Queen of S't,8259,5,12,9,15,45,49,-4,45
Raith,8259,6,11,9,16,36,54,-18,42
Dumbarton,8259,7,9,12,15,46,54,-8,39
St Mirren,8259,8,9,11,16,39,54,-15,38
Dunfermline,8259,9,8,13,15,44,53,-9,37
Ayr,8259,10,8,12,16,31,53,-22,36
Falkirk,8260,1,18,10,8,66,38,28,64
Hibernian,8260,2,16,12,8,50,32,18,60
Morton,8260,3,15,13,8,46,39,7,58
Dundee Utd,8260,4,15,11,10,50,38,12,56
Dunfermline,8260,5,12,11,13,52,52,0,47
Queen of S't,8260,6,11,11,14,44,48,-4,44
Raith,8260,7,10,10,16,35,49,-14,40
Dumbarton,8260,8,9,12,15,47,58,-11,39
St Mirren,8260,9,9,12,15,37,49,-12,39
Ayr,8260,10,7,14,15,31,55,-24,35
Hibernian,8261,1,20,12,4,56,25,31,72
Falkirk,8261,2,17,10,9,61,41,20,61
Morton,8261,3,15,14,7,49,37,12,59
Dundee Utd,8261,4,14,9,13,43,42,1,51
Raith,8261,5,11,10,15,39,46,-7,43
Dunfermline,8261,6,9,14,13,44,50,-6,41
Queen of S't,8261,7,10,10,16,41,51,-10,40
Ayr,8261,8,8,16,12,34,48,-14,40
Dumbarton,8261,9,9,12,15,48,55,-7,39
St Mirren,8261,10,8,11,17,39,59,-20,35
Hibernian,8262,1,19,11,6,55,27,28,68
Morton,8262,2,16,12,8,50,36,14,60
Dundee Utd,8262,3,15,11,10,53,42,11,56
Falkirk,8262,4,14,12,10,57,44,13,54
Queen of S't,8262,5,12,9,15,43,48,-5,45
Dunfermline,8262,6,10,14,12,49,49,0,44
Dumbarton,8262,7,10,12,14,52,59,-7,42
Raith,8262,8,10,11,15,32,46,-14,41
Ayr,8262,9,7,15,14,34,56,-22,36
St Mirren,8262,10,7,13,16,37,55,-18,34
Hibernian,8263,1,18,12,6,52,26,26,66
Falkirk,8263,2,17,10,9,61,40,21,61
Morton,8263,3,16,13,7,52,36,16,61
Dundee Utd,8263,4,16,9,11,48,39,9,57
Dunfermline,8263,5,9,14,13,47,52,-5,41
Queen of S't,8263,6,10,11,15,41,46,-5,41
Raith,8263,7,10,10,16,34,49,-15,40
Ayr,8263,8,9,13,14,31,51,-20,40
Dumbarton,8263,9,9,11,16,50,58,-8,38
St Mirren,8263,10,9,11,16,39,58,-19,38
Dundee Utd,8264,1,17,11,8,51,34,17,62
Hibernian,8264,2,16,13,7,52,31,21,61
Morton,8264,3,16,13,7,52,37,15,61
Falkirk,8264,4,16,11,9,58,39,19,59
Raith,8264,5,11,10,15,38,47,-9,43
Dumbarton,8264,6,10,12,14,48,51,-3,42
Queen of S't,8264,7,10,10,16,41,55,-14,40
Dunfermline,8264,8,9,12,15,43,53,-10,39
Ayr,8264,9,9,11,16,35,57,-22,38
St Mirren,8264,10,8,13,15,40,54,-14,37
Hibernian,8265,1,19,12,5,52,23,29,69
Falkirk,8265,2,16,11,9,60,40,20,59
Dundee Utd,8265,3,15,12,9,50,40,10,57
Morton,8265,4,15,12,9,46,37,9,57
Dunfermline,8265,5,11,12,13,49,49,0,45
Queen of S't,8265,6,11,9,16,42,55,-13,42
Dumbarton,8265,7,9,14,13,50,56,-6,41
Ayr,8265,8,8,15,13,31,47,-16,39
St Mirren,8265,9,8,12,16,40,54,-14,36
Raith,8265,10,9,9,18,34,53,-19,36
Hibernian,8266,1,20,11,5,60,25,35,71
Dundee Utd,8266,2,18,9,9,55,40,15,63
Morton,8266,3,17,10,9,50,38,12,61
Falkirk,8266,4,14,12,10,57,45,12,54
Queen of S't,8266,5,13,10,13,49,48,1,49
Dunfermline,8266,6,12,12,12,47,44,3,48
Dumbarton,8266,7,8,13,15,48,62,-14,37
Raith,8266,8,8,12,16,39,56,-17,36
Ayr,8266,9,6,14,16,31,59,-28,32
St Mirren,8266,10,6,13,17,34,53,-19,31
Hibernian,8267,1,18,12,6,51,28,23,66
Morton,8267,2,15,12,9,54,45,9,57
Falkirk,8267,3,15,10,11,54,41,13,55
Dundee Utd,8267,4,14,12,10,54,41,13,54
Queen of S't,8267,5,13,9,14,48,49,-1,48
Dunfermline,8267,6,11,13,12,52,50,2,46
Raith,8267,7,12,9,15,43,48,-5,45
Ayr,8267,8,11,11,14,36,55,-19,44
Dumbarton,8267,9,9,12,15,52,61,-9,39
St Mirren,8267,10,6,12,18,34,60,-26,30
Hibernian,8268,1,21,11,4,59,25,34,74
Dundee Utd,8268,2,17,10,9,51,37,14,61
Morton,8268,3,16,11,9,52,42,10,59
Falkirk,8268,4,15,12,9,62,44,18,57
Dunfermline,8268,5,10,14,12,47,50,-3,44
Queen of S't,8268,6,10,10,16,43,51,-8,40
Ayr,8268,7,9,13,14,35,51,-16,40
Raith,8268,8,10,8,18,35,52,-17,38
St Mirren,8268,9,8,12,16,40,55,-15,36
Dumbarton,8268,10,7,13,16,48,65,-17,34
Hibernian,8269,1,20,12,4,54,24,30,72
Morton,8269,2,16,13,7,50,35,15,61
Falkirk,8269,3,15,11,10,59,44,15,56
Dundee Utd,8269,4,13,10,13,48,46,2,49
Queen of S't,8269,5,13,9,14,45,49,-4,48
Dunfermline,8269,6,9,15,12,48,48,0,42
Ayr,8269,7,10,12,14,36,54,-18,42
St Mirren,8269,8,9,11,16,46,56,-10,38
Raith,8269,9,9,11,16,31,48,-17,38
Dumbarton,8269,10,7,14,15,48,61,-13,35
Hibernian,8270,1,22,10,4,66,29,37,76
Morton,8270,2,19,10,7,60,36,24,67
Dundee Utd,8270,3,17,11,8,54,36,18,62
Falkirk,8270,4,15,10,11,57,44,13,55
Queen of S't,8270,5,11,8,17,44,54,-10,41
Dumbarton,8270,6,10,11,15,49,60,-11,41
Dunfermline,8270,7,9,12,15,41,48,-7,39
Ayr,8270,8,8,14,14,34,53,-19,38
Raith,8270,9,9,9,18,33,54,-21,36
St Mirren,8270,10,8,9,19,37,61,-24,33
Hibernian,8271,1,17,13,6,56,28,28,64
Morton,8271,2,17,13,6,53,35,18,64
Falkirk,8271,3,14,12,10,56,46,10,54
Dundee Utd,8271,4,13,14,9,46,37,9,53
Queen of S't,8271,5,13,11,12,55,47,8,50
Dumbarton,8271,6,9,14,13,48,61,-13,41
Raith,8271,7,10,11,15,36,49,-13,41
Dunfermline,8271,8,8,15,13,41,47,-6,39
Ayr,8271,9,8,12,16,33,56,-23,36
St Mirren,8271,10,8,11,17,43,61,-18,35
Hibernian,8272,1,17,11,8,49,26,23,62
Falkirk,8272,2,17,11,8,58,39,19,62
Morton,8272,3,16,11,9,54,42,12,59
Dundee Utd,8272,4,16,10,10,53,38,15,58
Queen of S't,8272,5,15,8,13,48,45,3,53
Dunfermline,8272,6,10,12,14,47,54,-7,42
St Mirren,8272,7,10,10,16,46,61,-15,40
Raith,8272,8,10,9,17,38,53,-15,39
Ayr,8272,9,8,13,15,37,55,-18,37
Dumbarton,8272,10,8,11,17,47,64,-17,35
Hibernian,8273,1,20,11,5,56,27,29,71
Dundee Utd,8273,2,16,10,10,59,46,13,58
Morton,8273,3,15,11,10,45,42,3,56
Falkirk,8273,4,15,10,11,54,41,13,55
Queen of S't,8273,5,12,10,14,53,51,2,46
Dunfermline,8273,6,11,13,12,49,47,2,46
St Mirren,8273,7,11,9,16,44,53,-9,42
Raith,8273,8,11,8,17,32,47,-15,41
Dumbarton,8273,9,9,10,17,44,62,-18,37
Ayr,8273,10,9,10,17,42,62,-20,37
Hibernian,8274,1,20,12,4,56,24,32,72
Morton,8274,2,18,10,8,55,38,17,64
Dundee Utd,8274,3,15,11,10,51,43,8,56
Falkirk,8274,4,14,11,11,54,45,9,53
Queen of S't,8274,5,13,10,13,47,50,-3,49
Dumbarton,8274,6,11,10,15,53,56,-3,43
Dunfermline,8274,7,10,11,15,47,47,0,41
Raith,8274,8,10,10,16,35,53,-18,40
Ayr,8274,9,8,14,14,35,53,-18,38
St Mirren,8274,10,6,11,19,38,62,-24,29
Hibernian,8275,1,20,12,4,58,26,32,72
Falkirk,8275,2,16,11,9,59,41,18,59
Dundee Utd,8275,3,16,10,10,54,40,14,58
Morton,8275,4,15,12,9,50,43,7,57
Dunfermline,8275,5,10,15,11,48,46,2,45
Queen of S't,8275,6,11,10,15,45,57,-12,43
St Mirren,8275,7,10,11,15,44,54,-10,41
Ayr,8275,8,9,12,15,35,55,-20,39
Dumbarton,8275,9,8,12,16,47,60,-13,36
Raith,8275,10,8,9,19,34,52,-18,33
Hibernian,8276,1,17,14,5,56,28,28,65
Morton,8276,2,18,11,7,53,41,12,65
Falkirk,8276,3,16,10,10,62,46,16,58
Dundee Utd,8276,4,15,9,12,51,46,5,54
Dunfermline,8276,5,12,13,11,53,47,6,49
Queen of S't,8276,6,11,12,13,42,47,-5,45
Dumbarton,8276,7,9,12,15,52,60,-8,39
Raith,8276,8,9,10,17,36,52,-16,37
St Mirren,8276,9,9,9,18,39,54,-15,36
Ayr,8276,10,8,12,16,34,57,-23,36
Hibernian,8277,1,19,11,6,52,25,27,68
Falkirk,8277,2,15,14,7,56,36,20,59
Morton,8277,3,16,9,11,49,40,9,57
Dundee Utd,8277,4,15,10,11,51,40,11,55
Dunfermline,8277,5,11,13,12,44,45,-1,46
Queen of S't,8277,6,12,10,14,45,47,-2,46
Ayr,8277,7,12,10,14,38,53,-15,46
Raith,8277,8,11,9,16,37,50,-13,42
St Mirren,8277,9,8,10,18,39,59,-20,34
Dumbarton,8277,10,7,12,17,43,59,-16,33
Hibernian,8278,1,19,11,6,52,27,25,68
Morton,8278,2,18,13,5,56,33,23,67
Falkirk,8278,3,17,9,10,63,40,23,60
Dundee Utd,8278,4,16,10,10,51,41,10,58
Dunfermline,8278,5,10,12,14,51,51,0,42
Queen of S't,8278,6,11,9,16,41,47,-6,42
Ayr,8278,7,9,11,16,39,57,-18,38
Raith,8278,8,9,11,16,35,56,-21,38
Dumbarton,8278,9,9,10,17,48,67,-19,37
St Mirren,8278,10,8,12,16,41,58,-17,36
Hibernian,8279,1,18,12,6,56,27,29,66
Falkirk,8279,2,17,10,9,65,42,23,61
Dundee Utd,8279,3,16,11,9,53,39,14,59
Morton,8279,4,15,12,9,49,40,9,57
Dunfermline,8279,5,13,12,11,49,46,3,51
Queen of S't,8279,6,11,10,15,48,53,-5,43
St Mirren,8279,7,11,9,16,42,55,-13,42
Raith,8279,8,10,9,17,34,52,-18,39
Dumbarton,8279,9,8,11,17,45,58,-13,35
Ayr,8279,10,7,12,17,31,60,-29,33
Hibernian,8280,1,19,13,4,62,28,34,70
Falkirk,8280,2,17,11,8,63,39,24,62
Morton,8280,3,17,11,8,50,39,11,62
Dundee Utd,8280,4,14,9,13,48,46,2,51
Queen of S't,8280,5,13,8,15,42,53,-11,47
Raith,8280,6,12,9,15,38,48,-10,45
Dunfermline,8280,7,10,12,14,53,52,1,42
Dumbarton,8280,8,10,12,14,51,56,-5,42
Ayr,8280,9,7,12,17,30,58,-28,33
St Mirren,8280,10,7,11,18,38,56,-18,32
Hibernian,8281,1,20,12,4,63,25,38,72
Falkirk,8281,2,16,11,9,60,44,16,59
Morton,8281,3,15,13,8,50,39,11,58
Dundee Utd,8281,4,15,11,10,52,41,11,56
Queen of S't,8281,5,12,9,15,46,57,-11,45
Dunfermline,8281,6,11,11,14,51,52,-1,44
Raith,8281,7,10,11,15,36,46,-10,41
St Mirren,8281,8,8,13,15,39,54,-15,37
Ayr,8281,9,8,12,16,35,59,-24,36
Dumbarton,8281,10,8,11,17,44,59,-15,35
Hibernian,8282,1,18,12,6,53,27,26,66
Morton,8282,2,18,11,7,51,38,13,65
Falkirk,8282,3,17,11,8,68,44,24,62
Dundee Utd,8282,4,13,10,13,48,48,0,49
Queen of S't,8282,5,12,11,13,48,47,1,47
Dunfermline,8282,6,10,15,11,47,46,1,45
Dumbarton,8282,7,8,13,15,46,59,-13,37
Raith,8282,8,9,10,17,41,56,-15,37
St Mirren,8282,9,9,10,17,41,58,-17,37
Ayr,8282,10,7,15,14,36,56,-20,36
Hibernian,8283,1,20,13,3,56,24,32,73
Morton,8283,2,17,12,7,51,35,16,63
Falkirk,8283,3,16,9,11,55,41,14,57
Dundee Utd,8283,4,16,8,12,50,43,7,56
Queen of S't,8283,5,15,8,13,48,45,3,53
Dunfermline,8283,6,10,13,13,50,47,3,43
Dumbarton,8283,7,8,12,16,45,61,-16,36
Ayr,8283,8,8,12,16,36,55,-19,36
Raith,8283,9,9,9,18,32,53,-21,36
St Mirren,8283,10,8,10,18,37,56,-19,34
Hibernian,8284,1,19,11,6,53,29,24,68
Dundee Utd,8284,2,17,10,9,51,36,15,61
Morton,8284,3,16,11,9,54,40,14,59
Falkirk,8284,4,16,10,10,57,41,16,58
Dunfermline,8284,5,12,11,13,49,45,4,47
Queen of S't,8284,6,11,11,14,45,53,-8,44
Dumbarton,8284,7,10,13,13,52,59,-7,43
Raith,8284,8,10,8,18,35,51,-16,38
Ayr,8284,9,8,11,17,36,59,-23,35
St Mirren,8284,10,8,10,18,39,58,-19,34
Hibernian,8285,1,18,12,6,54,29,25,66
Morton,8285,2,18,11,7,55,36,19,65
Falkirk,8285,3,15,13,8,56,36,20,58
Dundee Utd,8285,4,14,8,14,46,49,-3,50
Queen of S't,8285,5,13,9,14,53,54,-1,48
Raith,8285,6,11,11,14,36,49,-13,44
Dumbarton,8285,7,10,12,14,44,51,-7,42
Dunfermline,8285,8,9,13,14,47,53,-6,40
Ayr,8285,9,9,11,16,36,53,-17,38
St Mirren,8285,10,7,12,17,38,55,-17,33
Hibernian,8286,1,18,14,4,55,26,29,68
Dundee Utd,8286,2,17,9,10,53,39,14,60
Falkirk,8286,3,16,11,9,56,39,17,59
Morton,8286,4,16,11,9,52,37,15,59
Dunfermline,8286,5,10,14,12,46,49,-3,44
Queen of S't,8286,6,11,9,16,39,48,-9,42
Raith,8286,7,10,11,15,34,46,-12,41
Ayr,8286,8,9,11,16,34,58,-24,38
Dumbarton,8286,9,8,12,16,48,60,-12,36
St Mirren,8286,10,8,12,16,40,55,-15,36
Hibernian,8287,1,22,10,4,63,23,40,76
Morton,8287,2,18,11,7,53,35,18,65
Dundee Utd,8287,3,17,9,10,58,44,14,60
Falkirk,8287,4,13,12,11,53,43,10,51
Queen of S't,8287,5,12,9,15,50,52,-2,45
Ayr,8287,6,11,12,13,43,55,-12,45
Dumbarton,8287,7,9,11,16,49,61,-12,38
Raith,8287,8,10,8,18,35,53,-18,38
Dunfermline,8287,9,8,12,16,38,51,-13,36
St Mirren,8287,10,8,10,18,40,65,-25,34
Morton,8288,1,21,10,5,61,31,30,73
Hibernian,8288,2,18,11,7,53,29,24,65
Falkirk,8288,3,16,9,11,58,46,12,57
Dundee Utd,8288,4,15,10,11,48,41,7,55
Queen of S't,8288,5,11,11,14,44,49,-5,44
Raith,8288,6,11,9,16,38,51,-13,42
Dumbarton,8288,7,10,11,15,49,58,-9,41
Dunfermline,8288,8,9,12,15,44,56,-12,39
St Mirren,8288,9,9,10,17,44,57,-13,37
Ayr,8288,10,8,11,17,31,52,-21,35
Hibernian,8289,1,21,11,4,60,25,35,74
Morton,8289,2,17,11,8,52,38,14,62
Dundee Utd,8289,3,17,9,10,48,39,9,60
Falkirk,8289,4,16,11,9,57,41,16,59
Dunfermline,8289,5,11,13,12,48,46,2,46
Queen of S't,8289,6,11,9,16,43,48,-5,42
Raith,8289,7,11,9,16,35,49,-14,42
Dumbarton,8289,8,8,11,17,47,64,-17,35
St Mirren,8289,9,7,12,17,43,58,-15,33
Ayr,8289,10,7,12,17,32,57,-25,33
Hibernian,8290,1,17,12,7,51,28,23,63
Falkirk,8290,2,16,12,8,59,40,19,60
Morton,8290,3,16,11,9,48,38,10,59
Dundee Utd,8290,4,15,9,12,47,43,4,54
Dunfermline,8290,5,12,11,13,46,43,3,47
St Mirren,8290,6,12,10,14,43,51,-8,46
Raith,8290,7,11,8,17,36,47,-11,41
Queen of S't,8290,8,10,10,16,42,51,-9,40
Ayr,8290,9,9,12,15,34,53,-19,39
Dumbarton,8290,10,8,13,15,45,57,-12,37
Hibernian,8291,1,21,11,4,53,24,29,74
Falkirk,8291,2,17,10,9,58,40,18,61
Dundee Utd,8291,3,17,10,9,49,35,14,61
Morton,8291,4,16,9,11,47,40,7,57
Dunfermline,8291,5,10,13,13,42,45,-3,43
Queen of S't,8291,6,10,13,13,42,47,-5,43
St Mirren,8291,7,9,12,15,43,53,-10,39
Raith,8291,8,9,11,16,35,47,-12,38
Dumbarton,8291,9,8,11,17,47,62,-15,35
Ayr,8291,10,7,12,17,31,54,-23,33
Hibernian,8292,1,20,12,4,60,25,35,72
Morton,8292,2,16,12,8,50,36,14,60
Dundee Utd,8292,3,17,9,10,51,39,12,60
Falkirk,8292,4,15,11,10,58,41,17,56
Queen of S't,8292,5,12,11,13,45,49,-4,47
Dunfermline,8292,6,9,14,13,47,51,-4,41
Dumbarton,8292,7,10,11,15,51,57,-6,41
Raith,8292,8,10,10,16,32,48,-16,40
St Mirren,8292,9,8,10,18,39,58,-19,34
Ayr,8292,10,8,10,18,31,60,-29,34
Morton,8293,1,18,11,7,54,36,18,65
Hibernian,8293,2,17,13,6,51,29,22,64
Dundee Utd,8293,3,18,9,9,52,35,17,63
Falkirk,8293,4,15,11,10,56,43,13,56
Raith,8293,5,12,9,15,38,45,-7,45
Queen of S't,8293,6,11,9,16,44,52,-8,42
Dunfermline,8293,7,9,13,14,46,51,-5,40
St Mirren,8293,8,10,10,16,44,51,-7,40
Dumbarton,8293,9,9,10,17,43,62,-19,37
Ayr,8293,10,8,11,17,35,59,-24,35
Hibernian,8294,1,20,10,6,56,26,30,70
Morton,8294,2,18,11,7,54,37,17,65
Falkirk,8294,3,17,10,9,62,40,22,61
Dundee Utd,8294,4,14,9,13,46,43,3,51
Dunfermline,8294,5,10,13,13,48,49,-1,43
Raith,8294,6,11,10,15,37,47,-10,43
Queen of S't,8294,7,11,8,17,46,57,-11,41
Ayr,8294,8,10,10,16,37,58,-21,40
Dumbarton,8294,9,9,11,16,48,60,-12,38
St Mirren,8294,10,9,10,17,39,56,-17,37
Hibernian,8295,1,19,12,5,51,25,26,69
Morton,8295,2,17,11,8,53,42,11,62
Dundee Utd,8295,3,17,9,10,54,40,14,60
Falkirk,8295,4,16,11,9,61,43,18,59
Queen of S't,8295,5,12,12,12,49,47,2,48
Dunfermline,8295,6,10,12,14,47,51,-4,42
Dumbarton,8295,7,9,12,15,53,61,-8,39
Raith,8295,8,9,10,17,36,53,-17,37
St Mirren,8295,9,8,11,17,43,59,-16,35
Ayr,8295,10,6,14,16,31,57,-26,32
Hibernian,8296,1,22,10,4,64,29,35,76
Morton,8296,2,17,10,9,57,39,18,61
Falkirk,8296,3,17,9,10,57,41,16,60
Dundee Utd,8296,4,15,10,11,50,39,11,55
Dunfermline,8296,5,11,12,13,46,50,-4,45
Raith,8296,6,11,11,14,39,49,-10,44
Dumbarton,8296,7,10,10,16,51,59,-8,40
Queen of S't,8296,8,10,10,16,49,58,-9,40
St Mirren,8296,9,8,10,18,38,61,-23,34
Ayr,8296,10,7,12,17,35,61,-26,33
Hibernian,8297,1,19,12,5,56,27,29,69
Falkirk,8297,2,17,12,7,65,39,26,63
Morton,8297,3,16,12,8,49,37,12,60
Dundee Utd,8297,4,14,12,10,47,41,6,54
Queen of S't,8297,5,11,11,14,43,49,-6,44
Dunfermline,8297,6,9,14,13,45,50,-5,41
Raith,8297,7,9,11,16,36,52,-16,38
Ayr,8297,8,8,14,14,41,58,-17,38
St Mirren,8297,9,9,10,17,41,59,-18,37
Dumbarton,8297,10,7,14,15,48,59,-11,35
Morton,8298,1,19,11,6,52,34,18,68
Hibernian,8298,2,17,15,4,51,25,26,66
Falkirk,8298,3,14,13,9,54,38,16,55
Dundee Utd,8298,4,15,9,12,48,43,5,54
Dunfermline,8298,5,11,12,13,50,47,3,45
Raith,8298,6,12,9,15,40,48,-8,45
Queen of S't,8298,7,10,11,15,44,52,-8,41
Dumbarton,8298,8,9,12,15,46,56,-10,39
St Mirren,8298,9,8,11,17,40,58,-18,35
Ayr,8298,10,8,11,17,33,57,-24,35
Hibernian,8299,1,19,14,3,54,24,30,71
Dundee Utd,8299,2,17,10,9,55,38,17,61
Morton,8299,3,15,12,9,50,37,13,57
Falkirk,8299,4,15,9,12,58,46,12,54
Dunfermline,8299,5,10,13,13,45,50,-5,43
Dumbarton,8299,6,11,10,15,51,58,-7,43
Queen of S't,8299,7,11,10,15,45,53,-8,43
St Mirren,8299,8,10,10,16,42,58,-16,40
Raith,8299,9,9,10,17,38,50,-12,37
Ayr,8299,10,7,14,15,34,58,-24,35
Morton,8300,1,19,10,7,57,36,21,67
Hibernian,8300,2,17,12,7,55,30,25,63
Dundee Utd,8300,3,18,8,10,53,42,11,62
Falkirk,8300,4,16,12,8,56,36,20,60
Dunfermline,8300,5,11,12,13,45,45,0,45
Queen of S't,8300,6,11,9,16,45,54,-9,42
Raith,8300,7,10,9,17,33,51,-18,39
St Mirren,8300,8,9,11,16,44,57,-13,38
Dumbarton,8300,9,8,12,16,45,59,-14,36
Ayr,8300,10,8,11,17,40,63,-23,35
Hibernian,8301,1,18,12,6,56,29,27,66
Falkirk,8301,2,17,11,8,61,39,22,62
Dundee Utd,8301,3,17,9,10,52,42,10,60
Morton,8301,4,14,12,10,48,43,5,54
Dunfermline,8301,5,10,14,12,47,48,-1,44
Queen of S't,8301,6,11,9,16,43,48,-5,42
Dumbarton,8301,7,9,13,14,49,59,-10,40
Raith,8301,8,10,10,16,32,47,-15,40
St Mirren,8301,9,9,11,16,39,52,-13,38
Ayr,8301,10,8,13,15,33,53,-20,37
Hibernian,8302,1,19,14,3,65,28,37,71
Dundee Utd,8302,2,17,10,9,54,39,15,61
Morton,8302,3,16,13,7,53,38,15,61
Falkirk,8302,4,14,9,13,55,51,4,51
Dumbarton,8302,5,11,11,14,50,54,-4,44
Raith,8302,6,10,11,15,35,44,-9,41
Dunfermline,8302,7,9,13,14,42,49,-7,40
Queen of S't,8302,8,10,10,16,43,55,-12,40
St Mirren,8302,9,10,10,16,40,55,-15,40
Ayr,8302,10,8,11,17,32,56,-24,35
Hibernian,8303,1,19,14,3,60,28,32,71
Morton,8303,2,17,13,6,57,38,19,64
Falkirk,8303,3,17,10,9,61,39,22,61
Dundee Utd,8303,4,15,11,10,57,42,15,56
Dunfermline,8303,5,11,11,14,51,55,-4,44
Queen of S't,8303,6,11,10,15,45,49,-4,43
Dumbarton,8303,7,10,12,14,52,60,-8,42
Raith,8303,8,10,8,18,35,55,-20,38
Ayr,8303,9,8,10,18,32,57,-25,34
St Mirren,8303,10,7,11,18,39,66,-27,32
Hibernian,8304,1,19,12,5,56,26,30,69
Dundee Utd,8304,2,17,10,9,51,39,12,61
Falkirk,8304,3,16,11,9,61,41,20,59
Morton,8304,4,15,9,12,45,45,0,54
Dunfermline,8304,5,12,13,11,57,50,7,49
Queen of S't,8304,6,12,10,14,53,51,2,46
Ayr,8304,7,10,11,15,36,54,-18,41
Dumbarton,8304,8,9,10,17,45,61,-16,37
Raith,8304,9,9,10,17,36,53,-17,37
St Mirren,8304,10,8,10,18,39,59,-20,34
Hibernian,8305,1,20,13,3,58,22,36,73
Falkirk,8305,2,16,11,9,59,43,16,59
Dundee Utd,8305,3,16,8,12,53,46,7,56
Morton,8305,4,15,11,10,49,43,6,56
Dunfermline,8305,5,10,14,12,48,49,-1,44
St Mirren,8305,6,11,10,15,42,52,-10,43
Dumbarton,8305,7,10,12,14,54,60,-6,42
Raith,8305,8,10,10,16,37,49,-12,40
Queen of S't,8305,9,10,9,17,41,51,-10,39
Ayr,8305,10,8,10,18,36,62,-26,34
Hibernian,8306,1,17,14,5,53,33,20,65
Morton,8306,2,17,13,6,50,31,19,64
Falkirk,8306,3,16,11,9,61,40,21,59
Dundee Utd,8306,4,16,8,12,57,41,16,56
Queen of S't,8306,5,13,11,12,49,46,3,50
St Mirren,8306,6,11,11,14,43,50,-7,44
Dumbarton,8306,7,8,13,15,50,68,-18,37
Dunfermline,8306,8,7,15,14,41,52,-11,36
Raith,8306,9,8,12,16,29,46,-17,36
Ayr,8306,10,7,12,17,33,59,-26,33
Hibernian,8307,1,21,11,4,60,27,33,74
Falkirk,8307,2,17,10,9,61,41,20,61
Dundee Utd,8307,3,15,11,10,53,40,13,56
Morton,8307,4,15,11,10,46,36,10,56
Queen of S't,8307,5,14,8,14,49,51,-2,50
Dunfermline,8307,6,12,11,13,45,48,-3,47
Ayr,8307,7,8,14,14,36,55,-19,38
Dumbarton,8307,8,9,10,17,46,59,-13,37
Raith,8307,9,9,9,18,35,55,-20,36
St Mirren,8307,10,7,11,18,39,58,-19,32
Hibernian,8308,1,21,10,5,61,26,35,73
Morton,8308,2,18,10,8,55,39,16,64
Dundee Utd,8308,3,17,10,9,51,36,15,61
Falkirk,8308,4,15,10,11,53,40,13,55
Queen of S't,8308,5,11,10,15,45,49,-4,43
Dunfermline,8308,6,10,13,13,47,53,-6,43
Dumbarton,8308,7,10,11,15,46,58,-12,41
Raith,8308,8,10,9,17,37,52,-15,39
St Mirren,8308,9,9,9,18,44,60,-16,36
Ayr,8308,10,7,12,17,31,57,-26,33
Hibernian,8309,1,21,10,5,53,25,28,73
Morton,8309,2,18,10,8,55,36,19,64
Falkirk,8309,3,16,11,9,63,41,22,59
Dundee Utd,8309,4,16,11,9,52,41,11,59
Queen of S't,8309,5,12,9,15,41,50,-9,45
Dunfermline,8309,6,9,13,14,43,47,-4,40
Raith,8309,7,10,9,17,34,51,-17,39
Ayr,8309,8,9,11,16,37,55,-18,38
Dumbarton,8309,9,8,11,17,49,64,-15,35
St Mirren,8309,10,8,11,17,40,57,-17,35
Falkirk,8310,1,19,9,8,61,38,23,66
Hibernian,8310,2,17,11,8,50,30,20,62
Morton,8310,3,16,13,7,46,32,14,61
Dundee Utd,8310,4,15,10,11,48,39,9,55
Queen of S't,8310,5,13,9,14,45,47,-2,48
Dumbarton,8310,6,10,11,15,50,58,-8,41
Ayr,8310,7,10,11,15,35,52,-17,41
Dunfermline,8310,8,9,13,14,44,50,-6,40
Raith,8310,9,10,10,16,37,52,-15,40
St Mirren,8310,10,7,11,18,41,59,-18,32
Hibernian,8311,1,21,11,4,54,21,33,74
Dundee Utd,8311,2,17,10,9,49,39,10,61
Morton,8311,3,15,13,8,49,39,10,58
Falkirk,8311,4,15,12,9,58,41,17,57
Queen of S't,8311,5,12,8,16,50,57,-7,44
Dumbarton,8311,6,10,12,14,51,55,-4,42
Dunfermline,8311,7,10,12,14,45,49,-4,42
Raith,8311,8,11,9,16,37,48,-11,42
Ayr,8311,9,8,11,17,33,55,-22,35
St Mirren,8311,10,7,10,19,38,60,-22,31
Hibernian,8312,1,22,10,4,65,23,42,76
Morton,8312,2,19,11,6,53,34,19,68
Dundee Utd,8312,3,16,9,11,50,41,9,57
Falkirk,8312,4,15,10,11,56,46,10,55
Queen of S't,8312,5,11,10,15,44,52,-8,43
Dunfermline,8312,6,10,12,14,45,49,-4,42
Raith,8312,7,11,9,16,37,50,-13,42
Dumbarton,8312,8,9,12,15,50,61,-11,39
St Mirren,8312,9,8,9,19,40,59,-19,33
Ayr,8312,10,7,12,17,29,54,-25,33
Hibernian,8313,1,21,11,4,56,24,32,74
Morton,8313,2,16,11,9,56,48,8,59
Falkirk,8313,3,15,12,9,55,40,15,57
Dundee Utd,8313,4,14,12,10,49,38,11,54
Queen of S't,8313,5,11,10,15,44,51,-7,43
Dunfermline,8313,6,9,14,13,51,53,-2,41
St Mirren,8313,7,10,11,15,42,52,-10,41
Dumbarton,8313,8,9,13,14,47,55,-8,40
Raith,8313,9,9,11,16,35,51,-16,38
Ayr,8313,10,7,13,16,30,53,-23,34
Hibernian,8314,1,19,12,5,54,25,29,69
Morton,8314,2,18,10,8,56,38,18,64
Falkirk,8314,3,17,11,8,57,35,22,62
Dundee Utd,8314,4,16,11,9,49,37,12,59
Raith,8314,5,11,10,15,36,45,-9,43
Dunfermline,8314,6,9,13,14,44,51,-7,40
Queen of S't,8314,7,10,10,16,38,52,-14,40
Dumbarton,8314,8,9,10,17,47,60,-13,37
Ayr,8314,9,8,12,16,34,58,-24,36
St Mirren,8314,10,8,11,17,39,53,-14,35
Hibernian,8315,1,18,13,5,61,33,28,67
Morton,8315,2,17,11,8,54,36,18,62
Dundee Utd,8315,3,18,8,10,54,38,16,62
Falkirk,8315,4,16,11,9,59,39,20,59
Raith,8315,5,12,9,15,36,47,-11,45
Queen of S't,8315,6,10,10,16,44,53,-9,40
St Mirren,8315,7,10,10,16,41,54,-13,40
Ayr,8315,8,10,10,16,38,59,-21,40
Dunfermline,8315,9,8,13,15,41,56,-15,37
Dumbarton,8315,10,8,11,17,47,60,-13,35
Hibernian,8316,1,19,11,6,55,26,29,68
Morton,8316,2,17,11,8,47,34,13,62
Falkirk,8316,3,16,9,11,60,41,19,57
Dundee Utd,8316,4,15,9,12,47,42,5,54
Queen of S't,8316,5,14,8,14,47,46,1,50
Raith,8316,6,12,8,16,38,50,-12,44
Dunfermline,8316,7,10,11,15,45,52,-7,41
Ayr,8316,8,10,11,15,39,58,-19,41
St Mirren,8316,9,9,12,15,39,51,-12,39
Dumbarton,8316,10,8,10,18,46,63,-17,34
Hibernian,8317,1,19,14,3,53,20,33,71
Morton,8317,2,17,12,7,52,37,15,63
Dundee Utd,8317,3,16,11,9,55,38,17,59
Falkirk,8317,4,16,11,9,58,45,13,59
Dunfermline,8317,5,11,13,12,50,50,0,46
Queen of S't,8317,6,12,9,15,49,57,-8,45
Raith,8317,7,11,8,17,37,50,-13,41
St Mirren,8317,8,8,11,17,39,57,-18,35
Ayr,8317,9,7,12,17,34,55,-21,33
Dumbarton,8317,10,7,11,18,45,63,-18,32
Hibernian,8318,1,18,12,6,52,25,27,66
Falkirk,8318,2,18,10,8,61,38,23,64
Morton,8318,3,17,11,8,49,35,14,62
Dundee Utd,8318,4,16,9,11,47,38,9,57
Dumbarton,8318,5,11,12,13,53,56,-3,45
Dunfermline,8318,6,10,12,14,46,49,-3,42
Queen of S't,8318,7,10,11,15,43,53,-10,41
Ayr,8318,8,8,13,15,31,48,-17,37
St Mirren,8318,9,9,10,17,40,60,-20,37
Raith,8318,10,8,10,18,31,51,-20,34
Hibernian,8319,1,20,13,3,59,21,38,73
Morton,8319,2,17,11,8,54,43,11,62
Dundee Utd,8319,3,15,10,11,52,45,7,55
Falkirk,8319,4,14,12,10,59,49,10,54
Dumbarton,8319,5,11,11,14,48,55,-7,44
Queen of S't,8319,6,10,12,14,44,48,-4,42
St Mirren,8319,7,10,10,16,44,51,-7,40
Ayr,8319,8,10,10,16,38,59,-21,40
Dunfermline,8319,9,8,14,14,50,56,-6,38
Raith,8319,10,8,11,17,31,52,-21,35
Hibernian,8320,1,20,12,4,57,25,32,72
Falkirk,8320,2,18,10,8,64,40,24,64
Morton,8320,3,17,11,8,52,33,19,62
Dundee Utd,8320,4,12,12,12,45,45,0,48
Queen of S't,8320,5,12,9,15,44,51,-7,45
Ayr,8320,6,11,11,14,38,53,-15,44
Dunfermline,8320,7,9,14,13,42,46,-4,41
Dumbarton,8320,8,9,11,16,47,62,-15,38
Raith,8320,9,9,9,18,32,51,-19,36
St Mirren,8320,10,8,11,17,43,58,-15,35
Hibernian,8321,1,20,12,4,55,26,29,72
Dundee Utd,8321,2,16,11,9,47,36,11,59
Morton,8321,3,16,10,10,47,37,10,58
Falkirk,8321,4,14,10,12,53,45,8,52
Dunfermline,8321,5,13,12,11,52,41,11,51
Raith,8321,6,11,10,15,40,48,-8,43
Queen of S't,8321,7,11,8,17,42,53,-11,41
St Mirren,8321,8,9,11,16,43,55,-12,38
Dumbarton,8321,9,9,10,17,45,58,-13,37
Ayr,8321,10,9,10,17,33,58,-25,37
Hibernian,8322,1,19,11,6,56,30,26,68
Falkirk,8322,2,17,9,10,61,42,19,60
Morton,8322,3,16,12,8,49,41,8,60
Dundee Utd,8322,4,16,9,11,52,37,15,57
Raith,8322,5,13,9,14,37,44,-7,48
Dunfermline,8322,6,9,14,13,45,46,-1,41
Queen of S't,8322,7,10,10,16,40,56,-16,40
Dumbarton,8322,8,9,12,15,48,62,-14,39
Ayr,8322,9,9,11,16,38,56,-18,38
St Mirren,8322,10,8,11,17,45,57,-12,35
Hibernian,8323,1,17,14,5,56,27,29,65
Morton,8323,2,18,11,7,53,36,17,65
Dundee Utd,8323,3,16,9,11,54,46,8,57
Falkirk,8323,4,15,10,11,51,39,12,55
Raith,8323,5,12,11,13,37,42,-5,47
Queen of S't,8323,6,11,11,14,45,49,-4,44
Dunfermline,8323,7,10,12,14,45,49,-4,42
Dumbarton,8323,8,9,13,14,48,55,-7,40
St Mirren,8323,9,9,9,18,40,60,-20,36
Ayr,8323,10,7,12,17,35,61,-26,33
Hibernian,8324,1,19,11,6,59,29,30,68
Morton,8324,2,17,11,8,48,37,11,62
Dundee Utd,8324,3,16,10,10,50,40,10,58
Falkirk,8324,4,15,9,12,53,44,9,54
Queen of S't,8324,5,12,9,15,45,51,-6,45
Raith,8324,6,12,8,16,34,47,-13,44
Dunfermline,8324,7,9,13,14,45,47,-2,40
St Mirren,8324,8,10,10,16,45,52,-7,40
Ayr,8324,9,10,10,16,38,56,-18,40
Dumbarton,8324,10,9,11,16,47,61,-14,38
Hibernian,8325,1,20,11,5,59,26,33,71
Falkirk,8325,2,18,11,7,62,38,24,65
Morton,8325,3,18,10,8,50,35,15,64
Dundee Utd,8325,4,15,9,12,46,40,6,54
Queen of S't,8325,5,11,9,16,46,53,-7,42
Dunfermline,8325,6,9,14,13,43,47,-4,41
Raith,8325,7,11,8,17,35,50,-15,41
St Mirren,8325,8,10,9,17,42,59,-17,39
Dumbarton,8325,9,9,11,16,47,58,-11,38
Ayr,8325,10,7,12,17,33,57,-24,33
Morton,8326,1,19,11,6,55,34,21,68
Hibernian,8326,2,18,11,7,57,28,29,65
Dundee Utd,8326,3,17,8,11,50,39,11,59
Falkirk,8326,4,15,9,12,59,46,13,54
Queen of S't,8326,5,12,9,15,52,52,0,45
St Mirren,8326,6,11,10,15,44,54,-10,43
Dunfermline,8326,7,9,14,13,46,51,-5,41
Raith,8326,8,10,9,17,38,55,-17,39
Dumbarton,8326,9,9,11,16,49,65,-16,38
Ayr,8326,10,9,10,17,36,62,-26,37
Hibernian,8327,1,16,15,5,52,30,22,63
Morton,8327,2,17,12,7,57,40,17,63
Dundee Utd,8327,3,17,11,8,54,40,14,62
Falkirk,8327,4,15,11,10,56,39,17,56
Dunfermline,8327,5,12,12,12,52,48,4,48
Raith,8327,6,12,9,15,34,47,-13,45
Queen of S't,8327,7,10,10,16,42,52,-10,40
Dumbarton,8327,8,9,12,15,48,60,-12,39
St Mirren,8327,9,8,10,18,41,58,-17,34
Ayr,8327,10,7,12,17,37,59,-22,33
Hibernian,8328,1,20,10,6,58,31,27,70
Morton,8328,2,18,11,7,49,31,18,65
Falkirk,8328,3,17,10,9,59,40,19,61
Dundee Utd,8328,4,16,11,9,53,37,16,59
Dunfermline,8328,5,10,12,14,45,52,-7,42
Queen of S't,8328,6,11,9,16,44,51,-7,42
Dumbarton,8328,7,9,12,15,45,57,-12,39
Ayr,8328,8,8,14,14,31,50,-19,38
Raith,8328,9,8,11,17,31,48,-17,35
St Mirren,8328,10,7,12,17,37,55,-18,33
Hibernian,8329,1,17,14,5,55,30,25,65
Morton,8329,2,18,10,8,50,35,15,64
Dundee Utd,8329,3,18,8,10,54,37,17,62
Falkirk,8329,4,16,12,8,57,38,19,60
Queen of S't,8329,5,10,12,14,44,52,-8,42
Dunfermline,8329,6,9,14,13,43,48,-5,41
Dumbarton,8329,7,9,12,15,51,56,-5,39
Raith,8329,8,9,11,16,34,48,-14,38
Ayr,8329,9,8,13,15,34,59,-25,37
St Mirren,8329,10,8,10,18,38,57,-19,34
Hibernian,8330,1,17,12,7,51,27,24,63
Morton,8330,2,17,12,7,51,33,18,63
Queen of S't,8330,3,15,9,12,53,47,6,54
Falkirk,8330,4,14,11,11,53,44,9,53
Dundee Utd,8330,5,13,9,14,45,49,-4,48
Dunfermline,8330,6,10,13,13,49,51,-2,43
St Mirren,8330,7,11,10,15,44,51,-7,43
Ayr,8330,8,10,12,14,37,54,-17,42
Raith,8330,9,10,9,17,36,51,-15,39
Dumbarton,8330,10,8,13,15,48,60,-12,37
Hibernian,8331,1,19,11,6,56,29,27,68
Falkirk,8331,2,15,13,8,56,37,19,58
Morton,8331,3,15,12,9,51,43,8,57
Dundee Utd,8331,4,14,9,13,49,45,4,51
Queen of S't,8331,5,11,11,14,47,51,-4,44
Dumbarton,8331,6,11,11,14,54,61,-7,44
Raith,8331,7,11,10,15,35,44,-9,43
Dunfermline,8331,8,9,13,14,49,57,-8,40
Ayr,8331,9,9,13,14,36,53,-17,40
St Mirren,8331,10,8,13,15,41,54,-13,37
Hibernian,8332,1,20,11,5,55,22,33,71
Morton,8332,2,16,10,10,49,41,8,58
Falkirk,8332,3,15,12,9,54,38,16,57
Dundee Utd,8332,4,14,11,11,50,45,5,53
Queen of S't,8332,5,11,12,13,46,48,-2,45
Ayr,8332,6,10,13,13,35,51,-16,43
Dunfermline,8332,7,9,14,13,44,48,-4,41
Dumbarton,8332,8,9,12,15,48,57,-9,39
St Mirren,8332,9,9,11,16,39,55,-16,38
Raith,8332,10,9,10,17,37,52,-15,37
Hibernian,8333,1,19,12,5,58,27,31,69
Morton,8333,2,19,9,8,55,40,15,66
Falkirk,8333,3,16,11,9,60,40,20,59
Dundee Utd,8333,4,14,11,11,45,41,4,53
Queen of S't,8333,5,13,9,14,47,51,-4,48
Dunfermline,8333,6,10,14,12,53,51,2,44
Raith,8333,7,10,9,17,33,50,-17,39
Dumbarton,8333,8,9,11,16,47,59,-12,38
St Mirren,8333,9,9,10,17,40,55,-15,37
Ayr,8333,10,7,12,17,33,57,-24,33
Hibernian,8334,1,19,11,6,51,24,27,68
Falkirk,8334,2,17,10,9,63,40,23,61
Morton,8334,3,16,11,9,47,39,8,59
Dundee Utd,8334,4,16,10,10,47,39,8,58
Ayr,8334,5,10,13,13,41,53,-12,43
Dunfermline,8334,6,10,11,15,44,49,-5,41
Queen of S't,8334,7,11,8,17,43,54,-11,41
St Mirren,8334,8,10,10,16,44,51,-7,40
Dumbarton,8334,9,9,13,14,50,61,-11,40
Raith,8334,10,9,9,18,35,55,-20,36
Hibernian,8335,1,20,12,4,57,26,31,72
Falkirk,8335,2,16,9,11,57,47,10,57
Dundee Utd,8335,3,16,9,11,48,39,9,57
Morton,8335,4,15,9,12,48,42,6,54
Queen of S't,8335,5,13,8,15,48,48,0,47
Dunfermline,8335,6,11,12,13,46,45,1,45
Ayr,8335,7,10,11,15,38,53,-15,41
Dumbarton,8335,8,10,11,15,48,64,-16,41
St Mirren,8335,9,10,9,17,48,58,-10,39
Raith,8335,10,9,10,17,32,48,-16,37
Hibernian,8336,1,16,15,5,55,30,25,63
Morton,8336,2,16,14,6,54,37,17,62
Dundee Utd,8336,3,17,10,9,53,38,15,61
Falkirk,8336,4,14,12,10,60,46,14,54
Queen of S't,8336,5,12,11,13,45,50,-5,47
St Mirren,8336,6,11,10,15,42,51,-9,43
Dunfermline,8336,7,9,15,12,47,51,-4,42
Raith,8336,8,9,12,15,38,50,-12,39
Dumbarton,8336,9,7,13,16,48,63,-15,34
Ayr,8336,10,7,12,17,35,61,-26,33
Hibernian,8337,1,16,12,8,52,32,20,60
Falkirk,8337,2,17,9,10,57,41,16,60
Dundee Utd,8337,3,16,10,10,57,40,17,58
Morton,8337,4,15,13,8,50,38,12,58
Queen of S't,8337,5,12,10,14,45,48,-3,46
Dunfermline,8337,6,10,14,12,47,49,-2,44
Dumbarton,8337,7,11,11,14,50,59,-9,44
Raith,8337,8,11,8,17,38,52,-14,41
St Mirren,8337,9,10,9,17,39,53,-14,39
Ayr,8337,10,8,12,16,36,59,-23,36
Hibernian,8338,1,18,11,7,50,26,24,65
Falkirk,8338,2,18,10,8,55,35,20,64
Morton,8338,3,18,10,8,53,37,16,64
Dundee Utd,8338,4,15,8,13,47,47,0,53
Dunfermline,8338,5,11,13,12,48,47,1,46
Ayr,8338,6,11,11,14,36,49,-13,44
Queen of S't,8338,7,11,9,16,44,49,-5,42
Dumbarton,8338,8,9,12,15,50,58,-8,39
Raith,8338,9,10,9,17,35,51,-16,39
St Mirren,8338,10,8,9,19,35,54,-19,33
Hibernian,8339,1,20,11,5,59,26,33,71
Falkirk,8339,2,18,10,8,62,41,21,64
Dundee Utd,8339,3,18,9,9,56,40,16,63
Morton,8339,4,17,10,9,57,41,16,61
Queen of S't,8339,5,11,10,15,44,49,-5,43
Raith,8339,6,11,9,16,37,52,-15,42
Dumbarton,8339,7,10,11,15,47,57,-10,41
Dunfermline,8339,8,9,12,15,46,49,-3,39
Ayr,8339,9,9,10,17,35,62,-27,37
St Mirren,8339,10,6,10,20,38,64,-26,28
Hibernian,8340,1,19,13,4,56,26,30,70
Dundee Utd,8340,2,17,10,9,56,40,16,61
Falkirk,8340,3,16,10,10,55,42,13,58
Morton,8340,4,15,11,10,50,40,10,56
Queen of S't,8340,5,12,10,14,49,52,-3,46
Dunfermline,8340,6,10,14,12,53,55,-2,44
Dumbarton,8340,7,9,10,17,47,59,-12,37
St Mirren,8340,8,8,13,15,40,55,-15,37
Ayr,8340,9,8,13,15,34,56,-22,37
Raith,8340,10,8,12,16,33,48,-15,36
Hibernian,8341,1,20,10,6,57,28,29,70
Morton,8341,2,18,10,8,55,41,14,64
Falkirk,8341,3,17,9,10,63,46,17,60
Dundee Utd,8341,4,14,12,10,49,42,7,54
Dunfermline,8341,5,10,12,14,50,53,-3,42
Queen of S't,8341,6,11,9,16,48,53,-5,42
Raith,8341,7,11,9,16,40,54,-14,42
Dumbarton,8341,8,10,10,16,52,63,-11,40
Ayr,8341,9,9,12,15,35,55,-20,39
St Mirren,8341,10,8,11,17,44,58,-14,35
Hibernian,8342,1,18,14,4,55,27,28,68
Dundee Utd,8342,2,16,9,11,53,44,9,57
Falkirk,8342,3,14,11,11,58,42,16,53
Morton,8342,4,14,11,11,47,41,6,53
Queen of S't,8342,5,13,10,13,50,47,3,49
Raith,8342,6,12,10,14,40,51,-11,46
Dumbarton,8342,7,11,11,14,49,56,-7,44
Dunfermline,8342,8,9,13,14,43,49,-6,40
St Mirren,8342,9,9,10,17,41,56,-15,37
Ayr,8342,10,8,13,15,31,54,-23,37
Hibernian,8343,1,20,11,5,57,23,34,71
Falkirk,8343,2,18,9,9,63,43,20,63
Morton,8343,3,16,11,9,48,34,14,59
Dundee Utd,8343,4,16,11,9,56,43,13,59
Dunfermline,8343,5,10,14,12,48,48,0,44
Queen of S't,8343,6,11,9,16,44,54,-10,42
Ayr,8343,7,9,13,14,35,52,-17,40
Dumbarton,8343,8,8,12,16,44,60,-16,36
Raith,8343,9,8,12,16,34,54,-20,36
St Mirren,8343,10,8,10,18,38,56,-18,34
Morton,8344,1,19,12,5,58,34,24,69
Falkirk,8344,2,17,10,9,60,39,21,61
Hibernian,8344,3,16,12,8,55,35,20,60
Dundee Utd,8344,4,17,9,10,55,37,18,60
Dunfermline,8344,5,11,12,13,48,51,-3,45
Raith,8344,6,12,9,15,38,46,-8,45
Queen of S't,8344,7,11,8,17,44,58,-14,41
Ayr,8344,8,10,11,15,37,53,-16,41
St Mirren,8344,9,9,9,18,39,59,-20,36
Dumbarton,8344,10,7,10,19,43,65,-22,31
Morton,8345,1,18,12,6,53,29,24,66
Hibernian,8345,2,17,12,7,51,28,23,63
Dundee Utd,8345,3,16,8,12,47,41,6,56
Falkirk,8345,4,14,11,11,55,44,11,53
Queen of S't,8345,5,12,10,14,46,49,-3,46
Dunfermline,8345,6,10,14,12,46,47,-1,44
Ayr,8345,7,11,10,15,37,54,-17,43
Raith,8345,8,11,9,16,38,52,-14,42
St Mirren,8345,9,10,9,17,39,54,-15,39
Dumbarton,8345,10,8,11,17,44,58,-14,35
Hibernian,8346,1,20,13,3,56,25,31,73
Morton,8346,2,17,11,8,49,34,15,62
Falkirk,8346,3,16,10,10,58,43,15,58
Dundee Utd,8346,4,15,10,11,49,42,7,55
Raith,8346,5,13,8,15,39,47,-8,47
Queen of S't,8346,6,11,8,17,44,51,-7,41
Dunfermline,8346,7,9,13,14,44,50,-6,40
Dumbarton,8346,8,9,11,16,47,61,-14,38
Ayr,8346,9,8,13,15,35,53,-18,37
St Mirren,8346,10,8,11,17,37,52,-15,35
Hibernian,8347,1,18,13,5,49,25,24,67
Falkirk,8347,2,17,10,9,60,39,21,61
Dundee Utd,8347,3,17,9,10,56,42,14,60
Morton,8347,4,16,10,10,51,42,9,58
Dunfermline,8347,5,12,13,11,47,43,4,49
Raith,8347,6,11,9,16,36,48,-12,42
Dumbarton,8347,7,9,14,13,49,57,-8,41
St Mirren,8347,8,8,13,15,41,54,-13,37
Queen of S't,8347,9,9,9,18,38,55,-17,36
Ayr,8347,10,8,10,18,35,57,-22,34
Hibernian,8348,1,21,11,4,57,23,34,74
Morton,8348,2,18,10,8,47,38,9,64
Falkirk,8348,3,16,11,9,64,43,21,59
Dundee Utd,8348,4,16,8,12,52,42,10,56
Dunfermline,8348,5,10,13,13,45,46,-1,43
Raith,8348,6,10,11,15,36,49,-13,41
Queen of S't,8348,7,10,10,16,40,53,-13,40
Dumbarton,8348,8,9,12,15,54,59,-5,39
Ayr,8348,9,8,12,16,31,52,-21,36
St Mirren,8348,10,8,10,18,41,62,-21,34
Hibernian,8349,1,19,13,4,51,23,28,70
Morton,8349,2,18,10,8,50,35,15,64
Dundee Utd,8349,3,17,10,9,50,37,13,61
Falkirk,8349,4,15,13,8,54,35,19,58
Dumbarton,8349,5,10,12,14,48,57,-9,42
Queen of S't,8349,6,10,11,15,40,50,-10,41
Raith,8349,7,10,10,16,37,48,-11,40
Dunfermline,8349,8,9,12,15,45,49,-4,39
Ayr,8349,9,9,11,16,34,55,-21,38
St Mirren,8349,10,7,10,19,35,55,-20,31
Hibernian,8350,1,20,11,5,57,26,31,71
Dundee Utd,8350,2,18,8,10,53,39,14,62
Morton,8350,3,17,10,9,56,39,17,61
Falkirk,8350,4,15,12,9,60,45,15,57
Queen of S't,8350,5,13,9,14,46,49,-3,48
Raith,8350,6,11,10,15,37,45,-8,43
Dunfermline,8350,7,9,12,15,42,51,-9,39
Dumbarton,8350,8,8,13,15,46,61,-15,37
Ayr,8350,9,8,12,16,35,59,-24,36
St Mirren,8350,10,6,13,17,36,54,-18,31
Hibernian,8351,1,17,15,4,56,28,28,66
Falkirk,8351,2,17,11,8,64,42,22,62
Morton,8351,3,16,12,8,51,38,13,60
Dundee Utd,8351,4,15,12,9,46,35,11,57
Queen of S't,8351,5,11,12,13,49,54,-5,45
Raith,8351,6,10,10,16,35,52,-17,40
Dunfermline,8351,7,8,13,15,46,52,-6,37
St Mirren,8351,8,8,13,15,41,54,-13,37
Dumbarton,8351,9,8,13,15,46,61,-15,37
Ayr,8351,10,8,13,15,39,57,-18,37
Hibernian,8352,1,20,10,6,56,26,30,70
Morton,8352,2,17,11,8,50,32,18,62
Dundee Utd,8352,3,17,10,9,55,40,15,61
Falkirk,8352,4,15,10,11,59,44,15,55
Queen of S't,8352,5,14,8,14,50,51,-1,50
Raith,8352,6,12,9,15,40,52,-12,45
Dunfermline,8352,7,10,12,14,45,48,-3,42
St Mirren,8352,8,9,9,18,38,60,-22,36
Dumbarton,8352,9,8,11,17,47,62,-15,35
Ayr,8352,10,7,12,17,33,58,-25,33
Hibernian,8353,1,20,12,4,58,24,34,72
Morton,8353,2,18,11,7,50,34,16,65
Dundee Utd,8353,3,18,8,10,58,39,19,62
Falkirk,8353,4,16,10,10,56,41,15,58
Queen of S't,8353,5,13,8,15,48,50,-2,47
Dunfermline,8353,6,10,11,15,51,55,-4,41
Raith,8353,7,10,11,15,34,48,-14,41
St Mirren,8353,8,9,10,17,43,58,-15,37
Dumbarton,8353,9,8,10,18,43,69,-26,34
Ayr,8353,10,7,11,18,37,60,-23,32
Hibernian,8354,1,18,13,5,51,25,26,67
Morton,8354,2,18,11,7,49,32,17,65
Dundee Utd,8354,3,17,8,11,55,40,15,59
Falkirk,8354,4,16,10,10,58,42,16,58
Raith,8354,5,11,11,14,39,47,-8,44
Queen of S't,8354,6,11,9,16,41,51,-10,42
Ayr,8354,7,10,12,14,34,48,-14,42
Dumbarton,8354,8,10,11,15,45,54,-9,41
Dunfermline,8354,9,8,13,15,42,51,-9,37
St Mirren,8354,10,7,10,19,36,60,-24,31
Hibernian,8355,1,16,17,3,48,22,26,65
Falkirk,8355,2,16,11,9,55,36,19,59
Morton,8355,3,15,14,7,46,35,11,59
Dundee Utd,8355,4,14,13,9,50,38,12,55
Dunfermline,8355,5,9,16,11,42,43,-1,43
Queen of S't,8355,6,11,10,15,44,50,-6,43
Dumbarton,8355,7,10,11,15,47,56,-9,41
Raith,8355,8,10,9,17,34,48,-14,39
Ayr,8355,9,8,13,15,33,57,-24,37
St Mirren,8355,10,8,12,16,40,54,-14,36
Hibernian,8356,1,18,12,6,57,31,26,66
Morton,8356,2,17,13,6,53,36,17,64
Falkirk,8356,3,17,10,9,66,45,21,61
Dundee Utd,8356,4,15,11,10,51,39,12,56
Dunfermline,8356,5,11,14,11,48,46,2,47
Queen of S't,8356,6,12,10,14,45,48,-3,46
Raith,8356,7,10,9,17,35,50,-15,39
Dumbarton,8356,8,8,11,17,46,62,-16,35
St Mirren,8356,9,8,11,17,40,57,-17,35
Ayr,8356,10,8,11,17,30,57,-27,35
Hibernian,8357,1,20,12,4,59,27,32,72
Falkirk,8357,2,16,10,10,59,40,19,58
Morton,8357,3,15,13,8,47,39,8,58
Dundee Utd,8357,4,15,9,12,48,40,8,54
Queen of S't,8357,5,13,9,14,49,51,-2,48
Dunfermline,8357,6,10,14,12,45,44,1,44
Dumbarton,8357,7,9,12,15,49,65,-16,39
Ayr,8357,8,8,15,13,36,54,-18,39
Raith,8357,9,10,8,18,33,47,-14,38
St Mirren,8357,10,8,10,18,43,61,-18,34
Hibernian,8358,1,18,13,5,53,28,25,67
Falkirk,8358,2,18,11,7,61,37,24,65
Morton,8358,3,18,11,7,54,36,18,65
Dundee Utd,8358,4,17,9,10,54,41,13,60
Dunfermline,8358,5,10,13,13,48,51,-3,43
Dumbarton,8358,6,10,12,14,52,60,-8,42
Raith,8358,7,10,11,15,38,48,-10,41
Queen of S't,8358,8,9,9,18,42,54,-12,36
St Mirren,8358,9,8,9,19,39,61,-22,33
Ayr,8358,10,7,12,17,33,58,-25,33
Hibernian,8359,1,21,12,3,56,24,32,75
Falkirk,8359,2,17,10,9,57,38,19,61
Dundee Utd,8359,3,17,9,10,52,38,14,60
Morton,8359,4,15,12,9,48,39,9,57
Dumbarton,8359,5,10,12,14,50,55,-5,42
Queen of S't,8359,6,10,11,15,44,50,-6,41
Raith,8359,7,10,11,15,37,50,-13,41
Dunfermline,8359,8,8,14,14,41,48,-7,38
Ayr,8359,9,8,11,17,33,56,-23,35
St Mirren,8359,10,8,10,18,41,61,-20,34
Hibernian,8360,1,20,12,4,57,25,32,72
Morton,8360,2,18,12,6,52,31,21,66
Falkirk,8360,3,17,11,8,59,38,21,62
Dundee Utd,8360,4,17,9,10,51,37,14,60
Queen of S't,8360,5,11,9,16,42,48,-6,42
Raith,8360,6,10,11,15,33,49,-16,41
Dumbarton,8360,7,9,12,15,47,61,-14,39
Dunfermline,8360,8,7,15,14,39,47,-8,36
Ayr,8360,9,8,10,18,31,58,-27,34
St Mirren,8360,10,8,9,19,38,55,-17,33
Hibernian,8361,1,18,13,5,53,25,28,67
Morton,8361,2,15,11,10,49,40,9,56
Falkirk,8361,3,15,10,11,56,45,11,55
Dundee Utd,8361,4,14,12,10,45,37,8,54
Dunfermline,8361,5,11,14,11,46,43,3,47
Queen of S't,8361,6,12,9,15,48,53,-5,45
Raith,8361,7,10,11,15,39,50,-11,41
Ayr,8361,8,9,14,13,35,51,-16,41
Dumbarton,8361,9,8,14,14,44,54,-10,38
St Mirren,8361,10,9,10,17,42,59,-17,37
Hibernian,8362,1,21,10,5,62,25,37,73
Morton,8362,2,18,11,7,52,35,17,65
Falkirk,8362,3,16,11,9,56,40,16,59
Dundee Utd,8362,4,15,9,12,47,40,7,54
Ayr,8362,5,11,11,14,42,56,-14,44
Dunfermline,8362,6,9,14,13,46,49,-3,41
Queen of S't,8362,7,11,8,17,43,53,-10,41
St Mirren,8362,8,10,10,16,43,59,-16,40
Raith,8362,9,10,8,18,37,55,-18,38
Dumbarton,8362,10,7,12,17,44,60,-16,33
Hibernian,8363,1,19,12,5,58,24,34,69
Falkirk,8363,2,18,10,8,66,40,26,64
Morton,8363,3,16,14,6,49,32,17,62
Queen of S't,8363,4,13,8,15,51,52,-1,47
Dundee Utd,8363,5,12,10,14,45,47,-2,46
Dunfermline,8363,6,11,12,13,49,55,-6,45
Dumbarton,8363,7,9,13,14,52,61,-9,40
Ayr,8363,8,9,11,16,36,55,-19,38
Raith,8363,9,10,8,18,32,51,-19,38
St Mirren,8363,10,9,10,17,39,60,-21,37
Hibernian,8364,1,21,11,4,60,24,36,74
Falkirk,8364,2,18,9,9,61,38,23,63
Morton,8364,3,17,11,8,57,39,18,62
Dundee Utd,8364,4,15,9,12,49,40,9,54
Raith,8364,5,12,9,15,35,47,-12,45
Dunfermline,8364,6,10,12,14,45,51,-6,42
Queen of S't,8364,7,10,10,16,42,51,-9,40
St Mirren,8364,8,10,10,16,44,54,-10,40
Ayr,8364,9,8,12,16,32,62,-30,36
Dumbarton,8364,10,7,11,18,43,62,-19,32
Morton,8365,1,20,9,7,56,33,23,69
Hibernian,8365,2,19,10,7,57,30,27,67
Dundee Utd,8365,3,18,9,9,54,36,18,63
Falkirk,8365,4,13,14,9,56,44,12,53
Queen of S't,8365,5,11,11,14,43,47,-4,44
Raith,8365,6,11,10,15,38,49,-11,43
Dunfermline,8365,7,9,12,15,47,55,-8,39
Dumbarton,8365,8,9,12,15,42,53,-11,39
Ayr,8365,9,8,13,15,32,54,-22,37
St Mirren,8365,10,6,12,18,34,58,-24,30
Hibernian,8366,1,20,13,3,58,24,34,73
Falkirk,8366,2,16,11,9,57,40,17,59
Morton,8366,3,14,13,9,50,42,8,55
Dundee Utd,8366,4,13,11,12,46,44,2,50
Queen of S't,8366,5,12,10,14,45,47,-2,46
Dunfermline,8366,6,9,15,12,46,49,-3,42
Dumbarton,8366,7,10,12,14,52,58,-6,42
Raith,8366,8,11,9,16,40,54,-14,42
St Mirren,8366,9,10,10,16,43,56,-13,40
Ayr,8366,10,7,12,17,33,56,-23,33
Hibernian,8367,1,20,12,4,57,25,32,72
Falkirk,8367,2,18,10,8,59,36,23,64
Morton,8367,3,17,12,7,49,36,13,63
Dundee Utd,8367,4,16,11,9,53,36,17,59
Queen of S't,8367,5,11,11,14,45,49,-4,44
Dunfermline,8367,6,9,14,13,47,56,-9,41
Dumbarton,8367,7,8,12,16,48,61,-13,36
St Mirren,8367,8,9,9,18,39,54,-15,36
Raith,8367,9,9,9,18,36,55,-19,36
Ayr,8367,10,7,12,17,33,58,-25,33
Hibernian,8368,1,17,14,5,54,26,28,65
Dundee Utd,8368,2,16,11,9,52,37,15,59
Morton,8368,3,13,16,7,44,34,10,55
Falkirk,8368,4,14,11,11,55,46,9,53
Queen of S't,8368,5,15,8,13,46,48,-2,53
Dunfermline,8368,6,9,14,13,47,55,-8,41
St Mirren,8368,7,10,11,15,43,53,-10,41
Raith,8368,8,10,11,15,37,49,-12,41
Dumbarton,8368,9,9,13,14,50,55,-5,40
Ayr,8368,10,6,13,17,31,56,-25,31
Hibernian,8369,1,17,14,5,58,34,24,65
Morton,8369,2,17,13,6,51,35,16,64
Dundee Utd,8369,3,16,10,10,53,40,13,58
Falkirk,8369,4,15,11,10,60,45,15,56
Raith,8369,5,11,9,16,38,51,-13,42
Dunfermline,8369,6,9,14,13,46,47,-1,41
Ayr,8369,7,9,14,13,39,56,-17,41
Queen of S't,8369,8,10,9,17,42,53,-11,39
Dumbarton,8369,9,9,12,15,44,61,-17,39
St Mirren,8369,10,9,10,17,50,59,-9,37
Hibernian,8370,1,20,12,4,57,24,33,72
Morton,8370,2,17,11,8,51,37,14,62
Dundee Utd,8370,3,16,9,11,59,43,16,57
Falkirk,8370,4,14,10,12,54,46,8,52
Queen of S't,8370,5,12,9,15,44,49,-5,45
Raith,8370,6,12,9,15,36,47,-11,45
Dunfermline,8370,7,9,14,13,45,48,-3,41
Dumbarton,8370,8,10,11,15,45,59,-14,41
St Mirren,8370,9,9,9,18,40,56,-16,36
Ayr,8370,10,8,12,16,33,55,-22,36
Hibernian,8371,1,19,12,5,55,27,28,69
Morton,8371,2,18,10,8,51,34,17,64
Falkirk,8371,3,17,11,8,60,37,23,62
Dundee Utd,8371,4,15,11,10,47,36,11,56
Queen of S't,8371,5,12,9,15,45,49,-4,45
Dunfermline,8371,6,10,13,13,47,48,-1,43
Raith,8371,7,10,9,17,33,54,-21,39
St Mirren,8371,8,9,11,16,42,55,-13,38
Ayr,8371,9,9,11,16,35,54,-19,38
Dumbarton,8371,10,7,11,18,46,67,-21,32
Morton,8372,1,18,12,6,50,31,19,66
Dundee Utd,8372,2,18,8,10,58,43,15,62
Hibernian,8372,3,16,12,8,54,35,19,60
Falkirk,8372,4,16,11,9,58,44,14,59
Queen of S't,8372,5,13,9,14,53,54,-1,48
Dunfermline,8372,6,10,13,13,48,51,-3,43
Ayr,8372,7,9,12,15,38,54,-16,39
Dumbarton,8372,8,8,13,15,46,58,-12,37
St Mirren,8372,9,9,10,17,42,58,-16,37
Raith,8372,10,9,8,19,34,53,-19,35
Hibernian,8373,1,19,13,4,52,23,29,70
Falkirk,8373,2,16,11,9,57,39,18,59
Morton,8373,3,16,11,9,52,40,12,59
Dundee Utd,8373,4,16,9,11,48,39,9,57
Queen of S't,8373,5,13,8,15,48,49,-1,47
Dunfermline,8373,6,9,15,12,45,50,-5,42
Dumbarton,8373,7,10,11,15,52,59,-7,41
Raith,8373,8,9,11,16,34,48,-14,38
St Mirren,8373,9,9,9,18,40,60,-20,36
Ayr,8373,10,8,12,16,34,55,-21,36
Morton,8374,1,20,10,6,57,33,24,70
Hibernian,8374,2,19,11,6,52,30,22,68
Falkirk,8374,3,17,10,9,59,39,20,61
Dundee Utd,8374,4,15,10,11,46,39,7,55
Dunfermline,8374,5,11,13,12,51,48,3,46
Raith,8374,6,11,10,15,38,50,-12,43
Queen of S't,8374,7,10,9,17,42,52,-10,39
Dumbarton,8374,8,8,11,17,44,58,-14,35
St Mirren,8374,9,8,11,17,40,55,-15,35
Ayr,8374,10,8,11,17,34,59,-25,35
Morton,8375,1,18,11,7,56,41,15,65
Hibernian,8375,2,17,11,8,53,31,22,62
Falkirk,8375,3,16,12,8,59,38,21,60
Dundee Utd,8375,4,16,9,11,54,41,13,57
Raith,8375,5,12,10,14,40,48,-8,46
Queen of S't,8375,6,11,11,14,46,50,-4,44
Dunfermline,8375,7,10,13,13,46,50,-4,43
Ayr,8375,8,9,13,14,36,52,-16,40
St Mirren,8375,9,8,10,18,44,64,-20,34
Dumbarton,8375,10,7,12,17,46,65,-19,33
Hibernian,8376,1,20,11,5,64,26,38,71
Morton,8376,2,17,11,8,55,43,12,62
Falkirk,8376,3,16,10,10,60,46,14,58
Dundee Utd,8376,4,16,9,11,52,40,12,57
Queen of S't,8376,5,12,8,16,46,50,-4,44
Dunfermline,8376,6,10,12,14,50,57,-7,42
Raith,8376,7,11,9,16,35,52,-17,42
Ayr,8376,8,9,13,14,35,51,-16,40
St Mirren,8376,9,8,12,16,44,58,-14,36
Dumbarton,8376,10,8,11,17,48,66,-18,35
Hibernian,8377,1,19,10,7,56,27,29,67
Morton,8377,2,18,11,7,54,38,16,65
Falkirk,8377,3,16,9,11,56,39,17,57
Dundee Utd,8377,4,16,9,11,45,39,6,57
Queen of S't,8377,5,14,9,13,51,47,4,51
Dunfermline,8377,6,10,12,14,47,51,-4,42
Dumbarton,8377,7,10,11,15,47,58,-11,41
Raith,8377,8,9,10,17,35,54,-19,37
Ayr,8377,9,8,13,15,34,54,-20,37
St Mirren,8377,10,7,12,17,38,56,-18,33
Hibernian,8378,1,20,13,3,59,22,37,73
Morton,8378,2,16,14,6,49,37,12,62
Dundee Utd,8378,3,16,10,10,48,41,7,58
Falkirk,8378,4,15,12,9,55,43,12,57
Dunfermline,8378,5,11,13,12,51,50,1,46
Queen of S't,8378,6,11,9,16,47,52,-5,42
Dumbarton,8378,7,8,13,15,47,61,-14,37
Ayr,8378,8,8,13,15,37,53,-16,37
Raith,8378,9,9,10,17,33,49,-16,37
St Mirren,8378,10,8,9,19,37,55,-18,33
Hibernian,8379,1,23,10,3,60,22,38,79
Morton,8379,2,16,11,9,45,36,9,59
Falkirk,8379,3,16,10,10,56,44,12,58
Dundee Utd,8379,4,15,8,13,51,46,5,53
Queen of S't,8379,5,12,9,15,49,52,-3,45
Dunfermline,8379,6,11,11,14,51,48,3,44
Dumbarton,8379,7,11,11,14,53,59,-6,44
Ayr,8379,8,9,11,16,35,56,-21,38
St Mirren,8379,9,8,11,17,38,56,-18,35
Raith,8379,10,8,10,18,31,50,-19,34
Hibernian,8380,1,19,11,6,57,26,31,68
Morton,8380,2,19,10,7,56,38,18,67
Dundee Utd,8380,3,15,12,9,50,40,10,57
Falkirk,8380,4,14,12,10,53,41,12,54
Queen of S't,8380,5,11,10,15,45,52,-7,43
Dunfermline,8380,6,10,12,14,47,50,-3,42
Raith,8380,7,11,9,16,34,47,-13,42
St Mirren,8380,8,10,11,15,49,53,-4,41
Dumbarton,8380,9,9,11,16,45,63,-18,38
Ayr,8380,10,6,14,16,30,56,-26,32
Hibernian,8381,1,19,11,6,54,26,28,68
Falkirk,8381,2,17,9,10,61,39,22,60
Morton,8381,3,16,12,8,46,34,12,60
Dundee Utd,8381,4,15,11,10,50,43,7,56
Dunfermline,8381,5,12,13,11,52,48,4,49
Queen of S't,8381,6,11,10,15,43,51,-8,43
Raith,8381,7,10,9,17,33,50,-17,39
Ayr,8381,8,9,12,15,36,56,-20,39
Dumbarton,8381,9,9,10,17,45,56,-11,37
St Mirren,8381,10,9,9,18,41,58,-17,36
Hibernian,8382,1,18,11,7,54,29,25,65
Falkirk,8382,2,18,9,9,63,41,22,63
Morton,8382,3,17,10,9,54,38,16,61
Dundee Utd,8382,4,16,10,10,51,37,14,58
Queen of S't,8382,5,12,8,16,48,58,-10,44
Raith,8382,6,11,9,16,36,49,-13,42
Ayr,8382,7,10,12,14,39,59,-20,42
Dunfermline,8382,8,10,11,15,44,49,-5,41
Dumbarton,8382,9,9,11,16,48,60,-12,38
St Mirren,8382,10,9,9,18,40,57,-17,36
Hibernian,8383,1,20,12,4,58,29,29,72
Falkirk,8383,2,17,11,8,64,36,28,62
Dundee Utd,8383,3,16,10,10,48,38,10,58
Morton,8383,4,15,12,9,45,37,8,57
Queen of S't,8383,5,12,9,15,44,50,-6,45
Dunfermline,8383,6,10,13,13,46,48,-2,43
Raith,8383,7,9,12,15,36,50,-14,39
Dumbarton,8383,8,8,13,15,47,61,-14,37
St Mirren,8383,9,9,9,18,42,58,-16,36
Ayr,8383,10,7,13,16,32,55,-23,34
Hibernian,8384,1,21,12,3,61,28,33,75
Morton,8384,2,19,11,6,61,35,26,68
Dundee Utd,8384,3,18,8,10,59,42,17,62
Falkirk,8384,4,14,11,11,52,42,10,53
Dunfermline,8384,5,10,12,14,51,52,-1,42
Queen of S't,8384,6,10,11,15,46,54,-8,41
Dumbarton,8384,7,9,12,15,47,58,-11,39
Ayr,8384,8,7,15,14,33,56,-23,36
Raith,8384,9,8,11,17,34,56,-22,35
St Mirren,8384,10,6,13,17,40,61,-21,31
Hibernian,8385,1,20,12,4,58,28,30,72
Falkirk,8385,2,17,11,8,64,41,23,62
Morton,8385,3,16,12,8,46,33,13,60
Dundee Utd,8385,4,15,8,13,45,42,3,53
Queen of S't,8385,5,12,9,15,50,57,-7,45
Dunfermline,8385,6,10,11,15,45,48,-3,41
Raith,8385,7,10,11,15,35,48,-13,41
Dumbarton,8385,8,9,13,14,48,56,-8,40
St Mirren,8385,9,9,11,16,43,57,-14,38
Ayr,8385,10,7,12,17,33,57,-24,33
Hibernian,8386,1,20,11,5,58,27,31,71
Morton,8386,2,19,11,6,52,31,21,68
Falkirk,8386,3,17,10,9,60,42,18,61
Dundee Utd,8386,4,17,9,10,54,42,12,60
Dunfermline,8386,5,11,12,13,50,50,0,45
Queen of S't,8386,6,10,10,16,46,55,-9,40
Ayr,8386,7,8,14,14,35,55,-20,38
St Mirren,8386,8,8,11,17,43,60,-17,35
Dumbarton,8386,9,8,10,18,48,63,-15,34
Raith,8386,10,8,10,18,30,51,-21,34
Hibernian,8387,1,18,14,4,53,24,29,68
Morton,8387,2,19,11,6,54,33,21,68
Falkirk,8387,3,16,12,8,58,40,18,60
Dundee Utd,8387,4,14,11,11,47,39,8,53
Queen of S't,8387,5,13,8,15,53,56,-3,47
Dunfermline,8387,6,8,14,14,44,51,-7,38
Ayr,8387,7,9,11,16,33,55,-22,38
Dumbarton,8387,8,8,13,15,48,60,-12,37
Raith,8387,9,9,10,17,36,53,-17,37
St Mirren,8387,10,8,12,16,38,53,-15,36
Hibernian,8388,1,17,13,6,52,28,24,64
Falkirk,8388,2,18,9,9,64,42,22,63
Morton,8388,3,16,14,6,45,31,14,62
Dundee Utd,8388,4,17,9,10,49,38,11,60
Dunfermline,8388,5,12,11,13,51,47,4,47
Queen of S't,8388,6,11,11,14,46,51,-5,44
Ayr,8388,7,8,14,14,32,50,-18,38
Dumbarton,8388,8,8,13,15,49,59,-10,37
Raith,8388,9,8,11,17,35,54,-19,35
St Mirren,8388,10,6,13,17,35,58,-23,31
Hibernian,8389,1,18,13,5,54,27,27,67
Dundee Utd,8389,2,17,10,9,59,41,18,61
Morton,8389,3,16,12,8,51,36,15,60
Falkirk,8389,4,16,9,11,61,49,12,57
Dunfermline,8389,5,11,12,13,52,53,-1,45
Dumbarton,8389,6,10,11,15,57,55,2,41
Queen of S't,8389,7,10,11,15,47,55,-8,41
Ayr,8389,8,10,11,15,38,60,-22,41
Raith,8389,9,8,13,15,32,50,-18,37
St Mirren,8389,10,8,10,18,38,63,-25,34
Hibernian,8390,1,18,13,5,54,28,26,67
Dundee Utd,8390,2,18,10,8,53,33,20,64
Morton,8390,3,16,13,7,50,36,14,61
Falkirk,8390,4,14,10,12,56,49,7,52
Queen of S't,8390,5,14,10,12,50,47,3,52
Raith,8390,6,11,9,16,42,53,-11,42
St Mirren,8390,7,10,10,16,43,56,-13,40
Dunfermline,8390,8,9,12,15,45,50,-5,39
Dumbarton,8390,9,8,13,15,50,60,-10,37
Ayr,8390,10,7,10,19,32,63,-31,31
Morton,8391,1,19,11,6,55,33,22,68
Hibernian,8391,2,18,11,7,55,31,24,65
Dundee Utd,8391,3,16,10,10,56,48,8,58
Falkirk,8391,4,15,10,11,55,42,13,55
Queen of S't,8391,5,14,9,13,49,48,1,51
Dunfermline,8391,6,10,13,13,46,48,-2,43
Raith,8391,7,10,9,17,32,52,-20,39
Dumbarton,8391,8,9,10,17,49,60,-11,37
Ayr,8391,9,8,13,15,36,53,-17,37
St Mirren,8391,10,8,10,18,38,56,-18,34
Hibernian,8392,1,19,11,6,53,26,27,68
Falkirk,8392,2,19,10,7,64,36,28,67
Morton,8392,3,15,14,7,45,32,13,59
Dundee Utd,8392,4,14,11,11,49,39,10,53
Dunfermline,8392,5,11,14,11,45,42,3,47
Queen of S't,8392,6,11,11,14,42,51,-9,44
Raith,8392,7,10,10,16,35,47,-12,40
St Mirren,8392,8,8,11,17,39,60,-21,35
Ayr,8392,9,8,11,17,32,56,-24,35
Dumbarton,8392,10,7,13,16,43,58,-15,34
Hibernian,8393,1,20,12,4,56,23,33,72
Dundee Utd,8393,2,17,9,10,53,36,17,60
Morton,8393,3,15,13,8,49,36,13,58
Falkirk,8393,4,15,10,11,56,44,12,55
Dunfermline,8393,5,12,11,13,46,50,-4,47
Queen of S't,8393,6,12,9,15,47,54,-7,45
Ayr,8393,7,10,12,14,34,50,-16,42
Raith,8393,8,8,12,16,34,50,-16,36
St Mirren,8393,9,8,11,17,41,56,-15,35
Dumbarton,8393,10,7,13,16,46,63,-17,34
Hibernian,8394,1,20,10,6,61,29,32,70
Morton,8394,2,19,10,7,54,39,15,67
Falkirk,8394,3,18,10,8,64,39,25,64
Dundee Utd,8394,4,16,9,11,55,45,10,57
Dunfermline,8394,5,11,13,12,59,50,9,46
Queen of S't,8394,6,12,8,16,49,60,-11,44
Dumbarton,8394,7,9,11,16,48,61,-13,38
Raith,8394,8,10,8,18,36,54,-18,38
St Mirren,8394,9,9,9,18,44,62,-18,36
Ayr,8394,10,7,10,19,32,63,-31,31
Hibernian,8395,1,19,12,5,60,26,34,69
Morton,8395,2,15,14,7,47,35,12,59
Dunfermline,8395,3,13,13,10,50,42,8,52
Falkirk,8395,4,14,10,12,53,47,6,52
Dundee Utd,8395,5,14,10,12,47,43,4,52
Queen of S't,8395,6,12,9,15,45,52,-7,45
Dumbarton,8395,7,10,11,15,44,53,-9,41
Raith,8395,8,10,11,15,34,46,-12,41
Ayr,8395,9,8,14,14,38,53,-15,38
St Mirren,8395,10,8,10,18,37,58,-21,34
Hibernian,8396,1,18,13,5,54,27,27,67
Dundee Utd,8396,2,18,10,8,46,31,15,64
Morton,8396,3,16,12,8,49,38,11,60
Falkirk,8396,4,15,11,10,56,42,14,56
Queen of S't,8396,5,11,10,15,43,51,-8,43
Raith,8396,6,11,10,15,36,49,-13,43
St Mirren,8396,7,9,12,15,40,51,-11,39
Dunfermline,8396,8,8,14,14,41,44,-3,38
Dumbarton,8396,9,8,13,15,44,55,-11,37
Ayr,8396,10,7,13,16,34,55,-21,34
Dundee Utd,8397,1,17,11,8,59,40,19,62
Hibernian,8397,2,16,13,7,49,31,18,61
Morton,8397,3,16,12,8,49,37,12,60
Falkirk,8397,4,16,9,11,62,44,18,57
Dunfermline,8397,5,12,13,11,52,48,4,49
Queen of S't,8397,6,13,9,14,45,48,-3,48
Raith,8397,7,10,9,17,31,49,-18,39
Ayr,8397,8,9,11,16,35,56,-21,38
Dumbarton,8397,9,9,10,17,47,58,-11,37
St Mirren,8397,10,8,11,17,37,55,-18,35
Hibernian,8398,1,16,14,6,56,33,23,62
Falkirk,8398,2,17,11,8,55,36,19,62
Morton,8398,3,17,11,8,56,40,16,62
Dundee Utd,8398,4,14,10,12,44,39,5,52
Raith,8398,5,12,10,14,40,47,-7,46
Queen of S't,8398,6,12,9,15,45,47,-2,45
St Mirren,8398,7,9,13,14,46,55,-9,40
Ayr,8398,8,9,12,15,36,58,-22,39
Dunfermline,8398,9,8,14,14,43,53,-10,38
Dumbarton,8398,10,8,12,16,44,57,-13,36
Hibernian,8399,1,21,12,3,61,25,36,75
Dundee Utd,8399,2,17,10,9,49,34,15,61
Morton,8399,3,15,14,7,49,36,13,59
Falkirk,8399,4,14,9,13,53,44,9,51
Dunfermline,8399,5,11,12,13,44,50,-6,45
Queen of S't,8399,6,12,8,16,40,48,-8,44
Dumbarton,8399,7,10,13,13,51,54,-3,43
Raith,8399,8,10,9,17,37,48,-11,39
St Mirren,8399,9,9,10,17,38,53,-15,37
Ayr,8399,10,7,11,18,32,62,-30,32
Hibernian,8400,1,20,12,4,59,27,32,72
Falkirk,8400,2,17,11,8,59,38,21,62
Dundee Utd,8400,3,17,9,10,50,38,12,60
Morton,8400,4,15,14,7,50,38,12,59
Queen of S't,8400,5,12,9,15,45,50,-5,45
Dumbarton,8400,6,11,11,14,48,54,-6,44
Raith,8400,7,11,10,15,41,49,-8,43
Dunfermline,8400,8,7,14,15,40,54,-14,35
Ayr,8400,9,7,14,15,32,51,-19,35
St Mirren,8400,10,6,10,20,36,61,-25,28
Hibernian,8401,1,19,12,5,56,26,30,69
Morton,8401,2,17,11,8,49,35,14,62
Falkirk,8401,3,17,10,9,60,42,18,61
Dundee Utd,8401,4,16,10,10,50,40,10,58
Dunfermline,8401,5,12,12,12,49,47,2,48
Queen of S't,8401,6,12,9,15,45,49,-4,45
Raith,8401,7,11,9,16,36,47,-11,42
St Mirren,8401,8,8,11,17,39,55,-16,35
Ayr,8401,9,7,13,16,33,57,-24,34
Dumbarton,8401,10,7,11,18,44,63,-19,32
Hibernian,8402,1,19,12,5,55,27,28,69
Morton,8402,2,16,13,7,49,37,12,61
Falkirk,8402,3,16,11,9,64,44,20,59
Dundee Utd,8402,4,15,10,11,52,46,6,55
Dunfermline,8402,5,12,12,12,52,49,3,48
Dumbarton,8402,6,10,12,14,55,57,-2,42
Raith,8402,7,10,11,15,34,46,-12,41
Queen of S't,8402,8,10,9,17,42,54,-12,39
Ayr,8402,9,8,12,16,32,54,-22,36
St Mirren,8402,10,8,10,18,41,62,-21,34
Hibernian,8403,1,20,10,6,51,23,28,70
Morton,8403,2,18,11,7,56,37,19,65
Falkirk,8403,3,15,11,10,51,38,13,56
Dundee Utd,8403,4,15,11,10,45,38,7,56
Dunfermline,8403,5,9,14,13,43,47,-4,41
Dumbarton,8403,6,9,14,13,48,54,-6,41
Raith,8403,7,10,11,15,37,50,-13,41
Queen of S't,8403,8,10,9,17,40,49,-9,39
Ayr,8403,9,8,14,14,31,50,-19,38
St Mirren,8403,10,7,13,16,40,56,-16,34
Hibernian,8404,1,21,11,4,55,24,31,74
Falkirk,8404,2,15,13,8,59,40,19,58
Morton,8404,3,15,10,11,46,37,9,55
Dundee Utd,8404,4,15,10,11,49,42,7,55
Dunfermline,8404,5,12,12,12,46,45,1,48
Raith,8404,6,11,10,15,38,50,-12,43
Queen of S't,8404,7,10,10,16,42,49,-7,40
Dumbarton,8404,8,8,14,14,44,55,-11,38
Ayr,8404,9,8,14,14,32,51,-19,38
St Mirren,8404,10,7,12,17,35,53,-18,33
Hibernian,8405,1,18,13,5,56,30,26,67
Morton,8405,2,17,12,7,54,37,17,63
Dundee Utd,8405,3,16,10,10,56,45,11,58
Falkirk,8405,4,15,12,9,58,44,14,57
Dunfermline,8405,5,11,12,13,48,50,-2,45
Queen of S't,8405,6,11,10,15,47,48,-1,43
Dumbarton,8405,7,10,11,15,46,57,-11,41
Raith,8405,8,8,14,14,34,49,-15,38
St Mirren,8405,9,8,12,16,42,58,-16,36
Ayr,8405,10,7,12,17,32,55,-23,33
Hibernian,8406,1,18,10,8,55,31,24,64
Morton,8406,2,17,11,8,48,36,12,62
Dundee Utd,8406,3,16,10,10,51,40,11,58
Falkirk,8406,4,15,11,10,60,45,15,56
Dunfermline,8406,5,11,13,12,55,48,7,46
Queen of S't,8406,6,12,9,15,47,53,-6,45
Raith,8406,7,11,9,16,35,52,-17,42
Dumbarton,8406,8,9,13,14,51,58,-7,40
Ayr,8406,9,9,13,14,36,53,-17,40
St Mirren,8406,10,8,9,19,37,59,-22,33
Hibernian,8407,1,18,13,5,55,25,30,67
Morton,8407,2,16,12,8,53,37,16,60
Falkirk,8407,3,15,13,8,62,41,21,58
Dundee Utd,8407,4,15,9,12,49,47,2,54
Dumbarton,8407,5,11,13,12,51,53,-2,46
Queen of S't,8407,6,12,8,16,48,54,-6,44
Dunfermline,8407,7,10,13,13,47,53,-6,43
Raith,8407,8,11,10,15,37,48,-11,43
St Mirren,8407,9,10,10,16,44,55,-11,40
Ayr,8407,10,6,11,19,32,65,-33,29
Hibernian,8408,1,19,12,5,56,28,28,69
Falkirk,8408,2,16,10,10,57,42,15,58
Dundee Utd,8408,3,16,10,10,50,41,9,58
Morton,8408,4,15,11,10,48,39,9,56
Dunfermline,8408,5,10,14,12,47,48,-1,44
Raith,8408,6,12,8,16,43,49,-6,44
St Mirren,8408,7,10,11,15,45,55,-10,41
Queen of S't,8408,8,10,10,16,41,54,-13,40
Ayr,8408,9,9,12,15,32,50,-18,39
Dumbarton,8408,10,8,12,16,51,64,-13,36
Hibernian,8409,1,20,12,4,56,25,31,72
Morton,8409,2,17,12,7,52,39,13,63
Falkirk,8409,3,16,9,11,57,44,13,57
Dundee Utd,8409,4,14,11,11,47,39,8,53
Queen of S't,8409,5,14,8,14,50,50,0,50
Dumbarton,8409,6,10,12,14,47,52,-5,42
Dunfermline,8409,7,9,13,14,45,52,-7,40
Raith,8409,8,10,8,18,36,51,-15,38
Ayr,8409,9,8,13,15,31,52,-21,37
St Mirren,8409,10,7,12,17,37,54,-17,33
Hibernian,8410,1,19,11,6,57,29,28,68
Falkirk,8410,2,18,9,9,61,39,22,63
Morton,8410,3,17,12,7,52,39,13,63
Dundee Utd,8410,4,13,11,12,47,41,6,50
Queen of S't,8410,5,12,9,15,45,52,-7,45
Raith,8410,6,11,10,15,39,50,-11,43
Dunfermline,8410,7,10,12,14,47,53,-6,42
St Mirren,8410,8,10,9,17,42,55,-13,39
Dumbarton,8410,9,9,11,16,50,58,-8,38
Ayr,8410,10,8,12,16,30,54,-24,36
Hibernian,8411,1,20,10,6,59,25,34,70
Morton,8411,2,17,13,6,52,36,16,64
Falkirk,8411,3,15,10,11,59,44,15,55
Dundee Utd,8411,4,14,12,10,49,42,7,54
Queen of S't,8411,5,13,8,15,51,52,-1,47
Raith,8411,6,11,9,16,37,53,-16,42
Dunfermline,8411,7,9,14,13,45,52,-7,41
St Mirren,8411,8,9,12,15,44,56,-12,39
Dumbarton,8411,9,8,12,16,48,61,-13,36
Ayr,8411,10,7,14,15,31,54,-23,35
Hibernian,8412,1,20,13,3,61,25,36,73
Falkirk,8412,2,15,11,10,57,41,16,56
Morton,8412,3,14,14,8,46,35,11,56
Dundee Utd,8412,4,16,8,12,53,43,10,56
Queen of S't,8412,5,13,10,13,51,49,2,49
Raith,8412,6,11,11,14,34,49,-15,44
Dunfermline,8412,7,10,13,13,47,51,-4,43
St Mirren,8412,8,9,11,16,37,53,-16,38
Dumbarton,8412,9,8,12,16,45,57,-12,36
Ayr,8412,10,6,13,17,31,59,-28,31
Hibernian,8413,1,19,11,6,52,25,27,68
Morton,8413,2,18,9,9,46,33,13,63
Dundee Utd,8413,3,16,9,11,50,40,10,57
Falkirk,8413,4,15,11,10,56,41,15,56
Queen of S't,8413,5,12,11,13,46,48,-2,47
Dumbarton,8413,6,11,11,14,49,54,-5,44
Dunfermline,8413,7,10,12,14,45,49,-4,42
Raith,8413,8,11,9,16,35,48,-13,42
St Mirren,8413,9,8,11,17,41,57,-16,35
Ayr,8413,10,7,12,17,32,57,-25,33
Hibernian,8414,1,19,13,4,58,24,34,70
Morton,8414,2,18,13,5,51,33,18,67
Falkirk,8414,3,16,11,9,59,42,17,59
Dundee Utd,8414,4,15,11,10,51,40,11,56
Dunfermline,8414,5,10,13,13,42,46,-4,43
Queen of S't,8414,6,11,9,16,49,57,-8,42
St Mirren,8414,7,10,10,16,47,61,-14,40
Raith,8414,8,9,9,18,36,52,-16,36
Dumbarton,8414,9,8,11,17,48,60,-12,35
Ayr,8414,10,7,14,15,33,59,-26,35
Hibernian,8415,1,20,12,4,58,26,32,72
Morton,8415,2,16,13,7,45,34,11,61
Dundee Utd,8415,3,15,12,9,45,37,8,57
Falkirk,8415,4,15,9,12,57,42,15,54
Queen of S't,8415,5,13,8,15,48,49,-1,47
Dunfermline,8415,6,10,14,12,44,45,-1,44
St Mirren,8415,7,10,11,15,46,56,-10,41
Ayr,8415,8,8,13,15,35,54,-19,37
Raith,8415,9,9,9,18,37,53,-16,36
Dumbarton,8415,10,8,11,17,45,64,-19,35
Hibernian,8416,1,17,15,4,55,26,29,66
Dundee Utd,8416,2,17,10,9,50,37,13,61
Morton,8416,3,16,12,8,49,35,14,60
Falkirk,8416,4,15,12,9,57,39,18,57
Queen of S't,8416,5,13,9,14,47,52,-5,48
Ayr,8416,6,10,13,13,38,52,-14,43
Dumbarton,8416,7,10,10,16,47,59,-12,40
Dunfermline,8416,8,7,15,14,43,50,-7,36
St Mirren,8416,9,8,11,17,41,58,-17,35
Raith,8416,10,8,11,17,32,51,-19,35
Hibernian,8417,1,18,12,6,54,27,27,66
Dundee Utd,8417,2,18,9,9,56,37,19,63
Morton,8417,3,14,16,6,49,37,12,58
Falkirk,8417,4,15,11,10,54,41,13,56
Dunfermline,8417,5,11,13,12,51,49,2,46
Queen of S't,8417,6,11,9,16,45,53,-8,42
Dumbarton,8417,7,10,11,15,48,60,-12,41
Ayr,8417,8,9,12,15,38,55,-17,39
Raith,8417,9,9,11,16,34,51,-17,38
St Mirren,8417,10,7,12,17,38,57,-19,33
Hibernian,8418,1,19,12,5,57,27,30,69
Falkirk,8418,2,16,11,9,56,38,18,59
Dundee Utd,8418,3,16,10,10,46,37,9,58
Morton,8418,4,14,14,8,47,37,10,56
Queen of S't,8418,5,11,10,15,45,51,-6,43
Dunfermline,8418,6,10,12,14,46,49,-3,42
Dumbarton,8418,7,10,12,14,47,54,-7,42
Raith,8418,8,10,10,16,38,54,-16,40
Ayr,8418,9,9,11,16,34,53,-19,38
St Mirren,8418,10,7,14,15,39,55,-16,35
Hibernian,8419,1,20,11,5,55,29,26,71
Falkirk,8419,2,18,9,9,61,39,22,63
Morton,8419,3,17,11,8,56,40,16,62
Dundee Utd,8419,4,16,12,8,55,39,16,60
Queen of S't,8419,5,11,10,15,42,46,-4,43
Raith,8419,6,11,9,16,38,48,-10,42
Dunfermline,8419,7,9,13,14,47,53,-6,40
Dumbarton,8419,8,9,10,17,46,60,-14,37
Ayr,8419,9,8,11,17,37,61,-24,35
St Mirren,8419,10,8,10,18,38,60,-22,34
Hibernian,8420,1,22,10,4,61,23,38,76
Falkirk,8420,2,18,10,8,58,36,22,64
Morton,8420,3,16,12,8,48,41,7,60
Dundee Utd,8420,4,15,10,11,48,41,7,55
Dunfermline,8420,5,10,12,14,49,52,-3,42
Queen of S't,8420,6,10,10,16,42,51,-9,40
Raith,8420,7,10,10,16,35,50,-15,40
Dumbarton,8420,8,9,12,15,50,55,-5,39
Ayr,8420,9,9,11,16,34,57,-23,38
St Mirren,8420,10,7,11,18,39,58,-19,32
Hibernian,8421,1,21,11,4,62,26,36,74
Falkirk,8421,2,18,9,9,65,40,25,63
Dundee Utd,8421,3,17,10,9,57,38,19,61
Morton,8421,4,16,13,7,49,35,14,61
Raith,8421,5,11,8,17,37,52,-15,41
Dumbarton,8421,6,9,13,14,49,57,-8,40
Dunfermline,8421,7,9,13,14,44,55,-11,40
Queen of S't,8421,8,10,8,18,45,60,-15,38
Ayr,8421,9,7,14,15,35,57,-22,35
St Mirren,8421,10,7,11,18,36,59,-23,32
Morton,8422,1,19,10,7,56,35,21,67
Hibernian,8422,2,18,11,7,53,27,26,65
Dundee Utd,8422,3,16,10,10,59,40,19,58
Falkirk,8422,4,16,9,11,57,40,17,57
Queen of S't,8422,5,14,10,12,47,43,4,52
Dunfermline,8422,6,9,14,13,43,52,-9,41
Raith,8422,7,10,9,17,31,46,-15,39
Dumbarton,8422,8,9,10,17,48,59,-11,37
St Mirren,8422,9,9,10,17,38,64,-26,37
Ayr,8422,10,8,11,17,30,56,-26,35
Hibernian,8423,1,20,12,4,59,25,34,72
Dundee Utd,8423,2,19,8,9,52,36,16,65
Falkirk,8423,3,17,10,9,59,40,19,61
Morton,8423,4,14,11,11,42,38,4,53
Dunfermline,8423,5,10,13,13,48,49,-1,43
Queen of S't,8423,6,10,12,14,48,53,-5,42
Dumbarton,8423,7,9,12,15,48,61,-13,39
Raith,8423,8,10,9,17,36,54,-18,39
Ayr,8423,9,8,12,16,34,54,-20,36
St Mirren,8423,10,8,11,17,41,57,-16,35
Hibernian,8424,1,20,11,5,56,28,28,71
Morton,8424,2,17,13,6,56,38,18,64
Falkirk,8424,3,15,11,10,59,44,15,56
Dundee Utd,8424,4,15,11,10,50,42,8,56
Dunfermline,8424,5,10,13,13,47,48,-1,43
Raith,8424,6,11,10,15,39,50,-11,43
Queen of S't,8424,7,11,9,16,46,52,-6,42
Dumbarton,8424,8,9,13,14,47,57,-10,40
Ayr,8424,9,8,12,16,35,58,-23,36
St Mirren,8424,10,7,11,18,37,55,-18,32
Hibernian,8425,1,18,11,7,56,28,28,65
Morton,8425,2,18,10,8,48,33,15,64
Dundee Utd,8425,3,16,9,11,49,38,11,57
Falkirk,8425,4,14,9,13,52,42,10,51
Dunfermline,8425,5,12,13,11,51,45,6,49
Queen of S't,8425,6,12,10,14,43,47,-4,46
Raith,8425,7,10,12,14,36,47,-11,42
Ayr,8425,8,10,12,14,38,54,-16,42
St Mirren,8425,9,9,9,18,41,63,-22,36
Dumbarton,8425,10,8,11,17,47,64,-17,35
Hibernian,8426,1,19,12,5,58,24,34,69
Falkirk,8426,2,16,13,7,55,35,20,61
Morton,8426,3,16,10,10,49,48,1,58
Dundee Utd,8426,4,16,9,11,51,41,10,57
Dumbarton,8426,5,11,12,13,51,55,-4,45
Dunfermline,8426,6,10,13,13,50,48,2,43
Queen of S't,8426,7,11,8,17,46,57,-11,41
Ayr,8426,8,10,11,15,36,51,-15,41
Raith,8426,9,11,8,17,35,50,-15,41
St Mirren,8426,10,7,10,19,39,61,-22,31
Hibernian,8427,1,18,13,5,52,23,29,67
Morton,8427,2,18,11,7,51,36,15,65
Falkirk,8427,3,17,12,7,63,40,23,63
Dundee Utd,8427,4,17,8,11,54,42,12,59
Queen of S't,8427,5,12,10,14,50,56,-6,46
Dunfermline,8427,6,10,11,15,49,53,-4,41
Dumbarton,8427,7,9,11,16,48,60,-12,38
Ayr,8427,8,8,13,15,32,51,-19,37
St Mirren,8427,9,8,11,17,37,52,-15,35
Raith,8427,10,9,8,19,35,58,-23,35
Morton,8428,1,18,11,7,51,34,17,65
Hibernian,8428,2,17,13,6,51,29,22,64
Falkirk,8428,3,16,10,10,57,42,15,58
Dundee Utd,8428,4,16,10,10,54,41,13,58
Dunfermline,8428,5,13,11,12,50,47,3,50
St Mirren,8428,6,10,11,15,44,53,-9,41
Queen of S't,8428,7,10,10,16,45,53,-8,40
Dumbarton,8428,8,10,10,16,48,57,-9,40
Raith,8428,9,9,9,18,34,52,-18,36
Ayr,8428,10,7,13,16,34,60,-26,34
Morton,8429,1,19,11,6,52,33,19,68
Hibernian,8429,2,19,10,7,55,28,27,67
Falkirk,8429,3,16,10,10,59,42,17,58
Dundee Utd,8429,4,16,10,10,50,37,13,58
Queen of S't,8429,5,11,10,15,45,52,-7,43
Ayr,8429,6,10,12,14,37,50,-13,42
Dunfermline,8429,7,10,11,15,48,53,-5,41
Dumbarton,8429,8,9,12,15,48,58,-10,39
Raith,8429,9,10,9,17,35,53,-18,39
St Mirren,8429,10,7,11,18,38,61,-23,32
Hibernian,8430,1,17,12,7,53,28,25,63
Dundee Utd,8430,2,16,10,10,46,36,10,58
Falkirk,8430,3,14,13,9,55,40,15,55
Morton,8430,4,15,9,12,47,46,1,54
Dunfermline,8430,5,12,13,11,47,42,5,49
Dumbarton,8430,6,11,11,14,48,54,-6,44
Ayr,8430,7,11,11,14,33,47,-14,44
St Mirren,8430,8,10,10,16,41,51,-10,40
Raith,8430,9,10,10,16,33,51,-18,40
Queen of S't,8430,10,10,9,17,44,52,-8,39
Hibernian,8431,1,21,11,4,64,26,38,74
Falkirk,8431,2,17,9,10,57,42,15,60
Morton,8431,3,16,11,9,50,39,11,59
Dundee Utd,8431,4,14,11,11,45,39,6,53
Queen of S't,8431,5,13,10,13,46,46,0,49
Raith,8431,6,12,8,16,36,47,-11,44
Dunfermline,8431,7,9,13,14,45,51,-6,40
Ayr,8431,8,8,13,15,34,56,-22,37
St Mirren,8431,9,9,9,18,37,55,-18,36
Dumbarton,8431,10,8,11,17,44,57,-13,35
Hibernian,8432,1,21,11,4,61,26,35,74
Morton,8432,2,17,13,6,51,31,20,64
Dundee Utd,8432,3,18,10,8,53,38,15,64
Falkirk,8432,4,17,10,9,61,44,17,61
Queen of S't,8432,5,11,10,15,42,52,-10,43
St Mirren,8432,6,9,11,16,47,58,-11,38
Dunfermline,8432,7,8,13,15,47,55,-8,37
Raith,8432,8,9,9,18,33,54,-21,36
Ayr,8432,9,8,11,17,36,54,-18,35
Dumbarton,8432,10,7,12,17,44,63,-19,33
Hibernian,8433,1,17,13,6,60,35,25,64
Falkirk,8433,2,17,10,9,63,44,19,61
Dundee Utd,8433,3,16,9,11,51,42,9,57
Morton,8433,4,14,14,8,47,40,7,56
Dunfermline,8433,5,13,13,10,53,44,9,52
Queen of S't,8433,6,11,11,14,48,54,-6,44
Raith,8433,7,10,10,16,42,57,-15,40
St Mirren,8433,8,9,11,16,39,53,-14,38
Dumbarton,8433,9,7,14,15,46,58,-12,35
Ayr,8433,10,7,13,16,35,57,-22,34
Morton,8434,1,20,10,6,55,33,22,70
Hibernian,8434,2,19,12,5,54,25,29,69
Dundee Utd,8434,3,17,10,9,50,39,11,61
Falkirk,8434,4,14,12,10,54,40,14,54
Queen of S't,8434,5,12,10,14,42,47,-5,46
Dunfermline,8434,6,9,14,13,43,44,-1,41
Raith,8434,7,10,9,17,33,48,-15,39
Ayr,8434,8,9,12,15,37,56,-19,39
Dumbarton,8434,9,8,12,16,46,57,-11,36
St Mirren,8434,10,7,9,20,37,62,-25,30
Hibernian,8435,1,20,12,4,61,27,34,72
Morton,8435,2,17,10,9,51,38,13,61
Falkirk,8435,3,16,9,11,58,42,16,57
Dundee Utd,8435,4,15,11,10,46,37,9,56
Dunfermline,8435,5,10,15,11,49,48,1,45
Queen of S't,8435,6,10,11,15,40,48,-8,41
Dumbarton,8435,7,10,10,16,48,59,-11,40
St Mirren,8435,8,10,9,17,39,56,-17,39
Ayr,8435,9,9,12,15,36,53,-17,39
Raith,8435,10,8,11,17,32,52,-20,35
Hibernian,8436,1,19,12,5,57,25,32,69
Morton,8436,2,16,10,10,47,38,9,58
Dundee Utd,8436,3,16,10,10,51,43,8,58
Falkirk,8436,4,14,10,12,52,44,8,52
Dunfermline,8436,5,12,13,11,54,44,10,49
Raith,8436,6,12,10,14,41,52,-11,46
Queen of S't,8436,7,12,9,15,49,56,-7,45
Ayr,8436,8,8,14,14,36,52,-16,38
Dumbarton,8436,9,8,12,16,46,62,-16,36
St Mirren,8436,10,8,10,18,37,54,-17,34
Hibernian,8437,1,19,12,5,54,24,30,69
Morton,8437,2,18,11,7,52,34,18,65
Falkirk,8437,3,16,11,9,61,41,20,59
Dundee Utd,8437,4,17,8,11,53,40,13,59
Queen of S't,8437,5,13,9,14,47,48,-1,48
Dunfermline,8437,6,10,12,14,48,52,-4,42
Raith,8437,7,9,11,16,34,50,-16,38
Dumbarton,8437,8,8,12,16,48,63,-15,36
Ayr,8437,9,7,14,15,30,54,-24,35
St Mirren,8437,10,8,10,18,39,60,-21,34
Hibernian,8438,1,18,12,6,55,30,25,66
Morton,8438,2,18,11,7,54,34,20,65
Falkirk,8438,3,17,9,10,58,43,15,60
Dundee Utd,8438,4,16,10,10,51,41,10,58
Dunfermline,8438,5,11,13,12,46,50,-4,46
Queen of S't,8438,6,11,10,15,44,48,-4,43
Raith,8438,7,10,10,16,34,47,-13,40
St Mirren,8438,8,9,10,17,40,54,-14,37
Dumbarton,8438,9,8,12,16,45,58,-13,36
Ayr,8438,10,7,13,16,33,55,-22,34
Hibernian,8439,1,19,12,5,54,25,29,69
Morton,8439,2,17,11,8,52,37,15,62
Dundee Utd,8439,3,15,11,10,54,42,12,56
Falkirk,8439,4,14,12,10,57,45,12,54
Queen of S't,8439,5,13,8,15,49,50,-1,47
Raith,8439,6,13,8,15,38,47,-9,47
Dunfermline,8439,7,10,13,13,47,48,-1,43
Dumbarton,8439,8,10,10,16,52,63,-11,40
Ayr,8439,9,8,15,13,32,49,-17,39
St Mirren,8439,10,6,10,20,34,63,-29,28
Hibernian,8440,1,17,12,7,52,29,23,63
Dundee Utd,8440,2,17,10,9,46,34,12,61
Falkirk,8440,3,16,11,9,55,36,19,59
Morton,8440,4,16,10,10,50,42,8,58
Queen of S't,8440,5,11,10,15,42,47,-5,43
Raith,8440,6,11,9,16,32,45,-13,42
Dunfermline,8440,7,9,14,13,48,52,-4,41
Ayr,8440,8,9,14,13,34,50,-16,41
St Mirren,8440,9,10,10,16,40,51,-11,40
Dumbarton,8440,10,9,10,17,46,59,-13,37
Hibernian,8441,1,18,13,5,57,28,29,67
Morton,8441,2,17,11,8,53,42,11,62
Falkirk,8441,3,17,10,9,57,37,20,61
Dundee Utd,8441,4,16,8,12,49,40,9,56
Queen of S't,8441,5,12,12,12,48,48,0,48
Dunfermline,8441,6,9,15,12,45,47,-2,42
Raith,8441,7,9,12,15,33,47,-14,39
St Mirren,8441,8,8,13,15,38,50,-12,37
Dumbarton,8441,9,8,11,17,42,60,-18,35
Ayr,8441,10,7,13,16,36,59,-23,34
Hibernian,8442,1,19,11,6,55,27,28,68
Morton,8442,2,17,10,9,50,39,11,61
Falkirk,8442,3,15,11,10,54,39,15,56
Dundee Utd,8442,4,13,12,11,45,42,3,51
Queen of S't,8442,5,13,9,14,44,46,-2,48
Raith,8442,6,12,10,14,39,46,-7,46
Dunfermline,8442,7,9,14,13,45,48,-3,41
Ayr,8442,8,9,13,14,35,51,-16,40
St Mirren,8442,9,9,11,16,37,51,-14,38
Dumbarton,8442,10,8,11,17,44,59,-15,35
Hibernian,8443,1,19,13,4,56,26,30,70
Morton,8443,2,16,13,7,53,38,15,61
Dundee Utd,8443,3,16,10,10,53,45,8,58
Falkirk,8443,4,15,12,9,60,42,18,57
Raith,8443,5,11,11,14,42,50,-8,44
Dunfermline,8443,6,10,13,13,48,48,0,43
Queen of S't,8443,7,10,9,17,42,58,-16,39
St Mirren,8443,8,9,10,17,48,64,-16,37
Ayr,8443,9,7,16,13,39,56,-17,37
Dumbarton,8443,10,8,11,17,48,62,-14,35
Hibernian,8444,1,21,12,3,59,23,36,75
Morton,8444,2,20,10,6,55,34,21,70
Dundee Utd,8444,3,18,8,10,53,39,14,62
Falkirk,8444,4,15,11,10,57,41,16,56
Dunfermline,8444,5,11,13,12,52,52,0,46
Queen of S't,8444,6,9,10,17,39,55,-16,37
Raith,8444,7,8,12,16,29,47,-18,36
Ayr,8444,8,8,12,16,33,54,-21,36
St Mirren,8444,9,8,10,18,39,56,-17,34
Dumbarton,8444,10,7,12,17,44,59,-15,33
Hibernian,8445,1,18,13,5,52,26,26,67
Falkirk,8445,2,18,11,7,60,37,23,65
Morton,8445,3,18,9,9,53,41,12,63
Dundee Utd,8445,4,15,10,11,50,42,8,55
Dunfermline,8445,5,10,13,13,44,46,-2,43
Queen of S't,8445,6,11,10,15,43,49,-6,43
Dumbarton,8445,7,10,11,15,51,58,-7,41
Ayr,8445,8,9,12,15,35,52,-17,39
St Mirren,8445,9,9,10,17,42,58,-16,37
Raith,8445,10,8,9,19,35,56,-21,33
Morton,8446,1,19,10,7,58,37,21,67
Hibernian,8446,2,18,12,6,54,29,25,66
Falkirk,8446,3,16,10,10,55,40,15,58
Dundee Utd,8446,4,16,10,10,54,39,15,58
Queen of S't,8446,5,12,10,14,46,48,-2,46
Dunfermline,8446,6,11,12,13,47,48,-1,45
Raith,8446,7,9,11,16,34,48,-14,38
St Mirren,8446,8,9,10,17,45,57,-12,37
Dumbarton,8446,9,8,11,17,46,67,-21,35
Ayr,8446,10,7,14,15,33,59,-26,35
Hibernian,8447,1,20,10,6,53,26,27,70
Morton,8447,2,17,10,9,47,34,13,61
Falkirk,8447,3,17,9,10,59,39,20,60
Dundee Utd,8447,4,15,11,10,52,41,11,56
Dunfermline,8447,5,11,13,12,45,45,0,46
Queen of S't,8447,6,12,10,14,42,48,-6,46
Dumbarton,8447,7,10,11,15,51,58,-7,41
Raith,8447,8,11,8,17,34,48,-14,41
St Mirren,8447,9,8,11,17,38,56,-18,35
Ayr,8447,10,7,11,18,30,56,-26,32
Hibernian,8448,1,18,14,4,54,25,29,68
Morton,8448,2,16,13,7,48,33,15,61
Falkirk,8448,3,16,11,9,58,43,15,59
Dundee Utd,8448,4,15,11,10,49,39,10,56
Dunfermline,8448,5,10,14,12,53,49,4,44
Queen of S't,8448,6,11,11,14,43,48,-5,44
Dumbarton,8448,7,10,12,14,54,58,-4,42
St Mirren,8448,8,9,9,18,38,58,-20,36
Ayr,8448,9,8,12,16,34,56,-22,36
Raith,8448,10,9,9,18,30,52,-22,36
Hibernian,8449,1,17,14,5,56,29,27,65
Falkirk,8449,2,18,10,8,64,37,27,64
Dundee Utd,8449,3,18,10,8,60,39,21,64
Morton,8449,4,14,14,8,46,38,8,56
Queen of S't,8449,5,14,8,14,46,46,0,50
Raith,8449,6,13,8,15,39,47,-8,47
Dunfermline,8449,7,7,16,13,45,50,-5,37
St Mirren,8449,8,8,11,17,41,59,-18,35
Dumbarton,8449,9,7,12,17,45,65,-20,33
Ayr,8449,10,6,13,17,30,62,-32,31
Hibernian,8450,1,19,12,5,54,23,31,69
Morton,8450,2,18,11,7,51,37,14,65
Falkirk,8450,3,15,10,11,56,40,16,55
Dundee Utd,8450,4,14,11,11,44,40,4,53
Queen of S't,8450,5,12,9,15,48,49,-1,45
Dunfermline,8450,6,11,12,13,47,48,-1,45
Dumbarton,8450,7,10,11,15,50,61,-11,41
Raith,8450,8,10,9,17,35,53,-18,39
St Mirren,8450,9,9,11,16,40,52,-12,38
Ayr,8450,10,8,12,16,37,59,-22,36
Hibernian,8451,1,19,12,5,58,28,30,69
Dundee Utd,8451,2,17,9,10,49,40,9,60
Falkirk,8451,3,16,9,11,59,43,16,57
Morton,8451,4,15,12,9,49,40,9,57
Dumbarton,8451,5,10,13,13,53,58,-5,43
Dunfermline,8451,6,9,14,13,46,48,-2,41
Queen of S't,8451,7,10,10,16,45,56,-11,40
Ayr,8451,8,9,13,14,38,54,-16,40
St Mirren,8451,9,9,11,16,42,54,-12,38
Raith,8451,10,9,11,16,34,52,-18,38
Hibernian,8452,1,19,13,4,59,25,34,70
Dundee Utd,8452,2,18,9,9,60,41,19,63
Morton,8452,3,17,11,8,51,38,13,62
Falkirk,8452,4,14,11,11,55,46,9,53
Dunfermline,8452,5,12,12,12,52,47,5,48
Queen of S't,8452,6,11,10,15,43,53,-10,43
Ayr,8452,7,9,14,13,32,48,-16,41
Raith,8452,8,10,10,16,35,54,-19,40
Dumbarton,8452,9,8,11,17,45,58,-13,35
St Mirren,8452,10,7,9,20,39,61,-22,30
Hibernian,8453,1,19,11,6,55,26,29,68
Dundee Utd,8453,2,18,9,9,50,34,16,63
Morton,8453,3,16,12,8,47,36,11,60
Falkirk,8453,4,13,10,13,53,47,6,49
Dunfermline,8453,5,11,13,12,50,48,2,46
Queen of S't,8453,6,11,9,16,45,55,-10,42
St Mirren,8453,7,11,9,16,38,49,-11,42
Dumbarton,8453,8,10,11,15,47,54,-7,41
Raith,8453,9,10,9,17,33,51,-18,39
Ayr,8453,10,9,11,16,38,56,-18,38
Hibernian,8454,1,21,11,4,58,24,34,74
Falkirk,8454,2,15,12,9,59,42,17,57
Dundee Utd,8454,3,15,10,11,45,39,6,55
Morton,8454,4,14,12,10,45,38,7,54
Queen of S't,8454,5,11,9,16,43,52,-9,42
Dunfermline,8454,6,9,14,13,48,49,-1,41
Dumbarton,8454,7,9,14,13,50,55,-5,41
St Mirren,8454,8,10,10,16,43,52,-9,40
Raith,8454,9,10,10,16,38,56,-18,40
Ayr,8454,10,9,12,15,37,59,-22,39
Hibernian,8455,1,19,12,5,56,25,31,69
Morton,8455,2,17,10,9,52,42,10,61
Falkirk,8455,3,16,12,8,55,37,18,60
Dundee Utd,8455,4,16,11,9,49,33,16,59
Raith,8455,5,11,10,15,36,45,-9,43
Dunfermline,8455,6,10,12,14,42,45,-3,42
Queen of S't,8455,7,10,11,15,40,50,-10,41
St Mirren,8455,8,9,11,16,44,59,-15,38
Dumbarton,8455,9,8,12,16,44,58,-14,36
Ayr,8455,10,8,11,17,36,60,-24,35
Hibernian,8456,1,20,13,3,60,25,35,73
Morton,8456,2,15,14,7,46,33,13,59
Dundee Utd,8456,3,15,10,11,50,40,10,55
Falkirk,8456,4,13,14,9,58,46,12,53
Queen of S't,8456,5,13,9,14,47,48,-1,48
Raith,8456,6,12,9,15,37,46,-9,45
Dunfermline,8456,7,9,12,15,43,53,-10,39
Dumbarton,8456,8,8,13,15,45,55,-10,37
Ayr,8456,9,8,13,15,35,59,-24,37
St Mirren,8456,10,7,13,16,36,52,-16,34
Hibernian,8457,1,19,12,5,54,27,27,69
Morton,8457,2,17,11,8,49,35,14,62
Dundee Utd,8457,3,15,9,12,49,41,8,54
Falkirk,8457,4,14,10,12,55,45,10,52
Queen of S't,8457,5,12,10,14,44,47,-3,46
Dunfermline,8457,6,10,13,13,49,52,-3,43
Raith,8457,7,11,9,16,35,51,-16,42
Dumbarton,8457,8,10,11,15,48,58,-10,41
Ayr,8457,9,10,10,16,35,51,-16,40
St Mirren,8457,10,9,11,16,41,52,-11,38
Dundee Utd,8458,1,18,10,8,54,39,15,64
Morton,8458,2,18,10,8,50,36,14,64
Hibernian,8458,3,17,10,9,50,29,21,61
Falkirk,8458,4,16,12,8,61,41,20,60
Queen of S't,8458,5,11,11,14,47,52,-5,44
Dunfermline,8458,6,10,13,13,49,51,-2,43
Dumbarton,8458,7,10,11,15,52,58,-6,41
Raith,8458,8,9,10,17,34,50,-16,37
St Mirren,8458,9,9,10,17,39,57,-18,37
Ayr,8458,10,8,11,17,35,58,-23,35
Morton,8459,1,18,12,6,50,33,17,66
Hibernian,8459,2,16,14,6,51,29,22,62
Falkirk,8459,3,14,11,11,57,44,13,53
Dundee Utd,8459,4,14,11,11,43,39,4,53
Queen of S't,8459,5,13,9,14,44,47,-3,48
Dunfermline,8459,6,10,15,11,49,47,2,45
Raith,8459,7,10,11,15,38,51,-13,41
St Mirren,8459,8,10,10,16,45,55,-10,40
Dumbarton,8459,9,9,11,16,48,59,-11,38
Ayr,8459,10,7,14,15,35,56,-21,35
Hibernian,8460,1,20,12,4,59,24,35,72
Dundee Utd,8460,2,15,11,10,47,43,4,56
Falkirk,8460,3,14,13,9,58,44,14,55
Morton,8460,4,14,13,9,48,42,6,55
Dunfermline,8460,5,11,14,11,47,42,5,47
Queen of S't,8460,6,12,9,15,46,50,-4,45
Raith,8460,7,10,10,16,32,46,-14,40
Ayr,8460,8,8,14,14,35,54,-19,38
St Mirren,8460,9,8,12,16,42,55,-13,36
Dumbarton,8460,10,8,12,16,49,63,-14,36
Hibernian,8461,1,20,11,5,61,27,34,71
Falkirk,8461,2,17,11,8,64,41,23,62
Dundee Utd,8461,3,17,11,8,56,36,20,62
Morton,8461,4,15,13,8,48,36,12,58
Queen of S't,8461,5,10,11,15,43,53,-10,41
Raith,8461,6,10,10,16,34,46,-12,40
Dumbarton,8461,7,9,12,15,45,56,-11,39
Dunfermline,8461,8,9,12,15,43,54,-11,39
St Mirren,8461,9,9,12,15,40,54,-14,39
Ayr,8461,10,7,11,18,35,66,-31,32
Hibernian,8462,1,20,12,4,62,27,35,72
Dundee Utd,8462,2,18,9,9,51,36,15,63
Falkirk,8462,3,15,10,11,53,43,10,55
Morton,8462,4,14,12,10,46,39,7,54
Dumbarton,8462,5,11,12,13,52,53,-1,45
Queen of S't,8462,6,11,11,14,50,50,0,44
Dunfermline,8462,7,10,11,15,44,58,-14,41
Raith,8462,8,10,10,16,37,48,-11,40
St Mirren,8462,9,8,12,16,34,50,-16,36
Ayr,8462,10,7,13,16,33,58,-25,34
Hibernian,8463,1,19,13,4,55,24,31,70
Falkirk,8463,2,16,11,9,63,38,25,59
Morton,8463,3,16,9,11,49,44,5,57
Dundee Utd,8463,4,15,11,10,47,38,9,56
Dumbarton,8463,5,11,11,14,47,53,-6,44
Dunfermline,8463,6,10,13,13,47,51,-4,43
Queen of S't,8463,7,10,12,14,46,57,-11,42
Raith,8463,8,10,10,16,36,50,-14,40
St Mirren,8463,9,8,13,15,37,50,-13,37
Ayr,8463,10,7,13,16,32,54,-22,34
Hibernian,8464,1,21,11,4,57,25,32,74
Morton,8464,2,16,13,7,49,35,14,61
Dundee Utd,8464,3,16,10,10,51,38,13,58
Falkirk,8464,4,14,9,13,52,46,6,51
Queen of S't,8464,5,12,8,16,44,50,-6,44
Ayr,8464,6,11,11,14,38,54,-16,44
Dunfermline,8464,7,9,13,14,44,48,-4,40
Raith,8464,8,10,9,17,35,48,-13,39
Dumbarton,8464,9,9,11,16,43,55,-12,38
St Mirren,8464,10,9,11,16,37,51,-14,38
Hibernian,8465,1,18,13,5,51,25,26,67
Morton,8465,2,17,11,8,49,35,14,62
Falkirk,8465,3,16,10,10,59,43,16,58
Dundee Utd,8465,4,16,9,11,51,37,14,57
Dunfermline,8465,5,12,12,12,47,45,2,48
Queen of S't,8465,6,11,10,15,45,53,-8,43
St Mirren,8465,7,10,10,16,41,55,-14,40
Ayr,8465,8,9,13,14,36,52,-16,40
Raith,8465,9,9,9,18,32,51,-19,36
Dumbarton,8465,10,8,11,17,48,63,-15,35
Hibernian,8466,1,20,12,4,60,22,38,72
Dundee Utd,8466,2,17,10,9,52,39,13,61
Morton,8466,3,15,12,9,48,39,9,57
Falkirk,8466,4,15,11,10,58,44,14,56
Queen of S't,8466,5,12,9,15,48,54,-6,45
Dunfermline,8466,6,10,12,14,51,52,-1,42
Dumbarton,8466,7,10,12,14,50,55,-5,42
St Mirren,8466,8,9,10,17,43,61,-18,37
Raith,8466,9,9,10,17,36,56,-20,37
Ayr,8466,10,7,14,15,37,61,-24,35
Morton,8467,1,19,11,6,57,34,23,68
Hibernian,8467,2,18,11,7,53,33,20,65
Falkirk,8467,3,17,10,9,60,40,20,61
Dundee Utd,8467,4,15,10,11,47,42,5,55
Queen of S't,8467,5,13,8,15,50,53,-3,47
Dunfermline,8467,6,10,11,15,44,47,-3,41
Raith,8467,7,10,11,15,39,49,-10,41
St Mirren,8467,8,9,11,16,41,51,-10,38
Ayr,8467,9,8,12,16,33,58,-25,36
Dumbarton,8467,10,8,11,17,47,64,-17,35
Hibernian,8468,1,18,14,4,51,23,28,68
Morton,8468,2,16,13,7,49,35,14,61
Dundee Utd,8468,3,16,10,10,53,41,12,58
Queen of S't,8468,4,14,10,12,46,45,1,52
Falkirk,8468,5,13,11,12,52,47,5,50
Dunfermline,8468,6,9,14,13,51,47,4,41
St Mirren,8468,7,10,11,15,41,49,-8,41
Raith,8468,8,9,10,17,33,54,-21,37
Ayr,8468,9,8,13,15,31,54,-23,37
Dumbarton,8468,10,7,14,15,45,57,-12,35
Hibernian,8469,1,19,12,5,55,27,28,69
Morton,8469,2,16,13,7,50,39,11,61
Dundee Utd,8469,3,15,10,11,54,40,14,55
Falkirk,8469,4,15,10,11,55,44,11,55
Dunfermline,8469,5,11,14,11,48,44,4,47
Raith,8469,6,10,12,14,38,46,-8,42
Queen of S't,8469,7,10,11,15,40,51,-11,41
St Mirren,8469,8,9,12,15,43,55,-12,39
Ayr,8469,9,9,10,17,37,58,-21,37
Dumbarton,8469,10,8,12,16,44,60,-16,36
Hibernian,8470,1,19,12,5,52,25,27,69
Falkirk,8470,2,16,11,9,57,46,11,59
Morton,8470,3,16,11,9,47,38,9,59
Dundee Utd,8470,4,16,9,11,58,43,15,57
Queen of S't,8470,5,12,9,15,47,49,-2,45
Dumbarton,8470,6,10,12,14,54,60,-6,42
Raith,8470,7,10,12,14,36,46,-10,42
Ayr,8470,8,10,12,14,39,57,-18,42
Dunfermline,8470,9,8,13,15,43,51,-8,37
St Mirren,8470,10,7,11,18,40,58,-18,32
Hibernian,8471,1,17,15,4,53,26,27,66
Morton,8471,2,17,12,7,53,39,14,63
Falkirk,8471,3,16,13,7,55,34,21,61
Dundee Utd,8471,4,14,10,12,47,42,5,52
Dunfermline,8471,5,10,14,12,48,46,2,44
Queen of S't,8471,6,11,11,14,43,46,-3,44
Dumbarton,8471,7,10,12,14,48,57,-9,42
Raith,8471,8,11,9,16,37,54,-17,42
Ayr,8471,9,8,13,15,34,53,-19,37
St Mirren,8471,10,6,11,19,36,57,-21,29
Hibernian,8472,1,19,13,4,62,27,35,70
Morton,8472,2,17,12,7,52,35,17,63
Dundee Utd,8472,3,17,9,10,51,39,12,60
Falkirk,8472,4,16,10,10,57,43,14,58
Dunfermline,8472,5,11,12,13,49,48,1,45
Queen of S't,8472,6,11,10,15,44,52,-8,43
Ayr,8472,7,9,11,16,33,54,-21,38
Raith,8472,8,9,10,17,32,52,-20,37
Dumbarton,8472,9,8,12,16,46,60,-14,36
St Mirren,8472,10,8,11,17,40,56,-16,35
Hibernian,8473,1,19,13,4,53,22,31,70
Dundee Utd,8473,2,18,8,10,52,39,13,62
Falkirk,8473,3,16,10,10,59,40,19,58
Morton,8473,4,15,9,12,46,44,2,54
Dunfermline,8473,5,11,13,12,46,45,1,46
Ayr,8473,6,11,11,14,39,48,-9,44
Raith,8473,7,12,8,16,37,46,-9,44
Dumbarton,8473,8,9,10,17,50,61,-11,37
St Mirren,8473,9,9,10,17,35,53,-18,37
Queen of S't,8473,10,9,10,17,39,58,-19,37
Hibernian,8474,1,18,13,5,53,28,25,67
Morton,8474,2,15,14,7,51,37,14,59
Dundee Utd,8474,3,16,8,12,55,41,14,56
Falkirk,8474,4,15,10,11,56,43,13,55
Queen of S't,8474,5,11,11,14,48,53,-5,44
Dumbarton,8474,6,11,10,15,50,56,-6,43
St Mirren,8474,7,11,10,15,47,56,-9,43
Dunfermline,8474,8,9,14,13,47,57,-10,41
Raith,8474,9,9,11,16,39,52,-13,38
Ayr,8474,10,8,13,15,34,57,-23,37
Morton,8475,1,18,13,5,54,34,20,67
Hibernian,8475,2,17,15,4,53,25,28,66
Dundee Utd,8475,3,18,9,9,55,41,14,63
Falkirk,8475,4,15,12,9,58,42,16,57
Dunfermline,8475,5,12,11,13,46,45,1,47
Queen of S't,8475,6,10,11,15,45,53,-8,41
Dumbarton,8475,7,8,13,15,47,57,-10,37
Raith,8475,8,8,11,17,35,54,-19,35
St Mirren,8475,9,7,13,16,43,58,-15,34
Ayr,8475,10,6,14,16,33,60,-27,32
Hibernian,8476,1,20,12,4,58,30,28,72
Morton,8476,2,18,12,6,57,36,21,66
Dundee Utd,8476,3,16,9,11,51,46,5,57
Falkirk,8476,4,15,10,11,64,44,20,55
Queen of S't,8476,5,15,8,13,49,47,2,53
Dumbarton,8476,6,10,11,15,53,60,-7,41
Raith,8476,7,10,9,17,36,52,-16,39
Ayr,8476,8,9,12,15,37,54,-17,39
Dunfermline,8476,9,8,11,17,44,57,-13,35
St Mirren,8476,10,6,12,18,35,58,-23,30
Hibernian,8477,1,20,10,6,56,27,29,70
Dundee Utd,8477,2,18,9,9,55,41,14,63
Morton,8477,3,17,11,8,50,38,12,62
Falkirk,8477,4,17,10,9,65,41,24,61
Queen of S't,8477,5,12,8,16,49,60,-11,44
Dunfermline,8477,6,10,13,13,47,47,0,43
Dumbarton,8477,7,9,11,16,51,64,-13,38
Ayr,8477,8,9,10,17,34,55,-21,37
St Mirren,8477,9,9,9,18,41,58,-17,36
Raith,8477,10,9,9,18,35,52,-17,36
Hibernian,8478,1,18,12,6,57,31,26,66
Morton,8478,2,16,12,8,50,35,15,60
Falkirk,8478,3,16,10,10,64,46,18,58
Dundee Utd,8478,4,16,10,10,54,43,11,58
Raith,8478,5,12,10,14,36,45,-9,46
Queen of S't,8478,6,12,9,15,52,56,-4,45
Ayr,8478,7,10,12,14,40,54,-14,42
Dunfermline,8478,8,9,14,13,40,44,-4,41
St Mirren,8478,9,9,9,18,39,60,-21,36
Dumbarton,8478,10,7,12,17,47,65,-18,33
Hibernian,8479,1,18,11,7,53,30,23,65
Falkirk,8479,2,18,10,8,61,36,25,64
Morton,8479,3,17,12,7,55,38,17,63
Dundee Utd,8479,4,16,9,11,53,44,9,57
Queen of S't,8479,5,13,8,15,52,53,-1,47
Dunfermline,8479,6,10,14,12,50,51,-1,44
Ayr,8479,7,11,11,14,42,57,-15,44
Dumbarton,8479,8,9,10,17,49,62,-13,37
Raith,8479,9,9,8,19,35,57,-22,35
St Mirren,8479,10,8,9,19,38,60,-22,33
Hibernian,8480,1,18,13,5,55,26,29,67
Falkirk,8480,2,18,10,8,64,40,24,64
Morton,8480,3,15,11,10,44,38,6,56
Dundee Utd,8480,4,16,8,12,48,43,5,56
Queen of S't,8480,5,13,10,13,48,46,2,49
Dunfermline,8480,6,10,13,13,50,50,0,43
Raith,8480,7,10,10,16,36,50,-14,40
Ayr,8480,8,9,12,15,35,53,-18,39
St Mirren,8480,9,9,10,17,44,60,-16,37
Dumbarton,8480,10,8,11,17,45,63,-18,35
Dundee Utd,8481,1,19,9,8,55,36,19,66
Hibernian,8481,2,18,11,7,61,34,27,65
Morton,8481,3,16,12,8,53,41,12,60
Falkirk,8481,4,13,12,11,53,44,9,51
Dunfermline,8481,5,11,13,12,53,51,2,46
Queen of S't,8481,6,11,11,14,48,52,-4,44
Raith,8481,7,11,10,15,40,50,-10,43
Dumbarton,8481,8,9,12,15,50,59,-9,39
Ayr,8481,9,8,13,15,34,59,-25,37
St Mirren,8481,10,8,9,19,40,61,-21,33
Hibernian,8482,1,19,13,4,54,27,27,70
Morton,8482,2,18,11,7,55,36,19,65
Dundee Utd,8482,3,16,10,10,54,39,15,58
Falkirk,8482,4,15,12,9,57,39,18,57
Raith,8482,5,11,10,15,38,50,-12,43
Queen of S't,8482,6,11,9,16,45,50,-5,42
Dunfermline,8482,7,9,12,15,43,49,-6,39
Dumbarton,8482,8,8,13,15,44,58,-14,37
St Mirren,8482,9,9,10,17,38,56,-18,37
Ayr,8482,10,9,10,17,35,59,-24,37
Hibernian,8483,1,20,12,4,51,21,30,72
Morton,8483,2,19,11,6,57,31,26,68
Falkirk,8483,3,18,11,7,59,35,24,65
Dundee Utd,8483,4,16,9,11,50,42,8,57
Queen of S't,8483,5,12,8,16,48,49,-1,44
Dunfermline,8483,6,9,13,14,42,49,-7,40
St Mirren,8483,7,9,10,17,40,59,-19,37
Ayr,8483,8,9,10,17,35,59,-24,37
Raith,8483,9,9,9,18,33,51,-18,36
Dumbarton,8483,10,7,11,18,44,63,-19,32
Hibernian,8484,1,18,12,6,53,29,24,66
Falkirk,8484,2,17,12,7,62,39,23,63
Dundee Utd,8484,3,16,11,9,51,39,12,59
Morton,8484,4,15,10,11,48,37,11,55
Queen of S't,8484,5,12,11,13,47,47,0,47
Dunfermline,8484,6,10,13,13,44,49,-5,43
Dumbarton,8484,7,9,12,15,47,59,-12,39
St Mirren,8484,8,9,11,16,41,51,-10,38
Raith,8484,9,9,11,16,36,50,-14,38
Ayr,8484,10,7,13,16,29,58,-29,34
Hibernian,8485,1,23,10,3,64,24,40,79
Morton,8485,2,16,11,9,49,41,8,59
Falkirk,8485,3,15,12,9,59,41,18,57
Dundee Utd,8485,4,16,9,11,51,39,12,57
Dumbarton,8485,5,11,12,13,51,53,-2,45
Dunfermline,8485,6,10,12,14,46,50,-4,42
Raith,8485,7,11,9,16,34,48,-14,42
Queen of S't,8485,8,10,10,16,45,55,-10,40
Ayr,8485,9,8,12,16,32,56,-24,36
St Mirren,8485,10,7,9,20,36,60,-24,30
Hibernian,8486,1,21,11,4,63,25,38,74
Morton,8486,2,17,11,8,48,33,15,62
Falkirk,8486,3,17,9,10,62,45,17,60
Dundee Utd,8486,4,16,9,11,55,43,12,57
Queen of S't,8486,5,13,8,15,51,53,-2,47
Dunfermline,8486,6,9,14,13,43,50,-7,41
Dumbarton,8486,7,10,11,15,48,57,-9,41
Raith,8486,8,10,8,18,33,54,-21,38
St Mirren,8486,9,9,9,18,40,58,-18,36
Ayr,8486,10,7,12,17,34,59,-25,33
Morton,8487,1,21,9,6,60,35,25,72
Hibernian,8487,2,18,10,8,55,30,25,64
Falkirk,8487,3,18,10,8,62,39,23,64
Dundee Utd,8487,4,13,10,13,49,48,1,49
Ayr,8487,5,12,10,14,38,52,-14,46
Dunfermline,8487,6,10,12,14,45,47,-2,42
Raith,8487,7,11,9,16,35,48,-13,42
Queen of S't,8487,8,11,8,17,43,55,-12,41
Dumbarton,8487,9,8,12,16,48,64,-16,36
St Mirren,8487,10,8,10,18,45,62,-17,34
Hibernian,8488,1,19,12,5,57,25,32,69
Morton,8488,2,19,10,7,55,36,19,67
Falkirk,8488,3,17,9,10,57,41,16,60
Dundee Utd,8488,4,17,9,10,53,40,13,60
Dunfermline,8488,5,11,13,12,51,49,2,46
Queen of S't,8488,6,11,10,15,48,53,-5,43
Dumbarton,8488,7,8,13,15,45,61,-16,37
Ayr,8488,8,9,10,17,32,60,-28,37
St Mirren,8488,9,9,9,18,46,58,-12,36
Raith,8488,10,8,9,19,33,54,-21,33
Morton,8489,1,18,10,8,49,35,14,64
Hibernian,8489,2,17,12,7,54,31,23,63
Falkirk,8489,3,16,10,10,57,42,15,58
Dundee Utd,8489,4,15,10,11,51,42,9,55
Queen of S't,8489,5,12,9,15,47,51,-4,45
Dunfermline,8489,6,10,13,13,43,46,-3,43
Raith,8489,7,11,10,15,41,49,-8,43
Dumbarton,8489,8,10,11,15,47,56,-9,41
St Mirren,8489,9,10,10,16,40,54,-14,40
Ayr,8489,10,7,13,16,36,59,-23,34
Hibernian,8490,1,21,11,4,56,23,33,74
Falkirk,8490,2,17,11,8,64,38,26,62
Morton,8490,3,16,12,8,54,40,14,60
Dundee Utd,8490,4,16,9,11,51,44,7,57
Queen of S't,8490,5,11,10,15,45,50,-5,43
Dunfermline,8490,6,10,12,14,44,53,-9,42
Ayr,8490,7,10,10,16,38,52,-14,40
St Mirren,8490,8,9,10,17,40,59,-19,37
Raith,8490,9,8,12,16,34,50,-16,36
Dumbarton,8490,10,8,11,17,48,65,-17,35
Hibernian,8491,1,20,12,4,54,23,31,72
Dundee Utd,8491,2,18,10,8,53,35,18,64
Morton,8491,3,15,11,10,46,37,9,56
Falkirk,8491,4,14,13,9,53,41,12,55
Queen of S't,8491,5,11,11,14,46,51,-5,44
Dunfermline,8491,6,9,15,12,44,44,0,42
Raith,8491,7,9,14,13,35,45,-10,41
Dumbarton,8491,8,9,10,17,48,61,-13,37
Ayr,8491,9,8,12,16,34,54,-20,36
St Mirren,8491,10,7,12,17,37,59,-22,33
Hibernian,8492,1,17,13,6,56,31,25,64
Falkirk,8492,2,16,13,7,62,42,20,61
Morton,8492,3,16,13,7,45,33,12,61
Dundee Utd,8492,4,16,12,8,50,37,13,60
Queen of S't,8492,5,11,13,12,45,47,-2,46
Dumbarton,8492,6,10,13,13,46,52,-6,43
Ayr,8492,7,9,12,15,36,51,-15,39
Raith,8492,8,9,11,16,38,51,-13,38
Dunfermline,8492,9,8,12,16,40,54,-14,36
St Mirren,8492,10,6,12,18,39,59,-20,30
Hibernian,8493,1,18,13,5,54,27,27,67
Dundee Utd,8493,2,17,10,9,57,41,16,61
Falkirk,8493,3,15,12,9,56,38,18,57
Morton,8493,4,15,12,9,51,44,7,57
Dunfermline,8493,5,11,13,12,52,47,5,46
Raith,8493,6,11,11,14,39,50,-11,44
Queen of S't,8493,7,10,11,15,43,54,-11,41
St Mirren,8493,8,10,11,15,40,52,-12,41
Dumbarton,8493,9,9,11,16,48,60,-12,38
Ayr,8493,10,6,12,18,34,61,-27,30
Hibernian,8494,1,17,13,6,52,30,22,64
Morton,8494,2,18,9,9,51,44,7,63
Falkirk,8494,3,15,11,10,59,43,16,56
Dundee Utd,8494,4,15,11,10,52,40,12,56
Dunfermline,8494,5,12,12,12,51,45,6,48
Queen of S't,8494,6,12,9,15,45,51,-6,45
Dumbarton,8494,7,10,11,15,49,57,-8,41
Raith,8494,8,10,11,15,35,47,-12,41
Ayr,8494,9,8,12,16,36,55,-19,36
St Mirren,8494,10,8,11,17,41,59,-18,35
Hibernian,8495,1,18,12,6,53,27,26,66
Morton,8495,2,17,11,8,52,41,11,62
Dundee Utd,8495,3,16,10,10,49,39,10,58
Falkirk,8495,4,15,10,11,57,44,13,55
Queen of S't,8495,5,15,9,12,53,47,6,54
Dunfermline,8495,6,11,12,13,47,49,-2,45
Ayr,8495,7,9,13,14,34,54,-20,40
St Mirren,8495,8,8,12,16,43,53,-10,36
Raith,8495,9,8,12,16,40,55,-15,36
Dumbarton,8495,10,7,11,18,43,62,-19,32
Hibernian,8496,1,17,12,7,56,33,23,63
Falkirk,8496,2,17,10,9,58,37,21,61
Morton,8496,3,16,11,9,50,40,10,59
Dundee Utd,8496,4,14,12,10,50,42,8,54
Raith,8496,5,13,8,15,37,46,-9,47
Queen of S't,8496,6,12,10,14,46,49,-3,46
Dunfermline,8496,7,10,13,13,48,51,-3,43
Ayr,8496,8,9,13,14,38,56,-18,40
Dumbarton,8496,9,8,13,15,50,62,-12,37
St Mirren,8496,10,8,10,18,40,57,-17,34
Morton,8497,1,19,10,7,59,38,21,67
Hibernian,8497,2,18,11,7,52,27,25,65
Dundee Utd,8497,3,17,9,10,53,37,16,60
Falkirk,8497,4,15,9,12,56,46,10,54
Queen of S't,8497,5,13,10,13,48,47,1,49
Dumbarton,8497,6,10,11,15,46,57,-11,41
Raith,8497,7,11,8,17,33,49,-16,41
Ayr,8497,8,9,12,15,32,53,-21,39
Dunfermline,8497,9,8,14,14,44,51,-7,38
St Mirren,8497,10,8,10,18,40,58,-18,34
Hibernian,8498,1,18,14,4,58,29,29,68
Morton,8498,2,18,11,7,50,32,18,65
Dundee Utd,8498,3,18,8,10,54,37,17,62
Falkirk,8498,4,17,9,10,58,44,14,60
Queen of S't,8498,5,13,8,15,44,45,-1,47
Dunfermline,8498,6,10,13,13,48,52,-4,43
Raith,8498,7,11,8,17,37,49,-12,41
Dumbarton,8498,8,9,12,15,47,59,-12,39
St Mirren,8498,9,8,9,19,39,62,-23,33
Ayr,8498,10,6,12,18,31,57,-26,30
Hibernian,8499,1,20,12,4,55,26,29,72
Morton,8499,2,18,11,7,57,38,19,65
Dundee Utd,8499,3,17,9,10,54,41,13,60
Falkirk,8499,4,15,13,8,55,37,18,58
Queen of S't,8499,5,11,10,15,43,48,-5,43
St Mirren,8499,6,9,12,15,44,57,-13,39
Raith,8499,7,10,9,17,33,52,-19,39
Dunfermline,8499,8,8,14,14,44,52,-8,38
Dumbarton,8499,9,9,11,16,48,58,-10,38
Ayr,8499,10,7,11,18,35,59,-24,32
Hibernian,8500,1,20,11,5,56,23,33,71
Dundee Utd,8500,2,19,8,9,57,40,17,65
Morton,8500,3,17,12,7,54,39,15,63
Falkirk,8500,4,17,11,8,62,38,24,62
Raith,8500,5,11,11,14,39,49,-10,44
Queen of S't,8500,6,11,9,16,43,54,-11,42
Dunfermline,8500,7,8,14,14,43,51,-8,38
Dumbarton,8500,8,8,12,16,43,57,-14,36
St Mirren,8500,9,7,11,18,41,59,-18,32
Ayr,8500,10,7,11,18,32,60,-28,32
Hibernian,8501,1,19,11,6,59,27,32,68
Morton,8501,2,18,10,8,50,33,17,64
Falkirk,8501,3,17,10,9,57,37,20,61
Dundee Utd,8501,4,16,9,11,46,37,9,57
Dunfermline,8501,5,12,12,12,47,45,2,48
Queen of S't,8501,6,11,8,17,42,53,-11,41
St Mirren,8501,7,10,11,15,41,53,-12,41
Raith,8501,8,10,9,17,33,54,-21,39
Dumbarton,8501,9,8,11,17,44,57,-13,35
Ayr,8501,10,8,11,17,37,60,-23,35
Hibernian,8502,1,22,10,4,63,25,38,76
Morton,8502,2,17,12,7,53,35,18,63
Falkirk,8502,3,16,10,10,62,44,18,58
Dundee Utd,8502,4,15,11,10,50,42,8,56
Raith,8502,5,12,10,14,39,46,-7,46
Queen of S't,8502,6,10,10,16,43,55,-12,40
Dumbarton,8502,7,9,11,16,49,63,-14,38
Dunfermline,8502,8,8,13,15,45,53,-8,37
Ayr,8502,9,8,12,16,33,54,-21,36
St Mirren,8502,10,8,11,17,39,59,-20,35
Hibernian,8503,1,20,12,4,60,23,37,72
Morton,8503,2,18,10,8,61,40,21,64
Dundee Utd,8503,3,18,8,10,56,40,16,62
Falkirk,8503,4,13,11,12,53,44,9,50
Queen of S't,8503,5,12,9,15,48,55,-7,45
Dumbarton,8503,6,10,11,15,47,55,-8,41
Raith,8503,7,10,11,15,37,50,-13,41
Dunfermline,8503,8,9,13,14,47,57,-10,40
St Mirren,8503,9,9,10,17,38,55,-17,37
Ayr,8503,10,8,11,17,35,63,-28,35
Hibernian,8504,1,20,12,4,60,26,34,72
Morton,8504,2,17,11,8,51,36,15,62
Falkirk,8504,3,15,13,8,56,37,19,58
Dundee Utd,8504,4,16,9,11,51,39,12,57
Dunfermline,8504,5,10,13,13,43,51,-8,43
Queen of S't,8504,6,11,9,16,44,53,-9,42
Raith,8504,7,11,9,16,37,47,-10,42
Ayr,8504,8,10,10,16,36,57,-21,40
Dumbarton,8504,9,9,11,16,46,58,-12,38
St Mirren,8504,10,8,9,19,40,60,-20,33
Hibernian,8505,1,17,13,6,49,27,22,64
Morton,8505,2,16,11,9,49,39,10,59
Dundee Utd,8505,3,15,11,10,50,38,12,56
Falkirk,8505,4,15,10,11,56,44,12,55
Queen of S't,8505,5,12,11,13,48,53,-5,47
Raith,8505,6,12,10,14,39,46,-7,46
Dumbarton,8505,7,11,10,15,56,56,0,43
Dunfermline,8505,8,10,13,13,47,55,-8,43
Ayr,8505,9,7,15,14,29,49,-20,36
St Mirren,8505,10,8,10,18,38,54,-16,34
Hibernian,8506,1,19,11,6,56,29,27,68
Morton,8506,2,19,11,6,57,35,22,68
Falkirk,8506,3,16,10,10,57,40,17,58
Dundee Utd,8506,4,16,9,11,57,47,10,57
Queen of S't,8506,5,12,9,15,46,52,-6,45
Dumbarton,8506,6,10,11,15,51,62,-11,41
Raith,8506,7,9,13,14,31,44,-13,40
Ayr,8506,8,9,13,14,42,59,-17,40
Dunfermline,8506,9,8,12,16,45,54,-9,36
St Mirren,8506,10,7,11,18,41,61,-20,32
Hibernian,8507,1,20,12,4,54,23,31,72
Morton,8507,2,17,12,7,49,32,17,63
Dundee Utd,8507,3,16,10,10,50,40,10,58
Falkirk,8507,4,15,10,11,56,45,11,55
Queen of S't,8507,5,13,8,15,47,50,-3,47
Dumbarton,8507,6,9,13,14,49,55,-6,40
Raith,8507,7,10,9,17,33,50,-17,39
Dunfermline,8507,8,8,14,14,43,51,-8,38
St Mirren,8507,9,9,10,17,41,55,-14,37
Ayr,8507,10,8,12,16,32,53,-21,36
Hibernian,8508,1,21,10,5,55,24,31,73
Falkirk,8508,2,17,12,7,60,37,23,63
Morton,8508,3,17,10,9,52,36,16,61
Dundee Utd,8508,4,16,10,10,48,41,7,58
Dumbarton,8508,5,10,12,14,49,58,-9,42
Queen of S't,8508,6,10,11,15,41,53,-12,41
Raith,8508,7,10,10,16,36,46,-10,40
Dunfermline,8508,8,9,12,15,42,48,-6,39
Ayr,8508,9,8,11,17,34,55,-21,35
St Mirren,8508,10,8,10,18,37,56,-19,34
Hibernian,8509,1,20,11,5,55,24,31,71
Morton,8509,2,19,12,5,55,34,21,69
Falkirk,8509,3,18,10,8,61,40,21,64
Dundee Utd,8509,4,16,8,12,51,42,9,56
Dunfermline,8509,5,9,14,13,47,51,-4,41
Raith,8509,6,10,11,15,38,49,-11,41
Queen of S't,8509,7,10,10,16,41,51,-10,40
Dumbarton,8509,8,8,11,17,48,63,-15,35
Ayr,8509,9,8,11,17,32,54,-22,35
St Mirren,8509,10,8,10,18,40,60,-20,34
Hibernian,8510,1,20,12,4,54,23,31,72
Falkirk,8510,2,17,10,9,63,39,24,61
Morton,8510,3,15,12,9,47,40,7,57
Dundee Utd,8510,4,15,11,10,49,39,10,56
Queen of S't,8510,5,11,9,16,43,49,-6,42
Dunfermline,8510,6,9,14,13,48,51,-3,41
St Mirren,8510,7,9,12,15,39,51,-12,39
Dumbarton,8510,8,9,12,15,48,63,-15,39
Ayr,8510,9,9,12,15,34,51,-17,39
Raith,8510,10,10,8,18,35,54,-19,38
Hibernian,8511,1,20,11,5,59,25,34,71
Morton,8511,2,16,12,8,49,40,9,60
Dundee Utd,8511,3,16,11,9,53,39,14,59
Falkirk,8511,4,15,10,11,58,45,13,55
Dunfermline,8511,5,12,13,11,49,44,5,49
Queen of S't,8511,6,13,9,14,48,48,0,48
Raith,8511,7,10,11,15,38,47,-9,41
Dumbarton,8511,8,9,10,17,45,63,-18,37
Ayr,8511,9,8,12,16,37,56,-19,36
St Mirren,8511,10,7,9,20,35,64,-29,30
Hibernian,8512,1,20,12,4,62,28,34,72
Morton,8512,2,18,11,7,54,37,17,65
Dundee Utd,8512,3,17,10,9,57,39,18,61
Falkirk,8512,4,16,10,10,61,43,18,58
Dumbarton,8512,5,11,12,13,47,51,-4,45
Queen of S't,8512,6,11,9,16,42,55,-13,42
Dunfermline,8512,7,8,13,15,45,51,-6,37
Raith,8512,8,9,10,17,32,52,-20,37
Ayr,8512,9,7,15,14,34,53,-19,36
St Mirren,8512,10,7,10,19,35,60,-25,31
Hibernian,8513,1,19,11,6,55,29,26,68
Morton,8513,2,17,11,8,54,36,18,62
Falkirk,8513,3,16,11,9,60,42,18,59
Dundee Utd,8513,4,15,9,12,51,47,4,54
Queen of S't,8513,5,12,11,13,46,45,1,47
Raith,8513,6,12,9,15,35,46,-11,45
St Mirren,8513,7,10,10,16,43,53,-10,40
Dumbarton,8513,8,9,12,15,44,58,-14,39
Dunfermline,8513,9,8,14,14,48,55,-7,38
Ayr,8513,10,8,10,18,34,59,-25,34
Hibernian,8514,1,19,11,6,52,24,28,68
Morton,8514,2,19,9,8,58,39,19,66
Falkirk,8514,3,17,11,8,62,38,24,62
Dundee Utd,8514,4,13,12,11,46,39,7,51
Dunfermline,8514,5,10,14,12,45,49,-4,44
Raith,8514,6,11,11,14,40,46,-6,44
Queen of S't,8514,7,11,11,14,42,50,-8,44
St Mirren,8514,8,8,12,16,39,55,-16,36
Ayr,8514,9,8,11,17,32,57,-25,35
Dumbarton,8514,10,7,12,17,44,63,-19,33
Hibernian,8515,1,20,12,4,57,24,33,72
Dundee Utd,8515,2,19,9,8,54,35,19,66
Morton,8515,3,14,12,10,47,41,6,54
Falkirk,8515,4,14,10,12,53,45,8,52
Dunfermline,8515,5,12,13,11,50,45,5,49
Queen of S't,8515,6,12,10,14,51,51,0,46
St Mirren,8515,7,9,11,16,41,53,-12,38
Ayr,8515,8,8,13,15,38,56,-18,37
Dumbarton,8515,9,8,12,16,50,64,-14,36
Raith,8515,10,9,8,19,31,58,-27,35
Hibernian,8516,1,19,14,3,56,23,33,71
Dundee Utd,8516,2,17,9,10,52,39,13,60
Morton,8516,3,16,12,8,47,34,13,60
Falkirk,8516,4,16,10,10,57,43,14,58
Queen of S't,8516,5,11,10,15,45,53,-8,43
Ayr,8516,6,10,12,14,37,53,-16,42
Dunfermline,8516,7,9,12,15,47,56,-9,39
Dumbarton,8516,8,9,11,16,47,57,-10,38
St Mirren,8516,9,9,11,16,47,60,-13,38
Raith,8516,10,8,11,17,37,54,-17,35
Hibernian,8517,1,20,12,4,56,24,32,72
Falkirk,8517,2,16,9,11,62,38,24,57
Dundee Utd,8517,3,16,9,11,48,42,6,57
Morton,8517,4,14,14,8,48,39,9,56
Queen of S't,8517,5,13,8,15,47,55,-8,47
Dunfermline,8517,6,11,13,12,47,45,2,46
Dumbarton,8517,7,10,11,15,48,55,-7,41
Raith,8517,8,10,10,16,34,47,-13,40
Ayr,8517,9,9,10,17,33,56,-23,37
St Mirren,8517,10,7,12,17,38,60,-22,33
Hibernian,8518,1,18,14,4,55,22,33,68
Dundee Utd,8518,2,17,8,11,55,38,17,59
Morton,8518,3,15,12,9,47,38,9,57
Falkirk,8518,4,15,11,10,55,42,13,56
Dumbarton,8518,5,11,11,14,48,57,-9,44
Dunfermline,8518,6,9,16,11,47,47,0,43
Queen of S't,8518,7,11,10,15,41,49,-8,43
Raith,8518,8,10,11,15,35,44,-9,41
Ayr,8518,9,9,12,15,35,57,-22,39
St Mirren,8518,10,6,13,17,35,59,-24,31
Hibernian,8519,1,20,13,3,61,25,36,73
Morton,8519,2,16,12,8,53,38,15,60
Dundee Utd,8519,3,17,9,10,49,35,14,60
Falkirk,8519,4,16,10,10,57,42,15,58
Queen of S't,8519,5,12,9,15,48,55,-7,45
Dumbarton,8519,6,9,13,14,48,55,-7,40
Dunfermline,8519,7,9,13,14,46,54,-8,40
Raith,8519,8,10,9,17,34,49,-15,39
Ayr,8519,9,8,13,15,35,55,-20,37
St Mirren,8519,10,7,11,18,40,63,-23,32
Hibernian,8520,1,17,12,7,53,34,19,63
Falkirk,8520,2,17,11,8,58,40,18,62
Morton,8520,3,16,11,9,51,35,16,59
Dundee Utd,8520,4,15,11,10,47,44,3,56
Queen of S't,8520,5,13,10,13,47,49,-2,49
Dunfermline,8520,6,12,12,12,58,46,12,48
Raith,8520,7,11,8,17,38,52,-14,41
St Mirren,8520,8,10,10,16,48,59,-11,40
Ayr,8520,9,9,11,16,33,55,-22,38
Dumbarton,8520,10,7,10,19,43,62,-19,31
Hibernian,8521,1,19,11,6,55,27,28,68
Falkirk,8521,2,16,12,8,57,39,18,60
Dundee Utd,8521,3,16,11,9,49,38,11,59
Morton,8521,4,16,9,11,52,41,11,57
Queen of S't,8521,5,11,11,14,47,52,-5,44
Raith,8521,6,10,12,14,34,45,-11,42
Dunfermline,8521,7,10,11,15,44,50,-6,41
Dumbarton,8521,8,10,11,15,45,55,-10,41
Ayr,8521,9,9,12,15,34,53,-19,39
St Mirren,8521,10,8,10,18,43,60,-17,34
Hibernian,8522,1,17,13,6,51,27,24,64
Morton,8522,2,17,12,7,51,39,12,63
Falkirk,8522,3,16,10,10,57,42,15,58
Dundee Utd,8522,4,16,10,10,57,45,12,58
Queen of S't,8522,5,12,9,15,44,52,-8,45
Dunfermline,8522,6,9,15,12,51,52,-1,42
Dumbarton,8522,7,10,12,14,54,60,-6,42
St Mirren,8522,8,10,10,16,39,51,-12,40
Raith,8522,9,10,8,18,36,51,-15,38
Ayr,8522,10,8,11,17,39,60,-21,35
Hibernian,8523,1,22,10,4,59,21,38,76
Dundee Utd,8523,2,16,10,10,50,42,8,58
Falkirk,8523,3,16,9,11,59,38,21,57
Morton,8523,4,15,11,10,46,40,6,56
Queen of S't,8523,5,12,10,14,53,53,0,46
Dunfermline,8523,6,10,14,12,49,48,1,44
Raith,8523,7,10,10,16,36,49,-13,40
St Mirren,8523,8,10,9,17,41,59,-18,39
Dumbarton,8523,9,8,11,17,43,64,-21,35
Ayr,8523,10,7,14,15,33,55,-22,35
Hibernian,8524,1,18,12,6,54,28,26,66
Dundee Utd,8524,2,18,9,9,54,40,14,63
Falkirk,8524,3,17,10,9,60,43,17,61
Morton,8524,4,15,11,10,46,41,5,56
Dunfermline,8524,5,11,13,12,49,45,4,46
Queen of S't,8524,6,12,8,16,52,56,-4,44
Dumbarton,8524,7,10,10,16,48,58,-10,40
Raith,8524,8,10,9,17,38,51,-13,39
St Mirren,8524,9,8,12,16,39,57,-18,36
Ayr,8524,10,8,12,16,34,55,-21,36
Hibernian,8525,1,21,11,4,57,27,30,74
Morton,8525,2,18,11,7,52,32,20,65
Falkirk,8525,3,16,11,9,60,44,16,59
Dundee Utd,8525,4,15,11,10,48,38,10,56
Queen of S't,8525,5,13,9,14,51,52,-1,48
Dunfermline,8525,6,10,12,14,46,51,-5,42
Raith,8525,7,9,10,17,33,49,-16,37
St Mirren,8525,8,8,12,16,36,51,-15,36
Dumbarton,8525,9,8,11,17,41,54,-13,35
Ayr,8525,10,8,10,18,31,57,-26,34
Hibernian,8526,1,19,12,5,56,27,29,69
Falkirk,8526,2,18,11,7,62,36,26,65
Dundee Utd,8526,3,17,9,10,54,42,12,60
Morton,8526,4,15,13,8,46,36,10,58
Raith,8526,5,12,9,15,42,47,-5,45
Queen of S't,8526,6,10,11,15,45,52,-7,41
St Mirren,8526,7,9,11,16,43,58,-15,38
Dunfermline,8526,8,8,13,15,45,57,-12,37
Dumbarton,8526,9,8,12,16,47,63,-16,36
Ayr,8526,10,7,13,16,33,55,-22,34
Hibernian,8527,1,19,11,6,53,25,28,68
Morton,8527,2,17,11,8,50,39,11,62
Dundee Utd,8527,3,17,8,11,58,46,12,59
Falkirk,8527,4,16,10,10,60,46,14,58
Dunfermline,8527,5,11,13,12,51,48,3,46
Queen of S't,8527,6,10,12,14,49,55,-6,42
St Mirren,8527,7,10,10,16,40,56,-16,40
Raith,8527,8,10,9,17,36,51,-15,39
Dumbarton,8527,9,8,12,16,51,63,-12,36
Ayr,8527,10,8,12,16,35,54,-19,36
Hibernian,8528,1,19,12,5,57,29,28,69
Dundee Utd,8528,2,19,8,9,58,38,20,65
Morton,8528,3,18,10,8,57,39,18,64
Falkirk,8528,4,16,9,11,54,42,12,57
Queen of S't,8528,5,12,8,16,47,55,-8,44
Dunfermline,8528,6,10,13,13,50,53,-3,43
Dumbarton,8528,7,10,10,16,50,60,-10,40
Ayr,8528,8,9,10,17,38,63,-25,37
St Mirren,8528,9,9,9,18,43,57,-14,36
Raith,8528,10,8,11,17,33,51,-18,35
Hibernian,8529,1,19,14,3,57,24,33,71
Morton,8529,2,17,10,9,48,36,12,61
Dundee Utd,8529,3,17,9,10,54,36,18,60
Falkirk,8529,4,14,11,11,57,48,9,53
Queen of S't,8529,5,13,11,12,50,50,0,50
Raith,8529,6,12,9,15,40,49,-9,45
Dunfermline,8529,7,9,13,14,43,48,-5,40
Dumbarton,8529,8,9,11,16,48,63,-15,38
Ayr,8529,9,7,13,16,35,59,-24,34
St Mirren,8529,10,8,9,19,39,58,-19,33
Hibernian,8530,1,20,12,4,54,23,31,72
Falkirk,8530,2,18,9,9,58,37,21,63
Morton,8530,3,16,12,8,52,39,13,60
Dundee Utd,8530,4,16,11,9,53,40,13,59
Queen of S't,8530,5,11,11,14,47,52,-5,44
Dunfermline,8530,6,8,14,14,39,45,-6,38
Raith,8530,7,9,11,16,36,49,-13,38
St Mirren,8530,8,9,10,17,38,56,-18,37
Ayr,8530,9,8,13,15,33,54,-21,37
Dumbarton,8530,10,8,11,17,46,61,-15,35
Hibernian,8531,1,19,12,5,56,26,30,69
Morton,8531,2,18,10,8,47,32,15,64
Dundee Utd,8531,3,16,11,9,50,37,13,59
Falkirk,8531,4,15,12,9,57,41,16,57
Dunfermline,8531,5,12,12,12,49,46,3,48
Queen of S't,8531,6,11,11,14,45,50,-5,44
Raith,8531,7,11,10,15,35,47,-12,43
Dumbarton,8531,8,8,13,15,46,58,-12,37
Ayr,8531,9,6,14,16,31,54,-23,32
St Mirren,8531,10,6,11,19,34,59,-25,29
Hibernian,8532,1,19,12,5,61,29,32,69
Morton,8532,2,18,10,8,54,42,12,64
Falkirk,8532,3,15,13,8,59,41,18,58
Dundee Utd,8532,4,15,11,10,51,41,10,56
Queen of S't,8532,5,12,10,14,46,51,-5,46
Dumbarton,8532,6,10,12,14,51,60,-9,42
Dunfermline,8532,7,9,14,13,44,48,-4,41
Ayr,8532,8,10,11,15,40,53,-13,41
Raith,8532,9,8,12,16,33,48,-15,36
St Mirren,8532,10,6,11,19,37,63,-26,29
Hibernian,8533,1,20,11,5,57,23,34,71
Dundee Utd,8533,2,17,10,9,51,35,16,61
Morton,8533,3,16,11,9,45,36,9,59
Falkirk,8533,4,15,10,11,55,47,8,55
Raith,8533,5,13,8,15,40,48,-8,47
Ayr,8533,6,10,12,14,39,56,-17,42
Dunfermline,8533,7,10,11,15,42,48,-6,41
Queen of S't,8533,8,10,9,17,40,51,-11,39
Dumbarton,8533,9,9,11,16,46,56,-10,38
St Mirren,8533,10,8,11,17,39,54,-15,35
Falkirk,8534,1,19,10,7,59,34,25,67
Hibernian,8534,2,18,12,6,54,31,23,66
Morton,8534,3,16,12,8,52,37,15,60
Dundee Utd,8534,4,15,10,11,47,37,10,55
Queen of S't,8534,5,12,8,16,46,53,-7,44
Raith,8534,6,11,9,16,37,51,-14,42
Dumbarton,8534,7,10,11,15,44,54,-10,41
Ayr,8534,8,10,10,16,34,54,-20,40
Dunfermline,8534,9,9,12,15,50,54,-4,39
St Mirren,8534,10,8,10,18,37,55,-18,34
Hibernian,8535,1,17,15,4,54,25,29,66
Morton,8535,2,18,11,7,51,36,15,65
Falkirk,8535,3,17,10,9,56,38,18,61
Dundee Utd,8535,4,16,10,10,53,41,12,58
Dunfermline,8535,5,10,14,12,50,50,0,44
Queen of S't,8535,6,11,10,15,42,48,-6,43
Raith,8535,7,10,10,16,32,46,-14,40
St Mirren,8535,8,9,9,18,40,58,-18,36
Dumbarton,8535,9,8,11,17,47,62,-15,35
Ayr,8535,10,7,14,15,32,53,-21,35
Hibernian,8536,1,19,11,6,55,25,30,68
Morton,8536,2,18,12,6,51,31,20,66
Falkirk,8536,3,16,11,9,59,40,19,59
Dundee Utd,8536,4,16,11,9,51,38,13,59
Raith,8536,5,11,11,14,35,44,-9,44
Dunfermline,8536,6,10,12,14,44,48,-4,42
Queen of S't,8536,7,10,8,18,39,55,-16,38
St Mirren,8536,8,8,13,15,40,54,-14,37
Dumbarton,8536,9,9,10,17,45,60,-15,37
Ayr,8536,10,8,11,17,34,58,-24,35
Hibernian,8537,1,19,12,5,55,28,27,69
Dundee Utd,8537,2,17,11,8,57,37,20,62
Morton,8537,3,15,14,7,50,36,14,59
Falkirk,8537,4,16,10,10,59,43,16,58
Dunfermline,8537,5,10,14,12,47,51,-4,44
Queen of S't,8537,6,10,11,15,43,51,-8,41
Raith,8537,7,10,10,16,35,49,-14,40
St Mirren,8537,8,9,11,16,42,58,-16,38
Ayr,8537,9,8,12,16,32,55,-23,36
Dumbarton,8537,10,7,13,16,45,57,-12,34
Hibernian,8538,1,21,11,4,54,22,32,74
Falkirk,8538,2,17,10,9,64,42,22,61
Dundee Utd,8538,3,16,10,10,53,38,15,58
Morton,8538,4,16,10,10,48,40,8,58
Dunfermline,8538,5,11,13,12,45,45,0,46
Raith,8538,6,11,9,16,36,47,-11,42
Queen of S't,8538,7,10,10,16,44,56,-12,40
Dumbarton,8538,8,9,12,15,49,56,-7,39
Ayr,8538,9,8,12,16,34,58,-24,36
St Mirren,8538,10,7,11,18,34,57,-23,32
Hibernian,8539,1,20,12,4,57,26,31,72
Morton,8539,2,17,10,9,47,37,10,61
Falkirk,8539,3,16,10,10,58,37,21,58
Dundee Utd,8539,4,16,9,11,50,40,10,57
Queen of S't,8539,5,13,8,15,49,54,-5,47
Dunfermline,8539,6,10,13,13,44,47,-3,43
Raith,8539,7,10,9,17,35,49,-14,39
Ayr,8539,8,9,12,15,36,54,-18,39
Dumbarton,8539,9,9,11,16,50,64,-14,38
St Mirren,8539,10,7,12,17,39,57,-18,33
Hibernian,8540,1,20,11,5,54,23,31,71
Morton,8540,2,19,11,6,54,34,20,68
Falkirk,8540,3,15,10,11,57,46,11,55
Dundee Utd,8540,4,14,10,12,50,44,6,52
Dumbarton,8540,5,11,12,13,52,57,-5,45
Dunfermline,8540,6,11,11,14,48,49,-1,44
Queen of S't,8540,7,11,10,15,48,53,-5,43
St Mirren,8540,8,10,9,17,48,56,-8,39
Raith,8540,9,10,9,17,34,55,-21,39
Ayr,8540,10,7,11,18,34,62,-28,32
Hibernian,8541,1,17,14,5,52,26,26,65
Morton,8541,2,17,11,8,50,35,15,62
Dundee Utd,8541,3,16,11,9,53,40,13,59
Falkirk,8541,4,16,10,10,58,40,18,58
Dunfermline,8541,5,12,12,12,46,46,0,48
Queen of S't,8541,6,12,8,16,48,54,-6,44
Dumbarton,8541,7,10,10,16,45,56,-11,40
Ayr,8541,8,9,11,16,32,55,-23,38
St Mirren,8541,9,8,12,16,39,54,-15,36
Raith,8541,10,9,9,18,32,49,-17,36
Hibernian,8542,1,18,13,5,50,24,26,67
Morton,8542,2,18,10,8,54,35,19,64
Falkirk,8542,3,16,12,8,58,40,18,60
Dundee Utd,8542,4,15,12,9,54,40,14,57
Queen of S't,8542,5,13,9,14,46,48,-2,48
St Mirren,8542,6,11,10,15,41,53,-12,43
Dunfermline,8542,7,9,13,14,43,51,-8,40
Dumbarton,8542,8,9,10,17,46,60,-14,37
Ayr,8542,9,8,12,16,34,54,-20,36
Raith,8542,10,8,9,19,30,51,-21,33
Hibernian,8543,1,18,12,6,56,27,29,66
Morton,8543,2,16,13,7,51,37,14,61
Falkirk,8543,3,16,11,9,57,43,14,59
Dundee Utd,8543,4,16,11,9,50,38,12,59
Raith,8543,5,12,10,14,41,51,-10,46
Dunfermline,8543,6,9,14,13,44,47,-3,41
Queen of S't,8543,7,10,9,17,43,52,-9,39
Dumbarton,8543,8,9,12,15,46,59,-13,39
Ayr,8543,9,8,14,14,35,51,-16,38
St Mirren,8543,10,7,12,17,38,56,-18,33
Hibernian,8544,1,20,11,5,58,27,31,71
Falkirk,8544,2,20,9,7,64,37,27,69
Morton,8544,3,15,11,10,45,40,5,56
Dundee Utd,8544,4,14,10,12,45,38,7,52
Dunfermline,8544,5,10,12,14,48,49,-1,42
Queen of S't,8544,6,11,9,16,44,52,-8,42
Raith,8544,7,10,11,15,34,48,-14,41
St Mirren,8544,8,9,11,16,40,53,-13,38
Ayr,8544,9,8,14,14,34,52,-18,38
Dumbarton,8544,10,8,12,16,44,60,-16,36
Hibernian,8545,1,18,14,4,52,23,29,68
Dundee Utd,8545,2,17,9,10,53,40,13,60
Morton,8545,3,15,11,10,49,42,7,56
Falkirk,8545,4,14,12,10,54,39,15,54
Dunfermline,8545,5,9,15,12,45,48,-3,42
Queen of S't,8545,6,11,9,16,45,56,-11,42
Raith,8545,7,10,12,14,36,47,-11,42
St Mirren,8545,8,10,11,15,41,50,-9,41
Dumbarton,8545,9,9,12,15,46,58,-12,39
Ayr,8545,10,9,11,16,38,56,-18,38
Hibernian,8546,1,18,14,4,55,27,28,68
Morton,8546,2,19,10,7,50,33,17,67
Falkirk,8546,3,17,11,8,56,38,18,62
Dundee Utd,8546,4,13,9,14,43,44,-1,48
Queen of S't,8546,5,12,9,15,45,48,-3,45
Dumbarton,8546,6,11,10,15,51,56,-5,43
Raith,8546,7,11,9,16,37,54,-17,42
Ayr,8546,8,10,11,15,32,52,-20,41
St Mirren,8546,9,9,10,17,46,54,-8,37
Dunfermline,8546,10,7,13,16,41,50,-9,34
Hibernian,8547,1,20,10,6,53,27,26,70
Morton,8547,2,18,11,7,52,37,15,65
Dundee Utd,8547,3,16,10,10,57,43,14,58
Falkirk,8547,4,14,10,12,56,45,11,52
Queen of S't,8547,5,13,9,14,44,48,-4,48
Dumbarton,8547,6,11,10,15,54,63,-9,43
Raith,8547,7,11,9,16,35,49,-14,42
Dunfermline,8547,8,9,12,15,51,51,0,39
Ayr,8547,9,8,12,16,33,53,-20,36
St Mirren,8547,10,8,11,17,40,59,-19,35
Hibernian,8548,1,17,15,4,49,24,25,66
Morton,8548,2,16,10,10,44,36,8,58
Falkirk,8548,3,15,12,9,56,40,16,57
Dundee Utd,8548,4,15,8,13,46,41,5,53
Ayr,8548,5,12,11,13,39,49,-10,47
Queen of S't,8548,6,10,12,14,42,47,-5,42
Dumbarton,8548,7,10,12,14,49,57,-8,42
Raith,8548,8,10,11,15,40,52,-12,41
Dunfermline,8548,9,9,13,14,49,51,-2,40
St Mirren,8548,10,9,10,17,44,61,-17,37
Morton,8549,1,18,10,8,53,34,19,64
Hibernian,8549,2,16,13,7,52,27,25,61
Dundee Utd,8549,3,17,10,9,54,38,16,61
Falkirk,8549,4,15,10,11,52,44,8,55
Dunfermline,8549,5,12,12,12,48,46,2,48
Queen of S't,8549,6,11,10,15,44,48,-4,43
Raith,8549,7,11,10,15,38,52,-14,43
Dumbarton,8549,8,9,13,14,48,57,-9,40
Ayr,8549,9,8,12,16,33,58,-25,36
St Mirren,8549,10,7,12,17,37,55,-18,33
Hibernian,8550,1,23,10,3,61,19,42,79
Falkirk,8550,2,17,9,10,64,42,22,60
Morton,8550,3,17,9,10,46,40,6,60
Dundee Utd,8550,4,16,11,9,52,36,16,59
Queen of S't,8550,5,10,12,14,44,52,-8,42
Dunfermline,8550,6,9,12,15,42,50,-8,39
Raith,8550,7,10,9,17,36,56,-20,39
St Mirren,8550,8,9,10,17,42,56,-14,37
Dumbarton,8550,9,9,10,17,45,60,-15,37
Ayr,8550,10,7,14,15,33,54,-21,35
Hibernian,8551,1,18,11,7,57,31,26,65
Morton,8551,2,17,13,6,50,33,17,64
Falkirk,8551,3,15,13,8,52,35,17,58
Dundee Utd,8551,4,14,12,10,47,37,10,54
Queen of S't,8551,5,13,9,14,46,48,-2,48
Dunfermline,8551,6,9,14,13,41,47,-6,41
St Mirren,8551,7,10,11,15,38,52,-14,41
Raith,8551,8,9,12,15,35,50,-15,39
Dumbarton,8551,9,9,10,17,47,57,-10,37
Ayr,8551,10,7,13,16,32,55,-23,34
Hibernian,8552,1,21,11,4,59,26,33,74
Morton,8552,2,19,11,6,51,30,21,68
Dundee Utd,8552,3,15,11,10,47,40,7,56
Falkirk,8552,4,13,12,11,54,43,11,51
Queen of S't,8552,5,13,10,13,52,51,1,49
Dunfermline,8552,6,10,11,15,49,54,-5,41
St Mirren,8552,7,9,12,15,41,51,-10,39
Raith,8552,8,9,10,17,31,53,-22,37
Dumbarton,8552,9,8,12,16,47,58,-11,36
Ayr,8552,10,7,12,17,34,59,-25,33
Hibernian,8553,1,22,11,3,58,22,36,77
Morton,8553,2,17,12,7,50,35,15,63
Dundee Utd,8553,3,16,8,12,48,39,9,56
Falkirk,8553,4,15,9,12,54,44,10,54
Queen of S't,8553,5,13,8,15,42,50,-8,47
Raith,8553,6,12,10,14,38,45,-7,46
Dunfermline,8553,7,10,12,14,45,44,1,42
Dumbarton,8553,8,9,10,17,46,60,-14,37
Ayr,8553,9,8,12,16,32,57,-25,36
St Mirren,8553,10,7,10,19,41,58,-17,31
Falkirk,8554,1,18,10,8,62,39,23,64
Hibernian,8554,2,17,11,8,50,28,22,62
Morton,8554,3,16,11,9,51,39,12,59
Dundee Utd,8554,4,16,10,10,52,42,10,58
Queen of S't,8554,5,13,9,14,47,49,-2,48
Dunfermline,8554,6,10,13,13,51,52,-1,43
Raith,8554,7,10,10,16,35,54,-19,40
St Mirren,8554,8,10,9,17,41,55,-14,39
Dumbarton,8554,9,9,11,16,46,58,-12,38
Ayr,8554,10,8,12,16,34,53,-19,36
Falkirk,8555,1,18,11,7,57,35,22,65
Morton,8555,2,18,10,8,55,40,15,64
Hibernian,8555,3,17,12,7,56,33,23,63
Dundee Utd,8555,4,16,11,9,53,41,12,59
Queen of S't,8555,5,11,10,15,44,50,-6,43
Ayr,8555,6,10,11,15,33,52,-19,41
Raith,8555,7,10,9,17,34,48,-14,39
Dunfermline,8555,8,8,14,14,42,48,-6,38
Dumbarton,8555,9,8,13,15,48,59,-11,37
St Mirren,8555,10,8,11,17,46,62,-16,35
Hibernian,8556,1,18,11,7,52,27,25,65
Morton,8556,2,17,11,8,50,35,15,62
Falkirk,8556,3,16,10,10,58,42,16,58
Dundee Utd,8556,4,15,11,10,51,42,9,56
Dunfermline,8556,5,10,13,13,45,46,-1,43
Raith,8556,6,10,12,14,38,48,-10,42
Ayr,8556,7,10,12,14,36,52,-16,42
Queen of S't,8556,8,10,10,16,46,59,-13,40
Dumbarton,8556,9,9,12,15,49,61,-12,39
St Mirren,8556,10,8,12,16,40,53,-13,36
Morton,8557,1,19,11,6,55,33,22,68
Hibernian,8557,2,17,14,5,53,29,24,65
Dundee Utd,8557,3,16,9,11,55,42,13,57
Falkirk,8557,4,14,13,9,58,44,14,55
Queen of S't,8557,5,12,10,14,52,54,-2,46
Dunfermline,8557,6,10,12,14,46,57,-11,42
Dumbarton,8557,7,10,10,16,49,60,-11,40
Ayr,8557,8,9,11,16,37,58,-21,38
Raith,8557,9,9,10,17,36,50,-14,37
St Mirren,8557,10,8,12,16,38,52,-14,36
Hibernian,8558,1,18,13,5,52,26,26,67
Morton,8558,2,16,13,7,50,38,12,61
Dundee Utd,8558,3,17,9,10,49,39,10,60
Falkirk,8558,4,16,9,11,59,41,18,57
Queen of S't,8558,5,13,8,15,51,51,0,47
Dunfermline,8558,6,11,13,12,49,47,2,46
Raith,8558,7,11,9,16,33,47,-14,42
Dumbarton,8558,8,9,12,15,50,60,-10,39
Ayr,8558,9,8,12,16,31,53,-22,36
St Mirren,8558,10,7,10,19,35,57,-22,31
Hibernian,8559,1,20,11,5,57,25,32,71
Morton,8559,2,15,13,8,50,38,12,58
Falkirk,8559,3,15,11,10,61,47,14,56
Dundee Utd,8559,4,15,11,10,50,45,5,56
Dunfermline,8559,5,12,13,11,53,48,5,49
Raith,8559,6,11,10,15,37,49,-12,43
Queen of S't,8559,7,11,8,17,45,56,-11,41
Dumbarton,8559,8,9,11,16,49,58,-9,38
St Mirren,8559,9,9,10,17,40,56,-16,37
Ayr,8559,10,8,12,16,35,55,-20,36
Hibernian,8560,1,19,12,5,56,26,30,69
Falkirk,8560,2,17,11,8,64,44,20,62
Dundee Utd,8560,3,16,10,10,55,44,11,58
Morton,8560,4,13,14,9,43,36,7,53
Dunfermline,8560,5,12,12,12,49,46,3,48
Raith,8560,6,11,10,15,37,51,-14,43
Dumbarton,8560,7,10,12,14,51,58,-7,42
Queen of S't,8560,8,11,9,16,46,54,-8,42
Ayr,8560,9,7,14,15,33,54,-21,35
St Mirren,8560,10,7,10,19,41,62,-21,31
Hibernian,8561,1,20,13,3,57,24,33,73
Morton,8561,2,17,12,7,51,35,16,63
Dundee Utd,8561,3,16,9,11,52,41,11,57
Falkirk,8561,4,14,13,9,56,41,15,55
Dunfermline,8561,5,10,13,13,48,48,0,43
Dumbarton,8561,6,9,14,13,50,56,-6,41
Queen of S't,8561,7,10,11,15,43,50,-7,41
St Mirren,8561,8,9,11,16,42,53,-11,38
Raith,8561,9,8,11,17,31,54,-23,35
Ayr,8561,10,6,15,15,34,62,-28,33
Hibernian,8562,1,18,12,6,54,26,28,66
Dundee Utd,8562,2,18,9,9,54,36,18,63
Morton,8562,3,18,9,9,55,38,17,63
Falkirk,8562,4,15,12,9,55,39,16,57
Queen of S't,8562,5,12,9,15,46,52,-6,45
St Mirren,8562,6,11,10,15,45,56,-11,43
Dumbarton,8562,7,10,10,16,50,62,-12,40
Raith,8562,8,10,10,16,35,52,-17,40
Dunfermline,8562,9,9,12,15,44,50,-6,39
Ayr,8562,10,6,13,17,31,58,-27,31
Hibernian,8563,1,19,13,4,59,25,34,70
Falkirk,8563,2,17,11,8,60,40,20,62
Dundee Utd,8563,3,17,11,8,59,41,18,62
Morton,8563,4,16,11,9,50,39,11,59
Dunfermline,8563,5,10,12,14,44,52,-8,42
Raith,8563,6,10,12,14,37,45,-8,42
Dumbarton,8563,7,10,11,15,48,59,-11,41
Queen of S't,8563,8,10,10,16,44,55,-11,40
St Mirren,8563,9,7,12,17,39,58,-19,33
Ayr,8563,10,7,11,18,30,56,-26,32
Hibernian,8564,1,21,11,4,60,23,37,74
Falkirk,8564,2,16,13,7,61,37,24,61
Morton,8564,3,17,9,10,50,43,7,60
Dundee Utd,8564,4,15,9,12,47,42,5,54
Dunfermline,8564,5,12,11,13,54,51,3,47
Queen of S't,8564,6,11,9,16,46,53,-7,42
Raith,8564,7,10,10,16,38,55,-17,40
St Mirren,8564,8,9,11,16,39,54,-15,38
Dumbarton,8564,9,9,10,17,46,60,-14,37
Ayr,8564,10,8,11,17,35,58,-23,35
Hibernian,8565,1,18,13,5,57,26,31,67
Dundee Utd,8565,2,18,9,9,58,40,18,63
Morton,8565,3,17,11,8,50,38,12,62
Falkirk,8565,4,15,12,9,57,44,13,57
Raith,8565,5,11,10,15,38,47,-9,43
Ayr,8565,6,10,11,15,34,53,-19,41
Dunfermline,8565,7,9,13,14,43,51,-8,40
Queen of S't,8565,8,10,10,16,44,57,-13,40
Dumbarton,8565,9,8,12,16,51,61,-10,36
St Mirren,8565,10,8,11,17,44,59,-15,35
Hibernian,8566,1,18,13,5,55,26,29,67
Morton,8566,2,18,13,5,53,32,21,67
Falkirk,8566,3,16,11,9,58,40,18,59
Dundee Utd,8566,4,13,11,12,45,43,2,50
Queen of S't,8566,5,12,10,14,48,51,-3,46
Dumbarton,8566,6,9,14,13,48,55,-7,41
Dunfermline,8566,7,9,13,14,40,48,-8,40
St Mirren,8566,8,10,10,16,40,53,-13,40
Raith,8566,9,9,9,18,33,51,-18,36
Ayr,8566,10,8,12,16,36,57,-21,36
Hibernian,8567,1,20,12,4,54,23,31,72
Falkirk,8567,2,17,11,8,59,37,22,62
Morton,8567,3,17,11,8,51,40,11,62
Dundee Utd,8567,4,16,10,10,54,43,11,58
St Mirren,8567,5,12,10,14,47,52,-5,46
Dunfermline,8567,6,9,14,13,44,49,-5,41
Queen of S't,8567,7,10,11,15,42,49,-7,41
Raith,8567,8,9,10,17,34,50,-16,37
Dumbarton,8567,9,8,11,17,48,62,-14,35
Ayr,8567,10,7,10,19,32,60,-28,31
Hibernian,8568,1,18,15,3,55,23,32,69
Falkirk,8568,2,15,13,8,61,44,17,58
Dundee Utd,8568,3,15,12,9,47,36,11,57
Morton,8568,4,15,12,9,47,38,9,57
Queen of S't,8568,5,11,9,16,43,51,-8,42
Raith,8568,6,10,12,14,37,50,-13,42
Dunfermline,8568,7,8,16,12,43,47,-4,40
Dumbarton,8568,8,9,12,15,46,57,-11,39
Ayr,8568,9,8,14,14,32,50,-18,38
St Mirren,8568,10,8,11,17,42,57,-15,35
Morton,8569,1,19,11,6,59,40,19,68
Hibernian,8569,2,18,12,6,59,29,30,66
Falkirk,8569,3,18,9,9,61,37,24,63
Dundee Utd,8569,4,17,9,10,55,41,14,60
Queen of S't,8569,5,12,9,15,44,52,-8,45
Raith,8569,6,12,8,16,34,46,-12,44
Dumbarton,8569,7,9,10,17,48,65,-17,37
Dunfermline,8569,8,8,12,16,42,52,-10,36
St Mirren,8569,9,9,9,18,42,63,-21,36
Ayr,8569,10,8,11,17,38,57,-19,35
Hibernian,8570,1,19,12,5,59,25,34,69
Dundee Utd,8570,2,18,9,9,53,38,15,63
Morton,8570,3,16,12,8,52,40,12,60
Falkirk,8570,4,15,11,10,54,40,14,56
Raith,8570,5,12,9,15,39,45,-6,45
Dunfermline,8570,6,10,12,14,51,50,1,42
Queen of S't,8570,7,10,10,16,41,59,-18,40
Dumbarton,8570,8,9,12,15,48,57,-9,39
St Mirren,8570,9,9,11,16,40,55,-15,38
Ayr,8570,10,7,12,17,29,57,-28,33
Hibernian,8571,1,21,11,4,57,23,34,74
Falkirk,8571,2,16,12,8,60,38,22,60
Morton,8571,3,17,9,10,49,38,11,60
Dundee Utd,8571,4,15,10,11,49,40,9,55
Queen of S't,8571,5,11,10,15,43,51,-8,43
Dunfermline,8571,6,10,12,14,43,48,-5,42
Raith,8571,7,10,11,15,35,49,-14,41
St Mirren,8571,8,9,12,15,39,52,-13,39
Dumbarton,8571,9,8,12,16,43,56,-13,36
Ayr,8571,10,7,13,16,30,53,-23,34
Hibernian,8572,1,19,13,4,55,26,29,70
Falkirk,8572,2,18,11,7,67,41,26,65
Dundee Utd,8572,3,17,9,10,55,44,11,60
Morton,8572,4,16,9,11,49,39,10,57
Queen of S't,8572,5,11,10,15,44,52,-8,43
Raith,8572,6,10,11,15,35,47,-12,41
Dunfermline,8572,7,9,13,14,47,53,-6,40
Ayr,8572,8,9,12,15,37,55,-18,39
Dumbarton,8572,9,8,12,16,46,57,-11,36
St Mirren,8572,10,8,10,18,40,61,-21,34
Hibernian,8573,1,18,11,7,53,30,23,65
Morton,8573,2,18,11,7,54,35,19,65
Dundee Utd,8573,3,17,10,9,54,38,16,61
Falkirk,8573,4,16,10,10,64,49,15,58
Dunfermline,8573,5,10,14,12,47,50,-3,44
Queen of S't,8573,6,9,13,14,42,53,-11,40
Raith,8573,7,10,10,16,34,48,-14,40
Dumbarton,8573,8,9,12,15,47,55,-8,39
Ayr,8573,9,9,11,16,32,51,-19,38
St Mirren,8573,10,8,10,18,38,56,-18,34
Morton,8574,1,19,11,6,51,32,19,68
Hibernian,8574,2,18,13,5,55,29,26,67
Falkirk,8574,3,18,11,7,63,37,26,65
Dundee Utd,8574,4,14,10,12,46,40,6,52
Queen of S't,8574,5,14,9,13,52,51,1,51
Dumbarton,8574,6,9,12,15,49,59,-10,39
Raith,8574,7,10,8,18,33,51,-18,38
Dunfermline,8574,8,8,13,15,42,52,-10,37
Ayr,8574,9,8,12,16,33,55,-22,36
St Mirren,8574,10,7,11,18,40,58,-18,32
Hibernian,8575,1,19,12,5,58,28,30,69
Dundee Utd,8575,2,15,10,11,49,42,7,55
Morton,8575,3,15,10,11,46,42,4,55
Falkirk,8575,4,14,9,13,52,42,10,51
Queen of S't,8575,5,14,9,13,44,44,0,51
Raith,8575,6,13,8,15,38,47,-9,47
Dunfermline,8575,7,11,12,13,48,47,1,45
Dumbarton,8575,8,8,14,14,46,56,-10,38
St Mirren,8575,9,9,11,16,44,56,-12,38
Ayr,8575,10,8,13,15,33,54,-21,37
Hibernian,8576,1,21,10,5,57,24,33,73
Morton,8576,2,18,12,6,51,33,18,66
Dundee Utd,8576,3,16,11,9,52,39,13,59
Falkirk,8576,4,15,11,10,56,41,15,56
Dunfermline,8576,5,10,13,13,46,48,-2,43
Raith,8576,6,11,9,16,34,47,-13,42
Queen of S't,8576,7,10,10,16,41,52,-11,40
Dumbarton,8576,8,7,14,15,48,62,-14,35
St Mirren,8576,9,8,11,17,42,59,-17,35
Ayr,8576,10,8,11,17,36,58,-22,35
Falkirk,8577,1,20,9,7,66,37,29,69
Hibernian,8577,2,19,12,5,56,27,29,69
Morton,8577,3,18,12,6,54,34,20,66
Dundee Utd,8577,4,16,10,10,53,41,12,58
Queen of S't,8577,5,12,10,14,47,51,-4,46
Dumbarton,8577,6,9,12,15,47,59,-12,39
Dunfermline,8577,7,8,13,15,43,53,-10,37
St Mirren,8577,8,9,9,18,45,58,-13,36
Raith,8577,9,8,10,18,32,55,-23,34
Ayr,8577,10,7,11,18,30,58,-28,32
Hibernian,8578,1,18,12,6,55,30,25,66
Falkirk,8578,2,17,10,9,62,41,21,61
Dundee Utd,8578,3,16,9,11,51,41,10,57
Morton,8578,4,14,12,10,45,41,4,54
Ayr,8578,5,12,12,12,42,50,-8,48
Queen of S't,8578,6,12,9,15,46,53,-7,45
Dunfermline,8578,7,10,13,13,53,54,-1,43
Raith,8578,8,11,9,16,41,56,-15,42
Dumbarton,8578,9,8,12,16,44,56,-12,36
St Mirren,8578,10,7,12,17,37,54,-17,33
Hibernian,8579,1,19,11,6,59,25,34,68
Morton,8579,2,17,11,8,50,37,13,62
Dundee Utd,8579,3,13,13,10,44,40,4,52
Falkirk,8579,4,13,12,11,51,44,7,51
Queen of S't,8579,5,13,9,14,53,51,2,48
Raith,8579,6,12,9,15,41,52,-11,45
Dunfermline,8579,7,10,13,13,49,49,0,43
Dumbarton,8579,8,9,14,13,45,55,-10,41
St Mirren,8579,9,8,12,16,41,56,-15,36
Ayr,8579,10,7,14,15,31,55,-24,35
Hibernian,8580,1,20,11,5,56,23,33,71
Falkirk,8580,2,18,9,9,59,37,22,63
Morton,8580,3,16,10,10,48,38,10,58
Dundee Utd,8580,4,15,11,10,51,38,13,56
Queen of S't,8580,5,12,9,15,43,51,-8,45
Raith,8580,6,11,11,14,39,46,-7,44
Dunfermline,8580,7,9,12,15,43,54,-11,39
Dumbarton,8580,8,9,12,15,44,56,-12,39
Ayr,8580,9,8,14,14,33,51,-18,38
St Mirren,8580,10,7,11,18,36,58,-22,32
Hibernian,8581,1,20,11,5,55,25,30,71
Morton,8581,2,19,10,7,56,35,21,67
Falkirk,8581,3,15,11,10,56,45,11,56
Dundee Utd,8581,4,14,11,11,45,41,4,53
Ayr,8581,5,11,11,14,34,51,-17,44
Dunfermline,8581,6,10,13,13,48,49,-1,43
Queen of S't,8581,7,11,9,16,43,48,-5,42
Dumbarton,8581,8,10,11,15,46,56,-10,41
Raith,8581,9,9,11,16,34,48,-14,38
St Mirren,8581,10,7,10,19,38,57,-19,31
Hibernian,8582,1,18,14,4,51,23,28,68
Morton,8582,2,18,12,6,51,34,17,66
Falkirk,8582,3,17,10,9,62,40,22,61
Dundee Utd,8582,4,15,11,10,50,43,7,56
Queen of S't,8582,5,11,9,16,45,53,-8,42
Dunfermline,8582,6,9,13,14,47,51,-4,40
Raith,8582,7,9,11,16,33,49,-16,38
Dumbarton,8582,8,8,13,15,48,59,-11,37
Ayr,8582,9,8,13,15,34,54,-20,37
St Mirren,8582,10,8,12,16,36,51,-15,36
Dundee Utd,8583,1,19,8,9,61,37,24,65
Falkirk,8583,2,18,10,8,59,37,22,64
Hibernian,8583,3,17,12,7,51,28,23,63
Morton,8583,4,17,9,10,49,41,8,60
Queen of S't,8583,5,12,10,14,45,48,-3,46
Raith,8583,6,12,9,15,38,47,-9,45
Dunfermline,8583,7,9,12,15,44,51,-7,39
Dumbarton,8583,8,9,10,17,43,58,-15,37
St Mirren,8583,9,8,11,17,34,53,-19,35
Ayr,8583,10,8,11,17,34,58,-24,35
Morton,8584,1,18,11,7,49,31,18,65
Hibernian,8584,2,17,13,6,54,30,24,64
Falkirk,8584,3,17,10,9,61,43,18,61
Dundee Utd,8584,4,17,10,9,50,37,13,61
Dunfermline,8584,5,13,11,12,53,48,5,50
Queen of S't,8584,6,12,10,14,45,48,-3,46
Ayr,8584,7,8,14,14,31,50,-19,38
St Mirren,8584,8,8,10,18,49,64,-15,34
Raith,8584,9,8,10,18,32,55,-23,34
Dumbarton,8584,10,7,11,18,45,63,-18,32
Hibernian,8585,1,21,12,3,56,21,35,75
Falkirk,8585,2,17,10,9,61,39,22,61
Morton,8585,3,16,12,8,51,37,14,60
Dundee Utd,8585,4,17,8,11,49,40,9,59
Dumbarton,8585,5,10,13,13,48,53,-5,43
Queen of S't,8585,6,11,10,15,42,48,-6,43
Dunfermline,8585,7,9,14,13,50,53,-3,41
Raith,8585,8,10,11,15,39,52,-13,41
Ayr,8585,9,7,12,17,29,58,-29,33
St Mirren,8585,10,6,10,20,37,61,-24,28
Hibernian,8586,1,19,13,4,61,28,33,70
Falkirk,8586,2,16,9,11,62,48,14,57
Morton,8586,3,14,13,9,45,36,9,55
Dunfermline,8586,4,12,14,10,51,43,8,50
Dundee Utd,8586,5,13,10,13,48,47,1,49
St Mirren,8586,6,11,11,14,46,51,-5,44
Dumbarton,8586,7,10,12,14,56,64,-8,42
Queen of S't,8586,8,10,10,16,42,50,-8,40
Raith,8586,9,10,9,17,33,56,-23,39
Ayr,8586,10,9,11,16,33,54,-21,38
Hibernian,8587,1,20,11,5,62,31,31,71
Morton,8587,2,19,11,6,55,36,19,68
Dundee Utd,8587,3,17,8,11,55,40,15,59
Falkirk,8587,4,15,10,11,56,43,13,55
Dumbarton,8587,5,11,10,15,49,56,-7,43
Queen of S't,8587,6,11,10,15,41,51,-10,43
Raith,8587,7,11,9,16,37,49,-12,42
Dunfermline,8587,8,8,14,14,41,49,-8,38
St Mirren,8587,9,9,10,17,46,56,-10,37
Ayr,8587,10,7,11,18,35,66,-31,32
Hibernian,8588,1,17,14,5,51,25,26,65
Dundee Utd,8588,2,17,11,8,53,34,19,62
Morton,8588,3,16,12,8,49,37,12,60
Falkirk,8588,4,15,12,9,57,37,20,57
Raith,8588,5,12,9,15,38,47,-9,45
Dumbarton,8588,6,11,10,15,49,59,-10,43
Queen of S't,8588,7,10,11,15,43,55,-12,41
Dunfermline,8588,8,9,13,14,44,50,-6,40
Ayr,8588,9,8,12,16,32,56,-24,36
St Mirren,8588,10,7,12,17,40,56,-16,33
Hibernian,8589,1,19,12,5,58,25,33,69
Morton,8589,2,18,10,8,52,34,18,64
Dundee Utd,8589,3,17,11,8,54,34,20,62
Falkirk,8589,4,16,12,8,62,40,22,60
Raith,8589,5,11,9,16,39,53,-14,42
Dumbarton,8589,6,10,10,16,46,62,-16,40
Dunfermline,8589,7,9,12,15,43,50,-7,39
Queen of S't,8589,8,10,9,17,45,60,-15,39
St Mirren,8589,9,9,11,16,44,58,-14,38
Ayr,8589,10,7,12,17,29,56,-27,33
Hibernian,8590,1,18,15,3,55,24,31,69
Morton,8590,2,16,13,7,53,40,13,61
Falkirk,8590,3,15,14,7,61,40,21,59
Dundee Utd,8590,4,15,11,10,52,42,10,56
Dunfermline,8590,5,10,14,12,48,47,1,44
Raith,8590,6,11,10,15,40,52,-12,43
Queen of S't,8590,7,10,10,16,45,54,-9,40
Dumbarton,8590,8,8,13,15,51,65,-14,37
St Mirren,8590,9,8,11,17,42,59,-17,35
Ayr,8590,10,7,13,16,37,61,-24,34
Hibernian,8591,1,19,11,6,54,25,29,68
Morton,8591,2,17,13,6,53,36,17,64
Dundee Utd,8591,3,17,9,10,53,39,14,60
Falkirk,8591,4,16,11,9,57,38,19,59
Queen of S't,8591,5,13,8,15,42,47,-5,47
St Mirren,8591,6,10,11,15,42,54,-12,41
Dunfermline,8591,7,9,13,14,46,52,-6,40
Dumbarton,8591,8,9,10,17,47,63,-16,37
Raith,8591,9,9,10,17,33,49,-16,37
Ayr,8591,10,7,12,17,33,57,-24,33
Hibernian,8592,1,19,12,5,53,25,28,69
Morton,8592,2,18,12,6,53,36,17,66
Dundee Utd,8592,3,18,8,10,55,37,18,62
Falkirk,8592,4,15,11,10,56,43,13,56
Queen of S't,8592,5,11,10,15,43,48,-5,43
Raith,8592,6,9,13,14,35,46,-11,40
Ayr,8592,7,8,14,14,34,54,-20,38
Dumbarton,8592,8,8,13,15,45,59,-14,37
Dunfermline,8592,9,8,12,16,42,51,-9,36
St Mirren,8592,10,7,13,16,43,60,-17,34
Hibernian,8593,1,19,12,5,51,24,27,69
Morton,8593,2,18,11,7,59,36,23,65
Dundee Utd,8593,3,17,9,10,53,42,11,60
Falkirk,8593,4,15,14,7,59,39,20,59
Dunfermline,8593,5,10,13,13,45,44,1,43
Raith,8593,6,11,9,16,35,48,-13,42
Dumbarton,8593,7,9,12,15,48,61,-13,39
Ayr,8593,8,9,12,15,37,56,-19,39
Queen of S't,8593,9,9,11,16,41,52,-11,38
St Mirren,8593,10,6,11,19,36,62,-26,29
Hibernian,8594,1,18,13,5,51,25,26,67
Falkirk,8594,2,17,10,9,60,42,18,61
Morton,8594,3,16,11,9,47,35,12,59
Dundee Utd,8594,4,16,9,11,55,40,15,57
Queen of S't,8594,5,12,10,14,42,44,-2,46
Dunfermline,8594,6,11,12,13,51,54,-3,45
Ayr,8594,7,10,11,15,37,54,-17,41
Dumbarton,8594,8,10,10,16,47,58,-11,40
St Mirren,8594,9,9,10,17,39,55,-16,37
Raith,8594,10,8,10,18,30,52,-22,34
Hibernian,8595,1,20,11,5,56,25,31,71
Falkirk,8595,2,17,9,10,60,40,20,60
Dundee Utd,8595,3,16,11,9,52,36,16,59
Morton,8595,4,15,12,9,52,40,12,57
Queen of S't,8595,5,14,10,12,47,46,1,52
Raith,8595,6,11,8,17,37,52,-15,41
Dunfermline,8595,7,8,15,13,47,52,-5,39
Ayr,8595,8,9,11,16,37,58,-21,38
Dumbarton,8595,9,8,11,17,47,66,-19,35
St Mirren,8595,10,8,10,18,38,58,-20,34
Hibernian,8596,1,20,11,5,59,28,31,71
Morton,8596,2,17,10,9,52,40,12,61
Falkirk,8596,3,15,9,12,56,46,10,54
Dundee Utd,8596,4,15,8,13,45,39,6,53
Dunfermline,8596,5,13,12,11,49,42,7,51
Queen of S't,8596,6,11,9,16,41,51,-10,42
Raith,8596,7,11,9,16,39,49,-10,42
Dumbarton,8596,8,10,10,16,49,58,-9,40
Ayr,8596,9,10,10,16,38,60,-22,40
St Mirren,8596,10,9,10,17,39,54,-15,37
Morton,8597,1,17,12,7,52,35,17,63
Hibernian,8597,2,17,11,8,52,31,21,62
Falkirk,8597,3,16,11,9,59,44,15,59
Dundee Utd,8597,4,16,11,9,54,42,12,59
Queen of S't,8597,5,13,9,14,46,49,-3,48
Raith,8597,6,12,10,14,38,46,-8,46
Dumbarton,8597,7,10,11,15,52,56,-4,41
Dunfermline,8597,8,9,14,13,44,49,-5,41
Ayr,8597,9,7,15,14,38,58,-20,36
St Mirren,8597,10,6,10,20,36,61,-25,28
Falkirk,8598,1,18,10,8,63,42,21,64
Hibernian,8598,2,17,11,8,57,35,22,62
Dundee Utd,8598,3,17,11,8,54,40,14,62
Morton,8598,4,15,14,7,44,33,11,59
St Mirren,8598,5,11,10,15,43,48,-5,43
Dumbarton,8598,6,10,12,14,56,62,-6,42
Queen of S't,8598,7,11,9,16,47,56,-9,42
Raith,8598,8,10,10,16,33,44,-11,40
Dunfermline,8598,9,8,13,15,41,53,-12,37
Ayr,8598,10,7,12,17,33,58,-25,33
Hibernian,8599,1,21,10,5,63,30,33,73
Morton,8599,2,17,11,8,50,35,15,62
Falkirk,8599,3,17,10,9,63,44,19,61
Dundee Utd,8599,4,16,8,12,48,40,8,56
St Mirren,8599,5,11,10,15,45,51,-6,43
Raith,8599,6,11,10,15,39,49,-10,43
Dunfermline,8599,7,9,14,13,46,48,-2,41
Dumbarton,8599,8,9,10,17,48,61,-13,37
Ayr,8599,9,9,10,17,34,57,-23,37
Queen of S't,8599,10,9,9,18,43,64,-21,36
Hibernian,8600,1,20,11,5,55,25,30,71
Falkirk,8600,2,17,11,8,61,40,21,62
Dundee Utd,8600,3,16,12,8,56,38,18,60
Morton,8600,4,16,11,9,47,37,10,59
Queen of S't,8600,5,11,11,14,45,48,-3,44
Raith,8600,6,12,8,16,35,47,-12,44
St Mirren,8600,7,10,9,17,39,55,-16,39
Ayr,8600,8,8,12,16,34,56,-22,36
Dunfermline,8600,9,7,14,15,45,57,-12,35
Dumbarton,8600,10,8,11,17,48,62,-14,35
Hibernian,8601,1,20,11,5,55,25,30,71
Dundee Utd,8601,2,17,10,9,54,39,15,61
Falkirk,8601,3,16,11,9,56,37,19,59
Morton,8601,4,15,13,8,46,38,8,58
Queen of S't,8601,5,11,10,15,45,50,-5,43
Dumbarton,8601,6,10,12,14,52,57,-5,42
Dunfermline,8601,7,7,17,12,44,50,-6,38
Ayr,8601,8,8,14,14,33,49,-16,38
Raith,8601,9,8,11,17,31,48,-17,35
St Mirren,8601,10,8,11,17,37,60,-23,35
Hibernian,8602,1,18,11,7,53,26,27,65
Dundee Utd,8602,2,17,11,8,55,40,15,62
Morton,8602,3,17,11,8,50,38,12,62
Falkirk,8602,4,15,12,9,62,44,18,57
Queen of S't,8602,5,12,9,15,45,53,-8,45
St Mirren,8602,6,10,12,14,44,55,-11,42
Dunfermline,8602,7,9,13,14,41,49,-8,40
Raith,8602,8,9,12,15,36,52,-16,39
Ayr,8602,9,9,10,17,40,57,-17,37
Dumbarton,8602,10,8,11,17,46,58,-12,35
Hibernian,8603,1,20,12,4,56,23,33,72
Falkirk,8603,2,17,10,9,60,41,19,61
Morton,8603,3,16,12,8,51,38,13,60
Dundee Utd,8603,4,15,9,12,45,38,7,54
Queen of S't,8603,5,12,9,15,49,52,-3,45
Raith,8603,6,11,9,16,36,49,-13,42
Dunfermline,8603,7,9,14,13,43,47,-4,41
Dumbarton,8603,8,9,11,16,47,60,-13,38
St Mirren,8603,9,9,10,17,40,55,-15,37
Ayr,8603,10,8,12,16,33,57,-24,36
Hibernian,8604,1,19,12,5,56,29,27,69
Morton,8604,2,17,10,9,52,37,15,61
Falkirk,8604,3,17,9,10,63,44,19,60
Dundee Utd,8604,4,16,11,9,50,37,13,59
Queen of S't,8604,5,11,10,15,45,50,-5,43
Raith,8604,6,11,10,15,38,51,-13,43
Dumbarton,8604,7,10,11,15,51,62,-11,41
Dunfermline,8604,8,9,11,16,45,55,-10,38
Ayr,8604,9,6,17,13,35,54,-19,35
St Mirren,8604,10,7,13,16,39,55,-16,34
Hibernian,8605,1,17,14,5,54,27,27,65
Falkirk,8605,2,17,10,9,58,41,17,61
Morton,8605,3,17,10,9,53,41,12,61
Dundee Utd,8605,4,15,10,11,53,44,9,55
Queen of S't,8605,5,12,10,14,45,47,-2,46
Dunfermline,8605,6,8,16,12,43,45,-2,40
Ayr,8605,7,9,13,14,34,53,-19,40
Dumbarton,8605,8,9,12,15,46,60,-14,39
Raith,8605,9,9,11,16,31,44,-13,38
St Mirren,8605,10,9,10,17,42,57,-15,37
Hibernian,8606,1,18,12,6,52,27,25,66
Morton,8606,2,18,11,7,50,33,17,65
Dundee Utd,8606,3,17,9,10,53,39,14,60
Falkirk,8606,4,16,10,10,57,41,16,58
Dunfermline,8606,5,11,14,11,47,43,4,47
Raith,8606,6,11,10,15,37,47,-10,43
Ayr,8606,7,9,11,16,33,52,-19,38
St Mirren,8606,8,9,10,17,38,53,-15,37
Queen of S't,8606,9,9,10,17,44,62,-18,37
Dumbarton,8606,10,7,13,16,45,59,-14,34
Hibernian,8607,1,20,13,3,59,25,34,73
Morton,8607,2,14,14,8,44,35,9,56
Dundee Utd,8607,3,14,12,10,49,39,10,54
Falkirk,8607,4,14,11,11,55,44,11,53
Dunfermline,8607,5,12,13,11,44,41,3,49
Queen of S't,8607,6,11,10,15,41,52,-11,43
Ayr,8607,7,10,12,14,41,53,-12,42
Raith,8607,8,10,12,14,34,46,-12,42
Dumbarton,8607,9,8,12,16,46,58,-12,36
St Mirren,8607,10,7,11,18,39,59,-20,32
Hibernian,8608,1,21,11,4,59,29,30,74
Morton,8608,2,19,10,7,54,33,21,67
Dundee Utd,8608,3,17,9,10,56,44,12,60
Falkirk,8608,4,15,10,11,57,44,13,55
Dunfermline,8608,5,11,12,13,47,46,1,45
Queen of S't,8608,6,12,9,15,51,55,-4,45
Raith,8608,7,10,9,17,35,49,-14,39
Ayr,8608,8,8,12,16,33,57,-24,36
Dumbarton,8608,9,8,10,18,48,65,-17,34
St Mirren,8608,10,8,10,18,37,55,-18,34
Hibernian,8609,1,18,14,4,56,27,29,68
Falkirk,8609,2,17,10,9,66,43,23,61
Dundee Utd,8609,3,17,8,11,52,40,12,59
Morton,8609,4,15,12,9,48,39,9,57
Queen of S't,8609,5,13,10,13,50,50,0,49
Raith,8609,6,9,14,13,38,49,-11,41
Ayr,8609,7,9,12,15,31,50,-19,39
Dumbarton,8609,8,9,11,16,46,63,-17,38
Dunfermline,8609,9,8,13,15,46,51,-5,37
St Mirren,8609,10,8,10,18,39,60,-21,34
Hibernian,8610,1,19,12,5,56,27,29,69
Morton,8610,2,19,9,8,53,33,20,66
Falkirk,8610,3,15,11,10,60,41,19,56
Dundee Utd,8610,4,14,10,12,48,47,1,52
Queen of S't,8610,5,12,11,13,49,48,1,47
Dunfermline,8610,6,11,11,14,48,52,-4,44
Dumbarton,8610,7,10,12,14,50,59,-9,42
Raith,8610,8,10,11,15,34,46,-12,41
St Mirren,8610,9,8,11,17,36,57,-21,35
Ayr,8610,10,7,12,17,31,55,-24,33
Morton,8611,1,19,10,7,54,37,17,67
Hibernian,8611,2,17,13,6,51,28,23,64
Dundee Utd,8611,3,18,9,9,57,41,16,63
Falkirk,8611,4,17,11,8,60,37,23,62
Queen of S't,8611,5,11,10,15,47,51,-4,43
Raith,8611,6,10,10,16,37,52,-15,40
Dunfermline,8611,7,9,12,15,44,53,-9,39
St Mirren,8611,8,8,12,16,43,58,-15,36
Ayr,8611,9,7,14,15,32,52,-20,35
Dumbarton,8611,10,7,13,16,48,64,-16,34
Hibernian,8612,1,20,11,5,53,26,27,71
Falkirk,8612,2,17,9,10,59,38,21,60
Morton,8612,3,16,12,8,49,38,11,60
Dundee Utd,8612,4,15,10,11,49,40,9,55
Raith,8612,5,13,9,14,41,46,-5,48
Queen of S't,8612,6,12,8,16,45,50,-5,44
Dumbarton,8612,7,10,10,16,49,59,-10,40
Ayr,8612,8,9,11,16,33,54,-21,38
St Mirren,8612,9,8,12,16,43,56,-13,36
Dunfermline,8612,10,8,12,16,42,56,-14,36
Hibernian,8613,1,19,13,4,59,27,32,70
Falkirk,8613,2,15,12,9,57,41,16,57
Dundee Utd,8613,3,15,11,10,51,46,5,56
Morton,8613,4,14,13,9,49,42,7,55
Dunfermline,8613,5,11,12,13,50,46,4,45
Queen of S't,8613,6,11,12,13,45,49,-4,45
St Mirren,8613,7,9,12,15,43,53,-10,39
Raith,8613,8,10,9,17,38,56,-18,39
Dumbarton,8613,9,8,13,15,47,58,-11,37
Ayr,8613,10,8,13,15,37,58,-21,37
Hibernian,8614,1,20,11,5,57,26,31,71
Falkirk,8614,2,16,10,10,55,40,15,58
Dundee Utd,8614,3,14,12,10,50,44,6,54
Morton,8614,4,14,12,10,45,39,6,54
Ayr,8614,5,11,11,14,36,50,-14,44
Dunfermline,8614,6,10,13,13,48,53,-5,43
St Mirren,8614,7,11,10,15,44,52,-8,43
Queen of S't,8614,8,11,9,16,43,50,-7,42
Raith,8614,9,10,10,16,35,47,-12,40
Dumbarton,8614,10,8,12,16,50,62,-12,36
Hibernian,8615,1,21,12,3,59,26,33,75
Falkirk,8615,2,17,10,9,60,39,21,61
Morton,8615,3,16,11,9,51,39,12,59
Dundee Utd,8615,4,14,9,13,48,46,2,51
Raith,8615,5,11,10,15,41,54,-13,43
Dunfermline,8615,6,9,15,12,48,47,1,42
Queen of S't,8615,7,11,9,16,45,51,-6,42
Ayr,8615,8,9,12,15,40,58,-18,39
Dumbarton,8615,9,9,11,16,49,59,-10,38
St Mirren,8615,10,9,9,18,41,63,-22,36
Morton,8616,1,18,11,7,52,33,19,65
Hibernian,8616,2,17,13,6,53,29,24,64
Falkirk,8616,3,16,9,11,56,40,16,57
Dundee Utd,8616,4,15,11,10,46,37,9,56
Queen of S't,8616,5,13,8,15,43,51,-8,47
Dumbarton,8616,6,10,13,13,48,54,-6,43
Raith,8616,7,10,11,15,33,47,-14,41
St Mirren,8616,8,9,12,15,41,53,-12,39
Dunfermline,8616,9,8,14,14,45,48,-3,38
Ayr,8616,10,6,14,16,33,58,-25,32
Hibernian,8617,1,19,12,5,57,24,33,69
Morton,8617,2,19,9,8,52,37,15,66
Dundee Utd,8617,3,17,8,11,56,38,18,59
Falkirk,8617,4,15,10,11,57,43,14,55
Queen of S't,8617,5,12,9,15,49,53,-4,45
Dunfermline,8617,6,11,11,14,46,52,-6,44
Dumbarton,8617,7,11,10,15,48,55,-7,43
Raith,8617,8,9,11,16,41,59,-18,38
Ayr,8617,9,9,11,16,39,63,-24,38
St Mirren,8617,10,7,11,18,38,59,-21,32
Hibernian,8618,1,20,12,4,56,23,33,72
Falkirk,8618,2,17,10,9,63,39,24,61
Morton,8618,3,16,11,9,47,37,10,59
Dundee Utd,8618,4,17,8,11,49,40,9,59
Dunfermline,8618,5,10,12,14,48,49,-1,42
Queen of S't,8618,6,11,9,16,47,60,-13,42
Raith,8618,7,10,11,15,35,47,-12,41
Dumbarton,8618,8,9,12,15,48,61,-13,39
St Mirren,8618,9,8,12,16,38,54,-16,36
Ayr,8618,10,7,13,16,29,50,-21,34
Hibernian,8619,1,19,11,6,58,31,27,68
Morton,8619,2,18,11,7,48,31,17,65
Falkirk,8619,3,14,13,9,58,44,14,55
Dundee Utd,8619,4,13,12,11,47,46,1,51
Dunfermline,8619,5,11,13,12,47,45,2,46
Dumbarton,8619,6,10,13,13,49,52,-3,43
Queen of S't,8619,7,10,12,14,40,47,-7,42
Raith,8619,8,10,10,16,34,48,-14,40
St Mirren,8619,9,8,13,15,38,52,-14,37
Ayr,8619,10,6,14,16,28,51,-23,32
Hibernian,8620,1,17,12,7,51,29,22,63
Falkirk,8620,2,16,12,8,60,38,22,60
Morton,8620,3,16,11,9,47,36,11,59
Dundee Utd,8620,4,16,9,11,49,38,11,57
Dunfermline,8620,5,13,13,10,54,45,9,52
Queen of S't,8620,6,12,9,15,47,55,-8,45
Raith,8620,7,11,8,17,36,47,-11,41
Dumbarton,8620,8,9,11,16,48,61,-13,38
St Mirren,8620,9,9,9,18,39,59,-20,36
Ayr,8620,10,8,12,16,32,55,-23,36
Hibernian,8621,1,19,12,5,56,28,28,69
Morton,8621,2,19,9,8,54,37,17,66
Falkirk,8621,3,16,11,9,56,37,19,59
Dundee Utd,8621,4,16,11,9,49,36,13,59
Dunfermline,8621,5,9,14,13,47,49,-2,41
Ayr,8621,6,9,13,14,39,57,-18,40
Dumbarton,8621,7,9,12,15,49,58,-9,39
Queen of S't,8621,8,9,12,15,42,53,-11,39
St Mirren,8621,9,9,9,18,37,54,-17,36
Raith,8621,10,9,9,18,33,53,-20,36
Hibernian,8622,1,19,11,6,60,32,28,68
Morton,8622,2,17,12,7,49,33,16,63
Falkirk,8622,3,16,10,10,61,43,18,58
Queen of S't,8622,4,15,9,12,51,47,4,54
Dundee Utd,8622,5,13,11,12,49,45,4,50
Dunfermline,8622,6,10,14,12,48,49,-1,44
Ayr,8622,7,9,13,14,36,55,-19,40
Dumbarton,8622,8,8,12,16,47,60,-13,36
St Mirren,8622,9,8,12,16,38,56,-18,36
Raith,8622,10,8,10,18,31,50,-19,34
Hibernian,8623,1,18,13,5,57,26,31,67
Falkirk,8623,2,18,10,8,62,39,23,64
Morton,8623,3,16,15,5,51,36,15,63
Dundee Utd,8623,4,17,11,8,50,37,13,62
Queen of S't,8623,5,12,9,15,49,51,-2,45
Raith,8623,6,9,12,15,39,51,-12,39
Dunfermline,8623,7,7,15,14,41,51,-10,36
Dumbarton,8623,8,8,11,17,46,60,-14,35
St Mirren,8623,9,7,14,15,37,52,-15,35
Ayr,8623,10,8,10,18,32,61,-29,34
Hibernian,8624,1,19,13,4,58,24,34,70
Dundee Utd,8624,2,18,9,9,59,41,18,63
Morton,8624,3,17,10,9,51,44,7,61
Falkirk,8624,4,14,10,12,55,45,10,52
Queen of S't,8624,5,13,10,13,48,46,2,49
Raith,8624,6,11,8,17,37,52,-15,41
Dunfermline,8624,7,9,13,14,44,49,-5,40
Dumbarton,8624,8,9,12,15,47,56,-9,39
St Mirren,8624,9,9,10,17,41,55,-14,37
Ayr,8624,10,8,11,17,32,60,-28,35
Hibernian,8625,1,19,12,5,54,24,30,69
Morton,8625,2,18,10,8,50,37,13,64
Falkirk,8625,3,15,12,9,59,41,18,57
Dundee Utd,8625,4,15,10,11,50,40,10,55
Queen of S't,8625,5,13,8,15,46,53,-7,47
Dunfermline,8625,6,11,12,13,49,52,-3,45
Dumbarton,8625,7,9,12,15,49,57,-8,39
Ayr,8625,8,9,12,15,31,49,-18,39
Raith,8625,9,9,9,18,35,54,-19,36
St Mirren,8625,10,8,11,17,38,54,-16,35
Morton,8626,1,20,9,7,55,34,21,69
Hibernian,8626,2,16,13,7,50,26,24,61
Falkirk,8626,3,16,11,9,58,41,17,59
Dundee Utd,8626,4,14,8,14,46,45,1,50
Queen of S't,8626,5,13,9,14,45,48,-3,48
Dunfermline,8626,6,11,11,14,42,47,-5,44
Dumbarton,8626,7,10,11,15,47,53,-6,41
Ayr,8626,8,9,13,14,34,51,-17,40
Raith,8626,9,10,9,17,34,49,-15,39
St Mirren,8626,10,9,10,17,39,56,-17,37
Hibernian,8627,1,20,11,5,53,22,31,71
Morton,8627,2,16,12,8,51,38,13,60
Falkirk,8627,3,16,11,9,61,44,17,59
Dundee Utd,8627,4,15,10,11,48,41,7,55
Dumbarton,8627,5,11,11,14,56,58,-2,44
Ayr,8627,6,10,13,13,37,50,-13,43
Raith,8627,7,10,10,16,36,52,-16,40
Queen of S't,8627,8,10,9,17,41,50,-9,39
Dunfermline,8627,9,7,17,12,45,55,-10,38
St Mirren,8627,10,8,10,18,41,59,-18,34
Hibernian,8628,1,21,11,4,58,25,33,74
Falkirk,8628,2,16,10,10,55,39,16,58
Dundee Utd,8628,3,16,10,10,53,39,14,58
Morton,8628,4,15,13,8,45,37,8,58
Queen of S't,8628,5,13,8,15,47,50,-3,47
Raith,8628,6,11,11,14,37,48,-11,44
St Mirren,8628,7,10,11,15,45,55,-10,41
Dunfermline,8628,8,7,17,12,44,48,-4,38
Ayr,8628,9,8,10,18,32,56,-24,34
Dumbarton,8628,10,7,11,18,42,61,-19,32
Hibernian,8629,1,20,11,5,55,24,31,71
Falkirk,8629,2,16,11,9,57,42,15,59
Morton,8629,3,15,11,10,48,44,4,56
Dundee Utd,8629,4,15,10,11,48,41,7,55
Dunfermline,8629,5,10,14,12,47,49,-2,44
St Mirren,8629,6,11,10,15,45,51,-6,43
Queen of S't,8629,7,11,10,15,43,49,-6,43
Raith,8629,8,9,12,15,39,49,-10,39
Dumbarton,8629,9,9,11,16,46,55,-9,38
Ayr,8629,10,8,12,16,33,57,-24,36
Hibernian,8630,1,18,13,5,59,31,28,67
Morton,8630,2,18,11,7,59,39,20,65
Dundee Utd,8630,3,18,9,9,55,37,18,63
Falkirk,8630,4,15,12,9,58,41,17,57
Dunfermline,8630,5,11,12,13,43,46,-3,45
Queen of S't,8630,6,11,9,16,41,53,-12,42
Ayr,8630,7,9,13,14,40,58,-18,40
St Mirren,8630,8,9,11,16,41,56,-15,38
Dumbarton,8630,9,8,10,18,46,62,-16,34
Raith,8630,10,8,10,18,34,53,-19,34
Hibernian,8631,1,18,11,7,53,25,28,65
Morton,8631,2,17,11,8,46,33,13,62
Falkirk,8631,3,15,13,8,57,40,17,58
Dundee Utd,8631,4,16,10,10,49,40,9,58
Dumbarton,8631,5,11,11,14,51,52,-1,44
Queen of S't,8631,6,11,11,14,39,44,-5,44
Raith,8631,7,11,11,14,41,51,-10,44
Dunfermline,8631,8,8,14,14,38,49,-11,38
Ayr,8631,9,8,11,17,32,58,-26,35
St Mirren,8631,10,7,13,16,42,56,-14,34
Hibernian,8632,1,17,13,6,50,26,24,64
Morton,8632,2,16,13,7,53,37,16,61
Dundee Utd,8632,3,15,11,10,54,41,13,56
Falkirk,8632,4,14,13,9,52,37,15,55
Queen of S't,8632,5,13,9,14,45,48,-3,48
Dunfermline,8632,6,11,14,11,45,46,-1,47
St Mirren,8632,7,9,12,15,39,52,-13,39
Raith,8632,8,9,12,15,36,49,-13,39
Dumbarton,8632,9,9,11,16,48,58,-10,38
Ayr,8632,10,8,10,18,32,60,-28,34
Hibernian,8633,1,20,12,4,58,25,33,72
Morton,8633,2,18,11,7,51,35,16,65
Falkirk,8633,3,14,13,9,57,41,16,55
Dundee Utd,8633,4,13,13,10,45,44,1,52
Queen of S't,8633,5,12,10,14,47,48,-1,46
Raith,8633,6,10,11,15,35,47,-12,41
Dunfermline,8633,7,8,15,13,41,47,-6,39
Dumbarton,8633,8,9,12,15,48,60,-12,39
St Mirren,8633,9,8,12,16,38,50,-12,36
Ayr,8633,10,6,15,15,33,56,-23,33
Hibernian,8634,1,19,12,5,53,23,30,69
Morton,8634,2,18,11,7,55,33,22,65
Falkirk,8634,3,16,11,9,54,38,16,59
Dundee Utd,8634,4,16,10,10,49,38,11,58
Queen of S't,8634,5,12,10,14,46,50,-4,46
Raith,8634,6,11,11,14,34,43,-9,44
Dumbarton,8634,7,7,15,14,44,55,-11,36
St Mirren,8634,8,8,12,16,39,53,-14,36
Ayr,8634,9,8,11,17,31,56,-25,35
Dunfermline,8634,10,7,13,16,39,55,-16,34
Morton,8635,1,19,11,6,54,35,19,68
Hibernian,8635,2,17,10,9,57,35,22,61
Falkirk,8635,3,15,11,10,57,45,12,56
Dundee Utd,8635,4,13,12,11,48,43,5,51
Dunfermline,8635,5,11,12,13,50,48,2,45
Queen of S't,8635,6,11,11,14,46,51,-5,44
St Mirren,8635,7,11,11,14,43,52,-9,44
Raith,8635,8,10,9,17,39,54,-15,39
Ayr,8635,9,9,12,15,37,56,-19,39
Dumbarton,8635,10,8,13,15,47,59,-12,37
Hibernian,8636,1,18,13,5,55,24,31,67
Morton,8636,2,17,12,7,49,33,16,63
Falkirk,8636,3,16,11,9,59,40,19,59
Dundee Utd,8636,4,16,9,11,50,43,7,57
Dunfermline,8636,5,12,13,11,51,45,6,49
Queen of S't,8636,6,11,11,14,45,49,-4,44
Raith,8636,7,10,9,17,33,49,-16,39
Ayr,8636,8,9,11,16,34,56,-22,38
St Mirren,8636,9,8,11,17,39,55,-16,35
Dumbarton,8636,10,8,10,18,45,66,-21,34
Hibernian,8637,1,21,11,4,61,26,35,74
Dundee Utd,8637,2,16,9,11,51,41,10,57
Falkirk,8637,3,15,11,10,57,45,12,56
Morton,8637,4,15,10,11,46,37,9,55
Dunfermline,8637,5,12,12,12,50,48,2,48
Queen of S't,8637,6,12,8,16,44,49,-5,44
Raith,8637,7,11,9,16,35,53,-18,42
Ayr,8637,8,9,12,15,35,55,-20,39
Dumbarton,8637,9,9,11,16,50,62,-12,38
St Mirren,8637,10,9,9,18,45,58,-13,36
Hibernian,8638,1,20,11,5,56,26,30,71
Falkirk,8638,2,19,10,7,59,34,25,67
Morton,8638,3,15,13,8,54,39,15,58
Dundee Utd,8638,4,15,10,11,53,43,10,55
Ayr,8638,5,10,11,15,32,55,-23,41
Dumbarton,8638,6,9,13,14,46,54,-8,40
Raith,8638,7,10,10,16,37,51,-14,40
Dunfermline,8638,8,9,12,15,46,53,-7,39
Queen of S't,8638,9,9,11,16,43,54,-11,38
St Mirren,8638,10,8,11,17,39,56,-17,35
Hibernian,8639,1,19,12,5,59,28,31,69
Dundee Utd,8639,2,16,11,9,49,37,12,59
Morton,8639,3,16,10,10,51,43,8,58
Falkirk,8639,4,16,9,11,57,42,15,57
Queen of S't,8639,5,11,11,14,45,49,-4,44
Dumbarton,8639,6,10,13,13,50,56,-6,43
Dunfermline,8639,7,10,12,14,48,52,-4,42
Raith,8639,8,10,9,17,31,53,-22,39
St Mirren,8639,9,9,10,17,44,55,-11,37
Ayr,8639,10,8,13,15,36,55,-19,37
Hibernian,8640,1,19,10,7,55,26,29,67
Morton,8640,2,18,13,5,52,31,21,67
Dundee Utd,8640,3,15,11,10,51,42,9,56
Falkirk,8640,4,14,12,10,56,42,14,54
Dunfermline,8640,5,11,12,13,52,53,-1,45
Queen of S't,8640,6,12,9,15,47,54,-7,45
Raith,8640,7,11,10,15,37,49,-12,43
Dumbarton,8640,8,9,12,15,46,58,-12,39
St Mirren,8640,9,8,10,18,40,58,-18,34
Ayr,8640,10,7,13,16,32,55,-23,34
Hibernian,8641,1,20,13,3,56,25,31,73
Morton,8641,2,17,12,7,49,34,15,63
Falkirk,8641,3,15,12,9,55,40,15,57
Dundee Utd,8641,4,14,11,11,45,41,4,53
Queen of S't,8641,5,11,12,13,46,47,-1,45
Raith,8641,6,11,11,14,37,46,-9,44
Dumbarton,8641,7,10,11,15,52,59,-7,41
Ayr,8641,8,8,14,14,32,52,-20,38
Dunfermline,8641,9,7,12,17,41,52,-11,33
St Mirren,8641,10,7,12,17,38,55,-17,33
Hibernian,8642,1,18,12,6,52,29,23,66
Morton,8642,2,18,11,7,52,39,13,65
Falkirk,8642,3,16,10,10,57,38,19,58
Dundee Utd,8642,4,15,10,11,50,40,10,55
Dunfermline,8642,5,12,11,13,51,47,4,47
Queen of S't,8642,6,12,11,13,48,51,-3,47
Raith,8642,7,10,11,15,37,49,-12,41
Dumbarton,8642,8,9,13,14,49,58,-9,40
Ayr,8642,9,7,14,15,35,58,-23,35
St Mirren,8642,10,7,9,20,33,55,-22,30
Hibernian,8643,1,21,11,4,58,24,34,74
Morton,8643,2,18,10,8,52,36,16,64
Dundee Utd,8643,3,17,9,10,54,40,14,60
Falkirk,8643,4,14,10,12,55,46,9,52
Queen of S't,8643,5,13,10,13,50,53,-3,49
Raith,8643,6,12,9,15,41,51,-10,45
Dumbarton,8643,7,10,10,16,47,55,-8,40
Dunfermline,8643,8,8,13,15,47,53,-6,37
Ayr,8643,9,7,13,16,34,59,-25,34
St Mirren,8643,10,7,11,18,36,57,-21,32
Hibernian,8644,1,18,13,5,50,26,24,67
Morton,8644,2,17,10,9,55,39,16,61
Falkirk,8644,3,16,11,9,54,39,15,59
Dundee Utd,8644,4,15,9,12,47,43,4,54
Queen of S't,8644,5,13,9,14,49,49,0,48
Dunfermline,8644,6,11,14,11,50,50,0,47
St Mirren,8644,7,11,9,16,49,57,-8,42
Ayr,8644,8,9,12,15,38,56,-18,39
Dumbarton,8644,9,8,11,17,49,64,-15,35
Raith,8644,10,8,10,18,32,50,-18,34
Hibernian,8645,1,20,12,4,64,27,37,72
Morton,8645,2,16,11,9,50,42,8,59
Dundee Utd,8645,3,16,10,10,52,41,11,58
Falkirk,8645,4,15,11,10,57,45,12,56
Queen of S't,8645,5,12,10,14,50,51,-1,46
Ayr,8645,6,10,13,13,39,53,-14,43
Dunfermline,8645,7,9,15,12,48,53,-5,42
Dumbarton,8645,8,9,11,16,46,54,-8,38
St Mirren,8645,9,9,9,18,43,62,-19,36
Raith,8645,10,8,10,18,31,52,-21,34
Hibernian,8646,1,20,12,4,55,25,30,72
Dundee Utd,8646,2,17,10,9,58,45,13,61
Falkirk,8646,3,16,9,11,57,44,13,57
Morton,8646,4,15,12,9,47,40,7,57
Dunfermline,8646,5,12,12,12,50,50,0,48
Queen of S't,8646,6,12,9,15,49,52,-3,45
St Mirren,8646,7,9,11,16,42,55,-13,38
Raith,8646,8,9,10,17,35,50,-15,37
Ayr,8646,9,8,13,15,34,55,-21,37
Dumbarton,8646,10,8,10,18,50,61,-11,34
Hibernian,8647,1,22,10,4,63,22,41,76
Falkirk,8647,2,19,9,8,64,37,27,66
Morton,8647,3,16,13,7,50,37,13,61
Dundee Utd,8647,4,17,9,10,53,39,14,60
Queen of S't,8647,5,10,12,14,46,54,-8,42
Dumbarton,8647,6,9,12,15,48,62,-14,39
Raith,8647,7,9,11,16,34,52,-18,38
Dunfermline,8647,8,8,13,15,42,49,-7,37
Ayr,8647,9,7,13,16,35,62,-27,34
St Mirren,8647,10,7,10,19,37,58,-21,31
Hibernian,8648,1,21,10,5,60,26,34,73
Falkirk,8648,2,18,9,9,55,37,18,63
Dundee Utd,8648,3,16,9,11,55,39,16,57
Morton,8648,4,15,12,9,44,38,6,57
Queen of S't,8648,5,13,9,14,46,47,-1,48
Dunfermline,8648,6,10,13,13,45,48,-3,43
St Mirren,8648,7,9,11,16,41,56,-15,38
Raith,8648,8,9,11,16,33,48,-15,38
Ayr,8648,9,9,11,16,39,57,-18,38
Dumbarton,8648,10,7,11,18,41,63,-22,32
Hibernian,8649,1,17,14,5,55,28,27,65
Morton,8649,2,17,11,8,50,38,12,62
Falkirk,8649,3,15,11,10,58,43,15,56
Dundee Utd,8649,4,14,11,11,43,39,4,53
Queen of S't,8649,5,13,9,14,47,55,-8,48
Dunfermline,8649,6,11,13,12,50,46,4,46
St Mirren,8649,7,12,9,15,46,51,-5,45
Raith,8649,8,10,10,16,37,49,-12,40
Ayr,8649,9,7,14,15,35,56,-21,35
Dumbarton,8649,10,8,10,18,45,61,-16,34
Hibernian,8650,1,20,12,4,55,24,31,72
Falkirk,8650,2,17,12,7,61,39,22,63
Morton,8650,3,14,13,9,47,38,9,55
Dundee Utd,8650,4,15,9,12,51,44,7,54
Queen of S't,8650,5,12,10,14,44,48,-4,46
Dumbarton,8650,6,11,12,13,52,56,-4,45
Raith,8650,7,12,9,15,43,49,-6,45
Dunfermline,8650,8,7,14,15,44,55,-11,35
St Mirren,8650,9,8,11,17,38,57,-19,35
Ayr,8650,10,7,12,17,32,57,-25,33
Morton,8651,1,18,12,6,50,32,18,66
Hibernian,8651,2,17,13,6,53,29,24,64
Dundee Utd,8651,3,17,9,10,50,38,12,60
Falkirk,8651,4,16,10,10,57,43,14,58
Queen of S't,8651,5,12,9,15,46,50,-4,45
Raith,8651,6,10,11,15,40,51,-11,41
Dumbarton,8651,7,10,10,16,47,57,-10,40
Dunfermline,8651,8,8,15,13,45,49,-4,39
St Mirren,8651,9,9,10,17,39,55,-16,37
Ayr,8651,10,8,11,17,32,55,-23,35
Hibernian,8652,1,19,12,5,60,31,29,69
Morton,8652,2,15,13,8,44,36,8,58
Dundee Utd,8652,3,15,10,11,52,43,9,55
Falkirk,8652,4,14,12,10,60,44,16,54
Queen of S't,8652,5,13,10,13,46,47,-1,49
Dunfermline,8652,6,11,12,13,44,46,-2,45
Dumbarton,8652,7,10,12,14,51,56,-5,42
Raith,8652,8,9,12,15,32,48,-16,39
St Mirren,8652,9,9,10,17,39,57,-18,37
Ayr,8652,10,7,13,16,34,54,-20,34
Morton,8653,1,21,10,5,52,31,21,73
Hibernian,8653,2,18,13,5,54,26,28,67
Falkirk,8653,3,17,11,8,58,39,19,62
Dundee Utd,8653,4,17,10,9,60,34,26,61
Dunfermline,8653,5,10,12,14,50,52,-2,42
Raith,8653,6,11,8,17,33,50,-17,41
Queen of S't,8653,7,10,10,16,44,55,-11,40
Ayr,8653,8,8,12,16,30,53,-23,36
Dumbarton,8653,9,8,10,18,47,66,-19,34
St Mirren,8653,10,7,10,19,39,61,-22,31
Hibernian,8654,1,20,13,3,54,23,31,73
Falkirk,8654,2,17,10,9,64,40,24,61
Morton,8654,3,16,11,9,47,35,12,59
Dundee Utd,8654,4,16,10,10,55,41,14,58
Queen of S't,8654,5,12,9,15,46,58,-12,45
Dunfermline,8654,6,10,13,13,45,48,-3,43
Dumbarton,8654,7,10,11,15,45,56,-11,41
Ayr,8654,8,8,13,15,37,57,-20,37
Raith,8654,9,8,10,18,37,57,-20,34
St Mirren,8654,10,7,12,17,43,58,-15,33
Hibernian,8655,1,19,13,4,59,25,34,70
Falkirk,8655,2,18,10,8,66,43,23,64
Morton,8655,3,15,12,9,48,38,10,57
Dundee Utd,8655,4,16,8,12,53,42,11,56
Dunfermline,8655,5,12,12,12,48,48,0,48
Queen of S't,8655,6,12,8,16,45,54,-9,44
St Mirren,8655,7,9,11,16,41,57,-16,38
Dumbarton,8655,8,9,10,17,49,63,-14,37
Ayr,8655,9,8,13,15,36,57,-21,37
Raith,8655,10,9,9,18,32,50,-18,36
Hibernian,8656,1,20,12,4,64,25,39,72
Morton,8656,2,18,11,7,56,42,14,65
Falkirk,8656,3,17,11,8,66,42,24,62
Dundee Utd,8656,4,16,8,12,54,43,11,56
Queen of S't,8656,5,12,10,14,45,50,-5,46
Dunfermline,8656,6,8,14,14,45,55,-10,38
Raith,8656,7,9,11,16,33,54,-21,38
St Mirren,8656,8,9,10,17,45,60,-15,37
Dumbarton,8656,9,8,12,16,49,58,-9,36
Ayr,8656,10,7,13,16,35,63,-28,34
Hibernian,8657,1,21,10,5,56,24,32,73
Morton,8657,2,15,14,7,48,34,14,59
Dundee Utd,8657,3,16,10,10,49,40,9,58
Falkirk,8657,4,14,11,11,56,42,14,53
Queen of S't,8657,5,12,9,15,46,51,-5,45
Dunfermline,8657,6,10,14,12,48,49,-1,44
Raith,8657,7,10,11,15,35,48,-13,41
Dumbarton,8657,8,9,12,15,45,57,-12,39
Ayr,8657,9,8,12,16,34,55,-21,36
St Mirren,8657,10,7,13,16,39,56,-17,34
Hibernian,8658,1,18,14,4,54,26,28,68
Falkirk,8658,2,15,12,9,58,44,14,57
Morton,8658,3,15,12,9,51,38,13,57
Dundee Utd,8658,4,14,12,10,52,41,11,54
Dumbarton,8658,5,13,11,12,55,54,1,50
Queen of S't,8658,6,11,10,15,42,51,-9,43
Raith,8658,7,10,12,14,34,44,-10,42
Dunfermline,8658,8,8,16,12,42,46,-4,40
St Mirren,8658,9,8,10,18,38,59,-21,34
Ayr,8658,10,7,13,16,34,57,-23,34
Morton,8659,1,19,10,7,60,37,23,67
Falkirk,8659,2,18,11,7,59,36,23,65
Hibernian,8659,3,16,16,4,55,28,27,64
Dundee Utd,8659,4,14,11,11,48,40,8,53
Dunfermline,8659,5,10,12,14,46,52,-6,42
Queen of S't,8659,6,10,12,14,40,47,-7,42
Dumbarton,8659,7,9,12,15,44,57,-13,39
Raith,8659,8,9,10,17,34,51,-17,37
St Mirren,8659,9,8,12,16,41,54,-13,36
Ayr,8659,10,8,12,16,33,58,-25,36
Hibernian,8660,1,20,13,3,61,22,39,73
Morton,8660,2,15,14,7,54,42,12,59
Falkirk,8660,3,15,10,11,55,50,5,55
Dundee Utd,8660,4,13,13,10,45,39,6,52
Raith,8660,5,12,11,13,43,44,-1,47
Dunfermline,8660,6,9,16,11,49,47,2,43
St Mirren,8660,7,9,12,15,42,52,-10,39
Queen of S't,8660,8,10,9,17,44,58,-14,39
Dumbarton,8660,9,9,10,17,46,62,-16,37
Ayr,8660,10,8,12,16,34,57,-23,36
Hibernian,8661,1,20,12,4,57,26,31,72
Falkirk,8661,2,18,9,9,59,40,19,63
Dundee Utd,8661,3,18,8,10,50,36,14,62
Morton,8661,4,15,13,8,52,38,14,58
Queen of S't,8661,5,11,10,15,43,47,-4,43
Dunfermline,8661,6,9,13,14,44,53,-9,40
Ayr,8661,7,9,13,14,35,50,-15,40
Dumbarton,8661,8,9,11,16,51,63,-12,38
Raith,8661,9,8,11,17,36,54,-18,35
St Mirren,8661,10,8,10,18,40,60,-20,34
Hibernian,8662,1,20,12,4,57,23,34,72
Morton,8662,2,16,13,7,54,39,15,61
Falkirk,8662,3,15,11,10,57,45,12,56
Dundee Utd,8662,4,14,12,10,47,39,8,54
Dunfermline,8662,5,12,12,12,50,48,2,48
Queen of S't,8662,6,13,9,14,47,46,1,48
Dumbarton,8662,7,10,11,15,47,55,-8,41
Raith,8662,8,10,8,18,35,55,-20,38
Ayr,8662,9,7,14,15,31,54,-23,35
St Mirren,8662,10,7,10,19,39,60,-21,31
Hibernian,8663,1,18,12,6,58,28,30,66
Falkirk,8663,2,17,10,9,63,43,20,61
Morton,8663,3,17,10,9,50,40,10,61
Dundee Utd,8663,4,17,8,11,52,40,12,59
Queen of S't,8663,5,13,9,14,47,47,0,48
Dunfermline,8663,6,10,14,12,46,45,1,44
Raith,8663,7,12,8,16,38,52,-14,44
Ayr,8663,8,9,10,17,35,60,-25,37
Dumbarton,8663,9,8,11,17,44,59,-15,35
St Mirren,8663,10,8,10,18,40,59,-19,34
Hibernian,8664,1,19,12,5,58,25,33,69
Morton,8664,2,18,11,7,50,35,15,65
Falkirk,8664,3,17,9,10,63,42,21,60
Dundee Utd,8664,4,15,10,11,48,40,8,55
Queen of S't,8664,5,12,8,16,47,53,-6,44
Dunfermline,8664,6,10,12,14,45,51,-6,42
Raith,8664,7,11,9,16,35,49,-14,42
Dumbarton,8664,8,9,14,13,52,60,-8,41
St Mirren,8664,9,9,12,15,45,57,-12,39
Ayr,8664,10,6,11,19,27,58,-31,29
Hibernian,8665,1,19,11,6,50,25,25,68
Morton,8665,2,17,12,7,53,35,18,63
Dundee Utd,8665,3,15,11,10,52,42,10,56
Falkirk,8665,4,13,12,11,54,49,5,51
Dunfermline,8665,5,10,14,12,50,50,0,44
Raith,8665,6,12,8,16,42,49,-7,44
Queen of S't,8665,7,11,10,15,48,56,-8,43
Dumbarton,8665,8,10,12,14,55,57,-2,42
Ayr,8665,9,8,14,14,35,55,-20,38
St Mirren,8665,10,7,12,17,37,58,-21,33
Hibernian,8666,1,20,12,4,58,29,29,72
Falkirk,8666,2,17,9,10,63,46,17,60
Morton,8666,3,16,12,8,46,36,10,60
Dundee Utd,8666,4,15,9,12,53,44,9,54
Dumbarton,8666,5,11,11,14,50,60,-10,44
Dunfermline,8666,6,9,14,13,47,47,0,41
Queen of S't,8666,7,10,11,15,41,51,-10,41
Raith,8666,8,10,11,15,39,51,-12,41
Ayr,8666,9,9,11,16,38,53,-15,38
St Mirren,8666,10,8,10,18,41,59,-18,34
Hibernian,8667,1,18,13,5,54,28,26,67
Morton,8667,2,17,14,5,53,33,20,65
Dundee Utd,8667,3,17,10,9,52,39,13,61
Falkirk,8667,4,15,9,12,57,43,14,54
Queen of S't,8667,5,13,10,13,46,46,0,49
Dunfermline,8667,6,9,16,11,48,47,1,43
Ayr,8667,7,10,10,16,39,57,-18,40
Raith,8667,8,10,9,17,34,53,-19,39
Dumbarton,8667,9,8,11,17,50,66,-16,35
St Mirren,8667,10,6,12,18,37,58,-21,30
Hibernian,8668,1,19,11,6,57,27,30,68
Morton,8668,2,17,10,9,47,38,9,61
Falkirk,8668,3,16,12,8,60,39,21,60
Dundee Utd,8668,4,15,11,10,49,41,8,56
Queen of S't,8668,5,13,9,14,46,50,-4,48
Dunfermline,8668,6,9,14,13,47,47,0,41
Raith,8668,7,11,8,17,34,49,-15,41
Ayr,8668,8,10,11,15,35,52,-17,41
Dumbarton,8668,9,8,14,14,44,55,-11,38
St Mirren,8668,10,7,10,19,37,58,-21,31
Morton,8669,1,18,13,5,54,34,20,67
Hibernian,8669,2,17,11,8,53,33,20,62
Falkirk,8669,3,15,10,11,57,42,15,55
Dundee Utd,8669,4,15,10,11,48,40,8,55
Queen of S't,8669,5,13,11,12,49,46,3,50
Ayr,8669,6,11,11,14,42,55,-13,44
Dunfermline,8669,7,10,13,13,49,50,-1,43
Dumbarton,8669,8,10,10,16,45,61,-16,40
Raith,8669,9,9,11,16,37,51,-14,38
St Mirren,8669,10,7,10,19,38,60,-22,31
Hibernian,8670,1,21,11,4,55,23,32,74
Dundee Utd,8670,2,17,11,8,56,41,15,62
Morton,8670,3,16,12,8,48,36,12,60
Falkirk,8670,4,16,11,9,60,43,17,59
Queen of S't,8670,5,11,10,15,42,49,-7,43
Dunfermline,8670,6,8,15,13,41,45,-4,39
Dumbarton,8670,7,8,14,14,49,58,-9,38
Ayr,8670,8,8,13,15,36,57,-21,37
Raith,8670,9,8,11,17,34,51,-17,35
St Mirren,8670,10,7,12,17,39,57,-18,33
Hibernian,8671,1,21,11,4,59,23,36,74
Morton,8671,2,16,11,9,51,38,13,59
Falkirk,8671,3,16,10,10,60,43,17,58
Dundee Utd,8671,4,16,10,10,57,43,14,58
Queen of S't,8671,5,12,9,15,49,58,-9,45
Dunfermline,8671,6,10,11,15,43,57,-14,41
Ayr,8671,7,9,12,15,33,51,-18,39
Dumbarton,8671,8,9,11,16,50,61,-11,38
Raith,8671,9,9,11,16,32,49,-17,38
St Mirren,8671,10,9,10,17,43,54,-11,37
Hibernian,8672,1,22,10,4,60,22,38,76
Dundee Utd,8672,2,18,9,9,56,38,18,63
Falkirk,8672,3,17,9,10,61,44,17,60
Morton,8672,4,15,12,9,47,36,11,57
Queen of S't,8672,5,12,8,16,48,58,-10,44
Dumbarton,8672,6,9,13,14,50,58,-8,40
Dunfermline,8672,7,9,12,15,43,54,-11,39
St Mirren,8672,8,9,12,15,40,53,-13,39
Raith,8672,9,9,8,19,34,53,-19,35
Ayr,8672,10,8,11,17,39,62,-23,35
Hibernian,8673,1,17,12,7,53,30,23,63
Dundee Utd,8673,2,17,10,9,50,34,16,61
Falkirk,8673,3,16,11,9,64,43,21,59
Morton,8673,4,16,11,9,51,40,11,59
Raith,8673,5,12,10,14,40,46,-6,46
Queen of S't,8673,6,12,9,15,45,56,-11,45
Dunfermline,8673,7,10,13,13,46,48,-2,43
St Mirren,8673,8,10,10,16,41,54,-13,40
Dumbarton,8673,9,9,10,17,49,63,-14,37
Ayr,8673,10,8,10,18,31,56,-25,34
Hibernian,8674,1,16,13,7,49,27,22,61
Morton,8674,2,16,13,7,49,33,16,61
Falkirk,8674,3,15,12,9,54,40,14,57
Dundee Utd,8674,4,14,11,11,50,42,8,53
Queen of S't,8674,5,12,9,15,45,47,-2,45
Raith,8674,6,10,13,13,36,46,-10,43
Dumbarton,8674,7,10,12,14,45,52,-7,42
Dunfermline,8674,8,10,12,14,45,53,-8,42
Ayr,8674,9,9,14,13,35,52,-17,41
St Mirren,8674,10,6,15,15,40,56,-16,33
Hibernian,8675,1,21,11,4,62,23,39,74
Morton,8675,2,16,12,8,50,39,11,60
Falkirk,8675,3,15,12,9,59,44,15,57
Dundee Utd,8675,4,14,10,12,50,46,4,52
Queen of S't,8675,5,13,9,14,48,50,-2,48
Raith,8675,6,12,8,16,40,51,-11,44
Dunfermline,8675,7,9,14,13,45,47,-2,41
Ayr,8675,8,9,13,14,36,52,-16,40
Dumbarton,8675,9,8,13,15,47,60,-13,37
St Mirren,8675,10,6,12,18,36,61,-25,30
Hibernian,8676,1,18,13,5,55,29,26,67
Morton,8676,2,16,13,7,53,39,14,61
Dundee Utd,8676,3,15,10,11,45,42,3,55
Falkirk,8676,4,14,12,10,57,41,16,54
Queen of S't,8676,5,14,8,14,49,47,2,50
Raith,8676,6,10,13,13,37,45,-8,43
Dunfermline,8676,7,9,13,14,44,54,-10,40
St Mirren,8676,8,9,12,15,41,52,-11,39
Ayr,8676,9,9,12,15,35,51,-16,39
Dumbarton,8676,10,8,10,18,46,62,-16,34
Hibernian,8677,1,21,11,4,63,23,40,74
Dundee Utd,8677,2,16,11,9,51,37,14,59
Falkirk,8677,3,15,12,9,58,44,14,57
Morton,8677,4,15,12,9,46,41,5,57
Dunfermline,8677,5,9,16,11,48,46,2,43
Queen of S't,8677,6,11,10,15,47,55,-8,43
Ayr,8677,7,10,10,16,39,55,-16,40
Raith,8677,8,9,11,16,35,52,-17,38
Dumbarton,8677,9,8,13,15,46,61,-15,37
St Mirren,8677,10,8,10,18,41,60,-19,34
Morton,8678,1,17,12,7,50,35,15,63
Hibernian,8678,2,17,11,8,52,26,26,62
Falkirk,8678,3,16,11,9,56,39,17,59
Dundee Utd,8678,4,16,10,10,48,38,10,58
Queen of S't,8678,5,13,8,15,48,49,-1,47
Dunfermline,8678,6,10,14,12,42,44,-2,44
Raith,8678,7,11,10,15,36,51,-15,43
Ayr,8678,8,9,11,16,36,56,-20,38
Dumbarton,8678,9,8,13,15,46,57,-11,37
St Mirren,8678,10,7,12,17,38,57,-19,33
Hibernian,8679,1,20,10,6,51,25,26,70
Dundee Utd,8679,2,18,9,9,57,41,16,63
Falkirk,8679,3,15,11,10,56,41,15,56
Morton,8679,4,15,11,10,49,38,11,56
Dunfermline,8679,5,11,13,12,47,47,0,46
Queen of S't,8679,6,12,9,15,45,53,-8,45
Raith,8679,7,11,9,16,36,45,-9,42
Dumbarton,8679,8,10,11,15,49,58,-9,41
Ayr,8679,9,7,14,15,37,58,-21,35
St Mirren,8679,10,7,11,18,37,58,-21,32
Hibernian,8680,1,19,13,4,53,24,29,70
Dundee Utd,8680,2,17,10,9,56,40,16,61
Morton,8680,3,17,10,9,49,34,15,61
Falkirk,8680,4,15,11,10,62,48,14,56
Queen of S't,8680,5,12,11,13,57,53,4,47
Dunfermline,8680,6,10,13,13,49,51,-2,43
Raith,8680,7,10,11,15,36,51,-15,41
Ayr,8680,8,8,13,15,34,57,-23,37
Dumbarton,8680,9,8,12,16,48,62,-14,36
St Mirren,8680,10,7,10,19,35,59,-24,31
Hibernian,8681,1,19,13,4,66,26,40,70
Dundee Utd,8681,2,15,12,9,52,44,8,57
Falkirk,8681,3,16,9,11,55,48,7,57
Morton,8681,4,14,12,10,49,43,6,54
Dunfermline,8681,5,11,12,13,45,46,-1,45
Queen of S't,8681,6,10,12,14,42,49,-7,42
St Mirren,8681,7,10,10,16,45,56,-11,40
Raith,8681,8,10,10,16,34,52,-18,40
Dumbarton,8681,9,9,12,15,50,57,-7,39
Ayr,8681,10,8,14,14,33,50,-17,38
Hibernian,8682,1,19,13,4,55,25,30,70
Morton,8682,2,18,13,5,52,30,22,67
Falkirk,8682,3,16,12,8,62,41,21,60
Dundee Utd,8682,4,15,8,13,50,44,6,53
Queen of S't,8682,5,12,10,14,47,51,-4,46
Ayr,8682,6,10,11,15,43,57,-14,41
Dunfermline,8682,7,9,12,15,44,53,-9,39
Raith,8682,8,10,9,17,33,51,-18,39
Dumbarton,8682,9,9,11,16,48,63,-15,38
St Mirren,8682,10,7,11,18,37,56,-19,32
Morton,8683,1,17,11,8,54,38,16,62
Hibernian,8683,2,16,13,7,48,30,18,61
Dundee Utd,8683,3,17,10,9,52,35,17,61
Falkirk,8683,4,16,10,10,57,40,17,58
Queen of S't,8683,5,11,11,14,43,50,-7,44
St Mirren,8683,6,11,10,15,40,51,-11,43
Raith,8683,7,9,13,14,37,50,-13,40
Dunfermline,8683,8,8,15,13,50,53,-3,39
Ayr,8683,9,9,12,15,33,52,-19,39
Dumbarton,8683,10,8,11,17,45,60,-15,35
Hibernian,8684,1,20,12,4,56,26,30,72
Dundee Utd,8684,2,18,8,10,55,40,15,62
Morton,8684,3,16,11,9,51,36,15,59
Falkirk,8684,4,15,10,11,57,46,11,55
Queen of S't,8684,5,12,8,16,43,48,-5,44
Dunfermline,8684,6,10,13,13,45,47,-2,43
Dumbarton,8684,7,11,10,15,46,58,-12,43
Ayr,8684,8,9,11,16,35,55,-20,38
St Mirren,8684,9,8,12,16,40,52,-12,36
Raith,8684,10,9,9,18,34,54,-20,36
Hibernian,8685,1,19,11,6,57,28,29,68
Morton,8685,2,17,13,6,54,30,24,64
Dundee Utd,8685,3,18,8,10,50,40,10,62
Falkirk,8685,4,15,9,12,56,46,10,54
Queen of S't,8685,5,11,11,14,47,51,-4,44
Raith,8685,6,11,10,15,33,45,-12,43
Dumbarton,8685,7,9,12,15,48,59,-11,39
Dunfermline,8685,8,9,12,15,44,56,-12,39
St Mirren,8685,9,9,11,16,42,53,-11,38
Ayr,8685,10,7,13,16,31,54,-23,34
Hibernian,8686,1,19,14,3,60,26,34,71
Morton,8686,2,18,10,8,49,34,15,64
Falkirk,8686,3,16,10,10,59,46,13,58
Dundee Utd,8686,4,15,10,11,50,42,8,55
Queen of S't,8686,5,12,10,14,46,47,-1,46
Raith,8686,6,12,8,16,36,46,-10,44
St Mirren,8686,7,9,12,15,41,51,-10,39
Dunfermline,8686,8,8,13,15,42,52,-10,37
Dumbarton,8686,9,8,12,16,45,56,-11,36
Ayr,8686,10,8,11,17,30,58,-28,35
Hibernian,8687,1,21,11,4,58,25,33,74
Morton,8687,2,16,14,6,53,36,17,62
Falkirk,8687,3,17,10,9,59,40,19,61
Dundee Utd,8687,4,17,9,10,52,39,13,60
Dumbarton,8687,5,10,12,14,52,57,-5,42
Raith,8687,6,11,9,16,39,47,-8,42
Queen of S't,8687,7,10,10,16,42,52,-10,40
Dunfermline,8687,8,8,12,16,40,54,-14,36
Ayr,8687,9,8,12,16,32,54,-22,36
St Mirren,8687,10,7,11,18,35,58,-23,32
Hibernian,8688,1,21,10,5,60,25,35,73
Dundee Utd,8688,2,19,9,8,58,36,22,66
Morton,8688,3,18,9,9,50,38,12,63
Falkirk,8688,4,15,9,12,54,47,7,54
Queen of S't,8688,5,14,8,14,47,48,-1,50
Raith,8688,6,11,9,16,34,45,-11,42
Dunfermline,8688,7,9,12,15,40,45,-5,39
Dumbarton,8688,8,9,11,16,49,63,-14,38
Ayr,8688,9,8,12,16,36,57,-21,36
St Mirren,8688,10,7,9,20,35,59,-24,30
Hibernian,8689,1,18,13,5,55,24,31,67
Dundee Utd,8689,2,17,11,8,51,36,15,62
Morton,8689,3,16,13,7,53,35,18,61
Falkirk,8689,4,15,11,10,55,38,17,56
Queen of S't,8689,5,12,10,14,47,53,-6,46
Dunfermline,8689,6,9,15,12,45,50,-5,42
Raith,8689,7,9,11,16,32,48,-16,38
St Mirren,8689,8,8,13,15,43,57,-14,37
Dumbarton,8689,9,8,13,15,51,66,-15,37
Ayr,8689,10,7,12,17,34,59,-25,33
Hibernian,8690,1,19,11,6,53,25,28,68
Morton,8690,2,18,10,8,53,35,18,64
Dundee Utd,8690,3,18,9,9,53,39,14,63
Falkirk,8690,4,16,12,8,54,35,19,60
Queen of S't,8690,5,11,11,14,43,48,-5,44
Dunfermline,8690,6,10,11,15,44,49,-5,41
Dumbarton,8690,7,10,11,15,47,55,-8,41
Raith,8690,8,9,10,17,33,49,-16,37
Ayr,8690,9,8,12,16,34,57,-23,36
St Mirren,8690,10,8,9,19,37,59,-22,33
Morton,8691,1,18,12,6,55,34,21,66
Hibernian,8691,2,17,13,6,56,28,28,64
Falkirk,8691,3,16,10,10,58,40,18,58
Dundee Utd,8691,4,14,10,12,47,46,1,52
Queen of S't,8691,5,13,9,14,48,49,-1,48
Dumbarton,8691,6,11,11,14,51,57,-6,44
Dunfermline,8691,7,9,14,13,41,46,-5,41
St Mirren,8691,8,10,10,16,42,54,-12,40
Raith,8691,9,8,12,16,32,52,-20,36
Ayr,8691,10,7,13,16,32,56,-24,34
Hibernian,8692,1,19,12,5,55,26,29,69
Morton,8692,2,19,10,7,51,34,17,67
Dundee Utd,8692,3,18,9,9,56,38,18,63
Falkirk,8692,4,14,11,11,54,46,8,53
Queen of S't,8692,5,13,9,14,46,48,-2,48
Raith,8692,6,11,9,16,36,49,-13,42
Dunfermline,8692,7,10,11,15,48,52,-4,41
Dumbarton,8692,8,8,12,16,47,59,-12,36
Ayr,8692,9,8,11,17,32,58,-26,35
St Mirren,8692,10,8,10,18,42,57,-15,34
Hibernian,8693,1,21,11,4,58,25,33,74
Dundee Utd,8693,2,18,8,10,54,36,18,62
Morton,8693,3,17,11,8,50,37,13,62
Falkirk,8693,4,17,9,10,60,41,19,60
Queen of S't,8693,5,13,8,15,47,54,-7,47
Raith,8693,6,10,11,15,33,45,-12,41
Dunfermline,8693,7,8,15,13,42,49,-7,39
Dumbarton,8693,8,9,11,16,46,58,-12,38
St Mirren,8693,9,8,10,18,38,54,-16,34
Ayr,8693,10,6,12,18,30,59,-29,30
Hibernian,8694,1,16,13,7,47,26,21,61
Falkirk,8694,2,16,11,9,53,37,16,59
Dundee Utd,8694,3,16,10,10,55,42,13,58
Morton,8694,4,15,12,9,47,38,9,57
Dumbarton,8694,5,12,12,12,54,52,2,48
Dunfermline,8694,6,12,12,12,48,47,1,48
Raith,8694,7,11,10,15,36,45,-9,43
Queen of S't,8694,8,10,12,14,44,50,-6,42
St Mirren,8694,9,8,10,18,37,57,-20,34
Ayr,8694,10,7,12,17,34,61,-27,33
Hibernian,8695,1,19,11,6,58,28,30,68
Morton,8695,2,18,11,7,52,34,18,65
Falkirk,8695,3,16,9,11,62,44,18,57
Dundee Utd,8695,4,15,12,9,48,41,7,57
Raith,8695,5,12,9,15,41,51,-10,45
Dunfermline,8695,6,10,13,13,46,47,-1,43
Queen of S't,8695,7,10,11,15,41,51,-10,41
Ayr,8695,8,9,13,14,37,54,-17,40
Dumbarton,8695,9,7,15,14,43,61,-18,36
St Mirren,8695,10,7,10,19,43,60,-17,31
Hibernian,8696,1,19,12,5,58,27,31,69
Morton,8696,2,19,10,7,61,35,26,67
Dundee Utd,8696,3,19,9,8,52,32,20,66
Falkirk,8696,4,15,12,9,54,40,14,57
Dunfermline,8696,5,10,14,12,49,50,-1,44
Queen of S't,8696,6,10,12,14,46,53,-7,42
Ayr,8696,7,9,12,15,34,55,-21,39
Dumbarton,8696,8,8,13,15,51,64,-13,37
Raith,8696,9,8,9,19,31,53,-22,33
St Mirren,8696,10,6,11,19,37,64,-27,29
Hibernian,8697,1,19,13,4,54,24,30,70
Morton,8697,2,19,10,7,55,34,21,67
Falkirk,8697,3,16,10,10,55,39,16,58
Dundee Utd,8697,4,15,10,11,48,43,5,55
Queen of S't,8697,5,11,10,15,41,47,-6,43
Ayr,8697,6,10,12,14,36,49,-13,42
Dunfermline,8697,7,9,13,14,43,49,-6,40
Dumbarton,8697,8,9,13,14,49,58,-9,40
Raith,8697,9,8,11,17,31,50,-19,35
St Mirren,8697,10,8,10,18,42,61,-19,34
Hibernian,8698,1,19,13,4,56,28,28,70
Dundee Utd,8698,2,19,9,8,53,37,16,66
Morton,8698,3,16,12,8,48,33,15,60
Falkirk,8698,4,16,11,9,64,41,23,59
Queen of S't,8698,5,11,11,14,44,50,-6,44
Dunfermline,8698,6,10,13,13,48,47,1,43
St Mirren,8698,7,10,9,17,41,54,-13,39
Dumbarton,8698,8,8,12,16,46,61,-15,36
Raith,8698,9,9,8,19,32,57,-25,35
Ayr,8698,10,8,10,18,32,56,-24,34
Hibernian,8699,1,19,11,6,53,25,28,68
Morton,8699,2,19,11,6,54,35,19,68
Falkirk,8699,3,19,9,8,62,37,25,66
Dundee Utd,8699,4,15,10,11,49,43,6,55
Queen of S't,8699,5,12,9,15,46,49,-3,45
Ayr,8699,6,10,10,16,39,56,-17,40
St Mirren,8699,7,9,11,16,40,53,-13,38
Raith,8699,8,10,8,18,34,52,-18,38
Dunfermline,8699,9,8,13,15,46,56,-10,37
Dumbarton,8699,10,7,12,17,45,62,-17,33
Hibernian,8700,1,18,12,6,57,32,25,66
Falkirk,8700,2,17,10,9,56,43,13,61
Morton,8700,3,15,14,7,50,33,17,59
Dundee Utd,8700,4,16,10,10,58,41,17,58
Dunfermline,8700,5,11,13,12,44,44,0,46
Queen of S't,8700,6,12,10,14,45,49,-4,46
Dumbarton,8700,7,10,11,15,49,58,-9,41
Raith,8700,8,10,9,17,36,52,-16,39
Ayr,8700,9,7,13,16,34,59,-25,34
St Mirren,8700,10,7,12,17,40,58,-18,33
Hibernian,8701,1,21,11,4,57,24,33,74
Dundee Utd,8701,2,18,9,9,49,37,12,63
Falkirk,8701,3,16,10,10,57,39,18,58
Morton,8701,4,15,12,9,48,40,8,57
Queen of S't,8701,5,13,9,14,48,51,-3,48
Raith,8701,6,13,8,15,41,47,-6,47
Dumbarton,8701,7,10,11,15,48,55,-7,41
Dunfermline,8701,8,8,12,16,41,51,-10,36
St Mirren,8701,9,7,11,18,39,59,-20,32
Ayr,8701,10,7,11,18,35,60,-25,32
Hibernian,8702,1,18,11,7,50,25,25,65
Morton,8702,2,17,11,8,50,38,12,62
Falkirk,8702,3,17,10,9,58,38,20,61
Dundee Utd,8702,4,16,8,12,51,41,10,56
Queen of S't,8702,5,13,9,14,47,52,-5,48
Raith,8702,6,12,9,15,39,50,-11,45
Ayr,8702,7,10,11,15,37,53,-16,41
Dunfermline,8702,8,8,15,13,47,51,-4,39
St Mirren,8702,9,9,9,18,42,57,-15,36
Dumbarton,8702,10,8,11,17,44,60,-16,35
Hibernian,8703,1,18,12,6,53,26,27,66
Morton,8703,2,17,13,6,53,35,18,64
Dundee Utd,8703,3,16,11,9,56,41,15,59
Falkirk,8703,4,15,12,9,56,38,18,57
Queen of S't,8703,5,13,9,14,45,48,-3,48
Dunfermline,8703,6,10,13,13,48,52,-4,43
Raith,8703,7,11,9,16,35,50,-15,42
Dumbarton,8703,8,8,12,16,43,57,-14,36
Ayr,8703,9,8,11,17,32,55,-23,35
St Mirren,8703,10,7,12,17,40,59,-19,33
Hibernian,8704,1,19,13,4,56,25,31,70
Morton,8704,2,16,12,8,51,36,15,60
Falkirk,8704,3,16,9,11,62,47,15,57
Dundee Utd,8704,4,15,12,9,56,41,15,57
Queen of S't,8704,5,14,8,14,48,49,-1,50
Dunfermline,8704,6,11,13,12,43,44,-1,46
Ayr,8704,7,8,14,14,33,53,-20,38
Dumbarton,8704,8,8,12,16,47,63,-16,36
Raith,8704,9,9,9,18,33,51,-18,36
St Mirren,8704,10,7,12,17,41,61,-20,33
Hibernian,8705,1,16,15,5,50,26,24,63
Morton,8705,2,15,13,8,48,37,11,58
Falkirk,8705,3,15,11,10,57,41,16,56
Dundee Utd,8705,4,15,11,10,51,47,4,56
Dunfermline,8705,5,10,14,12,46,47,-1,44
Queen of S't,8705,6,11,11,14,42,48,-6,44
Dumbarton,8705,7,9,14,13,50,57,-7,41
Ayr,8705,8,9,13,14,37,52,-15,40
Raith,8705,9,9,11,16,35,46,-11,38
St Mirren,8705,10,8,13,15,39,54,-15,37
Hibernian,8706,1,17,13,6,55,30,25,64
Falkirk,8706,2,17,10,9,56,42,14,61
Morton,8706,3,15,14,7,49,37,12,59
Dundee Utd,8706,4,16,10,10,49,39,10,58
Queen of S't,8706,5,13,10,13,52,48,4,49
Dunfermline,8706,6,9,16,11,51,49,2,43
Dumbarton,8706,7,10,11,15,51,60,-9,41
Raith,8706,8,10,9,17,36,48,-12,39
St Mirren,8706,9,9,9,18,37,56,-19,36
Ayr,8706,10,7,12,17,30,57,-27,33
Hibernian,8707,1,20,12,4,58,24,34,72
Morton,8707,2,17,11,8,48,35,13,62
Dundee Utd,8707,3,17,9,10,55,45,10,60
Falkirk,8707,4,15,12,9,59,44,15,57
Dunfermline,8707,5,10,12,14,46,46,0,42
Queen of S't,8707,6,11,8,17,45,53,-8,41
Dumbarton,8707,7,9,12,15,49,60,-11,39
Ayr,8707,8,9,12,15,39,56,-17,39
Raith,8707,9,9,10,17,36,56,-20,37
St Mirren,8707,10,7,14,15,38,54,-16,35
Hibernian,8708,1,21,11,4,65,22,43,74
Morton,8708,2,16,11,9,49,37,12,59
Falkirk,8708,3,14,12,10,53,45,8,54
Dundee Utd,8708,4,15,9,12,43,40,3,54
Queen of S't,8708,5,12,11,13,48,51,-3,47
St Mirren,8708,6,10,11,15,43,54,-11,41
Raith,8708,7,10,11,15,38,51,-13,41
Dunfermline,8708,8,9,13,14,43,50,-7,40
Dumbarton,8708,9,9,12,15,43,52,-9,39
Ayr,8708,10,7,13,16,31,54,-23,34
Morton,8709,1,20,10,6,53,34,19,70
Hibernian,8709,2,19,11,6,56,29,27,68
Dundee Utd,8709,3,17,9,10,55,35,20,60
Falkirk,8709,4,14,10,12,53,46,7,52
Queen of S't,8709,5,13,8,15,51,54,-3,47
Dunfermline,8709,6,10,12,14,57,53,4,42
Ayr,8709,7,10,10,16,35,57,-22,40
Raith,8709,8,10,9,17,38,53,-15,39
St Mirren,8709,9,9,10,17,37,55,-18,37
Dumbarton,8709,10,8,11,17,42,61,-19,35
Hibernian,8710,1,19,12,5,54,24,30,69
Morton,8710,2,19,11,6,52,33,19,68
Falkirk,8710,3,16,10,10,61,38,23,58
Dundee Utd,8710,4,15,12,9,48,38,10,57
Queen of S't,8710,5,12,8,16,44,53,-9,44
Dunfermline,8710,6,10,13,13,43,47,-4,43
Raith,8710,7,10,10,16,36,51,-15,40
Dumbarton,8710,8,9,11,16,46,62,-16,38
Ayr,8710,9,8,12,16,39,56,-17,36
St Mirren,8710,10,6,13,17,36,57,-21,31
Hibernian,8711,1,19,11,6,59,27,32,68
Falkirk,8711,2,17,11,8,62,43,19,62
Dundee Utd,8711,3,17,9,10,57,40,17,60
Morton,8711,4,15,11,10,46,43,3,56
Raith,8711,5,12,9,15,37,49,-12,45
Queen of S't,8711,6,11,9,16,45,57,-12,42
Dunfermline,8711,7,9,14,13,43,48,-5,41
St Mirren,8711,8,10,10,16,42,51,-9,40
Dumbarton,8711,9,8,12,16,44,57,-13,36
Ayr,8711,10,8,12,16,34,54,-20,36
Hibernian,8712,1,17,14,5,50,24,26,65
Falkirk,8712,2,17,9,10,61,41,20,60
Morton,8712,3,16,12,8,46,37,9,60
Dundee Utd,8712,4,16,9,11,51,41,10,57
St Mirren,8712,5,13,9,14,44,48,-4,48
Dunfermline,8712,6,11,12,13,47,51,-4,45
Queen of S't,8712,7,11,10,15,46,52,-6,43
Dumbarton,8712,8,10,10,16,50,57,-7,40
Raith,8712,9,9,9,18,36,55,-19,36
Ayr,8712,10,7,12,17,32,57,-25,33
Hibernian,8713,1,19,12,5,51,23,28,69
Morton,8713,2,16,12,8,46,34,12,60
Falkirk,8713,3,15,12,9,59,42,17,57
Dundee Utd,8713,4,15,12,9,54,42,12,57
Queen of S't,8713,5,13,10,13,47,47,0,49
Dunfermline,8713,6,8,16,12,45,48,-3,40
St Mirren,8713,7,9,12,15,44,56,-12,39
Raith,8713,8,9,11,16,33,50,-17,38
Dumbarton,8713,9,8,13,15,42,56,-14,37
Ayr,8713,10,7,12,17,33,56,-23,33
Hibernian,8714,1,22,11,3,64,23,41,77
Morton,8714,2,17,11,8,56,44,12,62
Falkirk,8714,3,17,10,9,62,41,21,61
Dundee Utd,8714,4,16,9,11,49,38,11,57
Queen of S't,8714,5,11,9,16,44,54,-10,42
Dunfermline,8714,6,10,11,15,47,52,-5,41
Dumbarton,8714,7,10,11,15,50,58,-8,41
Raith,8714,8,10,9,17,34,54,-20,39
Ayr,8714,9,8,12,16,34,56,-22,36
St Mirren,8714,10,7,11,18,37,57,-20,32
Hibernian,8715,1,19,13,4,55,27,28,70
Falkirk,8715,2,18,11,7,58,35,23,65
Morton,8715,3,15,12,9,50,39,11,57
Dundee Utd,8715,4,13,12,11,42,39,3,51
Dunfermline,8715,5,11,14,11,49,48,1,47
Ayr,8715,6,9,13,14,37,49,-12,40
St Mirren,8715,7,9,12,15,40,51,-11,39
Queen of S't,8715,8,9,12,15,41,54,-13,39
Dumbarton,8715,9,9,10,17,48,61,-13,37
Raith,8715,10,8,11,17,30,47,-17,35
Hibernian,8716,1,20,12,4,57,28,29,72
Morton,8716,2,16,11,9,50,38,12,59
Falkirk,8716,3,16,10,10,57,42,15,58
Dundee Utd,8716,4,16,8,12,51,45,6,56
Queen of S't,8716,5,12,10,14,47,52,-5,46
Raith,8716,6,11,11,14,38,45,-7,44
Dunfermline,8716,7,9,13,14,45,49,-4,40
Dumbarton,8716,8,10,10,16,51,60,-9,40
Ayr,8716,9,9,11,16,37,55,-18,38
St Mirren,8716,10,8,10,18,36,55,-19,34
Hibernian,8717,1,18,13,5,54,28,26,67
Morton,8717,2,15,13,8,51,39,12,58
Dundee Utd,8717,3,14,14,8,54,41,13,56
Falkirk,8717,4,14,11,11,56,46,10,53
Dunfermline,8717,5,9,16,11,47,50,-3,43
Queen of S't,8717,6,11,10,15,45,51,-6,43
Dumbarton,8717,7,10,12,14,50,57,-7,42
Raith,8717,8,10,11,15,33,45,-12,41
St Mirren,8717,9,9,12,15,43,56,-13,39
Ayr,8717,10,7,14,15,35,55,-20,35
Hibernian,8718,1,19,13,4,58,24,34,70
Morton,8718,2,17,12,7,49,36,13,63
Dundee Utd,8718,3,17,10,9,57,41,16,61
Falkirk,8718,4,15,10,11,53,47,6,55
Raith,8718,5,12,8,16,41,47,-6,44
Queen of S't,8718,6,11,10,15,43,50,-7,43
Dumbarton,8718,7,10,12,14,50,55,-5,42
Dunfermline,8718,8,9,14,13,47,49,-2,41
Ayr,8718,9,7,12,17,33,62,-29,33
St Mirren,8718,10,7,11,18,37,57,-20,32
Hibernian,8719,1,19,12,5,60,30,30,69
Dundee Utd,8719,2,17,10,9,49,36,13,61
Morton,8719,2,16,13,7,49,36,13,61
Falkirk,8719,4,14,10,12,56,44,12,52
Raith,8719,5,12,8,16,42,55,-13,44
Dunfermline,8719,6,10,13,13,51,52,-1,43
Queen of S't,8719,7,11,9,16,43,52,-9,42
Dumbarton,8719,8,9,14,13,51,58,-7,41
St Mirren,8719,9,8,13,15,41,55,-14,37
Ayr,8719,10,6,14,16,34,58,-24,32
Hibernian,8720,1,19,13,4,55,25,30,70
Morton,8720,2,16,12,8,47,34,13,60
Dundee Utd,8720,3,16,10,10,54,40,14,58
Falkirk,8720,4,15,9,12,56,45,11,54
Queen of S't,8720,5,12,12,12,47,46,1,48
Dumbarton,8720,6,10,13,13,56,61,-5,43
Ayr,8720,7,10,12,14,36,50,-14,42
Raith,8720,8,10,11,15,32,46,-14,41
Dunfermline,8720,9,8,13,15,47,52,-5,37
St Mirren,8720,10,7,9,20,37,68,-31,30
Hibernian,8721,1,18,12,6,52,26,26,66
Morton,8721,2,16,14,6,52,35,17,62
Falkirk,8721,3,16,12,8,61,39,22,60
Dundee Utd,8721,4,15,11,10,50,42,8,56
Dunfermline,8721,5,10,14,12,50,51,-1,44
Dumbarton,8721,6,11,11,14,54,59,-5,44
Queen of S't,8721,7,10,9,17,43,52,-9,39
Ayr,8721,8,9,12,15,34,52,-18,39
Raith,8721,9,9,10,17,29,49,-20,37
St Mirren,8721,10,9,9,18,37,57,-20,36
Hibernian,8722,1,20,11,5,60,29,31,71
Dundee Utd,8722,2,19,8,9,53,36,17,65
Morton,8722,3,16,12,8,49,38,11,60
Falkirk,8722,4,14,12,10,55,42,13,54
Queen of S't,8722,5,13,9,14,50,49,1,48
Dunfermline,8722,6,9,13,14,47,55,-8,40
Raith,8722,7,10,10,16,38,52,-14,40
Ayr,8722,8,9,11,16,37,54,-17,38
Dumbarton,8722,9,8,11,17,45,62,-17,35
St Mirren,8722,10,8,11,17,39,56,-17,35
Hibernian,8723,1,20,10,6,59,26,33,70
Morton,8723,2,19,10,7,50,33,17,67
Dundee Utd,8723,3,17,11,8,54,39,15,62
Falkirk,8723,4,17,10,9,60,41,19,61
Queen of S't,8723,5,11,10,15,41,51,-10,43
Raith,8723,6,9,12,15,37,50,-13,39
Dunfermline,8723,7,8,14,14,42,50,-8,38
St Mirren,8723,8,9,10,17,44,59,-15,37
Ayr,8723,9,8,12,16,35,57,-22,36
Dumbarton,8723,10,7,11,18,45,61,-16,32
Hibernian,8724,1,19,14,3,53,22,31,71
Dundee Utd,8724,2,17,10,9,53,38,15,61
Falkirk,8724,3,16,11,9,58,41,17,59
Morton,8724,4,13,12,11,44,40,4,51
Dunfermline,8724,5,10,14,12,47,48,-1,44
Raith,8724,6,11,11,14,37,46,-9,44
Queen of S't,8724,7,11,10,15,45,49,-4,43
Dumbarton,8724,8,9,13,14,46,56,-10,40
St Mirren,8724,9,8,11,17,39,55,-16,35
Ayr,8724,10,7,12,17,29,56,-27,33
Hibernian,8725,1,19,10,7,54,27,27,67
Falkirk,8725,2,18,10,8,62,42,20,64
Morton,8725,3,17,10,9,49,38,11,61
Dundee Utd,8725,4,16,9,11,55,43,12,57
Queen of S't,8725,5,14,8,14,46,48,-2,50
Dunfermline,8725,6,11,11,14,52,49,3,44
St Mirren,8725,7,10,9,17,42,52,-10,39
Raith,8725,8,10,9,17,35,53,-18,39
Dumbarton,8725,9,8,11,17,48,65,-17,35
Ayr,8725,10,8,11,17,36,62,-26,35
Morton,8726,1,19,10,7,56,37,19,67
Hibernian,8726,2,17,14,5,51,26,25,65
Falkirk,8726,3,17,10,9,59,41,18,61
Dundee Utd,8726,4,15,10,11,56,44,12,55
Dunfermline,8726,5,9,15,12,47,50,-3,42
Queen of S't,8726,6,10,12,14,44,50,-6,42
St Mirren,8726,7,10,10,16,43,55,-12,40
Ayr,8726,8,9,13,14,36,56,-20,40
Raith,8726,9,9,10,17,38,51,-13,37
Dumbarton,8726,10,7,12,17,44,64,-20,33
Hibernian,8727,1,19,13,4,56,27,29,70
Morton,8727,2,17,12,7,51,35,16,63
Falkirk,8727,3,17,11,8,56,36,20,62
Dundee Utd,8727,4,15,10,11,49,42,7,55
Raith,8727,5,11,10,15,38,48,-10,43
Dunfermline,8727,6,9,14,13,41,46,-5,41
Queen of S't,8727,7,10,11,15,44,50,-6,41
Ayr,8727,8,8,13,15,36,58,-22,37
Dumbarton,8727,9,8,12,16,46,61,-15,36
St Mirren,8727,10,8,10,18,43,57,-14,34
Hibernian,8728,1,19,10,7,59,29,30,67
Falkirk,8728,2,16,12,8,59,41,18,60
Morton,8728,3,14,13,9,46,41,5,55
Dundee Utd,8728,4,14,12,10,49,41,8,54
Dunfermline,8728,5,12,13,11,50,45,5,49
Queen of S't,8728,6,12,11,13,46,46,0,47
Raith,8728,7,11,9,16,38,52,-14,42
Ayr,8728,8,10,12,14,40,55,-15,42
Dumbarton,8728,9,7,14,15,44,58,-14,35
St Mirren,8728,10,7,10,19,38,61,-23,31
Hibernian,8729,1,20,11,5,56,28,28,71
Falkirk,8729,2,18,10,8,56,35,21,64
Morton,8729,3,17,11,8,55,36,19,62
Dundee Utd,8729,4,15,10,11,47,37,10,55
Dunfermline,8729,5,11,12,13,46,46,0,45
Queen of S't,8729,6,11,9,16,45,50,-5,42
Ayr,8729,7,10,11,15,33,55,-22,41
Dumbarton,8729,8,8,12,16,44,57,-13,36
Raith,8729,9,9,9,18,32,53,-21,36
St Mirren,8729,10,8,11,17,36,53,-17,35
Hibernian,8730,1,21,12,3,57,23,34,75
Falkirk,8730,2,17,10,9,64,43,21,61
Morton,8730,3,16,11,9,48,37,11,59
Dundee Utd,8730,4,16,9,11,51,41,10,57
Dumbarton,8730,5,10,13,13,51,53,-2,43
Dunfermline,8730,6,9,14,13,45,48,-3,41
Queen of S't,8730,7,10,10,16,41,50,-9,40
Raith,8730,8,9,11,16,33,53,-20,38
Ayr,8730,9,9,10,17,34,57,-23,37
St Mirren,8730,10,8,10,18,40,59,-19,34
Hibernian,8731,1,18,12,6,52,26,26,66
Morton,8731,2,17,12,7,54,43,11,63
Dundee Utd,8731,3,15,11,10,48,38,10,56
Falkirk,8731,4,14,12,10,55,44,11,54
Queen of S't,8731,5,13,8,15,48,47,1,47
Ayr,8731,6,11,12,13,37,51,-14,45
Dunfermline,8731,7,11,11,14,46,50,-4,44
Raith,8731,8,11,9,16,42,51,-9,42
Dumbarton,8731,9,8,13,15,45,56,-11,37
St Mirren,8731,10,7,10,19,40,61,-21,31
Hibernian,8732,1,20,13,3,55,22,33,73
Morton,8732,2,16,12,8,46,33,13,60
Dundee Utd,8732,3,16,11,9,52,39,13,59
Falkirk,8732,4,15,9,12,53,42,11,54
Queen of S't,8732,5,12,9,15,43,49,-6,45
Dunfermline,8732,6,10,12,14,46,53,-7,42
Dumbarton,8732,7,10,12,14,45,52,-7,42
St Mirren,8732,8,9,11,16,41,51,-10,38
Raith,8732,9,8,12,16,35,52,-17,36
Ayr,8732,10,7,13,16,31,54,-23,34
Hibernian,8733,1,21,12,3,58,22,36,75
Morton,8733,2,18,11,7,58,34,24,65
Falkirk,8733,3,16,10,10,57,41,16,58
Dundee Utd,8733,4,16,10,10,50,42,8,58
Raith,8733,5,11,11,14,42,48,-6,44
Dumbarton,8733,6,10,13,13,49,55,-6,43
Dunfermline,8733,7,8,15,13,44,51,-7,39
Queen of S't,8733,8,10,9,17,40,50,-10,39
Ayr,8733,9,7,11,18,30,58,-28,32
St Mirren,8733,10,7,10,19,39,66,-27,31
Hibernian,8734,1,19,11,6,52,30,22,68
Morton,8734,2,18,10,8,53,37,16,64
Falkirk,8734,3,17,11,8,60,40,20,62
Dundee Utd,8734,4,15,9,12,46,41,5,54
Dunfermline,8734,5,11,14,11,42,43,-1,47
Queen of S't,8734,6,10,11,15,43,49,-6,41
Ayr,8734,7,9,13,14,34,50,-16,40
Dumbarton,8734,8,8,14,14,50,59,-9,38
Raith,8734,9,9,10,17,36,48,-12,37
St Mirren,8734,10,6,13,17,38,57,-19,31
Hibernian,8735,1,21,12,3,59,27,32,75
Morton,8735,2,16,13,7,48,35,13,61
Dundee Utd,8735,3,16,10,10,53,41,12,58
Falkirk,8735,4,14,12,10,59,45,14,54
Ayr,8735,5,11,11,14,44,56,-12,44
Dunfermline,8735,6,9,15,12,47,48,-1,42
Queen of S't,8735,7,10,11,15,44,56,-12,41
Dumbarton,8735,8,9,12,15,47,56,-9,39
Raith,8735,9,9,9,18,39,54,-15,36
St Mirren,8735,10,7,11,18,36,58,-22,32
Hibernian,8736,1,19,13,4,61,27,34,70
Morton,8736,2,19,11,6,59,37,22,68
Dundee Utd,8736,3,17,9,10,49,37,12,60
Falkirk,8736,4,15,12,9,59,43,16,57
Queen of S't,8736,5,14,8,14,44,49,-5,50
St Mirren,8736,6,9,11,16,42,53,-11,38
Raith,8736,7,9,10,17,35,50,-15,37
Dunfermline,8736,8,8,12,16,42,52,-10,36
Dumbarton,8736,9,8,11,17,46,67,-21,35
Ayr,8736,10,7,13,16,31,53,-22,34
Hibernian,8737,1,20,10,6,56,28,28,70
Falkirk,8737,2,17,10,9,65,41,24,61
Morton,8737,3,17,10,9,52,38,14,61
Dundee Utd,8737,4,15,9,12,53,44,9,54
Dunfermline,8737,5,12,12,12,50,48,2,48
Dumbarton,8737,6,10,12,14,49,56,-7,42
Queen of S't,8737,7,11,8,17,43,54,-11,41
Raith,8737,8,10,8,18,34,51,-17,38
Ayr,8737,9,9,11,16,33,55,-22,38
St Mirren,8737,10,8,12,16,35,55,-20,36
Hibernian,8738,1,21,11,4,56,23,33,74
Falkirk,8738,2,19,9,8,66,40,26,66
Dundee Utd,8738,3,16,11,9,51,40,11,59
Morton,8738,4,16,10,10,49,42,7,58
Ayr,8738,5,10,13,13,46,57,-11,43
Dunfermline,8738,6,9,14,13,46,50,-4,41
Queen of S't,8738,7,10,10,16,43,53,-10,40
Raith,8738,8,9,10,17,32,52,-20,37
Dumbarton,8738,9,8,12,16,49,61,-12,36
St Mirren,8738,10,7,10,19,37,57,-20,31
Hibernian,8739,1,18,14,4,54,26,28,68
Dundee Utd,8739,2,17,11,8,49,34,15,62
Morton,8739,3,15,12,9,47,37,10,57
Falkirk,8739,4,15,11,10,56,38,18,56
Raith,8739,5,11,10,15,37,48,-11,43
Queen of S't,8739,6,11,9,16,49,57,-8,42
Dumbarton,8739,7,10,10,16,50,61,-11,40
St Mirren,8739,8,9,12,15,42,54,-12,39
Dunfermline,8739,9,9,11,16,42,52,-10,38
Ayr,8739,10,8,14,14,33,52,-19,38
Hibernian,8740,1,19,11,6,55,31,24,68
Morton,8740,2,17,11,8,54,38,16,62
Falkirk,8740,3,15,13,8,55,37,18,58
Dundee Utd,8740,4,14,13,9,46,41,5,55
Queen of S't,8740,5,11,10,15,44,49,-5,43
Raith,8740,6,11,10,15,40,49,-9,43
Dunfermline,8740,7,9,15,12,45,49,-4,42
St Mirren,8740,8,9,10,17,42,56,-14,37
Ayr,8740,9,8,13,15,35,52,-17,37
Dumbarton,8740,10,8,12,16,50,64,-14,36
Hibernian,8741,1,21,11,4,59,24,35,74
Falkirk,8741,2,18,10,8,61,37,24,64
Morton,8741,3,17,10,9,50,39,11,61
Dundee Utd,8741,4,13,11,12,45,43,2,50
Dunfermline,8741,5,11,11,14,48,51,-3,44
Queen of S't,8741,6,11,9,16,44,52,-8,42
Ayr,8741,7,10,12,14,37,54,-17,42
Raith,8741,8,11,8,17,35,49,-14,41
Dumbarton,8741,9,9,10,17,48,59,-11,37
St Mirren,8741,10,8,10,18,38,57,-19,34
Hibernian,8742,1,19,13,4,56,25,31,70
Dundee Utd,8742,2,18,8,10,54,37,17,62
Morton,8742,3,16,12,8,49,39,10,60
Falkirk,8742,4,15,10,11,56,41,15,55
Queen of S't,8742,5,14,9,13,46,45,1,51
Dunfermline,8742,6,10,12,14,48,54,-6,42
St Mirren,8742,7,10,10,16,48,56,-8,40
Dumbarton,8742,8,9,10,17,47,56,-9,37
Raith,8742,9,9,9,18,33,54,-21,36
Ayr,8742,10,8,11,17,31,61,-30,35
Hibernian,8743,1,19,13,4,60,27,33,70
Dundee Utd,8743,2,18,10,8,58,37,21,64
Morton,8743,3,17,12,7,50,38,12,63
Falkirk,8743,4,13,12,11,52,42,10,51
Queen of S't,8743,5,12,9,15,44,47,-3,45
Raith,8743,6,11,10,15,37,46,-9,43
St Mirren,8743,7,10,11,15,46,57,-11,41
Dunfermline,8743,8,8,14,14,40,48,-8,38
Dumbarton,8743,9,8,10,18,46,66,-20,34
Ayr,8743,10,7,13,16,32,57,-25,34
Hibernian,8744,1,19,12,5,56,27,29,69
Dundee Utd,8744,2,16,11,9,56,41,15,59
Morton,8744,3,14,14,8,46,40,6,56
Falkirk,8744,4,15,10,11,55,39,16,55
Queen of S't,8744,5,12,9,15,44,51,-7,45
Dumbarton,8744,6,10,12,14,48,53,-5,42
Dunfermline,8744,7,10,12,14,47,53,-6,42
Raith,8744,8,10,9,17,37,53,-16,39
Ayr,8744,9,8,14,14,39,59,-20,38
St Mirren,8744,10,8,13,15,42,54,-12,37
Hibernian,8745,1,18,13,5,54,26,28,67
Dundee Utd,8745,2,17,10,9,54,37,17,61
Falkirk,8745,3,17,9,10,63,42,21,60
Morton,8745,4,14,12,10,44,40,4,54
Dunfermline,8745,5,13,12,11,54,47,7,51
St Mirren,8745,6,11,10,15,45,52,-7,43
Raith,8745,7,10,10,16,36,55,-19,40
Queen of S't,8745,8,10,9,17,41,56,-15,39
Dumbarton,8745,9,9,10,17,55,69,-14,37
Ayr,8745,10,7,13,16,32,54,-22,34
Hibernian,8746,1,21,11,4,61,23,38,74
Morton,8746,2,18,12,6,57,39,18,66
Falkirk,8746,3,18,9,9,56,36,20,63
Dundee Utd,8746,4,15,10,11,51,41,10,55
Queen of S't,8746,5,13,9,14,54,50,4,48
Dunfermline,8746,6,10,13,13,46,51,-5,43
Ayr,8746,7,8,13,15,37,61,-24,37
St Mirren,8746,8,8,11,17,42,60,-18,35
Dumbarton,8746,9,7,12,17,45,66,-21,33
Raith,8746,10,8,8,20,36,58,-22,32
Hibernian,8747,1,19,13,4,55,25,30,70
Dundee Utd,8747,2,17,8,11,51,43,8,59
Morton,8747,3,16,9,11,47,39,8,57
Falkirk,8747,4,15,11,10,57,41,16,56
Dumbarton,8747,5,11,12,13,53,53,0,45
Dunfermline,8747,6,11,12,13,44,46,-2,45
Queen of S't,8747,7,11,9,16,41,50,-9,42
Raith,8747,8,10,10,16,33,49,-16,40
St Mirren,8747,9,9,11,16,43,55,-12,38
Ayr,8747,10,8,11,17,37,60,-23,35
Hibernian,8748,1,19,14,3,59,22,37,71
Morton,8748,2,16,12,8,46,35,11,60
Dundee Utd,8748,3,17,8,11,54,42,12,59
Falkirk,8748,4,16,10,10,61,44,17,58
Queen of S't,8748,5,11,9,16,48,59,-11,42
Ayr,8748,6,10,12,14,37,51,-14,42
Dumbarton,8748,7,10,10,16,51,64,-13,40
Dunfermline,8748,8,8,14,14,44,54,-10,38
St Mirren,8748,9,9,11,16,44,57,-13,38
Raith,8748,10,9,10,17,32,48,-16,37
Hibernian,8749,1,20,13,3,56,25,31,73
Falkirk,8749,2,17,12,7,59,35,24,63
Morton,8749,3,15,13,8,48,36,12,58
Dundee Utd,8749,4,13,14,9,47,40,7,53
Queen of S't,8749,5,11,10,15,50,54,-4,43
Raith,8749,6,11,9,16,36,51,-15,42
Dumbarton,8749,7,9,14,13,47,53,-6,41
Ayr,8749,8,9,12,15,37,53,-16,39
Dunfermline,8749,9,7,14,15,44,57,-13,35
St Mirren,8749,10,7,11,18,36,56,-20,32
Hibernian,8750,1,19,12,5,57,27,30,69
Morton,8750,2,18,13,5,50,31,19,67
Dundee Utd,8750,3,18,10,8,59,38,21,64
Falkirk,8750,4,16,10,10,57,45,12,58
Queen of S't,8750,5,11,9,16,45,54,-9,42
Dumbarton,8750,6,10,11,15,44,55,-11,41
Ayr,8750,7,9,12,15,33,56,-23,39
Raith,8750,8,10,8,18,32,47,-15,38
Dunfermline,8750,9,8,13,15,46,52,-6,37
St Mirren,8750,10,7,10,19,38,56,-18,31
Hibernian,8751,1,19,13,4,52,22,30,70
Morton,8751,2,17,10,9,47,36,11,61
Falkirk,8751,3,16,10,10,58,41,17,58
Dundee Utd,8751,4,16,9,11,50,41,9,57
Queen of S't,8751,5,12,10,14,45,48,-3,46
St Mirren,8751,6,11,9,16,49,55,-6,42
Dunfermline,8751,7,9,14,13,44,47,-3,41
Ayr,8751,8,9,12,15,36,56,-20,39
Dumbarton,8751,9,9,11,16,46,58,-12,38
Raith,8751,10,9,8,19,33,56,-23,35
Hibernian,8752,1,18,13,5,55,28,27,67
Falkirk,8752,2,17,10,9,62,38,24,61
Morton,8752,3,15,14,7,50,39,11,59
Dundee Utd,8752,4,14,11,11,49,43,6,53
Dunfermline,8752,5,13,12,11,48,41,7,51
Queen of S't,8752,6,12,9,15,48,55,-7,45
Dumbarton,8752,7,9,12,15,49,57,-8,39
St Mirren,8752,8,9,10,17,38,55,-17,37
Raith,8752,9,9,9,18,33,55,-22,36
Ayr,8752,10,7,14,15,30,51,-21,35
Hibernian,8753,1,19,12,5,55,26,29,69
Morton,8753,2,17,11,8,49,33,16,62
Falkirk,8753,3,16,9,11,55,40,15,57
Dundee Utd,8753,4,15,9,12,51,40,11,54
Queen of S't,8753,5,15,9,12,48,44,4,54
Dunfermline,8753,6,12,12,12,45,44,1,48
Raith,8753,7,10,11,15,36,48,-12,41
Ayr,8753,8,8,12,16,30,54,-24,36
Dumbarton,8753,9,8,10,18,43,59,-16,34
St Mirren,8753,10,8,9,19,36,60,-24,33
Hibernian,8754,1,20,11,5,60,28,32,71
Morton,8754,2,18,10,8,52,35,17,64
Dundee Utd,8754,3,15,13,8,55,45,10,58
Falkirk,8754,4,14,14,8,55,40,15,56
Queen of S't,8754,5,12,10,14,42,48,-6,46
Dunfermline,8754,6,10,11,15,48,57,-9,41
Raith,8754,7,10,10,16,34,46,-12,40
Dumbarton,8754,8,8,12,16,54,64,-10,36
Ayr,8754,9,8,12,16,36,58,-22,36
St Mirren,8754,10,7,13,16,44,59,-15,34
Hibernian,8755,1,19,12,5,63,30,33,69
Morton,8755,2,18,11,7,53,34,19,65
Falkirk,8755,3,16,10,10,57,46,11,58
Dundee Utd,8755,4,16,10,10,51,41,10,58
Raith,8755,5,13,8,15,43,49,-6,47
Queen of S't,8755,6,11,11,14,50,54,-4,44
Dunfermline,8755,7,8,16,12,45,50,-5,40
Dumbarton,8755,8,8,11,17,47,61,-14,35
Ayr,8755,9,7,13,16,30,51,-21,34
St Mirren,8755,10,8,10,18,35,58,-23,34
Morton,8756,1,17,13,6,52,35,17,64
Hibernian,8756,2,17,12,7,53,28,25,63
Falkirk,8756,3,15,11,10,59,41,18,56
Dundee Utd,8756,4,15,9,12,45,42,3,54
Dunfermline,8756,5,11,12,13,48,52,-4,45
Queen of S't,8756,6,12,9,15,45,56,-11,45
Ayr,8756,7,10,12,14,41,54,-13,42
Dumbarton,8756,8,8,15,13,49,55,-6,39
Raith,8756,9,10,9,17,36,51,-15,39
St Mirren,8756,10,8,12,16,42,56,-14,36
Hibernian,8757,1,18,13,5,53,27,26,67
Morton,8757,2,19,10,7,51,33,18,67
Falkirk,8757,3,15,14,7,59,40,19,59
Dundee Utd,8757,4,15,9,12,49,42,7,54
Dunfermline,8757,5,10,13,13,42,47,-5,43
Queen of S't,8757,6,10,11,15,44,50,-6,41
Ayr,8757,7,10,11,15,38,58,-20,41
Dumbarton,8757,8,8,14,14,48,56,-8,38
St Mirren,8757,9,9,11,16,38,51,-13,38
Raith,8757,10,8,10,18,32,50,-18,34
Hibernian,8758,1,19,12,5,56,27,29,69
Morton,8758,2,17,11,8,51,35,16,62
Dundee Utd,8758,3,17,9,10,53,43,10,60
Falkirk,8758,4,15,9,12,54,43,11,54
Dunfermline,8758,5,12,11,13,49,48,1,47
Queen of S't,8758,6,13,8,15,46,47,-1,47
Raith,8758,7,12,8,16,34,49,-15,44
Dumbarton,8758,8,9,10,17,52,65,-13,37
Ayr,8758,9,8,12,16,34,55,-21,36
St Mirren,8758,10,8,10,18,40,57,-17,34
Hibernian,8759,1,18,13,5,54,26,28,67
Morton,8759,2,17,12,7,49,35,14,63
Falkirk,8759,3,16,11,9,54,36,18,59
Dundee Utd,8759,4,15,10,11,49,42,7,55
Queen of S't,8759,5,11,10,15,42,49,-7,43
Dunfermline,8759,6,8,18,10,48,47,1,42
Dumbarton,8759,7,9,13,14,49,57,-8,40
St Mirren,8759,8,8,13,15,39,53,-14,37
Raith,8759,9,9,10,17,31,49,-18,37
Ayr,8759,10,8,12,16,31,52,-21,36
Hibernian,8760,1,20,11,5,54,26,28,71
Morton,8760,2,17,14,5,54,34,20,65
Falkirk,8760,3,16,11,9,57,36,21,59
Dundee Utd,8760,4,14,9,13,46,45,1,51
Queen of S't,8760,5,11,10,15,46,55,-9,43
Dunfermline,8760,6,9,13,14,47,51,-4,40
Dumbarton,8760,7,9,12,15,48,57,-9,39
Raith,8760,8,10,9,17,33,48,-15,39
Ayr,8760,9,9,12,15,37,56,-19,39
St Mirren,8760,10,9,11,16,42,56,-14,38
Hibernian,8761,1,20,12,4,53,22,31,72
Morton,8761,2,16,14,6,46,33,13,62
Dundee Utd,8761,3,17,9,10,49,38,11,60
Falkirk,8761,4,16,9,11,56,40,16,57
Queen of S't,8761,5,12,10,14,45,48,-3,46
Dumbarton,8761,6,10,12,14,44,52,-8,42
Dunfermline,8761,7,9,13,14,44,47,-3,40
St Mirren,8761,8,10,10,16,41,53,-12,40
Raith,8761,9,9,9,18,33,52,-19,36
Ayr,8761,10,6,12,18,30,56,-26,30
Hibernian,8762,1,16,14,6,51,30,21,62
Morton,8762,2,17,11,8,55,40,15,62
Falkirk,8762,3,16,12,8,59,37,22,60
Dundee Utd,8762,4,14,11,11,51,42,9,53
Queen of S't,8762,5,14,9,13,50,47,3,51
Dumbarton,8762,6,10,12,14,53,57,-4,42
Dunfermline,8762,7,10,12,14,45,53,-8,42
Ayr,8762,8,10,11,15,39,61,-22,41
St Mirren,8762,9,8,12,16,38,53,-15,36
Raith,8762,10,8,10,18,34,55,-21,34
Hibernian,8763,1,21,10,5,61,27,34,73
Morton,8763,2,19,10,7,50,33,17,67
Falkirk,8763,3,17,10,9,61,40,21,61
Dundee Utd,8763,4,14,10,12,46,42,4,52
Queen of S't,8763,5,12,10,14,48,51,-3,46
Dunfermline,8763,6,9,13,14,47,50,-3,40
Raith,8763,7,10,10,16,35,54,-19,40
Dumbarton,8763,8,8,13,15,50,59,-9,37
St Mirren,8763,9,9,10,17,40,56,-16,37
Ayr,8763,10,7,12,17,29,55,-26,33
Hibernian,8764,1,18,13,5,51,24,27,67
Morton,8764,2,17,13,6,53,34,19,64
Falkirk,8764,3,16,11,9,59,41,18,59
Dundee Utd,8764,4,16,10,10,54,42,12,58
Queen of S't,8764,5,11,10,15,48,55,-7,43
Raith,8764,6,11,9,16,33,44,-11,42
St Mirren,8764,7,10,11,15,41,51,-10,41
Dunfermline,8764,8,8,14,14,42,48,-6,38
Ayr,8764,9,9,10,17,34,60,-26,37
Dumbarton,8764,10,8,11,17,47,63,-16,35
Hibernian,8765,1,20,11,5,62,27,35,71
Morton,8765,2,17,11,8,53,36,17,62
Falkirk,8765,3,16,12,8,57,38,19,60
Dundee Utd,8765,4,15,11,10,51,42,9,56
Raith,8765,5,11,12,13,39,46,-7,45
Dumbarton,8765,6,11,11,14,55,59,-4,44
Queen of S't,8765,7,10,12,14,46,54,-8,42
Dunfermline,8765,8,9,14,13,46,48,-2,41
St Mirren,8765,9,7,11,18,36,63,-27,32
Ayr,8765,10,6,11,19,32,64,-32,29
Hibernian,8766,1,16,14,6,53,31,22,62
Dundee Utd,8766,2,17,10,9,53,39,14,61
Falkirk,8766,3,16,11,9,55,38,17,59
Morton,8766,4,14,12,10,47,44,3,54
Dunfermline,8766,5,12,13,11,48,44,4,49
Raith,8766,6,13,10,13,42,42,0,49
Queen of S't,8766,7,9,13,14,44,51,-7,40
Dumbarton,8766,8,9,13,14,47,55,-8,40
St Mirren,8766,9,8,10,18,41,60,-19,34
Ayr,8766,10,7,12,17,33,59,-26,33
Morton,8767,1,20,10,6,59,35,24,70
Hibernian,8767,2,19,11,6,54,28,26,68
Falkirk,8767,3,18,10,8,58,38,20,64
Dundee Utd,8767,4,14,10,12,47,43,4,52
Ayr,8767,5,10,12,14,34,48,-14,42
Dunfermline,8767,6,10,11,15,46,50,-4,41
Dumbarton,8767,7,9,12,15,44,55,-11,39
Queen of S't,8767,8,10,9,17,38,49,-11,39
Raith,8767,9,10,8,18,36,52,-16,38
St Mirren,8767,10,8,11,17,36,54,-18,35
Hibernian,8768,1,19,12,5,54,27,27,69
Falkirk,8768,2,15,12,9,53,38,15,57
Morton,8768,3,14,11,11,45,40,5,53
Dundee Utd,8768,4,14,10,12,43,38,5,52
Dunfermline,8768,5,10,14,12,48,47,1,44
Queen of S't,8768,6,11,11,14,43,47,-4,44
Ayr,8768,7,11,11,14,35,49,-14,44
Dumbarton,8768,8,10,12,14,49,57,-8,42
Raith,8768,9,10,10,16,36,51,-15,40
St Mirren,8768,10,9,11,16,41,53,-12,38
Hibernian,8769,1,21,10,5,54,24,30,73
Morton,8769,2,15,13,8,47,37,10,58
Falkirk,8769,3,15,12,9,60,41,19,57
Dundee Utd,8769,4,15,10,11,50,46,4,55
Queen of S't,8769,5,12,10,14,49,49,0,46
Dunfermline,8769,6,10,13,13,46,47,-1,43
Dumbarton,8769,7,10,13,13,49,55,-6,43
Ayr,8769,8,8,14,14,35,54,-19,38
Raith,8769,9,8,12,16,35,53,-18,36
St Mirren,8769,10,6,13,17,40,59,-19,31
Hibernian,8770,1,20,11,5,57,31,26,71
Morton,8770,2,16,12,8,50,34,16,60
Falkirk,8770,3,16,10,10,56,40,16,58
Dundee Utd,8770,4,15,10,11,45,40,5,55
Queen of S't,8770,5,11,11,14,49,56,-7,44
Dumbarton,8770,6,10,12,14,53,56,-3,42
Dunfermline,8770,7,9,14,13,42,45,-3,41
St Mirren,8770,8,10,9,17,43,57,-14,39
Raith,8770,9,9,10,17,35,51,-16,37
Ayr,8770,10,8,13,15,37,57,-20,37
Hibernian,8771,1,19,13,4,58,24,34,70
Morton,8771,2,17,12,7,55,43,12,63
Dundee Utd,8771,3,17,8,11,56,45,11,59
Falkirk,8771,4,14,12,10,56,45,11,54
Queen of S't,8771,5,13,9,14,43,47,-4,48
Dunfermline,8771,6,10,13,13,46,46,0,43
Raith,8771,7,9,12,15,33,46,-13,39
St Mirren,8771,8,9,10,17,42,57,-15,37
Dumbarton,8771,9,9,10,17,43,61,-18,37
Ayr,8771,10,8,11,17,38,56,-18,35
Hibernian,8772,1,20,10,6,61,29,32,70
Falkirk,8772,2,18,10,8,66,40,26,64
Dundee Utd,8772,3,18,8,10,57,38,19,62
Morton,8772,4,16,14,6,45,33,12,62
Queen of S't,8772,5,12,9,15,46,49,-3,45
Dunfermline,8772,6,8,15,13,43,51,-8,39
Ayr,8772,7,9,12,15,36,55,-19,39
Dumbarton,8772,8,9,11,16,50,64,-14,38
Raith,8772,9,8,10,18,34,55,-21,34
St Mirren,8772,10,7,11,18,38,62,-24,32
Hibernian,8773,1,18,10,8,51,33,18,64
Dundee Utd,8773,2,17,11,8,52,37,15,62
Morton,8773,3,17,10,9,50,39,11,61
Falkirk,8773,4,15,10,11,57,41,16,55
Queen of S't,8773,5,13,9,14,46,48,-2,48
Dumbarton,8773,6,12,10,14,51,55,-4,46
Dunfermline,8773,7,9,14,13,48,48,0,41
Raith,8773,8,11,8,17,41,54,-13,41
St Mirren,8773,9,10,9,17,42,57,-15,39
Ayr,8773,10,7,11,18,35,61,-26,32
Hibernian,8774,1,19,13,4,54,24,30,70
Morton,8774,2,18,11,7,49,33,16,65
Falkirk,8774,3,17,10,9,62,42,20,61
Dundee Utd,8774,4,16,9,11,50,44,6,57
Dunfermline,8774,5,11,12,13,48,49,-1,45
Queen of S't,8774,6,11,10,15,50,50,0,43
Raith,8774,7,9,10,17,35,54,-19,37
Dumbarton,8774,8,8,12,16,48,62,-14,36
St Mirren,8774,9,8,11,17,41,59,-18,35
Ayr,8774,10,7,14,15,41,61,-20,35
Hibernian,8775,1,19,12,5,56,23,33,69
Morton,8775,2,17,10,9,54,40,14,61
Falkirk,8775,3,16,11,9,57,39,18,59
Dundee Utd,8775,4,17,8,11,51,39,12,59
Dumbarton,8775,5,12,11,13,54,54,0,47
Dunfermline,8775,6,10,14,12,43,48,-5,44
Queen of S't,8775,7,10,12,14,44,52,-8,42
Ayr,8775,8,9,11,16,34,57,-23,38
Raith,8775,9,9,10,17,33,54,-21,37
St Mirren,8775,10,7,9,20,39,59,-20,30
Hibernian,8776,1,16,14,6,52,29,23,62
Falkirk,8776,2,16,12,8,55,39,16,60
Dundee Utd,8776,3,16,10,10,51,41,10,58
Morton,8776,4,14,14,8,43,35,8,56
Dunfermline,8776,5,10,15,11,48,46,2,45
Queen of S't,8776,6,11,11,14,44,47,-3,44
Raith,8776,7,10,11,15,39,50,-11,41
St Mirren,8776,8,9,11,16,40,53,-13,38
Dumbarton,8776,9,8,13,15,44,55,-11,37
Ayr,8776,10,8,13,15,33,54,-21,37
Hibernian,8777,1,20,11,5,54,25,29,71
Morton,8777,2,17,10,9,52,41,11,61
Falkirk,8777,3,15,11,10,56,40,16,56
Dundee Utd,8777,4,14,11,11,50,42,8,53
Queen of S't,8777,5,12,10,14,43,46,-3,46
Dumbarton,8777,6,12,10,14,47,54,-7,46
Dunfermline,8777,7,10,13,13,45,48,-3,43
St Mirren,8777,8,9,11,16,42,55,-13,38
Raith,8777,9,9,9,18,34,50,-16,36
Ayr,8777,10,8,12,16,33,55,-22,36
Hibernian,8778,1,18,13,5,58,29,29,67
Falkirk,8778,2,17,10,9,61,40,21,61
Morton,8778,3,16,11,9,52,37,15,59
Dundee Utd,8778,4,14,12,10,48,40,8,54
Queen of S't,8778,5,13,8,15,43,49,-6,47
Dumbarton,8778,6,10,12,14,49,55,-6,42
Dunfermline,8778,7,9,14,13,44,50,-6,41
Raith,8778,8,10,11,15,33,45,-12,41
Ayr,8778,9,8,14,14,33,52,-19,38
St Mirren,8778,10,7,11,18,37,61,-24,32
Dundee Utd,8779,1,17,11,8,56,39,17,62
Hibernian,8779,2,16,13,7,50,31,19,61
Falkirk,8779,3,17,9,10,57,39,18,60
Morton,8779,4,15,14,7,50,36,14,59
Dunfermline,8779,5,10,14,12,50,46,4,44
Ayr,8779,6,11,11,14,38,53,-15,44
Queen of S't,8779,7,11,9,16,45,55,-10,42
Raith,8779,8,11,9,16,35,47,-12,42
St Mirren,8779,9,9,10,17,46,59,-13,37
Dumbarton,8779,10,8,10,18,48,70,-22,34
Hibernian,8780,1,18,13,5,60,31,29,67
Morton,8780,2,16,13,7,54,40,14,61
Falkirk,8780,3,16,11,9,60,39,21,59
Dundee Utd,8780,4,16,10,10,48,40,8,58
Dunfermline,8780,5,11,13,12,51,48,3,46
Queen of S't,8780,6,11,10,15,46,55,-9,43
Raith,8780,7,11,10,15,38,50,-12,43
Ayr,8780,8,9,11,16,33,54,-21,38
Dumbarton,8780,9,7,13,16,45,57,-12,34
St Mirren,8780,10,8,10,18,38,59,-21,34
Hibernian,8781,1,18,12,6,54,30,24,66
Morton,8781,2,18,11,7,51,34,17,65
Falkirk,8781,3,16,10,10,61,42,19,58
Dundee Utd,8781,4,14,13,9,50,43,7,55
Queen of S't,8781,5,12,10,14,49,53,-4,46
Dunfermline,8781,6,10,14,12,48,48,0,44
Ayr,8781,7,9,14,13,39,54,-15,41
Dumbarton,8781,8,9,11,16,50,62,-12,38
St Mirren,8781,9,9,11,16,43,56,-13,38
Raith,8781,10,8,8,20,35,58,-23,32
Hibernian,8782,1,20,11,5,58,27,31,71
Morton,8782,2,19,10,7,58,37,21,67
Falkirk,8782,3,14,11,11,51,41,10,53
Dundee Utd,8782,4,14,10,12,50,48,2,52
Queen of S't,8782,5,13,9,14,53,49,4,48
Dunfermline,8782,6,11,12,13,45,47,-2,45
Dumbarton,8782,7,10,10,16,48,60,-12,40
St Mirren,8782,8,10,9,17,46,58,-12,39
Raith,8782,9,9,11,16,35,50,-15,38
Ayr,8782,10,7,13,16,33,60,-27,34
Hibernian,8783,1,18,14,4,51,22,29,68
Morton,8783,2,16,12,8,48,39,9,60
Dundee Utd,8783,3,16,11,9,53,37,16,59
Falkirk,8783,4,15,11,10,60,42,18,56
Queen of S't,8783,5,13,10,13,50,51,-1,49
Raith,8783,6,10,11,15,36,51,-15,41
Dunfermline,8783,7,8,15,13,46,48,-2,39
Dumbarton,8783,8,8,14,14,41,51,-10,38
St Mirren,8783,9,8,11,17,37,59,-22,35
Ayr,8783,10,8,11,17,32,54,-22,35
Hibernian,8784,1,19,12,5,59,29,30,69
Falkirk,8784,2,19,9,8,60,35,25,66
Morton,8784,3,17,11,8,47,36,11,62
Dundee Utd,8784,4,16,9,11,52,43,9,57
Queen of S't,8784,5,12,9,15,42,47,-5,45
Dunfermline,8784,6,10,14,12,46,48,-2,44
Dumbarton,8784,7,9,11,16,46,54,-8,38
Raith,8784,8,10,8,18,31,52,-21,38
Ayr,8784,9,9,10,17,31,52,-21,37
St Mirren,8784,10,8,9,19,42,60,-18,33
Morton,8785,1,21,9,6,58,32,26,72
Hibernian,8785,2,18,14,4,56,29,27,68
Falkirk,8785,3,15,11,10,55,42,13,56
Dundee Utd,8785,4,14,9,13,46,41,5,51
Dumbarton,8785,5,11,10,15,49,55,-6,43
Queen of S't,8785,6,11,9,16,45,55,-10,42
Dunfermline,8785,7,9,14,13,49,50,-1,41
Raith,8785,8,10,10,16,37,52,-15,40
Ayr,8785,9,9,11,16,33,51,-18,38
St Mirren,8785,10,9,9,18,39,60,-21,36
Hibernian,8786,1,19,13,4,56,26,30,70
Falkirk,8786,2,18,10,8,62,39,23,64
Dundee Utd,8786,3,16,10,10,49,40,9,58
Morton,8786,4,14,15,7,48,39,9,57
Dunfermline,8786,5,10,13,13,49,50,-1,43
Dumbarton,8786,6,10,11,15,49,57,-8,41
Queen of S't,8786,7,10,10,16,44,55,-11,40
Raith,8786,8,10,10,16,35,47,-12,40
St Mirren,8786,9,7,13,16,39,55,-16,34
Ayr,8786,10,7,13,16,35,58,-23,34
Hibernian,8787,1,21,10,5,58,22,36,73
Falkirk,8787,2,17,10,9,60,39,21,61
Morton,8787,3,17,10,9,50,37,13,61
Dundee Utd,8787,4,15,9,12,52,46,6,54
Queen of S't,8787,5,13,9,14,50,52,-2,48
Dunfermline,8787,6,10,11,15,45,53,-8,41
Raith,8787,7,10,9,17,36,53,-17,39
Ayr,8787,8,9,11,16,34,53,-19,38
Dumbarton,8787,9,8,13,15,51,62,-11,37
St Mirren,8787,10,9,10,17,39,58,-19,37
Hibernian,8788,1,19,13,4,58,26,32,70
Morton,8788,2,17,11,8,55,37,18,62
Dundee Utd,8788,3,17,9,10,52,40,12,60
Falkirk,8788,4,15,10,11,56,45,11,55
Queen of S't,8788,5,11,9,16,46,51,-5,42
Dunfermline,8788,6,9,13,14,43,48,-5,40
St Mirren,8788,7,9,12,15,47,58,-11,39
Dumbarton,8788,8,9,12,15,46,57,-11,39
Ayr,8788,9,9,12,15,33,51,-18,39
Raith,8788,10,9,11,16,33,56,-23,38
Hibernian,8789,1,18,14,4,55,26,29,68
Morton,8789,2,16,14,6,46,33,13,62
Falkirk,8789,3,16,12,8,59,38,21,60
Dundee Utd,8789,4,14,12,10,49,41,8,54
Dunfermline,8789,5,11,12,13,49,47,2,45
Queen of S't,8789,6,11,12,13,45,50,-5,45
Dumbarton,8789,7,9,12,15,49,58,-9,39
Raith,8789,8,10,9,17,37,53,-16,39
Ayr,8789,9,7,13,16,32,52,-20,34
St Mirren,8789,10,8,10,18,37,60,-23,34
Hibernian,8790,1,19,11,6,53,27,26,68
Morton,8790,2,19,11,6,56,35,21,68
Dundee Utd,8790,3,17,10,9,48,35,13,61
Falkirk,8790,4,15,11,10,56,40,16,56
Dumbarton,8790,5,10,12,14,52,55,-3,42
Queen of S't,8790,6,10,10,16,41,52,-11,40
Raith,8790,7,10,10,16,35,49,-14,40
Ayr,8790,8,9,11,16,35,53,-18,38
Dunfermline,8790,9,8,13,15,43,55,-12,37
St Mirren,8790,10,8,11,17,39,57,-18,35
Hibernian,8791,1,20,11,5,60,26,34,71
Morton,8791,2,20,10,6,55,34,21,70
Dundee Utd,8791,3,17,9,10,53,42,11,60
Falkirk,8791,4,16,10,10,62,45,17,58
Queen of S't,8791,5,11,12,13,43,48,-5,45
Dunfermline,8791,6,9,13,14,42,46,-4,40
Ayr,8791,7,10,10,16,31,53,-22,40
St Mirren,8791,8,9,9,18,38,57,-19,36
Dumbarton,8791,9,7,13,16,45,57,-12,34
Raith,8791,10,8,9,19,28,49,-21,33
Hibernian,8792,1,19,13,4,59,23,36,70
Falkirk,8792,2,17,10,9,60,39,21,61
Morton,8792,3,16,11,9,52,41,11,59
Dundee Utd,8792,4,16,10,10,52,40,12,58
Dumbarton,8792,5,12,10,14,50,54,-4,46
Dunfermline,8792,6,11,11,14,44,51,-7,44
Queen of S't,8792,7,10,9,17,40,51,-11,39
Raith,8792,8,10,9,17,37,53,-16,39
Ayr,8792,9,8,13,15,32,53,-21,37
St Mirren,8792,10,8,10,18,39,60,-21,34
Hibernian,8793,1,21,12,3,58,22,36,75
Falkirk,8793,2,16,10,10,54,41,13,58
Morton,8793,3,15,13,8,46,39,7,58
Dundee Utd,8793,4,14,11,11,49,43,6,53
Dumbarton,8793,5,12,12,12,51,51,0,48
Queen of S't,8793,6,12,9,15,47,48,-1,45
Raith,8793,7,11,9,16,36,47,-11,42
Dunfermline,8793,8,10,11,15,43,48,-5,41
Ayr,8793,9,7,12,17,30,55,-25,33
St Mirren,8793,10,6,13,17,36,56,-20,31
Hibernian,8794,1,18,12,6,54,28,26,66
Morton,8794,2,17,12,7,46,31,15,63
Falkirk,8794,3,16,11,9,60,38,22,59
Dundee Utd,8794,4,16,11,9,48,38,10,59
Dunfermline,8794,5,11,14,11,45,42,3,47
Raith,8794,6,12,9,15,36,47,-11,45
Dumbarton,8794,7,10,13,13,47,52,-5,43
Queen of S't,8794,8,9,10,17,43,56,-13,37
Ayr,8794,9,7,12,17,32,54,-22,33
St Mirren,8794,10,7,10,19,36,61,-25,31
Hibernian,8795,1,21,12,3,57,24,33,75
Dundee Utd,8795,2,18,9,9,54,36,18,63
Morton,8795,3,15,12,9,50,42,8,57
Falkirk,8795,4,14,10,12,55,45,10,52
Raith,8795,5,12,9,15,41,47,-6,45
Ayr,8795,6,10,11,15,37,53,-16,41
Dunfermline,8795,7,8,14,14,45,52,-7,38
St Mirren,8795,8,9,11,16,44,58,-14,38
Queen of S't,8795,9,9,11,16,39,54,-15,38
Dumbarton,8795,10,8,13,15,49,60,-11,37
Hibernian,8796,1,20,11,5,60,24,36,71
Dundee Utd,8796,2,17,10,9,56,38,18,61
Falkirk,8796,3,17,9,10,59,44,15,60
Morton,8796,4,15,13,8,45,37,8,58
Queen of S't,8796,5,12,9,15,44,50,-6,45
Raith,8796,6,10,11,15,34,47,-13,41
Dunfermline,8796,7,9,12,15,46,52,-6,39
Dumbarton,8796,8,9,12,15,54,62,-8,39
Ayr,8796,9,8,12,16,31,57,-26,36
St Mirren,8796,10,8,11,17,40,58,-18,35
Hibernian,8797,1,20,12,4,60,25,35,72
Falkirk,8797,2,16,11,9,60,44,16,59
Morton,8797,3,16,11,9,50,39,11,59
Dundee Utd,8797,4,15,11,10,52,42,10,56
Queen of S't,8797,5,12,10,14,48,47,1,46
Raith,8797,6,12,8,16,39,47,-8,44
Dunfermline,8797,7,10,12,14,47,52,-5,42
Ayr,8797,8,10,10,16,33,58,-25,40
St Mirren,8797,9,9,11,16,41,52,-11,38
Dumbarton,8797,10,7,10,19,45,69,-24,31
Hibernian,8798,1,21,10,5,61,25,36,73
Dundee Utd,8798,2,18,10,8,59,35,24,64
Falkirk,8798,3,16,10,10,59,47,12,58
Morton,8798,4,14,12,10,45,40,5,54
Queen of S't,8798,5,12,11,13,47,47,0,47
Raith,8798,6,11,10,15,37,48,-11,43
Dunfermline,8798,7,9,14,13,44,47,-3,41
Ayr,8798,8,8,13,15,33,57,-24,37
Dumbarton,8798,9,8,11,17,44,63,-19,35
St Mirren,8798,10,8,9,19,40,60,-20,33
Hibernian,8799,1,20,13,3,59,24,35,73
Dundee Utd,8799,2,17,10,9,53,36,17,61
Morton,8799,3,16,12,8,49,39,10,60
Falkirk,8799,4,15,10,11,60,45,15,55
Queen of S't,8799,5,12,12,12,48,49,-1,48
Dumbarton,8799,6,10,11,15,48,56,-8,41
Raith,8799,7,10,11,15,37,49,-12,41
Dunfermline,8799,8,8,14,14,43,48,-5,38
St Mirren,8799,9,8,9,19,40,63,-23,33
Ayr,8799,10,6,14,16,31,59,-28,32
Hibernian,8800,1,19,11,6,55,26,29,68
Dundee Utd,8800,2,17,10,9,50,38,12,61
Morton,8800,3,16,10,10,48,40,8,58
Falkirk,8800,4,15,11,10,60,44,16,56
Queen of S't,8800,5,12,10,14,49,51,-2,46
Dunfermline,8800,6,10,13,13,48,50,-2,43
St Mirren,8800,7,10,10,16,42,55,-13,40
Ayr,8800,8,10,10,16,38,52,-14,40
Raith,8800,9,10,9,17,34,51,-17,39
Dumbarton,8800,10,9,10,17,47,64,-17,37
Hibernian,8801,1,19,11,6,58,29,29,68
Falkirk,8801,2,17,11,8,60,38,22,62
Morton,8801,3,17,10,9,55,45,10,61
Dundee Utd,8801,4,17,9,10,55,40,15,60
Dunfermline,8801,5,10,12,14,46,48,-2,42
Raith,8801,6,11,9,16,36,49,-13,42
Ayr,8801,7,10,12,14,36,53,-17,42
Queen of S't,8801,8,11,8,17,41,49,-8,41
Dumbarton,8801,9,10,10,16,47,58,-11,40
St Mirren,8801,10,7,10,19,41,66,-25,31
Morton,8802,1,18,12,6,51,32,19,66
Hibernian,8802,2,16,15,5,50,26,24,63
Falkirk,8802,3,17,11,8,62,42,20,62
Dundee Utd,8802,4,15,8,13,50,47,3,53
Dumbarton,8802,5,10,13,13,47,53,-6,43
Raith,8802,6,11,9,16,36,46,-10,42
Ayr,8802,7,9,13,14,34,49,-15,40
Queen of S't,8802,8,10,9,17,41,53,-12,39
St Mirren,8802,9,9,11,16,39,51,-12,38
Dunfermline,8802,10,8,13,15,43,54,-11,37
Hibernian,8803,1,20,11,5,54,24,30,71
Morton,8803,2,18,10,8,48,32,16,64
Falkirk,8803,3,17,10,9,57,38,19,61
Dundee Utd,8803,4,15,10,11,49,41,8,55
Queen of S't,8803,5,13,9,14,45,47,-2,48
Dunfermline,8803,6,11,12,13,48,47,1,45
Raith,8803,7,10,10,16,37,48,-11,40
Dumbarton,8803,8,9,11,16,46,58,-12,38
St Mirren,8803,9,8,11,17,40,57,-17,35
Ayr,8803,10,7,10,19,30,62,-32,31
Hibernian,8804,1,17,13,6,53,28,25,64
Falkirk,8804,2,17,10,9,59,40,19,61
Morton,8804,3,16,12,8,52,38,14,60
Dundee Utd,8804,4,14,12,10,53,46,7,54
Raith,8804,5,13,9,14,36,43,-7,48
Dunfermline,8804,6,10,13,13,49,50,-1,43
Queen of S't,8804,7,11,10,15,41,50,-9,43
Dumbarton,8804,8,10,11,15,52,60,-8,41
Ayr,8804,9,7,14,15,35,56,-21,35
St Mirren,8804,10,8,10,18,39,58,-19,34
Hibernian,8805,1,19,14,3,54,22,32,71
Morton,8805,2,17,11,8,50,35,15,62
Falkirk,8805,3,17,10,9,60,39,21,61
Dundee Utd,8805,4,16,9,11,56,41,15,57
Dunfermline,8805,5,11,12,13,50,51,-1,45
Dumbarton,8805,6,11,10,15,46,57,-11,43
Ayr,8805,7,10,10,16,38,58,-20,40
Raith,8805,8,9,12,15,33,48,-15,39
Queen of S't,8805,9,9,10,17,40,53,-13,37
St Mirren,8805,10,7,10,19,36,59,-23,31
Hibernian,8806,1,19,11,6,57,30,27,68
Morton,8806,2,19,9,8,59,35,24,66
Dundee Utd,8806,3,18,9,9,58,39,19,63
Falkirk,8806,4,14,11,11,57,46,11,53
Queen of S't,8806,5,13,9,14,44,47,-3,48
Raith,8806,6,11,9,16,36,50,-14,42
Dumbarton,8806,7,10,10,16,50,58,-8,40
Dunfermline,8806,8,9,12,15,47,53,-6,39
Ayr,8806,9,9,11,16,34,60,-26,38
St Mirren,8806,10,7,11,18,38,62,-24,32
Hibernian,8807,1,19,12,5,58,27,31,69
Morton,8807,2,16,11,9,53,40,13,59
Falkirk,8807,3,16,10,10,57,41,16,58
Dundee Utd,8807,4,15,9,12,47,40,7,54
Dumbarton,8807,5,12,10,14,51,57,-6,46
Ayr,8807,6,11,11,14,38,53,-15,44
Queen of S't,8807,7,11,9,16,41,50,-9,42
Raith,8807,8,10,10,16,36,52,-16,40
St Mirren,8807,9,9,11,16,41,53,-12,38
Dunfermline,8807,10,8,13,15,38,47,-9,37
Hibernian,8808,1,20,10,6,57,28,29,70
Morton,8808,2,18,12,6,51,36,15,66
Falkirk,8808,3,17,9,10,62,43,19,60
Dundee Utd,8808,4,17,9,10,56,40,16,60
Dunfermline,8808,5,9,15,12,45,52,-7,42
Queen of S't,8808,6,11,9,16,45,54,-9,42
Dumbarton,8808,7,10,11,15,53,57,-4,41
Raith,8808,8,9,9,18,35,54,-19,36
Ayr,8808,9,8,12,16,34,55,-21,36
St Mirren,8808,10,8,10,18,38,57,-19,34
Hibernian,8809,1,18,13,5,54,27,27,67
Morton,8809,2,17,12,7,49,36,13,63
Falkirk,8809,3,16,11,9,58,43,15,59
Dundee Utd,8809,4,15,10,11,56,50,6,55
Dunfermline,8809,5,12,13,11,51,46,5,49
Queen of S't,8809,6,12,8,16,46,51,-5,44
Ayr,8809,7,9,14,13,39,54,-15,41
Raith,8809,8,8,12,16,33,50,-17,36
Dumbarton,8809,9,8,11,17,47,61,-14,35
St Mirren,8809,10,7,12,17,39,54,-15,33
Hibernian,8810,1,19,13,4,58,26,32,70
Morton,8810,2,17,13,6,54,34,20,64
Dundee Utd,8810,3,17,9,10,50,40,10,60
Falkirk,8810,4,15,10,11,55,43,12,55
Queen of S't,8810,5,11,9,16,44,49,-5,42
Dumbarton,8810,6,10,11,15,45,56,-11,41
Ayr,8810,7,10,10,16,38,55,-17,40
Raith,8810,8,9,12,15,33,49,-16,39
Dunfermline,8810,9,8,14,14,43,50,-7,38
St Mirren,8810,10,9,9,18,45,63,-18,36
Morton,8811,1,19,11,6,52,29,23,68
Hibernian,8811,2,17,13,6,55,30,25,64
Falkirk,8811,3,17,11,8,61,38,23,62
Dundee Utd,8811,4,14,8,14,47,43,4,50
Queen of S't,8811,5,11,11,14,48,52,-4,44
Raith,8811,6,10,11,15,36,47,-11,41
Ayr,8811,7,10,11,15,33,55,-22,41
Dunfermline,8811,8,9,13,14,43,50,-7,40
St Mirren,8811,9,10,9,17,43,60,-17,39
Dumbarton,8811,10,8,12,16,49,63,-14,36
Hibernian,8812,1,19,12,5,55,26,29,69
Morton,8812,2,18,10,8,50,34,16,64
Falkirk,8812,3,16,11,9,55,38,17,59
Dundee Utd,8812,4,15,10,11,48,40,8,55
Queen of S't,8812,5,13,10,13,52,48,4,49
Dunfermline,8812,6,10,13,13,49,51,-2,43
Dumbarton,8812,7,9,14,13,46,55,-9,41
Ayr,8812,8,9,12,15,34,54,-20,39
Raith,8812,9,8,10,18,30,52,-22,34
St Mirren,8812,10,7,10,19,34,55,-21,31
Hibernian,8813,1,20,11,5,63,25,38,71
Falkirk,8813,2,18,9,9,64,38,26,63
Morton,8813,3,17,10,9,48,37,11,61
Dundee Utd,8813,4,14,10,12,49,45,4,52
Queen of S't,8813,5,13,8,15,48,56,-8,47
Dunfermline,8813,6,10,12,14,44,50,-6,42
Raith,8813,7,11,9,16,38,49,-11,42
Ayr,8813,8,9,12,15,37,57,-20,39
Dumbarton,8813,9,9,11,16,45,61,-16,38
St Mirren,8813,10,8,10,18,40,58,-18,34
Hibernian,8814,1,20,10,6,58,26,32,70
Dundee Utd,8814,2,18,8,10,55,37,18,62
Morton,8814,3,16,12,8,47,37,10,60
Falkirk,8814,4,16,10,10,56,39,17,58
Raith,8814,5,12,8,16,38,47,-9,44
Dunfermline,8814,6,10,13,13,48,50,-2,43
Queen of S't,8814,7,11,8,17,44,56,-12,41
Dumbarton,8814,8,9,13,14,45,54,-9,40
Ayr,8814,9,9,10,17,33,56,-23,37
St Mirren,8814,10,8,10,18,36,58,-22,34
Hibernian,8815,1,18,13,5,52,24,28,67
Falkirk,8815,2,18,9,9,59,36,23,63
Morton,8815,3,16,12,8,50,41,9,60
Dundee Utd,8815,4,15,10,11,49,44,5,55
Queen of S't,8815,5,11,11,14,45,47,-2,44
Dumbarton,8815,6,10,12,14,48,57,-9,42
Dunfermline,8815,7,9,13,14,44,52,-8,40
Raith,8815,8,10,10,16,38,48,-10,40
St Mirren,8815,9,8,12,16,38,53,-15,36
Ayr,8815,10,7,14,15,31,52,-21,35
Hibernian,8816,1,18,11,7,52,29,23,65
Morton,8816,2,18,10,8,55,35,20,64
Falkirk,8816,3,16,13,7,62,38,24,61
Dundee Utd,8816,4,13,11,12,47,44,3,50
Queen of S't,8816,5,13,9,14,53,54,-1,48
Dunfermline,8816,6,11,11,14,46,53,-7,44
Raith,8816,7,11,9,16,39,51,-12,42
St Mirren,8816,8,10,9,17,40,56,-16,39
Ayr,8816,9,9,11,16,39,59,-20,38
Dumbarton,8816,10,8,12,16,48,62,-14,36
Hibernian,8817,1,19,14,3,55,25,30,71
Morton,8817,2,16,11,9,53,38,15,59
Falkirk,8817,3,15,10,11,56,42,14,55
Dundee Utd,8817,4,15,10,11,47,44,3,55
Queen of S't,8817,5,12,10,14,45,47,-2,46
Dumbarton,8817,6,10,12,14,49,59,-10,42
Dunfermline,8817,7,9,14,13,43,46,-3,41
Ayr,8817,8,9,13,14,38,52,-14,40
Raith,8817,9,9,11,16,31,47,-16,38
St Mirren,8817,10,9,9,18,39,56,-17,36
Hibernian,8818,1,18,13,5,54,24,30,67
Dundee Utd,8818,2,18,9,9,52,39,13,63
Morton,8818,3,17,11,8,51,39,12,62
Falkirk,8818,4,17,10,9,59,38,21,61
Raith,8818,5,13,8,15,40,46,-6,47
Dunfermline,8818,6,10,13,13,48,49,-1,43
Queen of S't,8818,7,11,9,16,42,53,-11,42
Ayr,8818,8,9,12,15,38,54,-16,39
Dumbarton,8818,9,7,11,18,42,62,-20,32
St Mirren,8818,10,7,10,19,36,58,-22,31
Hibernian,8819,1,19,12,5,54,26,28,69
Morton,8819,2,17,11,8,50,36,14,62
Dundee Utd,8819,3,17,10,9,52,39,13,61
Falkirk,8819,4,16,10,10,59,43,16,58
Dunfermline,8819,5,10,13,13,45,49,-4,43
Queen of S't,8819,6,11,10,15,44,49,-5,43
Dumbarton,8819,7,10,11,15,49,56,-7,41
Raith,8819,8,10,10,16,36,50,-14,40
St Mirren,8819,9,8,12,16,39,55,-16,36
Ayr,8819,10,7,11,18,30,55,-25,32
Hibernian,8820,1,19,11,6,56,29,27,68
Morton,8820,2,19,10,7,59,35,24,67
Falkirk,8820,3,17,10,9,59,38,21,61
Dundee Utd,8820,4,14,10,12,42,43,-1,52
Queen of S't,8820,5,13,10,13,51,50,1,49
Dumbarton,8820,6,10,12,14,51,58,-7,42
Dunfermline,8820,7,9,13,14,41,48,-7,40
St Mirren,8820,8,10,10,16,43,57,-14,40
Ayr,8820,9,9,10,17,35,56,-21,37
Raith,8820,10,8,8,20,31,54,-23,32
Hibernian,8821,1,18,13,5,52,28,24,67
Falkirk,8821,2,17,9,10,63,43,20,60
Dunfermline,8821,3,15,11,10,55,43,12,56
Dundee Utd,8821,4,14,13,9,47,39,8,55
Morton,8821,5,14,13,9,46,38,8,55
Raith,8821,6,11,9,16,35,52,-17,42
Dumbarton,8821,7,9,12,15,49,58,-9,39
St Mirren,8821,8,9,11,16,41,54,-13,38
Queen of S't,8821,9,9,9,18,45,60,-15,36
Ayr,8821,10,8,12,16,38,56,-18,36
Hibernian,8822,1,20,12,4,57,24,33,72
Morton,8822,2,19,12,5,53,32,21,69
Falkirk,8822,3,18,9,9,63,40,23,63
Dundee Utd,8822,4,15,9,12,48,41,7,54
Queen of S't,8822,5,13,8,15,45,49,-4,47
Dumbarton,8822,6,9,13,14,48,55,-7,40
Raith,8822,7,10,10,16,34,50,-16,40
Dunfermline,8822,8,8,13,15,44,54,-10,37
Ayr,8822,9,7,12,17,30,55,-25,33
St Mirren,8822,10,7,10,19,35,57,-22,31
Hibernian,8823,1,20,12,4,56,24,32,72
Morton,8823,2,18,11,7,50,35,15,65
Dundee Utd,8823,3,16,10,10,51,39,12,58
Falkirk,8823,4,14,11,11,56,45,11,53
Dunfermline,8823,5,11,12,13,44,46,-2,45
Raith,8823,6,12,8,16,35,47,-12,44
Ayr,8823,7,9,14,13,39,54,-15,41
Queen of S't,8823,8,10,9,17,45,54,-9,39
Dumbarton,8823,9,7,13,16,45,60,-15,34
St Mirren,8823,10,8,10,18,42,59,-17,34
Morton,8824,1,20,9,7,58,37,21,69
Hibernian,8824,2,17,13,6,51,27,24,64
Dundee Utd,8824,3,16,9,11,51,40,11,57
Falkirk,8824,4,14,12,10,58,42,16,54
Dunfermline,8824,5,10,14,12,47,49,-2,44
Dumbarton,8824,6,10,11,15,52,62,-10,41
St Mirren,8824,7,10,10,16,44,61,-17,40
Queen of S't,8824,8,10,9,17,41,54,-13,39
Ayr,8824,9,9,12,15,38,54,-16,39
Raith,8824,10,9,11,16,40,54,-14,38
Hibernian,8825,1,21,11,4,55,22,33,74
Morton,8825,2,19,10,7,54,32,22,67
Falkirk,8825,3,18,9,9,61,40,21,63
Dundee Utd,8825,4,16,9,11,51,41,10,57
Dunfermline,8825,5,11,12,13,45,45,0,45
Queen of S't,8825,6,10,10,16,43,53,-10,40
Raith,8825,7,10,9,17,35,51,-16,39
St Mirren,8825,8,9,9,18,42,59,-17,36
Ayr,8825,9,8,11,17,34,57,-23,35
Dumbarton,8825,10,8,10,18,44,64,-20,34
Hibernian,8826,1,19,12,5,53,25,28,69
Morton,8826,2,17,11,8,48,36,12,62
Falkirk,8826,3,17,9,10,56,39,17,60
Dundee Utd,8826,4,16,11,9,54,43,11,59
Dunfermline,8826,5,10,12,14,41,45,-4,42
Queen of S't,8826,6,10,10,16,45,56,-11,40
Raith,8826,7,10,10,16,39,50,-11,40
Dumbarton,8826,8,9,12,15,45,55,-10,39
Ayr,8826,9,7,16,13,31,49,-18,37
St Mirren,8826,10,8,11,17,44,58,-14,35
Morton,8827,1,18,12,6,50,34,16,66
Hibernian,8827,2,17,13,6,52,28,24,64
Falkirk,8827,3,16,11,9,59,39,20,59
Dundee Utd,8827,4,14,10,12,49,46,3,52
Dunfermline,8827,5,12,11,13,50,47,3,47
Queen of S't,8827,6,12,8,16,47,53,-6,44
Dumbarton,8827,7,10,10,16,47,57,-10,40
Raith,8827,8,9,13,14,35,47,-12,40
Ayr,8827,9,9,12,15,38,58,-20,39
St Mirren,8827,10,8,10,18,38,56,-18,34
Hibernian,8828,1,19,13,4,53,24,29,70
Morton,8828,2,17,13,6,50,35,15,64
Dundee Utd,8828,3,15,11,10,53,42,11,56
Falkirk,8828,4,14,12,10,59,47,12,54
Queen of S't,8828,5,12,10,14,48,50,-2,46
Dunfermline,8828,6,10,13,13,48,48,0,43
Ayr,8828,7,10,12,14,36,52,-16,42
Raith,8828,8,10,8,18,32,51,-19,38
Dumbarton,8828,9,9,10,17,48,62,-14,37
St Mirren,8828,10,8,10,18,39,55,-16,34
Hibernian,8829,1,18,13,5,54,27,27,67
Morton,8829,2,17,11,8,48,35,13,62
Falkirk,8829,3,16,10,10,59,40,19,58
Dundee Utd,8829,4,15,11,10,48,38,10,56
Queen of S't,8829,5,13,8,15,44,49,-5,47
Dunfermline,8829,6,11,13,12,47,47,0,46
Raith,8829,7,11,9,16,34,49,-15,42
Dumbarton,8829,8,10,10,16,48,61,-13,40
St Mirren,8829,9,8,12,16,40,53,-13,36
Ayr,8829,10,6,13,17,30,53,-23,31
Hibernian,8830,1,17,13,6,51,24,27,64
Morton,8830,2,17,13,6,51,35,16,64
Falkirk,8830,3,17,9,10,60,41,19,60
Dundee Utd,8830,4,16,10,10,54,42,12,58
Queen of S't,8830,5,12,11,13,42,44,-2,47
Raith,8830,6,12,9,15,36,48,-12,45
Dumbarton,8830,7,8,13,15,45,57,-12,37
Ayr,8830,8,8,13,15,35,55,-20,37
Dunfermline,8830,9,8,12,16,41,53,-12,36
St Mirren,8830,10,9,9,18,40,56,-16,36
Hibernian,8831,1,21,12,3,58,22,36,75
Morton,8831,2,15,14,7,52,38,14,59
Falkirk,8831,3,15,11,10,57,44,13,56
Dundee Utd,8831,4,15,9,12,52,44,8,54
Queen of S't,8831,5,11,11,14,49,55,-6,44
Dunfermline,8831,6,10,13,13,43,45,-2,43
St Mirren,8831,7,9,12,15,39,50,-11,39
Dumbarton,8831,8,9,11,16,49,61,-12,38
Ayr,8831,9,8,13,15,35,56,-21,37
Raith,8831,10,8,12,16,34,53,-19,36
Hibernian,8832,1,21,12,3,61,24,37,75
Dundee Utd,8832,2,17,10,9,54,38,16,61
Morton,8832,3,14,14,8,49,39,10,56
Falkirk,8832,4,15,10,11,54,41,13,55
Queen of S't,8832,5,13,8,15,51,50,1,47
Dunfermline,8832,6,10,14,12,45,53,-8,44
St Mirren,8832,7,10,10,16,40,56,-16,40
Raith,8832,8,10,8,18,38,55,-17,38
Dumbarton,8832,9,8,12,16,47,55,-8,36
Ayr,8832,10,7,12,17,29,57,-28,33
Hibernian,8833,1,21,12,3,60,22,38,75
Morton,8833,2,18,9,9,51,40,11,63
Falkirk,8833,3,17,9,10,60,43,17,60
Dundee Utd,8833,4,16,10,10,50,37,13,58
Dunfermline,8833,5,10,13,13,44,46,-2,43
Ayr,8833,6,10,11,15,33,50,-17,41
St Mirren,8833,7,10,9,17,43,59,-16,39
Queen of S't,8833,8,9,11,16,41,53,-12,38
Dumbarton,8833,9,8,12,16,44,57,-13,36
Raith,8833,10,9,8,19,34,53,-19,35
Hibernian,8834,1,19,12,5,58,28,30,69
Dundee Utd,8834,2,19,8,9,57,40,17,65
Falkirk,8834,3,16,10,10,61,44,17,58
Morton,8834,4,14,12,10,49,44,5,54
Dunfermline,8834,5,10,13,13,49,53,-4,43
Queen of S't,8834,6,11,10,15,43,50,-7,43
St Mirren,8834,7,10,11,15,44,50,-6,41
Raith,8834,8,10,9,17,37,54,-17,39
Dumbarton,8834,9,9,11,16,49,61,-12,38
Ayr,8834,10,8,12,16,33,56,-23,36
Hibernian,8835,1,20,11,5,56,26,30,71
Dundee Utd,8835,2,18,9,9,54,39,15,63
Falkirk,8835,3,16,9,11,52,40,12,57
Morton,8835,4,16,9,11,48,42,6,57
Dunfermline,8835,5,12,12,12,50,47,3,48
Queen of S't,8835,6,11,10,15,49,50,-1,43
Raith,8835,7,10,10,16,36,51,-15,40
Dumbarton,8835,8,9,11,16,44,57,-13,38
St Mirren,8835,9,9,11,16,40,53,-13,38
Ayr,8835,10,7,12,17,33,57,-24,33
Hibernian,8836,1,20,12,4,62,28,34,72
Morton,8836,2,20,11,5,56,31,25,71
Falkirk,8836,3,18,11,7,64,38,26,65
Dundee Utd,8836,4,15,8,13,49,46,3,53
Queen of S't,8836,5,10,11,15,48,57,-9,41
Ayr,8836,6,10,10,16,36,55,-19,40
St Mirren,8836,7,9,10,17,40,57,-17,37
Dunfermline,8836,8,7,15,14,39,46,-7,36
Dumbarton,8836,9,8,12,16,48,59,-11,36
Raith,8836,10,8,10,18,33,58,-25,34
Hibernian,8837,1,22,10,4,59,26,33,76
Dundee Utd,8837,2,17,10,9,54,39,15,61
Morton,8837,3,16,11,9,51,38,13,59
Falkirk,8837,4,15,11,10,60,45,15,56
Queen of S't,8837,5,13,11,12,53,50,3,50
Dunfermline,8837,6,9,13,14,44,53,-9,40
Dumbarton,8837,7,9,11,16,48,61,-13,38
Raith,8837,8,8,13,15,37,51,-14,37
St Mirren,8837,9,8,10,18,43,59,-16,34
Ayr,8837,10,7,12,17,33,60,-27,33
Hibernian,8838,1,21,10,5,62,29,33,73
Dundee Utd,8838,2,18,9,9,50,34,16,63
Falkirk,8838,3,17,11,8,61,42,19,62
Morton,8838,4,17,10,9,45,35,10,61
Queen of S't,8838,5,12,9,15,45,49,-4,45
St Mirren,8838,6,10,11,15,46,52,-6,41
Dunfermline,8838,7,9,12,15,50,53,-3,39
Dumbarton,8838,8,9,11,16,47,62,-15,38
Ayr,8838,9,8,11,17,31,55,-24,35
Raith,8838,10,8,8,20,32,58,-26,32
Hibernian,8839,1,21,11,4,61,27,34,74
Morton,8839,2,18,10,8,55,37,18,64
Dundee Utd,8839,3,18,9,9,58,37,21,63
Falkirk,8839,4,16,10,10,60,43,17,58
Queen of S't,8839,5,12,10,14,45,50,-5,46
Dunfermline,8839,6,8,15,13,46,52,-6,39
Raith,8839,7,10,9,17,37,52,-15,39
Dumbarton,8839,8,8,12,16,44,59,-15,36
St Mirren,8839,9,9,9,18,39,59,-20,36
Ayr,8839,10,7,11,18,31,60,-29,32
Hibernian,8840,1,19,12,5,57,26,31,69
Falkirk,8840,2,17,11,8,58,37,21,62
Morton,8840,3,15,12,9,54,42,12,57
Dundee Utd,8840,4,15,11,10,52,40,12,56
Queen of S't,8840,5,13,9,14,47,50,-3,48
St Mirren,8840,6,11,9,16,46,58,-12,42
Dunfermline,8840,7,9,12,15,45,50,-5,39
Dumbarton,8840,8,9,12,15,49,62,-13,39
Raith,8840,9,9,10,17,36,53,-17,37
Ayr,8840,10,8,12,16,32,58,-26,36
Hibernian,8841,1,20,12,4,61,29,32,72
Morton,8841,2,16,12,8,56,40,16,60
Falkirk,8841,3,16,11,9,58,39,19,59
Dundee Utd,8841,4,15,11,10,50,38,12,56
Queen of S't,8841,5,11,10,15,44,52,-8,43
Dunfermline,8841,6,9,14,13,45,47,-2,41
Dumbarton,8841,7,9,13,14,45,55,-10,40
Raith,8841,8,9,11,16,34,53,-19,38
St Mirren,8841,9,9,10,17,40,57,-17,37
Ayr,8841,10,8,12,16,32,55,-23,36
Hibernian,8842,1,18,12,6,52,25,27,66
Morton,8842,2,18,11,7,51,29,22,65
Falkirk,8842,3,18,10,8,63,41,22,64
Dundee Utd,8842,4,18,8,10,49,35,14,62
Queen of S't,8842,5,11,11,14,52,51,1,44
Raith,8842,6,11,9,16,37,48,-11,42
Dunfermline,8842,7,8,15,13,43,51,-8,39
Dumbarton,8842,8,9,12,15,45,62,-17,39
St Mirren,8842,9,8,9,19,39,60,-21,33
Ayr,8842,10,7,11,18,31,60,-29,32
Hibernian,8843,1,19,13,4,55,24,31,70
Falkirk,8843,2,18,9,9,57,38,19,63
Morton,8843,3,15,15,6,48,35,13,60
Dundee Utd,8843,4,15,9,12,50,42,8,54
Dunfermline,8843,5,11,13,12,46,42,4,46
Queen of S't,8843,6,12,8,16,49,49,0,44
Raith,8843,7,11,10,15,37,49,-12,43
Dumbarton,8843,8,9,11,16,47,60,-13,38
Ayr,8843,9,7,14,15,32,58,-26,35
St Mirren,8843,10,7,10,19,36,60,-24,31
Morton,8844,1,19,10,7,52,31,21,67
Hibernian,8844,2,18,12,6,53,28,25,66
Falkirk,8844,3,18,9,9,61,38,23,63
Dundee Utd,8844,4,15,10,11,49,40,9,55
Dunfermline,8844,5,11,12,13,48,48,0,45
Queen of S't,8844,6,11,9,16,43,55,-12,42
Raith,8844,7,10,10,16,38,50,-12,40
Dumbarton,8844,8,9,12,15,48,56,-8,39
Ayr,8844,9,8,13,15,30,52,-22,37
St Mirren,8844,10,8,9,19,36,60,-24,33
Hibernian,8845,1,18,14,4,52,23,29,68
Morton,8845,2,17,12,7,50,35,15,63
Falkirk,8845,3,17,10,9,59,41,18,61
Dundee Utd,8845,4,16,10,10,52,38,14,58
Queen of S't,8845,5,12,10,14,45,46,-1,46
Dumbarton,8845,6,10,11,15,48,57,-9,41
Dunfermline,8845,7,9,13,14,47,50,-3,40
Raith,8845,8,10,9,17,35,52,-17,39
St Mirren,8845,9,8,11,17,39,56,-17,35
Ayr,8845,10,7,12,17,28,57,-29,33
Hibernian,8846,1,19,13,4,56,28,28,70
Morton,8846,2,16,13,7,51,37,14,61
Dundee Utd,8846,3,16,9,11,48,35,13,57
Falkirk,8846,4,16,9,11,58,47,11,57
Queen of S't,8846,5,11,10,15,51,55,-4,43
Ayr,8846,6,10,12,14,39,51,-12,42
Raith,8846,7,11,9,16,36,52,-16,42
Dunfermline,8846,8,9,13,14,50,51,-1,40
Dumbarton,8846,9,9,10,17,48,64,-16,37
St Mirren,8846,10,9,10,17,37,54,-17,37
Hibernian,8847,1,19,11,6,60,31,29,68
Morton,8847,2,18,9,9,53,38,15,63
Dundee Utd,8847,3,17,10,9,56,39,17,61
Falkirk,8847,4,16,11,9,61,43,18,59
Dunfermline,8847,5,11,12,13,51,50,1,45
Queen of S't,8847,6,11,11,14,48,55,-7,44
Raith,8847,7,10,9,17,36,52,-16,39
Ayr,8847,8,9,10,17,36,61,-25,37
St Mirren,8847,9,9,9,18,44,62,-18,36
Dumbarton,8847,10,7,14,15,53,67,-14,35
Hibernian,8848,1,18,13,5,55,26,29,67
Morton,8848,2,17,12,7,48,35,13,63
Falkirk,8848,3,16,12,8,62,40,22,60
Dundee Utd,8848,4,15,12,9,48,37,11,57
Queen of S't,8848,5,10,13,13,48,52,-4,43
Dunfermline,8848,6,9,14,13,48,51,-3,41
Raith,8848,7,9,11,16,32,50,-18,38
Ayr,8848,8,8,13,15,34,55,-21,37
St Mirren,8848,9,8,12,16,40,53,-13,36
Dumbarton,8848,10,8,12,16,47,63,-16,36
Hibernian,8849,1,19,13,4,57,26,31,70
Falkirk,8849,2,19,10,7,62,38,24,67
Morton,8849,3,19,10,7,54,36,18,67
Dundee Utd,8849,4,16,9,11,54,38,16,57
Dunfermline,8849,5,9,13,14,46,51,-5,40
Ayr,8849,6,9,12,15,34,56,-22,39
Dumbarton,8849,7,9,11,16,46,56,-10,38
Queen of S't,8849,8,9,10,17,40,57,-17,37
St Mirren,8849,9,8,12,16,41,56,-15,36
Raith,8849,10,8,10,18,35,55,-20,34
Hibernian,8850,1,19,11,6,59,28,31,68
Morton,8850,2,19,9,8,53,33,20,66
Dundee Utd,8850,3,16,10,10,50,39,11,58
Falkirk,8850,4,16,9,11,56,41,15,57
Queen of S't,8850,5,12,11,13,47,54,-7,47
Dunfermline,8850,6,10,11,15,48,52,-4,41
Dumbarton,8850,7,10,11,15,51,61,-10,41
Ayr,8850,8,9,12,15,32,50,-18,39
St Mirren,8850,9,8,11,17,41,60,-19,35
Raith,8850,10,8,11,17,33,52,-19,35
Hibernian,8851,1,19,11,6,56,28,28,68
Morton,8851,2,15,13,8,49,36,13,58
Falkirk,8851,3,14,13,9,54,41,13,55
Dundee Utd,8851,4,15,10,11,47,38,9,55
Dunfermline,8851,5,12,12,12,45,45,0,48
Queen of S't,8851,6,12,10,14,39,44,-5,46
Ayr,8851,7,11,12,13,35,50,-15,45
Dumbarton,8851,8,8,13,15,47,58,-11,37
Raith,8851,9,8,12,16,32,48,-16,36
St Mirren,8851,10,8,10,18,36,52,-16,34
Hibernian,8852,1,19,11,6,57,29,28,68
Morton,8852,2,17,12,7,50,35,15,63
Falkirk,8852,3,14,12,10,58,45,13,54
Dundee Utd,8852,4,13,14,9,49,42,7,53
Queen of S't,8852,5,12,10,14,45,50,-5,46
Dunfermline,8852,6,10,12,14,46,49,-3,42
Raith,8852,7,10,12,14,39,51,-12,42
Dumbarton,8852,8,9,12,15,46,54,-8,39
St Mirren,8852,9,9,11,16,40,56,-16,38
Ayr,8852,10,8,12,16,36,55,-19,36
Hibernian,8853,1,20,11,5,55,22,33,71
Falkirk,8853,2,19,9,8,62,37,25,66
Dundee Utd,8853,3,14,12,10,48,39,9,54
Morton,8853,4,13,10,13,42,45,-3,49
Dunfermline,8853,5,11,14,11,45,43,2,47
Ayr,8853,6,10,12,14,36,52,-16,42
Dumbarton,8853,7,10,11,15,49,57,-8,41
Queen of S't,8853,8,10,10,16,43,51,-8,40
Raith,8853,9,10,10,16,36,51,-15,40
St Mirren,8853,10,8,11,17,38,57,-19,35
Hibernian,8854,1,20,13,3,55,23,32,73
Dundee Utd,8854,2,17,9,10,58,44,14,60
Falkirk,8854,3,16,11,9,56,41,15,59
Morton,8854,4,15,11,10,48,39,9,56
Queen of S't,8854,5,11,11,14,45,48,-3,44
Raith,8854,6,11,9,16,36,49,-13,42
Ayr,8854,7,10,10,16,40,59,-19,40
Dunfermline,8854,8,8,14,14,45,51,-6,38
Dumbarton,8854,9,9,11,16,51,62,-11,38
St Mirren,8854,10,8,11,17,41,59,-18,35
Hibernian,8855,1,16,15,5,51,28,23,63
Dundee Utd,8855,2,16,11,9,51,39,12,59
Morton,8855,3,15,14,7,49,37,12,59
Falkirk,8855,4,15,12,9,58,40,18,57
Queen of S't,8855,5,12,9,15,47,50,-3,45
Raith,8855,6,10,11,15,34,51,-17,41
Dumbarton,8855,7,10,10,16,48,57,-9,40
St Mirren,8855,8,10,10,16,41,54,-13,40
Ayr,8855,9,9,12,15,34,51,-17,39
Dunfermline,8855,10,8,14,14,44,50,-6,38
Hibernian,8856,1,20,12,4,63,24,39,72
Morton,8856,2,16,14,6,54,39,15,62
Dundee Utd,8856,3,16,11,9,48,38,10,59
Falkirk,8856,4,15,11,10,57,45,12,56
Dunfermline,8856,5,12,11,13,53,47,6,47
Raith,8856,6,11,10,15,34,47,-13,43
Queen of S't,8856,7,10,10,16,42,52,-10,40
Dumbarton,8856,8,8,12,16,44,63,-19,36
Ayr,8856,9,7,13,16,35,57,-22,34
St Mirren,8856,10,7,12,17,40,58,-18,33
Hibernian,8857,1,21,11,4,61,26,35,74
Morton,8857,2,16,14,6,50,36,14,62
Falkirk,8857,3,16,11,9,62,47,15,59
Dundee Utd,8857,4,15,12,9,56,42,14,57
Dunfermline,8857,5,10,13,13,48,50,-2,43
Dumbarton,8857,6,9,12,15,47,56,-9,39
Queen of S't,8857,7,9,12,15,43,52,-9,39
Ayr,8857,8,8,13,15,36,59,-23,37
Raith,8857,9,8,11,17,34,53,-19,35
St Mirren,8857,10,7,13,16,39,55,-16,34
Hibernian,8858,1,21,11,4,63,26,37,74
Falkirk,8858,2,18,9,9,57,39,18,63
Dundee Utd,8858,3,17,8,11,52,40,12,59
Morton,8858,4,16,10,10,53,44,9,58
Dunfermline,8858,5,11,13,12,52,49,3,46
Dumbarton,8858,6,9,12,15,51,59,-8,39
Queen of S't,8858,7,10,9,17,42,52,-10,39
Raith,8858,8,10,9,17,36,56,-20,39
St Mirren,8858,9,9,10,17,42,56,-14,37
Ayr,8858,10,8,11,17,33,60,-27,35
Hibernian,8859,1,21,11,4,60,26,34,74
Falkirk,8859,2,19,9,8,62,36,26,66
Morton,8859,3,16,12,8,46,36,10,60
Dundee Utd,8859,4,16,9,11,46,40,6,57
Dumbarton,8859,5,10,12,14,47,54,-7,42
Dunfermline,8859,6,9,13,14,48,53,-5,40
Queen of S't,8859,7,10,9,17,47,55,-8,39
St Mirren,8859,8,10,9,17,40,55,-15,39
Raith,8859,9,10,8,18,35,50,-15,38
Ayr,8859,10,7,12,17,32,58,-26,33
Hibernian,8860,1,17,13,6,54,27,27,64
Morton,8860,2,17,13,6,56,36,20,64
Falkirk,8860,3,17,11,8,64,43,21,62
Dundee Utd,8860,4,17,9,10,57,41,16,60
Queen of S't,8860,5,10,11,15,42,51,-9,41
Raith,8860,6,10,10,16,37,51,-14,40
Dunfermline,8860,7,9,12,15,41,49,-8,39
Dumbarton,8860,8,9,12,15,48,64,-16,39
St Mirren,8860,9,9,10,17,42,58,-16,37
Ayr,8860,10,8,13,15,36,57,-21,37
Hibernian,8861,1,19,12,5,51,22,29,69
Morton,8861,2,18,11,7,49,32,17,65
Dundee Utd,8861,3,17,8,11,54,43,11,59
Falkirk,8861,4,14,10,12,53,48,5,52
Queen of S't,8861,5,13,9,14,45,50,-5,48
Raith,8861,6,12,10,14,38,43,-5,46
Dunfermline,8861,7,11,12,13,44,42,2,45
Dumbarton,8861,8,8,12,16,49,59,-10,36
St Mirren,8861,9,8,11,17,41,58,-17,35
Ayr,8861,10,7,11,18,32,59,-27,32
Hibernian,8862,1,19,12,5,49,25,24,69
Dundee Utd,8862,2,18,9,9,57,42,15,63
Morton,8862,3,16,13,7,51,36,15,61
Falkirk,8862,4,16,11,9,57,38,19,59
Dunfermline,8862,5,10,15,11,50,50,0,45
Queen of S't,8862,6,12,8,16,44,50,-6,44
Raith,8862,7,11,9,16,34,46,-12,42
St Mirren,8862,8,9,10,17,39,54,-15,37
Dumbarton,8862,9,8,11,17,47,60,-13,35
Ayr,8862,10,7,10,19,36,63,-27,31
Hibernian,8863,1,20,12,4,56,24,32,72
Morton,8863,2,19,10,7,56,35,21,67
Falkirk,8863,3,16,11,9,59,40,19,59
Dundee Utd,8863,4,14,11,11,48,44,4,53
Raith,8863,5,11,10,15,34,45,-11,43
Queen of S't,8863,6,10,12,14,42,48,-6,42
Dumbarton,8863,7,10,12,14,51,59,-8,42
Dunfermline,8863,8,8,15,13,44,49,-5,39
Ayr,8863,9,7,13,16,32,58,-26,34
St Mirren,8863,10,7,10,19,41,61,-20,31
Hibernian,8864,1,19,12,5,55,27,28,69
Morton,8864,2,18,12,6,53,31,22,66
Dundee Utd,8864,3,15,9,12,49,44,5,54
Falkirk,8864,4,14,10,12,53,43,10,52
Dunfermline,8864,5,11,13,12,49,47,2,46
Queen of S't,8864,6,12,8,16,46,54,-8,44
Dumbarton,8864,7,11,10,15,48,54,-6,43
Raith,8864,8,10,10,16,38,52,-14,40
Ayr,8864,9,9,13,14,33,50,-17,40
St Mirren,8864,10,7,11,18,37,59,-22,32
Hibernian,8865,1,18,13,5,58,27,31,67
Dundee Utd,8865,2,17,10,9,52,38,14,61
Morton,8865,3,16,12,8,52,41,11,60
Falkirk,8865,4,15,11,10,57,46,11,56
Queen of S't,8865,5,15,8,13,49,50,-1,53
Dunfermline,8865,6,9,14,13,49,50,-1,41
Raith,8865,7,10,8,18,35,53,-18,38
Ayr,8865,8,9,11,16,36,59,-23,38
St Mirren,8865,9,9,10,17,42,53,-11,37
Dumbarton,8865,10,8,11,17,45,58,-13,35
Hibernian,8866,1,17,15,4,54,26,28,66
Falkirk,8866,2,18,11,7,62,38,24,65
Morton,8866,3,17,14,5,56,36,20,65
Dundee Utd,8866,4,14,12,10,49,42,7,54
Dunfermline,8866,5,11,13,12,46,49,-3,46
Queen of S't,8866,6,9,12,15,39,49,-10,39
Ayr,8866,7,8,15,13,38,54,-16,39
Dumbarton,8866,8,8,14,14,50,60,-10,38
Raith,8866,9,8,9,19,30,51,-21,33
St Mirren,8866,10,7,11,18,40,59,-19,32
Hibernian,8867,1,22,11,3,65,22,43,77
Morton,8867,2,16,12,8,46,34,12,60
Dundee Utd,8867,3,16,10,10,45,34,11,58
Falkirk,8867,4,14,10,12,52,45,7,52
Queen of S't,8867,5,12,10,14,45,48,-3,46
Dumbarton,8867,6,10,12,14,50,53,-3,42
Raith,8867,7,10,12,14,31,47,-16,42
Dunfermline,8867,8,9,11,16,42,51,-9,38
St Mirren,8867,9,8,11,17,35,55,-20,35
Ayr,8867,10,7,13,16,31,53,-22,34
Hibernian,8868,1,21,11,4,56,23,33,74
Falkirk,8868,2,16,10,10,58,39,19,58
Morton,8868,3,16,10,10,44,36,8,58
Dundee Utd,8868,4,15,11,10,46,37,9,56
Queen of S't,8868,5,13,10,13,51,50,1,49
Dumbarton,8868,6,11,12,13,48,53,-5,45
Dunfermline,8868,7,10,14,12,46,47,-1,44
Raith,8868,8,9,10,17,33,53,-20,37
Ayr,8868,9,7,14,15,32,53,-21,35
St Mirren,8868,10,6,10,20,37,60,-23,28
Hibernian,8869,1,18,11,7,54,27,27,65
Falkirk,8869,2,17,12,7,65,39,26,63
Dundee Utd,8869,3,17,9,10,54,38,16,60
Morton,8869,4,16,12,8,50,39,11,60
Dunfermline,8869,5,10,14,12,47,48,-1,44
Queen of S't,8869,6,11,9,16,44,55,-11,42
St Mirren,8869,7,9,11,16,46,58,-12,38
Raith,8869,8,9,11,16,35,49,-14,38
Ayr,8869,9,8,13,15,34,55,-21,37
Dumbarton,8869,10,8,12,16,48,69,-21,36
Hibernian,8870,1,18,13,5,53,24,29,67
Morton,8870,2,18,11,7,51,38,13,65
Dundee Utd,8870,3,17,9,10,51,38,13,60
Falkirk,8870,4,16,10,10,56,40,16,58
Raith,8870,5,11,11,14,38,45,-7,44
Queen of S't,8870,6,10,11,15,42,51,-9,41
St Mirren,8870,7,10,11,15,43,54,-11,41
Dumbarton,8870,8,9,11,16,48,60,-12,38
Dunfermline,8870,9,8,12,16,42,51,-9,36
Ayr,8870,10,7,13,16,36,59,-23,34
Hibernian,8871,1,21,10,5,56,24,32,73
Morton,8871,2,17,10,9,50,37,13,61
Falkirk,8871,3,16,11,9,55,38,17,59
Dundee Utd,8871,4,15,12,9,52,41,11,57
Raith,8871,5,12,8,16,39,49,-10,44
Queen of S't,8871,6,10,12,14,45,52,-7,42
Dumbarton,8871,7,10,10,16,47,56,-9,40
Ayr,8871,8,9,13,14,40,58,-18,40
Dunfermline,8871,9,8,14,14,45,50,-5,38
St Mirren,8871,10,7,10,19,36,60,-24,31
Hibernian,8872,1,19,12,5,53,22,31,69
Dundee Utd,8872,2,16,11,9,52,36,16,59
Falkirk,8872,3,15,12,9,55,39,16,57
Morton,8872,4,15,12,9,54,42,12,57
Queen of S't,8872,5,12,9,15,43,49,-6,45
Ayr,8872,6,10,12,14,35,49,-14,42
Dunfermline,8872,7,10,11,15,45,56,-11,41
Raith,8872,8,11,8,17,36,53,-17,41
St Mirren,8872,9,9,11,16,43,58,-15,38
Dumbarton,8872,10,9,10,17,46,58,-12,37
Hibernian,8873,1,19,13,4,62,29,33,70
Morton,8873,2,18,12,6,53,35,18,66
Dundee Utd,8873,3,18,9,9,57,38,19,63
Falkirk,8873,4,16,11,9,60,44,16,59
Queen of S't,8873,5,11,8,17,45,59,-14,41
Dunfermline,8873,6,9,12,15,49,56,-7,39
Raith,8873,7,10,9,17,37,51,-14,39
Dumbarton,8873,8,9,11,16,48,62,-14,38
Ayr,8873,9,9,11,16,36,55,-19,38
St Mirren,8873,10,8,10,18,38,56,-18,34
Hibernian,8874,1,20,11,5,55,25,30,71
Dundee Utd,8874,2,17,9,10,51,38,13,60
Morton,8874,3,16,11,9,52,39,13,59
Falkirk,8874,4,14,11,11,57,44,13,53
Dunfermline,8874,5,13,12,11,47,41,6,51
Queen of S't,8874,6,12,9,15,42,47,-5,45
Ayr,8874,7,10,10,16,33,51,-18,40
Raith,8874,8,10,10,16,31,49,-18,40
Dumbarton,8874,9,9,10,17,44,56,-12,37
St Mirren,8874,10,7,11,18,37,59,-22,32
Hibernian,8875,1,19,11,6,56,30,26,68
Morton,8875,2,18,12,6,56,38,18,66
Falkirk,8875,3,15,12,9,56,40,16,57
Dundee Utd,8875,4,16,8,12,50,43,7,56
Dunfermline,8875,5,10,14,12,46,47,-1,44
Queen of S't,8875,6,11,10,15,48,53,-5,43
Dumbarton,8875,7,10,11,15,48,56,-8,41
St Mirren,8875,8,10,10,16,41,54,-13,40
Raith,8875,9,9,10,17,35,52,-17,37
Ayr,8875,10,7,12,17,35,58,-23,33
Hibernian,8876,1,19,13,4,61,31,30,70
Morton,8876,2,17,11,8,51,36,15,62
Falkirk,8876,3,15,9,12,52,40,12,54
Dundee Utd,8876,4,14,11,11,46,38,8,53
Dunfermline,8876,5,9,15,12,43,46,-3,42
Dumbarton,8876,6,10,12,14,46,56,-10,42
Raith,8876,7,11,9,16,33,46,-13,42
Queen of S't,8876,8,10,11,15,47,54,-7,41
St Mirren,8876,9,10,9,17,41,55,-14,39
Ayr,8876,10,9,12,15,34,52,-18,39
Hibernian,8877,1,20,12,4,58,26,32,72
Morton,8877,2,16,12,8,54,37,17,60
Falkirk,8877,3,16,10,10,59,43,16,58
Dundee Utd,8877,4,15,10,11,50,48,2,55
Dumbarton,8877,5,11,11,14,53,56,-3,44
Raith,8877,6,11,11,14,39,46,-7,44
Queen of S't,8877,7,11,9,16,49,58,-9,42
Dunfermline,8877,8,10,11,15,50,56,-6,41
Ayr,8877,9,8,13,15,33,55,-22,37
St Mirren,8877,10,7,11,18,36,56,-20,32
Morton,8878,1,19,11,6,57,34,23,68
Hibernian,8878,2,18,11,7,57,30,27,65
Dundee Utd,8878,3,16,10,10,56,41,15,58
Falkirk,8878,4,15,9,12,52,43,9,54
Queen of S't,8878,5,13,8,15,42,47,-5,47
Dumbarton,8878,6,11,12,13,51,55,-4,45
Ayr,8878,7,10,12,14,37,57,-20,42
Dunfermline,8878,8,9,12,15,42,47,-5,39
Raith,8878,9,10,9,17,35,48,-13,39
St Mirren,8878,10,7,10,19,39,66,-27,31
Hibernian,8879,1,21,12,3,61,22,39,75
Morton,8879,2,17,11,8,50,34,16,62
Dundee Utd,8879,3,17,8,11,52,39,13,59
Falkirk,8879,4,16,10,10,57,40,17,58
Queen of S't,8879,5,12,8,16,46,52,-6,44
St Mirren,8879,6,10,10,16,37,53,-16,40
Ayr,8879,7,9,12,15,35,56,-21,39
Dunfermline,8879,8,9,11,16,44,51,-7,38
Dumbarton,8879,9,9,10,17,45,59,-14,37
Raith,8879,10,9,10,17,31,52,-21,37
Hibernian,8880,1,18,12,6,53,25,28,66
Morton,8880,2,18,11,7,49,32,17,65
Falkirk,8880,3,17,11,8,60,39,21,62
Dundee Utd,8880,4,14,11,11,49,40,9,53
Dunfermline,8880,5,10,13,13,42,46,-4,43
Queen of S't,8880,6,11,10,15,42,50,-8,43
Dumbarton,8880,7,10,12,14,49,56,-7,42
Raith,8880,8,9,13,14,34,46,-12,40
Ayr,8880,9,9,13,14,35,54,-19,40
St Mirren,8880,10,6,10,20,32,57,-25,28
Hibernian,8881,1,19,13,4,58,24,34,70
Falkirk,8881,2,17,12,7,68,42,26,63
Morton,8881,3,16,13,7,48,35,13,61
Dundee Utd,8881,4,16,9,11,51,41,10,57
Queen of S't,8881,5,11,9,16,43,52,-9,42
Raith,8881,6,11,9,16,37,47,-10,42
Dumbarton,8881,7,10,11,15,49,56,-7,41
Dunfermline,8881,8,9,13,14,46,54,-8,40
Ayr,8881,9,8,11,17,30,57,-27,35
St Mirren,8881,10,8,10,18,36,58,-22,34
Hibernian,8882,1,18,12,6,52,25,27,66
Morton,8882,2,19,9,8,54,37,17,66
Dundee Utd,8882,3,17,10,9,55,36,19,61
Falkirk,8882,4,15,11,10,55,42,13,56
Queen of S't,8882,5,12,9,15,49,54,-5,45
Dumbarton,8882,6,10,11,15,50,58,-8,41
Dunfermline,8882,7,9,13,14,44,48,-4,40
Raith,8882,8,10,9,17,39,55,-16,39
Ayr,8882,9,9,11,16,34,59,-25,38
St Mirren,8882,10,8,11,17,36,54,-18,35
Hibernian,8883,1,22,10,4,60,25,35,76
Dundee Utd,8883,2,18,9,9,56,36,20,63
Morton,8883,3,14,13,9,48,43,5,55
Falkirk,8883,4,14,10,12,52,42,10,52
Dunfermline,8883,5,11,13,12,47,46,1,46
Queen of S't,8883,6,12,9,15,47,49,-2,45
Ayr,8883,7,10,12,14,37,54,-17,42
Raith,8883,8,10,9,17,37,53,-16,39
Dumbarton,8883,9,8,11,17,44,60,-16,35
St Mirren,8883,10,8,10,18,39,59,-20,34
Hibernian,8884,1,19,13,4,55,26,29,70
Dundee Utd,8884,2,16,10,10,50,37,13,58
Falkirk,8884,3,16,9,11,59,44,15,57
Morton,8884,4,14,12,10,47,40,7,54
Queen of S't,8884,5,14,9,13,49,47,2,51
Dunfermline,8884,6,11,12,13,43,46,-3,45
Dumbarton,8884,7,11,11,14,50,54,-4,44
Raith,8884,8,10,10,16,34,46,-12,40
Ayr,8884,9,7,14,15,29,53,-24,35
St Mirren,8884,10,7,10,19,36,59,-23,31
Hibernian,8885,1,19,14,3,60,26,34,71
Dundee Utd,8885,2,17,10,9,52,36,16,61
Falkirk,8885,3,16,10,10,56,40,16,58
Morton,8885,4,15,13,8,48,38,10,58
Dumbarton,8885,5,11,10,15,53,57,-4,43
Queen of S't,8885,6,11,10,15,42,55,-13,43
Dunfermline,8885,7,9,13,14,43,46,-3,40
Ayr,8885,8,9,12,15,36,53,-17,39
Raith,8885,9,9,11,16,33,51,-18,38
St Mirren,8885,10,8,9,19,37,58,-21,33
Hibernian,8886,1,19,13,4,56,24,32,70
Falkirk,8886,2,18,11,7,67,36,31,65
Morton,8886,3,18,11,7,50,31,19,65
Dundee Utd,8886,4,15,8,13,49,47,2,53
Dunfermline,8886,5,9,15,12,45,47,-2,42
Dumbarton,8886,6,10,10,16,48,56,-8,40
Ayr,8886,7,9,13,14,37,56,-19,40
Queen of S't,8886,8,9,11,16,38,57,-19,38
Raith,8886,9,8,13,15,34,50,-16,37
St Mirren,8886,10,7,11,18,37,57,-20,32
Hibernian,8887,1,17,13,6,56,31,25,64
Morton,8887,2,15,14,7,46,35,11,59
Falkirk,8887,3,15,11,10,59,42,17,56
Dundee Utd,8887,4,14,14,8,50,40,10,56
Raith,8887,5,12,11,13,42,47,-5,47
Dunfermline,8887,6,10,15,11,54,52,2,45
Queen of S't,8887,7,10,11,15,43,55,-12,41
St Mirren,8887,8,7,15,14,39,53,-14,36
Ayr,8887,9,7,15,14,36,57,-21,36
Dumbarton,8887,10,8,11,17,47,60,-13,35
Hibernian,8888,1,21,12,3,60,24,36,75
Morton,8888,2,16,14,6,51,36,15,62
Dundee Utd,8888,3,17,10,9,59,39,20,61
Falkirk,8888,4,15,11,10,57,42,15,56
Queen of S't,8888,5,12,9,15,47,51,-4,45
Raith,8888,6,10,11,15,38,52,-14,41
Dunfermline,8888,7,9,13,14,42,46,-4,40
Dumbarton,8888,8,8,11,17,48,64,-16,35
St Mirren,8888,9,8,11,17,40,64,-24,35
Ayr,8888,10,7,12,17,35,59,-24,33
Morton,8889,1,21,10,5,57,34,23,73
Hibernian,8889,2,20,10,6,57,29,28,70
Falkirk,8889,3,17,9,10,64,44,20,60
Dundee Utd,8889,4,15,10,11,49,41,8,55
Queen of S't,8889,5,12,10,14,44,49,-5,46
Dunfermline,8889,6,10,12,14,49,53,-4,42
Dumbarton,8889,7,9,11,16,50,61,-11,38
St Mirren,8889,8,9,9,18,43,61,-18,36
Raith,8889,9,9,9,18,34,52,-18,36
Ayr,8889,10,6,14,16,35,58,-23,32
Hibernian,8890,1,19,11,6,53,25,28,68
Falkirk,8890,2,16,11,9,59,43,16,59
Morton,8890,3,16,11,9,45,33,12,59
Dundee Utd,8890,4,16,10,10,53,36,17,58
Dunfermline,8890,5,11,12,13,44,48,-4,45
Raith,8890,6,12,9,15,43,47,-4,45
Queen of S't,8890,7,11,9,16,43,53,-10,42
Dumbarton,8890,8,9,12,15,49,58,-9,39
Ayr,8890,9,9,11,16,35,55,-20,38
St Mirren,8890,10,8,10,18,36,62,-26,34
Hibernian,8891,1,19,12,5,57,26,31,69
Morton,8891,2,15,13,8,46,35,11,58
Falkirk,8891,3,14,13,9,56,43,13,55
Dundee Utd,8891,4,15,10,11,55,46,9,55
Dunfermline,8891,5,13,12,11,46,44,2,51
Queen of S't,8891,6,11,10,15,43,50,-7,43
Raith,8891,7,10,10,16,33,45,-12,40
Ayr,8891,8,9,12,15,38,57,-19,39
Dumbarton,8891,9,9,11,16,50,60,-10,38
St Mirren,8891,10,8,11,17,38,56,-18,35
Morton,8892,1,20,9,7,56,35,21,69
Hibernian,8892,2,18,12,6,52,26,26,66
Falkirk,8892,3,15,9,12,56,45,11,54
Dundee Utd,8892,4,14,10,12,47,41,6,52
Queen of S't,8892,5,13,8,15,44,47,-3,47
Dumbarton,8892,6,12,10,14,50,53,-3,46
Dunfermline,8892,7,10,13,13,47,50,-3,43
Raith,8892,8,10,11,15,34,45,-11,41
Ayr,8892,9,9,11,16,31,55,-24,38
St Mirren,8892,10,7,11,18,35,55,-20,32
Hibernian,8893,1,20,13,3,58,22,36,73
Dundee Utd,8893,2,18,9,9,54,35,19,63
Morton,8893,3,16,11,9,49,40,9,59
Falkirk,8893,4,15,10,11,53,40,13,55
Dumbarton,8893,5,12,10,14,48,51,-3,46
Queen of S't,8893,6,11,10,15,43,47,-4,43
Raith,8893,7,11,9,16,34,47,-13,42
Dunfermline,8893,8,10,11,15,46,51,-5,41
Ayr,8893,9,6,15,15,31,54,-23,33
St Mirren,8893,10,7,10,19,32,61,-29,31
Hibernian,8894,1,18,13,5,58,30,28,67
Morton,8894,2,17,9,10,49,37,12,60
Falkirk,8894,3,16,11,9,58,42,16,59
Dundee Utd,8894,4,16,10,10,51,40,11,58
Queen of S't,8894,5,13,9,14,45,47,-2,48
Dunfermline,8894,6,11,12,13,49,48,1,45
Raith,8894,7,11,9,16,39,51,-12,42
Dumbarton,8894,8,10,11,15,50,55,-5,41
St Mirren,8894,9,7,12,17,38,60,-22,33
Ayr,8894,10,7,12,17,30,57,-27,33
Hibernian,8895,1,18,13,5,52,25,27,67
Morton,8895,2,17,14,5,53,34,19,65
Dundee Utd,8895,3,17,10,9,50,38,12,61
Falkirk,8895,4,14,10,12,55,46,9,52
Queen of S't,8895,5,11,10,15,45,52,-7,43
Ayr,8895,6,10,12,14,40,56,-16,42
Dunfermline,8895,7,9,14,13,45,49,-4,41
Raith,8895,8,10,9,17,38,51,-13,39
Dumbarton,8895,9,8,14,14,45,55,-10,38
St Mirren,8895,10,7,12,17,40,57,-17,33
Hibernian,8896,1,21,12,3,59,24,35,75
Morton,8896,2,19,10,7,56,35,21,67
Dundee Utd,8896,3,15,10,11,51,46,5,55
Falkirk,8896,4,15,9,12,55,47,8,54
Queen of S't,8896,5,14,8,14,48,49,-1,50
Dunfermline,8896,6,10,12,14,49,51,-2,42
Dumbarton,8896,7,10,10,16,49,58,-9,40
Raith,8896,8,10,8,18,34,51,-17,38
Ayr,8896,9,8,14,14,34,52,-18,38
St Mirren,8896,10,7,9,20,39,61,-22,30
Hibernian,8897,1,17,14,5,50,26,24,65
Falkirk,8897,2,16,12,8,60,40,20,60
Morton,8897,3,15,12,9,47,37,10,57
Dundee Utd,8897,4,16,9,11,46,36,10,57
Dunfermline,8897,5,12,12,12,48,42,6,48
Queen of S't,8897,6,12,9,15,44,48,-4,45
Raith,8897,7,10,9,17,35,52,-17,39
Dumbarton,8897,8,9,11,16,43,56,-13,38
Ayr,8897,9,8,14,14,31,51,-20,38
St Mirren,8897,10,8,12,16,40,56,-16,36
Hibernian,8898,1,19,10,7,58,29,29,67
Falkirk,8898,2,17,12,7,56,36,20,63
Morton,8898,3,17,11,8,51,40,11,62
Dundee Utd,8898,4,14,11,11,47,39,8,53
Queen of S't,8898,5,11,11,14,44,50,-6,44
Dunfermline,8898,6,9,14,13,45,46,-1,41
Ayr,8898,7,9,13,14,37,56,-19,40
Dumbarton,8898,8,8,13,15,48,60,-12,37
St Mirren,8898,9,9,10,17,42,56,-14,37
Raith,8898,10,8,13,15,36,52,-16,37
Hibernian,8899,1,17,15,4,53,28,25,66
Falkirk,8899,2,16,12,8,60,39,21,60
Morton,8899,3,16,11,9,51,36,15,59
Dundee Utd,8899,4,15,10,11,49,46,3,55
Dumbarton,8899,5,10,13,13,50,52,-2,43
Queen of S't,8899,6,10,12,14,44,50,-6,42
Raith,8899,7,10,10,16,34,49,-15,40
Ayr,8899,8,9,13,14,36,52,-16,40
St Mirren,8899,9,9,12,15,45,57,-12,39
Dunfermline,8899,10,8,12,16,42,55,-13,36
Hibernian,8900,1,20,11,5,60,25,35,71
Morton,8900,2,17,11,8,49,37,12,62
Falkirk,8900,3,16,11,9,63,42,21,59
Dundee Utd,8900,4,15,9,12,49,41,8,54
Dunfermline,8900,5,12,12,12,50,49,1,48
Queen of S't,8900,6,11,9,16,41,51,-10,42
Raith,8900,7,10,10,16,36,50,-14,40
St Mirren,8900,8,9,11,16,37,54,-17,38
Ayr,8900,9,9,11,16,34,56,-22,38
Dumbarton,8900,10,7,13,16,44,58,-14,34
Hibernian,8901,1,19,12,5,57,24,33,69
Falkirk,8901,2,17,11,8,58,37,21,62
Morton,8901,3,17,11,8,50,39,11,62
Dundee Utd,8901,4,16,11,9,52,38,14,59
Dunfermline,8901,5,9,14,13,42,44,-2,41
Queen of S't,8901,6,10,11,15,40,48,-8,41
Raith,8901,7,10,11,15,33,47,-14,41
Ayr,8901,8,10,11,15,39,57,-18,41
St Mirren,8901,9,8,10,18,38,58,-20,34
Dumbarton,8901,10,7,12,17,44,61,-17,33
Hibernian,8902,1,19,12,5,58,25,33,69
Morton,8902,2,18,10,8,53,36,17,64
Falkirk,8902,3,17,10,9,61,40,21,61
Dundee Utd,8902,4,17,9,10,49,37,12,60
Queen of S't,8902,5,12,10,14,47,50,-3,46
Dunfermline,8902,6,10,13,13,46,47,-1,43
Dumbarton,8902,7,10,11,15,49,56,-7,41
Raith,8902,8,10,10,16,38,59,-21,40
St Mirren,8902,9,7,11,18,36,58,-22,32
Ayr,8902,10,7,10,19,29,58,-29,31
Hibernian,8903,1,18,11,7,52,30,22,65
Dundee Utd,8903,2,16,11,9,54,39,15,59
Falkirk,8903,3,16,10,10,61,42,19,58
Morton,8903,4,15,11,10,51,42,9,56
Queen of S't,8903,5,12,10,14,49,53,-4,46
Dunfermline,8903,6,11,12,13,53,52,1,45
Ayr,8903,7,10,12,14,37,52,-15,42
St Mirren,8903,8,10,11,15,43,50,-7,41
Raith,8903,9,9,10,17,34,51,-17,37
Dumbarton,8903,10,9,10,17,44,67,-23,37
Hibernian,8904,1,18,11,7,54,27,27,65
Dundee Utd,8904,2,18,10,8,55,37,18,64
Morton,8904,3,17,13,6,49,33,16,64
Falkirk,8904,4,17,11,8,58,38,20,62
Dunfermline,8904,5,9,14,13,42,51,-9,41
Raith,8904,6,10,10,16,42,50,-8,40
Queen of S't,8904,7,10,9,17,41,57,-16,39
Ayr,8904,8,8,14,14,35,51,-16,38
Dumbarton,8904,9,8,13,15,43,55,-12,37
St Mirren,8904,10,7,11,18,36,56,-20,32
Hibernian,8905,1,20,12,4,57,24,33,72
Falkirk,8905,2,18,10,8,63,41,22,64
Morton,8905,3,16,12,8,47,36,11,60
Dundee Utd,8905,4,14,10,12,47,44,3,52
Raith,8905,5,12,9,15,36,49,-13,45
Queen of S't,8905,6,11,11,14,45,47,-2,44
Dumbarton,8905,7,10,10,16,49,58,-9,40
Dunfermline,8905,8,8,12,16,44,56,-12,36
St Mirren,8905,9,8,12,16,40,56,-16,36
Ayr,8905,10,8,12,16,36,53,-17,36
Morton,8906,1,19,11,6,54,31,23,68
Hibernian,8906,2,18,12,6,57,28,29,66
Dundee Utd,8906,3,17,9,10,52,42,10,60
Falkirk,8906,4,14,11,11,55,44,11,53
Queen of S't,8906,5,12,10,14,49,51,-2,46
Dunfermline,8906,6,10,12,14,43,47,-4,42
Dumbarton,8906,7,10,12,14,48,54,-6,42
Ayr,8906,8,9,11,16,34,54,-20,38
Raith,8906,9,9,10,17,31,50,-19,37
St Mirren,8906,10,8,10,18,36,58,-22,34
Hibernian,8907,1,19,12,5,57,30,27,69
Morton,8907,2,16,12,8,51,40,11,60
Falkirk,8907,3,15,10,11,56,41,15,55
Dundee Utd,8907,4,12,13,11,46,44,2,49
Queen of S't,8907,5,12,9,15,50,54,-4,45
Raith,8907,6,12,9,15,34,45,-11,45
Dumbarton,8907,7,11,11,14,50,55,-5,44
Dunfermline,8907,8,10,13,13,50,49,1,43
St Mirren,8907,9,9,12,15,44,53,-9,39
Ayr,8907,10,7,13,16,36,63,-27,34
Hibernian,8908,1,19,11,6,53,24,29,68
Falkirk,8908,2,17,9,10,60,43,17,60
Morton,8908,3,17,9,10,47,37,10,60
Dundee Utd,8908,4,16,11,9,55,43,12,59
Dunfermline,8908,5,10,14,12,47,46,1,44
Raith,8908,6,11,9,16,35,45,-10,42
Dumbarton,8908,7,10,11,15,53,58,-5,41
Queen of S't,8908,8,11,8,17,41,53,-12,41
Ayr,8908,9,9,13,14,35,52,-17,40
St Mirren,8908,10,7,11,18,34,59,-25,32
Hibernian,8909,1,21,12,3,62,21,41,75
Dundee Utd,8909,2,16,9,11,50,40,10,57
Morton,8909,3,15,11,10,49,41,8,56
Falkirk,8909,4,15,9,12,57,45,12,54
Queen of S't,8909,5,14,9,13,48,49,-1,51
Raith,8909,6,11,10,15,39,52,-13,43
Ayr,8909,7,10,13,13,36,51,-15,43
Dunfermline,8909,8,9,12,15,44,52,-8,39
Dumbarton,8909,9,8,11,17,49,64,-15,35
St Mirren,8909,10,7,12,17,36,55,-19,33
Hibernian,8910,1,19,13,4,58,26,32,70
Dundee Utd,8910,2,16,9,11,51,40,11,57
Falkirk,8910,3,15,11,10,57,46,11,56
Morton,8910,4,15,11,10,48,41,7,56
Queen of S't,8910,5,13,9,14,48,49,-1,48
Dumbarton,8910,6,11,10,15,54,60,-6,43
Dunfermline,8910,7,9,13,14,41,46,-5,40
St Mirren,8910,8,10,10,16,42,54,-12,40
Raith,8910,9,10,10,16,39,51,-12,40
Ayr,8910,10,9,10,17,35,60,-25,37
Hibernian,8911,1,20,11,5,59,28,31,71
Morton,8911,2,18,9,9,52,39,13,63
Falkirk,8911,3,14,12,10,57,45,12,54
Dundee Utd,8911,4,14,10,12,47,41,6,52
Queen of S't,8911,5,12,10,14,43,48,-5,46
Dumbarton,8911,6,11,11,14,48,54,-6,44
Dunfermline,8911,7,8,15,13,49,54,-5,39
Raith,8911,8,9,12,15,36,46,-10,39
St Mirren,8911,9,9,12,15,42,54,-12,39
Ayr,8911,10,8,12,16,32,56,-24,36
Hibernian,8912,1,17,11,8,49,28,21,62
Falkirk,8912,2,16,11,9,55,39,16,59
Morton,8912,3,16,10,10,47,38,9,58
Dundee Utd,8912,4,15,8,13,54,44,10,53
Queen of S't,8912,5,14,8,14,48,50,-2,50
Dunfermline,8912,6,12,12,12,50,48,2,48
Raith,8912,7,13,8,15,40,44,-4,47
Dumbarton,8912,8,10,11,15,48,58,-10,41
Ayr,8912,9,9,10,17,32,58,-26,37
St Mirren,8912,10,8,11,17,37,53,-16,35
Morton,8913,1,19,10,7,62,41,21,67
Hibernian,8913,2,17,13,6,52,26,26,64
Dundee Utd,8913,3,17,10,9,55,39,16,61
Falkirk,8913,4,15,10,11,55,41,14,55
Dunfermline,8913,5,11,13,12,50,50,0,46
Queen of S't,8913,6,12,8,16,46,51,-5,44
Raith,8913,7,11,9,16,34,46,-12,42
Dumbarton,8913,8,9,11,16,50,65,-15,38
St Mirren,8913,9,9,10,17,42,58,-16,37
Ayr,8913,10,7,12,17,31,60,-29,33
Hibernian,8914,1,19,11,6,56,32,24,68
Morton,8914,2,17,12,7,55,34,21,63
Dundee Utd,8914,3,17,10,9,55,39,16,61
Falkirk,8914,4,17,9,10,62,45,17,60
Queen of S't,8914,5,12,11,13,47,48,-1,47
Dumbarton,8914,6,9,13,14,47,55,-8,40
Raith,8914,7,10,10,16,33,48,-15,40
Dunfermline,8914,8,8,13,15,42,54,-12,37
Ayr,8914,9,9,10,17,33,56,-23,37
St Mirren,8914,10,8,9,19,39,58,-19,33
Hibernian,8915,1,18,14,4,55,25,30,68
Falkirk,8915,2,17,11,8,60,37,23,62
Morton,8915,3,16,13,7,51,39,12,61
Dundee Utd,8915,4,16,11,9,49,37,12,59
Dunfermline,8915,5,11,12,13,50,55,-5,45
Queen of S't,8915,6,11,8,17,42,52,-10,41
Dumbarton,8915,7,9,10,17,47,61,-14,37
Raith,8915,8,9,10,17,36,53,-17,37
Ayr,8915,9,8,13,15,35,55,-20,37
St Mirren,8915,10,8,12,16,45,56,-11,36
Hibernian,8916,1,16,12,8,48,26,22,60
Morton,8916,2,16,12,8,47,36,11,60
Dundee Utd,8916,3,16,10,10,49,41,8,58
Falkirk,8916,4,15,11,10,56,46,10,56
Dunfermline,8916,5,13,12,11,54,44,10,51
Queen of S't,8916,6,11,10,15,46,52,-6,43
Raith,8916,7,10,12,14,37,47,-10,42
Dumbarton,8916,8,9,11,16,44,55,-11,38
St Mirren,8916,9,9,11,16,39,54,-15,38
Ayr,8916,10,8,13,15,35,54,-19,37
Hibernian,8917,1,19,11,6,55,29,26,68
Morton,8917,2,18,11,7,57,35,22,65
Falkirk,8917,3,16,10,10,63,46,17,58
Dundee Utd,8917,4,16,9,11,51,41,10,57
Queen of S't,8917,5,14,8,14,48,50,-2,50
Ayr,8917,6,11,11,14,38,54,-16,44
Dumbarton,8917,7,9,11,16,49,60,-11,38
Raith,8917,8,9,10,17,39,54,-15,37
St Mirren,8917,9,8,12,16,43,61,-18,36
Dunfermline,8917,10,8,11,17,41,54,-13,35
Hibernian,8918,1,19,11,6,53,26,27,68
Falkirk,8918,2,18,10,8,58,35,23,64
Dundee Utd,8918,3,18,9,9,60,36,24,63
Morton,8918,4,15,12,9,51,41,10,57
Raith,8918,5,13,9,14,39,45,-6,48
Queen of S't,8918,6,11,9,16,40,51,-11,42
Dunfermline,8918,7,9,12,15,42,53,-11,39
St Mirren,8918,8,9,10,17,40,56,-16,37
Dumbarton,8918,9,8,12,16,47,59,-12,36
Ayr,8918,10,7,12,17,30,58,-28,33
Hibernian,8919,1,18,12,6,53,27,26,66
Morton,8919,2,17,13,6,47,31,16,64
Falkirk,8919,3,17,10,9,55,37,18,61
Dundee Utd,8919,4,17,9,10,49,36,13,60
Dunfermline,8919,5,11,12,13,47,45,2,45
Ayr,8919,6,9,13,14,33,52,-19,40
Queen of S't,8919,7,10,9,17,42,51,-9,39
Raith,8919,8,9,11,16,33,49,-16,38
Dumbarton,8919,9,8,12,16,44,56,-12,36
St Mirren,8919,10,9,9,18,38,57,-19,36
Hibernian,8920,1,21,10,5,62,26,36,73
Dundee Utd,8920,2,17,10,9,51,37,14,61
Falkirk,8920,3,16,10,10,58,43,15,58
Morton,8920,4,16,10,10,45,39,6,58
Queen of S't,8920,5,12,9,15,48,52,-4,45
Dumbarton,8920,6,9,12,15,51,57,-6,39
Dunfermline,8920,7,9,12,15,45,55,-10,39
Raith,8920,8,10,9,17,37,50,-13,39
St Mirren,8920,9,9,11,16,43,59,-16,38
Ayr,8920,10,9,11,16,33,55,-22,38
Hibernian,8921,1,21,10,5,57,23,34,73
Falkirk,8921,2,15,12,9,54,40,14,57
Dundee Utd,8921,3,16,9,11,47,38,9,57
Morton,8921,4,15,11,10,50,39,11,56
Queen of S't,8921,5,12,9,15,41,46,-5,45
Dunfermline,8921,6,10,14,12,45,46,-1,44
Raith,8921,7,11,10,15,36,47,-11,43
Dumbarton,8921,8,9,13,14,49,57,-8,40
Ayr,8921,9,9,10,17,33,58,-25,37
St Mirren,8921,10,8,10,18,39,57,-18,34
Hibernian,8922,1,19,12,5,54,25,29,69
Falkirk,8922,2,18,10,8,62,41,21,64
Morton,8922,3,17,11,8,51,36,15,62
Dundee Utd,8922,4,17,9,10,52,40,12,60
Queen of S't,8922,5,11,12,13,43,48,-5,45
Dumbarton,8922,6,9,13,14,50,59,-9,40
Raith,8922,7,10,9,17,36,49,-13,39
Dunfermline,8922,8,8,13,15,42,51,-9,37
Ayr,8922,9,8,13,15,34,55,-21,37
St Mirren,8922,10,7,10,19,41,61,-20,31
Hibernian,8923,1,21,11,4,60,26,34,74
Morton,8923,2,15,11,10,46,42,4,56
Falkirk,8923,3,14,13,9,57,43,14,55
Dundee Utd,8923,4,14,12,10,51,44,7,54
Queen of S't,8923,5,12,11,13,46,48,-2,47
Dunfermline,8923,6,10,14,12,47,45,2,44
Dumbarton,8923,7,10,12,14,54,56,-2,42
Raith,8923,8,10,9,17,36,52,-16,39
St Mirren,8923,9,9,11,16,40,55,-15,38
Ayr,8923,10,8,10,18,31,57,-26,34
Hibernian,8924,1,18,14,4,54,25,29,68
Morton,8924,2,16,12,8,51,37,14,60
Dundee Utd,8924,3,17,9,10,50,36,14,60
Falkirk,8924,4,16,10,10,62,46,16,58
Queen of S't,8924,5,12,10,14,44,47,-3,46
Dunfermline,8924,6,10,12,14,44,47,-3,42
Dumbarton,8924,7,10,11,15,45,53,-8,41
Raith,8924,8,9,11,16,36,52,-16,38
Ayr,8924,9,9,11,16,32,54,-22,38
St Mirren,8924,10,7,12,17,38,59,-21,33
Hibernian,8925,1,20,11,5,52,25,27,71
Morton,8925,2,18,10,8,49,35,14,64
Dundee Utd,8925,3,15,12,9,49,40,9,57
Falkirk,8925,4,15,11,10,57,42,15,56
Queen of S't,8925,5,12,12,12,50,47,3,48
Dunfermline,8925,6,10,13,13,48,47,1,43
Ayr,8925,7,9,13,14,37,50,-13,40
Dumbarton,8925,8,9,11,16,47,65,-18,38
Raith,8925,9,8,11,17,32,49,-17,35
St Mirren,8925,10,6,12,18,35,56,-21,30
Hibernian,8926,1,20,13,3,54,23,31,73
Dundee Utd,8926,2,18,9,9,54,37,17,63
Morton,8926,3,15,12,9,52,40,12,57
Falkirk,8926,4,14,13,9,55,40,15,55
Dunfermline,8926,5,9,14,13,49,55,-6,41
Queen of S't,8926,6,11,8,17,43,54,-11,41
Raith,8926,7,10,10,16,38,49,-11,40
Dumbarton,8926,8,9,12,15,50,59,-9,39
Ayr,8926,9,9,11,16,35,55,-20,38
St Mirren,8926,10,9,10,17,37,55,-18,37
Hibernian,8927,1,19,14,3,56,22,34,71
Morton,8927,2,16,12,8,49,38,11,60
Falkirk,8927,3,15,12,9,56,40,16,57
Dundee Utd,8927,4,13,11,12,48,48,0,50
Queen of S't,8927,5,12,9,15,46,51,-5,45
Dunfermline,8927,6,10,12,14,48,53,-5,42
Raith,8927,7,11,9,16,35,48,-13,42
St Mirren,8927,8,10,11,15,42,50,-8,41
Dumbarton,8927,9,8,13,15,49,60,-11,37
Ayr,8927,10,8,13,15,33,52,-19,37
Hibernian,8928,1,19,13,4,54,25,29,70
Morton,8928,2,16,12,8,51,39,12,60
Dundee Utd,8928,3,15,11,10,54,38,16,56
Falkirk,8928,4,15,10,11,60,47,13,55
Queen of S't,8928,5,13,11,12,44,45,-1,50
Dunfermline,8928,6,10,14,12,54,54,0,44
Raith,8928,7,11,11,14,38,47,-9,44
Dumbarton,8928,8,8,12,16,49,63,-14,36
St Mirren,8928,9,9,9,18,42,58,-16,36
Ayr,8928,10,6,13,17,29,59,-30,31
Hibernian,8929,1,21,10,5,57,28,29,73
Dundee Utd,8929,2,17,9,10,48,37,11,60
Falkirk,8929,3,16,9,11,56,38,18,57
Morton,8929,4,15,10,11,50,40,10,55
Queen of S't,8929,5,11,11,14,42,50,-8,44
Dumbarton,8929,6,10,12,14,51,57,-6,42
Dunfermline,8929,7,9,13,14,47,51,-4,40
St Mirren,8929,8,10,10,16,42,55,-13,40
Raith,8929,9,10,10,16,31,48,-17,40
Ayr,8929,10,8,12,16,34,54,-20,36
Morton,8930,1,18,12,6,56,37,19,66
Hibernian,8930,2,18,11,7,54,31,23,65
Falkirk,8930,3,16,11,9,61,44,17,59
Dundee Utd,8930,4,15,11,10,53,42,11,56
Queen of S't,8930,5,13,9,14,49,52,-3,48
Dunfermline,8930,6,12,11,13,48,49,-1,47
Ayr,8930,7,10,12,14,36,50,-14,42
Raith,8930,8,9,12,15,37,53,-16,39
Dumbarton,8930,9,7,11,18,48,67,-19,32
St Mirren,8930,10,7,10,19,42,59,-17,31
Morton,8931,1,18,11,7,54,35,19,65
Hibernian,8931,2,17,13,6,57,28,29,64
Falkirk,8931,3,16,12,8,57,38,19,60
Ayr,8931,4,13,11,12,44,50,-6,50
Dundee Utd,8931,5,13,10,13,44,45,-1,49
Raith,8931,6,13,10,13,46,49,-3,49
Queen of S't,8931,7,11,9,16,48,57,-9,42
Dunfermline,8931,8,8,12,16,41,57,-16,36
Dumbarton,8931,9,8,11,17,43,56,-13,35
St Mirren,8931,10,8,11,17,44,63,-19,35
Hibernian,8932,1,21,10,5,60,28,32,73
Morton,8932,2,17,12,7,54,36,18,63
Falkirk,8932,3,16,10,10,59,44,15,58
Dundee Utd,8932,4,14,11,11,47,40,7,53
Queen of S't,8932,5,13,9,14,49,52,-3,48
Dumbarton,8932,6,10,14,12,53,57,-4,44
Ayr,8932,7,8,14,14,34,52,-18,38
Dunfermline,8932,8,8,13,15,45,53,-8,37
Raith,8932,9,9,10,17,34,54,-20,37
St Mirren,8932,10,7,11,18,42,61,-19,32
Hibernian,8933,1,18,12,6,55,29,26,66
Falkirk,8933,2,16,12,8,57,39,18,60
Morton,8933,3,15,12,9,49,38,11,57
Dundee Utd,8933,4,14,12,10,51,40,11,54
Dunfermline,8933,5,10,14,12,51,51,0,44
Raith,8933,6,11,10,15,38,48,-10,43
Queen of S't,8933,7,10,12,14,45,55,-10,42
Dumbarton,8933,8,9,14,13,45,52,-7,41
Ayr,8933,9,8,13,15,33,52,-19,37
St Mirren,8933,10,8,11,17,36,56,-20,35
Hibernian,8934,1,21,11,4,63,27,36,74
Dundee Utd,8934,2,17,9,10,56,40,16,60
Morton,8934,3,15,12,9,50,42,8,57
Falkirk,8934,4,15,10,11,56,45,11,55
Raith,8934,5,12,9,15,46,55,-9,45
Queen of S't,8934,6,12,8,16,45,52,-7,44
Dumbarton,8934,7,10,13,13,47,54,-7,43
Dunfermline,8934,8,9,14,13,47,52,-5,41
Ayr,8934,9,8,12,16,34,56,-22,36
St Mirren,8934,10,6,12,18,40,61,-21,30
Hibernian,8935,1,19,13,4,52,27,25,70
Dundee Utd,8935,2,19,9,8,62,40,22,66
Falkirk,8935,3,15,13,8,55,40,15,58
Morton,8935,4,14,12,10,49,38,11,54
Dunfermline,8935,5,10,13,13,49,52,-3,43
Queen of S't,8935,6,11,10,15,46,50,-4,43
Raith,8935,7,11,9,16,39,50,-11,42
Dumbarton,8935,8,8,13,15,44,56,-12,37
Ayr,8935,9,8,13,15,32,52,-20,37
St Mirren,8935,10,7,11,18,36,59,-23,32
Hibernian,8936,1,20,13,3,55,22,33,73
Morton,8936,2,15,14,7,47,35,12,59
Dundee Utd,8936,3,16,10,10,46,37,9,58
Falkirk,8936,4,14,11,11,56,44,12,53
Ayr,8936,5,12,10,14,38,50,-12,46
Queen of S't,8936,6,12,9,15,47,49,-2,45
Dunfermline,8936,7,9,14,13,47,51,-4,41
Raith,8936,8,11,8,17,37,53,-16,41
Dumbarton,8936,9,8,14,14,48,57,-9,38
St Mirren,8936,10,6,11,19,34,57,-23,29
Hibernian,8937,1,19,13,4,55,25,30,70
Dundee Utd,8937,2,18,8,10,59,37,22,62
Morton,8937,3,16,10,10,49,40,9,58
Falkirk,8937,4,15,12,9,63,44,19,57
Dunfermline,8937,5,11,11,14,48,51,-3,44
Dumbarton,8937,6,11,11,14,55,64,-9,44
Queen of S't,8937,7,11,8,17,44,57,-13,41
Raith,8937,8,10,10,16,36,49,-13,40
Ayr,8937,9,9,11,16,39,58,-19,38
St Mirren,8937,10,8,10,18,40,63,-23,34
Morton,8938,1,17,12,7,46,31,15,63
Falkirk,8938,2,17,11,8,59,35,24,62
Hibernian,8938,3,15,14,7,50,32,18,59
Dunfermline,8938,4,13,12,11,54,45,9,51
Dundee Utd,8938,5,14,9,13,46,44,2,51
Queen of S't,8938,6,12,10,14,46,51,-5,46
St Mirren,8938,7,10,12,14,40,49,-9,42
Raith,8938,8,9,11,16,35,52,-17,38
Dumbarton,8938,9,8,12,16,45,59,-14,36
Ayr,8938,10,7,13,16,32,55,-23,34
Hibernian,8939,1,19,13,4,62,25,37,70
Falkirk,8939,2,17,11,8,60,40,20,62
Morton,8939,3,14,16,6,47,37,10,58
Dundee Utd,8939,4,15,10,11,53,44,9,55
Dunfermline,8939,5,11,13,12,49,47,2,46
Queen of S't,8939,6,11,10,15,56,59,-3,43
Raith,8939,7,10,10,16,36,50,-14,40
Dumbarton,8939,8,8,12,16,42,61,-19,36
St Mirren,8939,9,8,11,17,42,61,-19,35
Ayr,8939,10,7,14,15,35,58,-23,35
Hibernian,8940,1,19,13,4,53,24,29,70
Dundee Utd,8940,2,18,9,9,52,40,12,63
Morton,8940,3,15,14,7,47,35,12,59
Falkirk,8940,4,14,11,11,55,43,12,53
Raith,8940,5,11,10,15,36,46,-10,43
Queen of S't,8940,6,11,9,16,43,51,-8,42
Dunfermline,8940,7,8,15,13,47,48,-1,39
Dumbarton,8940,8,9,12,15,47,58,-11,39
St Mirren,8940,9,10,9,17,41,54,-13,39
Ayr,8940,10,8,12,16,32,54,-22,36
Hibernian,8941,1,18,13,5,55,25,30,67
Morton,8941,2,18,10,8,50,38,12,64
Falkirk,8941,3,15,11,10,54,40,14,56
Dundee Utd,8941,4,13,10,13,49,50,-1,49
Queen of S't,8941,5,13,10,13,49,52,-3,49
Dumbarton,8941,6,11,11,14,48,54,-6,44
Dunfermline,8941,7,9,14,13,48,49,-1,41
Raith,8941,8,10,11,15,37,47,-10,41
St Mirren,8941,9,9,10,17,37,54,-17,37
Ayr,8941,10,8,12,16,34,52,-18,36
Hibernian,8942,1,18,13,5,58,27,31,67
Dundee Utd,8942,2,16,10,10,50,40,10,58
Falkirk,8942,3,15,11,10,55,40,15,56
Morton,8942,4,14,14,8,46,39,7,56
Raith,8942,5,11,10,15,36,45,-9,43
Queen of S't,8942,6,11,9,16,42,55,-13,42
St Mirren,8942,7,10,11,15,41,53,-12,41
Ayr,8942,8,9,14,13,40,53,-13,41
Dumbarton,8942,9,9,12,15,48,58,-10,39
Dunfermline,8942,10,8,14,14,43,49,-6,38
Hibernian,8943,1,21,11,4,62,24,38,74
Morton,8943,2,18,10,8,49,35,14,64
Dundee Utd,8943,3,18,8,10,57,38,19,62
Falkirk,8943,4,15,11,10,60,48,12,56
Queen of S't,8943,5,14,8,14,46,47,-1,50
Dunfermline,8943,6,11,11,14,45,47,-2,44
St Mirren,8943,7,8,12,16,42,56,-14,36
Raith,8943,8,8,12,16,33,51,-18,36
Dumbarton,8943,9,8,10,18,43,60,-17,34
Ayr,8943,10,7,11,18,32,63,-31,32
Morton,8944,1,17,13,6,52,36,16,64
Hibernian,8944,2,16,15,5,52,27,25,63
Falkirk,8944,3,17,11,8,61,35,26,62
Dundee Utd,8944,4,15,11,10,47,41,6,56
Dunfermline,8944,5,10,13,13,47,49,-2,43
Queen of S't,8944,6,11,10,15,42,48,-6,43
Dumbarton,8944,7,9,15,12,50,56,-6,42
St Mirren,8944,8,9,11,16,43,61,-18,38
Raith,8944,9,8,11,17,33,52,-19,35
Ayr,8944,10,7,12,17,35,57,-22,33
Morton,8945,1,18,11,7,48,31,17,65
Hibernian,8945,2,18,10,8,50,26,24,64
Falkirk,8945,3,15,13,8,58,41,17,58
Dundee Utd,8945,4,13,13,10,49,42,7,52
Queen of S't,8945,5,11,10,15,45,51,-6,43
Dunfermline,8945,6,9,14,13,48,50,-2,41
Dumbarton,8945,7,9,14,13,47,54,-7,41
Ayr,8945,8,9,13,14,33,52,-19,40
Raith,8945,9,9,12,15,30,45,-15,39
St Mirren,8945,10,8,12,16,38,54,-16,36
Hibernian,8946,1,18,13,5,61,32,29,67
Morton,8946,2,17,13,6,56,39,17,64
Falkirk,8946,3,16,11,9,56,41,15,59
Dundee Utd,8946,4,15,12,9,53,40,13,57
Dunfermline,8946,5,11,14,11,52,48,4,47
Queen of S't,8946,6,11,10,15,47,52,-5,43
Raith,8946,7,10,11,15,37,48,-11,41
Ayr,8946,8,8,13,15,35,56,-21,37
Dumbarton,8946,9,8,12,16,46,65,-19,36
St Mirren,8946,10,7,9,20,36,58,-22,30
Hibernian,8947,1,21,11,4,61,24,37,74
Morton,8947,2,17,11,8,50,39,11,62
Falkirk,8947,3,16,10,10,57,42,15,58
Dundee Utd,8947,4,13,10,13,45,50,-5,49
Queen of S't,8947,5,12,10,14,48,49,-1,46
Dumbarton,8947,6,10,13,13,50,53,-3,43
Dunfermline,8947,7,9,12,15,42,49,-7,39
St Mirren,8947,8,9,12,15,38,52,-14,39
Raith,8947,9,9,11,16,35,49,-14,38
Ayr,8947,10,8,12,16,36,55,-19,36
Hibernian,8948,1,18,13,5,54,27,27,67
Falkirk,8948,2,16,11,9,63,43,20,59
Morton,8948,3,16,11,9,49,38,11,59
Dundee Utd,8948,4,14,11,11,50,48,2,53
Queen of S't,8948,5,14,9,13,49,46,3,51
Dumbarton,8948,6,10,12,14,52,60,-8,42
Raith,8948,7,11,8,17,36,55,-19,41
Dunfermline,8948,8,9,12,15,43,48,-5,39
Ayr,8948,9,8,13,15,38,56,-18,37
St Mirren,8948,10,8,12,16,40,53,-13,36
Hibernian,8949,1,19,11,6,61,27,34,68
Falkirk,8949,2,19,9,8,64,39,25,66
Morton,8949,3,18,11,7,48,32,16,65
Dundee Utd,8949,4,18,8,10,51,40,11,62
Queen of S't,8949,5,13,8,15,49,55,-6,47
Raith,8949,6,11,9,16,36,55,-19,42
St Mirren,8949,7,9,10,17,43,53,-10,37
Dunfermline,8949,8,7,14,15,43,51,-8,35
Dumbarton,8949,9,8,10,18,46,65,-19,34
Ayr,8949,10,8,10,18,34,58,-24,34
Hibernian,8950,1,19,12,5,59,28,31,69
Falkirk,8950,2,17,11,8,59,39,20,62
Dundee Utd,8950,3,17,10,9,55,40,15,61
Morton,8950,4,16,13,7,51,39,12,61
Queen of S't,8950,5,10,10,16,42,49,-7,40
Dumbarton,8950,6,9,13,14,49,57,-8,40
Raith,8950,7,10,10,16,33,46,-13,40
Dunfermline,8950,8,9,12,15,43,52,-9,39
St Mirren,8950,9,9,11,16,38,54,-16,38
Ayr,8950,10,7,12,17,33,58,-25,33
Hibernian,8951,1,18,12,6,56,31,25,66
Morton,8951,2,18,11,7,52,34,18,65
Dundee Utd,8951,3,18,9,9,51,37,14,63
Falkirk,8951,4,17,10,9,59,39,20,61
Dunfermline,8951,5,11,12,13,48,51,-3,45
Queen of S't,8951,6,9,12,15,39,51,-12,39
Raith,8951,7,9,12,15,36,50,-14,39
Dumbarton,8951,8,9,11,16,52,59,-7,38
Ayr,8951,9,8,12,16,37,59,-22,36
St Mirren,8951,10,8,9,19,42,61,-19,33
Hibernian,8952,1,20,13,3,60,22,38,73
Falkirk,8952,2,17,10,9,56,38,18,61
Dundee Utd,8952,3,17,10,9,51,38,13,61
Morton,8952,4,15,10,11,50,49,1,55
Dunfermline,8952,5,11,12,13,50,49,1,45
Dumbarton,8952,6,10,11,15,49,57,-8,41
Ayr,8952,7,8,14,14,35,52,-17,38
Queen of S't,8952,8,9,10,17,41,56,-15,37
Raith,8952,9,9,10,17,35,52,-17,37
St Mirren,8952,10,8,12,16,40,54,-14,36
Hibernian,8953,1,21,11,4,63,28,35,74
Falkirk,8953,2,16,12,8,61,41,20,60
Dundee Utd,8953,3,16,10,10,53,40,13,58
Morton,8953,4,16,10,10,50,41,9,58
Dunfermline,8953,5,11,12,13,47,50,-3,45
Raith,8953,6,12,8,16,38,51,-13,44
Queen of S't,8953,7,10,9,17,48,57,-9,39
Ayr,8953,8,9,11,16,34,55,-21,38
Dumbarton,8953,9,8,12,16,46,60,-14,36
St Mirren,8953,10,8,11,17,39,56,-17,35
Morton,8954,1,19,11,6,59,32,27,68
Hibernian,8954,2,18,14,4,53,30,23,68
Dundee Utd,8954,3,17,10,9,46,33,13,61
Falkirk,8954,4,16,11,9,61,39,22,59
Queen of S't,8954,5,12,8,16,44,54,-10,44
Raith,8954,6,11,9,16,36,46,-10,42
Dumbarton,8954,7,9,11,16,47,61,-14,38
Dunfermline,8954,8,8,13,15,44,53,-9,37
Ayr,8954,9,8,11,17,36,61,-25,35
St Mirren,8954,10,7,12,17,36,53,-17,33
Hibernian,8955,1,21,12,3,56,20,36,75
Morton,8955,2,17,11,8,49,37,12,62
Falkirk,8955,3,15,10,11,55,42,13,55
Dundee Utd,8955,4,12,15,9,49,43,6,51
Dumbarton,8955,5,12,11,13,49,55,-6,47
St Mirren,8955,6,10,10,16,46,54,-8,40
Dunfermline,8955,7,8,15,13,45,48,-3,39
Queen of S't,8955,8,9,12,15,40,50,-10,39
Raith,8955,9,9,11,16,34,48,-14,38
Ayr,8955,10,7,13,16,31,57,-26,34
Hibernian,8956,1,22,10,4,54,21,33,76
Morton,8956,2,16,11,9,50,38,12,59
Falkirk,8956,3,16,10,10,54,38,16,58
Dundee Utd,8956,4,15,9,12,46,43,3,54
Dunfermline,8956,5,10,13,13,46,47,-1,43
Queen of S't,8956,6,11,10,15,44,49,-5,43
Ayr,8956,7,10,11,15,36,51,-15,41
Dumbarton,8956,8,9,13,14,44,53,-9,40
Raith,8956,9,9,10,17,32,50,-18,37
St Mirren,8956,10,8,11,17,38,54,-16,35
Hibernian,8957,1,20,12,4,59,30,29,72
Morton,8957,2,16,12,8,49,37,12,60
Falkirk,8957,3,15,13,8,54,36,18,58
Dundee Utd,8957,4,14,12,10,47,41,6,54
Dunfermline,8957,5,9,14,13,48,50,-2,41
Queen of S't,8957,6,10,10,16,42,50,-8,40
Dumbarton,8957,7,9,13,14,49,58,-9,40
Ayr,8957,8,8,15,13,35,50,-15,39
Raith,8957,9,10,9,17,33,48,-15,39
St Mirren,8957,10,8,12,16,42,58,-16,36
Hibernian,8958,1,18,14,4,50,22,28,68
Dundee Utd,8958,2,17,10,9,51,35,16,61
Falkirk,8958,3,16,11,9,60,41,19,59
Morton,8958,4,15,13,8,47,35,12,58
Dunfermline,8958,5,12,13,11,49,44,5,49
Queen of S't,8958,6,10,11,15,44,53,-9,41
Raith,8958,7,9,11,16,32,46,-14,38
Dumbarton,8958,8,9,11,16,48,63,-15,38
St Mirren,8958,9,9,10,17,41,56,-15,37
Ayr,8958,10,8,10,18,33,60,-27,34
Hibernian,8959,1,19,10,7,54,29,25,67
Morton,8959,2,17,10,9,54,37,17,61
Falkirk,8959,3,16,10,10,55,39,16,58
Dundee Utd,8959,4,15,10,11,52,43,9,55
Queen of S't,8959,5,13,11,12,47,45,2,50
Raith,8959,6,11,10,15,37,49,-12,43
Dunfermline,8959,7,10,12,14,46,52,-6,42
Ayr,8959,8,10,12,14,38,57,-19,42
Dumbarton,8959,9,9,10,17,49,63,-14,37
St Mirren,8959,10,8,9,19,39,57,-18,33
Hibernian,8960,1,18,13,5,53,28,25,67
Morton,8960,2,17,11,8,50,36,14,62
Dundee Utd,8960,3,16,10,10,54,37,17,58
Falkirk,8960,4,14,14,8,56,42,14,56
Dumbarton,8960,5,12,11,13,55,52,3,47
Queen of S't,8960,6,11,10,15,43,52,-9,43
Dunfermline,8960,7,10,12,14,49,54,-5,42
Raith,8960,8,10,11,15,42,55,-13,41
St Mirren,8960,9,8,10,18,41,60,-19,34
Ayr,8960,10,6,14,16,29,56,-27,32
Hibernian,8961,1,20,12,4,58,26,32,72
Falkirk,8961,2,17,10,9,60,38,22,61
Morton,8961,3,17,10,9,47,38,9,61
Dundee Utd,8961,4,13,11,12,50,44,6,50
St Mirren,8961,5,11,9,16,49,56,-7,42
Queen of S't,8961,6,11,9,16,45,53,-8,42
Dunfermline,8961,7,10,12,14,43,51,-8,42
Raith,8961,8,11,9,16,38,48,-10,42
Ayr,8961,9,9,12,15,34,56,-22,39
Dumbarton,8961,10,8,12,16,46,60,-14,36
Hibernian,8962,1,18,11,7,51,32,19,65
Morton,8962,2,17,13,6,52,36,16,64
Dundee Utd,8962,3,17,10,9,54,38,16,61
Falkirk,8962,4,15,11,10,54,39,15,56
Dunfermline,8962,5,10,14,12,48,45,3,44
Queen of S't,8962,6,11,10,15,45,49,-4,43
Dumbarton,8962,7,10,12,14,46,55,-9,42
Raith,8962,8,10,11,15,33,45,-12,41
Ayr,8962,9,9,12,15,35,56,-21,39
St Mirren,8962,10,6,10,20,36,59,-23,28
Hibernian,8963,1,20,10,6,57,25,32,70
Morton,8963,2,18,11,7,54,41,13,65
Falkirk,8963,3,15,12,9,60,43,17,57
Dundee Utd,8963,4,15,10,11,52,45,7,55
Queen of S't,8963,5,12,8,16,45,52,-7,44
Dunfermline,8963,6,9,14,13,48,53,-5,41
Raith,8963,7,10,11,15,39,49,-10,41
Dumbarton,8963,8,8,14,14,48,59,-11,38
Ayr,8963,9,8,13,15,34,56,-22,37
St Mirren,8963,10,8,11,17,41,55,-14,35
Hibernian,8964,1,17,12,7,56,31,25,63
Falkirk,8964,2,17,12,7,60,36,24,63
Morton,8964,3,15,12,9,48,43,5,57
Dundee Utd,8964,4,12,12,12,43,42,1,48
Dunfermline,8964,5,10,15,11,47,46,1,45
Queen of S't,8964,6,11,12,13,46,51,-5,45
St Mirren,8964,7,11,10,15,50,58,-8,43
Ayr,8964,8,10,12,14,40,56,-16,42
Dumbarton,8964,9,9,12,15,49,59,-10,39
Raith,8964,10,9,9,18,38,55,-17,36
Hibernian,8965,1,19,12,5,56,28,28,69
Falkirk,8965,2,17,11,8,58,38,20,62
Morton,8965,3,17,10,9,51,37,14,61
Dundee Utd,8965,4,15,9,12,49,45,4,54
Dunfermline,8965,5,14,11,11,52,44,8,53
Ayr,8965,6,10,11,15,38,56,-18,41
St Mirren,8965,7,10,9,17,45,54,-9,39
Raith,8965,8,10,8,18,32,53,-21,38
Dumbarton,8965,9,8,12,16,47,59,-12,36
Queen of S't,8965,10,9,9,18,39,53,-14,36
Hibernian,8966,1,18,12,6,51,30,21,66
Falkirk,8966,2,17,10,9,62,41,21,61
Morton,8966,3,16,10,10,51,44,7,58
Dundee Utd,8966,4,13,11,12,43,39,4,50
Dumbarton,8966,5,11,12,13,54,55,-1,45
Queen of S't,8966,6,11,12,13,43,47,-4,45
Raith,8966,7,11,10,15,39,48,-9,43
Dunfermline,8966,8,9,15,12,45,48,-3,42
St Mirren,8966,9,9,10,17,41,55,-14,37
Ayr,8966,10,8,12,16,29,51,-22,36
Hibernian,8967,1,20,12,4,56,23,33,72
Dundee Utd,8967,2,17,10,9,49,38,11,61
Falkirk,8967,3,16,12,8,58,40,18,60
Morton,8967,4,14,13,9,47,39,8,55
Queen of S't,8967,5,13,9,14,48,51,-3,48
Raith,8967,6,11,9,16,34,47,-13,42
Dunfermline,8967,7,9,14,13,46,48,-2,41
Dumbarton,8967,8,9,10,17,48,59,-11,37
Ayr,8967,9,8,11,17,33,55,-22,35
St Mirren,8967,10,8,10,18,37,56,-19,34
Hibernian,8968,1,19,12,5,54,21,33,69
Morton,8968,2,16,12,8,47,34,13,60
Falkirk,8968,3,16,11,9,58,39,19,59
Dundee Utd,8968,4,15,12,9,54,37,17,57
Dunfermline,8968,5,10,15,11,45,45,0,45
Raith,8968,6,12,9,15,36,45,-9,45
Queen of S't,8968,7,10,10,16,42,54,-12,40
St Mirren,8968,8,8,13,15,37,53,-16,37
Dumbarton,8968,9,7,13,16,45,63,-18,34
Ayr,8968,10,7,13,16,29,56,-27,34
Hibernian,8969,1,18,13,5,58,28,30,67
Morton,8969,2,16,12,8,48,40,8,60
Falkirk,8969,3,15,13,8,62,43,19,58
Dundee Utd,8969,4,16,9,11,50,44,6,57
Dunfermline,8969,5,12,12,12,50,48,2,48
Queen of S't,8969,6,11,10,15,49,56,-7,43
Ayr,8969,7,9,14,13,35,49,-14,41
St Mirren,8969,8,9,11,16,43,58,-15,38
Raith,8969,9,8,12,16,38,54,-16,36
Dumbarton,8969,10,8,10,18,50,63,-13,34
Hibernian,8970,1,19,14,3,55,26,29,71
Morton,8970,2,18,10,8,53,32,21,64
Falkirk,8970,3,15,12,9,57,39,18,57
Dundee Utd,8970,4,14,10,12,50,44,6,52
Queen of S't,8970,5,13,9,14,45,50,-5,48
St Mirren,8970,6,10,11,15,46,56,-10,41
Raith,8970,7,10,9,17,34,50,-16,39
Dunfermline,8970,8,8,14,14,42,50,-8,38
Ayr,8970,9,8,13,15,38,58,-20,37
Dumbarton,8970,10,8,12,16,46,61,-15,36
Hibernian,8971,1,18,13,5,51,26,25,67
Dundee Utd,8971,2,17,11,8,53,34,19,62
Morton,8971,3,16,12,8,49,35,14,60
Falkirk,8971,4,15,10,11,57,47,10,55
Queen of S't,8971,5,13,10,13,52,47,5,49
Dunfermline,8971,6,10,13,13,47,50,-3,43
Raith,8971,7,10,10,16,38,55,-17,40
Dumbarton,8971,8,9,12,15,51,61,-10,39
St Mirren,8971,9,8,10,18,41,58,-17,34
Ayr,8971,10,7,13,16,34,60,-26,34
Hibernian,8972,1,18,12,6,53,26,27,66
Morton,8972,2,17,10,9,51,41,10,61
Falkirk,8972,3,14,14,8,52,35,17,56
Dundee Utd,8972,4,15,11,10,49,41,8,56
Queen of S't,8972,5,14,9,13,51,50,1,51
Raith,8972,6,12,9,15,39,46,-7,45
Dunfermline,8972,7,9,13,14,46,49,-3,40
Ayr,8972,8,9,13,14,37,55,-18,40
Dumbarton,8972,9,7,14,15,45,59,-14,35
St Mirren,8972,10,7,11,18,37,58,-21,32
Hibernian,8973,1,19,11,6,55,26,29,68
Morton,8973,2,19,10,7,57,35,22,67
Falkirk,8973,3,14,13,9,52,39,13,55
Dundee Utd,8973,4,15,10,11,48,45,3,55
Raith,8973,5,13,9,14,42,45,-3,48
Queen of S't,8973,6,12,10,14,48,54,-6,46
Dunfermline,8973,7,10,12,14,42,51,-9,42
Dumbarton,8973,8,9,11,16,56,60,-4,38
St Mirren,8973,9,8,10,18,42,62,-20,34
Ayr,8973,10,7,12,17,32,57,-25,33
Hibernian,8974,1,20,11,5,59,25,34,71
Falkirk,8974,2,18,10,8,61,38,23,64
Morton,8974,3,17,10,9,51,37,14,61
Dundee Utd,8974,4,17,10,9,52,39,13,61
Dunfermline,8974,5,12,12,12,49,49,0,48
Raith,8974,6,10,9,17,33,49,-16,39
Queen of S't,8974,7,10,8,18,45,54,-9,38
Dumbarton,8974,8,8,11,17,46,63,-17,35
St Mirren,8974,9,8,11,17,38,56,-18,35
Ayr,8974,10,7,14,15,34,58,-24,35
Morton,8975,1,21,9,6,56,33,23,72
Hibernian,8975,2,19,12,5,56,27,29,69
Dundee Utd,8975,3,19,8,9,50,37,13,65
Falkirk,8975,4,14,12,10,57,42,15,54
Queen of S't,8975,5,11,11,14,44,52,-8,44
Dunfermline,8975,6,9,13,14,44,47,-3,40
Raith,8975,7,9,10,17,33,53,-20,37
Dumbarton,8975,8,8,12,16,45,57,-12,36
St Mirren,8975,9,8,12,16,41,55,-14,36
Ayr,8975,10,7,11,18,32,55,-23,32
Hibernian,8976,1,19,13,4,53,25,28,70
Falkirk,8976,2,17,11,8,62,40,22,62
Morton,8976,3,16,12,8,47,35,12,60
Dundee Utd,8976,4,16,11,9,49,37,12,59
Dunfermline,8976,5,10,13,13,47,49,-2,43
Queen of S't,8976,6,11,10,15,43,52,-9,43
Ayr,8976,7,9,12,15,33,51,-18,39
St Mirren,8976,8,9,10,17,42,55,-13,37
Raith,8976,9,9,9,18,33,51,-18,36
Dumbarton,8976,10,8,11,17,47,61,-14,35
Hibernian,8977,1,22,11,3,57,23,34,77
Morton,8977,2,17,11,8,49,35,14,62
Falkirk,8977,3,16,12,8,62,41,21,60
Dundee Utd,8977,4,15,10,11,54,42,12,55
Dunfermline,8977,5,10,13,13,43,47,-4,43
Raith,8977,6,10,11,15,39,49,-10,41
Queen of S't,8977,7,10,10,16,41,53,-12,40
Ayr,8977,8,9,11,16,37,58,-21,38
St Mirren,8977,9,7,13,16,38,54,-16,34
Dumbarton,8977,10,8,10,18,44,62,-18,34
Hibernian,8978,1,20,12,4,60,27,33,72
Morton,8978,2,19,11,6,55,31,24,68
Falkirk,8978,3,15,9,12,56,45,11,54
Dundee Utd,8978,4,15,8,13,46,41,5,53
Dunfermline,8978,5,11,12,13,51,54,-3,45
Queen of S't,8978,6,11,9,16,43,53,-10,42
Dumbarton,8978,7,10,10,16,47,59,-12,40
Raith,8978,8,10,9,17,38,52,-14,39
Ayr,8978,9,8,14,14,33,51,-18,38
St Mirren,8978,10,9,10,17,41,57,-16,37
Hibernian,8979,1,19,14,3,54,24,30,71
Dundee Utd,8979,2,17,8,11,59,43,16,59
Morton,8979,3,14,13,9,50,42,8,55
Falkirk,8979,4,14,10,12,55,47,8,52
Dunfermline,8979,5,10,14,12,49,48,1,44
Ayr,8979,6,11,10,15,36,53,-17,43
Dumbarton,8979,7,10,11,15,47,53,-6,41
Queen of S't,8979,8,10,11,15,42,50,-8,41
Raith,8979,9,11,8,17,36,52,-16,41
St Mirren,8979,10,9,11,16,41,57,-16,38
Hibernian,8980,1,18,12,6,54,26,28,66
Morton,8980,2,16,10,10,52,41,11,58
Falkirk,8980,3,14,13,9,56,41,15,55
Dundee Utd,8980,4,15,10,11,51,42,9,55
Queen of S't,8980,5,14,9,13,48,47,1,51
Dumbarton,8980,6,11,12,13,50,53,-3,45
Ayr,8980,7,10,12,14,37,52,-15,42
Raith,8980,8,10,10,16,35,50,-15,40
Dunfermline,8980,9,9,12,15,47,56,-9,39
St Mirren,8980,10,8,10,18,38,60,-22,34
Hibernian,8981,1,19,12,5,57,24,33,69
Falkirk,8981,2,16,11,9,54,39,15,59
Morton,8981,3,15,14,7,47,37,10,59
Dundee Utd,8981,4,15,11,10,47,37,10,56
Dunfermline,8981,5,12,12,12,47,46,1,48
Queen of S't,8981,6,11,8,17,43,52,-9,41
St Mirren,8981,7,10,10,16,42,52,-10,40
Ayr,8981,8,9,13,14,36,54,-18,40
Raith,8981,9,9,10,17,35,51,-16,37
Dumbarton,8981,10,8,11,17,46,62,-16,35
Hibernian,8982,1,20,11,5,57,27,30,71
Morton,8982,2,19,10,7,52,35,17,67
Falkirk,8982,3,18,9,9,62,40,22,63
Dundee Utd,8982,4,17,8,11,57,46,11,59
Queen of S't,8982,5,14,10,12,48,45,3,52
St Mirren,8982,6,10,9,17,43,56,-13,39
Raith,8982,7,9,9,18,33,51,-18,36
Dumbarton,8982,8,8,11,17,44,62,-18,35
Dunfermline,8982,9,7,13,16,42,52,-10,34
Ayr,8982,10,7,12,17,32,56,-24,33
Hibernian,8983,1,19,13,4,54,25,29,70
Morton,8983,2,18,11,7,50,33,17,65
Falkirk,8983,3,16,12,8,58,39,19,60
Dundee Utd,8983,4,15,11,10,52,44,8,56
Dunfermline,8983,5,10,13,13,50,48,2,43
Queen of S't,8983,6,10,13,13,45,52,-7,43
Dumbarton,8983,7,7,16,13,47,57,-10,37
Raith,8983,8,9,10,17,33,50,-17,37
Ayr,8983,9,8,11,17,33,56,-23,35
St Mirren,8983,10,7,12,17,38,56,-18,33
Hibernian,8984,1,21,12,3,60,22,38,75
Dundee Utd,8984,2,16,10,10,50,41,9,58
Morton,8984,3,15,12,9,52,41,11,57
Falkirk,8984,4,15,10,11,57,41,16,55
Dumbarton,8984,5,11,12,13,55,58,-3,45
Queen of S't,8984,6,11,10,15,46,52,-6,43
St Mirren,8984,7,11,9,16,46,59,-13,42
Raith,8984,8,10,9,17,35,53,-18,39
Dunfermline,8984,9,8,13,15,43,53,-10,37
Ayr,8984,10,6,15,15,31,55,-24,33
Hibernian,8985,1,18,13,5,56,27,29,67
Morton,8985,2,17,13,6,54,39,15,64
Falkirk,8985,3,16,10,10,55,39,16,58
Dundee Utd,8985,4,15,11,10,47,38,9,56
Raith,8985,5,12,9,15,35,44,-9,45
St Mirren,8985,6,10,10,16,44,55,-11,40
Queen of S't,8985,7,10,10,16,41,54,-13,40
Dumbarton,8985,8,9,12,15,52,59,-7,39
Ayr,8985,9,9,11,16,35,54,-19,38
Dunfermline,8985,10,8,13,15,45,55,-10,37
Hibernian,8986,1,19,13,4,51,22,29,70
Dundee Utd,8986,2,18,8,10,58,39,19,62
Morton,8986,3,16,10,10,49,39,10,58
Falkirk,8986,4,15,11,10,57,43,14,56
Queen of S't,8986,5,13,10,13,46,48,-2,49
Dunfermline,8986,6,11,12,13,49,50,-1,45
Dumbarton,8986,7,10,12,14,50,55,-5,42
Raith,8986,8,10,9,17,34,50,-16,39
Ayr,8986,9,9,11,16,31,52,-21,38
St Mirren,8986,10,6,10,20,37,64,-27,28
Hibernian,8987,1,19,13,4,62,26,36,70
Morton,8987,2,17,11,8,49,35,14,62
Dundee Utd,8987,3,17,9,10,52,36,16,60
Falkirk,8987,4,17,9,10,59,44,15,60
Queen of S't,8987,5,12,9,15,44,51,-7,45
St Mirren,8987,6,10,10,16,49,58,-9,40
Dunfermline,8987,7,9,12,15,44,48,-4,39
Ayr,8987,8,9,12,15,36,59,-23,39
Raith,8987,9,9,10,17,32,54,-22,37
Dumbarton,8987,10,8,11,17,46,62,-16,35
Hibernian,8988,1,21,12,3,56,25,31,75
Morton,8988,2,17,10,9,52,37,15,61
Falkirk,8988,3,16,11,9,55,40,15,59
Dundee Utd,8988,4,14,9,13,45,44,1,51
Queen of S't,8988,5,11,11,14,46,48,-2,44
St Mirren,8988,6,11,10,15,43,50,-7,43
Dunfermline,8988,7,9,13,14,47,49,-2,40
Dumbarton,8988,8,9,13,14,48,56,-8,40
Ayr,8988,9,9,11,16,34,57,-23,38
Raith,8988,10,8,10,18,30,50,-20,34
Hibernian,8989,1,19,12,5,53,23,30,69
Morton,8989,2,18,10,8,49,33,16,64
Falkirk,8989,3,16,11,9,58,43,15,59
Dundee Utd,8989,4,14,11,11,46,38,8,53
Queen of S't,8989,5,12,9,15,47,52,-5,45
Raith,8989,6,12,8,16,39,50,-11,44
Ayr,8989,7,10,12,14,37,52,-15,42
Dunfermline,8989,8,9,13,14,45,50,-5,40
Dumbarton,8989,9,8,13,15,46,60,-14,37
St Mirren,8989,10,6,13,17,37,56,-19,31
Hibernian,8990,1,20,11,5,62,27,35,71
Falkirk,8990,2,18,10,8,65,42,23,64
Morton,8990,3,17,12,7,55,40,15,63
Dundee Utd,8990,4,14,12,10,46,41,5,54
Queen of S't,8990,5,10,12,14,43,51,-8,42
Raith,8990,6,11,9,16,39,49,-10,42
Dunfermline,8990,7,9,14,13,45,47,-2,41
Dumbarton,8990,8,8,13,15,44,56,-12,37
St Mirren,8990,9,8,12,16,43,59,-16,36
Ayr,8990,10,6,13,17,32,62,-30,31
Hibernian,8991,1,18,13,5,56,28,28,67
Morton,8991,2,18,10,8,53,40,13,64
Dundee Utd,8991,3,17,9,10,53,38,15,60
Falkirk,8991,4,16,10,10,60,42,18,58
Dunfermline,8991,5,11,12,13,47,53,-6,45
Queen of S't,8991,6,11,10,15,43,51,-8,43
Ayr,8991,7,9,12,15,37,58,-21,39
Raith,8991,8,9,10,17,39,51,-12,37
St Mirren,8991,9,9,10,17,43,56,-13,37
Dumbarton,8991,10,8,12,16,45,59,-14,36
Hibernian,8992,1,21,11,4,60,26,34,74
Morton,8992,2,19,11,6,58,39,19,68
Dundee Utd,8992,3,18,8,10,53,39,14,62
Falkirk,8992,4,17,9,10,59,39,20,60
Queen of S't,8992,5,12,9,15,43,51,-8,45
Dunfermline,8992,6,9,12,15,42,49,-7,39
Raith,8992,7,9,11,16,39,56,-17,38
Dumbarton,8992,8,8,12,16,43,54,-11,36
Ayr,8992,9,7,12,17,32,56,-24,33
St Mirren,8992,10,7,11,18,36,56,-20,32
Hibernian,8993,1,16,14,6,50,28,22,62
Dundee Utd,8993,2,17,11,8,56,39,17,62
Morton,8993,3,16,14,6,52,35,17,62
Falkirk,8993,4,16,10,10,58,46,12,58
St Mirren,8993,5,11,10,15,40,51,-11,43
Raith,8993,6,11,10,15,36,48,-12,43
Dunfermline,8993,7,9,15,12,46,45,1,42
Queen of S't,8993,8,10,10,16,41,50,-9,40
Ayr,8993,9,7,14,15,33,53,-20,35
Dumbarton,8993,10,8,10,18,47,64,-17,34
Hibernian,8994,1,19,14,3,56,23,33,71
Falkirk,8994,2,16,11,9,60,39,21,59
Morton,8994,3,14,12,10,44,40,4,54
Dundee Utd,8994,4,13,12,11,47,40,7,51
Queen of S't,8994,5,12,10,14,44,47,-3,46
Dunfermline,8994,6,11,12,13,49,50,-1,45
Dumbarton,8994,7,10,12,14,47,55,-8,42
Raith,8994,8,10,10,16,37,50,-13,40
Ayr,8994,9,8,16,12,36,52,-16,40
St Mirren,8994,10,6,13,17,37,61,-24,31
Hibernian,8995,1,20,12,4,57,26,31,72
Dundee Utd,8995,2,16,10,10,50,36,14,58
Falkirk,8995,3,14,13,9,60,45,15,55
Morton,8995,4,14,11,11,46,43,3,53
Queen of S't,8995,5,12,10,14,46,50,-4,46
Dunfermline,8995,6,10,14,12,51,51,0,44
Raith,8995,7,10,10,16,33,47,-14,40
St Mirren,8995,8,9,12,15,42,53,-11,39
Ayr,8995,9,9,11,16,34,54,-20,38
Dumbarton,8995,10,8,13,15,44,58,-14,37
Hibernian,8996,1,19,13,4,60,31,29,70
Morton,8996,2,18,11,7,49,33,16,65
Falkirk,8996,3,16,10,10,60,41,19,58
Dundee Utd,8996,4,15,10,11,48,43,5,55
Queen of S't,8996,5,12,9,15,45,51,-6,45
Dumbarton,8996,6,10,12,14,49,56,-7,42
St Mirren,8996,7,10,10,16,48,53,-5,40
Dunfermline,8996,8,8,14,14,43,49,-6,38
Raith,8996,9,9,10,17,33,53,-20,37
Ayr,8996,10,8,11,17,37,62,-25,35
Hibernian,8997,1,19,14,3,57,26,31,71
Morton,8997,2,18,12,6,53,37,16,66
Falkirk,8997,3,17,9,10,58,37,21,60
Dundee Utd,8997,4,14,10,12,49,49,0,52
Queen of S't,8997,5,12,10,14,49,52,-3,46
Dunfermline,8997,6,10,14,12,47,47,0,44
Dumbarton,8997,7,10,12,14,48,53,-5,42
Raith,8997,8,8,11,17,32,49,-17,35
St Mirren,8997,9,7,12,17,39,59,-20,33
Ayr,8997,10,7,12,17,30,53,-23,33
Hibernian,8998,1,20,12,4,55,22,33,72
Morton,8998,2,17,11,8,53,35,18,62
Falkirk,8998,3,16,12,8,57,37,20,60
Dundee Utd,8998,4,16,9,11,47,41,6,57
Dumbarton,8998,5,10,13,13,48,54,-6,43
Queen of S't,8998,6,10,11,15,45,52,-7,41
Dunfermline,8998,7,9,13,14,45,50,-5,40
Raith,8998,8,9,11,16,34,54,-20,38
St Mirren,8998,9,8,11,17,37,55,-18,35
Ayr,8998,10,8,11,17,35,56,-21,35
Hibernian,8999,1,21,10,5,57,23,34,73
Falkirk,8999,2,17,11,8,60,39,21,62
Dundee Utd,8999,3,17,11,8,54,38,16,62
Morton,8999,4,14,11,11,48,44,4,53
Dunfermline,8999,5,10,12,14,48,54,-6,42
Raith,8999,6,11,9,16,38,54,-16,42
Queen of S't,8999,7,10,11,15,43,51,-8,41
St Mirren,8999,8,9,11,16,48,55,-7,38
Dumbarton,8999,9,8,13,15,45,55,-10,37
Ayr,8999,10,7,13,16,35,63,-28,34
Hibernian,9000,1,21,11,4,59,21,38,74
Dundee Utd,9000,2,17,9,10,57,38,19,60
Morton,9000,3,16,10,10,51,42,9,58
Falkirk,9000,4,14,11,11,58,47,11,53
Queen of S't,9000,5,12,10,14,45,49,-4,46
Raith,9000,6,12,10,14,42,48,-6,46
Dumbarton,9000,7,11,10,15,53,58,-5,43
Dunfermline,9000,8,9,12,15,45,62,-17,39
St Mirren,9000,9,9,10,17,38,54,-16,37
Ayr,9000,10,6,13,17,30,59,-29,31
Hibernian,9001,1,18,13,5,55,30,25,67
Falkirk,9001,2,18,11,7,61,38,23,65
Morton,9001,3,16,13,7,50,38,12,61
Dundee Utd,9001,4,14,10,12,48,42,6,52
Dunfermline,9001,5,10,14,12,48,48,0,44
Queen of S't,9001,6,11,9,16,41,50,-9,42
Ayr,9001,7,10,12,14,38,51,-13,42
Raith,9001,8,10,10,16,35,50,-15,40
St Mirren,9001,9,8,13,15,43,54,-11,37
Dumbarton,9001,10,7,11,18,43,61,-18,32
Hibernian,9002,1,18,13,5,51,26,25,67
Dundee Utd,9002,2,18,9,9,59,39,20,63
Morton,9002,3,16,11,9,46,37,9,59
Falkirk,9002,4,16,10,10,57,41,16,58
Queen of S't,9002,5,13,9,14,51,50,1,48
Raith,9002,6,11,10,15,38,49,-11,43
Dunfermline,9002,7,9,13,14,44,50,-6,40
Dumbarton,9002,8,9,10,17,45,60,-15,37
St Mirren,9002,9,9,10,17,41,57,-16,37
Ayr,9002,10,8,11,17,38,61,-23,35
Hibernian,9003,1,19,12,5,59,28,31,69
Falkirk,9003,2,19,9,8,60,36,24,66
Morton,9003,3,16,13,7,54,40,14,61
Dundee Utd,9003,4,14,10,12,49,41,8,52
Queen of S't,9003,5,12,10,14,42,45,-3,46
Raith,9003,6,10,10,16,36,55,-19,40
Dunfermline,9003,7,8,14,14,42,49,-7,38
Dumbarton,9003,8,9,11,16,43,60,-17,38
St Mirren,9003,9,8,12,16,43,58,-15,36
Ayr,9003,10,7,15,14,36,52,-16,36
Hibernian,9004,1,19,12,5,59,31,28,69
Morton,9004,2,16,10,10,55,43,12,58
Dundee Utd,9004,3,15,11,10,55,48,7,56
Falkirk,9004,4,15,10,11,56,43,13,55
Queen of S't,9004,5,14,8,14,52,49,3,50
Dunfermline,9004,6,12,12,12,52,48,4,48
Dumbarton,9004,7,10,11,15,50,61,-11,41
Raith,9004,8,10,10,16,32,50,-18,40
St Mirren,9004,9,9,11,16,45,56,-11,38
Ayr,9004,10,7,11,18,33,60,-27,32
Hibernian,9005,1,21,11,4,59,25,34,74
Morton,9005,2,17,11,8,52,37,15,62
Dundee Utd,9005,3,17,9,10,59,45,14,60
Falkirk,9005,4,13,12,11,53,44,9,51
Dunfermline,9005,5,11,12,13,46,46,0,45
Queen of S't,9005,6,11,9,16,46,52,-6,42
Dumbarton,9005,7,10,10,16,47,60,-13,40
Raith,9005,8,10,10,16,32,45,-13,40
St Mirren,9005,9,8,12,16,39,55,-16,36
Ayr,9005,10,8,12,16,32,56,-24,36
Hibernian,9006,1,18,14,4,55,27,28,68
Morton,9006,2,17,12,7,52,35,17,63
Falkirk,9006,3,16,10,10,59,42,17,58
Dundee Utd,9006,4,15,11,10,54,45,9,56
Dumbarton,9006,5,12,10,14,53,55,-2,46
Ayr,9006,6,10,12,14,38,56,-18,42
Dunfermline,9006,7,9,13,14,46,52,-6,40
Queen of S't,9006,8,10,10,16,43,52,-9,40
Raith,9006,9,10,8,18,32,50,-18,38
St Mirren,9006,10,8,10,18,40,58,-18,34
Hibernian,9007,1,20,12,4,62,26,36,72
Dundee Utd,9007,2,16,10,10,48,39,9,58
Falkirk,9007,3,15,12,9,58,41,17,57
Morton,9007,4,15,11,10,44,36,8,56
Raith,9007,5,13,9,14,39,45,-6,48
Dumbarton,9007,6,11,10,15,49,57,-8,43
Queen of S't,9007,7,11,9,16,46,55,-9,42
Dunfermline,9007,8,9,11,16,41,50,-9,38
Ayr,9007,9,8,13,15,35,54,-19,37
St Mirren,9007,10,8,11,17,39,58,-19,35
Hibernian,9008,1,18,12,6,59,28,31,66
Falkirk,9008,2,17,10,9,57,39,18,61
Dundee Utd,9008,3,17,10,9,51,38,13,61
Morton,9008,4,16,10,10,45,37,8,58
Queen of S't,9008,5,11,9,16,43,53,-10,42
Raith,9008,6,11,9,16,36,49,-13,42
Dunfermline,9008,7,9,14,13,44,47,-3,41
St Mirren,9008,8,10,9,17,39,56,-17,39
Ayr,9008,9,9,12,15,37,55,-18,39
Dumbarton,9008,10,9,11,16,48,57,-9,38
Hibernian,9009,1,19,13,4,61,27,34,70
Morton,9009,2,18,11,7,57,39,18,65
Falkirk,9009,3,16,11,9,59,40,19,59
Dundee Utd,9009,4,15,11,10,48,38,10,56
Queen of S't,9009,5,12,9,15,46,49,-3,45
Raith,9009,6,10,11,15,33,46,-13,41
St Mirren,9009,7,9,11,16,37,53,-16,38
Dunfermline,9009,8,7,15,14,40,50,-10,36
Dumbarton,9009,9,8,12,16,45,64,-19,36
Ayr,9009,10,8,12,16,35,55,-20,36
Hibernian,9010,1,20,11,5,55,24,31,71
Morton,9010,2,16,11,9,44,34,10,59
Falkirk,9010,3,15,10,11,57,46,11,55
Dundee Utd,9010,4,15,9,12,46,40,6,54
Ayr,9010,5,11,11,14,38,54,-16,44
Queen of S't,9010,6,11,10,15,46,51,-5,43
St Mirren,9010,7,11,9,16,44,52,-8,42
Dumbarton,9010,8,10,11,15,50,60,-10,41
Raith,9010,9,10,10,16,36,49,-13,40
Dunfermline,9010,10,8,14,14,45,51,-6,38
Hibernian,9011,1,20,13,3,63,25,38,73
Morton,9011,2,17,11,8,52,39,13,62
Falkirk,9011,3,15,9,12,60,45,15,54
Dundee Utd,9011,4,15,8,13,46,43,3,53
Dunfermline,9011,5,11,12,13,51,48,3,45
Queen of S't,9011,6,11,10,15,46,53,-7,43
Dumbarton,9011,7,10,12,14,47,58,-11,42
Ayr,9011,8,9,13,14,37,51,-14,40
Raith,9011,9,10,9,17,34,58,-24,39
St Mirren,9011,10,9,9,18,45,61,-16,36
Hibernian,9012,1,17,15,4,54,29,25,66
Dundee Utd,9012,2,18,9,9,59,43,16,63
Morton,9012,3,16,13,7,54,37,17,61
Falkirk,9012,4,15,13,8,57,40,17,58
Raith,9012,5,10,12,14,37,48,-11,42
Queen of S't,9012,6,10,11,15,42,52,-10,41
Dumbarton,9012,7,9,12,15,47,56,-9,39
Ayr,9012,8,9,11,16,38,57,-19,38
Dunfermline,9012,9,7,16,13,42,50,-8,37
St Mirren,9012,10,7,12,17,38,56,-18,33
Hibernian,9013,1,19,12,5,56,27,29,69
Morton,9013,2,18,10,8,50,36,14,64
Falkirk,9013,3,18,9,9,56,39,17,63
Dundee Utd,9013,4,17,9,10,53,36,17,60
Queen of S't,9013,5,12,9,15,48,50,-2,45
Dunfermline,9013,6,9,13,14,45,48,-3,40
Ayr,9013,7,9,13,14,32,50,-18,40
Dumbarton,9013,8,9,12,15,48,62,-14,39
Raith,9013,9,8,10,18,36,56,-20,34
St Mirren,9013,10,6,13,17,34,54,-20,31
Hibernian,9014,1,18,13,5,57,27,30,67
Morton,9014,2,16,12,8,47,37,10,60
Dundee Utd,9014,3,16,10,10,49,37,12,58
Falkirk,9014,4,14,11,11,58,45,13,53
Queen of S't,9014,5,13,9,14,50,52,-2,48
St Mirren,9014,6,11,10,15,40,51,-11,43
Dunfermline,9014,7,9,14,13,49,50,-1,41
Raith,9014,8,10,10,16,38,50,-12,40
Ayr,9014,9,9,11,16,33,54,-21,38
Dumbarton,9014,10,7,14,15,41,59,-18,35
Hibernian,9015,1,18,13,5,52,25,27,67
Dundee Utd,9015,2,18,10,8,51,35,16,64
Morton,9015,3,15,12,9,52,39,13,57
Falkirk,9015,4,15,10,11,58,43,15,55
Queen of S't,9015,5,13,10,13,50,51,-1,49
Dunfermline,9015,6,10,12,14,45,51,-6,42
Raith,9015,7,11,8,17,37,48,-11,41
Dumbarton,9015,8,9,13,14,52,62,-10,40
St Mirren,9015,9,9,10,17,42,59,-17,37
Ayr,9015,10,6,14,16,31,57,-26,32
Hibernian,9016,1,20,11,5,58,25,33,71
Dundee Utd,9016,2,19,8,9,61,37,24,65
Falkirk,9016,3,17,10,9,58,38,20,61
Morton,9016,4,16,10,10,53,42,11,58
Raith,9016,5,12,9,15,35,46,-11,45
Dunfermline,9016,6,10,12,14,48,53,-5,42
Dumbarton,9016,7,10,11,15,50,60,-10,41
Queen of S't,9016,8,10,9,17,45,54,-9,39
Ayr,9016,9,8,11,17,28,61,-33,35
St Mirren,9016,10,7,11,18,37,57,-20,32
Hibernian,9017,1,19,11,6,55,29,26,68
Falkirk,9017,2,18,10,8,58,38,20,64
Morton,9017,3,15,12,9,48,38,10,57
Dundee Utd,9017,4,14,10,12,51,43,8,52
Dunfermline,9017,5,12,12,12,43,42,1,48
Queen of S't,9017,6,11,10,15,45,51,-6,43
St Mirren,9017,7,11,9,16,41,51,-10,42
Raith,9017,8,11,9,16,38,48,-10,42
Dumbarton,9017,9,9,12,15,49,60,-11,39
Ayr,9017,10,7,11,18,30,58,-28,32
Hibernian,9018,1,18,11,7,53,26,27,65
Morton,9018,2,17,11,8,49,34,15,62
Falkirk,9018,3,16,10,10,56,38,18,58
Dundee Utd,9018,4,15,10,11,46,41,5,55
Queen of S't,9018,5,14,8,14,50,48,2,50
Dunfermline,9018,6,11,12,13,47,47,0,45
Raith,9018,7,11,8,17,35,51,-16,41
Dumbarton,9018,8,9,11,16,44,56,-12,38
St Mirren,9018,9,9,11,16,36,52,-16,38
Ayr,9018,10,8,12,16,35,58,-23,36
Hibernian,9019,1,20,11,5,55,29,26,71
Falkirk,9019,2,15,11,10,55,40,15,56
Morton,9019,3,15,11,10,48,37,11,56
Dundee Utd,9019,4,14,13,9,53,45,8,55
Dunfermline,9019,5,11,12,13,47,47,0,45
Dumbarton,9019,6,11,11,14,49,57,-8,44
Ayr,9019,7,9,15,12,34,49,-15,42
Raith,9019,8,10,9,17,34,47,-13,39
Queen of S't,9019,9,9,11,16,42,52,-10,38
St Mirren,9019,10,8,12,16,44,58,-14,36
Hibernian,9020,1,20,12,4,59,27,32,72
Dundee Utd,9020,2,18,8,10,55,40,15,62
Morton,9020,3,15,13,8,51,38,13,58
Falkirk,9020,4,15,10,11,57,47,10,55
Raith,9020,5,11,11,14,37,46,-9,44
Dunfermline,9020,6,10,12,14,48,51,-3,42
Dumbarton,9020,7,10,11,15,49,60,-11,41
Queen of S't,9020,8,10,10,16,42,52,-10,40
St Mirren,9020,9,9,10,17,40,55,-15,37
Ayr,9020,10,7,13,16,33,55,-22,34
Hibernian,9021,1,18,12,6,53,25,28,66
Morton,9021,2,17,11,8,49,36,13,62
Dundee Utd,9021,3,17,9,10,53,40,13,60
Falkirk,9021,4,16,9,11,59,45,14,57
Queen of S't,9021,5,13,9,14,42,47,-5,48
Ayr,9021,6,10,12,14,35,50,-15,42
Dunfermline,9021,7,9,14,13,46,49,-3,41
Dumbarton,9021,8,10,11,15,47,55,-8,41
Raith,9021,9,9,8,19,33,51,-18,35
St Mirren,9021,10,8,11,17,36,55,-19,35
Hibernian,9022,1,21,11,4,58,23,35,74
Morton,9022,2,18,9,9,53,37,16,63
Dundee Utd,9022,3,17,9,10,51,40,11,60
Falkirk,9022,4,16,10,10,57,40,17,58
Raith,9022,5,10,10,16,31,45,-14,40
Dumbarton,9022,6,9,12,15,48,58,-10,39
Queen of S't,9022,7,10,9,17,41,52,-11,39
St Mirren,9022,8,9,12,15,38,52,-14,39
Dunfermline,9022,9,8,14,14,43,52,-9,38
Ayr,9022,10,8,12,16,34,55,-21,36
Hibernian,9023,1,20,13,3,55,22,33,73
Falkirk,9023,2,16,11,9,60,39,21,59
Morton,9023,3,15,12,9,49,39,10,57
Dundee Utd,9023,4,14,11,11,47,45,2,53
Dunfermline,9023,5,11,13,12,47,44,3,46
Queen of S't,9023,6,11,11,14,44,50,-6,44
Dumbarton,9023,7,10,11,15,48,56,-8,41
Raith,9023,8,9,11,16,33,49,-16,38
St Mirren,9023,9,8,11,17,43,61,-18,35
Ayr,9023,10,7,14,15,33,54,-21,35
Morton,9024,1,19,11,6,52,32,20,68
Hibernian,9024,2,18,12,6,48,25,23,66
Falkirk,9024,3,18,11,7,63,38,25,65
Dundee Utd,9024,4,16,10,10,56,44,12,58
Queen of S't,9024,5,11,11,14,45,48,-3,44
Raith,9024,6,10,11,15,35,49,-14,41
Dumbarton,9024,7,9,10,17,46,57,-11,37
Ayr,9024,8,9,10,17,34,56,-22,37
Dunfermline,9024,9,8,12,16,44,54,-10,36
St Mirren,9024,10,8,10,18,37,57,-20,34
Hibernian,9025,1,20,12,4,59,25,34,72
Falkirk,9025,2,17,10,9,61,42,19,61
Dundee Utd,9025,3,17,9,10,58,38,20,60
Morton,9025,4,15,12,9,52,41,11,57
Queen of S't,9025,5,11,12,13,50,50,0,45
Dunfermline,9025,6,10,12,14,48,54,-6,42
Raith,9025,7,10,11,15,35,47,-12,41
St Mirren,9025,8,10,10,16,40,57,-17,40
Dumbarton,9025,9,7,13,16,45,62,-17,34
Ayr,9025,10,6,13,17,28,60,-32,31
Hibernian,9026,1,18,13,5,52,27,25,67
Dundee Utd,9026,2,17,9,10,53,40,13,60
Morton,9026,3,16,12,8,48,36,12,60
Falkirk,9026,4,14,11,11,54,44,10,53
Queen of S't,9026,5,14,8,14,49,47,2,50
Dunfermline,9026,6,11,12,13,46,45,1,45
St Mirren,9026,7,11,10,15,47,52,-5,43
Dumbarton,9026,8,8,13,15,45,58,-13,37
Raith,9026,9,9,9,18,30,52,-22,36
Ayr,9026,10,7,13,16,29,52,-23,34
Hibernian,9027,1,18,14,4,58,26,32,68
Falkirk,9027,2,18,9,9,60,40,20,63
Morton,9027,3,16,13,7,52,35,17,61
Dundee Utd,9027,4,17,9,10,52,39,13,60
Queen of S't,9027,5,12,10,14,46,51,-5,46
Dunfermline,9027,6,10,11,15,45,50,-5,41
Raith,9027,7,10,10,16,32,48,-16,40
St Mirren,9027,8,9,10,17,37,53,-16,37
Dumbarton,9027,9,8,11,17,42,58,-16,35
Ayr,9027,10,8,11,17,33,57,-24,35
Morton,9028,1,20,9,7,52,34,18,69
Hibernian,9028,2,18,14,4,53,24,29,68
Dundee Utd,9028,3,16,10,10,49,41,8,58
Falkirk,9028,4,13,11,12,52,47,5,50
Queen of S't,9028,5,12,11,13,46,47,-1,47
Dumbarton,9028,6,10,11,15,52,58,-6,41
St Mirren,9028,7,9,12,15,37,48,-11,39
Raith,9028,8,10,9,17,36,53,-17,39
Dunfermline,9028,9,7,15,14,44,50,-6,36
Ayr,9028,10,7,14,15,33,52,-19,35
Hibernian,9029,1,19,12,5,53,25,28,69
Morton,9029,2,17,14,5,47,30,17,65
Falkirk,9029,3,16,11,9,56,38,18,59
Dundee Utd,9029,4,15,9,12,50,43,7,54
Queen of S't,9029,5,14,9,13,47,47,0,51
Dunfermline,9029,6,10,12,14,47,53,-6,42
Raith,9029,7,10,8,18,36,51,-15,38
Dumbarton,9029,8,8,12,16,46,59,-13,36
St Mirren,9029,9,8,12,16,42,55,-13,36
Ayr,9029,10,8,11,17,36,59,-23,35
Hibernian,9030,1,20,11,5,58,28,30,71
Dundee Utd,9030,2,18,9,9,50,35,15,63
Morton,9030,3,16,11,9,53,41,12,59
Falkirk,9030,4,15,12,9,56,40,16,57
Dunfermline,9030,5,10,14,12,45,48,-3,44
Raith,9030,6,11,10,15,35,46,-11,43
Queen of S't,9030,7,11,9,16,42,50,-8,42
Ayr,9030,8,9,11,16,38,53,-15,38
Dumbarton,9030,9,8,11,17,47,61,-14,35
St Mirren,9030,10,7,12,17,38,60,-22,33
Hibernian,9031,1,19,13,4,57,27,30,70
Morton,9031,2,17,11,8,52,39,13,62
Dundee Utd,9031,3,16,10,10,51,39,12,58
Falkirk,9031,4,13,12,11,54,46,8,51
Queen of S't,9031,5,14,9,13,52,50,2,51
Dunfermline,9031,6,10,12,14,47,49,-2,42
Raith,9031,7,10,9,17,38,49,-11,39
Dumbarton,9031,8,9,12,15,51,64,-13,39
Ayr,9031,9,9,11,16,33,54,-21,38
St Mirren,9031,10,8,11,17,41,59,-18,35
Hibernian,9032,1,18,12,6,54,27,27,66
Morton,9032,2,17,12,7,48,34,14,63
Dundee Utd,9032,3,16,11,9,53,39,14,59
Falkirk,9032,4,15,11,10,60,46,14,56
Dunfermline,9032,5,11,12,13,48,48,0,45
Dumbarton,9032,6,9,14,13,50,53,-3,41
Raith,9032,7,10,9,17,32,50,-18,39
Ayr,9032,8,9,12,15,35,54,-19,39
St Mirren,9032,9,9,11,16,37,51,-14,38
Queen of S't,9032,10,9,10,17,42,57,-15,37
Morton,9033,1,17,12,7,50,35,15,63
Hibernian,9033,2,16,13,7,53,30,23,61
Falkirk,9033,3,16,10,10,57,45,12,58
Dundee Utd,9033,4,15,11,10,47,39,8,56
Dunfermline,9033,5,12,12,12,49,47,2,48
Queen of S't,9033,6,11,10,15,45,52,-7,43
Ayr,9033,7,9,14,13,37,49,-12,41
Dumbarton,9033,8,9,11,16,47,59,-12,38
Raith,9033,9,9,11,16,33,47,-14,38
St Mirren,9033,10,9,10,17,41,56,-15,37
Hibernian,9034,1,18,13,5,54,26,28,67
Falkirk,9034,2,19,9,8,63,40,23,66
Morton,9034,3,18,11,7,54,34,20,65
Dundee Utd,9034,4,18,8,10,52,39,13,62
Queen of S't,9034,5,10,11,15,40,50,-10,41
Dumbarton,9034,6,9,12,15,45,57,-12,39
Raith,9034,7,10,8,18,34,51,-17,38
Dunfermline,9034,8,8,13,15,41,47,-6,37
Ayr,9034,9,8,12,16,33,54,-21,36
St Mirren,9034,10,8,11,17,40,58,-18,35
Hibernian,9035,1,19,13,4,53,24,29,70
Falkirk,9035,2,19,9,8,61,37,24,66
Morton,9035,3,18,11,7,51,39,12,65
Dundee Utd,9035,4,14,9,13,48,45,3,51
Queen of S't,9035,5,11,10,15,44,51,-7,43
Raith,9035,6,11,9,16,35,46,-11,42
Dumbarton,9035,7,10,10,16,53,61,-8,40
Dunfermline,9035,8,9,12,15,44,49,-5,39
Ayr,9035,9,9,11,16,32,57,-25,38
St Mirren,9035,10,8,10,18,43,55,-12,34
Hibernian,9036,1,19,13,4,55,27,28,70
Morton,9036,2,18,10,8,55,40,15,64
Dundee Utd,9036,3,17,9,10,60,39,21,60
Falkirk,9036,4,14,10,12,57,49,8,52
Dunfermline,9036,5,12,12,12,55,50,5,48
Queen of S't,9036,6,12,11,13,44,45,-1,47
Raith,9036,7,10,9,17,39,56,-17,39
St Mirren,9036,8,9,10,17,42,59,-17,37
Ayr,9036,9,7,14,15,33,57,-24,35
Dumbarton,9036,10,8,10,18,47,65,-18,34
Morton,9037,1,19,11,6,58,34,24,68
Hibernian,9037,2,18,13,5,55,26,29,67
Dundee Utd,9037,3,17,11,8,49,35,14,62
Falkirk,9037,4,16,11,9,60,40,20,59
Dunfermline,9037,5,10,14,12,46,47,-1,44
Raith,9037,6,11,10,15,34,48,-14,43
Queen of S't,9037,7,10,10,16,40,48,-8,40
Ayr,9037,8,8,13,15,32,52,-20,37
Dumbarton,9037,9,7,12,17,42,61,-19,33
St Mirren,9037,10,6,11,19,35,60,-25,29
Hibernian,9038,1,18,12,6,55,25,30,66
Dundee Utd,9038,2,18,10,8,58,36,22,64
Falkirk,9038,3,17,10,9,55,39,16,61
Morton,9038,4,16,12,8,48,36,12,60
Dunfermline,9038,5,12,12,12,52,51,1,48
Queen of S't,9038,6,11,9,16,46,52,-6,42
Raith,9038,7,9,11,16,37,51,-14,38
Dumbarton,9038,8,8,12,16,42,59,-17,36
Ayr,9038,9,8,12,16,30,55,-25,36
St Mirren,9038,10,7,12,17,37,56,-19,33
Morton,9039,1,19,11,6,58,35,23,68
Hibernian,9039,2,18,12,6,57,34,23,66
Dundee Utd,9039,3,18,8,10,51,37,14,62
Falkirk,9039,4,17,10,9,57,39,18,61
Queen of S't,9039,5,11,11,14,40,46,-6,44
Dunfermline,9039,6,9,13,14,41,47,-6,40
Dumbarton,9039,7,9,11,16,50,59,-9,38
Raith,9039,8,9,10,17,36,52,-16,37
St Mirren,9039,9,9,9,18,37,53,-16,36
Ayr,9039,10,7,13,16,33,58,-25,34
Morton,9040,1,18,13,5,51,33,18,67
Hibernian,9040,2,17,14,5,54,25,29,65
Falkirk,9040,3,17,11,8,65,39,26,62
Dundee Utd,9040,4,13,10,13,45,43,2,49
Queen of S't,9040,5,12,10,14,45,52,-7,46
Dunfermline,9040,6,10,15,11,49,43,6,45
Ayr,9040,7,9,13,14,37,54,-17,40
St Mirren,9040,8,9,10,17,44,63,-19,37
Raith,9040,9,8,11,17,33,57,-24,35
Dumbarton,9040,10,7,13,16,45,59,-14,34
Hibernian,9041,1,21,11,4,58,26,32,74
Morton,9041,2,17,11,8,51,38,13,62
Dundee Utd,9041,3,16,10,10,50,39,11,58
Falkirk,9041,4,15,10,11,55,43,12,55
St Mirren,9041,5,11,9,16,49,53,-4,42
Raith,9041,6,11,9,16,36,50,-14,42
Dumbarton,9041,7,10,11,15,48,57,-9,41
Queen of S't,9041,8,11,8,17,46,56,-10,41
Dunfermline,9041,9,9,11,16,43,54,-11,38
Ayr,9041,10,8,12,16,34,54,-20,36
Hibernian,9042,1,19,10,7,55,31,24,67
Morton,9042,2,17,12,7,50,38,12,63
Falkirk,9042,3,17,10,9,62,43,19,61
Dundee Utd,9042,4,14,12,10,45,38,7,54
Dunfermline,9042,5,12,11,13,51,48,3,47
Queen of S't,9042,6,11,8,17,44,52,-8,41
Ayr,9042,7,9,13,14,34,52,-18,40
Dumbarton,9042,8,9,12,15,53,59,-6,39
St Mirren,9042,9,8,13,15,41,56,-15,37
Raith,9042,10,9,9,18,32,50,-18,36
Hibernian,9043,1,21,11,4,59,26,33,74
Morton,9043,2,17,9,10,55,41,14,60
Dundee Utd,9043,3,17,8,11,47,39,8,59
Falkirk,9043,4,16,10,10,59,45,14,58
Queen of S't,9043,5,11,11,14,42,47,-5,44
Dumbarton,9043,6,10,12,14,53,54,-1,42
Dunfermline,9043,7,10,12,14,46,52,-6,42
Raith,9043,8,10,10,16,31,45,-14,40
Ayr,9043,9,8,14,14,33,52,-19,38
St Mirren,9043,10,6,11,19,38,62,-24,29
Hibernian,9044,1,18,12,6,53,26,27,66
Morton,9044,2,18,11,7,59,35,24,65
Falkirk,9044,3,18,10,8,65,37,28,64
Dundee Utd,9044,4,18,9,9,53,35,18,63
Dumbarton,9044,5,12,10,14,51,57,-6,46
Queen of S't,9044,6,11,9,16,45,56,-11,42
Dunfermline,9044,7,9,13,14,50,58,-8,40
St Mirren,9044,8,9,10,17,35,53,-18,37
Raith,9044,9,8,9,19,30,57,-27,33
Ayr,9044,10,7,11,18,31,58,-27,32
Hibernian,9045,1,19,11,6,56,28,28,68
Morton,9045,2,16,11,9,52,42,10,59
Falkirk,9045,3,15,12,9,58,42,16,57
Dundee Utd,9045,4,15,12,9,53,44,9,57
Raith,9045,5,13,9,14,36,45,-9,48
Queen of S't,9045,6,11,10,15,43,48,-5,43
Dunfermline,9045,7,9,15,12,47,49,-2,42
Dumbarton,9045,8,9,11,16,53,61,-8,38
Ayr,9045,9,8,12,16,35,59,-24,36
St Mirren,9045,10,8,11,17,42,57,-15,35
Hibernian,9046,1,20,11,5,55,25,30,71
Morton,9046,2,20,9,7,55,34,21,69
Dundee Utd,9046,3,20,8,8,58,36,22,68
Falkirk,9046,4,15,11,10,57,43,14,56
Queen of S't,9046,5,13,9,14,53,51,2,48
Dunfermline,9046,6,9,11,16,46,53,-7,38
Raith,9046,7,9,11,16,33,49,-16,38
Ayr,9046,8,7,13,16,32,54,-22,34
Dumbarton,9046,9,7,12,17,45,66,-21,33
St Mirren,9046,10,7,11,18,38,61,-23,32
Hibernian,9047,1,18,12,6,55,28,27,66
Falkirk,9047,2,17,11,8,63,37,26,62
Morton,9047,3,16,11,9,49,36,13,59
Dundee Utd,9047,4,15,10,11,47,40,7,55
Queen of S't,9047,5,12,10,14,47,51,-4,46
Dunfermline,9047,6,10,13,13,48,54,-6,43
Raith,9047,7,11,9,16,33,47,-14,42
Dumbarton,9047,8,9,11,16,47,59,-12,38
St Mirren,9047,9,9,10,17,39,57,-18,37
Ayr,9047,10,7,15,14,36,55,-19,36
Hibernian,9048,1,17,13,6,55,33,22,64
Dundee Utd,9048,2,17,11,8,61,38,23,62
Morton,9048,3,16,12,8,53,39,14,60
Falkirk,9048,4,15,12,9,56,44,12,57
Queen of S't,9048,5,12,11,13,45,47,-2,47
Dumbarton,9048,6,10,12,14,53,60,-7,42
Dunfermline,9048,7,9,14,13,49,56,-7,41
Raith,9048,8,10,10,16,35,48,-13,40
St Mirren,9048,9,8,12,16,41,57,-16,36
Ayr,9048,10,7,11,18,34,60,-26,32
Hibernian,9049,1,18,13,5,53,27,26,67
Morton,9049,2,17,13,6,53,37,16,64
Falkirk,9049,3,15,13,8,60,39,21,58
Dundee Utd,9049,4,14,12,10,50,40,10,54
Dunfermline,9049,5,10,14,12,49,48,1,44
Raith,9049,6,10,10,16,32,46,-14,40
Queen of S't,9049,7,9,12,15,38,50,-12,39
Ayr,9049,8,8,14,14,33,55,-22,38
Dumbarton,9049,9,8,13,15,46,58,-12,37
St Mirren,9049,10,9,10,17,41,55,-14,37
Hibernian,9050,1,22,11,3,60,22,38,77
Dundee Utd,9050,2,18,8,10,51,39,12,62
Falkirk,9050,3,17,10,9,58,40,18,61
Morton,9050,4,15,10,11,47,40,7,55
Raith,9050,5,11,11,14,42,51,-9,44
Dunfermline,9050,6,9,14,13,46,48,-2,41
Ayr,9050,7,10,10,16,34,56,-22,40
Queen of S't,9050,8,10,9,17,41,52,-11,39
Dumbarton,9050,9,8,11,17,49,63,-14,35
St Mirren,9050,10,8,10,18,42,59,-17,34
Hibernian,9051,1,20,11,5,51,23,28,71
Morton,9051,2,16,12,8,50,35,15,60
Falkirk,9051,3,16,10,10,56,40,16,58
Dundee Utd,9051,4,16,9,11,49,38,11,57
Dunfermline,9051,5,10,14,12,48,47,1,44
Dumbarton,9051,6,11,11,14,49,59,-10,44
Queen of S't,9051,7,11,9,16,44,53,-9,42
Raith,9051,8,10,11,15,35,48,-13,41
St Mirren,9051,9,8,12,16,40,55,-15,36
Ayr,9051,10,6,13,17,30,54,-24,31
Hibernian,9052,1,17,14,5,53,26,27,65
Dundee Utd,9052,2,18,10,8,57,36,21,64
Morton,9052,3,16,12,8,48,38,10,60
Falkirk,9052,4,14,11,11,59,45,14,53
Queen of S't,9052,5,14,8,14,46,48,-2,50
Dunfermline,9052,6,9,14,13,43,49,-6,41
Raith,9052,7,10,10,16,36,48,-12,40
Dumbarton,9052,8,9,12,15,52,63,-11,39
St Mirren,9052,9,10,9,17,43,56,-13,39
Ayr,9052,10,7,12,17,31,59,-28,33
Dundee Utd,9053,1,17,10,9,60,41,19,61
Falkirk,9053,2,17,10,9,56,38,18,61
Hibernian,9053,3,16,11,9,49,32,17,59
Morton,9053,4,16,10,10,47,39,8,58
Dunfermline,9053,5,12,12,12,49,44,5,48
Raith,9053,6,12,9,15,35,47,-12,45
Queen of S't,9053,7,11,9,16,43,52,-9,42
Dumbarton,9053,8,10,11,15,47,59,-12,41
St Mirren,9053,9,10,10,16,43,56,-13,40
Ayr,9053,10,7,12,17,40,61,-21,33
Hibernian,9054,1,18,12,6,55,31,24,66
Morton,9054,2,16,13,7,50,38,12,61
Falkirk,9054,3,16,9,11,55,43,12,57
Dundee Utd,9054,4,14,11,11,46,41,5,53
Dunfermline,9054,5,13,11,12,56,45,11,50
Queen of S't,9054,6,12,8,16,41,49,-8,44
St Mirren,9054,7,10,12,14,46,51,-5,42
Dumbarton,9054,8,9,12,15,48,60,-12,39
Raith,9054,9,10,9,17,35,50,-15,39
Ayr,9054,10,8,11,17,33,57,-24,35
Hibernian,9055,1,18,13,5,56,30,26,67
Falkirk,9055,2,19,9,8,63,38,25,66
Morton,9055,3,15,12,9,48,38,10,57
Dundee Utd,9055,4,13,13,10,43,39,4,52
Ayr,9055,5,11,11,14,35,49,-14,44
Dunfermline,9055,6,10,12,14,45,49,-4,42
Dumbarton,9055,7,10,11,15,49,57,-8,41
Queen of S't,9055,8,10,10,16,44,51,-7,40
St Mirren,9055,9,9,11,16,37,51,-14,38
Raith,9055,10,9,10,17,34,52,-18,37
Hibernian,9056,1,22,11,3,55,22,33,77
Dundee Utd,9056,2,15,11,10,51,40,11,56
Falkirk,9056,3,14,11,11,55,43,12,53
Morton,9056,4,13,14,9,43,37,6,53
Queen of S't,9056,5,13,8,15,49,53,-4,47
St Mirren,9056,6,10,11,15,42,49,-7,41
Dumbarton,9056,7,10,11,15,43,56,-13,41
Dunfermline,9056,8,9,13,14,46,50,-4,40
Raith,9056,9,10,9,17,33,47,-14,39
Ayr,9056,10,8,13,15,32,52,-20,37
Dundee Utd,9057,1,20,8,8,53,33,20,68
Hibernian,9057,2,17,14,5,52,26,26,65
Falkirk,9057,3,18,10,8,64,40,24,64
Morton,9057,4,14,15,7,44,35,9,57
Raith,9057,5,12,9,15,34,46,-12,45
Queen of S't,9057,6,11,10,15,42,50,-8,43
Dumbarton,9057,7,9,13,14,49,58,-9,40
Dunfermline,9057,8,7,14,15,41,49,-8,35
St Mirren,9057,9,7,11,18,41,58,-17,32
Ayr,9057,10,6,14,16,31,56,-25,32
Hibernian,9058,1,19,12,5,56,26,30,69
Morton,9058,2,19,10,7,59,35,24,67
Falkirk,9058,3,16,10,10,58,41,17,58
Dundee Utd,9058,4,14,11,11,46,41,5,53
Dunfermline,9058,5,11,13,12,46,45,1,46
Queen of S't,9058,6,11,10,15,41,51,-10,43
Dumbarton,9058,7,9,11,16,50,58,-8,38
St Mirren,9058,8,9,11,16,41,59,-18,38
Ayr,9058,9,9,11,16,31,56,-25,38
Raith,9058,10,9,9,18,33,49,-16,36
Hibernian,9059,1,18,12,6,52,26,26,66
Dundee Utd,9059,2,19,8,9,53,35,18,65
Morton,9059,3,18,10,8,50,37,13,64
Falkirk,9059,4,16,12,8,59,43,16,60
Ayr,9059,5,10,11,15,36,52,-16,41
St Mirren,9059,6,10,10,16,45,56,-11,40
Dunfermline,9059,7,8,14,14,46,53,-7,38
Dumbarton,9059,8,8,13,15,49,60,-11,37
Queen of S't,9059,9,9,10,17,41,53,-12,37
Raith,9059,10,9,10,17,35,51,-16,37
Hibernian,9060,1,18,13,5,58,29,29,67
Morton,9060,2,18,10,8,51,41,10,64
Dundee Utd,9060,3,16,10,10,53,39,14,58
Falkirk,9060,4,16,9,11,56,42,14,57
Queen of S't,9060,5,12,10,14,49,50,-1,46
Raith,9060,6,11,11,14,35,42,-7,44
Dumbarton,9060,7,11,10,15,48,56,-8,43
Dunfermline,9060,8,10,11,15,48,55,-7,41
St Mirren,9060,9,8,10,18,38,59,-21,34
Ayr,9060,10,7,12,17,30,53,-23,33
Hibernian,9061,1,17,13,6,54,30,24,64
Falkirk,9061,2,15,13,8,58,40,18,58
Dundee Utd,9061,3,15,12,9,49,39,10,57
Morton,9061,4,15,11,10,49,39,10,56
Dunfermline,9061,5,10,16,10,44,43,1,46
Ayr,9061,6,10,12,14,33,51,-18,42
St Mirren,9061,7,10,10,16,43,55,-12,40
Queen of S't,9061,8,10,9,17,44,53,-9,39
Dumbarton,9061,9,9,12,15,43,54,-11,39
Raith,9061,10,9,12,15,35,48,-13,39
Hibernian,9062,1,18,11,7,54,28,26,65
Falkirk,9062,2,17,11,8,61,40,21,62
Morton,9062,3,17,11,8,53,37,16,62
Dundee Utd,9062,4,16,10,10,55,41,14,58
Queen of S't,9062,5,13,8,15,48,56,-8,47
Raith,9062,6,11,10,15,38,50,-12,43
Dunfermline,9062,7,10,12,14,47,51,-4,42
Dumbarton,9062,8,9,13,14,47,55,-8,40
St Mirren,9062,9,8,12,16,41,57,-16,36
Ayr,9062,10,7,10,19,31,60,-29,31
Hibernian,9063,1,20,11,5,57,29,28,71
Morton,9063,2,14,14,8,48,39,9,56
Falkirk,9063,3,14,12,10,51,39,12,54
Dundee Utd,9063,4,14,10,12,49,43,6,52
Dunfermline,9063,5,13,12,11,52,43,9,51
Ayr,9063,6,10,13,13,39,52,-13,43
Queen of S't,9063,7,11,9,16,44,51,-7,42
Dumbarton,9063,8,9,13,14,47,56,-9,40
Raith,9063,9,9,10,17,30,50,-20,37
St Mirren,9063,10,8,12,16,38,53,-15,36
Morton,9064,1,19,10,7,53,41,12,67
Hibernian,9064,2,16,13,7,50,28,22,61
Dundee Utd,9064,3,16,11,9,56,36,20,59
Falkirk,9064,4,16,10,10,55,39,16,58
Dunfermline,9064,5,12,14,10,52,47,5,50
Queen of S't,9064,6,11,10,15,44,51,-7,43
Ayr,9064,7,9,13,14,33,53,-20,40
Raith,9064,8,9,10,17,35,49,-14,37
Dumbarton,9064,9,8,11,17,45,60,-15,35
St Mirren,9064,10,6,14,16,36,55,-19,32
Hibernian,9065,1,18,12,6,54,27,27,66
Dundee Utd,9065,2,17,11,8,51,35,16,62
Morton,9065,3,15,13,8,47,37,10,58
Falkirk,9065,4,14,10,12,51,44,7,52
Dunfermline,9065,5,11,13,12,47,49,-2,46
Queen of S't,9065,6,11,12,13,48,52,-4,45
St Mirren,9065,7,9,13,14,40,51,-11,40
Dumbarton,9065,8,9,12,15,51,56,-5,39
Raith,9065,9,9,12,15,35,48,-13,39
Ayr,9065,10,7,12,17,34,59,-25,33
Hibernian,9066,1,19,14,3,54,24,30,71
Falkirk,9066,2,18,10,8,63,36,27,64
Morton,9066,3,17,11,8,56,39,17,62
Dundee Utd,9066,4,15,11,10,49,42,7,56
Raith,9066,5,13,8,15,39,47,-8,47
Queen of S't,9066,6,11,9,16,47,52,-5,42
Dumbarton,9066,7,8,13,15,45,60,-15,37
Dunfermline,9066,8,7,15,14,38,50,-12,36
Ayr,9066,9,7,14,15,33,54,-21,35
St Mirren,9066,10,7,11,18,39,59,-20,32
Hibernian,9067,1,21,11,4,55,23,32,74
Morton,9067,2,15,15,6,48,35,13,60
Dundee Utd,9067,3,16,9,11,51,42,9,57
Falkirk,9067,4,14,9,13,55,45,10,51
Dunfermline,9067,5,12,13,11,46,44,2,49
Queen of S't,9067,6,11,10,15,46,52,-6,43
Dumbarton,9067,7,9,13,14,46,55,-9,40
Raith,9067,8,10,9,17,33,48,-15,39
Ayr,9067,9,8,12,16,33,53,-20,36
St Mirren,9067,10,8,11,17,37,53,-16,35
Hibernian,9068,1,19,10,7,54,27,27,67
Morton,9068,2,18,10,8,52,38,14,64
Falkirk,9068,3,16,9,11,59,43,16,57
Dundee Utd,9068,4,16,8,12,50,43,7,56
Queen of S't,9068,5,13,8,15,48,51,-3,47
Dunfermline,9068,6,11,13,12,47,43,4,46
Raith,9068,7,11,11,14,43,51,-8,44
St Mirren,9068,8,9,10,17,42,57,-15,37
Ayr,9068,9,8,12,16,34,56,-22,36
Dumbarton,9068,10,8,11,17,47,67,-20,35
Hibernian,9069,1,17,12,7,52,30,22,63
Falkirk,9069,2,17,10,9,62,42,20,61
Dundee Utd,9069,3,17,9,10,52,41,11,60
Morton,9069,4,15,12,9,46,35,11,57
Raith,9069,5,13,10,13,41,45,-4,49
Queen of S't,9069,6,11,11,14,46,50,-4,44
Dunfermline,9069,7,11,11,14,44,49,-5,44
Dumbarton,9069,8,9,12,15,50,59,-9,39
St Mirren,9069,9,8,10,18,37,56,-19,34
Ayr,9069,10,7,13,16,33,56,-23,34
Hibernian,9070,1,18,12,6,52,29,23,66
Falkirk,9070,2,16,12,8,61,39,22,60
Morton,9070,3,17,9,10,51,37,14,60
Dundee Utd,9070,4,15,11,10,54,45,9,56
Raith,9070,5,11,10,15,38,47,-9,43
Queen of S't,9070,6,11,9,16,46,52,-6,42
Dunfermline,9070,7,9,14,13,44,48,-4,41
Ayr,9070,8,10,11,15,34,54,-20,41
St Mirren,9070,9,10,10,16,39,57,-18,40
Dumbarton,9070,10,8,12,16,48,59,-11,36
Hibernian,9071,1,19,13,4,57,22,35,70
Dundee Utd,9071,2,17,10,9,54,41,13,61
Morton,9071,3,16,10,10,42,35,7,58
Falkirk,9071,4,15,12,9,57,41,16,57
Dunfermline,9071,5,10,14,12,47,46,1,44
Queen of S't,9071,6,11,9,16,47,53,-6,42
Raith,9071,7,9,12,15,33,48,-15,39
St Mirren,9071,8,10,9,17,42,58,-16,39
Ayr,9071,9,8,13,15,32,52,-20,37
Dumbarton,9071,10,8,12,16,44,59,-15,36
Hibernian,9072,1,18,12,6,50,26,24,66
Dundee Utd,9072,2,18,10,8,54,37,17,64
Morton,9072,3,17,11,8,47,33,14,62
Falkirk,9072,4,15,10,11,55,43,12,55
Queen of S't,9072,5,12,10,14,44,47,-3,46
Dunfermline,9072,6,10,13,13,49,51,-2,43
St Mirren,9072,7,11,9,16,41,52,-11,42
Ayr,9072,8,9,11,16,34,56,-22,38
Dumbarton,9072,9,9,10,17,50,59,-9,37
Raith,9072,10,9,8,19,36,56,-20,35
Hibernian,9073,1,18,14,4,58,29,29,68
Morton,9073,2,18,10,8,53,38,15,64
Falkirk,9073,3,16,11,9,56,39,17,59
Dundee Utd,9073,4,14,11,11,48,41,7,53
Queen of S't,9073,5,11,10,15,46,53,-7,43
St Mirren,9073,6,11,10,15,45,54,-9,43
Dunfermline,9073,7,9,15,12,48,48,0,42
Dumbarton,9073,8,8,14,14,49,60,-11,38
Raith,9073,9,8,12,16,36,52,-16,36
Ayr,9073,10,7,13,16,37,62,-25,34
Hibernian,9074,1,20,12,4,55,25,30,72
Morton,9074,2,17,10,9,52,39,13,61
Falkirk,9074,3,15,11,10,54,39,15,56
Dundee Utd,9074,4,14,11,11,52,41,11,53
Queen of S't,9074,5,13,9,14,47,51,-4,48
Dunfermline,9074,6,11,13,12,49,46,3,46
Dumbarton,9074,7,11,10,15,54,66,-12,43
Raith,9074,8,9,10,17,30,48,-18,37
Ayr,9074,9,8,12,16,37,60,-23,36
St Mirren,9074,10,8,10,18,39,54,-15,34
Hibernian,9075,1,19,11,6,60,29,31,68
Morton,9075,2,19,11,6,53,33,20,68
Falkirk,9075,3,15,11,10,60,46,14,56
Dundee Utd,9075,4,15,11,10,48,41,7,56
Dunfermline,9075,5,11,12,13,44,43,1,45
Queen of S't,9075,6,11,10,15,47,52,-5,43
Raith,9075,7,11,10,15,35,48,-13,43
Dumbarton,9075,8,8,12,16,46,63,-17,36
St Mirren,9075,9,8,11,17,43,59,-16,35
Ayr,9075,10,7,13,16,32,54,-22,34
Hibernian,9076,1,20,10,6,59,23,36,70
Morton,9076,2,18,11,7,49,35,14,65
Dundee Utd,9076,3,15,12,9,53,40,13,57
Falkirk,9076,4,14,13,9,58,45,13,55
Dunfermline,9076,5,11,13,12,46,45,1,46
Dumbarton,9076,6,10,10,16,51,61,-10,40
Raith,9076,7,10,9,17,32,47,-15,39
St Mirren,9076,8,9,11,16,39,55,-16,38
Queen of S't,9076,9,9,10,17,42,56,-14,37
Ayr,9076,10,8,13,15,31,53,-22,37
Hibernian,9077,1,19,13,4,56,23,33,70
Morton,9077,2,19,11,6,55,33,22,68
Falkirk,9077,3,16,11,9,58,41,17,59
Dundee Utd,9077,4,15,11,10,57,49,8,56
Queen of S't,9077,5,11,10,15,44,51,-7,43
Dunfermline,9077,6,9,13,14,45,49,-4,40
Ayr,9077,7,9,12,15,38,60,-22,39
Dumbarton,9077,8,8,13,15,47,55,-8,37
St Mirren,9077,9,8,11,17,37,54,-17,35
Raith,9077,10,8,11,17,33,55,-22,35
Hibernian,9078,1,19,14,3,52,23,29,71
Morton,9078,2,18,11,7,53,32,21,65
Falkirk,9078,3,18,10,8,57,35,22,64
Dundee Utd,9078,4,15,10,11,49,43,6,55
Queen of S't,9078,5,10,12,14,39,45,-6,42
Dumbarton,9078,6,10,12,14,47,54,-7,42
Dunfermline,9078,7,9,13,14,41,46,-5,40
Raith,9078,8,9,10,17,30,49,-19,37
St Mirren,9078,9,8,10,18,39,57,-18,34
Ayr,9078,10,6,14,16,33,56,-23,32
Hibernian,9079,1,18,13,5,57,27,30,67
Morton,9079,2,17,12,7,53,36,17,63
Dundee Utd,9079,3,16,11,9,52,40,12,59
Falkirk,9079,4,15,11,10,55,44,11,56
Queen of S't,9079,5,12,11,13,46,47,-1,47
Dumbarton,9079,6,11,12,13,52,54,-2,45
Dunfermline,9079,7,10,13,13,50,52,-2,43
Raith,9079,8,9,10,17,32,50,-18,37
St Mirren,9079,9,7,12,17,35,55,-20,33
Ayr,9079,10,7,11,18,31,58,-27,32
Hibernian,9080,1,20,12,4,58,26,32,72
Falkirk,9080,2,20,9,7,64,36,28,69
Morton,9080,3,17,11,8,51,37,14,62
Dundee Utd,9080,4,15,8,13,45,49,-4,53
Queen of S't,9080,5,12,9,15,49,50,-1,45
Dunfermline,9080,6,10,11,15,48,52,-4,41
St Mirren,9080,7,9,11,16,44,58,-14,38
Ayr,9080,8,9,11,16,38,53,-15,38
Raith,9080,9,9,9,18,30,52,-22,36
Dumbarton,9080,10,8,11,17,47,61,-14,35
Hibernian,9081,1,18,13,5,51,25,26,67
Falkirk,9081,2,16,11,9,57,38,19,59
Morton,9081,3,16,11,9,50,39,11,59
Dundee Utd,9081,4,14,11,11,48,43,5,53
Queen of S't,9081,5,13,10,13,47,47,0,49
Dunfermline,9081,6,9,16,11,48,48,0,43
Dumbarton,9081,7,11,10,15,46,55,-9,43
St Mirren,9081,8,9,11,16,41,54,-13,38
Raith,9081,9,9,10,17,32,48,-16,37
Ayr,9081,10,7,13,16,31,54,-23,34
Hibernian,9082,1,20,11,5,56,23,33,71
Morton,9082,2,18,10,8,51,35,16,64
Dundee Utd,9082,3,15,11,10,52,40,12,56
Falkirk,9082,4,13,13,10,53,45,8,52
Dunfermline,9082,5,11,14,11,48,45,3,47
Queen of S't,9082,6,12,10,14,47,49,-2,46
Raith,9082,7,11,10,15,37,48,-11,43
Dumbarton,9082,8,9,12,15,47,59,-12,39
St Mirren,9082,9,8,10,18,36,55,-19,34
Ayr,9082,10,7,11,18,29,57,-28,32
Hibernian,9083,1,22,11,3,58,21,37,77
Morton,9083,2,17,11,8,53,35,18,62
Falkirk,9083,3,16,11,9,57,39,18,59
Dundee Utd,9083,4,16,8,12,55,49,6,56
Queen of S't,9083,5,11,10,15,50,59,-9,43
Dunfermline,9083,6,10,12,14,48,50,-2,42
Raith,9083,7,11,9,16,36,53,-17,42
Dumbarton,9083,8,8,13,15,50,61,-11,37
St Mirren,9083,9,9,9,18,41,54,-13,36
Ayr,9083,10,8,10,18,35,62,-27,34
Hibernian,9084,1,21,11,4,57,24,33,74
Morton,9084,2,15,13,8,50,37,13,58
Falkirk,9084,3,16,9,11,57,45,12,57
Dundee Utd,9084,4,15,11,10,50,39,11,56
Queen of S't,9084,5,12,11,13,43,46,-3,47
Dumbarton,9084,6,11,11,14,51,57,-6,44
Dunfermline,9084,7,9,14,13,44,46,-2,41
Raith,9084,8,8,12,16,32,49,-17,36
St Mirren,9084,9,7,13,16,41,57,-16,34
Ayr,9084,10,6,15,15,31,56,-25,33
Hibernian,9085,1,17,14,5,51,28,23,65
Morton,9085,2,15,13,8,48,35,13,58
Dundee Utd,9085,3,15,9,12,52,44,8,54
Falkirk,9085,4,14,10,12,53,45,8,52
St Mirren,9085,5,12,10,14,43,51,-8,46
Dumbarton,9085,6,11,11,14,54,55,-1,44
Dunfermline,9085,7,9,16,11,50,50,0,43
Raith,9085,8,10,11,15,37,49,-12,41
Queen of S't,9085,9,10,10,16,45,56,-11,40
Ayr,9085,10,9,12,15,38,58,-20,39
Hibernian,9086,1,21,11,4,56,27,29,74
Morton,9086,2,18,11,7,54,36,18,65
Dundee Utd,9086,3,16,10,10,47,39,8,58
Falkirk,9086,4,15,12,9,57,39,18,57
Dunfermline,9086,5,9,14,13,41,44,-3,41
Raith,9086,6,10,9,17,34,50,-16,39
St Mirren,9086,7,9,11,16,40,54,-14,38
Ayr,9086,8,8,14,14,36,53,-17,38
Queen of S't,9086,9,9,10,17,41,52,-11,37
Dumbarton,9086,10,8,12,16,43,55,-12,36
Hibernian,9087,1,19,14,3,62,26,36,71
Falkirk,9087,2,16,11,9,60,41,19,59
Morton,9087,3,15,12,9,45,36,9,57
Dundee Utd,9087,4,15,10,11,48,41,7,55
Dunfermline,9087,5,12,13,11,55,46,9,49
Raith,9087,6,12,9,15,35,45,-10,45
St Mirren,9087,7,9,11,16,42,55,-13,38
Queen of S't,9087,8,9,11,16,40,55,-15,38
Ayr,9087,9,8,12,16,33,55,-22,36
Dumbarton,9087,10,8,11,17,42,62,-20,35
Hibernian,9088,1,19,14,3,60,27,33,71
Morton,9088,2,16,13,7,52,38,14,61
Dundee Utd,9088,3,15,11,10,47,39,8,56
Falkirk,9088,4,14,12,10,55,40,15,54
Dumbarton,9088,5,12,11,13,49,53,-4,47
Dunfermline,9088,6,9,14,13,44,46,-2,41
Queen of S't,9088,7,10,10,16,42,52,-10,40
St Mirren,9088,8,9,11,16,42,55,-13,38
Raith,9088,9,9,10,17,35,55,-20,37
Ayr,9088,10,7,14,15,35,56,-21,35
Hibernian,9089,1,21,10,5,58,27,31,73
Morton,9089,2,17,10,9,47,38,9,61
Dundee Utd,9089,3,15,12,9,49,38,11,57
Falkirk,9089,4,15,10,11,59,44,15,55
Queen of S't,9089,5,13,10,13,47,47,0,49
Dunfermline,9089,6,11,13,12,52,49,3,46
Dumbarton,9089,7,10,11,15,48,55,-7,41
Raith,9089,8,9,10,17,36,51,-15,37
St Mirren,9089,9,9,10,17,40,57,-17,37
Ayr,9089,10,7,10,19,32,62,-30,31
Hibernian,9090,1,19,13,4,60,26,34,70
Morton,9090,2,16,13,7,52,38,14,61
Dundee Utd,9090,3,17,10,9,53,41,12,61
Falkirk,9090,4,15,10,11,57,41,16,55
Queen of S't,9090,5,13,8,15,49,51,-2,47
Dunfermline,9090,6,10,14,12,46,48,-2,44
Ayr,9090,7,9,12,15,35,54,-19,39
Dumbarton,9090,8,8,12,16,43,58,-15,36
St Mirren,9090,9,9,9,18,39,57,-18,36
Raith,9090,10,9,9,18,35,55,-20,36
Hibernian,9091,1,19,13,4,53,23,30,70
Falkirk,9091,2,16,11,9,55,38,17,59
Morton,9091,3,15,13,8,46,34,12,58
Dundee Utd,9091,4,14,10,12,47,43,4,52
Dunfermline,9091,5,11,14,11,48,45,3,47
Queen of S't,9091,6,12,10,14,43,47,-4,46
Dumbarton,9091,7,10,12,14,51,58,-7,42
Raith,9091,8,10,10,16,31,44,-13,40
Ayr,9091,9,9,12,15,33,52,-19,39
St Mirren,9091,10,6,11,19,35,58,-23,29
Hibernian,9092,1,20,13,3,57,25,32,73
Morton,9092,2,17,11,8,53,39,14,62
Dundee Utd,9092,3,16,8,12,52,41,11,56
Falkirk,9092,4,14,11,11,57,47,10,53
Queen of S't,9092,5,12,10,14,43,48,-5,46
Dunfermline,9092,6,10,14,12,45,45,0,44
Raith,9092,7,11,11,14,37,46,-9,44
Dumbarton,9092,8,10,11,15,45,55,-10,41
Ayr,9092,9,8,11,17,30,52,-22,35
St Mirren,9092,10,6,12,18,38,59,-21,30
Hibernian,9093,1,18,13,5,55,25,30,67
Morton,9093,2,14,17,5,46,31,15,59
Dundee Utd,9093,3,16,10,10,51,38,13,58
Falkirk,9093,4,14,13,9,58,47,11,55
Dunfermline,9093,5,11,14,11,52,48,4,47
St Mirren,9093,6,10,10,16,47,58,-11,40
Ayr,9093,7,8,15,13,34,52,-18,39
Queen of S't,9093,8,9,11,16,38,47,-9,38
Raith,9093,9,9,10,17,35,58,-23,37
Dumbarton,9093,10,7,15,14,44,56,-12,36
Hibernian,9094,1,20,11,5,55,26,29,71
Dundee Utd,9094,2,17,9,10,64,46,18,60
Morton,9094,3,16,11,9,52,41,11,59
Falkirk,9094,4,15,12,9,63,42,21,57
Queen of S't,9094,5,12,10,14,41,53,-12,46
Ayr,9094,6,11,10,15,38,54,-16,43
Dunfermline,9094,7,7,16,13,44,50,-6,37
Dumbarton,9094,8,8,13,15,48,61,-13,37
St Mirren,9094,9,9,10,17,44,59,-15,37
Raith,9094,10,9,10,17,35,52,-17,37
Hibernian,9095,1,20,13,3,60,27,33,73
Morton,9095,2,16,12,8,51,38,13,60
Falkirk,9095,3,15,9,12,55,44,11,54
Dundee Utd,9095,4,14,12,10,45,40,5,54
Queen of S't,9095,5,14,9,13,49,48,1,51
Dunfermline,9095,6,11,12,13,51,50,1,45
Raith,9095,7,12,8,16,33,44,-11,44
Dumbarton,9095,8,9,12,15,46,55,-9,39
Ayr,9095,9,8,13,15,31,52,-21,37
St Mirren,9095,10,6,10,20,35,58,-23,28
Hibernian,9096,1,20,10,6,58,26,32,70
Dundee Utd,9096,2,17,10,9,53,37,16,61
Morton,9096,3,17,10,9,50,39,11,61
Falkirk,9096,4,14,12,10,52,37,15,54
Queen of S't,9096,5,12,9,15,43,52,-9,45
Raith,9096,6,12,8,16,37,47,-10,44
Dunfermline,9096,7,10,12,14,46,47,-1,42
Dumbarton,9096,8,10,10,16,49,57,-8,40
Ayr,9096,9,9,11,16,36,61,-25,38
St Mirren,9096,10,8,10,18,38,59,-21,34
Hibernian,9097,1,17,14,5,49,25,24,65
Dundee Utd,9097,2,16,10,10,48,35,13,58
Morton,9097,3,15,13,8,46,34,12,58
Falkirk,9097,4,14,13,9,54,41,13,55
Dunfermline,9097,5,12,14,10,46,42,4,50
St Mirren,9097,6,11,10,15,45,55,-10,43
Raith,9097,7,10,11,15,36,49,-13,41
Queen of S't,9097,8,10,9,17,42,52,-10,39
Dumbarton,9097,9,8,12,16,46,61,-15,36
Ayr,9097,10,8,12,16,34,52,-18,36
Hibernian,9098,1,20,11,5,61,26,35,71
Morton,9098,2,17,12,7,54,37,17,63
Falkirk,9098,3,17,10,9,57,40,17,61
Dundee Utd,9098,4,17,10,9,54,38,16,61
Dunfermline,9098,5,9,15,12,48,52,-4,42
Queen of S't,9098,6,11,9,16,49,55,-6,42
Dumbarton,9098,7,9,12,15,53,66,-13,39
Raith,9098,8,9,10,17,31,50,-19,37
St Mirren,9098,9,8,10,18,40,54,-14,34
Ayr,9098,10,7,13,16,31,60,-29,34
Hibernian,9099,1,20,13,3,57,24,33,73
Morton,9099,2,18,12,6,49,34,15,66
Dundee Utd,9099,3,17,10,9,55,35,20,61
Falkirk,9099,4,15,9,12,59,45,14,54
Queen of S't,9099,5,11,11,14,42,47,-5,44
Dunfermline,9099,6,9,14,13,47,52,-5,41
Dumbarton,9099,7,8,13,15,43,53,-10,37
Raith,9099,8,8,13,15,32,47,-15,37
St Mirren,9099,9,8,11,17,38,57,-19,35
Ayr,9099,10,6,14,16,30,58,-28,32
Hibernian,9100,1,19,13,4,55,26,29,70
Dundee Utd,9100,2,17,10,9,51,37,14,61
Morton,9100,3,15,13,8,48,38,10,58
Falkirk,9100,4,15,10,11,60,45,15,55
Queen of S't,9100,5,12,10,14,48,50,-2,46
Dunfermline,9100,6,10,15,11,48,43,5,45
Raith,9100,7,11,9,16,37,50,-13,42
Dumbarton,9100,8,9,10,17,45,67,-22,37
St Mirren,9100,9,8,12,16,40,54,-14,36
Ayr,9100,10,7,12,17,34,56,-22,33
Hibernian,9101,1,18,14,4,55,28,27,68
Morton,9101,2,17,13,6,54,35,19,64
Falkirk,9101,3,16,13,7,60,35,25,61
Dundee Utd,9101,4,16,9,11,50,37,13,57
Queen of S't,9101,5,11,9,16,43,52,-9,42
Raith,9101,6,11,9,16,35,46,-11,42
Dunfermline,9101,7,8,16,12,46,47,-1,40
St Mirren,9101,8,9,11,16,40,53,-13,38
Ayr,9101,9,8,13,15,35,57,-22,37
Dumbarton,9101,10,7,11,18,42,70,-28,32
Hibernian,9102,1,20,12,4,60,28,32,72
Morton,9102,2,18,10,8,56,44,12,64
Dundee Utd,9102,3,17,8,11,53,44,9,59
Falkirk,9102,4,15,11,10,55,41,14,56
Raith,9102,5,12,10,14,42,47,-5,46
Queen of S't,9102,6,12,9,15,47,51,-4,45
Dunfermline,9102,7,9,15,12,52,52,0,42
Dumbarton,9102,8,8,13,15,51,61,-10,37
St Mirren,9102,9,8,11,17,39,56,-17,35
Ayr,9102,10,6,11,19,30,61,-31,29
Hibernian,9103,1,18,13,5,55,28,27,67
Morton,9103,2,18,10,8,49,33,16,64
Falkirk,9103,3,16,13,7,60,40,20,61
Dundee Utd,9103,4,15,12,9,52,40,12,57
Queen of S't,9103,5,10,11,15,42,52,-10,41
Raith,9103,6,10,11,15,35,51,-16,41
St Mirren,9103,7,10,9,17,43,54,-11,39
Dunfermline,9103,8,8,14,14,43,48,-5,38
Ayr,9103,9,8,13,15,33,52,-19,37
Dumbarton,9103,10,8,12,16,44,58,-14,36
Hibernian,9104,1,19,13,4,57,28,29,70
Falkirk,9104,2,16,11,9,57,39,18,59
Morton,9104,3,15,12,9,51,42,9,57
Dundee Utd,9104,4,15,9,12,52,46,6,54
Dunfermline,9104,5,10,14,12,48,47,1,44
Queen of S't,9104,6,11,9,16,46,54,-8,42
Dumbarton,9104,7,10,11,15,51,63,-12,41
St Mirren,9104,8,9,12,15,43,54,-11,39
Raith,9104,9,10,9,17,35,49,-14,39
Ayr,9104,10,9,12,15,40,58,-18,39
Hibernian,9105,1,19,10,7,60,28,32,67
Morton,9105,2,17,12,7,47,36,11,63
Dundee Utd,9105,3,17,9,10,47,36,11,60
Falkirk,9105,4,15,11,10,60,46,14,56
Dunfermline,9105,5,11,12,13,46,46,0,45
Dumbarton,9105,6,11,12,13,56,58,-2,45
Raith,9105,7,11,10,15,38,49,-11,43
Queen of S't,9105,8,10,9,17,42,55,-13,39
Ayr,9105,9,8,12,16,35,59,-24,36
St Mirren,9105,10,8,9,19,38,56,-18,33
Hibernian,9106,1,18,12,6,58,28,30,66
Morton,9106,2,17,11,8,51,39,12,62
Falkirk,9106,3,16,11,9,57,42,15,59
Dundee Utd,9106,4,14,10,12,52,44,8,52
Dunfermline,9106,5,12,14,10,51,44,7,50
Ayr,9106,6,9,13,14,36,56,-20,40
Queen of S't,9106,7,9,12,15,43,54,-11,39
Dumbarton,9106,8,8,14,14,48,56,-8,38
Raith,9106,9,9,11,16,32,48,-16,38
St Mirren,9106,10,7,14,15,39,56,-17,35
Hibernian,9107,1,19,11,6,60,29,31,68
Morton,9107,2,19,10,7,54,34,20,67
Falkirk,9107,3,15,11,10,55,40,15,56
Dundee Utd,9107,4,12,14,10,45,41,4,50
Queen of S't,9107,5,13,10,13,49,48,1,49
Raith,9107,6,11,10,15,40,47,-7,43
Dunfermline,9107,7,9,14,13,45,48,-3,41
Dumbarton,9107,8,8,13,15,43,58,-15,37
Ayr,9107,9,8,13,15,31,55,-24,37
St Mirren,9107,10,8,10,18,41,63,-22,34
Hibernian,9108,1,20,10,6,56,29,27,70
Dundee Utd,9108,2,19,8,9,52,37,15,65
Falkirk,9108,3,17,9,10,58,42,16,60
Morton,9108,4,15,10,11,45,40,5,55
Queen of S't,9108,5,13,9,14,46,47,-1,48
Dumbarton,9108,6,10,11,15,49,57,-8,41
Raith,9108,7,10,11,15,40,51,-11,41
Dunfermline,9108,8,9,12,15,42,50,-8,39
St Mirren,9108,9,9,9,18,40,58,-18,36
Ayr,9108,10,8,11,17,38,55,-17,35
Hibernian,9109,1,21,11,4,63,28,35,74
Falkirk,9109,2,17,10,9,59,40,19,61
Morton,9109,3,15,13,8,46,36,10,58
Dundee Utd,9109,4,15,10,11,47,38,9,55
Queen of S't,9109,5,13,9,14,49,51,-2,48
Dunfermline,9109,6,11,12,13,46,48,-2,45
Raith,9109,7,9,11,16,35,51,-16,38
Dumbarton,9109,8,8,12,16,46,60,-14,36
St Mirren,9109,9,8,11,17,44,59,-15,35
Ayr,9109,10,7,13,16,35,59,-24,34
Hibernian,9110,1,20,13,3,63,25,38,73
Morton,9110,2,17,13,6,52,33,19,64
Falkirk,9110,3,17,11,8,60,37,23,62
Dundee Utd,9110,4,15,10,11,46,41,5,55
Queen of S't,9110,5,12,9,15,45,54,-9,45
Ayr,9110,6,10,11,15,34,52,-18,41
Raith,9110,7,9,13,14,37,48,-11,40
Dunfermline,9110,8,8,13,15,45,54,-9,37
Dumbarton,9110,9,8,12,16,46,61,-15,36
St Mirren,9110,10,6,11,19,35,58,-23,29
Hibernian,9111,1,18,12,6,56,29,27,66
Dundee Utd,9111,2,16,10,10,50,38,12,58
Morton,9111,3,15,13,8,51,41,10,58
Falkirk,9111,4,15,12,9,58,43,15,57
Queen of S't,9111,5,13,9,14,49,50,-1,48
Dunfermline,9111,6,10,14,12,47,47,0,44
Dumbarton,9111,7,10,13,13,52,56,-4,43
Raith,9111,8,11,10,15,41,52,-11,43
St Mirren,9111,9,8,10,18,39,62,-23,34
Ayr,9111,10,7,11,18,33,58,-25,32
Hibernian,9112,1,21,10,5,59,26,33,73
Falkirk,9112,2,19,10,7,62,33,29,67
Morton,9112,3,19,9,8,50,32,18,66
Dundee Utd,9112,4,14,10,12,45,39,6,52
Queen of S't,9112,5,12,9,15,42,47,-5,45
Dumbarton,9112,6,9,11,16,48,60,-12,38
Raith,9112,7,9,11,16,32,55,-23,38
Ayr,9112,8,8,13,15,33,53,-20,37
Dunfermline,9112,9,8,12,16,39,49,-10,36
St Mirren,9112,10,8,11,17,44,60,-16,35
Hibernian,9113,1,20,11,5,59,27,32,71
Falkirk,9113,2,16,11,9,57,44,13,59
Morton,9113,3,16,11,9,46,37,9,59
Dundee Utd,9113,4,14,12,10,51,42,9,54
Dunfermline,9113,5,10,14,12,47,45,2,44
Queen of S't,9113,6,11,10,15,49,54,-5,43
Ayr,9113,7,10,11,15,34,50,-16,41
St Mirren,9113,8,9,11,16,43,55,-12,38
Dumbarton,9113,9,8,13,15,43,57,-14,37
Raith,9113,10,9,10,17,35,53,-18,37
Hibernian,9114,1,19,13,4,54,23,31,70
Falkirk,9114,2,17,10,9,60,40,20,61
Morton,9114,3,16,12,8,43,33,10,60
Dundee Utd,9114,4,15,9,12,45,37,8,54
Dumbarton,9114,5,12,10,14,50,54,-4,46
Dunfermline,9114,6,11,12,13,47,46,1,45
Queen of S't,9114,7,11,9,16,45,57,-12,42
Ayr,9114,8,10,11,15,33,54,-21,41
Raith,9114,9,9,9,18,36,52,-16,36
St Mirren,9114,10,8,9,19,40,57,-17,33
Morton,9115,1,17,12,7,52,36,16,63
Hibernian,9115,2,15,16,5,49,28,21,61
Falkirk,9115,3,17,10,9,62,42,20,61
Dundee Utd,9115,4,16,10,10,52,38,14,58
Queen of S't,9115,5,13,9,14,46,47,-1,48
Dunfermline,9115,6,10,12,14,51,53,-2,42
Dumbarton,9115,7,10,10,16,49,63,-14,40
St Mirren,9115,8,9,11,16,43,54,-11,38
Raith,9115,9,9,11,16,33,55,-22,38
Ayr,9115,10,6,15,15,36,57,-21,33
Hibernian,9116,1,18,14,4,55,25,30,68
Morton,9116,2,17,11,8,53,40,13,62
Dundee Utd,9116,3,16,9,11,49,40,9,57
Falkirk,9116,4,13,12,11,57,45,12,51
Raith,9116,5,14,9,13,38,43,-5,51
Dunfermline,9116,6,9,14,13,44,49,-5,41
Dumbarton,9116,7,9,14,13,53,59,-6,41
Queen of S't,9116,8,10,11,15,47,53,-6,41
St Mirren,9116,9,9,9,18,41,60,-19,36
Ayr,9116,10,8,11,17,29,52,-23,35
Hibernian,9117,1,20,12,4,54,22,32,72
Dundee Utd,9117,2,17,11,8,54,37,17,62
Falkirk,9117,3,17,9,10,59,40,19,60
Morton,9117,4,14,10,12,44,43,1,52
Dunfermline,9117,5,12,11,13,56,45,11,47
Raith,9117,6,13,8,15,42,48,-6,47
Dumbarton,9117,7,10,10,16,49,61,-12,40
Queen of S't,9117,8,10,10,16,40,53,-13,40
St Mirren,9117,9,8,11,17,40,56,-16,35
Ayr,9117,10,8,10,18,30,63,-33,34
Hibernian,9118,1,18,11,7,52,31,21,65
Morton,9118,2,18,11,7,54,36,18,65
Falkirk,9118,3,17,10,9,54,35,19,61
Dundee Utd,9118,4,15,10,11,49,42,7,55
Raith,9118,5,13,9,14,38,44,-6,48
Dunfermline,9118,6,11,11,14,51,50,1,44
Queen of S't,9118,7,12,8,16,43,48,-5,44
Dumbarton,9118,8,9,11,16,47,59,-12,38
St Mirren,9118,9,8,11,17,37,56,-19,35
Ayr,9118,10,7,12,17,32,56,-24,33
Hibernian,9119,1,20,10,6,58,29,29,70
Falkirk,9119,2,17,11,8,62,40,22,62
Morton,9119,3,17,11,8,50,36,14,62
Dundee Utd,9119,4,12,11,13,49,49,0,47
Queen of S't,9119,5,12,10,14,46,50,-4,46
Raith,9119,6,11,10,15,39,47,-8,43
Dunfermline,9119,7,9,14,13,44,48,-4,41
Dumbarton,9119,8,9,13,14,51,59,-8,40
St Mirren,9119,9,9,11,16,45,59,-14,38
Ayr,9119,10,7,13,16,30,57,-27,34
Hibernian,9120,1,19,11,6,58,25,33,68
Morton,9120,2,16,9,11,49,42,7,57
Dundee Utd,9120,3,16,9,11,48,41,7,57
Falkirk,9120,4,15,11,10,56,39,17,56
Dunfermline,9120,5,12,13,11,50,46,4,49
Queen of S't,9120,6,11,10,15,46,55,-9,43
Raith,9120,7,11,9,16,34,49,-15,42
St Mirren,9120,8,10,10,16,44,54,-10,40
Dumbarton,9120,9,9,12,15,45,56,-11,39
Ayr,9120,10,8,12,16,34,57,-23,36
Hibernian,9121,1,21,12,3,58,24,34,75
Morton,9121,2,17,9,10,49,45,4,60
Falkirk,9121,3,16,10,10,62,42,20,58
Dundee Utd,9121,4,16,9,11,50,42,8,57
Dunfermline,9121,5,11,14,11,51,41,10,47
Queen of S't,9121,6,12,10,14,46,49,-3,46
Raith,9121,7,9,11,16,35,53,-18,38
Dumbarton,9121,8,9,10,17,45,59,-14,37
Ayr,9121,9,8,12,16,35,55,-20,36
St Mirren,9121,10,7,11,18,39,60,-21,32
Hibernian,9122,1,18,12,6,51,26,25,66
Falkirk,9122,2,17,11,8,61,39,22,62
Morton,9122,3,15,14,7,52,41,11,59
Dundee Utd,9122,4,16,9,11,52,41,11,57
Dunfermline,9122,5,11,13,12,48,48,0,46
Queen of S't,9122,6,12,9,15,46,52,-6,45
Dumbarton,9122,7,10,12,14,49,58,-9,42
Raith,9122,8,10,9,17,31,47,-16,39
Ayr,9122,9,9,10,17,32,55,-23,37
St Mirren,9122,10,8,9,19,43,58,-15,33
Hibernian,9123,1,17,14,5,53,29,24,65
Falkirk,9123,2,17,11,8,62,42,20,62
Morton,9123,3,17,11,8,50,34,16,62
Dundee Utd,9123,4,16,11,9,54,40,14,59
Queen of S't,9123,5,11,11,14,49,48,1,44
Dunfermline,9123,6,10,14,12,46,47,-1,44
St Mirren,9123,7,10,10,16,42,53,-11,40
Raith,9123,8,10,8,18,35,57,-22,38
Dumbarton,9123,9,8,11,17,44,62,-18,35
Ayr,9123,10,7,13,16,34,57,-23,34
Hibernian,9124,1,17,12,7,54,29,25,63
Morton,9124,2,15,12,9,48,40,8,57
Falkirk,9124,3,15,10,11,58,43,15,55
Dundee Utd,9124,4,14,11,11,47,41,6,53
Queen of S't,9124,5,13,8,15,49,50,-1,47
Dunfermline,9124,6,11,13,12,51,47,4,46
Raith,9124,7,11,10,15,36,50,-14,43
Ayr,9124,8,10,13,13,36,51,-15,43
Dumbarton,9124,9,10,12,14,48,56,-8,42
St Mirren,9124,10,8,11,17,40,60,-20,35
Morton,9125,1,18,9,9,55,39,16,63
Hibernian,9125,2,17,11,8,52,33,19,62
Falkirk,9125,3,17,10,9,63,38,25,61
Dundee Utd,9125,4,14,10,12,49,46,3,52
Dunfermline,9125,5,11,13,12,49,47,2,46
Raith,9125,6,12,10,14,39,44,-5,46
Queen of S't,9125,7,10,10,16,48,55,-7,40
Dumbarton,9125,8,10,10,16,51,70,-19,40
St Mirren,9125,9,10,9,17,41,57,-16,39
Ayr,9125,10,9,12,15,39,57,-18,39
Hibernian,9126,1,21,12,3,56,22,34,75
Morton,9126,2,16,11,9,53,42,11,59
Dundee Utd,9126,3,16,10,10,55,42,13,58
Falkirk,9126,4,14,13,9,56,40,16,55
Queen of S't,9126,5,12,9,15,47,53,-6,45
Dunfermline,9126,6,10,12,14,49,51,-2,42
Dumbarton,9126,7,10,12,14,50,57,-7,42
Raith,9126,8,11,9,16,38,50,-12,42
St Mirren,9126,9,9,10,17,40,56,-16,37
Ayr,9126,10,6,12,18,35,66,-31,30
Hibernian,9127,1,19,12,5,54,24,30,69
Falkirk,9127,2,16,11,9,60,41,19,59
Morton,9127,3,15,11,10,48,39,9,56
Dundee Utd,9127,4,15,9,12,48,44,4,54
Dumbarton,9127,5,12,11,13,49,52,-3,47
Queen of S't,9127,6,12,10,14,48,54,-6,46
Dunfermline,9127,7,10,12,14,45,50,-5,42
Raith,9127,8,10,10,16,37,50,-13,40
St Mirren,9127,9,10,9,17,42,54,-12,39
Ayr,9127,10,7,13,16,32,55,-23,34
Hibernian,9128,1,19,13,4,55,24,31,70
Morton,9128,2,17,12,7,51,35,16,63
Falkirk,9128,3,16,12,8,58,38,20,60
Dundee Utd,9128,4,14,13,9,51,38,13,55
Queen of S't,9128,5,11,11,14,46,48,-2,44
Dunfermline,9128,6,8,16,12,45,48,-3,40
St Mirren,9128,7,9,11,16,42,57,-15,38
Ayr,9128,8,8,13,15,32,56,-24,37
Dumbarton,9128,9,8,12,16,47,59,-12,36
Raith,9128,10,9,9,18,35,59,-24,36
Morton,9129,1,20,9,7,54,35,19,69
Hibernian,9129,2,18,11,7,56,34,22,65
Dundee Utd,9129,3,18,8,10,46,35,11,62
Falkirk,9129,4,16,10,10,61,40,21,58
Dunfermline,9129,5,11,12,13,49,50,-1,45
Dumbarton,9129,6,11,10,15,51,61,-10,43
Ayr,9129,7,10,11,15,37,48,-11,41
Queen of S't,9129,8,10,10,16,44,51,-7,40
Raith,9129,9,9,10,17,34,51,-17,37
St Mirren,9129,10,6,11,19,35,62,-27,29
Hibernian,9130,1,19,12,5,57,27,30,69
Morton,9130,2,16,12,8,49,39,10,60
Dundee Utd,9130,3,16,10,10,57,43,14,58
Falkirk,9130,4,16,9,11,55,38,17,57
Queen of S't,9130,5,12,10,14,48,54,-6,46
Dunfermline,9130,6,10,13,13,46,48,-2,43
Raith,9130,7,10,10,16,33,51,-18,40
St Mirren,9130,8,10,9,17,42,52,-10,39
Dumbarton,9130,9,9,11,16,44,60,-16,38
Ayr,9130,10,8,12,16,38,57,-19,36
Hibernian,9131,1,20,13,3,62,24,38,73
Morton,9131,2,18,10,8,55,39,16,64
Dundee Utd,9131,3,15,10,11,48,42,6,55
Falkirk,9131,4,14,11,11,55,42,13,53
Dunfermline,9131,5,11,12,13,46,48,-2,45
Queen of S't,9131,6,11,11,14,43,50,-7,44
Dumbarton,9131,7,9,14,13,49,56,-7,41
Ayr,9131,8,9,12,15,39,58,-19,39
Raith,9131,9,9,9,18,32,52,-20,36
St Mirren,9131,10,8,10,18,39,57,-18,34
Hibernian,9132,1,18,14,4,53,25,28,68
Morton,9132,2,16,12,8,49,39,10,60
Dundee Utd,9132,3,16,11,9,54,35,19,59
Falkirk,9132,4,14,12,10,58,51,7,54
Queen of S't,9132,5,11,12,13,45,49,-4,45
Dunfermline,9132,6,10,13,13,51,49,2,43
Ayr,9132,7,9,14,13,32,49,-17,41
Raith,9132,8,9,12,15,31,46,-15,39
St Mirren,9132,9,9,10,17,45,55,-10,37
Dumbarton,9132,10,7,12,17,47,67,-20,33
Hibernian,9133,1,18,14,4,54,28,26,68
Dundee Utd,9133,2,16,9,11,52,39,13,57
Falkirk,9133,3,16,9,11,57,45,12,57
Morton,9133,4,15,11,10,47,38,9,56
Dunfermline,9133,5,11,14,11,51,47,4,47
Queen of S't,9133,6,12,11,13,47,47,0,47
Raith,9133,7,9,12,15,36,55,-19,39
Dumbarton,9133,8,9,11,16,51,63,-12,38
Ayr,9133,9,8,13,15,35,56,-21,37
St Mirren,9133,10,8,12,16,44,56,-12,36
Hibernian,9134,1,21,11,4,62,28,34,74
Morton,9134,2,16,12,8,57,39,18,60
Dundee Utd,9134,3,16,12,8,50,37,13,60
Falkirk,9134,4,16,9,11,57,43,14,57
Queen of S't,9134,5,13,10,13,47,44,3,49
Raith,9134,6,11,9,16,34,49,-15,42
Dunfermline,9134,7,9,13,14,44,51,-7,40
Dumbarton,9134,8,9,11,16,46,62,-16,38
St Mirren,9134,9,8,12,16,37,52,-15,36
Ayr,9134,10,6,11,19,32,61,-29,29
Hibernian,9135,1,18,12,6,52,25,27,66
Morton,9135,2,18,11,7,52,32,20,65
Dundee Utd,9135,3,16,11,9,46,37,9,59
Falkirk,9135,4,16,10,10,60,43,17,58
Dumbarton,9135,5,11,11,14,52,58,-6,44
Dunfermline,9135,6,10,13,13,48,46,2,43
Raith,9135,7,11,9,16,39,47,-8,42
Ayr,9135,8,9,11,16,34,58,-24,38
Queen of S't,9135,9,9,9,18,39,55,-16,36
St Mirren,9135,10,9,9,18,37,58,-21,36
Hibernian,9136,1,21,10,5,57,25,32,73
Morton,9136,2,18,12,6,54,34,20,66
Falkirk,9136,3,17,9,10,57,40,17,60
Dundee Utd,9136,4,17,8,11,55,43,12,59
Raith,9136,5,11,9,16,37,53,-16,42
Dunfermline,9136,6,10,11,15,47,55,-8,41
Queen of S't,9136,7,10,9,17,41,53,-12,39
St Mirren,9136,8,9,10,17,46,56,-10,37
Dumbarton,9136,9,8,12,16,47,61,-14,36
Ayr,9136,10,8,12,16,37,58,-21,36
Hibernian,9137,1,21,11,4,61,26,35,74
Morton,9137,2,18,11,7,56,37,19,65
Dundee Utd,9137,3,18,9,9,49,35,14,63
Falkirk,9137,4,15,10,11,58,44,14,55
Dunfermline,9137,5,10,13,13,52,52,0,43
Queen of S't,9137,6,10,11,15,43,52,-9,41
Dumbarton,9137,7,10,10,16,50,61,-11,40
St Mirren,9137,8,9,10,17,36,52,-16,37
Ayr,9137,9,8,13,15,34,52,-18,37
Raith,9137,10,8,8,20,30,58,-28,32
Hibernian,9138,1,18,11,7,59,30,29,65
Morton,9138,2,16,13,7,49,35,14,61
Falkirk,9138,3,16,9,11,59,41,18,57
Dundee Utd,9138,4,15,12,9,52,42,10,57
Queen of S't,9138,5,11,12,13,44,49,-5,45
Raith,9138,6,11,10,15,34,51,-17,43
Ayr,9138,7,10,11,15,32,51,-19,41
St Mirren,9138,8,10,10,16,45,53,-8,40
Dunfermline,9138,9,8,14,14,42,53,-11,38
Dumbarton,9138,10,8,12,16,47,58,-11,36
Hibernian,9139,1,22,10,4,56,23,33,76
Morton,9139,2,18,10,8,54,39,15,64
Falkirk,9139,3,17,10,9,59,41,18,61
Dundee Utd,9139,4,15,11,10,47,40,7,56
Queen of S't,9139,5,11,9,16,41,49,-8,42
Raith,9139,6,11,9,16,37,49,-12,42
Dunfermline,9139,7,9,12,15,44,50,-6,39
Ayr,9139,8,8,13,15,37,53,-16,37
Dumbarton,9139,9,8,12,16,44,57,-13,36
St Mirren,9139,10,7,12,17,39,57,-18,33
Hibernian,9140,1,19,12,5,58,28,30,69
Dundee Utd,9140,2,18,9,9,51,38,13,63
Falkirk,9140,3,16,10,10,59,43,16,58
Morton,9140,4,15,12,9,47,37,10,57
Ayr,9140,5,10,14,12,33,46,-13,44
Dunfermline,9140,6,10,12,14,44,50,-6,42
Queen of S't,9140,7,10,10,16,44,55,-11,40
Dumbarton,9140,8,9,12,15,47,55,-8,39
Raith,9140,9,9,10,17,34,50,-16,37
St Mirren,9140,10,8,11,17,41,56,-15,35
Hibernian,9141,1,21,11,4,59,24,35,74
Morton,9141,2,16,12,8,49,41,8,60
Falkirk,9141,3,16,11,9,60,40,20,59
Dundee Utd,9141,4,14,12,10,49,40,9,54
Dunfermline,9141,5,12,13,11,56,45,11,49
Queen of S't,9141,6,12,8,16,48,60,-12,44
Ayr,9141,7,8,14,14,38,54,-16,38
Raith,9141,8,9,10,17,32,53,-21,37
Dumbarton,9141,9,7,14,15,50,65,-15,35
St Mirren,9141,10,7,11,18,39,58,-19,32
Hibernian,9142,1,21,12,3,63,23,40,75
Falkirk,9142,2,16,11,9,60,44,16,59
Dundee Utd,9142,3,14,11,11,49,42,7,53
Morton,9142,4,14,11,11,45,39,6,53
Queen of S't,9142,5,12,12,12,47,48,-1,48
Dunfermline,9142,6,10,12,14,43,50,-7,42
Raith,9142,7,10,10,16,36,48,-12,40
Ayr,9142,8,9,12,15,35,56,-21,39
Dumbarton,9142,9,8,14,14,48,58,-10,38
St Mirren,9142,10,8,11,17,37,55,-18,35
Hibernian,9143,1,20,11,5,56,26,30,71
Falkirk,9143,2,17,10,9,61,39,22,61
Morton,9143,3,17,9,10,50,36,14,60
Dundee Utd,9143,4,17,9,10,51,42,9,60
Dunfermline,9143,5,11,11,14,53,53,0,44
Dumbarton,9143,6,11,11,14,48,53,-5,44
Raith,9143,7,10,10,16,36,49,-13,40
Queen of S't,9143,8,9,11,16,43,57,-14,38
St Mirren,9143,9,9,11,16,40,55,-15,38
Ayr,9143,10,6,13,17,31,59,-28,31
Hibernian,9144,1,18,11,7,52,26,26,65
Morton,9144,2,15,13,8,50,38,12,58
Dundee Utd,9144,3,15,13,8,46,35,11,58
Falkirk,9144,4,15,11,10,58,43,15,56
Queen of S't,9144,5,12,10,14,47,47,0,46
Dumbarton,9144,6,11,10,15,47,55,-8,43
Ayr,9144,7,10,13,13,34,49,-15,43
Dunfermline,9144,8,9,13,14,43,52,-9,40
Raith,9144,9,10,8,18,35,51,-16,38
St Mirren,9144,10,9,10,17,39,55,-16,37
Hibernian,9145,1,18,12,6,56,28,28,66
Morton,9145,2,17,11,8,49,38,11,62
Falkirk,9145,3,15,12,9,57,41,16,57
Dundee Utd,9145,4,16,8,12,47,41,6,56
Queen of S't,9145,5,14,10,12,48,46,2,52
Dumbarton,9145,6,12,11,13,54,54,0,47
Dunfermline,9145,7,11,12,13,48,46,2,45
Ayr,9145,8,8,11,17,29,52,-23,35
Raith,9145,9,8,10,18,34,58,-24,34
St Mirren,9145,10,7,11,18,36,54,-18,32
Hibernian,9146,1,18,13,5,60,32,28,67
Morton,9146,2,16,13,7,54,35,19,61
Falkirk,9146,3,16,10,10,60,47,13,58
Dundee Utd,9146,4,16,8,12,50,43,7,56
Queen of S't,9146,5,12,9,15,52,58,-6,45
Raith,9146,6,11,10,15,46,55,-9,43
St Mirren,9146,7,10,11,15,46,56,-10,41
Ayr,9146,8,9,12,15,37,58,-21,39
Dunfermline,9146,9,8,14,14,50,55,-5,38
Dumbarton,9146,10,8,12,16,46,62,-16,36
Hibernian,9147,1,21,11,4,59,25,34,74
Morton,9147,2,17,11,8,54,41,13,62
Falkirk,9147,3,14,13,9,55,40,15,55
Dundee Utd,9147,4,13,11,12,45,47,-2,50
Dumbarton,9147,5,11,12,13,50,56,-6,45
Queen of S't,9147,6,11,10,15,52,56,-4,43
Dunfermline,9147,7,9,15,12,47,47,0,42
Raith,9147,8,10,11,15,36,46,-10,41
Ayr,9147,9,8,12,16,31,54,-23,36
St Mirren,9147,10,7,12,17,38,55,-17,33
Hibernian,9148,1,18,12,6,55,28,27,66
Morton,9148,2,16,10,10,48,41,7,58
Falkirk,9148,3,14,12,10,55,43,12,54
Dundee Utd,9148,4,13,13,10,44,41,3,52
Queen of S't,9148,5,13,10,13,51,46,5,49
Raith,9148,6,11,11,14,37,45,-8,44
Dunfermline,9148,7,10,13,13,46,48,-2,43
Dumbarton,9148,8,10,11,15,48,59,-11,41
St Mirren,9148,9,8,13,15,37,52,-15,37
Ayr,9148,10,7,15,14,33,51,-18,36
Hibernian,9149,1,21,10,5,59,23,36,73
Morton,9149,2,17,9,10,52,38,14,60
Falkirk,9149,3,15,11,10,56,47,9,56
Dundee Utd,9149,4,15,9,12,44,42,2,54
Dumbarton,9149,5,11,12,13,53,53,0,45
Queen of S't,9149,6,11,12,13,44,51,-7,45
Dunfermline,9149,7,10,13,13,48,51,-3,43
Raith,9149,8,10,9,17,37,54,-17,39
Ayr,9149,9,9,11,16,32,53,-21,38
St Mirren,9149,10,8,10,18,43,56,-13,34
Hibernian,9150,1,20,10,6,61,29,32,70
Morton,9150,2,17,11,8,52,36,16,62
Falkirk,9150,3,14,12,10,60,48,12,54
Dundee Utd,9150,4,14,10,12,48,40,8,52
Queen of S't,9150,5,13,9,14,51,55,-4,48
Dunfermline,9150,6,11,13,12,46,49,-3,46
St Mirren,9150,7,10,10,16,44,56,-12,40
Dumbarton,9150,8,9,12,15,48,60,-12,39
Raith,9150,9,9,11,16,37,52,-15,38
Ayr,9150,10,8,12,16,30,52,-22,36
Hibernian,9151,1,20,12,4,60,25,35,72
Morton,9151,2,15,12,9,45,37,8,57
Dundee Utd,9151,3,15,11,10,47,36,11,56
Falkirk,9151,4,15,10,11,56,44,12,55
Dunfermline,9151,5,11,13,12,51,48,3,46
Queen of S't,9151,6,12,8,16,48,55,-7,44
Raith,9151,7,11,10,15,37,46,-9,43
Dumbarton,9151,8,9,11,16,47,57,-10,38
Ayr,9151,9,9,11,16,32,56,-24,38
St Mirren,9151,10,9,10,17,39,58,-19,37
Hibernian,9152,1,18,14,4,57,27,30,68
Morton,9152,2,17,11,8,53,41,12,62
Falkirk,9152,3,17,10,9,55,39,16,61
Dundee Utd,9152,4,14,9,13,46,44,2,51
Dunfermline,9152,5,11,13,12,47,44,3,46
Raith,9152,6,11,10,15,33,45,-12,43
Queen of S't,9152,7,10,11,15,43,49,-6,41
Dumbarton,9152,8,9,11,16,52,64,-12,38
Ayr,9152,9,8,14,14,33,50,-17,38
St Mirren,9152,10,8,11,17,41,57,-16,35
Hibernian,9153,1,21,11,4,61,22,39,74
Morton,9153,2,17,11,8,48,33,15,62
Dundee Utd,9153,3,16,11,9,56,40,16,59
Falkirk,9153,4,15,11,10,57,44,13,56
Dumbarton,9153,5,10,13,13,50,56,-6,43
Dunfermline,9153,6,10,13,13,45,51,-6,43
Queen of S't,9153,7,10,9,17,42,57,-15,39
Raith,9153,8,9,11,16,31,47,-16,38
Ayr,9153,9,8,13,15,35,55,-20,37
St Mirren,9153,10,7,11,18,39,59,-20,32
Hibernian,9154,1,20,12,4,56,22,34,72
Falkirk,9154,2,17,11,8,63,37,26,62
Morton,9154,3,17,11,8,48,35,13,62
Dundee Utd,9154,4,17,9,10,55,36,19,60
Queen of S't,9154,5,12,9,15,42,48,-6,45
Dunfermline,9154,6,10,12,14,41,45,-4,42
Raith,9154,7,10,9,17,32,53,-21,39
Dumbarton,9154,8,9,11,16,44,58,-14,38
St Mirren,9154,9,7,12,17,41,61,-20,33
Ayr,9154,10,7,12,17,31,58,-27,33
Hibernian,9155,1,18,10,8,53,29,24,64
Morton,9155,2,17,12,7,53,36,17,63
Falkirk,9155,3,16,10,10,58,40,18,58
Dundee Utd,9155,4,14,12,10,49,41,8,54
Raith,9155,5,12,11,13,37,43,-6,47
Dumbarton,9155,6,11,12,13,57,57,0,45
Queen of S't,9155,7,10,10,16,44,53,-9,40
Dunfermline,9155,8,9,12,15,45,59,-14,39
Ayr,9155,9,9,12,15,35,54,-19,39
St Mirren,9155,10,8,11,17,38,57,-19,35
Hibernian,9156,1,20,11,5,55,25,30,71
Morton,9156,2,18,10,8,47,34,13,64
Falkirk,9156,3,17,9,10,55,41,14,60
Dundee Utd,9156,4,16,11,9,48,37,11,59
Dunfermline,9156,5,12,12,12,50,45,5,48
Dumbarton,9156,6,10,10,16,50,59,-9,40
Ayr,9156,7,9,11,16,36,55,-19,38
St Mirren,9156,8,9,10,17,40,53,-13,37
Queen of S't,9156,9,9,9,18,39,53,-14,36
Raith,9156,10,9,9,18,30,48,-18,36
Hibernian,9157,1,19,11,6,55,29,26,68
Dundee Utd,9157,2,17,11,8,54,38,16,62
Falkirk,9157,3,16,12,8,60,39,21,60
Morton,9157,4,16,12,8,49,36,13,60
Dunfermline,9157,5,10,13,13,44,48,-4,43
Queen of S't,9157,6,11,8,17,43,51,-8,41
Dumbarton,9157,7,9,13,14,49,56,-7,40
Ayr,9157,8,9,13,14,38,54,-16,40
Raith,9157,9,9,10,17,33,53,-20,37
St Mirren,9157,10,7,11,18,38,59,-21,32
Hibernian,9158,1,19,13,4,53,23,30,70
Morton,9158,2,15,13,8,43,35,8,58
Dundee Utd,9158,3,15,11,10,49,39,10,56
Falkirk,9158,4,15,10,11,55,44,11,55
Queen of S't,9158,5,14,10,12,51,46,5,52
Dunfermline,9158,6,11,12,13,47,46,1,45
Raith,9158,7,11,9,16,37,50,-13,42
St Mirren,9158,8,9,10,17,44,56,-12,37
Dumbarton,9158,9,7,14,15,46,63,-17,35
Ayr,9158,10,7,12,17,33,56,-23,33
Hibernian,9159,1,17,10,9,55,33,22,61
Morton,9159,2,16,13,7,50,38,12,61
Dundee Utd,9159,3,17,9,10,55,43,12,60
Falkirk,9159,4,16,11,9,61,44,17,59
Queen of S't,9159,5,12,11,13,46,48,-2,47
Dunfermline,9159,6,10,14,12,47,50,-3,44
Raith,9159,7,11,10,15,39,50,-11,43
St Mirren,9159,8,10,11,15,44,53,-9,41
Ayr,9159,9,8,11,17,37,58,-21,35
Dumbarton,9159,10,7,12,17,45,62,-17,33
Hibernian,9160,1,20,12,4,57,25,32,72
Morton,9160,2,18,11,7,52,32,20,65
Falkirk,9160,3,15,13,8,61,41,20,58
Dundee Utd,9160,4,13,13,10,50,45,5,52
Queen of S't,9160,5,11,10,15,45,52,-7,43
Dunfermline,9160,6,9,15,12,44,49,-5,42
Raith,9160,7,10,8,18,31,48,-17,38
Ayr,9160,8,9,11,16,33,56,-23,38
Dumbarton,9160,9,8,13,15,48,58,-10,37
St Mirren,9160,10,9,10,17,38,53,-15,37
Hibernian,9161,1,21,11,4,62,23,39,74
Falkirk,9161,2,17,10,9,62,40,22,61
Morton,9161,3,17,10,9,53,39,14,61
Dundee Utd,9161,4,16,10,10,54,41,13,58
Queen of S't,9161,5,13,10,13,48,52,-4,49
Dunfermline,9161,6,10,12,14,48,51,-3,42
Raith,9161,7,10,9,17,34,49,-15,39
St Mirren,9161,8,7,13,16,41,60,-19,34
Dumbarton,9161,9,7,13,16,50,70,-20,34
Ayr,9161,10,7,12,17,33,60,-27,33
Hibernian,9162,1,20,12,4,59,27,32,72
Falkirk,9162,2,18,11,7,65,36,29,65
Morton,9162,3,15,13,8,52,41,11,58
Dundee Utd,9162,4,16,8,12,49,42,7,56
Queen of S't,9162,5,11,10,15,48,52,-4,43
Dunfermline,9162,6,10,12,14,51,57,-6,42
Raith,9162,7,10,11,15,38,52,-14,41
Ayr,9162,8,9,12,15,35,56,-21,39
Dumbarton,9162,9,8,12,16,44,57,-13,36
St Mirren,9162,10,7,11,18,39,60,-21,32
Hibernian,9163,1,20,11,5,58,28,30,71
Morton,9163,2,20,10,6,60,33,27,70
Falkirk,9163,3,17,10,9,62,40,22,61
Dundee Utd,9163,4,14,11,11,46,41,5,53
Dumbarton,9163,5,12,11,13,54,58,-4,47
Ayr,9163,6,11,11,14,37,54,-17,44
Queen of S't,9163,7,10,10,16,41,54,-13,40
Dunfermline,9163,8,8,12,16,47,57,-10,36
Raith,9163,9,8,10,18,32,53,-21,34
St Mirren,9163,10,7,10,19,41,60,-19,31
Hibernian,9164,1,19,11,6,57,28,29,68
Dundee Utd,9164,2,17,10,9,52,40,12,61
Falkirk,9164,3,15,11,10,59,45,14,56
Morton,9164,4,14,14,8,52,41,11,56
Queen of S't,9164,5,13,9,14,48,49,-1,48
Dunfermline,9164,6,11,12,13,49,48,1,45
Ayr,9164,7,9,12,15,36,53,-17,39
Dumbarton,9164,8,9,11,16,49,63,-14,38
Raith,9164,9,9,10,17,34,56,-22,37
St Mirren,9164,10,8,12,16,40,53,-13,36
Hibernian,9165,1,19,13,4,53,24,29,70
Morton,9165,2,18,10,8,52,34,18,64
Falkirk,9165,3,14,14,8,58,40,18,56
Dundee Utd,9165,4,14,12,10,47,41,6,54
Dunfermline,9165,5,11,12,13,43,44,-1,45
Queen of S't,9165,6,11,12,13,42,47,-5,45
Dumbarton,9165,7,9,13,14,51,59,-8,40
St Mirren,9165,8,9,11,16,44,60,-16,38
Raith,9165,9,9,9,18,32,50,-18,36
Ayr,9165,10,8,10,18,37,60,-23,34
Hibernian,9166,1,19,11,6,56,25,31,68
Falkirk,9166,2,15,13,8,54,37,17,58
Dundee Utd,9166,3,16,10,10,57,41,16,58
Morton,9166,4,15,9,12,47,41,6,54
Dunfermline,9166,5,11,12,13,47,49,-2,45
Queen of S't,9166,6,12,9,15,41,47,-6,45
Dumbarton,9166,7,11,10,15,49,61,-12,43
St Mirren,9166,8,10,11,15,44,57,-13,41
Raith,9166,9,10,9,17,34,49,-15,39
Ayr,9166,10,8,12,16,35,57,-22,36
Hibernian,9167,1,17,14,5,51,27,24,65
Morton,9167,2,18,11,7,51,34,17,65
Falkirk,9167,3,17,12,7,60,37,23,63
Dundee Utd,9167,4,14,12,10,46,40,6,54
Queen of S't,9167,5,12,12,12,44,44,0,48
Dunfermline,9167,6,9,13,14,42,48,-6,40
St Mirren,9167,7,9,11,16,40,51,-11,38
Ayr,9167,8,8,13,15,36,52,-16,37
Dumbarton,9167,9,8,12,16,41,57,-16,36
Raith,9167,10,8,10,18,31,52,-21,34
Hibernian,9168,1,17,14,5,54,26,28,65
Dundee Utd,9168,2,18,10,8,57,37,20,64
Morton,9168,3,17,11,8,50,40,10,62
Falkirk,9168,4,14,12,10,54,44,10,54
Queen of S't,9168,5,12,11,13,46,48,-2,47
Dumbarton,9168,6,10,11,15,49,54,-5,41
Dunfermline,9168,7,9,13,14,50,56,-6,40
Raith,9168,8,9,10,17,30,50,-20,37
St Mirren,9168,9,8,12,16,39,54,-15,36
Ayr,9168,10,8,12,16,31,51,-20,36
Hibernian,9169,1,20,12,4,57,22,35,72
Dundee Utd,9169,2,18,9,9,53,38,15,63
Falkirk,9169,3,17,10,9,59,40,19,61
Morton,9169,4,15,14,7,46,33,13,59
Dumbarton,9169,5,10,13,13,46,51,-5,43
Queen of S't,9169,6,10,10,16,39,46,-7,40
Raith,9169,7,10,10,16,35,54,-19,40
Dunfermline,9169,8,9,12,15,44,49,-5,39
Ayr,9169,9,7,13,16,31,56,-25,34
St Mirren,9169,10,8,9,19,38,59,-21,33
Hibernian,9170,1,17,14,5,51,28,23,65
Falkirk,9170,2,17,9,10,64,39,25,60
Morton,9170,3,15,13,8,45,35,10,58
Dundee Utd,9170,4,15,10,11,49,41,8,55
Raith,9170,5,11,10,15,37,45,-8,43
Queen of S't,9170,6,11,10,15,43,53,-10,43
St Mirren,9170,7,10,11,15,39,51,-12,41
Dunfermline,9170,8,8,15,13,41,46,-5,39
Ayr,9170,9,8,15,13,36,54,-18,39
Dumbarton,9170,10,8,13,15,45,58,-13,37
Hibernian,9171,1,17,13,6,50,26,24,64
Morton,9171,2,17,11,8,48,35,13,62
Falkirk,9171,3,16,11,9,56,39,17,59
Dundee Utd,9171,4,14,9,13,45,45,0,51
Queen of S't,9171,5,11,11,14,45,49,-4,44
Raith,9171,6,11,11,14,39,47,-8,44
Dunfermline,9171,7,10,13,13,47,48,-1,43
Dumbarton,9171,8,10,13,13,51,55,-4,43
Ayr,9171,9,9,13,14,36,52,-16,40
St Mirren,9171,10,8,9,19,37,58,-21,33
Hibernian,9172,1,17,15,4,49,24,25,66
Morton,9172,2,18,11,7,54,33,21,65
Dundee Utd,9172,3,17,9,10,56,40,16,60
Falkirk,9172,4,16,10,10,62,43,19,58
Queen of S't,9172,5,14,9,13,54,49,5,51
Dunfermline,9172,6,9,13,14,44,54,-10,40
Ayr,9172,7,9,12,15,35,52,-17,39
Dumbarton,9172,8,9,10,17,45,62,-17,37
Raith,9172,9,8,12,16,36,55,-19,36
St Mirren,9172,10,7,11,18,37,60,-23,32
Hibernian,9173,1,20,10,6,58,30,28,70
Morton,9173,2,18,10,8,52,35,17,64
Dundee Utd,9173,3,18,9,9,58,37,21,63
Falkirk,9173,4,15,11,10,57,46,11,56
Queen of S't,9173,5,11,9,16,47,53,-6,42
Dunfermline,9173,6,10,12,14,44,51,-7,42
Dumbarton,9173,7,10,11,15,47,56,-9,41
Raith,9173,8,10,9,17,38,52,-14,39
Ayr,9173,9,8,12,16,35,60,-25,36
St Mirren,9173,10,8,11,17,43,59,-16,35
Hibernian,9174,1,19,11,6,54,27,27,68
Falkirk,9174,2,17,11,8,60,39,21,62
Morton,9174,3,15,10,11,49,42,7,55
Dundee Utd,9174,4,15,9,12,49,45,4,54
Raith,9174,5,13,10,13,42,48,-6,49
Ayr,9174,6,11,12,13,37,48,-11,45
Queen of S't,9174,7,11,9,16,45,52,-7,42
Dumbarton,9174,8,10,10,16,47,58,-11,40
Dunfermline,9174,9,8,13,15,45,53,-8,37
St Mirren,9174,10,8,11,17,39,55,-16,35
Hibernian,9175,1,20,11,5,58,29,29,71
Morton,9175,2,16,13,7,51,37,14,61
Dundee Utd,9175,3,15,11,10,46,35,11,56
Dunfermline,9175,4,14,12,10,56,42,14,54
Falkirk,9175,5,13,12,11,54,46,8,51
Queen of S't,9175,6,12,10,14,46,52,-6,46
Ayr,9175,7,9,11,16,31,57,-26,38
St Mirren,9175,8,9,10,17,48,60,-12,37
Raith,9175,9,9,10,17,37,54,-17,37
Dumbarton,9175,10,8,10,18,48,63,-15,34
Hibernian,9176,1,19,13,4,54,23,31,70
Morton,9176,2,17,13,6,53,35,18,64
Falkirk,9176,3,16,11,9,55,36,19,59
Dundee Utd,9176,4,16,10,10,49,39,10,58
Queen of S't,9176,5,11,12,13,47,48,-1,45
Ayr,9176,6,9,13,14,35,53,-18,40
Dunfermline,9176,7,8,15,13,43,49,-6,39
Raith,9176,8,8,12,16,34,51,-17,36
St Mirren,9176,9,8,11,17,41,58,-17,35
Dumbarton,9176,10,7,12,17,46,65,-19,33
Hibernian,9177,1,18,11,7,56,29,27,65
Dundee Utd,9177,2,17,10,9,53,37,16,61
Morton,9177,3,16,11,9,47,37,10,59
Falkirk,9177,4,16,10,10,63,41,22,58
Queen of S't,9177,5,14,9,13,48,48,0,51
Dunfermline,9177,6,12,11,13,46,48,-2,47
Raith,9177,7,10,9,17,35,54,-19,39
Dumbarton,9177,8,8,14,14,48,58,-10,38
St Mirren,9177,9,8,12,16,44,57,-13,36
Ayr,9177,10,6,13,17,34,65,-31,31
Morton,9178,1,20,10,6,57,31,26,70
Hibernian,9178,2,18,13,5,54,25,29,67
Dundee Utd,9178,3,19,8,9,57,36,21,65
Falkirk,9178,4,14,12,10,53,40,13,54
Raith,9178,5,11,10,15,39,49,-10,43
Dunfermline,9178,6,9,13,14,46,52,-6,40
Queen of S't,9178,7,10,10,16,44,57,-13,40
St Mirren,9178,8,9,10,17,41,55,-14,37
Dumbarton,9178,9,8,11,17,45,61,-16,35
Ayr,9178,10,7,13,16,32,62,-30,34
Hibernian,9179,1,19,11,6,54,29,25,68
Morton,9179,2,16,10,10,49,42,7,58
Falkirk,9179,3,15,12,9,57,39,18,57
Dundee Utd,9179,4,14,10,12,44,40,4,52
Dunfermline,9179,5,12,14,10,48,42,6,50
Queen of S't,9179,6,11,9,16,47,52,-5,42
St Mirren,9179,7,10,11,15,45,53,-8,41
Raith,9179,8,10,10,16,40,54,-14,40
Dumbarton,9179,9,9,12,15,48,61,-13,39
Ayr,9179,10,9,11,16,35,55,-20,38
Hibernian,9180,1,18,11,7,54,28,26,65
Falkirk,9180,2,17,10,9,65,42,23,61
Morton,9180,3,15,13,8,48,38,10,58
Dundee Utd,9180,4,15,11,10,50,43,7,56
Queen of S't,9180,5,13,10,13,46,49,-3,49
Raith,9180,6,12,9,15,39,49,-10,45
Dumbarton,9180,7,10,12,14,49,57,-8,42
St Mirren,9180,8,10,10,16,45,58,-13,40
Dunfermline,9180,9,7,14,15,41,50,-9,35
Ayr,9180,10,7,12,17,34,57,-23,33
Hibernian,9181,1,22,10,4,60,23,37,76
Morton,9181,2,18,10,8,55,36,19,64
Dundee Utd,9181,3,17,10,9,51,36,15,61
Falkirk,9181,4,15,9,12,57,48,9,54
Dunfermline,9181,5,10,13,13,46,49,-3,43
Dumbarton,9181,6,11,10,15,48,52,-4,43
Queen of S't,9181,7,10,10,16,43,54,-11,40
Ayr,9181,8,9,11,16,32,58,-26,38
St Mirren,9181,9,9,9,18,41,55,-14,36
Raith,9181,10,8,10,18,33,55,-22,34
Hibernian,9182,1,20,11,5,59,26,33,71
Morton,9182,2,19,10,7,53,34,19,67
Falkirk,9182,3,16,10,10,59,43,16,58
Dundee Utd,9182,4,15,12,9,46,38,8,57
Queen of S't,9182,5,12,10,14,46,51,-5,46
Dunfermline,9182,6,11,11,14,48,46,2,44
Raith,9182,7,11,9,16,39,51,-12,42
St Mirren,9182,8,9,10,17,45,56,-11,37
Dumbarton,9182,9,9,10,17,45,59,-14,37
Ayr,9182,10,6,11,19,33,69,-36,29
Hibernian,9183,1,23,10,3,67,22,45,79
Dundee Utd,9183,2,17,10,9,54,37,17,61
Morton,9183,3,16,10,10,49,42,7,58
Falkirk,9183,4,14,11,11,56,42,14,53
Queen of S't,9183,5,12,9,15,42,53,-11,45
Dumbarton,9183,6,11,11,14,50,55,-5,44
Dunfermline,9183,7,10,12,14,46,50,-4,42
Raith,9183,8,10,9,17,37,51,-14,39
Ayr,9183,9,7,13,16,32,59,-27,34
St Mirren,9183,10,6,13,17,36,58,-22,31
Hibernian,9184,1,19,12,5,57,30,27,69
Morton,9184,2,18,11,7,56,38,18,65
Falkirk,9184,3,16,13,7,57,38,19,61
Dundee Utd,9184,4,14,13,9,50,39,11,55
Queen of S't,9184,5,13,10,13,47,48,-1,49
St Mirren,9184,6,10,11,15,44,52,-8,41
Dunfermline,9184,7,8,15,13,45,49,-4,39
Raith,9184,8,9,9,18,35,51,-16,36
Ayr,9184,9,8,10,18,33,64,-31,34
Dumbarton,9184,10,7,12,17,48,63,-15,33
Morton,9185,1,19,11,6,55,35,20,68
Hibernian,9185,2,18,12,6,53,31,22,66
Falkirk,9185,3,15,11,10,56,41,15,56
Dundee Utd,9185,4,13,13,10,46,40,6,52
Queen of S't,9185,5,13,10,13,48,48,0,49
Ayr,9185,6,10,10,16,39,55,-16,40
Dunfermline,9185,7,8,15,13,43,49,-6,39
Dumbarton,9185,8,9,12,15,50,59,-9,39
St Mirren,9185,9,9,11,16,42,55,-13,38
Raith,9185,10,9,9,18,35,54,-19,36
Hibernian,9186,1,20,12,4,60,22,38,72
Morton,9186,2,17,12,7,48,33,15,63
Dundee Utd,9186,3,18,8,10,55,42,13,62
Falkirk,9186,4,15,10,11,56,45,11,55
Dumbarton,9186,5,13,10,13,54,52,2,49
Queen of S't,9186,6,11,9,16,44,51,-7,42
Ayr,9186,7,9,13,14,38,55,-17,40
Dunfermline,9186,8,8,13,15,41,51,-10,37
Raith,9186,9,8,11,17,32,51,-19,35
St Mirren,9186,10,7,10,19,38,64,-26,31
Hibernian,9187,1,19,12,5,58,27,31,69
Morton,9187,2,17,11,8,55,36,19,62
Falkirk,9187,3,16,10,10,53,40,13,58
Dundee Utd,9187,4,14,11,11,48,44,4,53
Queen of S't,9187,5,11,12,13,46,50,-4,45
Dunfermline,9187,6,10,12,14,43,50,-7,42
Raith,9187,7,10,12,14,38,49,-11,42
St Mirren,9187,8,10,10,16,44,54,-10,40
Dumbarton,9187,9,9,11,16,47,59,-12,38
Ayr,9187,10,7,13,16,35,58,-23,34
Hibernian,9188,1,19,12,5,54,25,29,69
Falkirk,9188,2,16,11,9,57,40,17,59
Morton,9188,3,15,13,8,47,36,11,58
Dundee Utd,9188,4,16,9,11,48,40,8,57
Raith,9188,5,12,8,16,40,50,-10,44
Dunfermline,9188,6,10,13,13,47,51,-4,43
Queen of S't,9188,7,11,10,15,43,50,-7,43
Ayr,9188,8,9,13,14,32,50,-18,40
Dumbarton,9188,9,9,12,15,52,60,-8,39
St Mirren,9188,10,6,13,17,36,54,-18,31
Hibernian,9189,1,19,14,3,57,25,32,71
Morton,9189,2,17,13,6,53,31,22,64
Dundee Utd,9189,3,15,10,11,50,43,7,55
Falkirk,9189,4,14,10,12,55,43,12,52
Dunfermline,9189,5,10,14,12,48,46,2,44
Queen of S't,9189,6,11,9,16,44,55,-11,42
Ayr,9189,7,10,12,14,38,54,-16,42
Raith,9189,8,10,10,16,35,51,-16,40
Dumbarton,9189,9,8,13,15,49,61,-12,37
St Mirren,9189,10,9,9,18,41,61,-20,36
Morton,9190,1,17,12,7,49,37,12,63
Hibernian,9190,2,17,11,8,53,32,21,62
Dundee Utd,9190,3,17,11,8,56,38,18,62
Falkirk,9190,4,15,9,12,59,50,9,54
Dunfermline,9190,5,11,13,12,47,42,5,46
Queen of S't,9190,6,11,11,14,44,53,-9,44
Dumbarton,9190,7,10,12,14,47,55,-8,42
Raith,9190,8,10,11,15,37,45,-8,41
Ayr,9190,9,7,14,15,34,55,-21,35
St Mirren,9190,10,6,14,16,36,55,-19,32
Hibernian,9191,1,20,12,4,57,24,33,72
Morton,9191,2,17,11,8,52,37,15,62
Dundee Utd,9191,3,17,10,9,53,40,13,61
Falkirk,9191,4,15,12,9,60,45,15,57
Queen of S't,9191,5,12,9,15,47,54,-7,45
Ayr,9191,6,10,10,16,33,51,-18,40
Dunfermline,9191,7,9,12,15,47,53,-6,39
Dumbarton,9191,8,9,11,16,51,62,-11,38
Raith,9191,9,10,8,18,34,52,-18,38
St Mirren,9191,10,9,9,18,41,57,-16,36
Morton,9192,1,20,10,6,53,34,19,70
Hibernian,9192,2,17,13,6,56,31,25,64
Falkirk,9192,3,16,9,11,65,45,20,57
Dundee Utd,9192,4,16,9,11,49,41,8,57
Queen of S't,9192,5,13,10,13,49,49,0,49
Dunfermline,9192,6,10,12,14,46,52,-6,42
St Mirren,9192,7,10,10,16,41,54,-13,40
Raith,9192,8,10,8,18,38,53,-15,38
Dumbarton,9192,9,8,12,16,43,57,-14,36
Ayr,9192,10,7,13,16,36,60,-24,34
Hibernian,9193,1,21,12,3,60,27,33,75
Morton,9193,2,18,10,8,52,34,18,64
Falkirk,9193,3,17,9,10,60,41,19,60
Dundee Utd,9193,4,14,11,11,49,42,7,53
Queen of S't,9193,5,12,9,15,47,52,-5,45
Dumbarton,9193,6,10,12,14,49,59,-10,42
Raith,9193,7,10,9,17,35,48,-13,39
Dunfermline,9193,8,8,14,14,39,46,-7,38
Ayr,9193,9,8,12,16,37,61,-24,36
St Mirren,9193,10,8,10,18,41,59,-18,34
Hibernian,9194,1,20,12,4,58,25,33,72
Falkirk,9194,2,15,13,8,60,39,21,58
Dundee Utd,9194,3,15,13,8,48,37,11,58
Morton,9194,4,14,13,9,47,44,3,55
Dunfermline,9194,5,9,16,11,49,49,0,43
Queen of S't,9194,6,10,13,13,49,53,-4,43
Ayr,9194,7,8,14,14,32,49,-17,38
St Mirren,9194,8,9,10,17,42,61,-19,37
Dumbarton,9194,9,7,15,14,49,61,-12,36
Raith,9194,10,9,9,18,38,54,-16,36
Hibernian,9195,1,19,11,6,52,26,26,68
Morton,9195,2,17,9,10,53,44,9,60
Dundee Utd,9195,3,16,11,9,59,43,16,59
Falkirk,9195,4,15,11,10,63,46,17,56
Queen of S't,9195,5,13,11,12,52,50,2,50
Dunfermline,9195,6,11,12,13,52,52,0,45
Raith,9195,7,11,9,16,38,55,-17,42
St Mirren,9195,8,8,12,16,46,63,-17,36
Dumbarton,9195,9,7,13,16,54,67,-13,34
Ayr,9195,10,7,13,16,35,58,-23,34
Hibernian,9196,1,20,13,3,52,20,32,73
Dundee Utd,9196,2,17,9,10,51,42,9,60
Falkirk,9196,3,16,11,9,61,41,20,59
Morton,9196,4,15,13,8,47,36,11,58
Dunfermline,9196,5,10,13,13,47,49,-2,43
Queen of S't,9196,6,11,9,16,43,52,-9,42
Raith,9196,7,9,13,14,38,49,-11,40
St Mirren,9196,8,9,11,16,45,52,-7,38
Ayr,9196,9,8,12,16,33,56,-23,36
Dumbarton,9196,10,7,12,17,47,67,-20,33
Hibernian,9197,1,17,14,5,58,31,27,65
Dundee Utd,9197,2,17,9,10,52,38,14,60
Morton,9197,3,16,11,9,51,41,10,59
Falkirk,9197,4,15,11,10,55,40,15,56
Dunfermline,9197,5,13,12,11,47,42,5,51
Raith,9197,6,12,9,15,39,48,-9,45
Queen of S't,9197,7,10,11,15,44,54,-10,41
Dumbarton,9197,8,9,11,16,47,58,-11,38
St Mirren,9197,9,8,11,17,40,59,-19,35
Ayr,9197,10,8,11,17,39,61,-22,35
Hibernian,9198,1,19,11,6,56,24,32,68
Morton,9198,2,19,9,8,50,37,13,66
Dundee Utd,9198,3,16,11,9,52,36,16,59
Falkirk,9198,4,13,13,10,53,46,7,52
Dunfermline,9198,5,11,11,14,48,47,1,44
Queen of S't,9198,6,11,11,14,42,48,-6,44
Raith,9198,7,11,10,15,40,49,-9,43
Dumbarton,9198,8,8,12,16,46,59,-13,36
St Mirren,9198,9,8,12,16,45,58,-13,36
Ayr,9198,10,8,12,16,32,60,-28,36
Hibernian,9199,1,20,13,3,57,24,33,73
Dundee Utd,9199,2,17,11,8,50,36,14,62
Falkirk,9199,3,15,13,8,57,38,19,58
Morton,9199,4,14,14,8,47,38,9,56
Queen of S't,9199,5,12,12,12,46,47,-1,48
Dunfermline,9199,6,9,13,14,43,47,-4,40
Dumbarton,9199,7,9,12,15,48,57,-9,39
Ayr,9199,8,9,11,16,35,54,-19,38
Raith,9199,9,8,11,17,33,54,-21,35
St Mirren,9199,10,7,10,19,36,57,-21,31
Hibernian,9200,1,21,11,4,57,27,30,74
Morton,9200,2,17,12,7,51,36,15,63
Dundee Utd,9200,3,17,10,9,49,36,13,61
Falkirk,9200,4,16,10,10,58,40,18,58
Queen of S't,9200,5,11,11,14,47,46,1,44
Raith,9200,6,10,10,16,34,47,-13,40
Dunfermline,9200,7,8,13,15,44,51,-7,37
St Mirren,9200,8,9,10,17,39,52,-13,37
Dumbarton,9200,9,8,12,16,49,68,-19,36
Ayr,9200,10,8,11,17,31,56,-25,35
Morton,9201,1,17,14,5,54,38,16,65
Falkirk,9201,2,16,11,9,62,42,20,59
Hibernian,9201,3,16,11,9,55,36,19,59
Dundee Utd,9201,4,16,10,10,54,39,15,58
Raith,9201,5,14,9,13,39,43,-4,51
Queen of S't,9201,6,12,9,15,48,56,-8,45
Dunfermline,9201,7,10,14,12,50,50,0,44
Ayr,9201,8,10,10,16,35,53,-18,40
Dumbarton,9201,9,8,12,16,48,61,-13,36
St Mirren,9201,10,6,10,20,37,64,-27,28
Hibernian,9202,1,19,13,4,57,25,32,70
Morton,9202,2,16,10,10,47,39,8,58
Dundee Utd,9202,3,16,9,11,56,42,14,57
Falkirk,9202,4,15,11,10,58,41,17,56
Raith,9202,5,12,9,15,35,43,-8,45
Dunfermline,9202,6,10,14,12,47,47,0,44
Dumbarton,9202,7,10,13,13,54,58,-4,43
Queen of S't,9202,8,11,10,15,44,53,-9,43
Ayr,9202,9,8,12,16,37,59,-22,36
St Mirren,9202,10,8,9,19,38,66,-28,33
Hibernian,9203,1,17,14,5,51,25,26,65
Falkirk,9203,2,16,12,8,57,40,17,60
Dundee Utd,9203,3,16,10,10,52,38,14,58
Morton,9203,4,14,13,9,46,36,10,55
Queen of S't,9203,5,14,8,14,45,46,-1,50
Dunfermline,9203,6,11,14,11,44,41,3,47
Dumbarton,9203,7,10,10,16,42,54,-12,40
St Mirren,9203,8,9,10,17,37,55,-18,37
Ayr,9203,9,8,12,16,31,54,-23,36
Raith,9203,10,8,11,17,29,45,-16,35
Hibernian,9204,1,19,12,5,62,31,31,69
Morton,9204,2,19,11,6,61,40,21,68
Falkirk,9204,3,15,12,9,56,40,16,57
Dundee Utd,9204,4,15,9,12,52,41,11,54
Ayr,9204,5,11,12,13,43,54,-11,45
Queen of S't,9204,6,11,10,15,47,54,-7,43
Dunfermline,9204,7,8,14,14,47,55,-8,38
Dumbarton,9204,8,9,11,16,44,61,-17,38
Raith,9204,9,9,10,17,32,52,-20,37
St Mirren,9204,10,8,11,17,40,56,-16,35
Hibernian,9205,1,21,11,4,57,26,31,74
Dundee Utd,9205,2,18,10,8,56,38,18,64
Falkirk,9205,3,14,11,11,55,43,12,53
Morton,9205,4,13,12,11,41,39,2,51
Dumbarton,9205,5,11,11,14,49,57,-8,44
Queen of S't,9205,6,11,10,15,45,52,-7,43
Dunfermline,9205,7,9,15,12,45,47,-2,42
Raith,9205,8,10,11,15,36,47,-11,41
St Mirren,9205,9,9,10,17,42,50,-8,37
Ayr,9205,10,7,13,16,29,56,-27,34
Hibernian,9206,1,21,11,4,58,28,30,74
Falkirk,9206,2,17,9,10,55,44,11,60
Morton,9206,3,15,13,8,50,40,10,58
Dundee Utd,9206,4,15,11,10,53,40,13,56
Queen of S't,9206,5,11,9,16,45,51,-6,42
Raith,9206,6,11,9,16,37,48,-11,42
Dunfermline,9206,7,9,14,13,45,47,-2,41
Dumbarton,9206,8,10,11,15,48,57,-9,41
St Mirren,9206,9,10,9,17,41,52,-11,39
Ayr,9206,10,8,10,18,36,61,-25,34
Hibernian,9207,1,20,12,4,59,26,33,72
Morton,9207,2,17,11,8,47,34,13,62
Falkirk,9207,3,16,11,9,62,43,19,59
Dundee Utd,9207,4,16,10,10,54,37,17,58
Queen of S't,9207,5,12,11,13,50,54,-4,47
Dunfermline,9207,6,9,15,12,45,49,-4,42
Raith,9207,7,10,11,15,36,50,-14,41
Dumbarton,9207,8,9,11,16,49,61,-12,38
St Mirren,9207,9,8,10,18,38,53,-15,34
Ayr,9207,10,6,12,18,32,65,-33,30
Hibernian,9208,1,21,10,5,56,24,32,73
Morton,9208,2,18,11,7,50,33,17,65
Falkirk,9208,3,17,10,9,61,41,20,61
Dundee Utd,9208,4,15,11,10,49,40,9,56
Queen of S't,9208,5,14,8,14,50,51,-1,50
Dunfermline,9208,6,11,13,12,42,45,-3,46
Raith,9208,7,10,8,18,35,52,-17,38
St Mirren,9208,8,8,11,17,38,54,-16,35
Dumbarton,9208,9,7,11,18,43,59,-16,32
Ayr,9208,10,7,11,18,34,59,-25,32
Hibernian,9209,1,21,12,3,58,23,35,75
Morton,9209,2,16,11,9,47,37,10,59
Dundee Utd,9209,3,16,8,12,54,38,16,56
Falkirk,9209,4,15,11,10,57,45,12,56
Dunfermline,9209,5,10,15,11,47,44,3,45
Queen of S't,9209,6,12,9,15,44,50,-6,45
Dumbarton,9209,7,11,11,14,48,54,-6,44
St Mirren,9209,8,9,10,17,40,57,-17,37
Ayr,9209,9,8,11,17,32,61,-29,35
Raith,9209,10,8,10,18,33,51,-18,34
Hibernian,9210,1,21,12,3,62,26,36,75
Dundee Utd,9210,2,18,10,8,54,35,19,64
Falkirk,9210,3,16,11,9,57,38,19,59
Morton,9210,4,16,9,11,49,40,9,57
Queen of S't,9210,5,12,9,15,46,49,-3,45
Raith,9210,6,11,10,15,36,50,-14,43
Dunfermline,9210,7,9,13,14,45,50,-5,40
Dumbarton,9210,8,9,10,17,46,62,-16,37
Ayr,9210,9,8,12,16,33,56,-23,36
St Mirren,9210,10,7,10,19,39,61,-22,31
Hibernian,9211,1,21,11,4,58,24,34,74
Morton,9211,2,16,12,8,48,34,14,60
Falkirk,9211,3,15,10,11,53,39,14,55
Dundee Utd,9211,4,15,10,11,48,40,8,55
Dunfermline,9211,5,13,11,12,46,42,4,50
Queen of S't,9211,6,11,10,15,43,49,-6,43
Raith,9211,7,11,10,15,38,53,-15,43
Dumbarton,9211,8,8,13,15,48,59,-11,37
St Mirren,9211,9,8,10,18,38,58,-20,34
Ayr,9211,10,7,13,16,33,55,-22,34
Hibernian,9212,1,18,12,6,55,31,24,66
Falkirk,9212,2,16,10,10,58,41,17,58
Dundee Utd,9212,3,15,13,8,50,40,10,58
Morton,9212,4,14,12,10,46,39,7,54
Dunfermline,9212,5,12,13,11,52,46,6,49
Queen of S't,9212,6,12,9,15,45,52,-7,45
Ayr,9212,7,10,13,13,40,51,-11,43
Dumbarton,9212,8,8,13,15,48,61,-13,37
Raith,9212,9,9,10,17,33,51,-18,37
St Mirren,9212,10,8,11,17,40,55,-15,35
Hibernian,9213,1,23,10,3,68,23,45,79
Morton,9213,2,16,12,8,50,37,13,60
Falkirk,9213,3,15,11,10,56,47,9,56
Dundee Utd,9213,4,15,10,11,52,41,11,55
Dunfermline,9213,5,10,14,12,48,48,0,44
Ayr,9213,6,10,13,13,38,55,-17,43
Queen of S't,9213,7,10,11,15,45,53,-8,41
Raith,9213,8,9,10,17,33,53,-20,37
St Mirren,9213,9,9,9,18,44,60,-16,36
Dumbarton,9213,10,7,12,17,46,63,-17,33
Hibernian,9214,1,21,10,5,55,26,29,73
Morton,9214,2,17,12,7,54,36,18,63
Dundee Utd,9214,3,16,10,10,51,43,8,58
Falkirk,9214,4,15,12,9,57,41,16,57
Queen of S't,9214,5,12,10,14,46,50,-4,46
St Mirren,9214,6,9,12,15,43,53,-10,39
Raith,9214,7,10,9,17,39,53,-14,39
Dunfermline,9214,8,8,13,15,43,49,-6,37
Dumbarton,9214,9,8,12,16,47,59,-12,36
Ayr,9214,10,8,12,16,34,59,-25,36
Hibernian,9215,1,22,11,3,56,23,33,77
Falkirk,9215,2,17,9,10,60,40,20,60
Dundee Utd,9215,3,17,9,10,47,38,9,60
Morton,9215,4,16,10,10,46,36,10,58
Dunfermline,9215,5,11,13,12,47,47,0,46
Queen of S't,9215,6,11,9,16,41,49,-8,42
Raith,9215,7,11,9,16,40,50,-10,42
Dumbarton,9215,8,9,11,16,44,58,-14,38
St Mirren,9215,9,8,10,18,41,58,-17,34
Ayr,9215,10,7,11,18,32,55,-23,32
Hibernian,9216,1,18,14,4,56,28,28,68
Morton,9216,2,18,11,7,55,40,15,65
Dundee Utd,9216,3,18,9,9,54,38,16,63
Falkirk,9216,4,15,10,11,59,44,15,55
Dunfermline,9216,5,12,11,13,50,48,2,47
Queen of S't,9216,6,11,11,14,43,49,-6,44
Dumbarton,9216,7,10,11,15,47,58,-11,41
Raith,9216,8,10,10,16,35,47,-12,40
St Mirren,9216,9,7,11,18,36,55,-19,32
Ayr,9216,10,7,10,19,32,60,-28,31
Hibernian,9217,1,19,12,5,59,29,30,69
Morton,9217,2,15,13,8,50,42,8,58
Falkirk,9217,3,14,13,9,54,40,14,55
Dundee Utd,9217,4,15,10,11,51,37,14,55
Queen of S't,9217,5,13,9,14,45,46,-1,48
Dunfermline,9217,6,11,14,11,48,45,3,47
Dumbarton,9217,7,9,13,14,48,57,-9,40
Raith,9217,8,10,10,16,32,47,-15,40
St Mirren,9217,9,9,10,17,41,52,-11,37
Ayr,9217,10,7,12,17,32,65,-33,33
Hibernian,9218,1,19,11,6,59,32,27,68
Dundee Utd,9218,2,17,10,9,56,38,18,61
Falkirk,9218,3,15,12,9,60,44,16,57
Morton,9218,4,14,13,9,48,38,10,55
Dunfermline,9218,5,10,15,11,50,49,1,45
Dumbarton,9218,6,10,12,14,50,59,-9,42
Queen of S't,9218,7,10,11,15,46,58,-12,41
Ayr,9218,8,10,11,15,38,55,-17,41
Raith,9218,9,8,12,16,33,50,-17,36
St Mirren,9218,10,8,11,17,42,59,-17,35
Hibernian,9219,1,19,13,4,55,25,30,70
Morton,9219,2,19,10,7,57,36,21,67
Falkirk,9219,3,16,11,9,58,40,18,59
Dundee Utd,9219,4,16,9,11,51,40,11,57
Queen of S't,9219,5,12,10,14,45,49,-4,46
Raith,9219,6,11,10,15,36,49,-13,43
Dunfermline,9219,7,10,11,15,45,49,-4,41
Dumbarton,9219,8,9,10,17,43,55,-12,37
Ayr,9219,9,8,12,16,30,54,-24,36
St Mirren,9219,10,7,10,19,36,59,-23,31
Hibernian,9220,1,18,12,6,56,23,33,66
Dundee Utd,9220,2,16,10,10,54,40,14,58
Falkirk,9220,3,15,10,11,53,46,7,55
Morton,9220,4,14,13,9,50,43,7,55
Raith,9220,5,13,10,13,39,42,-3,49
Queen of S't,9220,6,12,10,14,46,49,-3,46
Ayr,9220,7,11,11,14,39,54,-15,44
Dumbarton,9220,8,9,12,15,50,59,-9,39
Dunfermline,9220,9,8,13,15,45,57,-12,37
St Mirren,9220,10,7,13,16,37,56,-19,34
Hibernian,9221,1,20,11,5,56,24,32,71
Morton,9221,2,17,11,8,47,34,13,62
Falkirk,9221,3,15,10,11,61,49,12,55
Dundee Utd,9221,4,15,10,11,49,39,10,55
Queen of S't,9221,5,13,8,15,45,55,-10,47
Dumbarton,9221,6,11,12,13,55,50,5,45
Raith,9221,7,11,9,16,33,45,-12,42
Dunfermline,9221,8,9,12,15,39,48,-9,39
Ayr,9221,9,9,11,16,32,55,-23,38
St Mirren,9221,10,6,14,16,38,56,-18,32
Hibernian,9222,1,20,10,6,61,27,34,70
Morton,9222,2,18,10,8,52,38,14,64
Falkirk,9222,3,15,11,10,55,40,15,56
Dundee Utd,9222,4,15,11,10,54,44,10,56
Queen of S't,9222,5,12,10,14,44,49,-5,46
Dumbarton,9222,6,10,12,14,49,57,-8,42
Dunfermline,9222,7,8,14,14,45,50,-5,38
Raith,9222,8,9,11,16,37,53,-16,38
Ayr,9222,9,8,14,14,34,56,-22,38
St Mirren,9222,10,8,11,17,41,58,-17,35
Hibernian,9223,1,20,11,5,62,25,37,71
Falkirk,9223,2,18,9,9,58,39,19,63
Morton,9223,3,15,11,10,48,41,7,56
Dundee Utd,9223,4,14,10,12,50,45,5,52
Queen of S't,9223,5,12,10,14,50,56,-6,46
Dunfermline,9223,6,11,12,13,46,48,-2,45
Dumbarton,9223,7,10,10,16,46,57,-11,40
Raith,9223,8,9,11,16,36,49,-13,38
St Mirren,9223,9,9,11,16,44,58,-14,38
Ayr,9223,10,8,13,15,32,54,-22,37
Hibernian,9224,1,19,14,3,59,27,32,71
Morton,9224,2,17,11,8,53,36,17,62
Falkirk,9224,3,17,10,9,58,39,19,61
Dundee Utd,9224,4,16,10,10,50,37,13,58
Raith,9224,5,11,10,15,38,52,-14,43
Queen of S't,9224,6,11,9,16,49,57,-8,42
Dunfermline,9224,7,8,14,14,47,55,-8,38
Ayr,9224,8,9,11,16,33,53,-20,38
St Mirren,9224,9,8,13,15,39,53,-14,37
Dumbarton,9224,10,7,12,17,42,59,-17,33
Hibernian,9225,1,17,13,6,51,28,23,64
Dundee Utd,9225,2,18,9,9,54,34,20,63
Falkirk,9225,3,17,10,9,55,36,19,61
Morton,9225,4,15,11,10,48,41,7,56
Dunfermline,9225,5,10,14,12,47,51,-4,44
Dumbarton,9225,6,10,12,14,56,57,-1,42
Queen of S't,9225,7,11,9,16,46,55,-9,42
Raith,9225,8,10,11,15,37,48,-11,41
Ayr,9225,9,9,12,15,33,56,-23,39
St Mirren,9225,10,7,11,18,38,59,-21,32
Morton,9226,1,17,13,6,49,33,16,64
Hibernian,9226,2,16,13,7,51,30,21,61
Falkirk,9226,3,17,10,9,61,43,18,61
Dundee Utd,9226,4,17,9,10,55,42,13,60
Queen of S't,9226,5,12,9,15,46,49,-3,45
Raith,9226,6,12,9,15,38,49,-11,45
Dunfermline,9226,7,10,14,12,48,46,2,44
Dumbarton,9226,8,11,11,14,55,59,-4,44
St Mirren,9226,9,8,9,19,40,60,-20,33
Ayr,9226,10,6,11,19,31,63,-32,29
Hibernian,9227,1,17,15,4,57,31,26,66
Morton,9227,2,17,11,8,54,39,15,62
Falkirk,9227,3,16,11,9,64,44,20,59
Dundee Utd,9227,4,15,9,12,49,45,4,54
Queen of S't,9227,5,11,12,13,45,50,-5,45
Dunfermline,9227,6,10,13,13,52,53,-1,43
Dumbarton,9227,7,10,11,15,50,59,-9,41
Raith,9227,8,10,11,15,39,50,-11,41
St Mirren,9227,9,9,10,17,39,54,-15,37
Ayr,9227,10,7,13,16,34,58,-24,34
Hibernian,9228,1,17,12,7,56,31,25,63
Morton,9228,2,16,13,7,50,37,13,61
Falkirk,9228,3,17,9,10,63,45,18,60
Dundee Utd,9228,4,15,12,9,49,38,11,57
Queen of S't,9228,5,12,10,14,49,54,-5,46
St Mirren,9228,6,11,10,15,45,53,-8,43
Ayr,9228,7,10,13,13,35,50,-15,43
Dunfermline,9228,8,9,14,13,50,49,1,41
Raith,9228,9,9,10,17,35,54,-19,37
Dumbarton,9228,10,7,11,18,43,64,-21,32
Hibernian,9229,1,21,12,3,62,24,38,75
Morton,9229,2,17,11,8,53,37,16,62
Falkirk,9229,3,16,10,10,61,41,20,58
Dundee Utd,9229,4,15,10,11,46,40,6,55
Queen of S't,9229,5,12,9,15,45,50,-5,45
Raith,9229,6,11,9,16,37,50,-13,42
Dunfermline,9229,7,8,14,14,42,50,-8,38
Ayr,9229,8,9,11,16,31,55,-24,38
Dumbarton,9229,9,8,13,15,43,57,-14,37
St Mirren,9229,10,8,11,17,40,56,-16,35
Hibernian,9230,1,21,10,5,61,25,36,73
Morton,9230,2,18,12,6,49,31,18,66
Dundee Utd,9230,3,17,10,9,49,37,12,61
Falkirk,9230,4,15,10,11,56,40,16,55
Queen of S't,9230,5,11,11,14,45,50,-5,44
Dumbarton,9230,6,10,11,15,52,56,-4,41
Dunfermline,9230,7,9,12,15,45,58,-13,39
St Mirren,9230,8,9,10,17,41,55,-14,37
Raith,9230,9,8,11,17,31,49,-18,35
Ayr,9230,10,7,13,16,30,58,-28,34
Hibernian,9231,1,18,11,7,57,27,30,65
Morton,9231,2,18,9,9,51,40,11,63
Falkirk,9231,3,16,12,8,60,41,19,60
Dundee Utd,9231,4,16,8,12,53,43,10,56
Queen of S't,9231,5,11,12,13,48,52,-4,45
Dunfermline,9231,6,10,13,13,46,49,-3,43
Raith,9231,7,10,11,15,36,48,-12,41
Dumbarton,9231,8,9,11,16,50,63,-13,38
St Mirren,9231,9,9,11,16,41,56,-15,38
Ayr,9231,10,8,12,16,37,60,-23,36
Hibernian,9232,1,21,12,3,62,23,39,75
Morton,9232,2,18,9,9,51,38,13,63
Falkirk,9232,3,17,11,8,61,41,20,62
Dundee Utd,9232,4,14,9,13,44,39,5,51
Dumbarton,9232,5,11,12,13,49,53,-4,45
Dunfermline,9232,6,9,13,14,44,50,-6,40
Queen of S't,9232,7,10,10,16,44,55,-11,40
Raith,9232,8,10,9,17,37,54,-17,39
St Mirren,9232,9,9,9,18,42,58,-16,36
Ayr,9232,10,8,12,16,31,54,-23,36
Morton,9233,1,19,10,7,49,31,18,67
Hibernian,9233,2,18,12,6,53,27,26,66
Falkirk,9233,3,13,12,11,55,45,10,51
Dundee Utd,9233,4,13,12,11,48,45,3,51
Queen of S't,9233,5,11,12,13,52,52,0,45
Dunfermline,9233,6,9,15,12,47,50,-3,42
Ayr,9233,7,10,12,14,38,51,-13,42
Raith,9233,8,10,10,16,39,50,-11,40
St Mirren,9233,9,10,10,16,41,54,-13,40
Dumbarton,9233,10,9,11,16,49,66,-17,38
Hibernian,9234,1,18,13,5,49,23,26,67
Dundee Utd,9234,2,18,8,10,56,42,14,62
Falkirk,9234,3,15,12,9,58,41,17,57
Morton,9234,4,15,9,12,47,40,7,54
Dunfermline,9234,5,13,11,12,50,52,-2,50
Queen of S't,9234,6,11,11,14,46,46,0,44
Raith,9234,7,10,10,16,34,49,-15,40
Ayr,9234,8,9,12,15,35,53,-18,39
St Mirren,9234,9,9,10,17,40,55,-15,37
Dumbarton,9234,10,8,12,16,46,60,-14,36
Hibernian,9235,1,21,10,5,53,24,29,73
Morton,9235,2,17,12,7,53,37,16,63
Falkirk,9235,3,14,12,10,53,40,13,54
Dundee Utd,9235,4,15,9,12,49,44,5,54
Queen of S't,9235,5,12,9,15,43,52,-9,45
St Mirren,9235,6,11,9,16,51,52,-1,42
Dunfermline,9235,7,10,12,14,47,49,-2,42
Ayr,9235,8,10,11,15,40,53,-13,41
Dumbarton,9235,9,9,13,14,49,62,-13,40
Raith,9235,10,8,9,19,31,56,-25,33
Hibernian,9236,1,17,14,5,53,26,27,65
Morton,9236,2,16,13,7,51,36,15,61
Dundee Utd,9236,3,17,9,10,52,37,15,60
Falkirk,9236,4,15,12,9,56,40,16,57
Dumbarton,9236,5,11,10,15,47,54,-7,43
Queen of S't,9236,6,10,11,15,42,50,-8,41
Ayr,9236,7,10,10,16,34,57,-23,40
Dunfermline,9236,8,8,15,13,42,47,-5,39
St Mirren,9236,9,9,11,16,41,56,-15,38
Raith,9236,10,8,13,15,35,50,-15,37
Hibernian,9237,1,20,11,5,55,22,33,71
Morton,9237,2,17,12,7,49,38,11,63
Falkirk,9237,3,16,12,8,59,40,19,60
Dundee Utd,9237,4,16,11,9,49,37,12,59
Queen of S't,9237,5,13,10,13,51,51,0,49
Dunfermline,9237,6,12,12,12,53,46,7,48
Raith,9237,7,10,9,17,34,50,-16,39
Dumbarton,9237,8,7,12,17,42,63,-21,33
Ayr,9237,9,7,11,18,33,59,-26,32
St Mirren,9237,10,7,10,19,38,57,-19,31
Hibernian,9238,1,18,12,6,53,25,28,66
Falkirk,9238,2,16,11,9,59,41,18,59
Morton,9238,3,16,11,9,47,38,9,59
Dundee Utd,9238,4,16,10,10,47,37,10,58
Dunfermline,9238,5,12,13,11,50,43,7,49
St Mirren,9238,6,11,10,15,45,54,-9,43
Queen of S't,9238,7,11,10,15,42,52,-10,43
Ayr,9238,8,9,12,15,35,52,-17,39
Raith,9238,9,9,9,18,33,52,-19,36
Dumbarton,9238,10,7,12,17,42,59,-17,33
Hibernian,9239,1,21,12,3,59,23,36,75
Dundee Utd,9239,2,18,9,9,53,40,13,63
Morton,9239,3,17,11,8,51,36,15,62
Falkirk,9239,4,15,12,9,56,43,13,57
Queen of S't,9239,5,12,8,16,41,46,-5,44
Dunfermline,9239,6,10,11,15,49,47,2,41
Raith,9239,7,10,9,17,36,56,-20,39
Dumbarton,9239,8,9,11,16,46,63,-17,38
Ayr,9239,9,9,10,17,36,57,-21,37
St Mirren,9239,10,7,11,18,41,57,-16,32
Hibernian,9240,1,20,11,5,55,24,31,71
Morton,9240,2,16,13,7,48,36,12,61
Dundee Utd,9240,3,15,10,11,52,43,9,55
Falkirk,9240,4,15,9,12,56,48,8,54
Dunfermline,9240,5,11,14,11,50,48,2,47
Queen of S't,9240,6,13,8,15,50,52,-2,47
Raith,9240,7,10,11,15,35,47,-12,41
Dumbarton,9240,8,9,12,15,50,57,-7,39
St Mirren,9240,9,8,11,17,39,56,-17,35
Ayr,9240,10,7,13,16,34,58,-24,34
Hibernian,9241,1,18,11,7,54,27,27,65
Morton,9241,2,17,11,8,53,35,18,62
Falkirk,9241,3,16,11,9,54,39,15,59
Dundee Utd,9241,4,16,10,10,49,38,11,58
Queen of S't,9241,5,13,9,14,51,47,4,48
Raith,9241,6,12,11,13,39,45,-6,47
Ayr,9241,7,9,12,15,33,54,-21,39
Dunfermline,9241,8,8,13,15,42,52,-10,37
St Mirren,9241,9,8,11,17,40,57,-17,35
Dumbarton,9241,10,7,13,16,47,68,-21,34
Hibernian,9242,1,19,12,5,56,26,30,69
Morton,9242,2,19,9,8,52,33,19,66
Falkirk,9242,3,17,10,9,59,42,17,61
Dundee Utd,9242,4,15,9,12,45,38,7,54
Queen of S't,9242,5,13,8,15,48,51,-3,47
Dunfermline,9242,6,11,12,13,46,49,-3,45
Raith,9242,7,12,8,16,40,46,-6,44
Ayr,9242,8,10,10,16,34,55,-21,40
Dumbarton,9242,9,7,11,18,42,58,-16,32
St Mirren,9242,10,7,11,18,36,60,-24,32
Hibernian,9243,1,21,10,5,63,30,33,73
Morton,9243,2,17,11,8,47,34,13,62
Dundee Utd,9243,3,15,11,10,46,38,8,56
Falkirk,9243,4,15,9,12,59,47,12,54
Dunfermline,9243,5,11,13,12,49,50,-1,46
Raith,9243,6,11,10,15,36,47,-11,43
Dumbarton,9243,7,9,13,14,49,58,-9,40
Ayr,9243,8,9,12,15,37,53,-16,39
Queen of S't,9243,9,9,10,17,43,54,-11,37
St Mirren,9243,10,8,11,17,40,58,-18,35
Hibernian,9244,1,18,14,4,50,24,26,68
Morton,9244,2,17,13,6,50,30,20,64
Dundee Utd,9244,3,16,12,8,51,34,17,60
Falkirk,9244,4,15,14,7,55,36,19,59
Dumbarton,9244,5,10,13,13,45,49,-4,43
Queen of S't,9244,6,11,9,16,43,54,-11,42
Raith,9244,7,10,10,16,34,51,-17,40
St Mirren,9244,8,8,11,17,40,53,-13,35
Dunfermline,9244,9,7,13,16,40,54,-14,34
Ayr,9244,10,7,13,16,32,55,-23,34
Hibernian,9245,1,19,13,4,54,23,31,70
Falkirk,9245,2,17,11,8,65,42,23,62
Dundee Utd,9245,3,16,12,8,56,41,15,60
Morton,9245,4,15,12,9,50,39,11,57
Raith,9245,5,11,10,15,34,46,-12,43
Ayr,9245,6,10,12,14,38,52,-14,42
Dunfermline,9245,7,9,13,14,40,47,-7,40
Dumbarton,9245,8,9,11,16,50,63,-13,38
Queen of S't,9245,9,9,10,17,42,57,-15,37
St Mirren,9245,10,7,12,17,40,59,-19,33
Hibernian,9246,1,19,12,5,60,25,35,69
Falkirk,9246,2,17,11,8,58,36,22,62
Morton,9246,3,17,10,9,50,40,10,61
Dundee Utd,9246,4,17,8,11,54,39,15,59
Raith,9246,5,11,10,15,38,50,-12,43
Queen of S't,9246,6,11,9,16,45,57,-12,42
Dunfermline,9246,7,9,14,13,47,48,-1,41
Dumbarton,9246,8,9,11,16,47,60,-13,38
Ayr,9246,9,9,11,16,34,61,-27,38
St Mirren,9246,10,7,12,17,39,56,-17,33
Hibernian,9247,1,18,13,5,56,27,29,67
Morton,9247,2,16,12,8,49,37,12,60
Dundee Utd,9247,3,16,11,9,57,39,18,59
Falkirk,9247,4,15,10,11,57,45,12,55
Dumbarton,9247,5,11,11,14,51,55,-4,44
Raith,9247,6,11,11,14,39,52,-13,44
Queen of S't,9247,7,11,10,15,47,54,-7,43
Ayr,9247,8,9,12,15,34,55,-21,39
Dunfermline,9247,9,8,12,16,44,54,-10,36
St Mirren,9247,10,8,12,16,42,58,-16,36
Morton,9248,1,19,11,6,57,36,21,68
Hibernian,9248,2,18,11,7,55,30,25,65
Dundee Utd,9248,3,17,10,9,55,39,16,61
Falkirk,9248,4,15,12,9,55,39,16,57
Raith,9248,5,11,9,16,32,46,-14,42
Queen of S't,9248,6,10,10,16,41,49,-8,40
Dunfermline,9248,7,8,15,13,45,54,-9,39
Ayr,9248,8,9,12,15,38,57,-19,39
Dumbarton,9248,9,8,13,15,42,53,-11,37
St Mirren,9248,10,9,9,18,39,56,-17,36
Hibernian,9249,1,18,12,6,56,29,27,66
Morton,9249,2,18,11,7,54,37,17,65
Dundee Utd,9249,3,18,8,10,53,40,13,62
Falkirk,9249,4,16,10,10,59,45,14,58
Dunfermline,9249,5,11,12,13,49,50,-1,45
Queen of S't,9249,6,12,9,15,47,51,-4,45
Dumbarton,9249,7,10,10,16,48,56,-8,40
Raith,9249,8,10,9,17,35,49,-14,39
Ayr,9249,9,9,10,17,32,55,-23,37
St Mirren,9249,10,7,11,18,41,62,-21,32
Hibernian,9250,1,22,10,4,58,25,33,76
Dundee Utd,9250,2,15,13,8,49,39,10,58
Morton,9250,3,15,11,10,55,44,11,56
Falkirk,9250,4,14,11,11,54,40,14,53
Dunfermline,9250,5,10,14,12,47,48,-1,44
Dumbarton,9250,6,10,12,14,49,60,-11,42
St Mirren,9250,7,10,11,15,42,53,-11,41
Raith,9250,8,11,8,17,37,50,-13,41
Queen of S't,9250,9,9,10,17,42,53,-11,37
Ayr,9250,10,8,12,16,32,53,-21,36
Hibernian,9251,1,20,11,5,58,25,33,71
Morton,9251,2,18,10,8,54,36,18,64
Falkirk,9251,3,16,11,9,57,39,18,59
Dundee Utd,9251,4,14,10,12,48,42,6,52
Queen of S't,9251,5,13,9,14,47,49,-2,48
Dunfermline,9251,6,10,14,12,44,46,-2,44
Raith,9251,7,11,11,14,39,50,-11,44
Dumbarton,9251,8,9,11,16,49,62,-13,38
St Mirren,9251,9,8,10,18,41,60,-19,34
Ayr,9251,10,7,11,18,35,63,-28,32
Hibernian,9252,1,19,11,6,54,26,28,68
Morton,9252,2,16,11,9,48,41,7,59
Falkirk,9252,3,15,11,10,59,47,12,56
Dundee Utd,9252,4,15,10,11,52,41,11,55
Raith,9252,5,13,9,14,45,45,0,48
Queen of S't,9252,6,12,8,16,42,53,-11,44
Ayr,9252,7,11,10,15,42,57,-15,43
St Mirren,9252,8,10,11,15,47,57,-10,41
Dunfermline,9252,9,8,14,14,42,51,-9,38
Dumbarton,9252,10,8,11,17,47,60,-13,35
Hibernian,9253,1,19,12,5,54,26,28,69
Dundee Utd,9253,2,20,8,8,56,35,21,68
Morton,9253,3,17,12,7,51,36,15,63
Falkirk,9253,4,16,11,9,61,41,20,59
Queen of S't,9253,5,12,8,16,42,52,-10,44
Dunfermline,9253,6,9,13,14,44,49,-5,40
Raith,9253,7,9,12,15,35,49,-14,39
Ayr,9253,8,8,12,16,34,54,-20,36
St Mirren,9253,9,8,10,18,38,55,-17,34
Dumbarton,9253,10,8,10,18,45,63,-18,34
Hibernian,9254,1,19,13,4,58,26,32,70
Morton,9254,2,16,12,8,48,37,11,60
Dundee Utd,9254,3,16,10,10,53,42,11,58
Falkirk,9254,4,14,13,9,58,43,15,55
Dunfermline,9254,5,10,14,12,46,48,-2,44
Queen of S't,9254,6,11,11,14,42,47,-5,44
Raith,9254,7,9,13,14,31,44,-13,40
Ayr,9254,8,9,11,16,34,54,-20,38
St Mirren,9254,9,8,12,16,37,51,-14,36
Dumbarton,9254,10,7,13,16,45,60,-15,34
Hibernian,9255,1,20,11,5,54,25,29,71
Dundee Utd,9255,2,19,8,9,56,36,20,65
Morton,9255,3,17,10,9,49,35,14,61
Falkirk,9255,4,16,11,9,60,43,17,59
St Mirren,9255,5,11,10,15,45,55,-10,43
Queen of S't,9255,6,10,12,14,44,51,-7,42
Raith,9255,7,10,9,17,36,55,-19,39
Dunfermline,9255,8,8,13,15,43,51,-8,37
Dumbarton,9255,9,8,11,17,45,59,-14,35
Ayr,9255,10,8,11,17,37,59,-22,35
Hibernian,9256,1,20,11,5,53,24,29,71
Falkirk,9256,2,17,9,10,59,37,22,60
Morton,9256,3,17,9,10,52,39,13,60
Dundee Utd,9256,4,16,10,10,50,40,10,58
Dunfermline,9256,5,11,11,14,43,47,-4,44
Queen of S't,9256,6,11,10,15,47,53,-6,43
Dumbarton,9256,7,10,11,15,50,57,-7,41
Raith,9256,8,10,9,17,35,53,-18,39
St Mirren,9256,9,9,11,16,46,56,-10,38
Ayr,9256,10,8,11,17,34,63,-29,35
Hibernian,9257,1,17,13,6,51,27,24,64
Dundee Utd,9257,2,17,11,8,53,40,13,62
Falkirk,9257,3,17,10,9,62,42,20,61
Morton,9257,4,17,10,9,50,37,13,61
Dunfermline,9257,5,11,12,13,48,48,0,45
Raith,9257,6,11,10,15,36,49,-13,43
Dumbarton,9257,7,10,10,16,55,62,-7,40
Queen of S't,9257,8,10,8,18,43,55,-12,38
St Mirren,9257,9,8,12,16,39,55,-16,36
Ayr,9257,10,8,12,16,38,60,-22,36
Hibernian,9258,1,17,12,7,52,31,21,63
Falkirk,9258,2,17,11,8,65,41,24,62
Morton,9258,3,17,11,8,55,42,13,62
Dundee Utd,9258,4,15,11,10,55,46,9,56
Dunfermline,9258,5,12,12,12,48,44,4,48
Queen of S't,9258,6,11,11,14,44,51,-7,44
Raith,9258,7,12,8,16,38,51,-13,44
Ayr,9258,8,9,10,17,37,60,-23,37
St Mirren,9258,9,9,9,18,43,56,-13,36
Dumbarton,9258,10,8,11,17,45,60,-15,35
Hibernian,9259,1,21,10,5,62,29,33,73
Morton,9259,2,17,11,8,56,44,12,62
Falkirk,9259,3,15,11,10,56,41,15,56
Dundee Utd,9259,4,14,10,12,52,44,8,52
Queen of S't,9259,5,13,9,14,47,49,-2,48
Dumbarton,9259,6,11,10,15,50,58,-8,43
Dunfermline,9259,7,9,14,13,49,51,-2,41
Raith,9259,8,10,11,15,42,55,-13,41
Ayr,9259,9,8,13,15,37,56,-19,37
St Mirren,9259,10,8,9,19,41,65,-24,33
Hibernian,9260,1,20,11,5,57,24,33,71
Morton,9260,2,17,10,9,47,38,9,61
Falkirk,9260,3,15,11,10,51,37,14,56
Dundee Utd,9260,4,15,10,11,47,40,7,55
Dunfermline,9260,5,10,14,12,45,44,1,44
Dumbarton,9260,6,11,11,14,49,55,-6,44
St Mirren,9260,7,10,11,15,41,53,-12,41
Queen of S't,9260,8,10,9,17,42,53,-11,39
Ayr,9260,9,9,12,15,35,52,-17,39
Raith,9260,10,9,9,18,37,55,-18,36
Hibernian,9261,1,20,12,4,59,25,34,72
Morton,9261,2,16,13,7,51,38,13,61
Falkirk,9261,3,15,12,9,58,42,16,57
Dundee Utd,9261,4,15,12,9,48,37,11,57
Dunfermline,9261,5,12,13,11,50,45,5,49
Queen of S't,9261,6,11,9,16,49,56,-7,42
St Mirren,9261,7,9,10,17,44,61,-17,37
Dumbarton,9261,8,8,12,16,46,61,-15,36
Raith,9261,9,8,12,16,31,48,-17,36
Ayr,9261,10,7,13,16,33,56,-23,34
Hibernian,9262,1,18,12,6,53,28,25,66
Morton,9262,2,17,11,8,50,33,17,62
Falkirk,9262,3,15,13,8,57,37,20,58
Dundee Utd,9262,4,16,10,10,45,34,11,58
Dunfermline,9262,5,12,13,11,48,46,2,49
Queen of S't,9262,6,11,10,15,44,49,-5,43
St Mirren,9262,7,10,10,16,41,53,-12,40
Raith,9262,8,9,12,15,34,49,-15,39
Dumbarton,9262,9,8,11,17,44,62,-18,35
Ayr,9262,10,8,10,18,33,58,-25,34
Morton,9263,1,19,11,6,54,37,17,68
Hibernian,9263,2,17,14,5,52,27,25,65
Dundee Utd,9263,3,16,10,10,49,39,10,58
Falkirk,9263,4,14,10,12,52,41,11,52
Queen of S't,9263,5,11,10,15,44,52,-8,43
Dunfermline,9263,6,8,17,11,46,49,-3,41
St Mirren,9263,7,10,11,15,47,52,-5,41
Dumbarton,9263,8,9,12,15,47,57,-10,39
Raith,9263,9,10,9,17,36,49,-13,39
Ayr,9263,10,8,12,16,35,59,-24,36
Hibernian,9264,1,21,10,5,67,26,41,73
Morton,9264,2,18,13,5,53,34,19,67
Falkirk,9264,3,16,11,9,59,42,17,59
Dundee Utd,9264,4,13,13,10,43,42,1,52
Queen of S't,9264,5,14,9,13,44,47,-3,51
Raith,9264,6,10,9,17,34,49,-15,39
Dunfermline,9264,7,8,13,15,47,51,-4,37
Dumbarton,9264,8,8,12,16,45,61,-16,36
Ayr,9264,9,8,11,17,38,57,-19,35
St Mirren,9264,10,8,11,17,40,61,-21,35
Hibernian,9265,1,20,12,4,59,26,33,72
Falkirk,9265,2,18,9,9,63,41,22,63
Dundee Utd,9265,3,17,9,10,52,41,11,60
Morton,9265,4,15,10,11,49,46,3,55
Dunfermline,9265,5,12,12,12,47,43,4,48
Queen of S't,9265,6,11,9,16,42,51,-9,42
Raith,9265,7,10,10,16,39,50,-11,40
Ayr,9265,8,9,13,14,35,51,-16,40
Dumbarton,9265,9,8,10,18,48,66,-18,34
St Mirren,9265,10,8,10,18,41,60,-19,34
Hibernian,9266,1,19,11,6,54,26,28,68
Morton,9266,2,17,12,7,54,35,19,63
Dundee Utd,9266,3,17,8,11,51,41,10,59
Falkirk,9266,4,16,9,11,60,44,16,57
Queen of S't,9266,5,13,9,14,48,49,-1,48
Dumbarton,9266,6,11,10,15,50,58,-8,43
Dunfermline,9266,7,10,12,14,49,52,-3,42
Ayr,9266,8,10,11,15,38,58,-20,41
Raith,9266,9,9,9,18,32,52,-20,36
St Mirren,9266,10,8,9,19,38,59,-21,33
Hibernian,9267,1,18,15,3,59,23,36,69
Morton,9267,2,17,11,8,54,37,17,62
Dundee Utd,9267,3,17,9,10,52,41,11,60
Falkirk,9267,4,14,11,11,57,48,9,53
Queen of S't,9267,5,13,8,15,50,52,-2,47
Dunfermline,9267,6,10,12,14,45,51,-6,42
Dumbarton,9267,7,10,12,14,50,57,-7,42
Raith,9267,8,10,10,16,32,49,-17,40
Ayr,9267,9,10,10,16,37,56,-19,40
St Mirren,9267,10,6,12,18,36,58,-22,30
Hibernian,9268,1,20,12,4,55,26,29,72
Morton,9268,2,16,11,9,52,38,14,59
Dundee Utd,9268,3,16,10,10,51,37,14,58
Falkirk,9268,4,16,9,11,57,42,15,57
Queen of S't,9268,5,13,9,14,48,46,2,48
Dunfermline,9268,6,11,14,11,51,48,3,47
St Mirren,9268,7,10,9,17,41,55,-14,39
Dumbarton,9268,8,9,11,16,47,63,-16,38
Raith,9268,9,9,9,18,33,52,-19,36
Ayr,9268,10,8,10,18,31,59,-28,34
Hibernian,9269,1,18,12,6,55,31,24,66
Morton,9269,2,17,11,8,51,35,16,62
Dundee Utd,9269,3,17,10,9,54,39,15,61
Falkirk,9269,4,15,12,9,56,40,16,57
Queen of S't,9269,5,11,10,15,49,49,0,43
Raith,9269,6,11,10,15,33,43,-10,43
Dumbarton,9269,7,10,11,15,48,58,-10,41
St Mirren,9269,8,10,9,17,43,54,-11,39
Dunfermline,9269,9,8,13,15,40,54,-14,37
Ayr,9269,10,8,12,16,33,59,-26,36
Hibernian,9270,1,17,14,5,51,29,22,65
Dundee Utd,9270,2,17,10,9,53,35,18,61
Morton,9270,3,15,12,9,50,40,10,57
Falkirk,9270,4,15,11,10,57,46,11,56
Queen of S't,9270,5,11,12,13,49,50,-1,45
Dumbarton,9270,6,11,11,14,49,55,-6,44
Raith,9270,7,11,10,15,36,46,-10,43
Dunfermline,9270,8,8,15,13,46,50,-4,39
Ayr,9270,9,9,11,16,32,54,-22,38
St Mirren,9270,10,7,12,17,35,53,-18,33
Hibernian,9271,1,20,13,3,59,22,37,73
Morton,9271,2,15,14,7,51,36,15,59
Falkirk,9271,3,15,12,9,55,41,14,57
Dundee Utd,9271,4,15,10,11,49,41,8,55
Queen of S't,9271,5,12,11,13,48,49,-1,47
Dunfermline,9271,6,9,14,13,44,49,-5,41
Dumbarton,9271,7,9,12,15,51,60,-9,39
Raith,9271,8,9,11,16,35,53,-18,38
Ayr,9271,9,9,10,17,36,59,-23,37
St Mirren,9271,10,8,11,17,38,56,-18,35
Hibernian,9272,1,18,13,5,56,28,28,67
Morton,9272,2,16,13,7,52,37,15,61
Falkirk,9272,3,15,11,10,57,40,17,56
Dundee Utd,9272,4,15,11,10,52,41,11,56
Queen of S't,9272,5,11,11,14,42,51,-9,44
Ayr,9272,6,11,11,14,34,50,-16,44
Dunfermline,9272,7,10,13,13,49,52,-3,43
Dumbarton,9272,8,9,13,14,48,57,-9,40
Raith,9272,9,10,10,16,36,48,-12,40
St Mirren,9272,10,7,10,19,36,58,-22,31
Morton,9273,1,19,11,6,56,36,20,68
Hibernian,9273,2,18,13,5,56,26,30,67
Falkirk,9273,3,17,10,9,56,40,16,61
Dundee Utd,9273,4,16,9,11,51,41,10,57
Raith,9273,5,12,11,13,40,47,-7,47
Queen of S't,9273,6,12,8,16,45,49,-4,44
Dunfermline,9273,7,10,13,13,48,52,-4,43
Ayr,9273,8,8,12,16,37,57,-20,36
Dumbarton,9273,9,7,11,18,43,63,-20,32
St Mirren,9273,10,6,12,18,37,58,-21,30
Hibernian,9274,1,18,11,7,54,29,25,65
Dundee Utd,9274,2,18,10,8,53,36,17,64
Morton,9274,3,17,11,8,49,40,9,62
Falkirk,9274,4,15,10,11,55,44,11,55
Dunfermline,9274,5,11,13,12,49,49,0,46
Queen of S't,9274,6,10,10,16,44,51,-7,40
Ayr,9274,7,8,15,13,34,49,-15,39
Raith,9274,8,10,9,17,34,51,-17,39
Dumbarton,9274,9,9,11,16,46,56,-10,38
St Mirren,9274,10,9,10,17,43,56,-13,37
Hibernian,9275,1,18,13,5,56,28,28,67
Morton,9275,2,17,13,6,52,34,18,64
Falkirk,9275,3,17,10,9,58,39,19,61
Dundee Utd,9275,4,15,9,12,47,39,8,54
Queen of S't,9275,5,12,10,14,44,48,-4,46
Raith,9275,6,11,9,16,34,48,-14,42
St Mirren,9275,7,10,10,16,37,50,-13,40
Dumbarton,9275,8,9,12,15,48,54,-6,39
Dunfermline,9275,9,9,12,15,42,53,-11,39
Ayr,9275,10,7,12,17,30,55,-25,33
Hibernian,9276,1,18,14,4,52,23,29,68
Morton,9276,2,17,12,7,50,36,14,63
Falkirk,9276,3,15,12,9,58,40,18,57
Dundee Utd,9276,4,13,11,12,48,49,-1,50
Queen of S't,9276,5,13,9,14,48,48,0,48
Raith,9276,6,11,9,16,35,50,-15,42
St Mirren,9276,7,10,11,15,45,57,-12,41
Ayr,9276,8,10,11,15,38,53,-15,41
Dumbarton,9276,9,8,13,15,48,59,-11,37
Dunfermline,9276,10,7,14,15,40,47,-7,35
Hibernian,9277,1,21,10,5,59,25,34,73
Falkirk,9277,2,20,9,7,65,36,29,69
Morton,9277,3,17,11,8,49,37,12,62
Dundee Utd,9277,4,15,11,10,45,38,7,56
Dunfermline,9277,5,9,14,13,48,53,-5,41
Queen of S't,9277,6,10,11,15,45,53,-8,41
Ayr,9277,7,10,10,16,39,57,-18,40
Dumbarton,9277,8,9,12,15,50,58,-8,39
Raith,9277,9,8,10,18,36,58,-22,34
St Mirren,9277,10,6,12,18,41,62,-21,30
Hibernian,9278,1,20,11,5,64,30,34,71
Morton,9278,2,17,12,7,53,38,15,63
Falkirk,9278,3,16,11,9,58,40,18,59
Dundee Utd,9278,4,16,11,9,52,38,14,59
Raith,9278,5,11,10,15,40,50,-10,43
Queen of S't,9278,6,10,10,16,46,57,-11,40
Dunfermline,9278,7,8,15,13,48,52,-4,39
Dumbarton,9278,8,8,13,15,48,61,-13,37
St Mirren,9278,9,8,11,17,44,63,-19,35
Ayr,9278,10,7,14,15,33,57,-24,35
Hibernian,9279,1,21,12,3,54,21,33,75
Morton,9279,2,19,10,7,52,33,19,67
Dundee Utd,9279,3,15,10,11,47,41,6,55
Falkirk,9279,4,14,12,10,54,40,14,54
Dunfermline,9279,5,9,13,14,45,48,-3,40
Queen of S't,9279,6,10,10,16,44,50,-6,40
St Mirren,9279,7,10,10,16,39,52,-13,40
Raith,9279,8,10,10,16,33,48,-15,40
Dumbarton,9279,9,9,11,16,46,61,-15,38
Ayr,9279,10,9,10,17,33,53,-20,37
Hibernian,9280,1,20,12,4,60,27,33,72
Dundee Utd,9280,2,18,8,10,50,38,12,62
Morton,9280,3,16,11,9,49,38,11,59
Falkirk,9280,4,15,11,10,56,41,15,56
Queen of S't,9280,5,14,8,14,50,48,2,50
Dumbarton,9280,6,11,10,15,50,60,-10,43
Dunfermline,9280,7,9,13,14,44,47,-3,40
Raith,9280,8,10,8,18,33,50,-17,38
St Mirren,9280,9,9,10,17,44,57,-13,37
Ayr,9280,10,7,11,18,31,61,-30,32
Hibernian,9281,1,19,13,4,55,24,31,70
Dundee Utd,9281,2,19,9,8,52,33,19,66
Morton,9281,3,16,11,9,45,37,8,59
Falkirk,9281,4,16,10,10,58,42,16,58
Queen of S't,9281,5,12,10,14,43,44,-1,46
Raith,9281,6,10,11,15,35,48,-13,41
Dunfermline,9281,7,9,13,14,42,49,-7,40
Ayr,9281,8,8,12,16,31,51,-20,36
Dumbarton,9281,9,8,11,17,45,61,-16,35
St Mirren,9281,10,7,12,17,40,57,-17,33
Hibernian,9282,1,19,13,4,59,27,32,70
Dundee Utd,9282,2,16,11,9,52,40,12,59
Morton,9282,3,15,13,8,48,36,12,58
Falkirk,9282,4,15,12,9,58,41,17,57
Queen of S't,9282,5,11,11,14,50,55,-5,44
Dunfermline,9282,6,9,14,13,48,48,0,41
Dumbarton,9282,7,9,12,15,49,59,-10,39
Raith,9282,8,10,9,17,34,54,-20,39
Ayr,9282,9,9,12,15,34,57,-23,39
St Mirren,9282,10,8,11,17,43,58,-15,35
Hibernian,9283,1,21,11,4,56,23,33,74
Morton,9283,2,17,11,8,54,39,15,62
Dundee Utd,9283,3,16,11,9,49,34,15,59
Falkirk,9283,4,15,13,8,57,40,17,58
Queen of S't,9283,5,12,10,14,46,49,-3,46
Raith,9283,6,11,9,16,35,51,-16,42
Dunfermline,9283,7,8,14,14,44,52,-8,38
Dumbarton,9283,8,9,11,16,47,61,-14,38
St Mirren,9283,9,8,11,17,41,56,-15,35
Ayr,9283,10,7,11,18,35,59,-24,32
Hibernian,9284,1,20,13,3,54,22,32,73
Dundee Utd,9284,2,16,10,10,53,39,14,58
Morton,9284,3,15,12,9,48,38,10,57
Falkirk,9284,4,14,13,9,58,45,13,55
Queen of S't,9284,5,13,10,13,47,45,2,49
Dunfermline,9284,6,10,12,14,47,48,-1,42
Raith,9284,7,9,12,15,37,55,-18,39
Dumbarton,9284,8,9,11,16,50,61,-11,38
St Mirren,9284,9,9,10,17,41,59,-18,37
Ayr,9284,10,8,11,17,34,57,-23,35
Hibernian,9285,1,19,10,7,57,30,27,67
Morton,9285,2,17,10,9,48,35,13,61
Falkirk,9285,3,17,9,10,61,40,21,60
Dundee Utd,9285,4,16,9,11,47,38,9,57
Dunfermline,9285,5,12,11,13,45,44,1,47
Queen of S't,9285,6,12,8,16,44,52,-8,44
Ayr,9285,7,10,12,14,39,55,-16,42
Dumbarton,9285,8,10,11,15,48,55,-7,41
Raith,9285,9,11,8,17,33,49,-16,41
St Mirren,9285,10,7,10,19,33,57,-24,31
Hibernian,9286,1,18,12,6,53,27,26,66
Morton,9286,2,17,11,8,49,36,13,62
Dundee Utd,9286,3,16,10,10,50,38,12,58
Falkirk,9286,4,14,13,9,54,42,12,55
Dumbarton,9286,5,10,13,13,45,50,-5,43
Dunfermline,9286,6,9,13,14,45,49,-4,40
Queen of S't,9286,7,10,10,16,41,54,-13,40
St Mirren,9286,8,10,10,16,42,56,-14,40
Ayr,9286,9,9,13,14,36,50,-14,40
Raith,9286,10,9,11,16,36,49,-13,38
Hibernian,9287,1,19,12,5,58,28,30,69
Morton,9287,2,17,10,9,53,41,12,61
Falkirk,9287,3,16,11,9,60,38,22,59
Dundee Utd,9287,4,15,11,10,49,39,10,56
Queen of S't,9287,5,12,9,15,44,51,-7,45
Dumbarton,9287,6,11,11,14,50,54,-4,44
Raith,9287,7,12,8,16,36,49,-13,44
Dunfermline,9287,8,9,13,14,49,55,-6,40
Ayr,9287,9,8,13,15,32,52,-20,37
St Mirren,9287,10,7,10,19,41,65,-24,31
Hibernian,9288,1,17,13,6,52,28,24,64
Falkirk,9288,2,16,11,9,55,40,15,59
Morton,9288,3,16,11,9,49,38,11,59
Dundee Utd,9288,4,16,8,12,48,42,6,56
Queen of S't,9288,5,11,11,14,45,48,-3,44
Dunfermline,9288,6,10,13,13,45,48,-3,43
Raith,9288,7,11,10,15,33,45,-12,43
Dumbarton,9288,8,10,11,15,49,56,-7,41
Ayr,9288,9,9,12,15,37,52,-15,39
St Mirren,9288,10,8,12,16,37,53,-16,36
Hibernian,9289,1,20,12,4,56,23,33,72
Morton,9289,2,16,12,8,47,36,11,60
Falkirk,9289,3,16,10,10,64,46,18,58
Dundee Utd,9289,4,14,10,12,45,42,3,52
Queen of S't,9289,5,13,10,13,53,52,1,49
Ayr,9289,6,11,13,12,39,50,-11,46
Dunfermline,9289,7,9,12,15,45,48,-3,39
Dumbarton,9289,8,9,11,16,46,62,-16,38
Raith,9289,9,9,10,17,38,55,-17,37
St Mirren,9289,10,7,12,17,34,53,-19,33
Falkirk,9290,1,19,10,7,63,35,28,67
Hibernian,9290,2,18,13,5,56,29,27,67
Morton,9290,3,17,11,8,51,36,15,62
Dundee Utd,9290,4,15,10,11,53,42,11,55
Queen of S't,9290,5,12,9,15,47,54,-7,45
Dunfermline,9290,6,10,13,13,50,52,-2,43
Raith,9290,7,10,9,17,36,52,-16,39
Dumbarton,9290,8,8,12,16,43,61,-18,36
Ayr,9290,9,8,12,16,35,55,-20,36
St Mirren,9290,10,8,11,17,41,59,-18,35
Hibernian,9291,1,18,14,4,62,27,35,68
Morton,9291,2,17,13,6,50,35,15,64
Falkirk,9291,3,16,13,7,60,37,23,61
Dundee Utd,9291,4,13,11,12,44,38,6,50
Dunfermline,9291,5,9,16,11,44,47,-3,43
Queen of S't,9291,6,11,10,15,40,51,-11,43
Raith,9291,7,11,9,16,35,47,-12,42
Ayr,9291,8,9,13,14,33,50,-17,40
Dumbarton,9291,9,9,12,15,48,56,-8,39
St Mirren,9291,10,7,9,20,35,63,-28,30
Hibernian,9292,1,20,12,4,58,26,32,72
Falkirk,9292,2,19,9,8,60,38,22,66
Morton,9292,3,16,13,7,46,34,12,61
Dundee Utd,9292,4,14,11,11,49,43,6,53
Dunfermline,9292,5,9,16,11,43,43,0,43
Raith,9292,6,11,9,16,35,49,-14,42
Dumbarton,9292,7,9,13,14,49,57,-8,40
Queen of S't,9292,8,10,10,16,42,51,-9,40
Ayr,9292,9,8,12,16,37,59,-22,36
St Mirren,9292,10,7,9,20,43,62,-19,30
Hibernian,9293,1,19,11,6,60,31,29,68
Dundee Utd,9293,2,17,9,10,59,41,18,60
Falkirk,9293,3,15,10,11,54,40,14,55
Morton,9293,4,15,10,11,51,49,2,55
Dunfermline,9293,5,12,12,12,49,49,0,48
Queen of S't,9293,6,12,9,15,42,48,-6,45
St Mirren,9293,7,11,10,15,45,52,-7,43
Dumbarton,9293,8,8,15,13,48,58,-10,39
Raith,9293,9,10,9,17,34,48,-14,39
Ayr,9293,10,7,13,16,31,57,-26,34
Hibernian,9294,1,22,11,3,61,26,35,77
Morton,9294,2,16,12,8,55,39,16,60
Falkirk,9294,3,16,10,10,57,40,17,58
Dundee Utd,9294,4,13,10,13,44,44,0,49
Queen of S't,9294,5,12,9,15,46,47,-1,45
Raith,9294,6,12,9,15,42,51,-9,45
Dumbarton,9294,7,10,11,15,48,57,-9,41
Dunfermline,9294,8,9,13,14,47,56,-9,40
Ayr,9294,9,9,12,15,33,54,-21,39
St Mirren,9294,10,7,11,18,36,55,-19,32
Hibernian,9295,1,20,11,5,59,26,33,71
Morton,9295,2,16,13,7,50,36,14,61
Dundee Utd,9295,3,17,9,10,52,42,10,60
Falkirk,9295,4,15,10,11,55,42,13,55
Queen of S't,9295,5,13,10,13,43,46,-3,49
Dunfermline,9295,6,11,12,13,49,50,-1,45
Raith,9295,7,10,9,17,33,48,-15,39
Ayr,9295,8,8,13,15,35,52,-17,37
Dumbarton,9295,9,8,12,16,43,58,-15,36
St Mirren,9295,10,7,11,18,36,55,-19,32
Hibernian,9296,1,19,14,3,57,26,31,71
Dundee Utd,9296,2,16,11,9,54,43,11,59
Falkirk,9296,3,15,13,8,57,41,16,58
Morton,9296,4,13,14,9,44,38,6,53
Queen of S't,9296,5,13,10,13,50,48,2,49
Raith,9296,6,11,9,16,35,46,-11,42
Dumbarton,9296,7,9,13,14,48,56,-8,40
Dunfermline,9296,8,7,15,14,40,51,-11,36
St Mirren,9296,9,8,11,17,39,54,-15,35
Ayr,9296,10,7,14,15,34,55,-21,35
Hibernian,9297,1,22,11,3,60,23,37,77
Morton,9297,2,16,12,8,50,36,14,60
Falkirk,9297,3,15,11,10,64,45,19,56
Dundee Utd,9297,4,15,9,12,49,41,8,54
Dunfermline,9297,5,11,11,14,48,52,-4,44
Raith,9297,6,11,9,16,36,50,-14,42
Queen of S't,9297,7,11,8,17,44,60,-16,41
Dumbarton,9297,8,9,12,15,50,60,-10,39
Ayr,9297,9,9,11,16,33,55,-22,38
St Mirren,9297,10,8,12,16,41,53,-12,36
Hibernian,9298,1,21,11,4,65,25,40,74
Falkirk,9298,2,17,10,9,60,42,18,61
Dundee Utd,9298,3,16,10,10,53,41,12,58
Morton,9298,4,15,11,10,52,44,8,56
Queen of S't,9298,5,12,9,15,46,51,-5,45
Dunfermline,9298,6,10,11,15,47,53,-6,41
Dumbarton,9298,7,10,11,15,54,62,-8,41
St Mirren,9298,8,10,9,17,39,58,-19,39
Raith,9298,9,9,10,17,36,52,-16,37
Ayr,9298,10,8,12,16,38,62,-24,36
Hibernian,9299,1,19,13,4,55,22,33,70
Morton,9299,2,16,13,7,53,39,14,61
Falkirk,9299,3,16,12,8,59,39,20,60
Dundee Utd,9299,4,16,10,10,48,36,12,58
Queen of S't,9299,5,13,10,13,47,45,2,49
Ayr,9299,6,8,15,13,34,51,-17,39
Dunfermline,9299,7,8,13,15,44,53,-9,37
St Mirren,9299,8,8,12,16,40,56,-16,36
Raith,9299,9,9,9,18,33,58,-25,36
Dumbarton,9299,10,8,11,17,43,57,-14,35
Hibernian,9300,1,20,13,3,61,25,36,73
Falkirk,9300,2,18,10,8,65,42,23,64
Morton,9300,3,16,12,8,46,37,9,60
Dundee Utd,9300,4,14,11,11,49,42,7,53
Queen of S't,9300,5,11,10,15,42,51,-9,43
Dumbarton,9300,6,9,12,15,49,59,-10,39
Ayr,9300,7,9,12,15,32,51,-19,39
St Mirren,9300,8,9,11,16,43,53,-10,38
Dunfermline,9300,9,8,13,15,43,53,-10,37
Raith,9300,10,9,10,17,33,50,-17,37
Hibernian,9301,1,19,14,3,55,25,30,71
Dundee Utd,9301,2,16,11,9,53,42,11,59
Morton,9301,2,16,11,9,53,42,11,59
Falkirk,9301,4,16,10,10,60,41,19,58
Raith,9301,5,11,10,15,41,49,-8,43
Dunfermline,9301,6,9,14,13,46,49,-3,41
Queen of S't,9301,7,10,10,16,42,55,-13,40
Dumbarton,9301,8,9,12,15,46,59,-13,39
Ayr,9301,9,8,13,15,39,58,-19,37
St Mirren,9301,10,8,11,17,43,58,-15,35
Hibernian,9302,1,19,13,4,57,27,30,70
Dundee Utd,9302,2,18,9,9,60,39,21,63
Morton,9302,3,16,11,9,50,40,10,59
Falkirk,9302,4,15,11,10,56,39,17,56
Dunfermline,9302,5,10,12,14,47,51,-4,42
Queen of S't,9302,6,11,8,17,44,52,-8,41
Dumbarton,9302,7,10,11,15,48,60,-12,41
Raith,9302,8,10,10,16,33,47,-14,40
Ayr,9302,9,9,12,15,35,58,-23,39
St Mirren,9302,10,9,9,18,38,55,-17,36
Hibernian,9303,1,19,11,6,59,27,32,68
Falkirk,9303,2,17,11,8,57,38,19,62
Morton,9303,3,16,13,7,51,37,14,61
Dundee Utd,9303,4,15,10,11,49,41,8,55
Ayr,9303,5,11,11,14,41,53,-12,44
Queen of S't,9303,6,11,10,15,44,53,-9,43
Dumbarton,9303,7,9,13,14,47,55,-8,40
Raith,9303,8,10,10,16,33,49,-16,40
Dunfermline,9303,9,7,17,12,46,50,-4,38
St Mirren,9303,10,7,10,19,35,59,-24,31
Hibernian,9304,1,21,11,4,59,24,35,74
Falkirk,9304,2,17,11,8,62,42,20,62
Morton,9304,3,17,11,8,50,36,14,62
Dundee Utd,9304,4,17,9,10,57,43,14,60
Dunfermline,9304,5,10,13,13,46,52,-6,43
Queen of S't,9304,6,11,9,16,50,53,-3,42
Raith,9304,7,10,10,16,38,52,-14,40
Dumbarton,9304,8,9,10,17,47,62,-15,37
St Mirren,9304,9,9,10,17,42,59,-17,37
Ayr,9304,10,7,10,19,32,60,-28,31
Hibernian,9305,1,19,10,7,55,29,26,67
Morton,9305,2,19,9,8,56,38,18,66
Falkirk,9305,3,17,11,8,59,38,21,62
Dundee Utd,9305,4,16,10,10,48,41,7,58
Dunfermline,9305,5,12,12,12,46,44,2,48
Queen of S't,9305,6,11,9,16,44,52,-8,42
Raith,9305,7,10,10,16,35,47,-12,40
St Mirren,9305,8,9,11,16,43,55,-12,38
Dumbarton,9305,9,8,11,17,48,63,-15,35
Ayr,9305,10,7,11,18,29,56,-27,32
Hibernian,9306,1,22,11,3,68,25,43,77
Dundee Utd,9306,2,17,9,10,54,37,17,60
Morton,9306,3,16,10,10,48,44,4,58
Falkirk,9306,4,15,12,9,54,38,16,57
Dunfermline,9306,5,11,14,11,51,48,3,47
Queen of S't,9306,6,11,10,15,45,53,-8,43
Raith,9306,7,10,8,18,34,51,-17,38
Dumbarton,9306,8,8,12,16,42,59,-17,36
St Mirren,9306,9,8,12,16,39,56,-17,36
Ayr,9306,10,7,12,17,34,58,-24,33
Hibernian,9307,1,18,12,6,55,30,25,66
Morton,9307,2,17,13,6,49,34,15,64
Falkirk,9307,3,17,10,9,58,36,22,61
Dundee Utd,9307,4,16,11,9,49,38,11,59
Queen of S't,9307,5,11,10,15,47,53,-6,43
Raith,9307,6,10,11,15,34,47,-13,41
Dumbarton,9307,7,9,11,16,47,60,-13,38
Ayr,9307,8,8,14,14,37,58,-21,38
Dunfermline,9307,9,8,13,15,45,48,-3,37
St Mirren,9307,10,8,11,17,37,54,-17,35
Hibernian,9308,1,19,13,4,56,26,30,70
Morton,9308,2,18,11,7,50,33,17,65
Dundee Utd,9308,3,15,10,11,48,43,5,55
Falkirk,9308,4,14,12,10,58,42,16,54
Queen of S't,9308,5,12,10,14,45,48,-3,46
St Mirren,9308,6,11,9,16,45,54,-9,42
Raith,9308,7,11,9,16,38,50,-12,42
Dunfermline,9308,8,9,13,14,46,50,-4,40
Ayr,9308,9,9,11,16,35,57,-22,38
Dumbarton,9308,10,8,10,18,46,64,-18,34
Hibernian,9309,1,18,13,5,55,26,29,67
Falkirk,9309,2,16,10,10,59,41,18,58
Dundee Utd,9309,3,16,10,10,50,41,9,58
Morton,9309,4,15,12,9,47,36,11,57
Dunfermline,9309,5,11,14,11,52,46,6,47
Raith,9309,6,12,9,15,35,48,-13,45
Queen of S't,9309,7,11,10,15,47,54,-7,43
Ayr,9309,8,9,13,14,40,56,-16,40
Dumbarton,9309,9,9,11,16,47,63,-16,38
St Mirren,9309,10,7,10,19,37,58,-21,31
Hibernian,9310,1,20,12,4,55,26,29,72
Dundee Utd,9310,2,18,10,8,55,39,16,64
Falkirk,9310,3,16,11,9,61,40,21,59
Morton,9310,4,16,11,9,53,37,16,59
Queen of S't,9310,5,13,9,14,46,47,-1,48
Raith,9310,6,12,8,16,38,49,-11,44
Dunfermline,9310,7,10,12,14,47,50,-3,42
Dumbarton,9310,8,10,10,16,54,66,-12,40
St Mirren,9310,9,7,9,20,35,62,-27,30
Ayr,9310,10,6,12,18,29,57,-28,30
Hibernian,9311,1,18,12,6,52,27,25,66
Morton,9311,2,18,11,7,55,35,20,65
Falkirk,9311,3,17,11,8,60,37,23,62
Dundee Utd,9311,4,17,9,10,56,42,14,60
Dunfermline,9311,5,11,11,14,42,48,-6,44
Queen of S't,9311,6,10,11,15,42,54,-12,41
Dumbarton,9311,7,9,13,14,49,60,-11,40
Raith,9311,8,9,9,18,31,47,-16,36
Ayr,9311,9,8,12,16,34,55,-21,36
St Mirren,9311,10,8,11,17,40,56,-16,35
Hibernian,9312,1,20,12,4,58,26,32,72
Morton,9312,2,17,12,7,50,36,14,63
Falkirk,9312,3,16,11,9,56,38,18,59
Dundee Utd,9312,4,14,12,10,50,39,11,54
Dumbarton,9312,5,11,12,13,50,54,-4,45
Dunfermline,9312,6,10,12,14,51,54,-3,42
Queen of S't,9312,7,10,11,15,43,52,-9,41
Raith,9312,8,10,10,16,36,50,-14,40
St Mirren,9312,9,8,12,16,38,51,-13,36
Ayr,9312,10,6,12,18,26,58,-32,30
Morton,9313,1,18,11,7,52,35,17,65
Dundee Utd,9313,2,16,11,9,62,41,21,59
Hibernian,9313,3,16,11,9,50,31,19,59
Falkirk,9313,4,16,11,9,56,46,10,59
Queen of S't,9313,5,13,8,15,48,50,-2,47
Dunfermline,9313,6,12,11,13,44,46,-2,47
Raith,9313,7,10,10,16,37,48,-11,40
St Mirren,9313,8,9,12,15,38,52,-14,39
Ayr,9313,9,9,11,16,37,57,-20,38
Dumbarton,9313,10,8,10,18,48,66,-18,34
Hibernian,9314,1,19,13,4,54,21,33,70
Morton,9314,2,16,13,7,46,32,14,61
Falkirk,9314,3,15,11,10,53,42,11,56
Dundee Utd,9314,4,13,14,9,47,40,7,53
Queen of S't,9314,5,13,9,14,48,48,0,48
Dunfermline,9314,6,9,15,12,45,46,-1,42
Dumbarton,9314,7,10,12,14,50,56,-6,42
Ayr,9314,8,8,14,14,38,58,-20,38
Raith,9314,9,9,10,17,32,51,-19,37
St Mirren,9314,10,7,11,18,36,55,-19,32
Hibernian,9315,1,19,12,5,56,26,30,69
Morton,9315,2,16,13,7,48,34,14,61
Dundee Utd,9315,3,16,10,10,53,41,12,58
Falkirk,9315,4,16,9,11,59,45,14,57
Dunfermline,9315,5,11,12,13,51,48,3,45
Queen of S't,9315,6,12,8,16,43,52,-9,44
Raith,9315,7,11,9,16,38,50,-12,42
Ayr,9315,8,9,12,15,35,53,-18,39
Dumbarton,9315,9,9,10,17,44,59,-15,37
St Mirren,9315,10,8,11,17,40,59,-19,35
Hibernian,9316,1,18,12,6,53,27,26,66
Morton,9316,2,16,12,8,49,40,9,60
Falkirk,9316,3,16,11,9,59,41,18,59
Dundee Utd,9316,4,16,10,10,53,43,10,58
Dunfermline,9316,5,10,15,11,49,43,6,45
Queen of S't,9316,6,11,12,13,43,47,-4,45
Raith,9316,7,9,13,14,39,51,-12,40
Dumbarton,9316,8,10,10,16,46,59,-13,40
St Mirren,9316,9,9,9,18,40,59,-19,36
Ayr,9316,10,7,12,17,34,55,-21,33
Hibernian,9317,1,20,10,6,60,26,34,70
Dundee Utd,9317,2,17,10,9,49,36,13,61
Morton,9317,3,16,10,10,48,38,10,58
Falkirk,9317,4,15,11,10,62,44,18,56
Dunfermline,9317,5,11,11,14,46,51,-5,44
St Mirren,9317,6,10,11,15,45,57,-12,41
Queen of S't,9317,7,10,10,16,44,53,-9,40
Dumbarton,9317,8,10,10,16,44,59,-15,40
Ayr,9317,9,9,13,14,35,53,-18,40
Raith,9317,10,9,10,17,38,54,-16,37
Hibernian,9318,1,19,13,4,57,29,28,70
Falkirk,9318,2,16,11,9,54,40,14,59
Morton,9318,3,15,11,10,52,47,5,56
Dundee Utd,9318,4,14,10,12,50,45,5,52
Queen of S't,9318,5,14,8,14,49,46,3,50
Dunfermline,9318,6,11,14,11,53,46,7,47
Raith,9318,7,11,10,15,37,46,-9,43
St Mirren,9318,8,9,10,17,39,54,-15,37
Ayr,9318,9,8,12,16,32,57,-25,36
Dumbarton,9318,10,8,11,17,48,61,-13,35
Hibernian,9319,1,20,13,3,60,24,36,73
Dundee Utd,9319,2,17,9,10,58,41,17,60
Falkirk,9319,3,16,9,11,55,41,14,57
Morton,9319,4,16,9,11,47,45,2,57
Queen of S't,9319,5,14,9,13,45,44,1,51
Dunfermline,9319,6,11,11,14,47,51,-4,44
St Mirren,9319,7,9,11,16,41,54,-13,38
Raith,9319,8,9,11,16,33,47,-14,38
Dumbarton,9319,9,9,10,17,48,62,-14,37
Ayr,9319,10,7,12,17,30,55,-25,33
Hibernian,9320,1,20,12,4,58,27,31,72
Falkirk,9320,2,18,10,8,69,43,26,64
Morton,9320,3,15,13,8,48,36,12,58
Dundee Utd,9320,4,15,9,12,52,45,7,54
Queen of S't,9320,5,12,10,14,48,51,-3,46
Dunfermline,9320,6,8,15,13,44,54,-10,39
St Mirren,9320,7,9,11,16,47,55,-8,38
Dumbarton,9320,8,9,11,16,46,62,-16,38
Raith,9320,9,9,11,16,32,50,-18,38
Ayr,9320,10,8,12,16,35,56,-21,36
Hibernian,9321,1,20,13,3,57,24,33,73
Dundee Utd,9321,2,18,9,9,51,38,13,63
Falkirk,9321,3,17,10,9,60,40,20,61
Morton,9321,4,16,11,9,49,36,13,59
Queen of S't,9321,5,12,9,15,45,54,-9,45
Dunfermline,9321,6,9,13,14,44,50,-6,40
Raith,9321,7,9,12,15,34,49,-15,39
St Mirren,9321,8,8,11,17,41,55,-14,35
Ayr,9321,9,7,14,15,33,52,-19,35
Dumbarton,9321,10,7,12,17,47,63,-16,33
Hibernian,9322,1,19,10,7,55,27,28,67
Falkirk,9322,2,18,9,9,62,37,25,63
Morton,9322,3,17,11,8,52,38,14,62
Dundee Utd,9322,4,17,9,10,50,39,11,60
Dunfermline,9322,5,10,13,13,45,49,-4,43
Queen of S't,9322,6,11,9,16,44,50,-6,42
St Mirren,9322,7,11,9,16,47,57,-10,42
Dumbarton,9322,8,9,11,16,51,64,-13,38
Raith,9322,9,9,11,16,33,48,-15,38
Ayr,9322,10,7,12,17,30,60,-30,33
Hibernian,9323,1,17,16,3,53,26,27,67
Dundee Utd,9323,2,17,10,9,54,40,14,61
Morton,9323,3,15,12,9,50,41,9,57
Falkirk,9323,4,13,11,12,56,47,9,50
Dunfermline,9323,5,11,14,11,50,51,-1,47
Queen of S't,9323,6,11,9,16,43,52,-9,42
Raith,9323,7,11,9,16,40,49,-9,42
St Mirren,9323,8,9,12,15,44,56,-12,39
Dumbarton,9323,9,9,11,16,52,62,-10,38
Ayr,9323,10,8,14,14,33,51,-18,38
Hibernian,9324,1,19,10,7,55,30,25,67
Morton,9324,2,18,10,8,52,34,18,64
Dundee Utd,9324,3,18,8,10,53,43,10,62
Falkirk,9324,4,16,10,10,60,44,16,58
Dunfermline,9324,5,11,13,12,48,46,2,46
Dumbarton,9324,6,11,10,15,50,57,-7,43
Queen of S't,9324,7,10,10,16,44,53,-9,40
Raith,9324,8,10,10,16,36,50,-14,40
St Mirren,9324,9,9,10,17,40,54,-14,37
Ayr,9324,10,7,11,18,33,60,-27,32
Hibernian,9325,1,20,11,5,52,25,27,71
Morton,9325,2,17,10,9,49,38,11,61
Dundee Utd,9325,3,17,9,10,56,39,17,60
Falkirk,9325,4,15,10,11,55,43,12,55
Queen of S't,9325,5,12,8,16,42,49,-7,44
Dunfermline,9325,6,10,11,15,51,57,-6,41
Raith,9325,7,10,11,15,35,47,-12,41
Dumbarton,9325,8,9,13,14,47,54,-7,40
Ayr,9325,9,8,13,15,34,54,-20,37
St Mirren,9325,10,8,12,16,45,60,-15,36
Hibernian,9326,1,21,10,5,63,27,36,73
Morton,9326,2,16,12,8,54,42,12,60
Falkirk,9326,3,16,11,9,57,40,17,59
Dundee Utd,9326,4,16,10,10,51,38,13,58
Raith,9326,5,13,8,15,42,50,-8,47
Dunfermline,9326,6,10,13,13,48,50,-2,43
Queen of S't,9326,7,11,9,16,47,58,-11,42
Ayr,9326,8,10,11,15,39,58,-19,41
Dumbarton,9326,9,7,12,17,47,61,-14,33
St Mirren,9326,10,7,10,19,36,60,-24,31
Hibernian,9327,1,18,15,3,56,25,31,69
Dundee Utd,9327,2,17,11,8,57,38,19,62
Falkirk,9327,3,15,14,7,59,39,20,59
Morton,9327,4,14,13,9,48,38,10,55
Dunfermline,9327,5,11,13,12,47,45,2,46
Queen of S't,9327,6,11,11,14,50,53,-3,44
Raith,9327,7,10,9,17,33,52,-19,39
Dumbarton,9327,8,8,13,15,47,61,-14,37
Ayr,9327,9,7,15,14,35,58,-23,36
St Mirren,9327,10,6,12,18,37,60,-23,30
Hibernian,9328,1,18,14,4,55,27,28,68
Morton,9328,2,18,10,8,55,38,17,64
Falkirk,9328,3,16,12,8,63,38,25,60
Dundee Utd,9328,4,15,9,12,45,38,7,54
Queen of S't,9328,5,12,10,14,46,51,-5,46
Dunfermline,9328,6,10,12,14,43,48,-5,42
St Mirren,9328,7,11,9,16,40,55,-15,42
Raith,9328,8,10,10,16,35,49,-14,40
Dumbarton,9328,9,8,11,17,45,63,-18,35
Ayr,9328,10,8,11,17,36,56,-20,35
Hibernian,9329,1,18,12,6,54,30,24,66
Falkirk,9329,2,16,11,9,61,42,19,59
Morton,9329,3,16,11,9,47,36,11,59
Dundee Utd,9329,4,15,9,12,47,40,7,54
Queen of S't,9329,5,13,9,14,48,53,-5,48
Dunfermline,9329,6,10,14,12,47,47,0,44
Dumbarton,9329,7,11,10,15,50,56,-6,43
Raith,9329,8,9,12,15,37,51,-14,39
Ayr,9329,9,9,10,17,32,55,-23,37
St Mirren,9329,10,8,12,16,42,55,-13,36
Hibernian,9330,1,18,13,5,55,26,29,67
Morton,9330,2,18,13,5,54,37,17,67
Falkirk,9330,3,15,12,9,56,39,17,57
Dundee Utd,9330,4,14,9,13,51,47,4,51
Dumbarton,9330,5,12,11,13,57,57,0,47
Ayr,9330,6,9,14,13,39,54,-15,41
Dunfermline,9330,7,9,13,14,47,53,-6,40
Queen of S't,9330,8,10,8,18,40,53,-13,38
Raith,9330,9,9,11,16,32,48,-16,38
St Mirren,9330,10,9,10,17,39,56,-17,37
Hibernian,9331,1,20,13,3,56,24,32,73
Morton,9331,2,17,13,6,51,34,17,64
Falkirk,9331,3,15,13,8,58,41,17,58
Dundee Utd,9331,4,15,11,10,47,38,9,56
Queen of S't,9331,5,15,8,13,47,43,4,53
Raith,9331,6,10,9,17,33,47,-14,39
Dumbarton,9331,7,8,13,15,46,55,-9,37
St Mirren,9331,8,8,11,17,37,53,-16,35
Dunfermline,9331,9,7,13,16,43,56,-13,34
Ayr,9331,10,7,12,17,32,59,-27,33
Hibernian,9332,1,22,11,3,60,22,38,77
Falkirk,9332,2,16,11,9,60,41,19,59
Morton,9332,3,15,12,9,47,38,9,57
Dundee Utd,9332,4,13,12,11,45,44,1,51
Dunfermline,9332,5,11,13,12,49,46,3,46
Queen of S't,9332,6,10,11,15,45,53,-8,41
Raith,9332,7,10,10,16,33,48,-15,40
St Mirren,9332,8,9,11,16,39,57,-18,38
Ayr,9332,9,8,13,15,38,54,-16,37
Dumbarton,9332,10,7,14,15,46,59,-13,35
Hibernian,9333,1,19,12,5,60,25,35,69
Morton,9333,2,18,11,7,48,35,13,65
Dundee Utd,9333,3,15,8,13,50,40,10,53
Falkirk,9333,4,13,13,10,53,42,11,52
Dunfermline,9333,5,11,13,12,52,47,5,46
Queen of S't,9333,6,12,10,14,45,52,-7,46
Raith,9333,7,10,11,15,37,53,-16,41
Ayr,9333,8,9,13,14,37,53,-16,40
Dumbarton,9333,9,9,11,16,45,56,-11,38
St Mirren,9333,10,8,10,18,38,62,-24,34
Hibernian,9334,1,19,13,4,53,24,29,70
Morton,9334,2,15,14,7,47,34,13,59
Dundee Utd,9334,3,16,10,10,49,38,11,58
Falkirk,9334,4,14,13,9,55,42,13,55
Dunfermline,9334,5,11,13,12,44,44,0,46
Queen of S't,9334,6,11,9,16,43,52,-9,42
Dumbarton,9334,7,10,11,15,50,54,-4,41
St Mirren,9334,8,9,12,15,41,52,-11,39
Raith,9334,9,9,10,17,32,48,-16,37
Ayr,9334,10,8,11,17,33,59,-26,35
Hibernian,9335,1,20,10,6,60,25,35,70
Morton,9335,2,17,13,6,52,37,15,64
Dundee Utd,9335,3,16,11,9,52,40,12,59
Falkirk,9335,4,14,12,10,57,45,12,54
Queen of S't,9335,5,13,10,13,47,49,-2,49
Dunfermline,9335,6,12,12,12,45,44,1,48
Raith,9335,7,10,10,16,35,51,-16,40
Dumbarton,9335,8,8,11,17,45,56,-11,35
St Mirren,9335,9,7,13,16,42,59,-17,34
Ayr,9335,10,6,12,18,31,60,-29,30
Hibernian,9336,1,20,12,4,58,27,31,72
Morton,9336,2,17,11,8,52,34,18,62
Falkirk,9336,3,16,10,10,55,44,11,58
Dundee Utd,9336,4,14,11,11,51,42,9,53
Dunfermline,9336,5,9,14,13,46,52,-6,41
Dumbarton,9336,6,10,11,15,49,56,-7,41
Queen of S't,9336,7,10,10,16,43,51,-8,40
Ayr,9336,8,10,10,16,33,54,-21,40
Raith,9336,9,9,12,15,36,50,-14,39
St Mirren,9336,10,9,11,16,38,51,-13,38
Hibernian,9337,1,19,12,5,54,26,28,69
Morton,9337,2,17,10,9,49,36,13,61
Dundee Utd,9337,3,17,8,11,55,40,15,59
Falkirk,9337,4,15,11,10,60,44,16,56
Ayr,9337,5,11,12,13,37,52,-15,45
Queen of S't,9337,6,11,11,14,43,47,-4,44
Dumbarton,9337,7,10,11,15,47,56,-9,41
Dunfermline,9337,8,8,13,15,44,52,-8,37
St Mirren,9337,9,9,10,17,40,56,-16,37
Raith,9337,10,8,12,16,32,52,-20,36
Hibernian,9338,1,22,10,4,65,25,40,76
Morton,9338,2,18,10,8,55,37,18,64
Falkirk,9338,3,15,10,11,59,45,14,55
Dundee Utd,9338,4,14,10,12,48,43,5,52
Queen of S't,9338,5,12,10,14,43,49,-6,46
Dunfermline,9338,6,10,14,12,48,49,-1,44
Ayr,9338,7,9,12,15,36,55,-19,39
Dumbarton,9338,8,8,13,15,45,56,-11,37
St Mirren,9338,9,9,10,17,41,61,-20,37
Raith,9338,10,8,11,17,34,54,-20,35
Morton,9339,1,19,12,5,53,34,19,69
Hibernian,9339,2,18,13,5,54,26,28,67
Falkirk,9339,3,18,9,9,59,39,20,63
Dundee Utd,9339,4,14,10,12,46,40,6,52
Queen of S't,9339,5,13,10,13,53,49,4,49
Dunfermline,9339,6,9,13,14,41,45,-4,40
Raith,9339,7,10,10,16,39,56,-17,40
St Mirren,9339,8,9,9,18,42,57,-15,36
Dumbarton,9339,9,8,11,17,44,60,-16,35
Ayr,9339,10,7,13,16,31,56,-25,34
Hibernian,9340,1,18,12,6,50,23,27,66
Morton,9340,2,17,12,7,47,34,13,63
Dundee Utd,9340,3,17,10,9,55,40,15,61
Falkirk,9340,4,15,9,12,55,45,10,54
Queen of S't,9340,5,13,9,14,44,49,-5,48
Dunfermline,9340,6,10,13,13,46,46,0,43
Ayr,9340,7,10,11,15,36,52,-16,41
Dumbarton,9340,8,9,11,16,46,57,-11,38
St Mirren,9340,9,8,13,15,39,54,-15,37
Raith,9340,10,8,10,18,33,51,-18,34
Hibernian,9341,1,18,12,6,53,27,26,66
Morton,9341,2,18,12,6,56,34,22,66
Falkirk,9341,3,16,11,9,59,43,16,59
Dundee Utd,9341,4,15,10,11,48,44,4,55
Dunfermline,9341,5,11,12,13,50,49,1,45
Queen of S't,9341,6,11,10,15,43,51,-8,43
Ayr,9341,7,9,14,13,33,48,-15,41
St Mirren,9341,8,9,12,15,42,53,-11,39
Dumbarton,9341,9,8,12,16,47,64,-17,36
Raith,9341,10,8,9,19,30,48,-18,33
Hibernian,9342,1,21,11,4,58,21,37,74
Morton,9342,2,18,10,8,49,33,16,64
Dundee Utd,9342,3,18,9,9,57,42,15,63
Falkirk,9342,4,16,9,11,57,45,12,57
Dunfermline,9342,5,10,13,13,45,48,-3,43
Queen of S't,9342,6,11,10,15,46,53,-7,43
Raith,9342,7,11,10,15,37,48,-11,43
Dumbarton,9342,8,10,10,16,46,56,-10,40
St Mirren,9342,9,7,10,19,40,62,-22,31
Ayr,9342,10,6,12,18,32,59,-27,30
Hibernian,9343,1,19,12,5,57,30,27,69
Morton,9343,2,19,10,7,56,35,21,67
Dundee Utd,9343,3,15,12,9,47,37,10,57
Falkirk,9343,4,14,11,11,52,41,11,53
Queen of S't,9343,5,12,11,13,49,49,0,47
Raith,9343,6,12,9,15,40,48,-8,45
Dumbarton,9343,7,11,10,15,52,58,-6,43
Dunfermline,9343,8,9,12,15,43,51,-8,39
St Mirren,9343,9,8,12,16,40,55,-15,36
Ayr,9343,10,6,11,19,30,62,-32,29
Hibernian,9344,1,20,11,5,56,25,31,71
Morton,9344,2,16,13,7,49,34,15,61
Dundee Utd,9344,3,17,10,9,50,37,13,61
Falkirk,9344,4,15,11,10,55,43,12,56
Ayr,9344,5,11,12,13,35,49,-14,45
Queen of S't,9344,6,11,9,16,44,51,-7,42
Dunfermline,9344,7,10,11,15,44,51,-7,41
Raith,9344,8,10,9,17,34,49,-15,39
Dumbarton,9344,9,8,12,16,45,57,-12,36
St Mirren,9344,10,7,12,17,40,56,-16,33
Hibernian,9345,1,20,10,6,58,29,29,70
Morton,9345,2,17,10,9,53,39,14,61
Falkirk,9345,3,17,9,10,61,43,18,60
Dundee Utd,9345,4,16,10,10,48,39,9,58
Queen of S't,9345,5,13,9,14,46,48,-2,48
Dunfermline,9345,6,10,11,15,49,56,-7,41
Raith,9345,7,11,8,17,37,55,-18,41
Dumbarton,9345,8,9,12,15,50,58,-8,39
Ayr,9345,9,8,13,15,32,50,-18,37
St Mirren,9345,10,8,10,18,39,56,-17,34
Hibernian,9346,1,20,10,6,59,32,27,70
Morton,9346,2,16,12,8,53,39,14,60
Falkirk,9346,3,16,10,10,59,40,19,58
Dundee Utd,9346,4,16,9,11,48,38,10,57
Queen of S't,9346,5,13,9,14,46,48,-2,48
Dunfermline,9346,6,10,13,13,49,54,-5,43
Ayr,9346,7,10,11,15,35,54,-19,41
Dumbarton,9346,8,9,12,15,49,58,-9,39
Raith,9346,9,9,10,17,37,51,-14,37
St Mirren,9346,10,8,10,18,38,59,-21,34
Hibernian,9347,1,19,11,6,56,28,28,68
Morton,9347,2,17,13,6,51,36,15,64
Falkirk,9347,3,16,11,9,65,40,25,59
Dundee Utd,9347,4,15,12,9,53,42,11,57
Dunfermline,9347,5,10,16,10,47,44,3,46
Raith,9347,6,11,10,15,33,45,-12,43
Dumbarton,9347,7,10,11,15,46,58,-12,41
Ayr,9347,8,8,13,15,33,53,-20,37
Queen of S't,9347,9,9,9,18,39,54,-15,36
St Mirren,9347,10,6,12,18,37,60,-23,30
Hibernian,9348,1,19,11,6,57,27,30,68
Morton,9348,2,18,11,7,55,38,17,65
Falkirk,9348,3,17,11,8,59,35,24,62
Dundee Utd,9348,4,16,11,9,49,39,10,59
Queen of S't,9348,5,11,10,15,42,49,-7,43
Dumbarton,9348,6,9,13,14,47,56,-9,40
Dunfermline,9348,7,8,14,14,43,51,-8,38
Raith,9348,8,9,11,16,33,48,-15,38
St Mirren,9348,9,8,11,17,38,55,-17,35
Ayr,9348,10,8,11,17,31,56,-25,35
Hibernian,9349,1,19,12,5,57,26,31,69
Morton,9349,2,15,14,7,47,35,12,59
Dundee Utd,9349,3,16,9,11,50,41,9,57
Falkirk,9349,4,15,11,10,54,42,12,56
Dunfermline,9349,5,11,13,12,47,43,4,46
Queen of S't,9349,6,11,11,14,45,50,-5,44
Raith,9349,7,10,10,16,33,48,-15,40
Dumbarton,9349,8,9,11,16,47,61,-14,38
St Mirren,9349,9,9,10,17,40,56,-16,37
Ayr,9349,10,8,13,15,36,54,-18,37
Hibernian,9350,1,19,11,6,53,27,26,68
Morton,9350,2,18,12,6,52,32,20,66
Falkirk,9350,3,16,9,11,60,42,18,57
Dundee Utd,9350,4,16,9,11,49,42,7,57
Queen of S't,9350,5,13,10,13,46,48,-2,49
Dumbarton,9350,6,10,12,14,51,57,-6,42
Ayr,9350,7,9,12,15,35,54,-19,39
Raith,9350,8,9,10,17,36,52,-16,37
Dunfermline,9350,9,8,12,16,40,50,-10,36
St Mirren,9350,10,9,9,18,38,56,-18,36
Hibernian,9351,1,21,11,4,64,30,34,74
Falkirk,9351,2,17,10,9,63,43,20,61
Morton,9351,3,16,11,9,49,40,9,59
Dundee Utd,9351,4,14,12,10,46,38,8,54
Queen of S't,9351,5,12,10,14,47,51,-4,46
Dumbarton,9351,6,10,11,15,49,60,-11,41
Raith,9351,7,10,9,17,36,50,-14,39
St Mirren,9351,8,9,11,16,42,55,-13,38
Ayr,9351,9,8,14,14,38,55,-17,38
Dunfermline,9351,10,8,11,17,43,55,-12,35
Hibernian,9352,1,19,12,5,55,30,25,69
Falkirk,9352,2,17,12,7,61,38,23,63
Morton,9352,3,16,10,10,51,39,12,58
Dundee Utd,9352,4,15,12,9,49,42,7,57
Dumbarton,9352,5,9,14,13,44,49,-5,41
Queen of S't,9352,6,10,11,15,44,50,-6,41
Raith,9352,7,10,10,16,34,47,-13,40
Dunfermline,9352,8,8,14,14,42,49,-7,38
Ayr,9352,9,8,14,14,35,53,-18,38
St Mirren,9352,10,8,11,17,40,58,-18,35
Hibernian,9353,1,18,12,6,55,27,28,66
Falkirk,9353,2,17,10,9,60,38,22,61
Morton,9353,3,15,15,6,48,33,15,60
Dundee Utd,9353,4,16,10,10,53,42,11,58
Dunfermline,9353,5,9,16,11,48,48,0,43
Ayr,9353,6,10,12,14,35,51,-16,42
Queen of S't,9353,7,11,8,17,46,58,-12,41
Raith,9353,8,11,8,17,39,53,-14,41
St Mirren,9353,9,9,11,16,41,54,-13,38
Dumbarton,9353,10,7,12,17,44,65,-21,33
Hibernian,9354,1,19,12,5,54,26,28,69
Morton,9354,2,18,11,7,57,34,23,65
Dundee Utd,9354,3,18,10,8,53,36,17,64
Falkirk,9354,4,16,10,10,58,43,15,58
Dunfermline,9354,5,10,15,11,47,46,1,45
Queen of S't,9354,6,11,9,16,43,53,-10,42
Raith,9354,7,9,10,17,33,50,-17,37
Dumbarton,9354,8,8,12,16,52,65,-13,36
Ayr,9354,9,8,12,16,35,58,-23,36
St Mirren,9354,10,7,11,18,40,61,-21,32
Hibernian,9355,1,19,13,4,53,24,29,70
Morton,9355,2,16,14,6,54,35,19,62
Falkirk,9355,3,17,10,9,62,40,22,61
Dundee Utd,9355,4,16,10,10,48,43,5,58
Queen of S't,9355,5,13,8,15,44,49,-5,47
Dunfermline,9355,6,10,12,14,47,50,-3,42
Raith,9355,7,10,9,17,36,49,-13,39
Dumbarton,9355,8,9,11,16,46,57,-11,38
Ayr,9355,9,8,12,16,33,53,-20,36
St Mirren,9355,10,7,11,18,36,59,-23,32
Hibernian,9356,1,20,11,5,56,24,32,71
Dundee Utd,9356,2,16,10,10,50,38,12,58
Morton,9356,3,16,10,10,49,40,9,58
Falkirk,9356,4,15,11,10,56,40,16,56
Queen of S't,9356,5,14,9,13,50,47,3,51
Dunfermline,9356,6,10,12,14,49,50,-1,42
Ayr,9356,7,8,15,13,36,55,-19,39
Raith,9356,8,9,11,16,35,51,-16,38
Dumbarton,9356,9,8,12,16,46,64,-18,36
St Mirren,9356,10,8,11,17,41,59,-18,35
Hibernian,9357,1,21,11,4,61,29,32,74
Falkirk,9357,2,17,11,8,59,38,21,62
Morton,9357,3,17,10,9,57,42,15,61
Dundee Utd,9357,4,14,12,10,46,39,7,54
Queen of S't,9357,5,13,9,14,47,46,1,48
Dunfermline,9357,6,11,12,13,45,50,-5,45
Raith,9357,7,9,10,17,37,51,-14,37
Dumbarton,9357,8,8,12,16,47,64,-17,36
Ayr,9357,9,8,12,16,32,56,-24,36
St Mirren,9357,10,7,11,18,41,57,-16,32
Hibernian,9358,1,20,11,5,60,26,34,71
Dundee Utd,9358,2,17,11,8,55,39,16,62
Morton,9358,3,16,13,7,48,34,14,61
Falkirk,9358,4,15,11,10,58,44,14,56
Raith,9358,5,11,10,15,33,45,-12,43
Dumbarton,9358,6,10,12,14,48,55,-7,42
Queen of S't,9358,7,11,9,16,41,49,-8,42
Ayr,9358,8,9,11,16,39,59,-20,38
Dunfermline,9358,9,7,14,15,44,56,-12,35
St Mirren,9358,10,8,10,18,37,56,-19,34
Hibernian,9359,1,19,12,5,53,25,28,69
Morton,9359,2,16,12,8,51,37,14,60
Dundee Utd,9359,3,17,9,10,51,38,13,60
Falkirk,9359,4,16,11,9,57,40,17,59
Dunfermline,9359,5,10,14,12,45,48,-3,44
Queen of S't,9359,6,10,11,15,42,47,-5,41
Ayr,9359,7,10,11,15,35,55,-20,41
Dumbarton,9359,8,10,10,16,49,59,-10,40
St Mirren,9359,9,9,10,17,38,55,-17,37
Raith,9359,10,8,10,18,34,51,-17,34
Hibernian,9360,1,21,12,3,58,24,34,75
Morton,9360,2,18,10,8,51,36,15,64
Dundee Utd,9360,3,16,10,10,55,43,12,58
Falkirk,9360,4,15,11,10,57,43,14,56
Queen of S't,9360,5,12,8,16,47,53,-6,44
Dunfermline,9360,6,10,12,14,48,55,-7,42
Ayr,9360,7,8,14,14,35,53,-18,38
Raith,9360,8,10,8,18,34,52,-18,38
Dumbarton,9360,9,8,12,16,46,58,-12,36
St Mirren,9360,10,8,11,17,43,57,-14,35
Hibernian,9361,1,18,13,5,56,28,28,67
Morton,9361,2,17,12,7,51,36,15,63
Dundee Utd,9361,3,16,11,9,48,37,11,59
Falkirk,9361,4,15,11,10,59,42,17,56
Queen of S't,9361,5,12,9,15,43,51,-8,45
Dumbarton,9361,6,10,12,14,50,56,-6,42
Dunfermline,9361,7,9,14,13,46,50,-4,41
Raith,9361,8,9,10,17,34,50,-16,37
Ayr,9361,9,7,15,14,36,54,-18,36
St Mirren,9361,10,7,13,16,33,52,-19,34
Hibernian,9362,1,21,11,4,64,24,40,74
Dundee Utd,9362,2,18,9,9,54,41,13,63
Morton,9362,3,15,10,11,47,42,5,55
Falkirk,9362,4,15,9,12,52,40,12,54
Dumbarton,9362,5,13,11,12,53,49,4,50
Raith,9362,6,14,8,14,42,48,-6,50
Queen of S't,9362,7,11,9,16,42,50,-8,42
Dunfermline,9362,8,9,11,16,42,51,-9,38
Ayr,9362,9,8,11,17,34,60,-26,35
St Mirren,9362,10,6,11,19,35,60,-25,29
Hibernian,9363,1,17,14,5,53,27,26,65
Morton,9363,2,17,11,8,50,40,10,62
Dundee Utd,9363,3,15,11,10,46,38,8,56
Falkirk,9363,4,14,12,10,53,40,13,54
Dunfermline,9363,5,11,13,12,50,47,3,46
Raith,9363,6,10,12,14,34,44,-10,42
Dumbarton,9363,7,9,14,13,49,56,-7,41
Queen of S't,9363,8,10,10,16,43,53,-10,40
Ayr,9363,9,9,12,15,34,51,-17,39
St Mirren,9363,10,8,11,17,42,58,-16,35
Morton,9364,1,19,9,8,57,37,20,66
Hibernian,9364,2,17,14,5,49,24,25,65
Falkirk,9364,3,16,12,8,59,43,16,60
Dundee Utd,9364,4,14,10,12,45,43,2,52
Dunfermline,9364,5,12,12,12,51,49,2,48
Queen of S't,9364,6,11,10,15,45,53,-8,43
Dumbarton,9364,7,10,11,15,47,53,-6,41
Raith,9364,8,9,11,16,36,50,-14,38
St Mirren,9364,9,8,12,16,39,55,-16,36
Ayr,9364,10,8,11,17,32,53,-21,35
Hibernian,9365,1,19,10,7,53,24,29,67
Morton,9365,2,17,11,8,48,38,10,62
Dundee Utd,9365,3,16,9,11,54,40,14,57
Falkirk,9365,4,15,10,11,54,46,8,55
Dunfermline,9365,5,12,12,12,49,47,2,48
Queen of S't,9365,6,12,9,15,44,50,-6,45
Ayr,9365,7,9,14,13,37,52,-15,41
St Mirren,9365,8,10,9,17,43,54,-11,39
Raith,9365,9,10,9,17,38,56,-18,39
Dumbarton,9365,10,8,11,17,50,63,-13,35
Hibernian,9366,1,17,15,4,51,25,26,66
Morton,9366,2,17,12,7,52,33,19,63
Falkirk,9366,3,15,14,7,57,37,20,59
Dundee Utd,9366,4,15,11,10,49,40,9,56
Queen of S't,9366,5,11,11,14,45,49,-4,44
Raith,9366,6,10,12,14,36,45,-9,42
Dunfermline,9366,7,9,13,14,45,50,-5,40
Ayr,9366,8,8,14,14,33,51,-18,38
Dumbarton,9366,9,8,12,16,45,61,-16,36
St Mirren,9366,10,8,10,18,38,60,-22,34
Hibernian,9367,1,20,13,3,57,24,33,73
Morton,9367,2,17,13,6,51,36,15,64
Falkirk,9367,3,15,11,10,59,44,15,56
Dundee Utd,9367,4,14,12,10,49,40,9,54
Dunfermline,9367,5,10,13,13,45,48,-3,43
Queen of S't,9367,6,11,10,15,43,50,-7,43
Raith,9367,7,11,10,15,37,47,-10,43
Dumbarton,9367,8,8,13,15,42,54,-12,37
St Mirren,9367,9,8,10,18,37,56,-19,34
Ayr,9367,10,7,13,16,33,54,-21,34
Hibernian,9368,1,20,13,3,57,26,31,73
Dundee Utd,9368,2,20,8,8,50,33,17,68
Falkirk,9368,3,15,11,10,62,46,16,56
Morton,9368,4,14,12,10,47,40,7,54
Dunfermline,9368,5,10,13,13,46,49,-3,43
Dumbarton,9368,6,9,12,15,48,56,-8,39
Ayr,9368,7,9,12,15,35,53,-18,39
Queen of S't,9368,8,9,11,16,43,54,-11,38
St Mirren,9368,9,8,12,16,38,53,-15,36
Raith,9368,10,8,12,16,35,51,-16,36
Hibernian,9369,1,16,14,6,49,28,21,62
Morton,9369,2,17,11,8,47,36,11,62
Falkirk,9369,3,16,11,9,61,40,21,59
Dundee Utd,9369,4,16,9,11,48,39,9,57
St Mirren,9369,5,12,10,14,49,53,-4,46
Queen of S't,9369,6,12,9,15,43,49,-6,45
Dunfermline,9369,7,9,15,12,44,45,-1,42
Raith,9369,8,10,11,15,36,48,-12,41
Ayr,9369,9,9,12,15,35,52,-17,39
Dumbarton,9369,10,7,10,19,42,64,-22,31
Hibernian,9370,1,21,10,5,63,32,31,73
Dundee Utd,9370,2,18,8,10,58,39,19,62
Morton,9370,3,16,10,10,51,40,11,58
Falkirk,9370,4,16,9,11,57,43,14,57
Dunfermline,9370,5,11,13,12,46,45,1,46
Queen of S't,9370,6,11,9,16,43,53,-10,42
Raith,9370,7,10,10,16,36,51,-15,40
Ayr,9370,8,10,10,16,40,62,-22,40
Dumbarton,9370,9,9,12,15,50,57,-7,39
St Mirren,9370,10,7,11,18,37,59,-22,32
Hibernian,9371,1,20,10,6,56,25,31,70
Dundee Utd,9371,2,18,8,10,52,36,16,62
Morton,9371,3,15,13,8,45,32,13,58
Falkirk,9371,4,15,11,10,55,39,16,56
Queen of S't,9371,5,14,8,14,46,47,-1,50
Dunfermline,9371,6,9,13,14,41,51,-10,40
Ayr,9371,7,9,12,15,34,53,-19,39
Raith,9371,8,10,8,18,32,50,-18,38
St Mirren,9371,9,8,13,15,40,55,-15,37
Dumbarton,9371,10,7,14,15,43,56,-13,35
Hibernian,9372,1,18,12,6,61,28,33,66
Falkirk,9372,2,18,11,7,63,37,26,65
Morton,9372,3,16,12,8,49,36,13,60
Dundee Utd,9372,4,16,11,9,54,40,14,59
Queen of S't,9372,5,11,9,16,41,48,-7,42
St Mirren,9372,6,10,10,16,48,59,-11,40
Raith,9372,7,10,10,16,38,50,-12,40
Dunfermline,9372,8,9,12,15,44,52,-8,39
Ayr,9372,9,9,11,16,36,67,-31,38
Dumbarton,9372,10,8,12,16,43,60,-17,36
Hibernian,9373,1,19,12,5,55,25,30,69
Morton,9373,2,17,12,7,51,35,16,63
Falkirk,9373,3,15,13,8,60,42,18,58
Dundee Utd,9373,4,15,12,9,57,44,13,57
Dunfermline,9373,5,11,12,13,50,50,0,45
Queen of S't,9373,6,11,10,15,48,54,-6,43
Raith,9373,7,9,11,16,35,51,-16,38
St Mirren,9373,8,9,10,17,41,55,-14,37
Ayr,9373,9,8,13,15,38,61,-23,37
Dumbarton,9373,10,7,13,16,43,61,-18,34
Hibernian,9374,1,19,13,4,57,26,31,70
Dundee Utd,9374,2,17,9,10,56,40,16,60
Falkirk,9374,3,16,10,10,59,42,17,58
Morton,9374,4,15,11,10,46,38,8,56
Dunfermline,9374,5,11,11,14,43,47,-4,44
Queen of S't,9374,6,11,10,15,41,50,-9,43
Raith,9374,7,10,10,16,37,52,-15,40
St Mirren,9374,8,10,9,17,38,54,-16,39
Ayr,9374,9,9,12,15,34,52,-18,39
Dumbarton,9374,10,9,11,16,46,56,-10,38
Hibernian,9375,1,20,12,4,60,24,36,72
Morton,9375,2,16,12,8,49,39,10,60
Dundee Utd,9375,3,16,11,9,52,38,14,59
Falkirk,9375,4,16,9,11,57,44,13,57
Queen of S't,9375,5,12,11,13,42,45,-3,47
Dunfermline,9375,6,11,12,13,48,48,0,45
Raith,9375,7,9,11,16,36,49,-13,38
Ayr,9375,8,8,14,14,31,54,-23,38
Dumbarton,9375,9,7,12,17,43,56,-13,33
St Mirren,9375,10,7,12,17,34,55,-21,33
Hibernian,9376,1,21,12,3,59,21,38,75
Morton,9376,2,17,11,8,54,39,15,62
Falkirk,9376,3,16,12,8,60,37,23,60
Dundee Utd,9376,4,14,9,13,42,39,3,51
Raith,9376,5,12,9,15,39,49,-10,45
Queen of S't,9376,6,11,9,16,49,55,-6,42
Dumbarton,9376,7,10,12,14,52,62,-10,42
Dunfermline,9376,8,9,13,14,46,53,-7,40
Ayr,9376,9,8,11,17,35,61,-26,35
St Mirren,9376,10,8,10,18,39,59,-20,34
Hibernian,9377,1,20,11,5,60,25,35,71
Falkirk,9377,2,17,11,8,59,41,18,62
Dundee Utd,9377,3,15,12,9,47,37,10,57
Morton,9377,4,15,12,9,47,38,9,57
Dunfermline,9377,5,11,13,12,47,46,1,46
Dumbarton,9377,6,10,12,14,51,57,-6,42
Queen of S't,9377,7,11,8,17,43,51,-8,41
Raith,9377,8,10,9,17,34,51,-17,39
Ayr,9377,9,8,13,15,34,56,-22,37
St Mirren,9377,10,7,11,18,39,59,-20,32
Hibernian,9378,1,19,13,4,58,27,31,70
Falkirk,9378,2,18,9,9,63,39,24,63
Morton,9378,3,14,16,6,54,42,12,58
Dundee Utd,9378,4,16,10,10,53,41,12,58
Queen of S't,9378,5,11,11,14,44,54,-10,44
St Mirren,9378,6,9,13,14,41,52,-11,40
Ayr,9378,7,9,12,15,39,57,-18,39
Raith,9378,8,9,11,16,36,51,-15,38
Dunfermline,9378,9,8,13,15,45,52,-7,37
Dumbarton,9378,10,7,12,17,48,66,-18,33
Hibernian,9379,1,20,12,4,66,28,38,72
Morton,9379,2,17,12,7,52,38,14,63
Dundee Utd,9379,3,15,10,11,46,38,8,55
Falkirk,9379,4,15,9,12,63,49,14,54
Queen of S't,9379,5,12,9,15,43,51,-8,45
Dumbarton,9379,6,11,11,14,48,54,-6,44
Dunfermline,9379,7,8,15,13,42,46,-4,39
St Mirren,9379,8,10,9,17,43,55,-12,39
Raith,9379,9,10,9,17,33,54,-21,39
Ayr,9379,10,7,14,15,31,54,-23,35
Hibernian,9380,1,20,11,5,56,26,30,71
Morton,9380,2,18,10,8,55,37,18,64
Falkirk,9380,3,15,11,10,52,41,11,56
Dundee Utd,9380,4,13,12,11,44,42,2,51
Dunfermline,9380,5,10,14,12,48,51,-3,44
Queen of S't,9380,6,11,11,14,44,47,-3,44
Raith,9380,7,11,8,17,38,50,-12,41
Dumbarton,9380,8,10,10,16,55,64,-9,40
St Mirren,9380,9,8,13,15,37,52,-15,37
Ayr,9380,10,8,12,16,41,60,-19,36
Hibernian,9381,1,21,11,4,57,29,28,74
Dundee Utd,9381,2,18,9,9,57,38,19,63
Morton,9381,3,16,13,7,55,39,16,61
Falkirk,9381,4,15,10,11,57,43,14,55
Dumbarton,9381,5,11,11,14,50,57,-7,44
Dunfermline,9381,6,10,13,13,46,47,-1,43
Queen of S't,9381,7,10,11,15,50,57,-7,41
Raith,9381,8,10,8,18,37,55,-18,38
St Mirren,9381,9,8,10,18,42,61,-19,34
Ayr,9381,10,6,14,16,34,59,-25,32
Hibernian,9382,1,21,12,3,55,22,33,75
Dundee Utd,9382,2,17,9,10,49,37,12,60
Morton,9382,3,16,11,9,43,35,8,59
Falkirk,9382,4,13,14,9,56,43,13,53
Dumbarton,9382,5,10,12,14,50,56,-6,42
Dunfermline,9382,6,9,14,13,46,49,-3,41
Queen of S't,9382,7,10,11,15,40,50,-10,41
Raith,9382,8,9,12,15,36,49,-13,39
Ayr,9382,9,8,13,15,36,54,-18,37
St Mirren,9382,10,8,10,18,41,57,-16,34
Hibernian,9383,1,20,11,5,66,26,40,71
Falkirk,9383,2,16,11,9,59,44,15,59
Dundee Utd,9383,3,16,10,10,57,42,15,58
Morton,9383,4,15,12,9,49,43,6,57
Dunfermline,9383,5,10,14,12,45,48,-3,44
Dumbarton,9383,6,10,12,14,51,57,-6,42
St Mirren,9383,7,11,9,16,41,53,-12,42
Queen of S't,9383,8,10,11,15,44,53,-9,41
Raith,9383,9,8,12,16,34,49,-15,36
Ayr,9383,10,7,12,17,31,62,-31,33
Hibernian,9384,1,20,12,4,58,26,32,72
Morton,9384,2,16,13,7,53,37,16,61
Falkirk,9384,3,16,11,9,61,39,22,59
Dundee Utd,9384,4,13,11,12,45,44,1,50
Queen of S't,9384,5,13,9,14,47,53,-6,48
Dunfermline,9384,6,9,12,15,45,53,-8,39
Dumbarton,9384,7,9,12,15,49,61,-12,39
Raith,9384,8,9,12,15,37,53,-16,39
St Mirren,9384,9,9,11,16,45,56,-11,38
Ayr,9384,10,7,15,14,34,52,-18,36
Hibernian,9385,1,19,13,4,55,25,30,70
Morton,9385,2,16,14,6,53,38,15,62
Dundee Utd,9385,3,17,10,9,61,41,20,61
Falkirk,9385,4,14,12,10,57,41,16,54
Dunfermline,9385,5,10,14,12,50,48,2,44
Raith,9385,6,11,10,15,31,44,-13,43
Queen of S't,9385,7,10,11,15,43,52,-9,41
St Mirren,9385,8,9,11,16,40,54,-14,38
Ayr,9385,9,8,11,17,37,61,-24,35
Dumbarton,9385,10,7,12,17,48,71,-23,33
Hibernian,9386,1,19,11,6,60,32,28,68
Morton,9386,2,17,9,10,46,38,8,60
Falkirk,9386,3,16,11,9,59,41,18,59
Dundee Utd,9386,4,17,8,11,49,37,12,59
Dunfermline,9386,5,13,11,12,50,45,5,50
Queen of S't,9386,6,12,8,16,46,54,-8,44
Raith,9386,7,11,8,17,36,52,-16,41
Ayr,9386,8,10,10,16,35,57,-22,40
St Mirren,9386,9,9,9,18,46,54,-8,36
Dumbarton,9386,10,8,11,17,45,62,-17,35
Hibernian,9387,1,18,13,5,55,24,31,67
Dundee Utd,9387,2,17,9,10,52,38,14,60
Morton,9387,3,15,13,8,54,39,15,58
Falkirk,9387,4,14,12,10,53,42,11,54
Queen of S't,9387,5,11,11,14,44,49,-5,44
Dunfermline,9387,6,10,13,13,43,45,-2,43
Raith,9387,7,11,10,15,38,47,-9,43
Dumbarton,9387,8,9,12,15,48,59,-11,39
Ayr,9387,9,9,12,15,34,59,-25,39
St Mirren,9387,10,8,11,17,39,58,-19,35
Hibernian,9388,1,20,11,5,58,24,34,71
Falkirk,9388,2,17,11,8,56,37,19,62
Morton,9388,3,17,11,8,52,36,16,62
Dundee Utd,9388,4,16,11,9,52,38,14,59
Queen of S't,9388,5,12,8,16,43,49,-6,44
Dumbarton,9388,6,9,12,15,50,56,-6,39
Dunfermline,9388,7,9,12,15,45,55,-10,39
St Mirren,9388,8,9,11,16,39,54,-15,38
Raith,9388,9,9,10,17,34,50,-16,37
Ayr,9388,10,8,11,17,34,64,-30,35
Hibernian,9389,1,21,11,4,63,24,39,74
Morton,9389,2,18,12,6,52,33,19,66
Falkirk,9389,3,17,10,9,58,41,17,61
Dundee Utd,9389,4,16,10,10,48,36,12,58
Queen of S't,9389,5,12,9,15,44,48,-4,45
Raith,9389,6,10,9,17,35,53,-18,39
Dumbarton,9389,7,9,11,16,50,61,-11,38
Dunfermline,9389,8,8,13,15,40,49,-9,37
St Mirren,9389,9,8,12,16,40,57,-17,36
Ayr,9389,10,7,11,18,30,58,-28,32
Hibernian,9390,1,18,14,4,55,26,29,68
Morton,9390,2,18,10,8,51,36,15,64
Falkirk,9390,3,15,13,8,60,40,20,58
Dundee Utd,9390,4,15,9,12,48,42,6,54
Dunfermline,9390,5,11,13,12,47,48,-1,46
Queen of S't,9390,6,11,10,15,49,54,-5,43
Raith,9390,7,10,11,15,38,49,-11,41
Dumbarton,9390,8,9,11,16,49,62,-13,38
Ayr,9390,9,8,12,16,32,54,-22,36
St Mirren,9390,10,8,11,17,36,54,-18,35
Hibernian,9391,1,18,13,5,58,28,30,67
Morton,9391,2,16,12,8,50,37,13,60
Falkirk,9391,3,15,10,11,55,43,12,55
Dundee Utd,9391,4,14,11,11,53,46,7,53
Queen of S't,9391,5,13,10,13,46,47,-1,49
Dunfermline,9391,6,10,15,11,50,48,2,45
Dumbarton,9391,7,10,11,15,48,56,-8,41
Raith,9391,8,10,9,17,36,51,-15,39
St Mirren,9391,9,10,9,17,38,58,-20,39
Ayr,9391,10,8,12,16,33,53,-20,36
Hibernian,9392,1,17,13,6,53,30,23,64
Falkirk,9392,2,16,11,9,62,45,17,59
Dundee Utd,9392,3,16,9,11,51,38,13,57
Morton,9392,4,15,12,9,43,36,7,57
Dunfermline,9392,5,12,14,10,49,40,9,50
St Mirren,9392,6,12,9,15,43,52,-9,45
Queen of S't,9392,7,10,12,14,40,49,-9,42
Raith,9392,8,10,10,16,35,51,-16,40
Dumbarton,9392,9,8,12,16,44,59,-15,36
Ayr,9392,10,8,10,18,36,56,-20,34
Hibernian,9393,1,20,11,5,56,29,27,71
Morton,9393,2,18,10,8,50,33,17,64
Dundee Utd,9393,3,16,11,9,53,39,14,59
Falkirk,9393,4,14,15,7,60,40,20,57
Dunfermline,9393,5,10,12,14,46,50,-4,42
Queen of S't,9393,6,10,12,14,42,52,-10,42
Dumbarton,9393,7,9,13,14,44,56,-12,40
Raith,9393,8,10,9,17,36,49,-13,39
St Mirren,9393,9,9,10,17,40,53,-13,37
Ayr,9393,10,7,11,18,30,56,-26,32
Hibernian,9394,1,21,11,4,60,26,34,74
Morton,9394,2,17,13,6,48,33,15,64
Falkirk,9394,3,17,10,9,64,42,22,61
Dundee Utd,9394,4,16,9,11,52,42,10,57
Dumbarton,9394,5,10,11,15,53,61,-8,41
Queen of S't,9394,6,11,8,17,42,52,-10,41
Dunfermline,9394,7,9,13,14,48,52,-4,40
St Mirren,9394,8,9,11,16,38,58,-20,38
Ayr,9394,9,9,10,17,33,54,-21,37
Raith,9394,10,9,8,19,34,52,-18,35
Hibernian,9395,1,17,14,5,49,25,24,65
Falkirk,9395,2,18,10,8,58,35,23,64
Morton,9395,3,16,12,8,45,35,10,60
Dundee Utd,9395,4,14,11,11,48,40,8,53
Queen of S't,9395,5,12,8,16,46,51,-5,44
Raith,9395,6,11,10,15,38,48,-10,43
Dunfermline,9395,7,9,14,13,42,45,-3,41
Dumbarton,9395,8,9,13,14,44,54,-10,40
Ayr,9395,9,8,14,14,32,51,-19,38
St Mirren,9395,10,8,10,18,37,55,-18,34
Hibernian,9396,1,20,12,4,62,25,37,72
Morton,9396,2,18,12,6,52,36,16,66
Falkirk,9396,3,16,10,10,59,42,17,58
Dundee Utd,9396,4,14,13,9,51,39,12,55
Dunfermline,9396,5,10,14,12,46,45,1,44
Queen of S't,9396,6,11,10,15,43,51,-8,43
Dumbarton,9396,7,10,10,16,51,65,-14,40
Ayr,9396,8,7,15,14,32,53,-21,36
Raith,9396,9,9,8,19,36,58,-22,35
St Mirren,9396,10,7,12,17,43,61,-18,33
Hibernian,9397,1,19,12,5,54,24,30,69
Morton,9397,2,19,12,5,54,32,22,69
Dundee Utd,9397,3,17,10,9,56,38,18,61
Falkirk,9397,4,15,11,10,52,39,13,56
Queen of S't,9397,5,11,10,15,45,51,-6,43
Dunfermline,9397,6,10,12,14,46,52,-6,42
Raith,9397,7,11,9,16,38,53,-15,42
Dumbarton,9397,8,10,11,15,49,57,-8,41
Ayr,9397,9,7,12,17,32,58,-26,33
St Mirren,9397,10,7,9,20,38,60,-22,30
Hibernian,9398,1,20,11,5,55,24,31,71
Morton,9398,2,17,12,7,49,35,14,63
Dundee Utd,9398,3,17,8,11,52,39,13,59
Falkirk,9398,4,14,11,11,56,45,11,53
Queen of S't,9398,5,11,11,14,48,51,-3,44
Dunfermline,9398,6,10,13,13,42,48,-6,43
Ayr,9398,7,10,11,15,33,50,-17,41
Raith,9398,8,8,13,15,40,55,-15,37
Dumbarton,9398,9,8,12,16,46,58,-12,36
St Mirren,9398,10,8,12,16,41,57,-16,36
Hibernian,9399,1,17,15,4,55,28,27,66
Falkirk,9399,2,17,11,8,64,42,22,62
Morton,9399,3,14,14,8,47,37,10,56
Dundee Utd,9399,4,14,10,12,48,42,6,52
Queen of S't,9399,5,14,8,14,47,50,-3,50
Dunfermline,9399,6,9,15,12,46,47,-1,42
St Mirren,9399,7,10,10,16,42,57,-15,40
Ayr,9399,8,9,12,15,35,52,-17,39
Raith,9399,9,9,11,16,33,49,-16,38
Dumbarton,9399,10,8,12,16,46,59,-13,36
Hibernian,9400,1,20,11,5,56,24,32,71
Dundee Utd,9400,2,17,9,10,56,35,21,60
Morton,9400,3,16,12,8,50,36,14,60
Falkirk,9400,4,14,11,11,60,50,10,53
Queen of S't,9400,5,13,9,14,53,51,2,48
Dunfermline,9400,6,10,12,14,43,55,-12,42
Raith,9400,7,10,9,17,32,49,-17,39
Dumbarton,9400,8,9,11,16,50,66,-16,38
St Mirren,9400,9,9,11,16,41,58,-17,38
Ayr,9400,10,9,11,16,36,53,-17,38
Hibernian,9401,1,21,11,4,57,22,35,74
Dundee Utd,9401,2,17,10,9,55,38,17,61
Morton,9401,3,15,13,8,52,40,12,58
Falkirk,9401,4,14,10,12,58,47,11,52
Raith,9401,5,12,10,14,41,46,-5,46
Queen of S't,9401,6,11,9,16,41,53,-12,42
Dunfermline,9401,7,9,13,14,41,47,-6,40
Dumbarton,9401,8,9,11,16,47,62,-15,38
St Mirren,9401,9,9,11,16,40,55,-15,38
Ayr,9401,10,8,12,16,31,53,-22,36
Hibernian,9402,1,20,12,4,57,25,32,72
Falkirk,9402,2,17,10,9,56,39,17,61
Morton,9402,3,16,12,8,50,38,12,60
Dundee Utd,9402,4,15,10,11,53,41,12,55
Queen of S't,9402,5,13,10,13,43,45,-2,49
Raith,9402,6,10,10,16,36,49,-13,40
Dunfermline,9402,7,8,14,14,43,49,-6,38
Dumbarton,9402,8,8,13,15,50,58,-8,37
St Mirren,9402,9,9,10,17,38,58,-20,37
Ayr,9402,10,7,13,16,34,58,-24,34
Hibernian,9403,1,20,12,4,59,26,33,72
Falkirk,9403,2,17,10,9,56,38,18,61
Morton,9403,3,15,14,7,52,39,13,59
Dundee Utd,9403,4,16,9,11,52,42,10,57
Queen of S't,9403,5,11,10,15,42,49,-7,43
Dunfermline,9403,6,9,14,13,45,50,-5,41
Dumbarton,9403,7,9,13,14,52,58,-6,40
Raith,9403,8,9,11,16,36,53,-17,38
Ayr,9403,9,8,12,16,34,56,-22,36
St Mirren,9403,10,8,11,17,38,55,-17,35
Hibernian,9404,1,22,10,4,65,27,38,76
Morton,9404,2,18,11,7,53,34,19,65
Falkirk,9404,3,17,9,10,63,39,24,60
Dundee Utd,9404,4,16,9,11,51,38,13,57
Raith,9404,5,11,10,15,38,49,-11,43
Queen of S't,9404,6,10,11,15,41,53,-12,41
Dumbarton,9404,7,9,12,15,46,57,-11,39
Dunfermline,9404,8,9,12,15,40,54,-14,39
St Mirren,9404,9,8,10,18,39,59,-20,34
Ayr,9404,10,7,12,17,31,57,-26,33
Morton,9405,1,20,10,6,58,37,21,70
Hibernian,9405,2,19,11,6,56,29,27,68
Falkirk,9405,3,18,11,7,63,38,25,65
Dundee Utd,9405,4,13,11,12,48,45,3,50
Dunfermline,9405,5,12,11,13,52,51,1,47
Queen of S't,9405,6,12,10,14,46,47,-1,46
St Mirren,9405,7,9,11,16,39,54,-15,38
Raith,9405,8,10,8,18,33,53,-20,38
Ayr,9405,9,7,12,17,31,55,-24,33
Dumbarton,9405,10,7,11,18,46,63,-17,32
Hibernian,9406,1,21,11,4,59,27,32,74
Falkirk,9406,2,16,12,8,59,37,22,60
Morton,9406,3,16,11,9,45,35,10,59
Dundee Utd,9406,4,16,10,10,51,38,13,58
Dunfermline,9406,5,10,13,13,47,47,0,43
Raith,9406,6,11,10,15,39,49,-10,43
Ayr,9406,7,9,12,15,35,54,-19,39
Dumbarton,9406,8,8,13,15,45,58,-13,37
Queen of S't,9406,9,9,10,17,43,61,-18,37
St Mirren,9406,10,8,10,18,39,56,-17,34
Hibernian,9407,1,19,11,6,54,28,26,68
Dundee Utd,9407,2,16,11,9,56,44,12,59
Morton,9407,3,15,12,9,47,39,8,57
Falkirk,9407,4,13,13,10,57,46,11,52
Queen of S't,9407,5,12,11,13,49,48,1,47
Dunfermline,9407,6,10,13,13,50,53,-3,43
Dumbarton,9407,7,10,12,14,51,63,-12,42
Raith,9407,8,10,10,16,33,45,-12,40
St Mirren,9407,9,9,12,15,41,52,-11,39
Ayr,9407,10,8,11,17,34,54,-20,35
Hibernian,9408,1,20,12,4,56,22,34,72
Morton,9408,2,16,13,7,45,33,12,61
Falkirk,9408,3,16,12,8,59,38,21,60
Dundee Utd,9408,4,13,11,12,45,42,3,50
Queen of S't,9408,5,13,9,14,49,49,0,48
Dunfermline,9408,6,9,14,13,43,47,-4,41
Raith,9408,7,10,10,16,34,47,-13,40
Dumbarton,9408,8,9,12,15,47,56,-9,39
Ayr,9408,9,7,14,15,33,56,-23,35
St Mirren,9408,10,7,13,16,35,56,-21,34
Hibernian,9409,1,21,11,4,66,28,38,74
Morton,9409,2,17,10,9,51,39,12,61
Falkirk,9409,3,16,9,11,60,46,14,57
Dundee Utd,9409,4,16,8,12,54,43,11,56
Dunfermline,9409,5,11,11,14,50,52,-2,44
Queen of S't,9409,6,12,8,16,43,53,-10,44
Dumbarton,9409,7,10,10,16,53,65,-12,40
Ayr,9409,8,9,12,15,37,59,-22,39
St Mirren,9409,9,9,11,16,43,57,-14,38
Raith,9409,10,10,8,18,36,51,-15,38
Hibernian,9410,1,20,13,3,64,25,39,73
Falkirk,9410,2,18,11,7,59,35,24,65
Morton,9410,3,16,9,11,50,48,2,57
Dundee Utd,9410,4,15,9,12,48,42,6,54
Queen of S't,9410,5,12,10,14,45,50,-5,46
Raith,9410,6,11,10,15,37,45,-8,43
Dumbarton,9410,7,10,10,16,51,57,-6,40
Dunfermline,9410,8,9,12,15,44,52,-8,39
Ayr,9410,9,9,11,16,34,54,-20,38
St Mirren,9410,10,8,9,19,35,59,-24,33
Hibernian,9411,1,18,13,5,54,27,27,67
Morton,9411,2,18,11,7,53,33,20,65
Dundee Utd,9411,3,17,9,10,48,44,4,60
Falkirk,9411,4,13,12,11,55,45,10,51
Queen of S't,9411,5,12,9,15,45,50,-5,45
Dunfermline,9411,6,10,13,13,46,49,-3,43
Dumbarton,9411,7,10,11,15,45,53,-8,41
Raith,9411,8,9,12,15,35,49,-14,39
St Mirren,9411,9,8,12,16,41,54,-13,36
Ayr,9411,10,8,12,16,34,52,-18,36
Hibernian,9412,1,19,12,5,53,26,27,69
Morton,9412,2,15,13,8,48,39,9,58
Falkirk,9412,3,15,12,9,54,40,14,57
Dundee Utd,9412,4,16,8,12,55,47,8,56
Dunfermline,9412,5,12,12,12,50,45,5,48
Queen of S't,9412,6,12,9,15,46,51,-5,45
Raith,9412,7,10,12,14,35,46,-11,42
Ayr,9412,8,9,11,16,32,52,-20,38
Dumbarton,9412,9,9,10,17,49,61,-12,37
St Mirren,9412,10,7,13,16,40,55,-15,34
Hibernian,9413,1,19,13,4,61,26,35,70
Morton,9413,2,18,12,6,55,37,18,66
Falkirk,9413,3,18,10,8,66,35,31,64
Dundee Utd,9413,4,15,9,12,50,43,7,54
Queen of S't,9413,5,14,9,13,48,51,-3,51
Raith,9413,6,11,9,16,38,48,-10,42
Dunfermline,9413,7,8,14,14,43,48,-5,38
Dumbarton,9413,8,8,11,17,50,67,-17,35
St Mirren,9413,9,8,10,18,38,64,-26,34
Ayr,9413,10,7,11,18,30,60,-30,32
Hibernian,9414,1,20,11,5,58,24,34,71
Morton,9414,2,19,10,7,53,34,19,67
Falkirk,9414,3,16,11,9,56,38,18,59
Dundee Utd,9414,4,15,10,11,49,47,2,55
Raith,9414,5,11,9,16,35,52,-17,42
Dumbarton,9414,6,10,11,15,49,57,-8,41
Dunfermline,9414,7,9,13,14,47,50,-3,40
Queen of S't,9414,8,10,10,16,42,53,-11,40
St Mirren,9414,9,9,10,17,38,54,-16,37
Ayr,9414,10,8,11,17,35,53,-18,35
Hibernian,9415,1,20,11,5,57,28,29,71
Falkirk,9415,2,16,10,10,61,43,18,58
Dundee Utd,9415,3,15,10,11,48,41,7,55
Morton,9415,4,14,13,9,48,43,5,55
Dumbarton,9415,5,11,12,13,48,51,-3,45
Queen of S't,9415,6,11,10,15,40,48,-8,43
Dunfermline,9415,7,9,15,12,46,49,-3,42
St Mirren,9415,8,11,9,16,46,54,-8,42
Raith,9415,9,10,10,16,36,48,-12,40
Ayr,9415,10,7,12,17,31,56,-25,33
Morton,9416,1,18,10,8,51,34,17,64
Hibernian,9416,2,16,14,6,50,30,20,62
Falkirk,9416,3,15,13,8,59,42,17,58
Dundee Utd,9416,4,13,10,13,42,40,2,49
Dunfermline,9416,5,11,13,12,44,44,0,46
Dumbarton,9416,6,11,12,13,52,54,-2,45
Queen of S't,9416,7,11,10,15,47,51,-4,43
Raith,9416,8,9,13,14,33,44,-11,40
Ayr,9416,9,10,10,16,34,56,-22,40
St Mirren,9416,10,7,13,16,40,57,-17,34
Hibernian,9417,1,16,16,4,55,29,26,64
Morton,9417,2,17,13,6,58,38,20,64
Dundee Utd,9417,3,18,9,9,52,37,15,63
Falkirk,9417,4,16,11,9,56,40,16,59
Queen of S't,9417,5,14,9,13,46,47,-1,51
Dunfermline,9417,6,9,12,15,45,51,-6,39
Dumbarton,9417,7,9,11,16,48,58,-10,38
Raith,9417,8,9,11,16,33,47,-14,38
Ayr,9417,9,7,13,16,30,56,-26,34
St Mirren,9417,10,7,11,18,34,54,-20,32
Hibernian,9418,1,17,11,8,54,30,24,62
Morton,9418,2,17,11,8,47,37,10,62
Falkirk,9418,3,16,10,10,58,42,16,58
Dundee Utd,9418,4,15,10,11,52,47,5,55
Raith,9418,5,12,10,14,38,45,-7,46
Ayr,9418,6,10,13,13,38,50,-12,43
Queen of S't,9418,7,11,9,16,47,54,-7,42
Dunfermline,9418,8,9,13,14,40,45,-5,40
Dumbarton,9418,9,9,12,15,47,55,-8,39
St Mirren,9418,10,9,11,16,41,57,-16,38
Hibernian,9419,1,20,12,4,61,29,32,72
Falkirk,9419,2,17,12,7,62,39,23,63
Morton,9419,3,16,11,9,53,41,12,59
Dundee Utd,9419,4,13,11,12,48,45,3,50
Dunfermline,9419,5,11,12,13,51,48,3,45
Raith,9419,6,11,10,15,35,49,-14,43
Queen of S't,9419,7,11,9,16,41,49,-8,42
Dumbarton,9419,8,9,13,14,50,58,-8,40
St Mirren,9419,9,8,12,16,47,62,-15,36
Ayr,9419,10,7,12,17,31,59,-28,33
Hibernian,9420,1,19,13,4,58,26,32,70
Falkirk,9420,2,18,10,8,59,38,21,64
Dundee Utd,9420,3,16,9,11,50,44,6,57
Morton,9420,4,14,14,8,42,32,10,56
Queen of S't,9420,5,14,8,14,47,45,2,50
Ayr,9420,6,10,12,14,36,53,-17,42
Dunfermline,9420,7,9,14,13,42,42,0,41
St Mirren,9420,8,9,10,17,47,60,-13,37
Raith,9420,9,8,10,18,33,56,-23,34
Dumbarton,9420,10,7,12,17,45,63,-18,33
Hibernian,9421,1,19,12,5,55,28,27,69
Dundee Utd,9421,2,19,9,8,55,33,22,66
Morton,9421,3,15,12,9,50,45,5,57
Falkirk,9421,4,14,12,10,53,40,13,54
Dunfermline,9421,5,11,13,12,48,47,1,46
Queen of S't,9421,6,12,9,15,45,48,-3,45
Raith,9421,7,10,10,16,34,45,-11,40
St Mirren,9421,8,8,12,16,38,54,-16,36
Ayr,9421,9,7,15,14,33,54,-21,36
Dumbarton,9421,10,8,10,18,45,62,-17,34
Hibernian,9422,1,21,11,4,59,24,35,74
Morton,9422,2,18,9,9,46,35,11,63
Dundee Utd,9422,3,16,11,9,56,39,17,59
Falkirk,9422,4,15,10,11,58,42,16,55
St Mirren,9422,5,10,12,14,44,52,-8,42
Queen of S't,9422,6,11,9,16,43,54,-11,42
Dumbarton,9422,7,10,10,16,48,62,-14,40
Raith,9422,8,10,9,17,37,52,-15,39
Dunfermline,9422,9,9,11,16,44,54,-10,38
Ayr,9422,10,7,14,15,32,53,-21,35
Hibernian,9423,1,19,12,5,51,23,28,69
Falkirk,9423,2,17,10,9,57,40,17,61
Morton,9423,3,16,12,8,52,39,13,60
Dundee Utd,9423,4,16,8,12,50,46,4,56
Dunfermline,9423,5,10,14,12,49,48,1,44
Ayr,9423,6,11,11,14,41,51,-10,44
Queen of S't,9423,7,11,10,15,42,49,-7,43
Dumbarton,9423,8,10,10,16,48,58,-10,40
Raith,9423,9,9,10,17,34,47,-13,37
St Mirren,9423,10,7,11,18,41,64,-23,32
Hibernian,9424,1,21,10,5,61,24,37,73
Morton,9424,2,18,11,7,54,38,16,65
Dundee Utd,9424,3,16,9,11,47,39,8,57
Falkirk,9424,4,15,10,11,60,43,17,55
Dunfermline,9424,5,10,13,13,43,50,-7,43
Raith,9424,6,11,10,15,40,51,-11,43
Dumbarton,9424,7,10,12,14,50,57,-7,42
Queen of S't,9424,8,10,12,14,41,48,-7,42
Ayr,9424,9,8,12,16,34,56,-22,36
St Mirren,9424,10,6,11,19,37,61,-24,29
Hibernian,9425,1,20,12,4,61,30,31,72
Morton,9425,2,15,12,9,52,41,11,57
Falkirk,9425,3,15,11,10,58,39,19,56
Dundee Utd,9425,4,15,11,10,49,41,8,56
Dunfermline,9425,5,11,12,13,47,50,-3,45
Raith,9425,6,11,10,15,41,51,-10,43
Dumbarton,9425,7,10,11,15,54,62,-8,41
Queen of S't,9425,8,10,10,16,43,58,-15,40
St Mirren,9425,9,9,11,16,39,52,-13,38
Ayr,9425,10,8,12,16,36,56,-20,36
Hibernian,9426,1,22,11,3,58,25,33,77
Morton,9426,2,15,11,10,52,41,11,56
Falkirk,9426,3,15,10,11,55,42,13,55
Dundee Utd,9426,4,14,9,13,42,40,2,51
Dumbarton,9426,5,11,11,14,51,56,-5,44
Queen of S't,9426,6,11,11,14,45,50,-5,44
Dunfermline,9426,7,10,13,13,51,55,-4,43
Raith,9426,8,11,10,15,38,48,-10,43
Ayr,9426,9,9,11,16,34,54,-20,38
St Mirren,9426,10,8,11,17,42,57,-15,35
Hibernian,9427,1,19,11,6,54,28,26,68
Morton,9427,2,17,11,8,48,34,14,62
Dundee Utd,9427,3,17,10,9,56,38,18,61
Falkirk,9427,4,16,11,9,59,41,18,59
Dunfermline,9427,5,12,11,13,51,46,5,47
Queen of S't,9427,6,11,10,15,43,53,-10,43
Dumbarton,9427,7,10,11,15,45,55,-10,41
Raith,9427,8,9,10,17,33,50,-17,37
Ayr,9427,9,8,13,15,32,54,-22,37
St Mirren,9427,10,7,10,19,38,60,-22,31
Hibernian,9428,1,18,11,7,58,32,26,65
Falkirk,9428,2,18,9,9,61,38,23,63
Dundee Utd,9428,3,16,9,11,47,40,7,57
Morton,9428,4,16,9,11,48,42,6,57
Queen of S't,9428,5,12,10,14,48,50,-2,46
Raith,9428,6,12,9,15,37,52,-15,45
Dunfermline,9428,7,11,11,14,46,45,1,44
Dumbarton,9428,8,10,10,16,48,59,-11,40
St Mirren,9428,9,9,10,17,46,59,-13,37
Ayr,9428,10,9,10,17,32,54,-22,37
Hibernian,9429,1,18,12,6,51,28,23,66
Morton,9429,2,18,11,7,49,31,18,65
Falkirk,9429,3,17,10,9,59,41,18,61
Dundee Utd,9429,4,17,9,10,54,37,17,60
Queen of S't,9429,5,12,11,13,47,49,-2,47
Dunfermline,9429,6,9,13,14,42,47,-5,40
Dumbarton,9429,7,10,10,16,53,66,-13,40
St Mirren,9429,8,10,9,17,43,57,-14,39
Raith,9429,9,8,11,17,33,50,-17,35
Ayr,9429,10,8,10,18,36,61,-25,34
Hibernian,9430,1,18,11,7,52,26,26,65
Morton,9430,2,18,10,8,54,36,18,64
Falkirk,9430,3,16,10,10,55,42,13,58
Dundee Utd,9430,4,15,10,11,49,41,8,55
Dunfermline,9430,5,12,12,12,50,49,1,48
St Mirren,9430,6,11,10,15,40,51,-11,43
Queen of S't,9430,7,11,9,16,45,50,-5,42
Ayr,9430,8,10,10,16,32,53,-21,40
Raith,9430,9,9,10,17,32,48,-16,37
Dumbarton,9430,10,8,12,16,44,57,-13,36
Hibernian,9431,1,19,10,7,54,28,26,67
Falkirk,9431,2,17,10,9,58,35,23,61
Morton,9431,3,15,13,8,53,42,11,58
Dundee Utd,9431,4,14,9,13,45,45,0,51
Dunfermline,9431,5,12,12,12,49,47,2,48
St Mirren,9431,6,12,9,15,45,53,-8,45
Queen of S't,9431,7,12,8,16,48,54,-6,44
Raith,9431,8,11,9,16,36,48,-12,42
Dumbarton,9431,9,9,11,16,46,57,-11,38
Ayr,9431,10,8,11,17,37,62,-25,35
Hibernian,9432,1,19,13,4,51,20,31,70
Morton,9432,2,17,12,7,49,33,16,63
Falkirk,9432,3,15,12,9,53,38,15,57
Dundee Utd,9432,4,15,9,12,48,45,3,54
Queen of S't,9432,5,12,9,15,48,46,2,45
Ayr,9432,6,10,12,14,36,52,-16,42
Dunfermline,9432,7,9,14,13,45,50,-5,41
St Mirren,9432,8,10,9,17,38,54,-16,39
Raith,9432,9,9,11,16,34,47,-13,38
Dumbarton,9432,10,8,11,17,47,64,-17,35
Hibernian,9433,1,19,14,3,60,26,34,71
Falkirk,9433,2,17,10,9,61,41,20,61
Morton,9433,3,16,13,7,50,37,13,61
Dundee Utd,9433,4,15,9,12,56,46,10,54
Queen of S't,9433,5,11,9,16,46,56,-10,42
Dumbarton,9433,6,10,11,15,50,59,-9,41
St Mirren,9433,7,10,10,16,41,54,-13,40
Dunfermline,9433,8,8,15,13,45,49,-4,39
Raith,9433,9,9,11,16,34,49,-15,38
Ayr,9433,10,9,10,17,38,64,-26,37
Hibernian,9434,1,19,12,5,53,23,30,69
Dundee Utd,9434,2,16,12,8,57,41,16,60
Morton,9434,3,15,13,8,47,36,11,58
Falkirk,9434,4,14,11,11,56,41,15,53
Queen of S't,9434,5,12,8,16,47,52,-5,44
Ayr,9434,6,10,13,13,36,53,-17,43
Dunfermline,9434,7,10,12,14,43,49,-6,42
Raith,9434,8,11,9,16,36,49,-13,42
St Mirren,9434,9,9,10,17,40,59,-19,37
Dumbarton,9434,10,8,12,16,50,62,-12,36
Hibernian,9435,1,21,11,4,64,26,38,74
Morton,9435,2,17,11,8,50,35,15,62
Dundee Utd,9435,3,16,11,9,54,37,17,59
Falkirk,9435,4,16,10,10,55,39,16,58
Dumbarton,9435,5,10,12,14,51,60,-9,42
Queen of S't,9435,6,10,10,16,43,56,-13,40
St Mirren,9435,7,10,9,17,46,55,-9,39
Dunfermline,9435,8,8,14,14,44,51,-7,38
Ayr,9435,9,9,11,16,33,59,-26,38
Raith,9435,10,9,9,18,33,55,-22,36
Hibernian,9436,1,19,11,6,54,25,29,68
Dundee Utd,9436,2,18,9,9,49,36,13,63
Falkirk,9436,3,15,13,8,54,38,16,58
Morton,9436,4,15,12,9,47,37,10,57
Queen of S't,9436,5,12,11,13,47,48,-1,47
Dunfermline,9436,6,9,15,12,47,48,-1,42
Dumbarton,9436,7,10,11,15,48,58,-10,41
St Mirren,9436,8,9,10,17,44,59,-15,37
Raith,9436,9,8,12,16,36,53,-17,36
Ayr,9436,10,7,12,17,34,58,-24,33
Hibernian,9437,1,19,13,4,58,26,32,70
Dundee Utd,9437,2,18,9,9,57,41,16,63
Morton,9437,3,17,10,9,48,35,13,61
Falkirk,9437,4,15,11,10,57,43,14,56
Dunfermline,9437,5,10,15,11,46,45,1,45
Dumbarton,9437,6,11,11,14,50,58,-8,44
Queen of S't,9437,7,9,12,15,48,56,-8,39
Raith,9437,8,10,9,17,35,51,-16,39
Ayr,9437,9,8,12,16,32,53,-21,36
St Mirren,9437,10,7,10,19,36,59,-23,31
Hibernian,9438,1,20,12,4,61,26,35,72
Morton,9438,2,16,12,8,48,36,12,60
Falkirk,9438,3,16,10,10,60,40,20,58
Dundee Utd,9438,4,16,10,10,48,41,7,58
Queen of S't,9438,5,12,8,16,50,55,-5,44
Ayr,9438,6,11,10,15,40,52,-12,43
Dunfermline,9438,7,8,16,12,42,46,-4,40
St Mirren,9438,8,9,13,14,45,55,-10,40
Dumbarton,9438,9,8,11,17,47,66,-19,35
Raith,9438,10,8,10,18,35,59,-24,34
Hibernian,9439,1,17,12,7,55,29,26,63
Morton,9439,2,17,10,9,51,36,15,61
Falkirk,9439,3,15,12,9,59,41,18,57
Dundee Utd,9439,4,15,10,11,54,41,13,55
Queen of S't,9439,5,11,12,13,42,46,-4,45
Dumbarton,9439,6,11,11,14,49,58,-9,44
Dunfermline,9439,7,9,14,13,49,54,-5,41
Ayr,9439,8,10,10,16,35,60,-25,40
St Mirren,9439,9,9,12,15,45,56,-11,39
Raith,9439,10,9,11,16,31,49,-18,38
Hibernian,9440,1,19,11,6,56,30,26,68
Morton,9440,2,18,11,7,54,35,19,65
Dundee Utd,9440,3,15,13,8,52,40,12,58
Falkirk,9440,4,15,10,11,59,44,15,55
Queen of S't,9440,5,12,10,14,45,51,-6,46
Raith,9440,6,11,10,15,37,47,-10,43
Dumbarton,9440,7,9,13,14,50,59,-9,40
Dunfermline,9440,8,8,14,14,42,50,-8,38
Ayr,9440,9,8,12,16,38,59,-21,36
St Mirren,9440,10,8,10,18,41,59,-18,34
Hibernian,9441,1,21,12,3,57,22,35,75
Morton,9441,2,17,11,8,52,37,15,62
Falkirk,9441,3,17,10,9,61,42,19,61
Dundee Utd,9441,4,16,9,11,48,43,5,57
Dumbarton,9441,5,10,11,15,49,60,-11,41
Raith,9441,6,10,10,16,37,50,-13,40
Dunfermline,9441,7,8,15,13,42,47,-5,39
Queen of S't,9441,8,9,10,17,42,53,-11,37
St Mirren,9441,9,9,10,17,39,53,-14,37
Ayr,9441,10,9,10,17,38,58,-20,37
Hibernian,9442,1,20,12,4,55,25,30,72
Falkirk,9442,2,17,11,8,62,41,21,62
Morton,9442,3,17,11,8,49,34,15,62
Dundee Utd,9442,4,16,11,9,56,41,15,59
Queen of S't,9442,5,13,8,15,53,52,1,47
Dunfermline,9442,6,8,14,14,42,53,-11,38
St Mirren,9442,7,9,11,16,44,57,-13,38
Dumbarton,9442,8,8,13,15,48,64,-16,37
Raith,9442,9,9,8,19,33,51,-18,35
Ayr,9442,10,8,11,17,34,58,-24,35
Hibernian,9443,1,17,15,4,56,28,28,66
Morton,9443,2,16,13,7,52,39,13,61
Dundee Utd,9443,3,16,11,9,52,39,13,59
Falkirk,9443,4,15,11,10,58,40,18,56
Queen of S't,9443,5,12,11,13,44,47,-3,47
Dunfermline,9443,6,11,13,12,49,46,3,46
Dumbarton,9443,7,10,10,16,47,58,-11,40
Raith,9443,8,9,11,16,32,51,-19,38
Ayr,9443,9,8,12,16,33,54,-21,36
St Mirren,9443,10,7,11,18,36,57,-21,32
Hibernian,9444,1,19,12,5,57,27,30,69
Morton,9444,2,16,12,8,50,40,10,60
Falkirk,9444,3,15,12,9,61,41,20,57
Dundee Utd,9444,4,15,10,11,54,46,8,55
Queen of S't,9444,5,13,10,13,48,46,2,49
Dunfermline,9444,6,10,14,12,50,52,-2,44
Ayr,9444,7,9,13,14,35,52,-17,40
Raith,9444,8,9,12,15,35,49,-14,39
St Mirren,9444,9,8,12,16,40,57,-17,36
Dumbarton,9444,10,7,11,18,44,64,-20,32
Hibernian,9445,1,21,12,3,63,29,34,75
Morton,9445,2,16,10,10,54,40,14,58
Falkirk,9445,3,15,11,10,59,42,17,56
Dundee Utd,9445,4,15,10,11,49,42,7,55
Queen of S't,9445,5,13,9,14,48,49,-1,48
Dunfermline,9445,6,10,13,13,44,48,-4,43
Dumbarton,9445,7,10,12,14,46,53,-7,42
St Mirren,9445,8,10,9,17,43,58,-15,39
Raith,9445,9,10,8,18,35,57,-22,38
Ayr,9445,10,8,10,18,33,56,-23,34
Morton,9446,1,19,9,8,50,35,15,66
Hibernian,9446,2,18,11,7,55,31,24,65
Falkirk,9446,3,17,10,9,67,45,22,61
Dundee Utd,9446,4,14,9,13,49,45,4,51
Queen of S't,9446,5,14,8,14,50,52,-2,50
Dunfermline,9446,6,12,12,12,53,45,8,48
Dumbarton,9446,7,11,10,15,49,58,-9,43
Raith,9446,8,10,8,18,33,51,-18,38
St Mirren,9446,9,9,9,18,39,59,-20,36
Ayr,9446,10,8,10,18,31,55,-24,34
Hibernian,9447,1,19,11,6,54,26,28,68
Morton,9447,2,16,13,7,51,34,17,61
Dundee Utd,9447,3,17,9,10,54,40,14,60
Falkirk,9447,4,15,12,9,61,42,19,57
Raith,9447,5,11,12,13,36,45,-9,45
Queen of S't,9447,6,10,11,15,44,50,-6,41
Dumbarton,9447,7,10,10,16,46,63,-17,40
Dunfermline,9447,8,8,15,13,43,51,-8,39
Ayr,9447,9,8,12,16,33,54,-21,36
St Mirren,9447,10,8,11,17,38,55,-17,35
Hibernian,9448,1,20,11,5,59,27,32,71
Morton,9448,2,17,12,7,51,37,14,63
Dundee Utd,9448,3,17,10,9,53,39,14,61
Falkirk,9448,4,15,12,9,57,40,17,57
Raith,9448,5,12,9,15,39,48,-9,45
Queen of S't,9448,6,10,11,15,41,48,-7,41
Ayr,9448,7,9,13,14,38,54,-16,40
Dumbarton,9448,8,8,14,14,45,55,-10,38
Dunfermline,9448,8,9,11,16,45,55,-10,38
St Mirren,9448,10,6,11,19,38,63,-25,29
Hibernian,9449,1,20,11,5,62,26,36,71
Morton,9449,2,16,14,6,49,36,13,62
Dundee Utd,9449,3,17,10,9,56,38,18,61
Falkirk,9449,4,17,9,10,60,45,15,60
Queen of S't,9449,5,12,10,14,43,49,-6,46
Dunfermline,9449,6,10,11,15,46,45,1,41
Dumbarton,9449,7,8,13,15,46,59,-13,37
Raith,9449,8,9,9,18,34,51,-17,36
St Mirren,9449,9,9,9,18,41,62,-21,36
Ayr,9449,10,8,12,16,36,62,-26,36
Hibernian,9450,1,18,11,7,58,34,24,65
Morton,9450,2,17,13,6,51,33,18,64
Dundee Utd,9450,3,16,10,10,49,45,4,58
Falkirk,9450,4,15,9,12,57,47,10,54
Queen of S't,9450,5,14,9,13,49,48,1,51
Dunfermline,9450,6,10,13,13,47,49,-2,43
Dumbarton,9450,7,10,11,15,48,55,-7,41
Raith,9450,8,10,10,16,34,49,-15,40
St Mirren,9450,9,9,10,17,40,54,-14,37
Ayr,9450,10,7,12,17,38,57,-19,33
Hibernian,9451,1,20,11,5,55,25,30,71
Morton,9451,2,18,12,6,52,34,18,66
Falkirk,9451,3,17,11,8,58,37,21,62
Dundee Utd,9451,4,15,11,10,51,40,11,56
Raith,9451,5,10,12,14,35,45,-10,42
Dunfermline,9451,6,9,13,14,46,53,-7,40
Queen of S't,9451,7,10,9,17,42,52,-10,39
Ayr,9451,8,9,12,15,35,51,-16,39
Dumbarton,9451,9,8,11,17,43,60,-17,35
St Mirren,9451,10,8,10,18,37,57,-20,34
Hibernian,9452,1,21,11,4,61,25,36,74
Morton,9452,2,18,10,8,59,40,19,64
Falkirk,9452,3,17,9,10,56,39,17,60
Dundee Utd,9452,4,15,10,11,50,46,4,55
Dunfermline,9452,5,10,14,12,46,47,-1,44
Queen of S't,9452,6,11,9,16,41,50,-9,42
Dumbarton,9452,7,10,10,16,46,57,-11,40
Ayr,9452,8,8,13,15,33,53,-20,37
St Mirren,9452,9,8,11,17,40,57,-17,35
Raith,9452,10,8,11,17,35,53,-18,35
Hibernian,9453,1,19,12,5,56,27,29,69
Morton,9453,2,19,10,7,53,36,17,67
Dundee Utd,9453,3,18,9,9,55,40,15,63
Falkirk,9453,4,14,11,11,53,42,11,53
Queen of S't,9453,5,13,8,15,45,49,-4,47
Dunfermline,9453,6,10,12,14,47,50,-3,42
Dumbarton,9453,7,10,10,16,49,62,-13,40
Raith,9453,8,9,11,16,35,50,-15,38
St Mirren,9453,9,8,11,17,41,56,-15,35
Ayr,9453,10,7,12,17,33,55,-22,33
Morton,9454,1,18,12,6,50,31,19,66
Dundee Utd,9454,2,18,9,9,56,42,14,63
Hibernian,9454,3,15,15,6,49,29,20,60
Falkirk,9454,4,15,11,10,62,46,16,56
Dunfermline,9454,5,11,11,14,49,51,-2,44
Raith,9454,6,11,11,14,39,46,-7,44
Queen of S't,9454,7,11,10,15,45,51,-6,43
St Mirren,9454,8,8,13,15,40,53,-13,37
Dumbarton,9454,9,8,11,17,50,66,-16,35
Ayr,9454,10,7,13,16,32,57,-25,34
Hibernian,9455,1,19,13,4,54,25,29,70
Morton,9455,2,18,10,8,54,38,16,64
Falkirk,9455,3,16,11,9,61,40,21,59
Dundee Utd,9455,4,13,13,10,49,44,5,52
Dunfermline,9455,5,10,15,11,46,46,0,45
Raith,9455,6,11,10,15,34,45,-11,43
Queen of S't,9455,7,11,9,16,46,53,-7,42
St Mirren,9455,8,8,13,15,36,51,-15,37
Ayr,9455,9,8,12,16,36,57,-21,36
Dumbarton,9455,10,7,12,17,45,62,-17,33
Hibernian,9456,1,21,11,4,62,26,36,74
Falkirk,9456,2,17,10,9,60,43,17,61
Dundee Utd,9456,3,15,10,11,47,39,8,55
Morton,9456,4,14,9,13,45,42,3,51
Dunfermline,9456,5,11,13,12,47,45,2,46
Queen of S't,9456,6,12,10,14,44,48,-4,46
Raith,9456,7,11,11,14,35,45,-10,44
Dumbarton,9456,8,8,14,14,47,58,-11,38
St Mirren,9456,9,8,12,16,39,55,-16,36
Ayr,9456,10,8,10,18,30,55,-25,34
Hibernian,9457,1,19,12,5,52,24,28,69
Morton,9457,2,17,12,7,49,34,15,63
Falkirk,9457,3,14,12,10,58,46,12,54
Dunfermline,9457,4,12,12,12,50,48,2,48
Dundee Utd,9457,5,12,10,14,45,45,0,46
Queen of S't,9457,6,12,8,16,47,50,-3,44
Raith,9457,7,10,12,14,37,48,-11,42
Ayr,9457,8,10,12,14,38,53,-15,42
St Mirren,9457,9,9,13,14,45,52,-7,40
Dumbarton,9457,10,8,11,17,42,63,-21,35
Hibernian,9458,1,20,11,5,56,26,30,71
Morton,9458,2,15,13,8,46,34,12,58
Falkirk,9458,3,14,12,10,53,40,13,54
Dundee Utd,9458,4,14,11,11,42,37,5,53
Queen of S't,9458,5,13,10,13,50,46,4,49
Dunfermline,9458,6,12,13,11,48,44,4,49
Raith,9458,7,9,11,16,37,52,-15,38
St Mirren,9458,8,9,10,17,37,56,-19,37
Ayr,9458,9,8,13,15,37,57,-20,37
Dumbarton,9458,10,8,12,16,46,60,-14,36
Hibernian,9459,1,19,11,6,53,28,25,68
Morton,9459,2,18,10,8,52,36,16,64
Dundee Utd,9459,3,17,11,8,50,36,14,62
Falkirk,9459,4,15,12,9,61,42,19,57
St Mirren,9459,5,11,9,16,48,55,-7,42
Queen of S't,9459,6,10,11,15,43,50,-7,41
Dunfermline,9459,7,8,14,14,45,51,-6,38
Dumbarton,9459,8,8,13,15,44,56,-12,37
Ayr,9459,9,8,13,15,31,56,-25,37
Raith,9459,10,8,12,16,34,51,-17,36
Hibernian,9460,1,19,14,3,53,23,30,71
Morton,9460,2,17,10,9,54,37,17,61
Falkirk,9460,3,15,13,8,56,40,16,58
Dundee Utd,9460,4,14,11,11,45,41,4,53
Queen of S't,9460,5,11,11,14,45,49,-4,44
Raith,9460,6,11,11,14,36,44,-8,44
Dunfermline,9460,7,10,13,13,49,50,-1,43
Dumbarton,9460,8,8,13,15,43,56,-13,37
Ayr,9460,9,8,13,15,35,54,-19,37
St Mirren,9460,10,7,11,18,34,56,-22,32
Hibernian,9461,1,18,13,5,53,25,28,67
Dundee Utd,9461,2,18,9,9,55,39,16,63
Morton,9461,3,17,11,8,51,37,14,62
Falkirk,9461,4,15,10,11,59,42,17,55
Dunfermline,9461,5,11,12,13,44,45,-1,45
Dumbarton,9461,6,11,10,15,49,58,-9,43
Queen of S't,9461,7,10,11,15,44,54,-10,41
Raith,9461,8,10,10,16,34,48,-14,40
St Mirren,9461,9,9,9,18,42,62,-20,36
Ayr,9461,10,7,13,16,33,54,-21,34
Hibernian,9462,1,18,13,5,53,26,27,67
Falkirk,9462,2,17,12,7,62,37,25,63
Morton,9462,3,17,12,7,57,40,17,63
Dundee Utd,9462,4,16,9,11,61,48,13,57
Dunfermline,9462,5,10,14,12,50,51,-1,44
Dumbarton,9462,6,11,11,14,51,57,-6,44
Raith,9462,7,10,9,17,37,48,-11,39
Queen of S't,9462,8,10,9,17,41,57,-16,39
Ayr,9462,9,8,12,16,37,61,-24,36
St Mirren,9462,10,7,11,18,38,62,-24,32
Hibernian,9463,1,20,11,5,57,27,30,71
Morton,9463,2,15,12,9,49,40,9,57
Falkirk,9463,3,14,14,8,55,39,16,56
Dundee Utd,9463,4,14,10,12,50,45,5,52
Queen of S't,9463,5,14,9,13,50,50,0,51
Ayr,9463,6,12,11,13,40,52,-12,47
Dunfermline,9463,7,10,13,13,51,51,0,43
Dumbarton,9463,8,10,11,15,47,55,-8,41
Raith,9463,9,8,10,18,32,52,-20,34
St Mirren,9463,10,7,11,18,36,56,-20,32
Hibernian,9464,1,19,14,3,62,27,35,71
Morton,9464,2,17,12,7,54,38,16,63
Dundee Utd,9464,3,16,12,8,53,37,16,60
Falkirk,9464,4,15,12,9,58,39,19,57
Queen of S't,9464,5,12,10,14,51,56,-5,46
Dunfermline,9464,6,9,12,15,49,57,-8,39
Dumbarton,9464,7,9,12,15,49,60,-11,39
Raith,9464,8,9,11,16,34,49,-15,38
Ayr,9464,9,8,13,15,38,57,-19,37
St Mirren,9464,10,7,10,19,36,64,-28,31
Falkirk,9465,1,19,9,8,64,35,29,66
Hibernian,9465,2,18,12,6,55,32,23,66
Morton,9465,3,18,10,8,49,34,15,64
Dundee Utd,9465,4,18,9,9,53,38,15,63
Queen of S't,9465,5,12,8,16,43,55,-12,44
Dunfermline,9465,6,10,13,13,41,45,-4,43
Raith,9465,7,10,10,16,32,46,-14,40
Dumbarton,9465,8,9,11,16,46,59,-13,38
Ayr,9465,9,8,10,18,39,58,-19,34
St Mirren,9465,10,7,10,19,37,57,-20,31
Hibernian,9466,1,19,12,5,57,28,29,69
Morton,9466,2,15,15,6,50,36,14,60
Dundee Utd,9466,3,16,11,9,54,45,9,59
Falkirk,9466,4,16,9,11,57,42,15,57
Dunfermline,9466,5,10,14,12,47,47,0,44
Raith,9466,6,11,9,16,42,51,-9,42
Queen of S't,9466,7,10,10,16,43,52,-9,40
Dumbarton,9466,8,8,15,13,50,61,-11,39
Ayr,9466,9,8,12,16,34,57,-23,36
St Mirren,9466,10,8,11,17,41,56,-15,35
Hibernian,9467,1,19,11,6,55,30,25,68
Morton,9467,2,17,11,8,52,36,16,62
Dundee Utd,9467,3,17,11,8,50,35,15,62
Falkirk,9467,4,16,10,10,60,44,16,58
Raith,9467,5,12,8,16,39,47,-8,44
Dunfermline,9467,6,10,13,13,45,47,-2,43
Queen of S't,9467,7,11,10,15,46,52,-6,43
Dumbarton,9467,8,9,13,14,53,62,-9,40
Ayr,9467,9,7,14,15,40,59,-19,35
St Mirren,9467,10,7,9,20,35,63,-28,30
Hibernian,9468,1,20,13,3,57,23,34,73
Morton,9468,2,16,12,8,49,35,14,60
Falkirk,9468,3,16,11,9,59,40,19,59
Dundee Utd,9468,4,15,10,11,49,40,9,55
Queen of S't,9468,5,12,9,15,46,53,-7,45
Dumbarton,9468,6,10,11,15,51,56,-5,41
Raith,9468,7,11,8,17,37,50,-13,41
Dunfermline,9468,8,9,13,14,45,52,-7,40
St Mirren,9468,9,9,10,17,39,54,-15,37
Ayr,9468,10,8,11,17,32,61,-29,35
Hibernian,9469,1,17,14,5,56,31,25,65
Morton,9469,2,18,10,8,54,40,14,64
Dundee Utd,9469,3,17,10,9,56,40,16,61
Falkirk,9469,4,15,14,7,62,39,23,59
Raith,9469,5,11,10,15,39,53,-14,43
Dunfermline,9469,6,9,14,13,47,50,-3,41
Queen of S't,9469,7,9,12,15,42,51,-9,39
St Mirren,9469,8,10,9,17,46,63,-17,39
Dumbarton,9469,9,8,12,16,50,66,-16,36
Ayr,9469,10,8,11,17,36,55,-19,35
Hibernian,9470,1,20,12,4,60,26,34,72
Dundee Utd,9470,2,17,11,8,49,37,12,62
Morton,9470,3,16,12,8,52,36,16,60
Falkirk,9470,4,16,11,9,58,40,18,59
Queen of S't,9470,5,12,8,16,45,51,-6,44
Dunfermline,9470,6,9,13,14,46,52,-6,40
Raith,9470,7,10,9,17,35,52,-17,39
Ayr,9470,8,9,12,15,40,58,-18,39
St Mirren,9470,9,8,12,16,42,56,-14,36
Dumbarton,9470,10,7,12,17,48,67,-19,33
Hibernian,9471,1,20,11,5,61,24,37,71
Dundee Utd,9471,2,18,9,9,61,43,18,63
Falkirk,9471,3,17,10,9,57,40,17,61
Morton,9471,4,14,11,11,47,42,5,53
Raith,9471,5,10,11,15,34,48,-14,41
Queen of S't,9471,6,10,10,16,44,57,-13,40
Ayr,9471,7,9,13,14,34,52,-18,40
Dunfermline,9471,8,8,15,13,43,46,-3,39
Dumbarton,9471,9,9,12,15,48,61,-13,39
St Mirren,9471,10,9,10,17,42,58,-16,37
Hibernian,9472,1,17,15,4,52,26,26,66
Falkirk,9472,2,17,11,8,59,38,21,62
Dundee Utd,9472,3,18,8,10,49,37,12,62
Morton,9472,4,15,13,8,49,38,11,58
Queen of S't,9472,5,12,10,14,43,47,-4,46
Raith,9472,6,12,8,16,36,47,-11,44
Dumbarton,9472,7,10,12,14,50,57,-7,42
Dunfermline,9472,8,9,12,15,45,48,-3,39
St Mirren,9472,9,8,10,18,38,58,-20,34
Ayr,9472,10,6,13,17,31,56,-25,31
Hibernian,9473,1,19,13,4,63,29,34,70
Falkirk,9473,2,17,10,9,57,40,17,61
Morton,9473,3,16,11,9,46,38,8,59
Dundee Utd,9473,4,15,9,12,47,41,6,54
Dunfermline,9473,5,11,12,13,48,50,-2,45
Dumbarton,9473,6,11,11,14,49,56,-7,44
Raith,9473,7,11,9,16,44,49,-5,42
Queen of S't,9473,8,10,10,16,40,52,-12,40
Ayr,9473,9,8,13,15,32,52,-20,37
St Mirren,9473,10,8,10,18,40,59,-19,34
Hibernian,9474,1,19,13,4,60,25,35,70
Falkirk,9474,2,17,11,8,57,40,17,62
Morton,9474,3,17,10,9,50,45,5,61
Dundee Utd,9474,4,15,9,12,52,44,8,54
Dumbarton,9474,5,11,12,13,50,55,-5,45
Dunfermline,9474,6,10,12,14,52,50,2,42
Queen of S't,9474,7,10,11,15,45,54,-9,41
St Mirren,9474,8,9,11,16,43,57,-14,38
Raith,9474,9,10,8,18,35,55,-20,38
Ayr,9474,10,8,11,17,34,53,-19,35
Hibernian,9475,1,18,12,6,54,28,26,66
Morton,9475,2,18,12,6,50,33,17,66
Dundee Utd,9475,3,17,9,10,46,36,10,60
Falkirk,9475,4,14,12,10,61,44,17,54
Queen of S't,9475,5,13,10,13,57,51,6,49
St Mirren,9475,6,10,11,15,41,51,-10,41
Dunfermline,9475,7,9,13,14,48,49,-1,40
Raith,9475,8,9,10,17,33,54,-21,37
Dumbarton,9475,9,7,14,15,44,64,-20,35
Ayr,9475,10,8,11,17,32,56,-24,35
Hibernian,9476,1,19,11,6,55,29,26,68
Dundee Utd,9476,2,16,11,9,47,38,9,59
Morton,9476,3,16,10,10,47,36,11,58
Falkirk,9476,4,15,12,9,56,37,19,57
Dumbarton,9476,5,11,12,13,47,53,-6,45
Raith,9476,6,11,10,15,33,44,-11,43
Queen of S't,9476,7,11,9,16,46,55,-9,42
St Mirren,9476,8,10,11,15,43,51,-8,41
Dunfermline,9476,9,8,15,13,42,47,-5,39
Ayr,9476,10,6,13,17,35,61,-26,31
Hibernian,9477,1,20,12,4,58,26,32,72
Morton,9477,2,16,13,7,50,35,15,61
Falkirk,9477,3,16,12,8,62,42,20,60
Dundee Utd,9477,4,14,10,12,48,43,5,52
Queen of S't,9477,5,12,10,14,50,54,-4,46
Dunfermline,9477,6,9,16,11,50,52,-2,43
Raith,9477,7,9,12,15,35,49,-14,39
Dumbarton,9477,8,9,11,16,49,62,-13,38
Ayr,9477,9,8,12,16,35,57,-22,36
St Mirren,9477,10,8,10,18,38,55,-17,34
Hibernian,9478,1,19,11,6,58,26,32,68
Dundee Utd,9478,2,17,10,9,54,41,13,61
Morton,9478,3,17,10,9,49,41,8,61
Falkirk,9478,4,15,12,9,60,46,14,57
Queen of S't,9478,5,12,9,15,50,56,-6,45
Dumbarton,9478,6,11,11,14,54,58,-4,44
Dunfermline,9478,7,9,13,14,50,49,1,40
St Mirren,9478,8,10,9,17,40,53,-13,39
Raith,9478,9,9,10,17,35,57,-22,37
Ayr,9478,10,8,11,17,32,55,-23,35
Hibernian,9479,1,22,10,4,67,30,37,76
Morton,9479,2,19,9,8,57,39,18,66
Dundee Utd,9479,3,17,9,10,51,40,11,60
Falkirk,9479,4,15,11,10,58,44,14,56
Dumbarton,9479,5,12,11,13,55,56,-1,47
Queen of S't,9479,6,11,9,16,44,52,-8,42
Dunfermline,9479,7,9,13,14,46,49,-3,40
Raith,9479,8,10,9,17,39,56,-17,39
St Mirren,9479,9,8,10,18,36,59,-23,34
Ayr,9479,10,6,11,19,32,60,-28,29
Hibernian,9480,1,20,11,5,55,22,33,71
Morton,9480,2,17,9,10,53,39,14,60
Dundee Utd,9480,3,15,11,10,50,41,9,56
Falkirk,9480,4,15,10,11,60,47,13,55
Queen of S't,9480,5,12,10,14,46,51,-5,46
Dunfermline,9480,6,10,12,14,47,53,-6,42
Raith,9480,7,10,12,14,38,48,-10,42
Dumbarton,9480,8,10,11,15,51,59,-8,41
Ayr,9480,9,10,11,15,35,53,-18,41
St Mirren,9480,10,7,11,18,39,61,-22,32
Hibernian,9481,1,19,12,5,58,29,29,69
Morton,9481,2,17,11,8,47,37,10,62
Falkirk,9481,3,17,10,9,58,38,20,61
Dundee Utd,9481,4,16,9,11,52,38,14,57
Queen of S't,9481,5,12,9,15,43,49,-6,45
Raith,9481,6,12,9,15,39,57,-18,45
Dunfermline,9481,7,10,13,13,55,49,6,43
Ayr,9481,8,8,13,15,37,56,-19,37
Dumbarton,9481,9,8,12,16,49,65,-16,36
St Mirren,9481,10,7,10,19,40,60,-20,31
Hibernian,9482,1,18,14,4,58,24,34,68
Morton,9482,2,17,12,7,51,32,19,63
Falkirk,9482,3,17,11,8,61,40,21,62
Dundee Utd,9482,4,16,10,10,53,42,11,58
Queen of S't,9482,5,12,9,15,47,54,-7,45
Dunfermline,9482,6,9,14,13,44,49,-5,41
Raith,9482,7,10,9,17,35,52,-17,39
St Mirren,9482,8,9,11,16,39,52,-13,38
Ayr,9482,9,9,10,17,33,58,-25,37
Dumbarton,9482,10,7,12,17,47,65,-18,33
Hibernian,9483,1,20,11,5,61,27,34,71
Morton,9483,2,18,11,7,51,34,17,65
Falkirk,9483,3,17,9,10,61,41,20,60
Dundee Utd,9483,4,15,11,10,52,41,11,56
Queen of S't,9483,5,12,8,16,46,52,-6,44
Dunfermline,9483,6,10,12,14,45,49,-4,42
Raith,9483,7,11,9,16,38,50,-12,42
Dumbarton,9483,8,9,12,15,51,63,-12,39
Ayr,9483,9,8,11,17,31,54,-23,35
St Mirren,9483,10,8,10,18,42,67,-25,34
Hibernian,9484,1,20,10,6,59,25,34,70
Dundee Utd,9484,2,17,10,9,50,35,15,61
Morton,9484,3,17,10,9,52,40,12,61
Falkirk,9484,4,16,11,9,60,44,16,59
Queen of S't,9484,5,11,11,14,47,53,-6,44
Dunfermline,9484,6,10,12,14,49,52,-3,42
Raith,9484,7,11,8,17,34,55,-21,41
Dumbarton,9484,8,9,13,14,51,59,-8,40
Ayr,9484,9,9,12,15,38,56,-18,39
St Mirren,9484,10,7,9,20,39,60,-21,30
Hibernian,9485,1,22,10,4,58,25,33,76
Morton,9485,2,17,10,9,54,40,14,61
Falkirk,9485,3,16,11,9,57,38,19,59
Dundee Utd,9485,4,15,8,13,49,47,2,53
Dunfermline,9485,5,10,15,11,53,47,6,45
Queen of S't,9485,6,11,10,15,43,50,-7,43
Raith,9485,7,10,10,16,36,52,-16,40
Dumbarton,9485,8,8,13,15,46,60,-14,37
St Mirren,9485,9,9,9,18,48,64,-16,36
Ayr,9485,10,8,12,16,38,59,-21,36
Hibernian,9486,1,19,13,4,55,25,30,70
Morton,9486,2,16,12,8,52,37,15,60
Falkirk,9486,3,16,10,10,56,43,13,58
Dundee Utd,9486,4,16,9,11,51,38,13,57
Queen of S't,9486,5,12,11,13,50,53,-3,47
Dunfermline,9486,6,11,11,14,52,54,-2,44
St Mirren,9486,7,9,12,15,42,53,-11,39
Dumbarton,9486,8,9,11,16,50,59,-9,38
Raith,9486,9,9,11,16,37,55,-18,38
Ayr,9486,10,6,14,16,30,58,-28,32
Morton,9487,1,18,10,8,48,37,11,64
Hibernian,9487,2,16,14,6,50,26,24,62
Falkirk,9487,3,15,11,10,57,39,18,56
Dundee Utd,9487,4,15,8,13,52,46,6,53
Ayr,9487,5,12,11,13,42,51,-9,47
Queen of S't,9487,6,12,9,15,48,54,-6,45
Dunfermline,9487,7,9,14,13,43,47,-4,41
Dumbarton,9487,8,10,10,16,44,59,-15,40
St Mirren,9487,9,9,11,16,40,52,-12,38
Raith,9487,10,8,14,14,32,45,-13,38
Hibernian,9488,1,22,10,4,64,29,35,76
Falkirk,9488,2,17,10,9,59,41,18,61
Morton,9488,3,17,10,9,52,37,15,61
Dundee Utd,9488,4,17,9,10,59,43,16,60
Dunfermline,9488,5,10,13,13,46,51,-5,43
Queen of S't,9488,6,10,10,16,47,54,-7,40
Raith,9488,7,10,10,16,37,53,-16,40
Ayr,9488,8,8,12,16,33,57,-24,36
Dumbarton,9488,9,8,11,17,46,60,-14,35
St Mirren,9488,10,8,11,17,41,59,-18,35
Hibernian,9489,1,19,12,5,53,25,28,69
Dundee Utd,9489,2,17,9,10,49,38,11,60
Morton,9489,3,16,11,9,49,34,15,59
Falkirk,9489,4,15,10,11,59,44,15,55
Queen of S't,9489,5,12,10,14,46,48,-2,46
Dunfermline,9489,6,11,11,14,48,53,-5,44
Raith,9489,7,11,9,16,36,51,-15,42
Dumbarton,9489,8,10,10,16,53,60,-7,40
St Mirren,9489,9,10,9,17,41,57,-16,39
Ayr,9489,10,8,11,17,31,55,-24,35
Morton,9490,1,20,11,5,54,32,22,71
Hibernian,9490,2,19,12,5,53,24,29,69
Falkirk,9490,3,15,11,10,55,42,13,56
Dundee Utd,9490,4,15,11,10,51,41,10,56
Dumbarton,9490,5,11,11,14,47,53,-6,44
Queen of S't,9490,6,11,10,15,45,50,-5,43
Raith,9490,7,11,9,16,33,47,-14,42
Dunfermline,9490,8,9,13,14,46,50,-4,40
Ayr,9490,9,6,14,16,32,56,-24,32
St Mirren,9490,10,7,10,19,37,58,-21,31
Hibernian,9491,1,20,12,4,54,22,32,72
Morton,9491,2,17,12,7,59,40,19,63
Falkirk,9491,3,16,11,9,55,36,19,59
Dundee Utd,9491,4,14,10,12,49,42,7,52
Queen of S't,9491,5,11,10,15,44,52,-8,43
Dunfermline,9491,6,10,12,14,43,49,-6,42
Dumbarton,9491,7,9,13,14,46,54,-8,40
Raith,9491,8,10,10,16,32,46,-14,40
Ayr,9491,9,9,11,16,36,57,-21,38
St Mirren,9491,10,8,11,17,37,57,-20,35
Hibernian,9492,1,18,10,8,51,29,22,64
Falkirk,9492,2,17,9,10,57,42,15,60
Dundee Utd,9492,3,16,10,10,53,41,12,58
Morton,9492,4,14,12,10,44,39,5,54
Queen of S't,9492,5,13,10,13,46,46,0,49
Raith,9492,6,12,11,13,41,47,-6,47
Dunfermline,9492,7,9,15,12,44,47,-3,42
Ayr,9492,8,9,14,13,42,55,-13,41
Dumbarton,9492,9,8,12,16,46,60,-14,36
St Mirren,9492,10,7,11,18,40,58,-18,32
Hibernian,9493,1,21,11,4,56,22,34,74
Dundee Utd,9493,2,17,9,10,54,38,16,60
Morton,9493,3,16,11,9,47,42,5,59
Falkirk,9493,4,13,12,11,56,45,11,51
Dunfermline,9493,5,11,13,12,45,45,0,46
Queen of S't,9493,6,10,12,14,44,51,-7,42
Raith,9493,7,9,12,15,35,48,-13,39
Ayr,9493,8,9,12,15,34,52,-18,39
Dumbarton,9493,9,7,15,14,46,58,-12,36
St Mirren,9493,10,7,13,16,42,58,-16,34
Hibernian,9494,1,19,12,5,58,27,31,69
Morton,9494,2,16,12,8,48,33,15,60
Falkirk,9494,3,16,11,9,64,46,18,59
Dundee Utd,9494,4,16,10,10,48,40,8,58
Queen of S't,9494,5,11,11,14,46,53,-7,44
Dumbarton,9494,6,10,12,14,52,58,-6,42
Raith,9494,7,10,11,15,35,50,-15,41
Ayr,9494,8,9,12,15,36,54,-18,39
Dunfermline,9494,9,9,11,16,42,49,-7,38
St Mirren,9494,10,7,12,17,39,58,-19,33
Morton,9495,1,17,12,7,53,45,8,63
Falkirk,9495,2,17,11,8,57,36,21,62
Dundee Utd,9495,3,16,11,9,50,40,10,59
Hibernian,9495,4,15,13,8,51,32,19,58
Queen of S't,9495,5,11,11,14,51,53,-2,44
Dunfermline,9495,6,9,15,12,53,49,4,42
Raith,9495,7,11,9,16,35,49,-14,42
Ayr,9495,8,9,12,15,33,53,-20,39
St Mirren,9495,9,9,10,17,42,57,-15,37
Dumbarton,9495,10,8,12,16,51,62,-11,36
Hibernian,9496,1,17,13,6,52,24,28,64
Morton,9496,2,17,12,7,55,39,16,63
Falkirk,9496,3,17,9,10,57,36,21,60
Dundee Utd,9496,4,16,10,10,54,43,11,58
Queen of S't,9496,5,11,11,14,45,52,-7,44
Dunfermline,9496,6,10,13,13,48,57,-9,43
Dumbarton,9496,7,10,11,15,52,58,-6,41
Raith,9496,8,10,11,15,34,49,-15,41
St Mirren,9496,9,9,12,15,40,51,-11,39
Ayr,9496,10,6,12,18,32,60,-28,30
Hibernian,9497,1,18,13,5,56,25,31,67
Falkirk,9497,2,16,11,9,58,41,17,59
Morton,9497,3,14,13,9,45,40,5,55
Dundee Utd,9497,4,13,9,14,46,49,-3,48
Queen of S't,9497,5,12,10,14,45,48,-3,46
Dunfermline,9497,6,10,14,12,45,45,0,44
Raith,9497,7,10,12,14,38,48,-10,42
Dumbarton,9497,8,9,13,14,50,57,-7,40
St Mirren,9497,9,10,10,16,44,54,-10,40
Ayr,9497,10,9,13,14,38,58,-20,40
Hibernian,9498,1,20,12,4,56,23,33,72
Morton,9498,2,19,10,7,56,37,19,67
Falkirk,9498,3,15,11,10,56,41,15,56
Dundee Utd,9498,4,15,10,11,45,39,6,55
St Mirren,9498,5,11,9,16,40,52,-12,42
Queen of S't,9498,6,10,11,15,41,49,-8,41
Dunfermline,9498,7,8,14,14,44,50,-6,38
Dumbarton,9498,8,9,11,16,47,57,-10,38
Raith,9498,9,9,11,16,32,48,-16,38
Ayr,9498,10,8,13,15,33,54,-21,37
Hibernian,9499,1,19,11,6,58,27,31,68
Falkirk,9499,2,17,10,9,63,44,19,61
Morton,9499,3,17,10,9,51,45,6,61
Dundee Utd,9499,4,16,10,10,50,40,10,58
Queen of S't,9499,5,13,9,14,48,51,-3,48
Dunfermline,9499,6,9,13,14,49,50,-1,40
Raith,9499,7,10,10,16,38,52,-14,40
St Mirren,9499,8,9,11,16,44,58,-14,38
Dumbarton,9499,9,8,13,15,46,58,-12,37
Ayr,9499,10,8,11,17,36,58,-22,35
Hibernian,9500,1,20,12,4,62,31,31,72
Falkirk,9500,2,17,10,9,58,42,16,61
Morton,9500,3,17,10,9,56,46,10,61
Dundee Utd,9500,4,15,8,13,49,47,2,53
Queen of S't,9500,5,13,9,14,49,51,-2,48
Dumbarton,9500,6,11,10,15,54,59,-5,43
St Mirren,9500,7,10,11,15,45,52,-7,41
Dunfermline,9500,8,9,11,16,47,53,-6,38
Raith,9500,9,9,10,17,37,54,-17,37
Ayr,9500,10,8,11,17,37,59,-22,35
Hibernian,9501,1,19,12,5,58,26,32,69
Falkirk,9501,2,18,9,9,62,41,21,63
Morton,9501,3,16,11,9,45,35,10,59
Dundee Utd,9501,4,15,9,12,49,43,6,54
Queen of S't,9501,5,12,11,13,43,46,-3,47
Dunfermline,9501,6,11,13,12,43,43,0,46
St Mirren,9501,7,10,9,17,48,56,-8,39
Ayr,9501,8,9,11,16,33,56,-23,38
Dumbarton,9501,9,8,13,15,42,56,-14,37
Raith,9501,10,8,10,18,31,52,-21,34
Morton,9502,1,18,11,7,55,38,17,65
Hibernian,9502,2,17,13,6,52,27,25,64
Dundee Utd,9502,3,17,9,10,60,40,20,60
Falkirk,9502,4,16,11,9,58,43,15,59
Queen of S't,9502,5,13,9,14,51,51,0,48
Raith,9502,6,12,9,15,40,51,-11,45
Dunfermline,9502,7,10,13,13,50,53,-3,43
Dumbarton,9502,8,9,11,16,48,62,-14,38
Ayr,9502,9,8,10,18,32,59,-27,34
St Mirren,9502,10,7,10,19,36,58,-22,31
Hibernian,9503,1,18,12,6,57,32,25,66
Morton,9503,2,16,10,10,54,45,9,58
Dundee Utd,9503,3,16,8,12,54,41,13,56
Falkirk,9503,4,15,10,11,57,46,11,55
Queen of S't,9503,5,14,8,14,47,47,0,50
Dunfermline,9503,6,10,13,13,50,52,-2,43
St Mirren,9503,7,11,10,15,41,53,-12,43
Ayr,9503,8,10,11,15,35,50,-15,41
Raith,9503,9,10,9,17,36,53,-17,39
Dumbarton,9503,10,9,11,16,47,59,-12,38
Hibernian,9504,1,19,11,6,59,31,28,68
Morton,9504,2,17,11,8,55,37,18,62
Falkirk,9504,3,15,11,10,56,43,13,56
Dundee Utd,9504,4,16,8,12,49,41,8,56
Dumbarton,9504,5,11,12,13,50,53,-3,45
Queen of S't,9504,6,12,9,15,44,49,-5,45
Dunfermline,9504,7,10,12,14,45,55,-10,42
Ayr,9504,8,10,11,15,34,49,-15,41
Raith,9504,9,10,10,16,33,46,-13,40
St Mirren,9504,10,8,9,19,36,57,-21,33
Hibernian,9505,1,17,14,5,57,27,30,65
Morton,9505,2,18,10,8,48,33,15,64
Falkirk,9505,3,17,12,7,62,36,26,63
Dundee Utd,9505,4,15,10,11,47,38,9,55
Queen of S't,9505,5,13,10,13,49,54,-5,49
Raith,9505,6,11,9,16,36,53,-17,42
Ayr,9505,7,9,12,15,35,52,-17,39
Dunfermline,9505,8,7,15,14,46,54,-8,36
Dumbarton,9505,9,8,12,16,44,56,-12,36
St Mirren,9505,10,8,10,18,38,59,-21,34
Hibernian,9506,1,18,13,5,55,28,27,67
Morton,9506,2,17,11,8,52,38,14,62
Falkirk,9506,3,15,11,10,57,40,17,56
Dundee Utd,9506,4,14,10,12,47,43,4,52
Queen of S't,9506,5,13,9,14,46,50,-4,48
Dunfermline,9506,6,11,13,12,49,50,-1,46
Dumbarton,9506,7,10,11,15,53,55,-2,41
St Mirren,9506,8,9,11,16,42,55,-13,38
Raith,9506,9,9,11,16,34,52,-18,38
Ayr,9506,10,8,12,16,37,61,-24,36
Hibernian,9507,1,20,11,5,59,25,34,71
Dundee Utd,9507,2,17,10,9,51,39,12,61
Morton,9507,3,16,11,9,49,40,9,59
Falkirk,9507,4,16,10,10,59,42,17,58
Raith,9507,5,11,10,15,38,51,-13,43
Dunfermline,9507,6,10,12,14,44,47,-3,42
Dumbarton,9507,7,10,12,14,49,60,-11,42
Queen of S't,9507,8,10,10,16,46,53,-7,40
Ayr,9507,9,8,13,15,36,56,-20,37
St Mirren,9507,10,7,11,18,39,57,-18,32
Morton,9508,1,19,10,7,48,33,15,67
Hibernian,9508,2,18,12,6,53,26,27,66
Dundee Utd,9508,3,18,9,9,55,36,19,63
Falkirk,9508,4,16,12,8,56,39,17,60
Dumbarton,9508,5,10,12,14,51,58,-7,42
Dunfermline,9508,6,9,14,13,46,50,-4,41
Queen of S't,9508,7,9,12,15,45,53,-8,39
Raith,9508,8,10,9,17,33,52,-19,39
St Mirren,9508,9,8,10,18,39,54,-15,34
Ayr,9508,10,7,12,17,32,57,-25,33
Hibernian,9509,1,20,12,4,60,27,33,72
Dundee Utd,9509,2,17,9,10,49,37,12,60
Morton,9509,3,14,11,11,48,39,9,53
Falkirk,9509,4,14,9,13,54,49,5,51
Queen of S't,9509,5,12,10,14,43,47,-4,46
Dumbarton,9509,6,11,11,14,53,55,-2,44
Dunfermline,9509,7,10,13,13,49,51,-2,43
Ayr,9509,8,10,12,14,36,52,-16,42
Raith,9509,9,10,9,17,35,53,-18,39
St Mirren,9509,10,9,10,17,44,61,-17,37
Hibernian,9510,1,19,12,5,51,23,28,69
Falkirk,9510,2,20,9,7,62,36,26,69
Morton,9510,3,19,11,6,53,32,21,68
Dundee Utd,9510,4,14,10,12,46,39,7,52
Dunfermline,9510,5,9,14,13,46,48,-2,41
Queen of S't,9510,6,10,11,15,43,54,-11,41
Ayr,9510,7,10,11,15,37,53,-16,41
Raith,9510,8,10,9,17,37,53,-16,39
Dumbarton,9510,9,7,13,16,45,61,-16,34
St Mirren,9510,10,7,10,19,38,59,-21,31
Morton,9511,1,19,11,6,53,32,21,68
Hibernian,9511,2,18,12,6,55,28,27,66
Dundee Utd,9511,3,17,10,9,52,39,13,61
Falkirk,9511,4,16,10,10,58,41,17,58
Dumbarton,9511,5,11,10,15,52,59,-7,43
Raith,9511,6,10,10,16,33,47,-14,40
Queen of S't,9511,7,10,9,17,42,53,-11,39
St Mirren,9511,8,10,9,17,42,58,-16,39
Dunfermline,9511,9,8,14,14,44,51,-7,38
Ayr,9511,10,8,11,17,32,55,-23,35
Hibernian,9512,1,17,15,4,57,30,27,66
Morton,9512,2,16,14,6,50,37,13,62
Falkirk,9512,3,16,10,10,63,46,17,58
Dundee Utd,9512,4,16,9,11,53,41,12,57
Queen of S't,9512,5,14,9,13,51,49,2,51
Dunfermline,9512,6,9,15,12,46,49,-3,42
Dumbarton,9512,7,9,12,15,45,57,-12,39
Raith,9512,8,9,10,17,33,51,-18,37
St Mirren,9512,9,8,11,17,43,58,-15,35
Ayr,9512,10,8,11,17,34,57,-23,35
Hibernian,9513,1,20,11,5,53,26,27,71
Falkirk,9513,2,16,9,11,56,43,13,57
Dundee Utd,9513,3,15,11,10,43,36,7,56
Morton,9513,4,14,12,10,45,37,8,54
Queen of S't,9513,5,12,11,13,45,47,-2,47
Dunfermline,9513,6,10,12,14,48,50,-2,42
Ayr,9513,7,9,14,13,36,51,-15,41
Raith,9513,8,10,10,16,35,53,-18,40
St Mirren,9513,9,9,11,16,49,54,-5,38
Dumbarton,9513,10,9,11,16,44,57,-13,38
Hibernian,9514,1,21,11,4,58,22,36,74
Morton,9514,2,19,10,7,54,34,20,67
Dundee Utd,9514,3,18,10,8,54,36,18,64
Falkirk,9514,4,14,12,10,58,46,12,54
Dumbarton,9514,5,9,12,15,49,60,-11,39
St Mirren,9514,6,10,9,17,40,53,-13,39
Queen of S't,9514,7,9,12,15,41,55,-14,39
Dunfermline,9514,8,8,13,15,43,54,-11,37
Raith,9514,9,9,10,17,31,46,-15,37
Ayr,9514,10,7,13,16,32,54,-22,34
Hibernian,9515,1,17,15,4,53,27,26,66
Falkirk,9515,2,17,10,9,59,41,18,61
Morton,9515,3,17,10,9,46,35,11,61
Dundee Utd,9515,4,15,8,13,45,38,7,53
Dumbarton,9515,5,12,11,13,50,53,-3,47
Queen of S't,9515,6,12,9,15,45,50,-5,45
St Mirren,9515,7,10,11,15,40,51,-11,41
Dunfermline,9515,8,9,12,15,42,50,-8,39
Ayr,9515,9,9,11,16,33,52,-19,38
Raith,9515,10,9,9,18,32,48,-16,36
Hibernian,9516,1,19,14,3,56,26,30,71
Morton,9516,2,16,12,8,48,37,11,60
Dundee Utd,9516,3,16,10,10,48,40,8,58
Falkirk,9516,4,15,11,10,60,43,17,56
Dunfermline,9516,5,10,16,10,53,47,6,46
Queen of S't,9516,6,11,10,15,46,52,-6,43
Raith,9516,7,10,9,17,36,54,-18,39
St Mirren,9516,8,9,11,16,42,58,-16,38
Ayr,9516,9,7,14,15,32,50,-18,35
Dumbarton,9516,10,7,13,16,46,60,-14,34
Hibernian,9517,1,18,13,5,54,28,26,67
Morton,9517,2,17,10,9,50,36,14,61
Falkirk,9517,3,16,12,8,66,40,26,60
Dundee Utd,9517,4,16,10,10,52,42,10,58
St Mirren,9517,5,11,10,15,42,53,-11,43
Raith,9517,6,10,11,15,33,47,-14,41
Queen of S't,9517,7,10,10,16,42,52,-10,40
Ayr,9517,8,9,12,15,37,56,-19,39
Dumbarton,9517,9,9,10,17,50,61,-11,37
Dunfermline,9517,10,7,16,13,47,58,-11,37
Hibernian,9518,1,20,11,5,61,25,36,71
Morton,9518,2,16,13,7,49,38,11,61
Falkirk,9518,3,16,11,9,55,39,16,59
Dundee Utd,9518,4,15,11,10,52,43,9,56
Queen of S't,9518,5,13,9,14,46,49,-3,48
Ayr,9518,6,10,12,14,38,53,-15,42
St Mirren,9518,7,10,10,16,41,54,-13,40
Dumbarton,9518,8,8,14,14,48,58,-10,38
Raith,9518,9,9,8,19,29,50,-21,35
Dunfermline,9518,10,7,13,16,42,52,-10,34
Hibernian,9519,1,20,12,4,56,23,33,72
Morton,9519,2,17,11,8,50,35,15,62
Falkirk,9519,3,16,13,7,63,43,20,61
Dundee Utd,9519,4,16,8,12,50,43,7,56
Raith,9519,5,11,9,16,43,51,-8,42
Dunfermline,9519,6,9,14,13,43,48,-5,41
Dumbarton,9519,7,9,12,15,49,59,-10,39
Queen of S't,9519,8,10,9,17,40,52,-12,39
Ayr,9519,9,9,11,16,38,61,-23,38
St Mirren,9519,10,9,9,18,42,59,-17,36
Falkirk,9520,1,19,10,7,67,37,30,67
Hibernian,9520,2,18,12,6,53,27,26,66
Morton,9520,3,16,12,8,56,41,15,60
Dundee Utd,9520,4,16,9,11,58,47,11,57
Dunfermline,9520,5,11,12,13,53,51,2,45
Queen of S't,9520,6,12,9,15,48,59,-11,45
Ayr,9520,7,9,12,15,36,55,-19,39
Raith,9520,8,10,8,18,37,55,-18,38
St Mirren,9520,9,9,10,17,43,57,-14,37
Dumbarton,9520,10,7,12,17,42,64,-22,33
Morton,9521,1,18,12,6,55,36,19,66
Falkirk,9521,2,17,12,7,60,36,24,63
Hibernian,9521,3,16,13,7,49,27,22,61
Dunfermline,9521,4,12,14,10,52,45,7,50
Dundee Utd,9521,5,13,11,12,48,47,1,50
Queen of S't,9521,6,11,9,16,46,54,-8,42
Dumbarton,9521,7,9,12,15,50,62,-12,39
Raith,9521,8,9,10,17,33,51,-18,37
Ayr,9521,9,8,13,15,37,59,-22,37
St Mirren,9521,10,8,12,16,39,52,-13,36
Hibernian,9522,1,17,13,6,49,25,24,64
Morton,9522,2,16,12,8,48,38,10,60
Falkirk,9522,3,16,10,10,54,38,16,58
Dundee Utd,9522,4,13,12,11,47,42,5,51
Queen of S't,9522,5,13,9,14,50,49,1,48
Raith,9522,6,11,11,14,34,46,-12,44
Ayr,9522,7,9,14,13,35,49,-14,41
Dunfermline,9522,8,8,16,12,44,48,-4,40
Dumbarton,9522,9,9,11,16,47,59,-12,38
St Mirren,9522,10,9,10,17,39,53,-14,37
Hibernian,9523,1,19,14,3,58,25,33,71
Morton,9523,2,18,11,7,51,38,13,65
Falkirk,9523,3,18,10,8,66,43,23,64
Dundee Utd,9523,4,16,9,11,49,38,11,57
Queen of S't,9523,5,14,9,13,50,48,2,51
St Mirren,9523,6,9,11,16,45,55,-10,38
Raith,9523,7,9,11,16,32,45,-13,38
Ayr,9523,8,8,12,16,29,54,-25,36
Dumbarton,9523,9,8,10,18,45,62,-17,34
Dunfermline,9523,10,7,11,18,42,59,-17,32
Hibernian,9524,1,21,10,5,59,22,37,73
Morton,9524,2,17,12,7,46,37,9,63
Dundee Utd,9524,3,16,9,11,53,44,9,57
Falkirk,9524,4,14,10,12,53,46,7,52
Queen of S't,9524,5,13,8,15,47,51,-4,47
Dumbarton,9524,6,11,12,13,53,52,1,45
Dunfermline,9524,7,9,14,13,48,48,0,41
Ayr,9524,8,9,12,15,35,53,-18,39
Raith,9524,9,9,11,16,35,52,-17,38
St Mirren,9524,10,7,10,19,36,60,-24,31
Hibernian,9525,1,19,12,5,56,28,28,69
Morton,9525,2,18,10,8,54,39,15,64
Dundee Utd,9525,3,18,9,9,56,40,16,63
Falkirk,9525,4,15,11,10,58,45,13,56
Queen of S't,9525,5,11,11,14,46,50,-4,44
Dunfermline,9525,6,9,12,15,47,54,-7,39
Raith,9525,7,10,9,17,36,51,-15,39
St Mirren,9525,8,9,11,16,45,57,-12,38
Dumbarton,9525,9,8,12,16,51,65,-14,36
Ayr,9525,10,7,15,14,34,54,-20,36
Hibernian,9526,1,21,12,3,62,23,39,75
Falkirk,9526,2,17,11,8,60,37,23,62
Morton,9526,3,17,11,8,50,34,16,62
Dundee Utd,9526,4,15,10,11,51,41,10,55
Queen of S't,9526,5,12,9,15,51,54,-3,45
Dumbarton,9526,6,11,12,13,52,56,-4,45
Dunfermline,9526,7,8,13,15,43,52,-9,37
Raith,9526,8,9,10,17,34,53,-19,37
St Mirren,9526,9,8,10,18,37,64,-27,34
Ayr,9526,10,7,12,17,31,57,-26,33
Hibernian,9527,1,16,15,5,50,27,23,63
Falkirk,9527,2,16,12,8,58,37,21,60
Dundee Utd,9527,3,15,11,10,47,40,7,56
Morton,9527,4,13,14,9,44,38,6,53
Dunfermline,9527,5,13,11,12,51,46,5,50
Queen of S't,9527,6,12,10,14,45,47,-2,46
Dumbarton,9527,7,10,10,16,48,57,-9,40
Ayr,9527,8,9,13,14,38,55,-17,40
Raith,9527,9,10,9,17,38,53,-15,39
St Mirren,9527,10,8,11,17,39,58,-19,35
Hibernian,9528,1,19,13,4,56,27,29,70
Morton,9528,2,17,11,8,51,35,16,62
Dundee Utd,9528,3,16,12,8,53,38,15,60
Falkirk,9528,4,14,12,10,59,44,15,54
Queen of S't,9528,5,11,12,13,48,50,-2,45
Raith,9528,6,10,10,16,36,53,-17,40
Dumbarton,9528,7,9,12,15,49,60,-11,39
Dunfermline,9528,8,8,14,14,44,50,-6,38
St Mirren,9528,9,9,10,17,44,59,-15,37
Ayr,9528,10,8,12,16,35,59,-24,36
Hibernian,9529,1,22,10,4,57,21,36,76
Dundee Utd,9529,2,18,9,9,55,36,19,63
Morton,9529,3,16,10,10,49,36,13,58
Falkirk,9529,4,16,9,11,56,42,14,57
Queen of S't,9529,5,12,10,14,44,47,-3,46
Dunfermline,9529,6,11,11,14,47,49,-2,44
Dumbarton,9529,7,10,12,14,45,54,-9,42
Raith,9529,8,11,8,17,34,51,-17,41
St Mirren,9529,9,9,9,18,38,60,-22,36
Ayr,9529,10,6,10,20,30,59,-29,28
Hibernian,9530,1,21,12,3,60,19,41,75
Dundee Utd,9530,2,16,10,10,50,38,12,58
Falkirk,9530,3,15,11,10,58,45,13,56
Morton,9530,4,14,12,10,47,40,7,54
Queen of S't,9530,5,13,8,15,43,52,-9,47
Dumbarton,9530,6,11,10,15,50,60,-10,43
Dunfermline,9530,7,9,13,14,44,49,-5,40
Raith,9530,8,10,9,17,35,50,-15,39
Ayr,9530,9,9,12,15,33,53,-20,39
St Mirren,9530,10,7,13,16,45,59,-14,34
Hibernian,9531,1,21,12,3,60,26,34,75
Morton,9531,2,16,12,8,51,35,16,60
Falkirk,9531,3,16,10,10,56,41,15,58
Dundee Utd,9531,4,16,8,12,49,41,8,56
Dunfermline,9531,5,11,14,11,48,46,2,47
Queen of S't,9531,6,12,8,16,45,51,-6,44
Dumbarton,9531,7,10,11,15,47,56,-9,41
Raith,9531,8,9,10,17,32,47,-15,37
Ayr,9531,9,8,12,16,32,56,-24,36
St Mirren,9531,10,8,9,19,39,60,-21,33
Hibernian,9532,1,19,11,6,56,24,32,68
Morton,9532,2,18,11,7,55,35,20,65
Dundee Utd,9532,3,16,11,9,50,39,11,59
Falkirk,9532,4,16,10,10,58,43,15,58
Dunfermline,9532,5,12,14,10,50,44,6,50
Queen of S't,9532,6,11,10,15,49,56,-7,43
Raith,9532,7,10,10,16,38,51,-13,40
Ayr,9532,8,8,13,15,36,59,-23,37
Dumbarton,9532,9,7,11,18,44,62,-18,32
St Mirren,9532,10,7,11,18,39,62,-23,32
Morton,9533,1,18,13,5,50,29,21,67
Hibernian,9533,2,18,12,6,56,27,29,66
Falkirk,9533,3,15,9,12,58,50,8,54
Dundee Utd,9533,4,15,8,13,49,45,4,53
Dumbarton,9533,5,13,10,13,56,57,-1,49
Dunfermline,9533,6,11,12,13,47,45,2,45
Queen of S't,9533,7,11,8,17,40,51,-11,41
Ayr,9533,8,9,12,15,38,55,-17,39
Raith,9533,9,9,10,17,31,48,-17,37
St Mirren,9533,10,9,10,17,39,57,-18,37
Hibernian,9534,1,20,11,5,58,25,33,71
Dundee Utd,9534,2,18,10,8,54,34,20,64
Morton,9534,3,16,11,9,48,35,13,59
Falkirk,9534,4,15,11,10,53,38,15,56
Queen of S't,9534,5,12,9,15,43,50,-7,45
Raith,9534,6,11,10,15,36,53,-17,43
Dunfermline,9534,7,9,14,13,45,50,-5,41
Dumbarton,9534,8,10,11,15,52,63,-11,41
Ayr,9534,9,8,11,17,33,53,-20,35
St Mirren,9534,10,6,12,18,37,58,-21,30
Hibernian,9535,1,19,13,4,58,28,30,70
Morton,9535,2,16,12,8,50,39,11,60
Falkirk,9535,3,16,10,10,56,37,19,58
Dumbarton,9535,4,13,10,13,55,52,3,49
Dundee Utd,9535,5,13,9,14,42,47,-5,48
Dunfermline,9535,6,11,13,12,49,50,-1,46
Raith,9535,7,12,8,16,37,45,-8,44
Queen of S't,9535,8,11,10,15,43,50,-7,43
St Mirren,9535,9,9,10,17,38,57,-19,37
Ayr,9535,10,7,11,18,36,59,-23,32
Morton,9536,1,17,13,6,49,33,16,64
Hibernian,9536,2,16,13,7,48,27,21,61
Dundee Utd,9536,3,17,10,9,50,37,13,61
Falkirk,9536,4,17,9,10,66,40,26,60
Queen of S't,9536,5,12,10,14,47,54,-7,46
Dumbarton,9536,6,10,11,15,47,54,-7,41
Dunfermline,9536,7,9,12,15,44,52,-8,39
Raith,9536,8,9,12,15,35,50,-15,39
Ayr,9536,9,7,15,14,32,52,-20,36
St Mirren,9536,10,8,11,17,38,57,-19,35
Hibernian,9537,1,20,10,6,60,27,33,70
Morton,9537,2,18,11,7,50,34,16,65
Falkirk,9537,3,17,10,9,55,38,17,61
Dundee Utd,9537,4,16,8,12,48,39,9,56
Dumbarton,9537,5,10,14,12,54,57,-3,44
Queen of S't,9537,6,11,10,15,46,52,-6,43
Dunfermline,9537,7,9,14,13,44,50,-6,41
St Mirren,9537,8,10,10,16,40,54,-14,40
Raith,9537,9,8,10,18,30,47,-17,34
Ayr,9537,10,7,11,18,34,63,-29,32
Hibernian,9538,1,19,12,5,56,26,30,69
Falkirk,9538,2,17,10,9,58,41,17,61
Morton,9538,3,16,12,8,51,42,9,60
Dundee Utd,9538,4,15,11,10,51,41,10,56
Queen of S't,9538,5,12,9,15,43,46,-3,45
Raith,9538,6,11,10,15,38,46,-8,43
Dumbarton,9538,7,9,12,15,50,58,-8,39
Dunfermline,9538,8,7,16,13,46,54,-8,37
St Mirren,9538,9,9,10,17,44,61,-17,37
Ayr,9538,10,9,10,17,36,58,-22,37
Hibernian,9539,1,20,11,5,54,23,31,71
Dundee Utd,9539,2,19,9,8,55,37,18,66
Falkirk,9539,3,17,10,9,54,37,17,61
Morton,9539,4,16,10,10,48,40,8,58
Raith,9539,5,12,9,15,37,48,-11,45
Queen of S't,9539,6,10,12,14,46,52,-6,42
Dunfermline,9539,7,8,13,15,42,49,-7,37
Dumbarton,9539,8,8,13,15,47,57,-10,37
St Mirren,9539,9,9,9,18,41,57,-16,36
Ayr,9539,10,8,10,18,34,58,-24,34
Hibernian,9540,1,20,10,6,58,26,32,70
Morton,9540,2,18,12,6,53,32,21,66
Falkirk,9540,3,16,11,9,57,37,20,59
Dundee Utd,9540,4,14,13,9,44,35,9,55
Queen of S't,9540,5,12,8,16,44,55,-11,44
Dunfermline,9540,6,10,13,13,45,53,-8,43
Dumbarton,9540,7,9,13,14,46,54,-8,40
Ayr,9540,8,8,13,15,31,49,-18,37
Raith,9540,9,8,11,17,31,47,-16,35
St Mirren,9540,10,8,10,18,37,58,-21,34
Hibernian,9541,1,20,12,4,60,25,35,72
Morton,9541,2,17,11,8,51,36,15,62
Falkirk,9541,3,15,11,10,58,44,14,56
Dundee Utd,9541,4,15,10,11,46,39,7,55
Raith,9541,5,11,11,14,39,50,-11,44
Queen of S't,9541,6,11,10,15,43,50,-7,43
Dunfermline,9541,7,9,13,14,44,47,-3,40
Dumbarton,9541,8,9,12,15,48,59,-11,39
St Mirren,9541,9,9,10,17,38,57,-19,37
Ayr,9541,10,8,12,16,33,53,-20,36
Hibernian,9542,1,21,10,5,62,27,35,73
Falkirk,9542,2,18,11,7,65,41,24,65
Morton,9542,3,17,10,9,50,39,11,61
Dundee Utd,9542,4,16,9,11,53,44,9,57
Dunfermline,9542,5,10,14,12,53,49,4,44
Queen of S't,9542,6,11,9,16,48,58,-10,42
Dumbarton,9542,7,9,12,15,49,59,-10,39
Ayr,9542,8,9,11,16,34,55,-21,38
St Mirren,9542,9,8,11,17,41,61,-20,35
Raith,9542,10,8,9,19,32,54,-22,33
Hibernian,9543,1,18,12,6,53,27,26,66
Morton,9543,2,17,12,7,50,35,15,63
Dundee Utd,9543,3,15,11,10,46,39,7,56
Falkirk,9543,4,14,11,11,56,49,7,53
Queen of S't,9543,5,12,10,14,49,50,-1,46
Dunfermline,9543,6,11,12,13,47,46,1,45
Raith,9543,7,11,9,16,39,50,-11,42
Ayr,9543,8,9,12,15,36,54,-18,39
St Mirren,9543,9,9,11,16,41,54,-13,38
Dumbarton,9543,10,8,12,16,43,56,-13,36
Hibernian,9544,1,22,11,3,58,22,36,77
Morton,9544,2,16,11,9,52,41,11,59
Falkirk,9544,3,16,9,11,58,42,16,57
Dundee Utd,9544,4,15,11,10,50,39,11,56
Dumbarton,9544,5,10,12,14,47,54,-7,42
Queen of S't,9544,6,11,9,16,44,52,-8,42
Dunfermline,9544,7,10,11,15,43,53,-10,41
Raith,9544,8,10,9,17,37,53,-16,39
Ayr,9544,9,9,11,16,38,61,-23,38
St Mirren,9544,10,9,10,17,45,55,-10,37
Morton,9545,1,20,9,7,53,33,20,69
Hibernian,9545,2,18,10,8,51,28,23,64
Falkirk,9545,3,16,12,8,63,41,22,60
Dundee Utd,9545,4,16,10,10,58,42,16,58
Queen of S't,9545,5,13,9,14,51,49,2,48
Dumbarton,9545,6,10,11,15,45,60,-15,41
Raith,9545,7,10,9,17,36,52,-16,39
St Mirren,9545,8,10,9,17,40,58,-18,39
Dunfermline,9545,9,7,14,15,39,48,-9,35
Ayr,9545,10,8,11,17,31,56,-25,35
Hibernian,9546,1,19,13,4,56,24,32,70
Dundee Utd,9546,2,18,10,8,53,37,16,64
Falkirk,9546,3,16,13,7,62,40,22,61
Morton,9546,4,15,12,9,48,40,8,57
Dunfermline,9546,5,10,14,12,54,53,1,44
Queen of S't,9546,6,11,9,16,44,54,-10,42
Dumbarton,9546,7,9,11,16,48,62,-14,38
Raith,9546,8,9,11,16,36,52,-16,38
Ayr,9546,9,7,14,15,32,51,-19,35
St Mirren,9546,10,8,9,19,38,58,-20,33
Hibernian,9547,1,17,14,5,53,28,25,65
Morton,9547,2,17,12,7,54,36,18,63
Falkirk,9547,3,16,12,8,63,42,21,60
Dundee Utd,9547,4,17,9,10,54,39,15,60
Dunfermline,9547,5,9,16,11,43,43,0,43
Raith,9547,6,11,9,16,36,49,-13,42
Dumbarton,9547,7,9,12,15,47,60,-13,39
Queen of S't,9547,8,9,11,16,39,51,-12,38
St Mirren,9547,9,9,11,16,45,60,-15,38
Ayr,9547,10,7,12,17,31,57,-26,33
Hibernian,9548,1,21,12,3,57,25,32,75
Dundee Utd,9548,2,17,10,9,54,36,18,61
Morton,9548,3,16,13,7,48,35,13,61
Falkirk,9548,4,14,10,12,55,44,11,52
Queen of S't,9548,5,12,10,14,47,50,-3,46
Ayr,9548,6,11,12,13,39,51,-12,45
Dunfermline,9548,7,9,12,15,44,51,-7,39
Dumbarton,9548,8,9,10,17,47,61,-14,37
St Mirren,9548,9,8,11,17,42,59,-17,35
Raith,9548,10,8,10,18,33,54,-21,34
Hibernian,9549,1,18,13,5,54,26,28,67
Morton,9549,2,17,13,6,52,34,18,64
Falkirk,9549,3,16,13,7,67,40,27,61
Dundee Utd,9549,4,15,10,11,52,42,10,55
Queen of S't,9549,5,13,11,12,47,47,0,50
Dumbarton,9549,6,9,13,14,47,56,-9,40
Dunfermline,9549,7,8,15,13,44,47,-3,39
Raith,9549,8,9,9,18,31,51,-20,36
Ayr,9549,9,7,13,16,31,55,-24,34
St Mirren,9549,10,8,10,18,36,63,-27,34
Hibernian,9550,1,20,11,5,60,27,33,71
Morton,9550,2,18,10,8,52,35,17,64
Falkirk,9550,3,16,11,9,63,40,23,59
Dundee Utd,9550,4,15,8,13,51,49,2,53
Dumbarton,9550,5,12,11,13,53,58,-5,47
Ayr,9550,6,10,11,15,41,54,-13,41
Raith,9550,7,10,11,15,35,48,-13,41
Queen of S't,9550,8,10,10,16,42,54,-12,40
Dunfermline,9550,9,8,14,14,43,51,-8,38
St Mirren,9550,10,7,11,18,38,62,-24,32
Hibernian,9551,1,19,13,4,57,29,28,70
Morton,9551,2,16,11,9,51,38,13,59
Falkirk,9551,3,15,12,9,60,42,18,57
Dundee Utd,9551,4,16,9,11,51,41,10,57
Queen of S't,9551,5,12,11,13,48,53,-5,47
Dumbarton,9551,6,9,14,13,50,59,-9,41
Raith,9551,7,10,11,15,35,48,-13,41
Dunfermline,9551,8,9,12,15,46,50,-4,39
Ayr,9551,9,8,12,16,33,53,-20,36
St Mirren,9551,10,8,11,17,40,58,-18,35
Hibernian,9552,1,18,12,6,56,30,26,66
Morton,9552,2,18,11,7,58,35,23,65
Dundee Utd,9552,3,17,9,10,52,42,10,60
Falkirk,9552,4,16,11,9,58,41,17,59
Dunfermline,9552,5,11,11,14,46,51,-5,44
Queen of S't,9552,6,10,10,16,49,57,-8,40
Dumbarton,9552,7,9,13,14,50,59,-9,40
Raith,9552,8,10,9,17,33,49,-16,39
Ayr,9552,9,9,11,16,35,55,-20,38
St Mirren,9552,10,9,9,18,42,60,-18,36
Hibernian,9553,1,18,12,6,53,26,27,66
Morton,9553,2,18,11,7,54,36,18,65
Falkirk,9553,3,15,12,9,56,41,15,57
Dundee Utd,9553,4,13,14,9,48,41,7,53
Dunfermline,9553,5,12,11,13,49,47,2,47
Queen of S't,9553,6,10,11,15,44,52,-8,41
Ayr,9553,7,9,13,14,40,60,-20,40
Dumbarton,9553,8,8,14,14,49,58,-9,38
St Mirren,9553,9,9,11,16,42,56,-14,38
Raith,9553,10,9,9,18,34,52,-18,36
Falkirk,9554,1,18,10,8,63,38,25,64
Hibernian,9554,2,17,12,7,51,27,24,63
Morton,9554,3,17,11,8,51,39,12,62
Dundee Utd,9554,4,15,10,11,52,44,8,55
Dunfermline,9554,5,11,12,13,48,48,0,45
Queen of S't,9554,6,11,10,15,42,51,-9,43
Raith,9554,7,11,10,15,35,49,-14,43
Ayr,9554,8,8,14,14,37,55,-18,38
St Mirren,9554,9,9,10,17,42,56,-14,37
Dumbarton,9554,10,8,11,17,48,62,-14,35
Hibernian,9555,1,20,12,4,56,23,33,72
Dundee Utd,9555,2,17,10,9,55,37,18,61
Morton,9555,3,16,13,7,51,37,14,61
Falkirk,9555,4,16,10,10,58,38,20,58
Dunfermline,9555,5,10,15,11,45,47,-2,45
Raith,9555,6,12,8,16,36,51,-15,44
St Mirren,9555,7,10,10,16,44,55,-11,40
Queen of S't,9555,8,10,9,17,41,56,-15,39
Dumbarton,9555,9,9,10,17,49,61,-12,37
Ayr,9555,10,6,11,19,32,62,-30,29
Hibernian,9556,1,17,14,5,59,27,32,65
Morton,9556,2,16,15,5,51,33,18,63
Falkirk,9556,3,17,10,9,62,39,23,61
Dundee Utd,9556,4,16,9,11,49,41,8,57
Queen of S't,9556,5,13,9,14,47,51,-4,48
Dunfermline,9556,6,11,12,13,43,45,-2,45
St Mirren,9556,7,10,10,16,41,62,-21,40
Ayr,9556,8,8,13,15,38,57,-19,37
Raith,9556,9,9,9,18,31,51,-20,36
Dumbarton,9556,10,7,11,18,45,60,-15,32
Hibernian,9557,1,19,14,3,57,25,32,71
Falkirk,9557,2,18,10,8,59,38,21,64
Morton,9557,3,16,12,8,52,39,13,60
Dundee Utd,9557,4,16,10,10,50,40,10,58
Queen of S't,9557,5,11,11,14,46,52,-6,44
Dumbarton,9557,6,10,12,14,48,54,-6,42
Raith,9557,7,9,11,16,33,46,-13,38
Ayr,9557,8,8,12,16,34,57,-23,36
Dunfermline,9557,9,7,14,15,42,52,-10,35
St Mirren,9557,10,8,10,18,36,54,-18,34
Hibernian,9558,1,20,11,5,56,26,30,71
Falkirk,9558,2,18,10,8,67,40,27,64
Dundee Utd,9558,3,16,11,9,50,38,12,59
Morton,9558,4,15,12,9,47,37,10,57
Queen of S't,9558,5,13,9,14,46,48,-2,48
Raith,9558,6,10,12,14,35,47,-12,42
Dumbarton,9558,7,9,10,17,46,59,-13,37
Dunfermline,9558,8,7,15,14,40,51,-11,36
Ayr,9558,9,7,14,15,31,52,-21,35
St Mirren,9558,10,7,12,17,43,63,-20,33
Hibernian,9559,1,20,11,5,58,28,30,71
Falkirk,9559,2,15,10,11,56,44,12,55
Dundee Utd,9559,3,14,11,11,48,41,7,53
Morton,9559,4,13,14,9,41,34,7,53
Queen of S't,9559,5,14,10,12,51,50,1,52
Dunfermline,9559,6,11,14,11,48,46,2,47
Raith,9559,7,11,9,16,38,49,-11,42
Dumbarton,9559,8,9,13,14,48,55,-7,40
St Mirren,9559,9,9,10,17,40,56,-16,37
Ayr,9559,10,7,12,17,32,57,-25,33
Hibernian,9560,1,21,10,5,56,25,31,73
Morton,9560,2,18,11,7,53,34,19,65
Dundee Utd,9560,3,15,12,9,50,41,9,57
Falkirk,9560,4,15,10,11,60,47,13,55
Queen of S't,9560,5,12,8,16,47,50,-3,44
Dunfermline,9560,6,10,12,14,45,47,-2,42
Dumbarton,9560,7,10,11,15,47,56,-9,41
Ayr,9560,8,9,13,14,35,51,-16,40
Raith,9560,9,9,9,18,31,51,-20,36
St Mirren,9560,10,7,12,17,37,59,-22,33
Hibernian,9561,1,19,13,4,54,24,30,70
Falkirk,9561,2,17,10,9,59,43,16,61
Dundee Utd,9561,3,15,10,11,48,40,8,55
Queen of S't,9561,4,15,8,13,55,50,5,53
Morton,9561,5,13,11,12,41,41,0,50
Dunfermline,9561,6,11,13,12,48,49,-1,46
Raith,9561,7,11,9,16,44,53,-9,42
Dumbarton,9561,8,10,11,15,48,58,-10,41
Ayr,9561,9,8,13,15,36,56,-20,37
St Mirren,9561,10,6,12,18,37,56,-19,30
Hibernian,9562,1,17,14,5,58,31,27,65
Morton,9562,2,16,13,7,51,36,15,61
Falkirk,9562,3,15,11,10,55,41,14,56
Dundee Utd,9562,4,14,11,11,53,42,11,53
Queen of S't,9562,5,14,9,13,50,46,4,51
Dunfermline,9562,6,10,13,13,47,50,-3,43
Ayr,9562,7,8,15,13,40,56,-16,39
Dumbarton,9562,8,9,12,15,45,62,-17,39
Raith,9562,9,9,11,16,35,50,-15,38
St Mirren,9562,10,9,9,18,40,60,-20,36
Hibernian,9563,1,18,13,5,54,30,24,67
Falkirk,9563,2,18,10,8,61,38,23,64
Dundee Utd,9563,3,18,9,9,59,36,23,63
Morton,9563,4,16,14,6,54,38,16,62
Queen of S't,9563,5,11,10,15,47,54,-7,43
Dumbarton,9563,6,10,11,15,49,61,-12,41
Dunfermline,9563,7,9,12,15,47,52,-5,39
Ayr,9563,8,8,13,15,31,53,-22,37
Raith,9563,9,8,10,18,32,53,-21,34
St Mirren,9563,10,7,12,17,39,58,-19,33
Hibernian,9564,1,21,12,3,61,21,40,75
Falkirk,9564,2,16,11,9,59,38,21,59
Dundee Utd,9564,3,17,8,11,52,39,13,59
Morton,9564,4,15,12,9,46,39,7,57
Queen of S't,9564,5,13,8,15,44,50,-6,47
Dumbarton,9564,6,10,12,14,46,53,-7,42
Raith,9564,7,10,9,17,35,50,-15,39
Dunfermline,9564,8,8,14,14,44,54,-10,38
Ayr,9564,9,9,11,16,35,55,-20,38
St Mirren,9564,10,7,11,18,35,58,-23,32
Hibernian,9565,1,19,13,4,59,25,34,70
Morton,9565,2,17,11,8,47,34,13,62
Dundee Utd,9565,3,17,9,10,54,35,19,60
Falkirk,9565,4,15,11,10,56,44,12,56
Queen of S't,9565,5,13,11,12,47,46,1,50
Raith,9565,6,11,9,16,36,50,-14,42
Dunfermline,9565,7,9,12,15,44,52,-8,39
Dumbarton,9565,8,9,11,16,49,60,-11,38
St Mirren,9565,9,8,11,17,40,57,-17,35
Ayr,9565,10,6,14,16,30,59,-29,32
Hibernian,9566,1,19,13,4,56,26,30,70
Morton,9566,2,18,10,8,55,37,18,64
Falkirk,9566,3,14,13,9,56,46,10,55
Dundee Utd,9566,4,14,12,10,52,41,11,54
Queen of S't,9566,5,11,12,13,43,44,-1,45
Dunfermline,9566,6,9,14,13,42,49,-7,41
Dumbarton,9566,7,8,15,13,47,54,-7,39
Raith,9566,8,9,10,17,35,50,-15,37
Ayr,9566,9,8,13,15,37,60,-23,37
St Mirren,9566,10,8,12,16,41,57,-16,36
Hibernian,9567,1,19,11,6,56,26,30,68
Falkirk,9567,2,17,10,9,61,37,24,61
Morton,9567,3,15,14,7,48,40,8,59
Dundee Utd,9567,4,16,10,10,51,41,10,58
Queen of S't,9567,5,13,10,13,45,45,0,49
Dunfermline,9567,6,9,13,14,43,46,-3,40
St Mirren,9567,7,9,11,16,42,54,-12,38
Raith,9567,8,10,8,18,33,53,-20,38
Dumbarton,9567,9,7,15,14,42,55,-13,36
Ayr,9567,10,7,14,15,34,58,-24,35
Hibernian,9568,1,19,11,6,51,25,26,68
Falkirk,9568,2,18,10,8,61,38,23,64
Morton,9568,3,17,10,9,48,36,12,61
Dundee Utd,9568,4,13,11,12,47,44,3,50
Ayr,9568,5,11,13,12,41,52,-11,46
Dunfermline,9568,6,11,12,13,46,47,-1,45
Dumbarton,9568,7,9,14,13,48,56,-8,41
Queen of S't,9568,8,10,10,16,43,51,-8,40
Raith,9568,9,8,10,18,34,51,-17,34
St Mirren,9568,10,7,13,16,37,56,-19,34
Hibernian,9569,1,18,15,3,55,26,29,69
Dundee Utd,9569,2,18,9,9,60,39,21,63
Morton,9569,3,16,12,8,53,40,13,60
Falkirk,9569,4,16,9,11,60,47,13,57
Raith,9569,5,11,11,14,38,45,-7,44
Queen of S't,9569,6,10,12,14,46,51,-5,42
Dunfermline,9569,7,10,12,14,44,53,-9,42
Ayr,9569,8,8,13,15,38,58,-20,37
St Mirren,9569,9,8,11,17,42,56,-14,35
Dumbarton,9569,10,7,12,17,47,68,-21,33
Hibernian,9570,1,18,12,6,54,29,25,66
Morton,9570,2,18,10,8,52,37,15,64
Falkirk,9570,3,17,11,8,64,41,23,62
Dundee Utd,9570,4,18,8,10,56,35,21,62
Dunfermline,9570,5,11,13,12,47,48,-1,46
Queen of S't,9570,6,11,11,14,45,49,-4,44
Raith,9570,7,11,8,17,37,49,-12,41
St Mirren,9570,8,9,9,18,42,66,-24,36
Dumbarton,9570,9,8,10,18,42,57,-15,34
Ayr,9570,10,8,10,18,33,61,-28,34
Hibernian,9571,1,19,12,5,59,26,33,69
Dundee Utd,9571,2,17,10,9,51,34,17,61
Morton,9571,3,16,13,7,48,35,13,61
Falkirk,9571,4,15,11,10,56,38,18,56
Dumbarton,9571,5,10,13,13,52,55,-3,43
Queen of S't,9571,6,11,9,16,41,52,-11,42
Dunfermline,9571,7,9,14,13,44,53,-9,41
St Mirren,9571,8,9,10,17,43,61,-18,37
Ayr,9571,9,8,13,15,31,51,-20,37
Raith,9571,10,9,9,18,29,49,-20,36
Hibernian,9572,1,18,13,5,52,27,25,67
Morton,9572,2,18,10,8,53,36,17,64
Dundee Utd,9572,3,17,8,11,52,35,17,59
Falkirk,9572,4,14,11,11,51,44,7,53
Queen of S't,9572,5,12,9,15,46,47,-1,45
Dunfermline,9572,6,11,12,13,45,48,-3,45
Dumbarton,9572,7,11,11,14,51,56,-5,44
Ayr,9572,8,11,11,14,36,53,-17,44
Raith,9572,9,9,8,19,31,51,-20,35
St Mirren,9572,10,7,11,18,38,58,-20,32
Hibernian,9573,1,20,11,5,57,25,32,71
Dundee Utd,9573,2,19,9,8,56,34,22,66
Morton,9573,3,16,12,8,49,34,15,60
Falkirk,9573,4,14,12,10,58,45,13,54
Queen of S't,9573,5,11,9,16,42,52,-10,42
Dunfermline,9573,6,9,14,13,43,44,-1,41
Dumbarton,9573,7,10,11,15,44,58,-14,41
Raith,9573,8,10,11,15,38,54,-16,41
St Mirren,9573,9,7,12,17,38,57,-19,33
Ayr,9573,10,6,15,15,31,53,-22,33
Hibernian,9574,1,23,10,3,61,22,39,79
Falkirk,9574,2,17,10,9,62,40,22,61
Morton,9574,3,15,13,8,48,36,12,58
Queen of S't,9574,4,14,8,14,48,50,-2,50
Dundee Utd,9574,5,12,13,11,42,38,4,49
Dunfermline,9574,6,9,13,14,46,51,-5,40
Dumbarton,9574,7,9,12,15,45,60,-15,39
Raith,9574,8,10,8,18,32,50,-18,38
St Mirren,9574,9,9,9,18,40,57,-17,36
Ayr,9574,10,8,12,16,35,55,-20,36
Hibernian,9575,1,17,16,3,53,24,29,67
Dundee Utd,9575,2,18,9,9,58,39,19,63
Morton,9575,3,18,9,9,55,38,17,63
Falkirk,9575,4,15,11,10,57,42,15,56
Queen of S't,9575,5,12,11,13,45,50,-5,47
Raith,9575,6,10,10,16,37,49,-12,40
Dumbarton,9575,7,8,15,13,49,58,-9,39
Dunfermline,9575,8,8,13,15,41,50,-9,37
St Mirren,9575,9,8,11,17,39,62,-23,35
Ayr,9575,10,7,13,16,34,56,-22,34
Hibernian,9576,1,18,13,5,56,26,30,67
Morton,9576,2,17,12,7,53,37,16,63
Dundee Utd,9576,3,16,11,9,55,41,14,59
Falkirk,9576,4,15,12,9,56,41,15,57
Queen of S't,9576,5,13,9,14,50,52,-2,48
Dunfermline,9576,6,11,12,13,46,46,0,45
Raith,9576,7,12,8,16,36,50,-14,44
Dumbarton,9576,8,8,13,15,48,61,-13,37
Ayr,9576,9,8,12,16,34,55,-21,36
St Mirren,9576,10,6,10,20,37,62,-25,28
Hibernian,9577,1,20,10,6,63,26,37,70
Dundee Utd,9577,2,17,10,9,57,42,15,61
Morton,9577,3,16,13,7,48,36,12,61
Falkirk,9577,4,16,9,11,55,42,13,57
Queen of S't,9577,5,12,9,15,42,55,-13,45
Dumbarton,9577,6,10,12,14,47,52,-5,42
Raith,9577,7,11,9,16,36,48,-12,42
Dunfermline,9577,8,9,13,14,43,47,-4,40
Ayr,9577,9,8,12,16,33,53,-20,36
St Mirren,9577,10,7,11,18,34,57,-23,32
Hibernian,9578,1,18,13,5,54,30,24,67
Falkirk,9578,2,17,12,7,58,38,20,63
Dundee Utd,9578,3,17,10,9,51,34,17,61
Morton,9578,4,16,13,7,52,39,13,61
Dunfermline,9578,5,10,12,14,47,47,0,42
Raith,9578,6,10,10,16,36,51,-15,40
Ayr,9578,7,10,10,16,36,57,-21,40
Queen of S't,9578,8,10,9,17,43,54,-11,39
St Mirren,9578,9,9,10,17,43,55,-12,37
Dumbarton,9578,10,8,11,17,49,64,-15,35
Hibernian,9579,1,21,11,4,56,23,33,74
Falkirk,9579,2,17,11,8,61,40,21,62
Dundee Utd,9579,3,16,11,9,52,38,14,59
Morton,9579,4,15,11,10,47,39,8,56
Dunfermline,9579,5,9,15,12,43,44,-1,42
Queen of S't,9579,6,11,9,16,44,53,-9,42
Raith,9579,7,11,9,16,39,52,-13,42
Dumbarton,9579,8,8,14,14,50,61,-11,38
St Mirren,9579,9,8,11,17,38,54,-16,35
Ayr,9579,10,7,12,17,31,57,-26,33
Hibernian,9580,1,18,13,5,62,30,32,67
Falkirk,9580,2,17,11,8,67,39,28,62
Morton,9580,3,16,12,8,50,37,13,60
Dundee Utd,9580,4,15,12,9,56,42,14,57
Queen of S't,9580,5,11,10,15,46,56,-10,43
Raith,9580,6,11,9,16,39,52,-13,42
Dunfermline,9580,7,9,13,14,48,61,-13,40
Dumbarton,9580,8,9,11,16,49,61,-12,38
St Mirren,9580,9,9,10,17,44,60,-16,37
Ayr,9580,10,7,15,14,35,58,-23,36
Hibernian,9581,1,20,13,3,58,22,36,73
Dundee Utd,9581,2,18,8,10,58,38,20,62
Morton,9581,3,16,13,7,50,39,11,61
Falkirk,9581,4,16,11,9,57,47,10,59
Ayr,9581,5,10,12,14,40,54,-14,42
Queen of S't,9581,6,10,9,17,43,50,-7,39
Dunfermline,9581,7,8,15,13,42,51,-9,39
Raith,9581,8,9,11,16,34,51,-17,38
St Mirren,9581,9,8,11,17,39,56,-17,35
Dumbarton,9581,10,7,13,16,46,59,-13,34
Hibernian,9582,1,18,13,5,52,24,28,67
Morton,9582,2,18,12,6,48,32,16,66
Falkirk,9582,3,15,11,10,55,40,15,56
Dundee Utd,9582,4,14,11,11,46,40,6,53
Dunfermline,9582,5,10,16,10,46,43,3,46
Queen of S't,9582,6,10,11,15,45,52,-7,41
Raith,9582,7,9,12,15,31,45,-14,39
St Mirren,9582,8,9,11,16,39,54,-15,38
Ayr,9582,9,8,13,15,35,55,-20,37
Dumbarton,9582,10,8,12,16,48,60,-12,36
Hibernian,9583,1,19,12,5,62,26,36,69
Morton,9583,2,19,10,7,51,33,18,67
Falkirk,9583,3,16,11,9,62,44,18,59
Dundee Utd,9583,4,16,10,10,54,43,11,58
Dunfermline,9583,5,10,13,13,46,47,-1,43
Queen of S't,9583,6,11,9,16,44,53,-9,42
Raith,9583,7,11,8,17,38,54,-16,41
Dumbarton,9583,8,9,12,15,46,56,-10,39
St Mirren,9583,9,9,10,17,45,62,-17,37
Ayr,9583,10,7,11,18,32,62,-30,32
Hibernian,9584,1,18,13,5,55,27,28,67
Morton,9584,2,17,10,9,47,39,8,61
Falkirk,9584,3,16,10,10,57,40,17,58
Dundee Utd,9584,4,16,10,10,52,40,12,58
Raith,9584,5,14,9,13,42,45,-3,51
Queen of S't,9584,6,12,10,14,48,51,-3,46
Dumbarton,9584,7,10,13,13,53,55,-2,43
Dunfermline,9584,8,9,13,14,42,49,-7,40
St Mirren,9584,9,7,10,19,38,60,-22,31
Ayr,9584,10,6,12,18,33,61,-28,30
Hibernian,9585,1,20,11,5,53,23,30,71
Falkirk,9585,2,17,9,10,56,41,15,60
Dundee Utd,9585,3,16,10,10,54,40,14,58
Morton,9585,4,15,12,9,47,36,11,57
Dunfermline,9585,5,10,13,13,43,48,-5,43
Queen of S't,9585,6,10,11,15,40,48,-8,41
Dumbarton,9585,7,10,11,15,47,56,-9,41
Ayr,9585,8,9,14,13,34,52,-18,41
Raith,9585,9,9,10,17,30,44,-14,37
St Mirren,9585,10,8,11,17,40,56,-16,35
Hibernian,9586,1,17,14,5,57,29,28,65
Dundee Utd,9586,2,17,10,9,55,41,14,61
Morton,9586,3,16,11,9,50,41,9,59
Falkirk,9586,4,15,9,12,56,47,9,54
Queen of S't,9586,5,13,10,13,48,50,-2,49
Dumbarton,9586,6,11,11,14,52,56,-4,44
Dunfermline,9586,7,9,14,13,47,49,-2,41
Raith,9586,8,10,9,17,39,51,-12,39
St Mirren,9586,9,8,12,16,44,61,-17,36
Ayr,9586,10,7,14,15,35,58,-23,35
Hibernian,9587,1,19,10,7,57,28,29,67
Morton,9587,2,16,12,8,49,38,11,60
Dundee Utd,9587,3,17,8,11,56,43,13,59
Falkirk,9587,4,15,10,11,60,51,9,55
Dunfermline,9587,5,11,13,12,44,46,-2,46
Raith,9587,6,12,10,14,41,47,-6,46
Queen of S't,9587,7,11,12,13,52,52,0,45
Ayr,9587,8,10,12,14,35,53,-18,42
Dumbarton,9587,9,9,11,16,47,58,-11,38
St Mirren,9587,10,6,10,20,35,60,-25,28
Hibernian,9588,1,21,12,3,59,21,38,75
Falkirk,9588,2,17,11,8,64,38,26,62
Dundee Utd,9588,3,16,9,11,50,42,8,57
Morton,9588,4,15,12,9,48,40,8,57
Queen of S't,9588,5,10,12,14,44,51,-7,42
Ayr,9588,6,10,11,15,41,56,-15,41
Dunfermline,9588,7,9,13,14,42,48,-6,40
Dumbarton,9588,8,9,13,14,46,55,-9,40
Raith,9588,9,9,10,17,36,51,-15,37
St Mirren,9588,10,7,11,18,34,62,-28,32
Hibernian,9589,1,18,14,4,58,29,29,68
Falkirk,9589,2,17,12,7,59,38,21,63
Morton,9589,3,17,11,8,50,36,14,62
Dundee Utd,9589,4,15,11,10,49,41,8,56
Ayr,9589,5,11,11,14,40,55,-15,44
Dunfermline,9589,6,9,13,14,42,46,-4,40
Queen of S't,9589,7,10,9,17,43,55,-12,39
Raith,9589,8,10,8,18,40,54,-14,38
Dumbarton,9589,9,8,13,15,47,60,-13,37
St Mirren,9589,10,9,10,17,45,59,-14,37
Morton,9590,1,19,9,8,59,39,20,66
Hibernian,9590,2,17,13,6,56,32,24,64
Falkirk,9590,3,17,9,10,58,39,19,60
Dundee Utd,9590,4,13,13,10,50,45,5,52
Queen of S't,9590,5,12,11,13,43,46,-3,47
Dunfermline,9590,6,11,13,12,50,47,3,46
Raith,9590,7,11,9,16,35,48,-13,42
Ayr,9590,8,8,13,15,33,55,-22,37
Dumbarton,9590,9,8,11,17,46,62,-16,35
St Mirren,9590,10,8,11,17,38,55,-17,35
Hibernian,9591,1,20,11,5,59,24,35,71
Falkirk,9591,2,16,10,10,58,42,16,58
Morton,9591,3,14,15,7,52,40,12,57
Dundee Utd,9591,4,14,12,10,47,40,7,54
Raith,9591,5,12,9,15,42,51,-9,45
Queen of S't,9591,6,11,10,15,42,50,-8,43
Dumbarton,9591,7,9,13,14,52,61,-9,40
Dunfermline,9591,8,8,14,14,45,54,-9,38
St Mirren,9591,9,9,11,16,41,54,-13,38
Ayr,9591,10,8,13,15,35,57,-22,37
Hibernian,9592,1,19,13,4,58,26,32,70
Morton,9592,2,16,13,7,55,37,18,61
Dundee Utd,9592,3,16,10,10,49,38,11,58
Falkirk,9592,4,15,12,9,60,46,14,57
Ayr,9592,5,10,12,14,39,53,-14,42
Raith,9592,6,10,11,15,39,50,-11,41
Queen of S't,9592,7,10,10,16,41,52,-11,40
Dunfermline,9592,8,8,15,13,45,57,-12,39
Dumbarton,9592,9,8,13,15,48,56,-8,37
St Mirren,9592,10,8,11,17,41,60,-19,35
Hibernian,9593,1,18,14,4,54,24,30,68
Falkirk,9593,2,16,9,11,58,46,12,57
Dundee Utd,9593,3,15,10,11,52,43,9,55
Morton,9593,4,14,13,9,46,41,5,55
Queen of S't,9593,5,12,11,13,44,47,-3,47
Raith,9593,6,12,11,13,35,43,-8,47
Ayr,9593,7,11,12,13,41,51,-10,45
Dunfermline,9593,8,9,14,13,41,43,-2,41
Dumbarton,9593,9,8,13,15,48,58,-10,37
St Mirren,9593,10,6,11,19,35,58,-23,29
Hibernian,9594,1,20,12,4,61,25,36,72
Falkirk,9594,2,16,11,9,59,41,18,59
Morton,9594,3,15,12,9,44,40,4,57
Dundee Utd,9594,4,15,10,11,51,40,11,55
Dunfermline,9594,5,11,11,14,47,50,-3,44
Queen of S't,9594,6,12,8,16,46,51,-5,44
St Mirren,9594,7,11,9,16,40,55,-15,42
Ayr,9594,8,10,11,15,37,52,-15,41
Dumbarton,9594,9,9,11,16,49,61,-12,38
Raith,9594,10,9,9,18,33,52,-19,36
Hibernian,9595,1,19,14,3,59,26,33,71
Falkirk,9595,2,18,11,7,63,39,24,65
Morton,9595,3,13,15,8,45,39,6,54
Dundee Utd,9595,4,15,9,12,49,45,4,54
Dunfermline,9595,5,10,14,12,51,50,1,44
Queen of S't,9595,6,11,10,15,52,57,-5,43
Dumbarton,9595,7,10,12,14,49,56,-7,42
Raith,9595,8,11,9,16,35,50,-15,42
Ayr,9595,9,8,13,15,35,55,-20,37
St Mirren,9595,10,6,11,19,37,58,-21,29
Hibernian,9596,1,20,12,4,56,24,32,72
Dundee Utd,9596,2,18,9,9,57,36,21,63
Morton,9596,3,16,9,11,48,40,8,57
Falkirk,9596,4,15,11,10,58,40,18,56
Dunfermline,9596,5,13,12,11,49,44,5,51
Queen of S't,9596,6,11,8,17,40,55,-15,41
Raith,9596,7,10,10,16,37,49,-12,40
Dumbarton,9596,8,9,11,16,48,60,-12,38
Ayr,9596,9,9,10,17,34,57,-23,37
St Mirren,9596,10,7,12,17,38,60,-22,33
Hibernian,9597,1,21,11,4,59,23,36,74
Falkirk,9597,2,16,12,8,57,39,18,60
Morton,9597,3,16,11,9,50,39,11,59
Dundee Utd,9597,4,15,11,10,52,40,12,56
Queen of S't,9597,5,13,10,13,45,46,-1,49
Dunfermline,9597,6,10,13,13,49,52,-3,43
Dumbarton,9597,7,8,14,14,49,58,-9,38
St Mirren,9597,8,9,9,18,41,59,-18,36
Raith,9597,9,9,8,19,32,53,-21,35
Ayr,9597,10,7,13,16,30,55,-25,34
Hibernian,9598,1,21,12,3,61,22,39,75
Falkirk,9598,2,17,10,9,62,43,19,61
Dundee Utd,9598,3,16,10,10,52,39,13,58
Morton,9598,4,16,10,10,47,35,12,58
Dunfermline,9598,5,11,14,11,50,47,3,47
Queen of S't,9598,6,10,11,15,40,50,-10,41
Ayr,9598,7,10,11,15,33,60,-27,41
Raith,9598,8,10,9,17,32,46,-14,39
St Mirren,9598,9,8,10,18,40,58,-18,34
Dumbarton,9598,10,7,11,18,43,60,-17,32
Hibernian,9599,1,18,13,5,57,30,27,67
Morton,9599,2,16,13,7,53,37,16,61
Falkirk,9599,3,15,12,9,57,40,17,57
Dundee Utd,9599,4,15,9,12,48,42,6,54
Raith,9599,5,11,12,13,37,41,-4,45
Ayr,9599,6,11,12,13,40,49,-9,45
Queen of S't,9599,7,11,10,15,42,50,-8,43
Dumbarton,9599,8,10,11,15,48,60,-12,41
Dunfermline,9599,9,9,13,14,41,49,-8,40
St Mirren,9599,10,6,11,19,41,66,-25,29
Hibernian,9600,1,18,14,4,54,25,29,68
Falkirk,9600,2,17,11,8,59,39,20,62
Morton,9600,3,15,13,8,45,36,9,58
Dundee Utd,9600,4,16,9,11,48,39,9,57
Dumbarton,9600,5,11,11,14,48,54,-6,44
Queen of S't,9600,6,11,9,16,45,53,-8,42
Dunfermline,9600,7,9,13,14,42,47,-5,40
St Mirren,9600,8,9,13,14,42,51,-9,40
Ayr,9600,9,9,10,17,36,56,-20,37
Raith,9600,10,9,9,18,34,53,-19,36
Hibernian,9601,1,20,11,5,60,26,34,71
Falkirk,9601,2,17,9,10,61,45,16,60
Morton,9601,3,16,12,8,46,36,10,60
Dundee Utd,9601,4,17,8,11,55,43,12,59
Queen of S't,9601,5,13,11,12,47,46,1,50
Raith,9601,6,11,9,16,39,49,-10,42
Dumbarton,9601,7,10,10,16,52,60,-8,40
Dunfermline,9601,8,9,13,14,43,54,-11,40
St Mirren,9601,9,8,10,18,39,56,-17,34
Ayr,9601,10,6,13,17,29,56,-27,31
Hibernian,9602,1,17,12,7,55,27,28,63
Morton,9602,2,16,12,8,50,38,12,60
Dundee Utd,9602,3,16,10,10,49,42,7,58
Falkirk,9602,4,14,11,11,60,46,14,53
Queen of S't,9602,5,13,9,14,50,52,-2,48
Dunfermline,9602,6,11,12,13,46,48,-2,45
Raith,9602,7,11,10,15,35,49,-14,43
St Mirren,9602,8,11,9,16,46,57,-11,42
Dumbarton,9602,9,9,11,16,50,61,-11,38
Ayr,9602,10,9,10,17,32,53,-21,37
Hibernian,9603,1,19,12,5,58,26,32,69
Morton,9603,2,17,12,7,48,36,12,63
Falkirk,9603,3,17,10,9,62,38,24,61
Dundee Utd,9603,4,16,10,10,52,44,8,58
Dunfermline,9603,5,12,11,13,49,49,0,47
Queen of S't,9603,6,11,11,14,45,48,-3,44
St Mirren,9603,7,9,11,16,41,55,-14,38
Raith,9603,8,9,10,17,29,46,-17,37
Dumbarton,9603,9,7,13,16,42,60,-18,34
Ayr,9603,10,6,14,16,33,57,-24,32
Hibernian,9604,1,20,10,6,63,29,34,70
Morton,9604,2,20,9,7,52,31,21,69
Falkirk,9604,3,17,9,10,64,47,17,60
Dundee Utd,9604,4,16,8,12,48,46,2,56
Dunfermline,9604,5,12,11,13,54,49,5,47
Queen of S't,9604,6,12,8,16,44,53,-9,44
Dumbarton,9604,7,10,12,14,50,57,-7,42
Raith,9604,8,10,9,17,32,52,-20,39
Ayr,9604,9,7,12,17,29,54,-25,33
St Mirren,9604,10,7,10,19,39,57,-18,31
Hibernian,9605,1,18,13,5,53,29,24,67
Morton,9605,2,18,12,6,55,35,20,66
Falkirk,9605,3,18,10,8,60,36,24,64
Dundee Utd,9605,4,15,11,10,45,37,8,56
Queen of S't,9605,5,11,10,15,48,52,-4,43
St Mirren,9605,6,10,11,15,40,50,-10,41
Raith,9605,7,10,9,17,35,57,-22,39
Dunfermline,9605,8,8,14,14,43,48,-5,38
Dumbarton,9605,9,8,11,17,46,62,-16,35
Ayr,9605,10,8,11,17,34,53,-19,35
Hibernian,9606,1,18,12,6,53,27,26,66
Dundee Utd,9606,2,19,8,9,49,35,14,65
Morton,9606,3,15,14,7,50,35,15,59
Falkirk,9606,4,16,9,11,62,47,15,57
Dunfermline,9606,5,11,14,11,53,48,5,47
Queen of S't,9606,6,11,9,16,44,49,-5,42
Raith,9606,7,10,10,16,34,49,-15,40
St Mirren,9606,8,9,10,17,35,52,-17,37
Dumbarton,9606,9,8,12,16,47,63,-16,36
Ayr,9606,10,7,14,15,30,52,-22,35
Hibernian,9607,1,17,14,5,53,26,27,65
Morton,9607,2,18,11,7,51,33,18,65
Dundee Utd,9607,3,17,8,11,49,39,10,59
Falkirk,9607,4,15,10,11,53,39,14,55
Queen of S't,9607,5,12,10,14,45,50,-5,46
Dunfermline,9607,6,10,14,12,46,46,0,44
Dumbarton,9607,7,9,12,15,46,56,-10,39
Ayr,9607,8,9,12,15,36,54,-18,39
St Mirren,9607,9,8,12,16,40,54,-14,36
Raith,9607,10,9,9,18,31,53,-22,36
Hibernian,9608,1,20,10,6,55,28,27,70
Morton,9608,2,18,10,8,55,41,14,64
Falkirk,9608,3,16,10,10,57,40,17,58
Dundee Utd,9608,4,14,11,11,46,40,6,53
Queen of S't,9608,5,15,8,13,47,47,0,53
Ayr,9608,6,12,11,13,41,50,-9,47
Dumbarton,9608,7,11,10,15,53,61,-8,43
Raith,9608,8,9,9,18,36,54,-18,36
Dunfermline,9608,9,7,14,15,44,51,-7,35
St Mirren,9608,10,7,9,20,36,58,-22,30
Hibernian,9609,1,20,11,5,58,27,31,71
Morton,9609,2,18,11,7,50,34,16,65
Dundee Utd,9609,3,17,9,10,54,40,14,60
Falkirk,9609,4,15,13,8,57,41,16,58
Queen of S't,9609,5,11,9,16,42,51,-9,42
Raith,9609,6,10,12,14,34,44,-10,42
Dumbarton,9609,7,9,11,16,46,60,-14,38
Dunfermline,9609,8,7,15,14,42,51,-9,36
St Mirren,9609,9,7,14,15,38,53,-15,35
Ayr,9609,10,7,13,16,34,54,-20,34
Hibernian,9610,1,20,11,5,61,30,31,71
Morton,9610,2,17,11,8,51,37,14,62
Falkirk,9610,3,16,11,9,63,42,21,59
Dundee Utd,9610,4,15,11,10,52,42,10,56
Dumbarton,9610,5,10,12,14,53,57,-4,42
Queen of S't,9610,6,11,9,16,44,54,-10,42
Raith,9610,7,10,11,15,33,48,-15,41
Dunfermline,9610,8,9,12,15,48,57,-9,39
Ayr,9610,9,8,14,14,34,52,-18,38
St Mirren,9610,10,8,10,18,44,64,-20,34
Hibernian,9611,1,19,12,5,56,27,29,69
Morton,9611,2,16,12,8,47,35,12,60
Dundee Utd,9611,3,16,11,9,48,35,13,59
Falkirk,9611,4,14,11,11,56,45,11,53
Queen of S't,9611,5,12,10,14,51,51,0,46
Dumbarton,9611,6,12,10,14,51,56,-5,46
St Mirren,9611,7,10,12,14,42,52,-10,42
Dunfermline,9611,8,8,16,12,41,48,-7,40
Raith,9611,9,10,9,17,35,50,-15,39
Ayr,9611,10,6,11,19,34,62,-28,29
Hibernian,9612,1,20,12,4,59,27,32,72
Falkirk,9612,2,16,11,9,56,38,18,59
Dundee Utd,9612,3,16,10,10,50,37,13,58
Morton,9612,4,16,10,10,48,38,10,58
Queen of S't,9612,5,12,10,14,43,48,-5,46
Dumbarton,9612,6,11,10,15,50,57,-7,43
Ayr,9612,7,10,11,15,35,53,-18,41
Dunfermline,9612,8,9,12,15,52,56,-4,39
Raith,9612,9,10,9,17,33,49,-16,39
St Mirren,9612,10,8,9,19,37,60,-23,33
Hibernian,9613,1,18,12,6,59,31,28,66
Falkirk,9613,2,17,10,9,58,39,19,61
Morton,9613,3,15,12,9,51,41,10,57
Dundee Utd,9613,4,15,9,12,54,43,11,54
Dunfermline,9613,5,11,13,12,52,49,3,46
Queen of S't,9613,6,12,8,16,41,51,-10,44
Raith,9613,7,11,10,15,35,49,-14,43
Dumbarton,9613,8,10,12,14,47,56,-9,42
Ayr,9613,9,9,12,15,34,54,-20,39
St Mirren,9613,10,6,14,16,37,55,-18,32
Morton,9614,1,19,11,6,50,32,18,68
Hibernian,9614,2,17,13,6,51,29,22,64
Dundee Utd,9614,3,17,10,9,51,37,14,61
Falkirk,9614,4,15,11,10,55,43,12,56
Queen of S't,9614,5,11,12,13,42,47,-5,45
Dunfermline,9614,6,9,13,14,44,44,0,40
Raith,9614,7,10,10,16,35,46,-11,40
Dumbarton,9614,8,9,11,16,49,60,-11,38
St Mirren,9614,9,9,10,17,42,58,-16,37
Ayr,9614,10,8,11,17,35,58,-23,35
Hibernian,9615,1,19,11,6,50,23,27,68
Falkirk,9615,2,18,9,9,59,38,21,63
Morton,9615,3,17,12,7,48,31,17,63
Dundee Utd,9615,4,15,10,11,51,41,10,55
Dunfermline,9615,5,10,14,12,42,42,0,44
Queen of S't,9615,6,10,12,14,42,52,-10,42
Raith,9615,7,9,11,16,37,54,-17,38
Dumbarton,9615,8,8,13,15,48,58,-10,37
Ayr,9615,9,8,13,15,31,51,-20,37
St Mirren,9615,10,9,9,18,41,59,-18,36
Hibernian,9616,1,19,13,4,56,28,28,70
Morton,9616,2,17,9,10,50,39,11,60
Falkirk,9616,3,16,11,9,61,43,18,59
Dundee Utd,9616,4,14,11,11,51,40,11,53
Dumbarton,9616,5,11,12,13,52,53,-1,45
Dunfermline,9616,6,10,12,14,47,53,-6,42
Raith,9616,7,11,9,16,39,53,-14,42
Queen of S't,9616,8,10,11,15,42,49,-7,41
St Mirren,9616,9,10,10,16,43,57,-14,40
Ayr,9616,10,8,10,18,31,57,-26,34
Hibernian,9617,1,19,13,4,56,25,31,70
Morton,9617,2,17,10,9,48,39,9,61
Falkirk,9617,3,15,12,9,57,41,16,57
Dundee Utd,9617,4,14,12,10,51,44,7,54
Dunfermline,9617,5,10,14,12,46,46,0,44
Dumbarton,9617,6,10,13,13,48,54,-6,43
Queen of S't,9617,7,11,9,16,43,51,-8,42
Ayr,9617,8,8,14,14,36,53,-17,38
Raith,9617,9,9,10,17,35,51,-16,37
St Mirren,9617,10,8,11,17,39,55,-16,35
Hibernian,9618,1,19,11,6,59,30,29,68
Dundee Utd,9618,2,19,8,9,54,38,16,65
Morton,9618,3,17,11,8,51,38,13,62
Falkirk,9618,4,17,10,9,63,41,22,61
Raith,9618,5,11,10,15,39,48,-9,43
Queen of S't,9618,6,10,9,17,44,53,-9,39
Dumbarton,9618,7,9,11,16,46,60,-14,38
Dunfermline,9618,8,8,13,15,43,53,-10,37
St Mirren,9618,9,9,10,17,41,58,-17,37
Ayr,9618,10,8,13,15,37,58,-21,37
Hibernian,9619,1,18,14,4,57,30,27,68
Morton,9619,2,17,13,6,53,37,16,64
Falkirk,9619,3,15,14,7,59,39,20,59
Dundee Utd,9619,4,14,12,10,49,41,8,54
Queen of S't,9619,5,12,11,13,52,51,1,47
Dumbarton,9619,6,10,11,15,50,59,-9,41
St Mirren,9619,7,9,12,15,42,50,-8,39
Ayr,9619,8,8,13,15,32,58,-26,37
Dunfermline,9619,9,7,14,15,43,54,-11,35
Raith,9619,10,8,10,18,32,50,-18,34
Hibernian,9620,1,21,11,4,59,23,36,74
Morton,9620,2,20,9,7,55,40,15,69
Falkirk,9620,3,18,10,8,62,40,22,64
Dundee Utd,9620,4,15,9,12,48,43,5,54
Queen of S't,9620,5,11,12,13,44,48,-4,45
St Mirren,9620,6,10,10,16,44,53,-9,40
Raith,9620,7,10,10,16,40,52,-12,40
Dunfermline,9620,8,8,13,15,48,56,-8,37
Dumbarton,9620,9,7,11,18,45,63,-18,32
Ayr,9620,10,6,13,17,34,61,-27,31
Morton,9621,1,19,10,7,52,32,20,67
Hibernian,9621,2,17,14,5,50,26,24,65
Dundee Utd,9621,3,15,10,11,49,38,11,55
Falkirk,9621,4,14,11,11,58,49,9,53
Dunfermline,9621,5,10,14,12,48,45,3,44
Queen of S't,9621,6,11,11,14,49,50,-1,44
Dumbarton,9621,7,11,11,14,48,58,-10,44
Ayr,9621,8,9,12,15,34,52,-18,39
Raith,9621,9,9,11,16,35,55,-20,38
St Mirren,9621,10,8,10,18,39,57,-18,34
Hibernian,9622,1,18,13,5,54,29,25,67
Dundee Utd,9622,2,16,10,10,55,37,18,58
Falkirk,9622,3,14,12,10,60,46,14,54
Morton,9622,4,14,12,10,45,38,7,54
Dunfermline,9622,5,13,12,11,51,47,4,51
Raith,9622,6,11,10,15,38,50,-12,43
Queen of S't,9622,7,10,12,14,43,50,-7,42
Dumbarton,9622,8,10,12,14,54,62,-8,42
St Mirren,9622,9,9,11,16,45,58,-13,38
Ayr,9622,10,7,12,17,28,56,-28,33
Hibernian,9623,1,19,12,5,57,26,31,69
Morton,9623,2,16,14,6,51,34,17,62
Falkirk,9623,3,17,10,9,59,39,20,61
Dundee Utd,9623,4,15,11,10,44,37,7,56
Dumbarton,9623,5,10,13,13,54,55,-1,43
Dunfermline,9623,6,10,13,13,50,53,-3,43
Queen of S't,9623,7,10,12,14,40,48,-8,42
St Mirren,9623,8,9,10,17,36,53,-17,37
Raith,9623,9,9,9,18,33,54,-21,36
Ayr,9623,10,7,12,17,35,60,-25,33
Hibernian,9624,1,21,11,4,62,23,39,74
Falkirk,9624,2,18,9,9,62,43,19,63
Morton,9624,3,16,11,9,46,37,9,59
Dundee Utd,9624,4,14,10,12,47,43,4,52
Dunfermline,9624,5,11,11,14,46,49,-3,44
Queen of S't,9624,6,11,10,15,48,53,-5,43
Dumbarton,9624,7,10,11,15,49,59,-10,41
Raith,9624,8,10,10,16,34,47,-13,40
Ayr,9624,9,8,13,15,32,52,-20,37
St Mirren,9624,10,7,12,17,42,62,-20,33
Hibernian,9625,1,20,11,5,59,29,30,71
Morton,9625,2,18,10,8,51,36,15,64
Falkirk,9625,3,17,10,9,56,39,17,61
Dundee Utd,9625,4,16,8,12,48,38,10,56
St Mirren,9625,5,13,9,14,46,50,-4,48
Dunfermline,9625,6,11,12,13,47,48,-1,45
Queen of S't,9625,7,12,8,16,44,49,-5,44
Ayr,9625,8,9,10,17,33,55,-22,37
Dumbarton,9625,9,8,10,18,44,64,-20,34
Raith,9625,10,8,8,20,34,54,-20,32
Hibernian,9626,1,19,11,6,57,31,26,68
Falkirk,9626,2,17,10,9,60,41,19,61
Dundee Utd,9626,3,17,9,10,56,43,13,60
Morton,9626,4,16,10,10,51,36,15,58
Queen of S't,9626,5,12,9,15,48,50,-2,45
Dunfermline,9626,6,11,11,14,47,47,0,44
Dumbarton,9626,7,10,10,16,48,64,-16,40
Raith,9626,8,9,11,16,31,47,-16,38
St Mirren,9626,9,9,10,17,42,58,-16,37
Ayr,9626,10,8,13,15,34,57,-23,37
Hibernian,9627,1,19,11,6,55,27,28,68
Falkirk,9627,2,18,9,9,64,43,21,63
Dundee Utd,9627,3,17,10,9,49,39,10,61
Morton,9627,4,14,10,12,44,45,-1,52
Queen of S't,9627,5,13,9,14,52,53,-1,48
Dunfermline,9627,6,11,11,14,53,49,4,44
St Mirren,9627,7,10,10,16,41,53,-12,40
Raith,9627,8,10,10,16,37,52,-15,40
Ayr,9627,9,9,12,15,41,55,-14,39
Dumbarton,9627,10,8,10,18,43,63,-20,34
Hibernian,9628,1,19,12,5,52,23,29,69
Morton,9628,2,17,12,7,56,35,21,63
Falkirk,9628,3,17,9,10,56,39,17,60
Dundee Utd,9628,4,15,11,10,50,42,8,56
Queen of S't,9628,5,11,11,14,46,50,-4,44
Dunfermline,9628,6,10,13,13,48,51,-3,43
Dumbarton,9628,7,10,12,14,47,55,-8,42
Raith,9628,8,9,10,17,33,52,-19,37
St Mirren,9628,9,9,9,18,42,58,-16,36
Ayr,9628,10,8,11,17,31,56,-25,35
Hibernian,9629,1,18,12,6,55,26,29,66
Morton,9629,2,18,9,9,52,37,15,63
Dundee Utd,9629,3,17,10,9,51,36,15,61
Falkirk,9629,4,16,11,9,60,42,18,59
Dunfermline,9629,5,10,12,14,45,48,-3,42
Queen of S't,9629,6,10,12,14,43,50,-7,42
Dumbarton,9629,7,10,12,14,46,54,-8,42
St Mirren,9629,8,9,10,17,40,59,-19,37
Raith,9629,9,9,10,17,32,51,-19,37
Ayr,9629,10,7,14,15,30,51,-21,35
Hibernian,9630,1,22,10,4,60,21,39,76
Morton,9630,2,16,11,9,49,37,12,59
Dundee Utd,9630,3,15,11,10,48,39,9,56
Falkirk,9630,4,14,9,13,58,45,13,51
Dunfermline,9630,5,11,13,12,44,44,0,46
Dumbarton,9630,6,10,12,14,46,52,-6,42
Raith,9630,7,11,9,16,37,49,-12,42
Ayr,9630,8,10,11,15,34,56,-22,41
St Mirren,9630,9,9,11,16,40,54,-14,38
Queen of S't,9630,10,9,9,18,37,56,-19,36
Hibernian,9631,1,19,14,3,54,24,30,71
Morton,9631,2,16,12,8,53,36,17,60
Falkirk,9631,3,16,10,10,60,41,19,58
Dundee Utd,9631,4,16,10,10,53,41,12,58
Queen of S't,9631,5,14,9,13,48,46,2,51
Raith,9631,6,11,8,17,32,48,-16,41
Dumbarton,9631,7,9,13,14,52,61,-9,40
Dunfermline,9631,8,8,15,13,43,52,-9,39
Ayr,9631,9,7,12,17,34,60,-26,33
St Mirren,9631,10,7,11,18,37,57,-20,32
Hibernian,9632,1,19,13,4,59,26,33,70
Dundee Utd,9632,2,16,11,9,49,37,12,59
Falkirk,9632,3,15,12,9,58,40,18,57
Morton,9632,4,15,12,9,47,38,9,57
Dunfermline,9632,5,11,13,12,50,48,2,46
Ayr,9632,6,11,12,13,40,53,-13,45
St Mirren,9632,7,10,10,16,42,56,-14,40
Raith,9632,8,10,9,17,35,53,-18,39
Queen of S't,9632,9,9,10,17,44,59,-15,37
Dumbarton,9632,10,7,12,17,47,61,-14,33
Hibernian,9633,1,19,14,3,56,23,33,71
Dundee Utd,9633,2,18,9,9,55,40,15,63
Falkirk,9633,3,16,11,9,57,39,18,59
Morton,9633,4,15,13,8,50,37,13,58
Queen of S't,9633,5,13,8,15,47,50,-3,47
Dunfermline,9633,6,10,12,14,43,48,-5,42
Dumbarton,9633,7,9,10,17,46,63,-17,37
Ayr,9633,8,8,13,15,38,55,-17,37
St Mirren,9633,9,8,12,16,41,55,-14,36
Raith,9633,10,9,8,19,30,53,-23,35
Hibernian,9634,1,19,13,4,57,23,34,70
Morton,9634,2,17,10,9,52,36,16,61
Dundee Utd,9634,3,17,10,9,53,41,12,61
Falkirk,9634,4,15,13,8,56,39,17,58
Dumbarton,9634,5,11,11,14,51,55,-4,44
Queen of S't,9634,6,12,8,16,42,48,-6,44
Dunfermline,9634,7,10,12,14,42,49,-7,42
Raith,9634,8,10,9,17,36,49,-13,39
Ayr,9634,9,8,12,16,33,57,-24,36
St Mirren,9634,10,7,10,19,33,58,-25,31
Hibernian,9635,1,20,12,4,53,21,32,72
Dundee Utd,9635,2,17,10,9,50,37,13,61
Morton,9635,3,16,12,8,49,35,14,60
Falkirk,9635,4,15,11,10,58,40,18,56
Queen of S't,9635,5,14,8,14,48,47,1,50
Dunfermline,9635,6,10,14,12,45,45,0,44
Dumbarton,9635,7,11,11,14,50,54,-4,44
Ayr,9635,8,8,11,17,30,56,-26,35
St Mirren,9635,9,7,11,18,36,60,-24,32
Raith,9635,10,8,8,20,30,54,-24,32
Hibernian,9636,1,19,13,4,62,26,36,70
Morton,9636,2,17,13,6,54,35,19,64
Dundee Utd,9636,3,15,10,11,45,39,6,55
Falkirk,9636,4,14,12,10,55,43,12,54
Queen of S't,9636,5,11,11,14,45,51,-6,44
Raith,9636,6,11,11,14,38,47,-9,44
St Mirren,9636,7,10,11,15,42,52,-10,41
Dunfermline,9636,8,8,13,15,45,58,-13,37
Dumbarton,9636,9,8,12,16,47,59,-12,36
Ayr,9636,10,8,12,16,32,55,-23,36
Hibernian,9637,1,20,12,4,55,23,32,72
Morton,9637,2,16,12,8,49,36,13,60
Dundee Utd,9637,3,16,10,10,49,38,11,58
Falkirk,9637,4,15,11,10,54,40,14,56
Dunfermline,9637,5,11,13,12,45,48,-3,46
Queen of S't,9637,6,11,11,14,45,48,-3,44
St Mirren,9637,7,9,12,15,44,53,-9,39
Raith,9637,8,8,12,16,33,51,-18,36
Dumbarton,9637,9,8,11,17,43,57,-14,35
Ayr,9637,10,7,14,15,32,55,-23,35
Hibernian,9638,1,20,12,4,56,28,28,72
Morton,9638,2,17,10,9,51,41,10,61
Falkirk,9638,3,15,11,10,58,43,15,56
Dundee Utd,9638,4,15,10,11,51,43,8,55
Dunfermline,9638,5,12,12,12,47,45,2,48
Queen of S't,9638,6,11,11,14,47,49,-2,44
St Mirren,9638,7,10,10,16,42,54,-12,40
Dumbarton,9638,8,9,11,16,48,58,-10,38
Raith,9638,9,9,9,18,33,51,-18,36
Ayr,9638,10,8,12,16,33,54,-21,36
Hibernian,9639,1,21,12,3,62,25,37,75
Morton,9639,2,18,10,8,53,37,16,64
Falkirk,9639,3,16,12,8,58,38,20,60
Dundee Utd,9639,4,14,9,13,49,50,-1,51
Queen of S't,9639,5,13,10,13,48,46,2,49
Dunfermline,9639,6,10,13,13,49,48,1,43
Ayr,9639,7,9,12,15,38,55,-17,39
Dumbarton,9639,8,9,10,17,46,62,-16,37
Raith,9639,9,9,9,18,36,56,-20,36
St Mirren,9639,10,8,9,19,39,61,-22,33
Hibernian,9640,1,21,12,3,63,25,38,75
Morton,9640,2,17,12,7,56,38,18,63
Falkirk,9640,3,17,9,10,57,40,17,60
Dundee Utd,9640,4,16,10,10,50,39,11,58
Queen of S't,9640,5,13,8,15,45,52,-7,47
Ayr,9640,6,9,12,15,38,56,-18,39
Raith,9640,7,10,9,17,30,51,-21,39
Dunfermline,9640,8,8,12,16,42,52,-10,36
Dumbarton,9640,9,8,12,16,46,59,-13,36
St Mirren,9640,10,8,10,18,37,52,-15,34
Hibernian,9641,1,20,12,4,56,26,30,72
Morton,9641,2,16,12,8,53,39,14,60
Falkirk,9641,3,16,10,10,58,45,13,58
Dundee Utd,9641,4,13,11,12,44,39,5,50
Dunfermline,9641,5,11,15,10,51,48,3,48
Raith,9641,6,12,8,16,37,47,-10,44
Queen of S't,9641,7,10,11,15,44,51,-7,41
St Mirren,9641,8,9,11,16,43,55,-12,38
Dumbarton,9641,9,8,13,15,47,61,-14,37
Ayr,9641,10,8,11,17,31,53,-22,35
Hibernian,9642,1,21,11,4,61,25,36,74
Morton,9642,2,18,11,7,54,35,19,65
Falkirk,9642,3,18,10,8,62,36,26,64
Dundee Utd,9642,4,15,11,10,54,45,9,56
Queen of S't,9642,5,12,10,14,47,51,-4,46
Dunfermline,9642,6,10,14,12,50,47,3,44
Raith,9642,7,9,10,17,32,53,-21,37
St Mirren,9642,8,8,11,17,39,56,-17,35
Ayr,9642,9,7,11,18,36,61,-25,32
Dumbarton,9642,10,7,11,18,44,70,-26,32
Hibernian,9643,1,22,11,3,62,26,36,77
Falkirk,9643,2,17,10,9,61,44,17,61
Dundee Utd,9643,3,17,8,11,56,40,16,59
Morton,9643,4,14,11,11,44,42,2,53
Queen of S't,9643,5,11,12,13,45,49,-4,45
Dumbarton,9643,6,9,14,13,45,53,-8,41
Dunfermline,9643,7,9,13,14,46,51,-5,40
Raith,9643,8,9,10,17,33,50,-17,37
Ayr,9643,9,7,14,15,30,52,-22,35
St Mirren,9643,10,7,13,16,38,53,-15,34
Hibernian,9644,1,20,10,6,52,26,26,70
Falkirk,9644,2,18,9,9,62,43,19,63
Morton,9644,3,17,10,9,47,36,11,61
Dundee Utd,9644,4,17,8,11,59,36,23,59
Queen of S't,9644,5,13,9,14,46,52,-6,48
Dunfermline,9644,6,10,12,14,47,51,-4,42
Dumbarton,9644,7,10,10,16,47,56,-9,40
Ayr,9644,8,8,12,16,32,54,-22,36
St Mirren,9644,9,8,11,17,38,56,-18,35
Raith,9644,10,8,11,17,32,52,-20,35
Hibernian,9645,1,20,11,5,54,24,30,71
Falkirk,9645,2,19,10,7,65,38,27,67
Dundee Utd,9645,3,18,8,10,53,40,13,62
Morton,9645,4,15,10,11,49,46,3,55
Dunfermline,9645,5,10,12,14,46,49,-3,42
Dumbarton,9645,6,10,12,14,50,57,-7,42
St Mirren,9645,7,10,10,16,43,53,-10,40
Raith,9645,8,10,9,17,38,54,-16,39
Queen of S't,9645,9,10,8,18,41,55,-14,38
Ayr,9645,10,7,12,17,34,57,-23,33
Hibernian,9646,1,17,15,4,50,23,27,66
Falkirk,9646,2,17,9,10,57,40,17,60
Dundee Utd,9646,3,17,9,10,51,36,15,60
Morton,9646,4,16,12,8,51,38,13,60
Dunfermline,9646,5,10,13,13,48,49,-1,43
Queen of S't,9646,6,10,11,15,40,47,-7,41
St Mirren,9646,7,10,11,15,42,54,-12,41
Ayr,9646,8,9,12,15,31,52,-21,39
Raith,9646,9,9,10,17,37,55,-18,37
Dumbarton,9646,10,8,12,16,43,56,-13,36
Hibernian,9647,1,19,14,3,55,21,34,71
Morton,9647,2,17,12,7,57,35,22,63
Falkirk,9647,3,16,10,10,60,41,19,58
Dundee Utd,9647,4,15,11,10,50,43,7,56
Dunfermline,9647,5,9,15,12,44,47,-3,42
Queen of S't,9647,6,11,9,16,46,58,-12,42
Raith,9647,7,10,11,15,38,51,-13,41
Dumbarton,9647,8,8,13,15,48,60,-12,37
St Mirren,9647,9,8,12,16,38,58,-20,36
Ayr,9647,10,7,13,16,33,55,-22,34
Hibernian,9648,1,22,11,3,56,21,35,77
Morton,9648,2,16,12,8,52,34,18,60
Falkirk,9648,3,16,10,10,56,37,19,58
Dundee Utd,9648,4,15,10,11,46,41,5,55
Dunfermline,9648,5,10,12,14,44,50,-6,42
Queen of S't,9648,6,11,9,16,42,50,-8,42
Ayr,9648,7,10,11,15,36,55,-19,41
Raith,9648,8,10,10,16,37,50,-13,40
St Mirren,9648,9,8,12,16,47,57,-10,36
Dumbarton,9648,10,8,11,17,43,64,-21,35
Hibernian,9649,1,20,11,5,58,32,26,71
Morton,9649,2,17,11,8,50,39,11,62
Falkirk,9649,3,17,10,9,63,42,21,61
Dundee Utd,9649,4,15,10,11,51,37,14,55
Dumbarton,9649,5,12,11,13,52,54,-2,47
Dunfermline,9649,6,10,13,13,48,52,-4,43
Queen of S't,9649,7,11,9,16,45,53,-8,42
Raith,9649,8,10,10,16,38,49,-11,40
St Mirren,9649,9,8,10,18,37,59,-22,34
Ayr,9649,10,7,11,18,31,56,-25,32
Hibernian,9650,1,18,11,7,53,31,22,65
Morton,9650,2,18,10,8,53,32,21,64
Falkirk,9650,3,17,10,9,61,41,20,61
Dundee Utd,9650,4,16,10,10,52,40,12,58
Queen of S't,9650,5,12,9,15,45,50,-5,45
Raith,9650,6,11,9,16,34,47,-13,42
Dunfermline,9650,7,10,11,15,43,47,-4,41
Dumbarton,9650,8,9,13,14,50,60,-10,40
Ayr,9650,9,9,10,17,32,55,-23,37
St Mirren,9650,10,8,11,17,39,59,-20,35
Hibernian,9651,1,20,11,5,60,25,35,71
Morton,9651,2,16,11,9,48,37,11,59
Falkirk,9651,3,15,10,11,57,43,14,55
Dundee Utd,9651,4,14,9,13,49,50,-1,51
Dunfermline,9651,5,11,14,11,49,44,5,47
Dumbarton,9651,6,11,11,14,55,57,-2,44
St Mirren,9651,7,11,10,15,42,52,-10,43
Ayr,9651,8,10,11,15,40,58,-18,41
Queen of S't,9651,9,10,9,17,42,54,-12,39
Raith,9651,10,9,10,17,30,52,-22,37
Morton,9652,1,20,11,5,54,29,25,71
Hibernian,9652,2,17,13,6,50,30,20,64
Falkirk,9652,3,15,12,9,63,48,15,57
Dundee Utd,9652,4,14,13,9,49,40,9,55
Queen of S't,9652,5,13,10,13,45,45,0,49
Raith,9652,6,10,10,16,37,47,-10,40
Dunfermline,9652,7,8,15,13,41,46,-5,39
Dumbarton,9652,8,9,12,15,47,55,-8,39
St Mirren,9652,9,8,10,18,42,62,-20,34
Ayr,9652,10,7,12,17,29,55,-26,33
Hibernian,9653,1,17,13,6,52,28,24,64
Morton,9653,2,17,11,8,52,39,13,62
Falkirk,9653,3,17,10,9,60,40,20,61
Dundee Utd,9653,4,14,10,12,48,39,9,52
Queen of S't,9653,5,13,11,12,49,44,5,50
Dunfermline,9653,6,12,12,12,45,43,2,48
Raith,9653,7,10,10,16,32,48,-16,40
Ayr,9653,8,9,11,16,35,56,-21,38
Dumbarton,9653,9,8,12,16,46,61,-15,36
St Mirren,9653,10,8,10,18,42,63,-21,34
Hibernian,9654,1,17,15,4,55,29,26,66
Falkirk,9654,2,17,11,8,62,39,23,62
Morton,9654,3,16,12,8,52,39,13,60
Dundee Utd,9654,4,16,9,11,55,45,10,57
Queen of S't,9654,5,13,9,14,48,47,1,48
Dunfermline,9654,6,11,12,13,46,47,-1,45
Raith,9654,7,12,9,15,35,47,-12,45
Dumbarton,9654,8,9,12,15,49,59,-10,39
Ayr,9654,9,7,11,18,31,61,-30,32
St Mirren,9654,10,6,12,18,36,56,-20,30
Hibernian,9655,1,20,12,4,60,25,35,72
Falkirk,9655,2,17,10,9,60,42,18,61
Dundee Utd,9655,3,17,8,11,56,42,14,59
Morton,9655,4,16,11,9,48,40,8,59
Queen of S't,9655,5,12,9,15,45,51,-6,45
Raith,9655,6,12,9,15,36,44,-8,45
Dunfermline,9655,7,9,12,15,41,48,-7,39
St Mirren,9655,8,9,10,17,44,59,-15,37
Dumbarton,9655,9,9,10,17,44,64,-20,37
Ayr,9655,10,8,11,17,37,56,-19,35
Hibernian,9656,1,20,12,4,55,25,30,72
Falkirk,9656,2,16,13,7,64,42,22,61
Morton,9656,3,14,15,7,46,35,11,57
Dundee Utd,9656,4,14,11,11,49,44,5,53
Dunfermline,9656,5,11,14,11,50,50,0,47
Queen of S't,9656,6,11,10,15,44,49,-5,43
St Mirren,9656,7,9,11,16,41,55,-14,38
Raith,9656,8,9,11,16,32,49,-17,38
Ayr,9656,9,8,12,16,34,53,-19,36
Dumbarton,9656,10,7,13,16,41,54,-13,34
Hibernian,9657,1,19,11,6,55,28,27,68
Falkirk,9657,2,18,10,8,64,40,24,64
Dundee Utd,9657,3,18,9,9,52,35,17,63
Morton,9657,4,14,13,9,45,37,8,55
Dunfermline,9657,5,9,15,12,46,48,-2,42
St Mirren,9657,6,10,10,16,45,55,-10,40
Queen of S't,9657,7,10,10,16,45,56,-11,40
Ayr,9657,8,9,12,15,34,53,-19,39
Raith,9657,9,9,10,17,35,51,-16,37
Dumbarton,9657,10,7,14,15,46,64,-18,35
Hibernian,9658,1,20,12,4,55,23,32,72
Dundee Utd,9658,2,17,10,9,57,39,18,61
Falkirk,9658,3,15,12,9,57,40,17,57
Morton,9658,4,15,12,9,49,38,11,57
Queen of S't,9658,5,12,10,14,45,51,-6,46
Dunfermline,9658,6,10,13,13,47,50,-3,43
Raith,9658,7,10,12,14,35,45,-10,42
St Mirren,9658,8,8,12,16,40,52,-12,36
Dumbarton,9658,9,8,10,18,46,71,-25,34
Ayr,9658,10,6,15,15,31,53,-22,33
Hibernian,9659,1,20,12,4,56,23,33,72
Morton,9659,2,18,11,7,50,36,14,65
Falkirk,9659,3,15,11,10,54,42,12,56
Dundee Utd,9659,4,15,9,12,47,38,9,54
Queen of S't,9659,5,14,9,13,50,50,0,51
Raith,9659,6,11,10,15,34,43,-9,43
Dunfermline,9659,7,9,13,14,43,49,-6,40
Ayr,9659,8,8,12,16,30,53,-23,36
Dumbarton,9659,9,8,11,17,46,57,-11,35
St Mirren,9659,10,8,10,18,37,56,-19,34
Hibernian,9660,1,18,13,5,50,25,25,67
Morton,9660,2,17,11,8,53,37,16,62
Dundee Utd,9660,3,15,10,11,47,42,5,55
Falkirk,9660,4,13,13,10,54,41,13,52
Queen of S't,9660,5,12,11,13,46,47,-1,47
Dunfermline,9660,6,11,12,13,47,46,1,45
Dumbarton,9660,7,9,13,14,47,55,-8,40
Raith,9660,8,10,10,16,37,48,-11,40
St Mirren,9660,9,9,10,17,40,56,-16,37
Ayr,9660,10,8,13,15,33,57,-24,37
Hibernian,9661,1,19,11,6,59,31,28,68
Falkirk,9661,2,18,10,8,60,38,22,64
Morton,9661,3,16,11,9,48,38,10,59
Dundee Utd,9661,4,15,10,11,51,46,5,55
Queen of S't,9661,5,12,11,13,48,48,0,47
Raith,9661,6,12,9,15,37,45,-8,45
Dunfermline,9661,7,10,13,13,45,47,-2,43
Dumbarton,9661,8,10,11,15,48,59,-11,41
St Mirren,9661,9,9,9,18,43,59,-16,36
Ayr,9661,10,6,11,19,30,58,-28,29
Hibernian,9662,1,18,12,6,53,25,28,66
Morton,9662,2,18,12,6,55,33,22,66
Dundee Utd,9662,3,17,9,10,51,40,11,60
Falkirk,9662,4,15,12,9,58,43,15,57
Dunfermline,9662,5,10,12,14,51,59,-8,42
Dumbarton,9662,6,9,14,13,55,59,-4,41
Raith,9662,7,10,11,15,36,47,-11,41
Queen of S't,9662,8,10,10,16,43,55,-12,40
Ayr,9662,9,8,13,15,35,56,-21,37
St Mirren,9662,10,6,13,17,36,56,-20,31
Hibernian,9663,1,20,11,5,60,25,35,71
Morton,9663,2,16,13,7,48,38,10,61
Falkirk,9663,3,15,12,9,59,39,20,57
Dundee Utd,9663,4,16,9,11,49,39,10,57
Queen of S't,9663,5,14,9,13,49,48,1,51
Ayr,9663,6,10,12,14,36,56,-20,42
Raith,9663,7,10,9,17,35,48,-13,39
Dunfermline,9663,8,8,13,15,44,52,-8,37
St Mirren,9663,9,9,9,18,35,56,-21,36
Dumbarton,9663,10,7,13,16,41,55,-14,34
Hibernian,9664,1,19,12,5,58,27,31,69
Morton,9664,2,16,12,8,49,39,10,60
Dundee Utd,9664,3,15,11,10,55,39,16,56
Falkirk,9664,4,15,10,11,59,43,16,55
Queen of S't,9664,5,11,11,14,45,53,-8,44
Raith,9664,6,11,11,14,41,49,-8,44
Dunfermline,9664,7,10,13,13,48,52,-4,43
Dumbarton,9664,8,9,13,14,50,57,-7,40
Ayr,9664,9,9,12,15,33,54,-21,39
St Mirren,9664,10,7,11,18,39,64,-25,32
Hibernian,9665,1,19,13,4,57,24,33,70
Morton,9665,2,19,10,7,59,36,23,67
Falkirk,9665,3,16,11,9,55,36,19,59
Dundee Utd,9665,4,15,10,11,50,43,7,55
Queen of S't,9665,5,12,10,14,49,51,-2,46
Dumbarton,9665,6,9,12,15,51,59,-8,39
Raith,9665,7,10,9,17,33,51,-18,39
Dunfermline,9665,8,9,11,16,41,57,-16,38
Ayr,9665,9,8,14,14,39,56,-17,38
St Mirren,9665,10,8,10,18,42,63,-21,34
Morton,9666,1,18,12,6,48,31,17,66
Falkirk,9666,2,17,9,10,59,40,19,60
Hibernian,9666,3,15,14,7,48,29,19,59
Dundee Utd,9666,4,15,11,10,52,39,13,56
Queen of S't,9666,5,12,10,14,48,52,-4,46
Dunfermline,9666,6,10,14,12,45,45,0,44
Raith,9666,7,11,10,15,34,47,-13,43
St Mirren,9666,8,10,10,16,39,51,-12,40
Ayr,9666,9,7,14,15,32,53,-21,35
Dumbarton,9666,10,7,12,17,49,67,-18,33
Hibernian,9667,1,19,12,5,56,27,29,69
Dundee Utd,9667,2,18,9,9,58,38,20,63
Morton,9667,3,15,13,8,44,33,11,58
Falkirk,9667,4,15,10,11,56,45,11,55
Raith,9667,5,12,11,13,43,50,-7,47
Dunfermline,9667,6,10,14,12,47,46,1,44
Queen of S't,9667,7,11,9,16,46,56,-10,42
Dumbarton,9667,8,10,10,16,46,58,-12,40
St Mirren,9667,9,9,10,17,46,59,-13,37
Ayr,9667,10,6,12,18,29,59,-30,30
Hibernian,9668,1,18,13,5,52,24,28,67
Morton,9668,2,16,10,10,45,37,8,58
Falkirk,9668,3,14,12,10,56,46,10,54
Dundee Utd,9668,4,12,12,12,44,44,0,48
Dunfermline,9668,5,10,15,11,49,50,-1,45
Queen of S't,9668,6,11,12,13,44,46,-2,45
Dumbarton,9668,7,10,12,14,54,62,-8,42
Raith,9668,8,10,11,15,33,44,-11,41
Ayr,9668,9,9,14,13,36,51,-15,41
St Mirren,9668,10,10,9,17,44,53,-9,39
Hibernian,9669,1,18,12,6,52,28,24,66
Morton,9669,2,16,13,7,57,40,17,61
Dundee Utd,9669,3,16,9,11,48,37,11,57
Dunfermline,9669,4,13,11,12,49,46,3,50
Queen of S't,9669,5,14,8,14,47,48,-1,50
Falkirk,9669,6,13,10,13,56,47,9,49
Raith,9669,7,12,10,14,39,46,-7,46
Dumbarton,9669,8,9,13,14,48,58,-10,40
St Mirren,9669,9,9,9,18,41,58,-17,36
Ayr,9669,10,7,11,18,30,59,-29,32
Hibernian,9670,1,19,12,5,60,26,34,69
Morton,9670,2,19,12,5,54,32,22,69
Falkirk,9670,3,16,13,7,55,34,21,61
Dundee Utd,9670,4,15,10,11,45,39,6,55
Dunfermline,9670,5,10,13,13,43,45,-2,43
Queen of S't,9670,6,11,10,15,43,54,-11,43
Raith,9670,7,10,9,17,34,50,-16,39
St Mirren,9670,8,8,12,16,43,55,-12,36
Dumbarton,9670,9,8,12,16,43,56,-13,36
Ayr,9670,10,7,11,18,31,60,-29,32
Hibernian,9671,1,19,11,6,54,25,29,68
Morton,9671,2,16,12,8,50,38,12,60
Falkirk,9671,3,16,11,9,57,39,18,59
Dundee Utd,9671,4,14,11,11,52,46,6,53
Queen of S't,9671,5,13,10,13,53,51,2,49
Dunfermline,9671,6,12,12,12,51,52,-1,48
Dumbarton,9671,7,10,10,16,51,63,-12,40
Raith,9671,8,9,11,16,35,56,-21,38
St Mirren,9671,9,9,10,17,43,53,-10,37
Ayr,9671,10,7,12,17,32,55,-23,33
Hibernian,9672,1,20,13,3,59,25,34,73
Morton,9672,2,18,11,7,55,39,16,65
Dundee Utd,9672,3,17,10,9,52,38,14,61
Falkirk,9672,4,14,13,9,58,44,14,55
Queen of S't,9672,5,11,12,13,46,51,-5,45
Dunfermline,9672,6,9,12,15,44,52,-8,39
Raith,9672,7,10,9,17,35,49,-14,39
Dumbarton,9672,8,9,11,16,47,56,-9,38
Ayr,9672,9,8,12,16,30,50,-20,36
St Mirren,9672,10,8,9,19,37,59,-22,33
Hibernian,9673,1,19,13,4,55,20,35,70
Dundee Utd,9673,2,18,9,9,56,40,16,63
Falkirk,9673,3,16,12,8,59,41,18,60
Morton,9673,4,15,13,8,51,41,10,58
Raith,9673,5,11,11,14,41,49,-8,44
Queen of S't,9673,6,11,9,16,48,56,-8,42
Dunfermline,9673,7,9,12,15,43,51,-8,39
Ayr,9673,8,9,11,16,35,57,-22,38
Dumbarton,9673,9,8,12,16,52,68,-16,36
St Mirren,9673,10,8,10,18,41,58,-17,34
Hibernian,9674,1,21,12,3,58,23,35,75
Morton,9674,2,16,11,9,47,42,5,59
Falkirk,9674,3,15,13,8,57,36,21,58
Dundee Utd,9674,4,14,10,12,45,39,6,52
Queen of S't,9674,5,14,10,12,49,46,3,52
Dunfermline,9674,6,10,12,14,47,48,-1,42
Ayr,9674,7,10,10,16,44,57,-13,40
Dumbarton,9674,8,8,12,16,47,64,-17,36
St Mirren,9674,9,9,9,18,43,61,-18,36
Raith,9674,10,9,9,18,33,54,-21,36
Hibernian,9675,1,20,11,5,59,25,34,71
Morton,9675,2,18,12,6,54,31,23,66
Falkirk,9675,3,16,9,11,59,41,18,57
Dundee Utd,9675,4,15,12,9,58,41,17,57
Queen of S't,9675,5,11,11,14,43,49,-6,44
Dunfermline,9675,6,10,12,14,42,51,-9,42
St Mirren,9675,7,9,11,16,43,59,-16,38
Raith,9675,8,10,8,18,34,54,-20,38
Ayr,9675,9,8,13,15,34,58,-24,37
Dumbarton,9675,10,8,11,17,45,62,-17,35
Hibernian,9676,1,19,12,5,54,25,29,69
Falkirk,9676,2,15,13,8,61,41,20,58
Morton,9676,3,15,12,9,45,37,8,57
Dundee Utd,9676,4,15,10,11,49,41,8,55
Queen of S't,9676,5,11,11,14,45,51,-6,44
Ayr,9676,6,10,14,12,37,51,-14,44
Dumbarton,9676,7,9,13,14,50,57,-7,40
Dunfermline,9676,8,7,17,12,46,51,-5,38
Raith,9676,9,9,11,16,31,46,-15,38
St Mirren,9676,10,8,11,17,37,55,-18,35
Hibernian,9677,1,19,13,4,56,22,34,70
Morton,9677,2,18,10,8,54,36,18,64
Falkirk,9677,3,16,10,10,59,46,13,58
Dundee Utd,9677,4,16,10,10,51,39,12,58
Queen of S't,9677,5,12,8,16,45,55,-10,44
Dumbarton,9677,6,10,10,16,49,59,-10,40
St Mirren,9677,7,10,10,16,37,51,-14,40
Dunfermline,9677,8,8,14,14,44,52,-8,38
Ayr,9677,9,8,13,15,30,50,-20,37
Raith,9677,10,8,12,16,29,44,-15,36
Hibernian,9678,1,18,15,3,57,25,32,69
Falkirk,9678,2,16,11,9,58,39,19,59
Dundee Utd,9678,3,16,9,11,49,41,8,57
Morton,9678,4,15,12,9,48,40,8,57
Queen of S't,9678,5,12,10,14,53,52,1,46
Dunfermline,9678,6,10,14,12,51,49,2,44
Dumbarton,9678,7,9,13,14,47,55,-8,40
Raith,9678,8,10,10,16,40,56,-16,40
St Mirren,9678,9,9,11,16,40,54,-14,38
Ayr,9678,10,7,11,18,28,60,-32,32
Hibernian,9679,1,20,12,4,56,25,31,72
Morton,9679,2,18,10,8,51,39,12,64
Dundee Utd,9679,3,16,10,10,52,41,11,58
Falkirk,9679,4,15,9,12,55,42,13,54
Queen of S't,9679,5,11,9,16,42,49,-7,42
Dunfermline,9679,6,10,11,15,50,54,-4,41
Raith,9679,7,11,8,17,35,52,-17,41
Dumbarton,9679,8,9,12,15,50,58,-8,39
St Mirren,9679,9,9,12,15,49,61,-12,39
Ayr,9679,10,9,11,16,34,53,-19,38
Hibernian,9680,1,18,15,3,55,25,30,69
Dundee Utd,9680,2,18,10,8,56,37,19,64
Falkirk,9680,3,17,10,9,66,44,22,61
Morton,9680,4,16,12,8,51,37,14,60
Dumbarton,9680,5,10,12,14,47,55,-8,42
Raith,9680,6,11,9,16,38,51,-13,42
Queen of S't,9680,7,10,11,15,42,53,-11,41
Dunfermline,9680,8,9,12,15,51,54,-3,39
Ayr,9680,9,6,15,15,30,54,-24,33
St Mirren,9680,10,6,12,18,36,62,-26,30
Hibernian,9681,1,21,10,5,57,27,30,73
Morton,9681,2,19,9,8,53,33,20,66
Dundee Utd,9681,3,18,9,9,53,34,19,63
Falkirk,9681,4,16,9,11,60,44,16,57
Queen of S't,9681,5,12,8,16,46,52,-6,44
Dunfermline,9681,6,9,12,15,46,51,-5,39
Dumbarton,9681,7,9,12,15,48,57,-9,39
Raith,9681,8,10,8,18,37,58,-21,38
Ayr,9681,9,9,10,17,35,63,-28,37
St Mirren,9681,10,9,9,18,45,61,-16,36
Hibernian,9682,1,18,14,4,53,23,30,68
Falkirk,9682,2,17,11,8,62,38,24,62
Dundee Utd,9682,3,16,11,9,49,37,12,59
Morton,9682,4,13,14,9,44,38,6,53
Queen of S't,9682,5,13,9,14,46,52,-6,48
Ayr,9682,6,10,12,14,40,51,-11,42
Raith,9682,7,10,9,17,37,53,-16,39
Dunfermline,9682,8,8,14,14,44,53,-9,38
St Mirren,9682,9,9,11,16,38,50,-12,38
Dumbarton,9682,10,8,11,17,45,63,-18,35
Hibernian,9683,1,20,12,4,61,27,34,72
Morton,9683,2,17,13,6,53,33,20,64
Falkirk,9683,3,15,12,9,57,40,17,57
Dundee Utd,9683,4,14,10,12,49,41,8,52
Dunfermline,9683,5,11,14,11,49,45,4,47
Queen of S't,9683,6,12,10,14,45,48,-3,46
St Mirren,9683,7,9,12,15,40,55,-15,39
Dumbarton,9683,8,8,12,16,47,63,-16,36
Raith,9683,9,8,10,18,31,55,-24,34
Ayr,9683,10,7,13,16,33,58,-25,34
Hibernian,9684,1,20,11,5,55,27,28,71
Morton,9684,2,18,13,5,54,32,22,67
Falkirk,9684,3,17,9,10,57,43,14,60
Dundee Utd,9684,4,14,12,10,49,40,9,54
Queen of S't,9684,5,13,8,15,44,49,-5,47
Raith,9684,6,10,10,16,37,48,-11,40
Dunfermline,9684,7,8,14,14,44,51,-7,38
Dumbarton,9684,8,9,11,16,49,58,-9,38
Ayr,9684,9,8,13,15,34,52,-18,37
St Mirren,9684,10,7,11,18,38,61,-23,32
Hibernian,9685,1,21,10,5,62,25,37,73
Dundee Utd,9685,2,16,12,8,52,38,14,60
Morton,9685,3,15,13,8,45,33,12,58
Falkirk,9685,4,15,10,11,55,44,11,55
Queen of S't,9685,5,12,10,14,48,49,-1,46
Raith,9685,6,11,10,15,37,46,-9,43
Ayr,9685,7,10,12,14,37,52,-15,42
Dunfermline,9685,8,8,14,14,38,50,-12,38
Dumbarton,9685,9,9,10,17,46,60,-14,37
St Mirren,9685,10,7,11,18,35,58,-23,32
Hibernian,9686,1,21,12,3,60,23,37,75
Falkirk,9686,2,16,10,10,57,44,13,58
Morton,9686,3,14,12,10,48,46,2,54
Dundee Utd,9686,4,14,11,11,49,42,7,53
Dunfermline,9686,5,11,13,12,47,46,1,46
Queen of S't,9686,6,10,14,12,44,47,-3,44
Ayr,9686,7,9,13,14,35,50,-15,40
St Mirren,9686,8,9,11,16,38,54,-16,38
Raith,9686,9,9,10,17,36,51,-15,37
Dumbarton,9686,10,7,14,15,46,57,-11,35
Hibernian,9687,1,20,11,5,56,25,31,71
Dundee Utd,9687,2,16,11,9,53,41,12,59
Morton,9687,3,15,12,9,50,41,9,57
Falkirk,9687,4,15,11,10,57,46,11,56
Dunfermline,9687,5,12,12,12,51,46,5,48
Queen of S't,9687,6,11,9,16,47,50,-3,42
Raith,9687,7,11,9,16,36,49,-13,42
Ayr,9687,8,9,13,14,33,51,-18,40
St Mirren,9687,9,8,12,16,37,52,-15,36
Dumbarton,9687,10,7,12,17,45,64,-19,33
Hibernian,9688,1,22,10,4,66,27,39,76
Falkirk,9688,2,17,10,9,59,40,19,61
Morton,9688,3,15,14,7,48,36,12,59
Dundee Utd,9688,4,16,11,9,54,43,11,59
Raith,9688,5,11,9,16,39,51,-12,42
Dunfermline,9688,6,9,13,14,46,51,-5,40
Dumbarton,9688,7,9,13,14,51,57,-6,40
Queen of S't,9688,8,9,12,15,44,53,-9,39
Ayr,9688,9,7,14,15,34,59,-25,35
St Mirren,9688,10,7,10,19,37,61,-24,31
Hibernian,9689,1,19,14,3,55,22,33,71
Morton,9689,2,18,11,7,53,32,21,65
Falkirk,9689,3,18,9,9,66,42,24,63
Dundee Utd,9689,4,17,8,11,52,43,9,59
Queen of S't,9689,5,11,10,15,50,56,-6,43
Raith,9689,6,11,9,16,40,50,-10,42
Dumbarton,9689,7,9,11,16,49,60,-11,38
Ayr,9689,8,9,11,16,31,53,-22,38
St Mirren,9689,9,9,9,18,38,58,-20,36
Dunfermline,9689,10,7,12,17,44,62,-18,33
Hibernian,9690,1,17,14,5,52,25,27,65
Morton,9690,2,18,10,8,55,37,18,64
Falkirk,9690,3,15,12,9,58,38,20,57
Dundee Utd,9690,4,15,11,10,52,44,8,56
Dunfermline,9690,5,10,14,12,47,49,-2,44
Queen of S't,9690,6,11,9,16,44,51,-7,42
Raith,9690,7,10,11,15,36,51,-15,41
Ayr,9690,8,8,14,14,37,52,-15,38
Dumbarton,9690,9,9,11,16,46,62,-16,38
St Mirren,9690,10,8,12,16,38,56,-18,36
Hibernian,9691,1,20,12,4,59,23,36,72
Morton,9691,2,17,13,6,48,32,16,64
Dundee Utd,9691,3,17,9,10,51,39,12,60
Falkirk,9691,4,15,10,11,60,45,15,55
Dumbarton,9691,5,10,13,13,47,52,-5,43
Queen of S't,9691,6,11,10,15,45,54,-9,43
Dunfermline,9691,7,9,14,13,45,46,-1,41
Raith,9691,8,10,10,16,36,55,-19,40
Ayr,9691,9,9,10,17,37,57,-20,37
St Mirren,9691,10,6,11,19,35,60,-25,29
Morton,9692,1,19,11,6,56,34,22,68
Falkirk,9692,2,18,10,8,65,39,26,64
Hibernian,9692,3,18,10,8,53,32,21,64
Dundee Utd,9692,4,16,10,10,48,39,9,58
Queen of S't,9692,5,11,11,14,47,51,-4,44
Raith,9692,6,11,10,15,39,47,-8,43
Ayr,9692,7,10,11,15,42,56,-14,41
Dunfermline,9692,8,9,12,15,43,50,-7,39
St Mirren,9692,9,8,9,19,40,61,-21,33
Dumbarton,9692,10,7,12,17,43,67,-24,33
Hibernian,9693,1,20,10,6,54,26,28,70
Dundee Utd,9693,2,18,9,9,53,35,18,63
Morton,9693,3,16,10,10,50,39,11,58
Falkirk,9693,4,14,10,12,53,44,9,52
Queen of S't,9693,5,13,9,14,46,46,0,48
Dunfermline,9693,6,11,13,12,45,44,1,46
Dumbarton,9693,7,10,11,15,46,55,-9,41
Raith,9693,8,11,8,17,33,50,-17,41
St Mirren,9693,9,10,10,16,41,56,-15,40
Ayr,9693,10,7,10,19,29,55,-26,31
Hibernian,9694,1,20,12,4,59,25,34,72
Falkirk,9694,2,17,11,8,64,39,25,62
Dundee Utd,9694,3,15,12,9,49,39,10,57
Morton,9694,4,14,11,11,46,42,4,53
Queen of S't,9694,5,11,10,15,45,49,-4,43
Ayr,9694,6,10,13,13,38,52,-14,43
Raith,9694,7,11,9,16,40,53,-13,42
Dunfermline,9694,8,9,12,15,50,55,-5,39
Dumbarton,9694,9,9,12,15,47,66,-19,39
St Mirren,9694,10,8,10,18,39,57,-18,34
Hibernian,9695,1,18,13,5,54,28,26,67
Dundee Utd,9695,2,19,8,9,54,37,17,65
Morton,9695,3,18,11,7,52,38,14,65
Falkirk,9695,4,15,12,9,58,41,17,57
Raith,9695,5,12,9,15,38,47,-9,45
Dunfermline,9695,6,10,13,13,43,46,-3,43
Queen of S't,9695,7,10,8,18,40,52,-12,38
Dumbarton,9695,8,9,10,17,46,56,-10,37
St Mirren,9695,9,8,11,17,41,57,-16,35
Ayr,9695,10,8,11,17,33,57,-24,35
Morton,9696,1,19,11,6,54,33,21,68
Hibernian,9696,2,17,12,7,55,31,24,63
Falkirk,9696,3,17,9,10,62,45,17,60
Dundee Utd,9696,4,15,10,11,46,39,7,55
Queen of S't,9696,5,13,9,14,50,49,1,48
Raith,9696,6,12,9,15,43,51,-8,45
Dumbarton,9696,7,10,12,14,53,57,-4,42
Ayr,9696,8,9,10,17,33,61,-28,37
St Mirren,9696,9,9,9,18,40,58,-18,36
Dunfermline,9696,10,8,11,17,42,54,-12,35
Hibernian,9697,1,18,14,4,53,23,30,68
Falkirk,9697,2,17,10,9,59,39,20,61
Morton,9697,3,16,11,9,51,41,10,59
Dundee Utd,9697,4,15,8,13,50,43,7,53
Dunfermline,9697,5,11,14,11,51,48,3,47
Queen of S't,9697,6,12,10,14,45,50,-5,46
Ayr,9697,7,9,13,14,35,53,-18,40
Dumbarton,9697,8,8,12,16,43,58,-15,36
St Mirren,9697,9,8,12,16,37,53,-16,36
Raith,9697,10,8,12,16,35,51,-16,36
Hibernian,9698,1,18,13,5,56,28,28,67
Falkirk,9698,2,17,9,10,56,39,17,60
Morton,9698,3,16,12,8,50,37,13,60
Dundee Utd,9698,4,14,12,10,48,38,10,54
St Mirren,9698,5,11,10,15,43,56,-13,43
Ayr,9698,6,10,12,14,39,55,-16,42
Queen of S't,9698,7,10,11,15,46,52,-6,41
Raith,9698,8,10,10,16,35,47,-12,40
Dunfermline,9698,9,8,14,14,44,52,-8,38
Dumbarton,9698,10,9,11,16,46,59,-13,38
Hibernian,9699,1,19,10,7,53,27,26,67
Dundee Utd,9699,2,18,9,9,53,38,15,63
Morton,9699,3,17,9,10,50,39,11,60
Falkirk,9699,4,16,10,10,56,39,17,58
Queen of S't,9699,5,13,10,13,47,47,0,49
Dunfermline,9699,6,12,11,13,48,45,3,47
Dumbarton,9699,7,9,11,16,49,59,-10,38
Raith,9699,8,9,10,17,35,53,-18,37
St Mirren,9699,9,9,9,18,44,59,-15,36
Ayr,9699,10,7,13,16,32,61,-29,34
Hibernian,9700,1,18,11,7,52,28,24,65
Dundee Utd,9700,2,17,10,9,49,36,13,61
Falkirk,9700,3,16,10,10,58,41,17,58
Morton,9700,4,16,9,11,45,39,6,57
Dunfermline,9700,5,10,13,13,45,50,-5,43
Queen of S't,9700,6,11,9,16,47,54,-7,42
Ayr,9700,7,10,12,14,35,51,-16,42
Dumbarton,9700,8,10,11,15,49,55,-6,41
St Mirren,9700,9,10,11,15,44,52,-8,41
Raith,9700,10,9,10,17,35,53,-18,37
Hibernian,9701,1,21,11,4,58,27,31,74
Dundee Utd,9701,2,18,9,9,61,37,24,63
Falkirk,9701,3,17,11,8,63,40,23,62
Morton,9701,4,14,11,11,45,40,5,53
Dunfermline,9701,5,10,12,14,44,50,-6,42
Queen of S't,9701,6,11,9,16,42,51,-9,42
St Mirren,9701,7,10,10,16,43,52,-9,40
Raith,9701,8,10,10,16,33,49,-16,40
Ayr,9701,9,9,11,16,33,58,-25,38
Dumbarton,9701,10,8,10,18,47,65,-18,34
Hibernian,9702,1,16,14,6,51,26,25,62
Falkirk,9702,2,17,10,9,56,38,18,61
Morton,9702,3,15,14,7,50,36,14,59
Dundee Utd,9702,4,15,10,11,48,42,6,55
Queen of S't,9702,5,14,10,12,47,45,2,52
Ayr,9702,6,11,11,14,37,49,-12,44
Raith,9702,7,10,11,15,35,47,-12,41
Dunfermline,9702,8,9,13,14,45,58,-13,40
Dumbarton,9702,9,9,11,16,50,55,-5,38
St Mirren,9702,10,7,10,19,35,58,-23,31
Hibernian,9703,1,22,11,3,61,21,40,77
Morton,9703,2,18,11,7,49,34,15,65
Dundee Utd,9703,3,16,11,9,50,40,10,59
Falkirk,9703,4,16,10,10,55,39,16,58
Queen of S't,9703,5,13,8,15,47,51,-4,47
Raith,9703,6,10,9,17,34,56,-22,39
Ayr,9703,7,9,11,16,36,55,-19,38
St Mirren,9703,8,9,9,18,46,55,-9,36
Dunfermline,9703,9,8,11,17,40,49,-9,35
Dumbarton,9703,10,8,11,17,43,61,-18,35
Hibernian,9704,1,19,12,5,57,27,30,69
Falkirk,9704,2,16,12,8,56,39,17,60
Dundee Utd,9704,3,15,11,10,51,41,10,56
Morton,9704,4,14,10,12,53,46,7,52
Dunfermline,9704,5,11,13,12,52,51,1,46
Raith,9704,6,12,9,15,40,47,-7,45
Queen of S't,9704,7,10,14,12,45,47,-2,44
Ayr,9704,8,9,11,16,36,60,-24,38
Dumbarton,9704,9,8,13,15,44,58,-14,37
St Mirren,9704,10,7,13,16,41,59,-18,34
Hibernian,9705,1,19,13,4,55,25,30,70
Falkirk,9705,2,17,12,7,59,37,22,63
Dundee Utd,9705,3,15,12,9,47,36,11,57
Morton,9705,4,15,11,10,49,40,9,56
Queen of S't,9705,5,12,10,14,46,48,-2,46
Dunfermline,9705,6,10,15,11,41,41,0,45
Dumbarton,9705,7,9,13,14,46,55,-9,40
Raith,9705,8,10,8,18,37,51,-14,38
Ayr,9705,9,8,11,17,33,60,-27,35
St Mirren,9705,10,7,11,18,36,56,-20,32
Morton,9706,1,19,11,6,52,31,21,68
Hibernian,9706,2,17,13,6,54,32,22,64
Falkirk,9706,3,17,10,9,59,44,15,61
Dundee Utd,9706,4,16,10,10,54,43,11,58
Dunfermline,9706,5,10,13,13,46,46,0,43
Raith,9706,6,11,10,15,33,45,-12,43
Ayr,9706,7,9,11,16,39,55,-16,38
St Mirren,9706,8,8,13,15,42,54,-12,37
Queen of S't,9706,9,9,9,18,41,54,-13,36
Dumbarton,9706,10,8,12,16,50,66,-16,36
Falkirk,9707,1,18,10,8,63,38,25,64
Hibernian,9707,2,17,13,6,51,28,23,64
Dundee Utd,9707,3,17,10,9,49,37,12,61
Morton,9707,4,16,12,8,50,38,12,60
Queen of S't,9707,5,13,9,14,49,47,2,48
Raith,9707,6,11,10,15,36,47,-11,43
Dunfermline,9707,7,9,11,16,46,54,-8,38
Dumbarton,9707,8,9,10,17,51,68,-17,37
Ayr,9707,9,8,13,15,37,58,-21,37
St Mirren,9707,10,8,10,18,39,56,-17,34
Hibernian,9708,1,19,13,4,55,25,30,70
Dundee Utd,9708,2,17,8,11,56,41,15,59
Morton,9708,3,16,11,9,53,42,11,59
Falkirk,9708,4,16,9,11,55,43,12,57
Dunfermline,9708,5,12,11,13,49,45,4,47
Queen of S't,9708,6,12,10,14,46,49,-3,46
Ayr,9708,7,10,12,14,39,58,-19,42
Raith,9708,8,11,8,17,37,49,-12,41
Dumbarton,9708,9,8,12,16,47,61,-14,36
St Mirren,9708,10,7,10,19,40,64,-24,31
Hibernian,9709,1,18,12,6,56,30,26,66
Morton,9709,2,18,11,7,51,37,14,65
Dundee Utd,9709,3,17,11,8,48,33,15,62
Falkirk,9709,4,14,13,9,59,41,18,55
Queen of S't,9709,5,10,11,15,41,49,-8,41
Raith,9709,6,10,11,15,37,50,-13,41
Dunfermline,9709,7,9,13,14,47,51,-4,40
St Mirren,9709,8,9,11,16,47,61,-14,38
Dumbarton,9709,9,8,12,16,47,63,-16,36
Ayr,9709,10,7,15,14,33,51,-18,36
Hibernian,9710,1,20,11,5,61,31,30,71
Dundee Utd,9710,2,17,11,8,54,39,15,62
Falkirk,9710,3,16,11,9,57,41,16,59
Morton,9710,4,16,10,10,51,39,12,58
Dumbarton,9710,5,10,12,14,54,59,-5,42
Dunfermline,9710,6,9,14,13,48,54,-6,41
Queen of S't,9710,7,10,11,15,46,52,-6,41
St Mirren,9710,8,9,10,17,42,60,-18,37
Raith,9710,9,9,10,17,35,53,-18,37
Ayr,9710,10,8,12,16,35,55,-20,36
Hibernian,9711,1,20,12,4,61,28,33,72
Falkirk,9711,2,16,11,9,60,41,19,59
Dundee Utd,9711,3,14,11,11,48,41,7,53
Morton,9711,4,14,10,12,47,48,-1,52
Queen of S't,9711,5,14,9,13,52,53,-1,51
Raith,9711,6,11,9,16,39,50,-11,42
Dumbarton,9711,7,10,11,15,51,57,-6,41
Ayr,9711,8,9,13,14,36,53,-17,40
Dunfermline,9711,9,9,12,15,41,48,-7,39
St Mirren,9711,10,9,10,17,45,61,-16,37
Hibernian,9712,1,20,12,4,55,24,31,72
Dundee Utd,9712,2,16,10,10,55,45,10,58
Falkirk,9712,3,15,10,11,57,44,13,55
Morton,9712,4,14,13,9,47,39,8,55
Raith,9712,5,13,9,14,40,46,-6,48
Queen of S't,9712,6,11,9,16,49,56,-7,42
Dunfermline,9712,7,9,13,14,45,48,-3,40
St Mirren,9712,8,10,10,16,44,58,-14,40
Dumbarton,9712,9,9,11,16,49,61,-12,38
Ayr,9712,10,8,13,15,36,56,-20,37
Hibernian,9713,1,19,12,5,57,28,29,69
Morton,9713,2,20,9,7,57,36,21,69
Falkirk,9713,3,16,12,8,60,39,21,60
Dundee Utd,9713,4,17,9,10,56,39,17,60
Queen of S't,9713,5,11,10,15,48,53,-5,43
Raith,9713,6,9,11,16,33,50,-17,38
Ayr,9713,7,9,11,16,37,60,-23,38
Dunfermline,9713,8,8,13,15,42,53,-11,37
Dumbarton,9713,9,8,12,16,45,60,-15,36
St Mirren,9713,10,9,9,18,41,58,-17,36
Hibernian,9714,1,19,14,3,57,24,33,71
Dundee Utd,9714,2,17,10,9,52,41,11,61
Morton,9714,3,17,9,10,52,39,13,60
Falkirk,9714,4,15,11,10,57,39,18,56
Queen of S't,9714,5,12,10,14,45,50,-5,46
Raith,9714,6,11,11,14,33,43,-10,44
Dunfermline,9714,7,10,13,13,47,50,-3,43
Ayr,9714,8,8,14,14,32,47,-15,38
Dumbarton,9714,9,8,11,17,50,65,-15,35
St Mirren,9714,10,7,9,20,35,62,-27,30
Morton,9715,1,20,10,6,56,31,25,70
Hibernian,9715,2,16,12,8,50,31,19,60
Dundee Utd,9715,3,17,9,10,52,39,13,60
Falkirk,9715,4,15,11,10,52,40,12,56
Dunfermline,9715,5,11,11,14,45,46,-1,44
Queen of S't,9715,6,12,8,16,44,48,-4,44
Dumbarton,9715,7,10,10,16,51,63,-12,40
Raith,9715,8,10,10,16,32,49,-17,40
Ayr,9715,9,8,13,15,36,56,-20,37
St Mirren,9715,10,8,12,16,43,58,-15,36
Hibernian,9716,1,17,13,6,53,31,22,64
Morton,9716,2,17,11,8,52,38,14,62
Dundee Utd,9716,3,17,10,9,54,39,15,61
Falkirk,9716,4,16,12,8,59,37,22,60
Queen of S't,9716,5,13,8,15,45,48,-3,47
Dunfermline,9716,6,10,12,14,43,46,-3,42
Raith,9716,7,10,10,16,35,49,-14,40
Dumbarton,9716,8,9,12,15,47,62,-15,39
Ayr,9716,9,8,12,16,36,57,-21,36
St Mirren,9716,10,7,12,17,42,59,-17,33
Hibernian,9717,1,20,12,4,56,23,33,72
Morton,9717,2,17,13,6,50,36,14,64
Falkirk,9717,3,16,11,9,64,43,21,59
Dundee Utd,9717,4,16,11,9,55,42,13,59
Dunfermline,9717,5,9,14,13,47,47,0,41
Queen of S't,9717,6,10,11,15,44,52,-8,41
Dumbarton,9717,7,10,10,16,53,63,-10,40
St Mirren,9717,8,10,9,17,46,61,-15,39
Raith,9717,9,9,9,18,34,56,-22,36
Ayr,9717,10,7,12,17,36,62,-26,33
Hibernian,9718,1,20,12,4,64,27,37,72
Falkirk,9718,2,16,13,7,67,43,24,61
Morton,9718,3,16,10,10,51,41,10,58
Dundee Utd,9718,4,15,10,11,48,41,7,55
Queen of S't,9718,5,13,11,12,49,45,4,50
Dunfermline,9718,6,9,15,12,44,47,-3,42
St Mirren,9718,7,10,10,16,42,59,-17,40
Dumbarton,9718,8,9,11,16,46,63,-17,38
Raith,9718,9,9,8,19,34,55,-21,35
Ayr,9718,10,8,10,18,31,55,-24,34
Hibernian,9719,1,17,14,5,51,26,25,65
Morton,9719,2,17,13,6,51,35,16,64
Falkirk,9719,3,17,9,10,61,42,19,60
Dundee Utd,9719,4,15,10,11,46,40,6,55
Dunfermline,9719,5,11,14,11,46,44,2,47
Queen of S't,9719,6,11,9,16,44,49,-5,42
St Mirren,9719,7,11,9,16,45,51,-6,42
Dumbarton,9719,8,9,11,16,44,60,-16,38
Ayr,9719,9,9,11,16,31,52,-21,38
Raith,9719,10,8,10,18,34,54,-20,34
Hibernian,9720,1,20,11,5,56,26,30,71
Morton,9720,2,18,11,7,48,31,17,65
Falkirk,9720,3,17,10,9,61,40,21,61
Dundee Utd,9720,4,17,9,10,49,39,10,60
Raith,9720,5,11,9,16,36,47,-11,42
Queen of S't,9720,6,10,11,15,42,50,-8,41
Dumbarton,9720,7,10,10,16,45,55,-10,40
Dunfermline,9720,8,9,12,15,44,52,-8,39
Ayr,9720,9,8,12,16,32,49,-17,36
St Mirren,9720,10,8,9,19,36,60,-24,33
Hibernian,9721,1,18,10,8,56,31,25,64
Falkirk,9721,2,17,10,9,58,40,18,61
Morton,9721,3,16,12,8,54,40,14,60
Dundee Utd,9721,4,15,11,10,50,40,10,56
Raith,9721,5,12,9,15,36,46,-10,45
Dunfermline,9721,6,10,13,13,44,47,-3,43
Queen of S't,9721,7,11,10,15,44,49,-5,43
Dumbarton,9721,8,10,12,14,49,56,-7,42
Ayr,9721,9,9,11,16,35,55,-20,38
St Mirren,9721,10,8,10,18,37,59,-22,34
Hibernian,9722,1,19,11,6,58,30,28,68
Dundee Utd,9722,2,16,10,10,52,39,13,58
Morton,9722,3,16,10,10,46,36,10,58
Falkirk,9722,4,14,13,9,59,43,16,55
Queen of S't,9722,5,13,9,14,50,59,-9,48
Dumbarton,9722,6,11,12,13,54,52,2,45
Dunfermline,9722,7,8,14,14,44,53,-9,38
Raith,9722,8,9,11,16,35,51,-16,38
Ayr,9722,9,8,14,14,35,54,-19,38
St Mirren,9722,10,8,12,16,41,57,-16,36
Hibernian,9723,1,19,10,7,53,28,25,67
Morton,9723,2,17,11,8,54,40,14,62
Dundee Utd,9723,3,17,9,10,53,43,10,60
Falkirk,9723,4,16,11,9,59,40,19,59
Queen of S't,9723,5,13,8,15,49,54,-5,47
Raith,9723,6,12,9,15,40,48,-8,45
Dunfermline,9723,7,9,13,14,49,54,-5,40
Ayr,9723,8,8,13,15,35,54,-19,37
Dumbarton,9723,9,8,12,16,44,58,-14,36
St Mirren,9723,10,7,12,17,39,56,-17,33
Hibernian,9724,1,19,11,6,57,29,28,68
Morton,9724,2,18,12,6,56,36,20,66
Dundee Utd,9724,3,19,8,9,61,41,20,65
Falkirk,9724,4,15,10,11,60,48,12,55
Dunfermline,9724,5,9,14,13,52,56,-4,41
Queen of S't,9724,6,10,11,15,43,49,-6,41
Dumbarton,9724,7,9,13,14,45,56,-11,40
St Mirren,9724,8,10,9,17,46,59,-13,39
Ayr,9724,9,9,11,16,32,57,-25,38
Raith,9724,10,8,9,19,33,54,-21,33
Hibernian,9725,1,19,12,5,57,27,30,69
Falkirk,9725,2,17,9,10,61,44,17,60
Morton,9725,3,16,12,8,50,36,14,60
Dundee Utd,9725,4,15,10,11,57,46,11,55
Queen of S't,9725,5,12,9,15,50,51,-1,45
Dunfermline,9725,6,10,14,12,49,49,0,44
St Mirren,9725,7,10,10,16,46,59,-13,40
Raith,9725,8,10,9,17,37,51,-14,39
Ayr,9725,9,9,11,16,38,62,-24,38
Dumbarton,9725,10,8,12,16,44,64,-20,36
Hibernian,9726,1,19,14,3,62,31,31,71
Morton,9726,2,17,10,9,51,39,12,61
Falkirk,9726,3,14,12,10,56,43,13,54
Queen of S't,9726,4,14,9,13,51,47,4,51
Dundee Utd,9726,5,14,9,13,44,41,3,51
Dunfermline,9726,6,10,13,13,48,51,-3,43
Raith,9726,7,11,9,16,36,47,-11,42
Dumbarton,9726,8,9,12,15,47,58,-11,39
St Mirren,9726,9,9,10,17,40,54,-14,37
Ayr,9726,10,9,10,17,34,58,-24,37
Hibernian,9727,1,20,11,5,56,24,32,71
Dundee Utd,9727,2,18,8,10,53,38,15,62
Falkirk,9727,3,16,12,8,58,37,21,60
Morton,9727,4,14,14,8,47,37,10,56
Queen of S't,9727,5,12,10,14,46,49,-3,46
Dunfermline,9727,6,10,14,12,50,53,-3,44
St Mirren,9727,7,9,11,16,39,53,-14,38
Dumbarton,9727,8,7,14,15,45,61,-16,35
Raith,9727,9,8,11,17,33,55,-22,35
Ayr,9727,10,7,13,16,32,52,-20,34
Hibernian,9728,1,19,12,5,54,26,28,69
Falkirk,9728,2,17,9,10,56,40,16,60
Dundee Utd,9728,3,17,8,11,49,39,10,59
Morton,9728,4,16,10,10,49,39,10,58
Queen of S't,9728,5,14,9,13,49,46,3,51
Dunfermline,9728,6,10,13,13,43,46,-3,43
St Mirren,9728,7,10,9,17,41,51,-10,39
Ayr,9728,8,9,11,16,33,53,-20,38
Dumbarton,9728,9,9,10,17,44,57,-13,37
Raith,9728,10,9,9,18,31,52,-21,36
Morton,9729,1,19,11,6,52,33,19,68
Hibernian,9729,2,18,12,6,55,28,27,66
Falkirk,9729,3,17,10,9,58,39,19,61
Dundee Utd,9729,4,13,10,13,45,45,0,49
Dunfermline,9729,5,11,13,12,50,49,1,46
Queen of S't,9729,6,12,10,14,47,53,-6,46
St Mirren,9729,7,10,10,16,43,54,-11,40
Raith,9729,8,10,9,17,37,52,-15,39
Dumbarton,9729,9,9,10,17,48,59,-11,37
Ayr,9729,10,7,13,16,33,56,-23,34
Hibernian,9730,1,17,15,4,52,25,27,66
Falkirk,9730,2,16,11,9,61,38,23,59
Dundee Utd,9730,3,16,10,10,52,39,13,58
Morton,9730,4,15,11,10,47,39,8,56
Dumbarton,9730,5,12,10,14,52,55,-3,46
Queen of S't,9730,6,11,12,13,39,43,-4,45
Dunfermline,9730,7,10,13,13,43,49,-6,43
Raith,9730,8,10,10,16,36,49,-13,40
St Mirren,9730,9,9,11,16,42,58,-16,38
Ayr,9730,10,6,13,17,31,60,-29,31
Hibernian,9731,1,19,13,4,56,28,28,70
Falkirk,9731,2,18,10,8,65,39,26,64
Morton,9731,3,16,12,8,57,37,20,60
Dundee Utd,9731,4,14,11,11,50,47,3,53
Dumbarton,9731,5,13,10,13,58,59,-1,49
Queen of S't,9731,6,11,10,15,46,53,-7,43
Raith,9731,7,9,13,14,38,52,-14,40
Dunfermline,9731,8,8,15,13,46,53,-7,39
Ayr,9731,9,7,12,17,33,57,-24,33
St Mirren,9731,10,7,10,19,36,60,-24,31
Hibernian,9732,1,18,14,4,52,25,27,68
Falkirk,9732,2,16,11,9,57,39,18,59
Morton,9732,3,16,11,9,48,36,12,59
Dundee Utd,9732,4,16,8,12,48,40,8,56
Queen of S't,9732,5,15,9,12,51,46,5,54
Dunfermline,9732,6,9,12,15,43,52,-9,39
Raith,9732,7,9,12,15,33,47,-14,39
Dumbarton,9732,8,9,11,16,48,61,-13,38
St Mirren,9732,9,9,10,17,41,54,-13,37
Ayr,9732,10,8,12,16,33,54,-21,36
Hibernian,9733,1,19,12,5,58,27,31,69
Dundee Utd,9733,2,17,10,9,58,39,19,61
Morton,9733,3,15,12,9,47,38,9,57
Falkirk,9733,4,14,12,10,57,44,13,54
Queen of S't,9733,5,14,8,14,50,51,-1,50
Dumbarton,9733,6,9,13,14,45,55,-10,40
Raith,9733,7,10,9,17,34,57,-23,39
Dunfermline,9733,8,9,11,16,45,54,-9,38
St Mirren,9733,9,9,11,16,44,56,-12,38
Ayr,9733,10,8,14,14,35,52,-17,38
Hibernian,9734,1,18,12,6,54,27,27,66
Dundee Utd,9734,2,16,11,9,53,38,15,59
Falkirk,9734,3,16,10,10,56,42,14,58
Morton,9734,4,15,10,11,46,40,6,55
Queen of S't,9734,5,11,11,14,44,48,-4,44
Raith,9734,6,11,10,15,36,47,-11,43
Dumbarton,9734,7,9,15,12,48,52,-4,42
Dunfermline,9734,8,10,12,14,41,47,-6,42
Ayr,9734,9,7,16,13,34,53,-19,37
St Mirren,9734,10,8,11,17,43,61,-18,35
Dundee Utd,9735,1,19,9,8,57,39,18,66
Morton,9735,2,18,11,7,57,39,18,65
Hibernian,9735,3,17,12,7,54,28,26,63
Falkirk,9735,4,15,11,10,55,39,16,56
Raith,9735,5,12,11,13,38,45,-7,47
Queen of S't,9735,6,11,9,16,46,55,-9,42
Dunfermline,9735,7,9,11,16,43,51,-8,38
Dumbarton,9735,8,9,11,16,47,59,-12,38
St Mirren,9735,9,8,12,16,41,57,-16,36
Ayr,9735,10,6,15,15,34,60,-26,33
Hibernian,9736,1,18,14,4,55,27,28,68
Morton,9736,2,17,12,7,52,36,16,63
Dundee Utd,9736,3,17,10,9,55,38,17,61
Falkirk,9736,4,14,11,11,55,49,6,53
Queen of S't,9736,5,14,9,13,48,48,0,51
Dunfermline,9736,6,9,13,14,48,49,-1,40
Dumbarton,9736,7,9,13,14,47,55,-8,40
Raith,9736,8,10,9,17,40,57,-17,39
St Mirren,9736,9,8,11,17,44,60,-16,35
Ayr,9736,10,8,10,18,33,58,-25,34
Hibernian,9737,1,20,11,5,58,27,31,71
Falkirk,9737,2,18,10,8,63,40,23,64
Morton,9737,3,17,10,9,54,38,16,61
Dundee Utd,9737,4,14,10,12,45,39,6,52
Queen of S't,9737,5,13,8,15,46,48,-2,47
Dunfermline,9737,6,11,13,12,43,46,-3,46
Ayr,9737,7,9,13,14,36,52,-16,40
Raith,9737,8,9,11,16,33,51,-18,38
St Mirren,9737,9,7,12,17,38,55,-17,33
Dumbarton,9737,10,7,12,17,46,66,-20,33
Hibernian,9738,1,19,13,4,57,27,30,70
Falkirk,9738,2,17,10,9,62,43,19,61
Morton,9738,3,17,10,9,50,40,10,61
Dundee Utd,9738,4,17,9,10,52,38,14,60
Queen of S't,9738,5,11,10,15,47,55,-8,43
St Mirren,9738,6,11,9,16,43,52,-9,42
Dunfermline,9738,7,8,16,12,48,53,-5,40
Dumbarton,9738,8,9,13,14,51,57,-6,40
Raith,9738,9,10,9,17,36,50,-14,39
Ayr,9738,10,6,11,19,30,61,-31,29
Hibernian,9739,1,19,12,5,55,25,30,69
Morton,9739,2,17,11,8,47,34,13,62
Falkirk,9739,3,16,10,10,56,41,15,58
Dundee Utd,9739,4,15,10,11,50,42,8,55
Queen of S't,9739,5,11,11,14,50,52,-2,44
Raith,9739,6,11,10,15,38,48,-10,43
St Mirren,9739,7,10,10,16,40,57,-17,40
Dunfermline,9739,8,8,14,14,40,43,-3,38
Dumbarton,9739,9,9,11,16,46,61,-15,38
Ayr,9739,10,8,13,15,34,53,-19,37
Hibernian,9740,1,18,14,4,56,26,30,68
Morton,9740,2,17,11,8,47,35,12,62
Falkirk,9740,3,17,9,10,59,40,19,60
Dundee Utd,9740,4,15,10,11,49,42,7,55
Queen of S't,9740,5,14,8,14,52,49,3,50
Raith,9740,6,13,9,14,37,43,-6,48
Dumbarton,9740,7,10,11,15,49,58,-9,41
Dunfermline,9740,8,8,13,15,42,51,-9,37
Ayr,9740,9,7,12,17,33,59,-26,33
St Mirren,9740,10,7,11,18,35,56,-21,32
Hibernian,9741,1,19,10,7,53,30,23,67
Falkirk,9741,2,17,11,8,63,40,23,62
Dundee Utd,9741,3,17,8,11,50,43,7,59
Morton,9741,4,15,13,8,53,42,11,58
Dunfermline,9741,5,13,11,12,54,50,4,50
Queen of S't,9741,6,12,9,15,45,53,-8,45
Ayr,9741,7,9,12,15,41,53,-12,39
Dumbarton,9741,8,9,11,16,45,57,-12,38
Raith,9741,9,9,10,17,36,54,-18,37
St Mirren,9741,10,7,11,18,39,57,-18,32
Hibernian,9742,1,18,11,7,57,35,22,65
Falkirk,9742,2,17,9,10,62,42,20,60
Dundee Utd,9742,3,17,9,10,54,40,14,60
Morton,9742,4,16,12,8,51,40,11,60
Dunfermline,9742,5,13,12,11,56,45,11,51
Queen of S't,9742,6,11,10,15,45,55,-10,43
Raith,9742,7,10,9,17,37,56,-19,39
St Mirren,9742,8,9,11,16,42,54,-12,38
Dumbarton,9742,9,8,12,16,44,56,-12,36
Ayr,9742,10,8,11,17,32,57,-25,35
Hibernian,9743,1,18,12,6,53,32,21,66
Morton,9743,2,18,10,8,50,35,15,64
Dundee Utd,9743,3,16,10,10,53,36,17,58
Falkirk,9743,4,16,10,10,61,45,16,58
Raith,9743,5,14,8,14,47,50,-3,50
Dunfermline,9743,6,11,11,14,50,49,1,44
Queen of S't,9743,7,11,10,15,43,53,-10,43
Dumbarton,9743,8,10,10,16,49,65,-16,40
St Mirren,9743,9,8,10,18,46,59,-13,34
Ayr,9743,10,6,13,17,31,59,-28,31
Hibernian,9744,1,21,11,4,60,27,33,74
Morton,9744,2,18,11,7,53,39,14,65
Falkirk,9744,3,18,10,8,60,37,23,64
Dundee Utd,9744,4,16,10,10,54,45,9,58
Raith,9744,5,12,8,16,36,48,-12,44
St Mirren,9744,6,11,9,16,44,55,-11,42
Queen of S't,9744,7,11,8,17,47,52,-5,41
Dunfermline,9744,8,9,11,16,46,52,-6,38
Dumbarton,9744,9,9,10,17,47,64,-17,37
Ayr,9744,10,6,10,20,33,61,-28,28
Hibernian,9745,1,19,12,5,57,25,32,69
Morton,9745,2,18,12,6,51,31,20,66
Falkirk,9745,3,16,12,8,57,42,15,60
Dundee Utd,9745,4,14,10,12,46,41,5,52
Queen of S't,9745,5,11,12,13,46,52,-6,45
Raith,9745,6,11,11,14,40,46,-6,44
Ayr,9745,7,9,14,13,36,53,-17,41
Dumbarton,9745,8,7,15,14,44,54,-10,36
Dunfermline,9745,9,7,12,17,38,52,-14,33
St Mirren,9745,10,6,14,16,38,57,-19,32
Hibernian,9746,1,20,11,5,56,27,29,71
Morton,9746,2,18,10,8,54,37,17,64
Dundee Utd,9746,3,17,10,9,61,42,19,61
Falkirk,9746,4,16,11,9,57,41,16,59
Dunfermline,9746,5,10,13,13,56,53,3,43
Queen of S't,9746,6,10,11,15,46,55,-9,41
St Mirren,9746,7,10,9,17,42,59,-17,39
Raith,9746,8,9,11,16,38,51,-13,38
Ayr,9746,9,8,12,16,37,64,-27,36
Dumbarton,9746,10,8,10,18,52,70,-18,34
Morton,9747,1,18,12,6,56,34,22,66
Hibernian,9747,2,18,11,7,56,29,27,65
Dundee Utd,9747,3,18,8,10,54,40,14,62
Falkirk,9747,4,15,12,9,56,43,13,57
Queen of S't,9747,5,13,9,14,45,50,-5,48
Dunfermline,9747,6,10,13,13,47,49,-2,43
Raith,9747,7,11,8,17,35,51,-16,41
Ayr,9747,8,10,10,16,40,57,-17,40
Dumbarton,9747,9,7,12,17,49,65,-16,33
St Mirren,9747,10,7,11,18,41,61,-20,32
Hibernian,9748,1,19,12,5,54,26,28,69
Morton,9748,2,19,11,6,52,31,21,68
Falkirk,9748,3,18,10,8,60,39,21,64
Dundee Utd,9748,4,15,11,10,45,34,11,56
Dunfermline,9748,5,9,14,13,44,50,-6,41
Queen of S't,9748,6,10,10,16,44,50,-6,40
Ayr,9748,7,9,12,15,33,51,-18,39
Dumbarton,9748,8,9,11,16,44,59,-15,38
Raith,9748,9,10,8,18,36,52,-16,38
St Mirren,9748,10,7,11,18,41,61,-20,32
Hibernian,9749,1,20,11,5,53,25,28,71
Dundee Utd,9749,2,18,9,9,53,37,16,63
Morton,9749,3,17,9,10,47,38,9,60
Queen of S't,9749,4,15,9,12,49,43,6,54
Falkirk,9749,5,13,10,13,54,48,6,49
Dunfermline,9749,6,11,12,13,47,47,0,45
Dumbarton,9749,7,10,11,15,52,59,-7,41
Raith,9749,8,9,11,16,36,52,-16,38
St Mirren,9749,9,7,12,17,42,56,-14,33
Ayr,9749,10,7,12,17,34,62,-28,33
Hibernian,9750,1,22,10,4,58,27,31,76
Falkirk,9750,2,18,10,8,64,37,27,64
Morton,9750,3,16,12,8,51,39,12,60
Dundee Utd,9750,4,14,9,13,47,42,5,51
Queen of S't,9750,5,12,9,15,46,53,-7,45
Dumbarton,9750,6,10,13,13,52,57,-5,43
Dunfermline,9750,7,8,15,13,46,52,-6,39
St Mirren,9750,8,9,11,16,39,57,-18,38
Raith,9750,9,9,9,18,35,52,-17,36
Ayr,9750,10,7,12,17,38,60,-22,33
Hibernian,9751,1,19,11,6,57,31,26,68
Falkirk,9751,2,17,10,9,64,37,27,61
Dundee Utd,9751,3,17,10,9,59,37,22,61
Morton,9751,4,15,14,7,52,39,13,59
Queen of S't,9751,5,12,8,16,45,53,-8,44
Dumbarton,9751,6,10,11,15,48,62,-14,41
Ayr,9751,7,10,11,15,40,55,-15,41
Dunfermline,9751,8,9,13,14,47,57,-10,40
Raith,9751,9,9,9,18,35,57,-22,36
St Mirren,9751,10,8,11,17,39,58,-19,35
Hibernian,9752,1,19,11,6,55,27,28,68
Morton,9752,2,19,10,7,53,34,19,67
Falkirk,9752,3,16,12,8,62,44,18,60
Dundee Utd,9752,4,15,12,9,48,38,10,57
Dunfermline,9752,5,10,13,13,48,49,-1,43
Queen of S't,9752,6,11,10,15,46,50,-4,43
Ayr,9752,7,9,13,14,34,51,-17,40
Dumbarton,9752,8,8,12,16,43,58,-15,36
St Mirren,9752,9,8,11,17,40,57,-17,35
Raith,9752,10,9,8,19,30,51,-21,35
Hibernian,9753,1,19,12,5,60,29,31,69
Dundee Utd,9753,2,18,10,8,54,36,18,64
Falkirk,9753,3,15,12,9,57,44,13,57
Morton,9753,4,14,12,10,46,45,1,54
Raith,9753,5,12,10,14,40,49,-9,46
Dunfermline,9753,6,11,12,13,49,47,2,45
Dumbarton,9753,7,10,12,14,54,57,-3,42
Ayr,9753,8,10,12,14,38,54,-16,42
Queen of S't,9753,9,9,9,18,41,55,-14,36
St Mirren,9753,10,7,9,20,36,59,-23,30
Hibernian,9754,1,19,11,6,56,31,25,68
Morton,9754,2,18,12,6,54,33,21,66
Dundee Utd,9754,3,17,9,10,59,44,15,60
Falkirk,9754,4,13,12,11,56,47,9,51
Dunfermline,9754,5,11,14,11,52,43,9,47
Raith,9754,6,10,11,15,38,50,-12,41
Dumbarton,9754,7,10,10,16,52,64,-12,40
Queen of S't,9754,8,10,9,17,45,59,-14,39
Ayr,9754,9,9,12,15,37,56,-19,39
St Mirren,9754,10,7,12,17,36,58,-22,33
Hibernian,9755,1,21,12,3,63,22,41,75
Falkirk,9755,2,17,9,10,58,44,14,60
Morton,9755,3,15,12,9,50,42,8,57
Dundee Utd,9755,4,15,9,12,49,47,2,54
Dunfermline,9755,5,11,13,12,51,50,1,46
Queen of S't,9755,6,11,9,16,44,52,-8,42
St Mirren,9755,7,10,11,15,50,54,-4,41
Ayr,9755,8,8,14,14,33,53,-20,38
Raith,9755,9,9,10,17,34,49,-15,37
Dumbarton,9755,10,8,11,17,44,63,-19,35
Hibernian,9756,1,20,12,4,63,28,35,72
Morton,9756,2,16,12,8,54,41,13,60
Falkirk,9756,3,16,11,9,62,50,12,59
Dundee Utd,9756,4,14,13,9,51,45,6,55
Dunfermline,9756,5,10,13,13,53,51,2,43
Queen of S't,9756,6,10,11,15,42,50,-8,41
Raith,9756,7,10,10,16,37,53,-16,40
St Mirren,9756,8,9,12,15,43,54,-11,39
Dumbarton,9756,9,8,12,16,48,59,-11,36
Ayr,9756,10,8,12,16,33,55,-22,36
Hibernian,9757,1,20,12,4,58,25,33,72
Falkirk,9757,2,18,9,9,63,41,22,63
Dundee Utd,9757,3,18,9,9,51,35,16,63
Morton,9757,4,15,12,9,44,34,10,57
Ayr,9757,5,11,10,15,36,51,-15,43
Queen of S't,9757,6,11,8,17,41,51,-10,41
Raith,9757,7,11,8,17,33,50,-17,41
St Mirren,9757,8,9,11,16,36,51,-15,38
Dunfermline,9757,9,8,13,15,42,53,-11,37
Dumbarton,9757,10,8,10,18,46,59,-13,34
Hibernian,9758,1,20,12,4,58,26,32,72
Morton,9758,2,17,12,7,55,37,18,63
Falkirk,9758,3,15,10,11,59,45,14,55
Dundee Utd,9758,4,14,12,10,52,46,6,54
Dunfermline,9758,5,10,14,12,46,51,-5,44
Dumbarton,9758,6,11,10,15,53,54,-1,43
Queen of S't,9758,7,10,11,15,45,54,-9,41
Raith,9758,8,10,10,16,35,51,-16,40
Ayr,9758,9,9,11,16,35,56,-21,38
St Mirren,9758,10,8,10,18,38,56,-18,34
Hibernian,9759,1,21,11,4,55,22,33,74
Falkirk,9759,2,17,10,9,65,42,23,61
Morton,9759,3,15,11,10,52,40,12,56
Dundee Utd,9759,4,14,12,10,48,40,8,54
Dunfermline,9759,5,11,13,12,47,46,1,46
Queen of S't,9759,6,11,11,14,47,54,-7,44
Dumbarton,9759,7,9,12,15,52,64,-12,39
Raith,9759,8,10,9,17,36,54,-18,39
St Mirren,9759,9,8,12,16,37,55,-18,36
Ayr,9759,10,8,11,17,33,55,-22,35
Hibernian,9760,1,20,12,4,56,22,34,72
Morton,9760,2,20,10,6,51,32,19,70
Falkirk,9760,3,14,10,12,56,46,10,52
Dundee Utd,9760,4,14,10,12,47,47,0,52
Queen of S't,9760,5,13,9,14,51,50,1,48
Dunfermline,9760,6,11,11,14,50,48,2,44
St Mirren,9760,7,10,11,15,43,52,-9,41
Dumbarton,9760,8,9,11,16,48,62,-14,38
Raith,9760,9,9,11,16,35,52,-17,38
Ayr,9760,10,6,13,17,31,57,-26,31
Hibernian,9761,1,20,11,5,56,26,30,71
Dundee Utd,9761,2,18,9,9,54,37,17,63
Morton,9761,3,15,13,8,46,35,11,58
Falkirk,9761,4,14,13,9,56,44,12,55
Dunfermline,9761,5,9,15,12,43,47,-4,42
Queen of S't,9761,6,10,11,15,41,50,-9,41
Raith,9761,7,10,10,16,36,51,-15,40
Dumbarton,9761,8,9,12,15,50,58,-8,39
Ayr,9761,9,9,12,15,36,53,-17,39
St Mirren,9761,10,7,12,17,40,57,-17,33
Hibernian,9762,1,19,11,6,57,27,30,68
Dundee Utd,9762,2,19,8,9,56,40,16,65
Falkirk,9762,3,16,12,8,58,41,17,60
Morton,9762,4,17,9,10,47,37,10,60
Dunfermline,9762,5,12,12,12,49,46,3,48
Queen of S't,9762,6,11,10,15,48,54,-6,43
Ayr,9762,7,10,11,15,38,53,-15,41
Dumbarton,9762,8,8,11,17,44,60,-16,35
Raith,9762,9,8,10,18,33,51,-18,34
St Mirren,9762,10,8,10,18,40,61,-21,34
Hibernian,9763,1,20,13,3,56,21,35,73
Dundee Utd,9763,2,16,11,9,49,37,12,59
Falkirk,9763,3,15,12,9,57,41,16,57
Dunfermline,9763,4,13,13,10,51,44,7,52
Morton,9763,5,13,11,12,46,46,0,50
Dumbarton,9763,6,10,11,15,51,59,-8,41
Ayr,9763,7,10,11,15,38,55,-17,41
Queen of S't,9763,8,9,11,16,41,51,-10,38
Raith,9763,9,9,11,16,35,51,-16,38
St Mirren,9763,10,7,12,17,35,54,-19,33
Hibernian,9764,1,19,12,5,58,26,32,69
Morton,9764,2,17,12,7,50,39,11,63
Dundee Utd,9764,3,16,10,10,50,40,10,58
Falkirk,9764,4,13,12,11,54,46,8,51
Dunfermline,9764,5,11,14,11,54,50,4,47
Queen of S't,9764,6,10,12,14,44,51,-7,42
Dumbarton,9764,7,9,12,15,53,61,-8,39
Raith,9764,8,10,9,17,37,50,-13,39
St Mirren,9764,9,9,11,16,42,53,-11,38
Ayr,9764,10,9,10,17,33,59,-26,37
Hibernian,9765,1,20,12,4,53,22,31,72
Falkirk,9765,2,18,10,8,62,39,23,64
Dundee Utd,9765,3,16,10,10,58,46,12,58
Morton,9765,4,16,10,10,50,40,10,58
Dumbarton,9765,5,10,12,14,49,58,-9,42
Dunfermline,9765,6,9,13,14,45,49,-4,40
Queen of S't,9765,7,10,10,16,43,54,-11,40
Ayr,9765,8,9,11,16,37,58,-21,38
St Mirren,9765,9,9,10,17,41,56,-15,37
Raith,9765,10,9,10,17,33,49,-16,37
Hibernian,9766,1,18,12,6,54,30,24,66
Morton,9766,2,15,14,7,48,35,13,59
Dundee Utd,9766,3,17,8,11,52,42,10,59
Falkirk,9766,4,16,10,10,65,43,22,58
Queen of S't,9766,5,15,8,13,52,46,6,53
Raith,9766,6,11,9,16,34,47,-13,42
Dunfermline,9766,7,9,13,14,47,50,-3,40
Dumbarton,9766,8,10,10,16,46,59,-13,40
Ayr,9766,9,9,10,17,33,55,-22,37
St Mirren,9766,10,8,10,18,37,61,-24,34
Hibernian,9767,1,20,12,4,61,26,35,72
Dundee Utd,9767,2,19,9,8,52,33,19,66
Morton,9767,3,16,10,10,51,41,10,58
Falkirk,9767,4,13,12,11,52,42,10,51
Ayr,9767,5,11,11,14,44,50,-6,44
Queen of S't,9767,6,11,10,15,45,50,-5,43
Dunfermline,9767,7,10,11,15,45,52,-7,41
Raith,9767,8,10,9,17,32,50,-18,39
St Mirren,9767,9,9,10,17,38,55,-17,37
Dumbarton,9767,10,9,10,17,44,65,-21,37
Hibernian,9768,1,18,13,5,55,25,30,67
Morton,9768,2,17,11,8,52,46,6,62
Falkirk,9768,3,14,14,8,58,43,15,56
Dundee Utd,9768,4,15,11,10,49,42,7,56
Dunfermline,9768,5,11,14,11,49,45,4,47
Queen of S't,9768,6,13,8,15,49,50,-1,47
Ayr,9768,7,9,12,15,37,53,-16,39
Dumbarton,9768,8,9,11,16,48,59,-11,38
St Mirren,9768,9,9,10,17,40,52,-12,37
Raith,9768,10,8,10,18,35,57,-22,34
Hibernian,9769,1,16,15,5,55,30,25,63
Morton,9769,2,15,14,7,48,36,12,59
Falkirk,9769,3,16,10,10,58,42,16,58
Dundee Utd,9769,4,16,9,11,47,37,10,57
Queen of S't,9769,5,12,12,12,50,51,-1,48
Raith,9769,6,11,9,16,37,49,-12,42
Dunfermline,9769,7,9,14,13,48,51,-3,41
St Mirren,9769,8,10,10,16,41,52,-11,40
Dumbarton,9769,9,9,11,16,51,61,-10,38
Ayr,9769,10,7,14,15,30,56,-26,35
Falkirk,9770,1,19,9,8,62,39,23,66
Morton,9770,2,17,12,7,49,37,12,63
Hibernian,9770,3,16,12,8,49,27,22,60
Dundee Utd,9770,4,16,11,9,53,38,15,59
St Mirren,9770,5,11,10,15,42,51,-9,43
Queen of S't,9770,6,9,13,14,45,54,-9,40
Raith,9770,7,10,10,16,34,49,-15,40
Ayr,9770,8,9,13,14,35,54,-19,40
Dunfermline,9770,9,9,12,15,46,49,-3,39
Dumbarton,9770,10,7,12,17,47,64,-17,33
Hibernian,9771,1,18,13,5,48,21,27,67
Dundee Utd,9771,2,18,9,9,55,36,19,63
Falkirk,9771,3,16,10,10,55,38,17,58
Morton,9771,4,14,13,9,43,37,6,55
Queen of S't,9771,5,12,9,15,45,55,-10,45
Dunfermline,9771,6,10,14,12,48,46,2,44
Raith,9771,7,10,11,15,34,46,-12,41
Ayr,9771,8,10,10,16,35,55,-20,40
Dumbarton,9771,9,8,12,16,47,59,-12,36
St Mirren,9771,10,8,11,17,37,54,-17,35
Hibernian,9772,1,19,12,5,59,30,29,69
Morton,9772,2,20,9,7,55,34,21,69
Falkirk,9772,3,18,9,9,59,41,18,63
Dundee Utd,9772,4,15,12,9,51,38,13,57
Dumbarton,9772,5,11,12,13,54,59,-5,45
Queen of S't,9772,6,11,8,17,50,56,-6,41
Dunfermline,9772,7,8,13,15,45,55,-10,37
Raith,9772,8,9,10,17,33,50,-17,37
St Mirren,9772,9,8,10,18,38,56,-18,34
Ayr,9772,10,7,13,16,36,61,-25,34
Hibernian,9773,1,20,12,4,56,25,31,72
Dundee Utd,9773,2,16,11,9,50,39,11,59
Falkirk,9773,3,15,11,10,57,41,16,56
Morton,9773,4,15,11,10,54,47,7,56
Queen of S't,9773,5,12,9,15,46,52,-6,45
Raith,9773,6,11,11,14,38,46,-8,44
Dunfermline,9773,7,9,12,15,45,52,-7,39
St Mirren,9773,8,9,11,16,39,54,-15,38
Dumbarton,9773,9,8,13,15,50,59,-9,37
Ayr,9773,10,7,15,14,33,53,-20,36
Hibernian,9774,1,20,12,4,53,23,30,72
Morton,9774,2,17,12,7,52,38,14,63
Dundee Utd,9774,3,15,11,10,49,40,9,56
Falkirk,9774,4,14,11,11,57,44,13,53
Queen of S't,9774,5,12,9,15,51,56,-5,45
Ayr,9774,6,10,11,15,34,51,-17,41
Dumbarton,9774,7,9,13,14,48,56,-8,40
St Mirren,9774,8,9,12,15,43,55,-12,39
Raith,9774,9,9,11,16,34,49,-15,38
Dunfermline,9774,10,7,14,15,42,51,-9,35
Hibernian,9775,1,20,10,6,56,29,27,70
Morton,9775,2,18,10,8,52,37,15,64
Falkirk,9775,3,15,11,10,55,40,15,56
Dundee Utd,9775,4,15,10,11,51,44,7,55
Raith,9775,5,12,9,15,35,46,-11,45
Dunfermline,9775,6,10,14,12,53,51,2,44
Queen of S't,9775,7,11,9,16,46,53,-7,42
Ayr,9775,8,10,10,16,36,53,-17,40
St Mirren,9775,9,9,10,17,43,57,-14,37
Dumbarton,9775,10,8,11,17,47,64,-17,35
Hibernian,9776,1,20,13,3,62,26,36,73
Morton,9776,2,17,12,7,52,36,16,63
Dundee Utd,9776,3,16,10,10,48,38,10,58
Falkirk,9776,4,15,9,12,53,44,9,54
Queen of S't,9776,5,11,9,16,46,55,-9,42
Dunfermline,9776,6,10,11,15,47,51,-4,41
St Mirren,9776,7,10,11,15,43,54,-11,41
Ayr,9776,8,10,10,16,36,54,-18,40
Raith,9776,9,10,9,17,35,50,-15,39
Dumbarton,9776,10,8,12,16,44,58,-14,36
Hibernian,9777,1,21,11,4,64,26,38,74
Dundee Utd,9777,2,16,10,10,51,39,12,58
Falkirk,9777,3,15,12,9,53,38,15,57
Morton,9777,4,13,11,12,46,44,2,50
Queen of S't,9777,5,12,9,15,41,49,-8,45
Dumbarton,9777,6,11,11,14,53,57,-4,44
Dunfermline,9777,7,10,13,13,44,46,-2,43
Raith,9777,8,11,10,15,37,50,-13,43
St Mirren,9777,9,9,9,18,42,60,-18,36
Ayr,9777,10,8,12,16,34,56,-22,36
Hibernian,9778,1,17,14,5,52,28,24,65
Falkirk,9778,2,17,10,9,58,40,18,61
Morton,9778,3,16,12,8,52,38,14,60
Dundee Utd,9778,4,17,8,11,50,39,11,59
Dunfermline,9778,5,11,13,12,49,50,-1,46
Ayr,9778,6,11,11,14,33,50,-17,44
Queen of S't,9778,7,10,10,16,43,52,-9,40
St Mirren,9778,8,10,9,17,46,57,-11,39
Raith,9778,9,10,9,17,35,48,-13,39
Dumbarton,9778,10,7,12,17,44,60,-16,33
Hibernian,9779,1,20,13,3,59,23,36,73
Morton,9779,2,15,15,6,50,33,17,60
Dundee Utd,9779,3,16,9,11,50,38,12,57
Falkirk,9779,4,14,10,12,51,42,9,52
Dunfermline,9779,5,11,12,13,42,46,-4,45
Queen of S't,9779,6,11,10,15,40,48,-8,43
Ayr,9779,7,10,11,15,35,53,-18,41
Dumbarton,9779,8,9,12,15,51,60,-9,39
Raith,9779,9,9,12,15,36,51,-15,39
St Mirren,9779,10,7,12,17,44,64,-20,33
Hibernian,9780,1,21,10,5,58,26,32,73
Morton,9780,2,17,11,8,53,38,15,62
Dundee Utd,9780,3,16,10,10,48,38,10,58
Falkirk,9780,4,15,12,9,57,40,17,57
Dunfermline,9780,5,11,13,12,46,46,0,46
Dumbarton,9780,6,10,13,13,46,52,-6,43
Queen of S't,9780,7,10,9,17,44,55,-11,39
Raith,9780,8,10,9,17,34,52,-18,39
Ayr,9780,9,8,13,15,35,53,-18,37
St Mirren,9780,10,7,10,19,34,55,-21,31
Hibernian,9781,1,19,12,5,53,25,28,69
Falkirk,9781,2,17,11,8,57,38,19,62
Morton,9781,3,17,11,8,52,39,13,62
Dundee Utd,9781,4,16,10,10,48,39,9,58
Queen of S't,9781,5,11,10,15,45,49,-4,43
Raith,9781,6,11,9,16,37,51,-14,42
Dunfermline,9781,7,9,13,14,47,50,-3,40
Dumbarton,9781,8,9,12,15,45,54,-9,39
Ayr,9781,9,8,12,16,34,56,-22,36
St Mirren,9781,10,8,10,18,39,56,-17,34
Hibernian,9782,1,19,13,4,55,23,32,70
Morton,9782,2,17,12,7,53,34,19,63
Dundee Utd,9782,3,16,10,10,48,42,6,58
Falkirk,9782,4,14,12,10,52,38,14,54
Queen of S't,9782,5,11,9,16,44,52,-8,42
Dunfermline,9782,6,9,14,13,45,50,-5,41
Dumbarton,9782,7,9,13,14,50,58,-8,40
St Mirren,9782,8,9,11,16,42,57,-15,38
Ayr,9782,9,9,11,16,35,52,-17,38
Raith,9782,10,9,11,16,32,50,-18,38
Hibernian,9783,1,17,12,7,52,27,25,63
Falkirk,9783,2,16,12,8,60,41,19,60
Dundee Utd,9783,3,16,9,11,53,43,10,57
Morton,9783,4,14,13,9,46,38,8,55
Dunfermline,9783,5,10,15,11,50,48,2,45
Queen of S't,9783,6,12,9,15,43,48,-5,45
Dumbarton,9783,7,10,12,14,48,57,-9,42
St Mirren,9783,8,10,10,16,41,55,-14,40
Ayr,9783,9,9,12,15,41,56,-15,39
Raith,9783,10,9,10,17,33,54,-21,37
Hibernian,9784,1,21,11,4,61,26,35,74
Dundee Utd,9784,2,16,11,9,47,37,10,59
Falkirk,9784,3,16,10,10,58,42,16,58
Morton,9784,4,13,15,8,46,39,7,54
Dunfermline,9784,5,10,15,11,51,49,2,45
Dumbarton,9784,6,10,12,14,50,56,-6,42
Queen of S't,9784,7,10,10,16,49,59,-10,40
Raith,9784,8,9,11,16,37,51,-14,38
St Mirren,9784,9,8,11,17,39,57,-18,35
Ayr,9784,10,6,16,14,34,56,-22,34
Morton,9785,1,19,11,6,52,35,17,68
Hibernian,9785,2,17,13,6,49,26,23,64
Falkirk,9785,3,17,11,8,58,38,20,62
Dundee Utd,9785,4,15,10,11,48,41,7,55
Queen of S't,9785,5,11,10,15,45,55,-10,43
Dunfermline,9785,6,9,14,13,52,49,3,41
Raith,9785,7,11,8,17,37,51,-14,41
Dumbarton,9785,8,9,11,16,49,58,-9,38
Ayr,9785,9,9,10,17,32,55,-23,37
St Mirren,9785,10,8,12,16,37,51,-14,36
Hibernian,9786,1,22,10,4,58,22,36,76
Falkirk,9786,2,17,11,8,62,42,20,62
Morton,9786,3,15,12,9,46,40,6,57
Dundee Utd,9786,4,14,11,11,46,39,7,53
Queen of S't,9786,5,12,9,15,46,53,-7,45
Dumbarton,9786,6,11,11,14,48,53,-5,44
Raith,9786,7,11,10,15,41,48,-7,43
Ayr,9786,8,8,13,15,36,54,-18,37
Dunfermline,9786,9,8,12,16,40,52,-12,36
St Mirren,9786,10,7,11,18,41,61,-20,32
Hibernian,9787,1,20,12,4,52,23,29,72
Morton,9787,2,18,11,7,50,33,17,65
Falkirk,9787,3,16,11,9,58,40,18,59
Dundee Utd,9787,4,14,11,11,47,42,5,53
Queen of S't,9787,5,14,8,14,44,45,-1,50
Dunfermline,9787,6,11,12,13,45,46,-1,45
Dumbarton,9787,7,9,12,15,47,57,-10,39
Raith,9787,8,9,8,19,32,50,-18,35
St Mirren,9787,9,8,10,18,44,58,-14,34
Ayr,9787,10,7,13,16,32,57,-25,34
Hibernian,9788,1,20,13,3,61,28,33,73
Dundee Utd,9788,2,19,8,9,54,35,19,65
Falkirk,9788,3,16,10,10,59,42,17,58
Morton,9788,4,14,11,11,45,42,3,53
Queen of S't,9788,5,11,12,13,43,45,-2,45
Raith,9788,6,11,11,14,41,48,-7,44
Dunfermline,9788,7,10,13,13,46,48,-2,43
Dumbarton,9788,8,10,11,15,46,56,-10,41
St Mirren,9788,9,8,10,18,38,60,-22,34
Ayr,9788,10,6,11,19,34,63,-29,29
Hibernian,9789,1,20,10,6,57,29,28,70
Falkirk,9789,2,18,10,8,65,39,26,64
Morton,9789,3,18,9,9,51,35,16,63
Dundee Utd,9789,4,14,12,10,49,42,7,54
Dunfermline,9789,5,12,12,12,47,46,1,48
Queen of S't,9789,6,11,10,15,40,48,-8,43
Raith,9789,7,11,8,17,38,50,-12,41
Ayr,9789,8,9,11,16,34,53,-19,38
Dumbarton,9789,9,8,12,16,43,58,-15,36
St Mirren,9789,10,7,10,19,37,61,-24,31
Hibernian,9790,1,20,12,4,55,21,34,72
Morton,9790,2,18,10,8,53,35,18,64
Falkirk,9790,3,16,10,10,58,39,19,58
Dundee Utd,9790,4,15,11,10,54,40,14,56
Raith,9790,5,12,9,15,37,48,-11,45
Dunfermline,9790,6,11,11,14,44,47,-3,44
Queen of S't,9790,7,11,10,15,42,51,-9,43
Dumbarton,9790,8,10,10,16,47,58,-11,40
St Mirren,9790,9,8,10,18,34,61,-27,34
Ayr,9790,10,6,13,17,31,55,-24,31
Hibernian,9791,1,19,13,4,58,26,32,70
Morton,9791,2,17,12,7,50,35,15,63
Falkirk,9791,3,15,11,10,57,41,16,56
Dundee Utd,9791,4,15,9,12,51,40,11,54
Queen of S't,9791,5,12,9,15,44,54,-10,45
Ayr,9791,6,10,12,14,39,52,-13,42
Dunfermline,9791,7,10,11,15,45,52,-7,41
Raith,9791,8,10,11,15,35,47,-12,41
Dumbarton,9791,9,8,13,15,46,61,-15,37
St Mirren,9791,10,7,13,16,39,56,-17,34
Hibernian,9792,1,19,12,5,54,28,26,69
Falkirk,9792,2,18,10,8,59,36,23,64
Morton,9792,3,17,11,8,55,37,18,62
Dundee Utd,9792,4,15,10,11,48,39,9,55
Dunfermline,9792,5,11,12,13,50,47,3,45
Queen of S't,9792,6,11,11,14,42,49,-7,44
Raith,9792,7,11,8,17,39,54,-15,41
Ayr,9792,8,9,11,16,32,55,-23,38
Dumbarton,9792,9,9,10,17,46,57,-11,37
St Mirren,9792,10,8,9,19,38,61,-23,33
Hibernian,9793,1,17,16,3,55,27,28,67
Dundee Utd,9793,2,18,9,9,55,40,15,63
Morton,9793,3,17,12,7,47,34,13,63
Falkirk,9793,4,15,11,10,55,41,14,56
Dunfermline,9793,5,10,14,12,51,48,3,44
Queen of S't,9793,6,11,10,15,43,49,-6,43
Ayr,9793,7,9,11,16,36,56,-20,38
Dumbarton,9793,8,8,13,15,48,58,-10,37
Raith,9793,9,9,10,17,30,50,-20,37
St Mirren,9793,10,7,12,17,39,56,-17,33
Hibernian,9794,1,20,12,4,52,24,28,72
Dundee Utd,9794,2,18,9,9,56,38,18,63
Falkirk,9794,3,17,10,9,58,37,21,61
Morton,9794,4,15,11,10,43,36,7,56
Queen of S't,9794,5,12,9,15,44,48,-4,45
Dunfermline,9794,6,10,14,12,42,48,-6,44
Raith,9794,7,11,10,15,39,45,-6,43
St Mirren,9794,8,10,10,16,45,54,-9,40
Dumbarton,9794,9,8,11,17,47,62,-15,35
Ayr,9794,10,6,10,20,34,68,-34,28
Hibernian,9795,1,20,13,3,56,23,33,73
Dundee Utd,9795,2,20,8,8,58,33,25,68
Falkirk,9795,3,16,10,10,56,42,14,58
Morton,9795,4,14,14,8,52,43,9,56
Raith,9795,5,11,9,16,36,51,-15,42
Dunfermline,9795,6,9,14,13,51,53,-2,41
Queen of S't,9795,7,10,9,17,47,56,-9,39
Dumbarton,9795,8,8,14,14,51,61,-10,38
Ayr,9795,9,7,13,16,34,60,-26,34
St Mirren,9795,10,7,12,17,36,55,-19,33
Morton,9796,1,19,11,6,51,30,21,68
Hibernian,9796,2,17,10,9,47,27,20,61
Falkirk,9796,3,16,10,10,58,41,17,58
Dundee Utd,9796,4,14,10,12,51,48,3,52
Queen of S't,9796,5,13,9,14,46,47,-1,48
Dunfermline,9796,6,10,12,14,42,48,-6,42
Raith,9796,7,11,9,16,36,51,-15,42
St Mirren,9796,8,9,12,15,43,53,-10,39
Ayr,9796,9,9,12,15,36,55,-19,39
Dumbarton,9796,10,8,13,15,46,56,-10,37
Hibernian,9797,1,18,13,5,56,27,29,67
Morton,9797,2,15,14,7,44,31,13,59
Dundee Utd,9797,3,16,11,9,51,40,11,59
Falkirk,9797,4,14,11,11,57,46,11,53
Dunfermline,9797,5,10,13,13,46,50,-4,43
Raith,9797,6,11,10,15,34,45,-11,43
Queen of S't,9797,7,10,11,15,42,52,-10,41
St Mirren,9797,8,9,12,15,44,55,-11,39
Dumbarton,9797,9,8,14,14,53,63,-10,38
Ayr,9797,10,7,15,14,34,52,-18,36
Hibernian,9798,1,21,12,3,58,22,36,75
Dundee Utd,9798,2,17,11,8,52,36,16,62
Morton,9798,3,16,11,9,48,36,12,59
Falkirk,9798,4,14,12,10,50,40,10,54
Queen of S't,9798,5,12,8,16,45,49,-4,44
Dunfermline,9798,6,10,13,13,45,51,-6,43
Dumbarton,9798,7,10,12,14,46,58,-12,42
Ayr,9798,8,9,11,16,35,55,-20,38
Raith,9798,9,9,9,18,36,52,-16,36
St Mirren,9798,10,7,11,18,40,56,-16,32
Hibernian,9799,1,19,12,5,55,27,28,69
Morton,9799,2,19,10,7,51,36,15,67
Falkirk,9799,3,15,11,10,59,46,13,56
Dundee Utd,9799,4,14,11,11,44,38,6,53
Queen of S't,9799,5,12,9,15,50,53,-3,45
Dunfermline,9799,6,10,14,12,47,47,0,44
Raith,9799,7,11,10,15,40,51,-11,43
Dumbarton,9799,8,9,11,16,45,57,-12,38
St Mirren,9799,9,9,9,18,40,56,-16,36
Ayr,9799,10,7,13,16,37,57,-20,34
Hibernian,9800,1,19,13,4,56,30,26,70
Dundee Utd,9800,2,18,9,9,55,39,16,63
Falkirk,9800,3,15,12,9,65,47,18,57
Queen of S't,9800,4,15,9,12,56,46,10,54
Morton,9800,5,15,9,12,49,41,8,54
Dunfermline,9800,6,12,11,13,46,47,-1,47
St Mirren,9800,7,10,9,17,44,59,-15,39
Raith,9800,8,10,8,18,35,51,-16,38
Dumbarton,9800,9,8,11,17,44,60,-16,35
Ayr,9800,10,7,11,18,35,65,-30,32
Hibernian,9801,1,21,12,3,59,23,36,75
Falkirk,9801,2,19,9,8,63,36,27,66
Morton,9801,3,18,11,7,53,38,15,65
Dundee Utd,9801,4,16,9,11,50,40,10,57
Queen of S't,9801,5,12,11,13,48,50,-2,47
Dunfermline,9801,6,9,12,15,45,51,-6,39
Raith,9801,7,9,10,17,32,50,-18,37
St Mirren,9801,8,9,9,18,40,61,-21,36
Ayr,9801,9,7,12,17,30,55,-25,33
Dumbarton,9801,10,7,11,18,44,60,-16,32
Hibernian,9802,1,21,12,3,57,21,36,75
Dundee Utd,9802,2,16,10,10,46,38,8,58
Falkirk,9802,3,15,11,10,55,41,14,56
Morton,9802,4,15,11,10,43,40,3,56
Queen of S't,9802,5,11,12,13,50,50,0,45
Dunfermline,9802,6,9,14,13,48,49,-1,41
Dumbarton,9802,7,10,11,15,50,60,-10,41
Raith,9802,8,10,11,15,34,46,-12,41
Ayr,9802,9,9,12,15,35,53,-18,39
St Mirren,9802,10,7,10,19,35,55,-20,31
Hibernian,9803,1,19,12,5,58,26,32,69
Morton,9803,2,17,11,8,49,36,13,62
Dundee Utd,9803,3,16,10,10,47,37,10,58
Falkirk,9803,4,14,11,11,54,42,12,53
Dumbarton,9803,5,12,11,13,50,53,-3,47
Queen of S't,9803,6,12,8,16,47,53,-6,44
Dunfermline,9803,7,10,11,15,45,52,-7,41
Ayr,9803,8,9,12,15,34,53,-19,39
St Mirren,9803,9,9,11,16,39,54,-15,38
Raith,9803,10,9,9,18,33,50,-17,36
Hibernian,9804,1,20,10,6,55,27,28,70
Falkirk,9804,2,18,10,8,61,36,25,64
Dundee Utd,9804,3,16,10,10,50,38,12,58
Morton,9804,4,15,12,9,47,35,12,57
Dunfermline,9804,5,13,11,12,49,45,4,50
Queen of S't,9804,6,13,8,15,50,50,0,47
Raith,9804,7,10,9,17,35,56,-21,39
St Mirren,9804,8,9,10,17,38,54,-16,37
Ayr,9804,9,8,11,17,31,57,-26,35
Dumbarton,9804,10,7,11,18,41,59,-18,32
Hibernian,9805,1,19,13,4,55,22,33,70
Falkirk,9805,2,16,12,8,61,43,18,60
Morton,9805,3,16,12,8,47,35,12,60
Dundee Utd,9805,4,16,9,11,50,43,7,57
Queen of S't,9805,5,11,10,15,44,50,-6,43
Dumbarton,9805,6,10,12,14,50,58,-8,42
Dunfermline,9805,7,7,18,11,43,46,-3,39
Raith,9805,8,9,10,17,32,48,-16,37
St Mirren,9805,9,8,12,16,43,57,-14,36
Ayr,9805,10,8,12,16,34,57,-23,36
Hibernian,9806,1,18,14,4,51,22,29,68
Morton,9806,2,18,11,7,50,32,18,65
Falkirk,9806,3,16,12,8,62,40,22,60
Dundee Utd,9806,4,15,12,9,47,39,8,57
Queen of S't,9806,5,11,11,14,43,49,-6,44
Dunfermline,9806,6,10,11,15,45,49,-4,41
Raith,9806,7,10,11,15,33,48,-15,41
Dumbarton,9806,8,10,10,16,46,59,-13,40
St Mirren,9806,9,8,10,18,39,55,-16,34
Ayr,9806,10,7,12,17,30,53,-23,33
Hibernian,9807,1,17,15,4,54,24,30,66
Falkirk,9807,2,17,9,10,58,39,19,60
Morton,9807,3,15,14,7,47,34,13,59
Dundee Utd,9807,4,15,11,10,48,41,7,56
Dunfermline,9807,5,11,14,11,47,44,3,47
Queen of S't,9807,6,11,10,15,44,53,-9,43
Ayr,9807,7,10,11,15,38,54,-16,41
Dumbarton,9807,8,10,10,16,47,57,-10,40
St Mirren,9807,9,9,9,18,42,56,-14,36
Raith,9807,10,9,9,18,32,55,-23,36
Hibernian,9808,1,19,13,4,54,26,28,70
Morton,9808,2,19,10,7,52,36,16,67
Falkirk,9808,3,17,11,8,56,37,19,62
Dundee Utd,9808,4,17,9,10,48,37,11,60
Queen of S't,9808,5,10,12,14,46,50,-4,42
Dunfermline,9808,6,8,14,14,50,53,-3,38
Dumbarton,9808,7,9,11,16,51,61,-10,38
Ayr,9808,8,8,13,15,31,50,-19,37
St Mirren,9808,9,8,11,17,37,55,-18,35
Raith,9808,10,8,10,18,33,53,-20,34
Hibernian,9809,1,21,11,4,62,25,37,74
Morton,9809,2,18,10,8,52,34,18,64
Dundee Utd,9809,3,18,8,10,53,38,15,62
Falkirk,9809,4,15,10,11,55,45,10,55
Dunfermline,9809,5,11,13,12,47,47,0,46
Dumbarton,9809,6,9,11,16,47,58,-11,38
Queen of S't,9809,7,9,11,16,41,54,-13,38
Raith,9809,8,9,11,16,33,49,-16,38
St Mirren,9809,9,9,9,18,44,62,-18,36
Ayr,9809,10,8,12,16,33,55,-22,36
Hibernian,9810,1,18,13,5,57,25,32,67
Morton,9810,2,18,11,7,50,37,13,65
Falkirk,9810,3,18,9,9,60,41,19,63
Dundee Utd,9810,4,17,8,11,53,38,15,59
Dunfermline,9810,5,11,13,12,46,45,1,46
Dumbarton,9810,6,10,12,14,52,58,-6,42
Raith,9810,7,10,9,17,35,52,-17,39
Queen of S't,9810,8,9,10,17,42,53,-11,37
Ayr,9810,9,8,13,15,38,56,-18,37
St Mirren,9810,10,7,10,19,38,66,-28,31
Hibernian,9811,1,19,12,5,55,24,31,69
Dundee Utd,9811,2,17,10,9,58,42,16,61
Morton,9811,3,16,13,7,56,41,15,61
Falkirk,9811,4,15,10,11,58,44,14,55
Queen of S't,9811,5,13,8,15,44,49,-5,47
Dumbarton,9811,6,11,11,14,50,59,-9,44
Raith,9811,7,11,9,16,33,45,-12,42
Dunfermline,9811,8,9,14,13,47,52,-5,41
St Mirren,9811,9,7,13,16,39,58,-19,34
Ayr,9811,10,6,12,18,31,57,-26,30
Hibernian,9812,1,19,13,4,55,28,27,70
Morton,9812,2,16,10,10,51,41,10,58
Dundee Utd,9812,3,16,9,11,47,39,8,57
Falkirk,9812,4,14,12,10,56,44,12,54
Queen of S't,9812,5,13,10,13,45,47,-2,49
Ayr,9812,6,11,13,12,40,47,-7,46
Dunfermline,9812,7,9,12,15,45,49,-4,39
Dumbarton,9812,8,9,12,15,47,59,-12,39
Raith,9812,9,8,12,16,35,54,-19,36
St Mirren,9812,10,8,11,17,40,53,-13,35
Hibernian,9813,1,19,13,4,56,25,31,70
Morton,9813,2,17,10,9,51,41,10,61
Falkirk,9813,3,17,9,10,58,39,19,60
Dundee Utd,9813,4,15,12,9,50,41,9,57
Dunfermline,9813,5,9,14,13,47,50,-3,41
Dumbarton,9813,6,10,11,15,50,56,-6,41
Queen of S't,9813,7,10,11,15,43,52,-9,41
Raith,9813,8,10,11,15,34,47,-13,41
Ayr,9813,9,8,13,15,38,57,-19,37
St Mirren,9813,10,7,12,17,37,56,-19,33
Hibernian,9814,1,18,12,6,55,28,27,66
Dundee Utd,9814,2,17,10,9,52,38,14,61
Morton,9814,3,16,10,10,48,38,10,58
Falkirk,9814,4,15,11,10,62,43,19,56
Dunfermline,9814,5,12,12,12,50,49,1,48
Queen of S't,9814,6,10,11,15,42,51,-9,41
Ayr,9814,7,9,13,14,35,52,-17,40
Raith,9814,8,9,12,15,34,45,-11,39
Dumbarton,9814,9,8,13,15,45,61,-16,37
St Mirren,9814,10,8,12,16,39,57,-18,36
Hibernian,9815,1,18,12,6,55,29,26,66
Morton,9815,2,18,12,6,56,35,21,66
Falkirk,9815,3,17,9,10,62,41,21,60
Dundee Utd,9815,4,14,11,11,46,42,4,53
Ayr,9815,5,10,13,13,38,51,-13,43
Dunfermline,9815,6,10,12,14,45,52,-7,42
Queen of S't,9815,7,10,11,15,38,50,-12,41
Raith,9815,8,9,11,16,37,51,-14,38
Dumbarton,9815,9,8,13,15,51,62,-11,37
St Mirren,9815,10,8,12,16,43,58,-15,36
Hibernian,9816,1,19,14,3,58,27,31,71
Falkirk,9816,2,19,9,8,60,37,23,66
Morton,9816,3,18,11,7,49,34,15,65
Dundee Utd,9816,4,15,10,11,54,41,13,55
Dunfermline,9816,5,10,12,14,50,54,-4,42
Queen of S't,9816,6,11,9,16,50,59,-9,42
Dumbarton,9816,7,10,11,15,54,63,-9,41
Raith,9816,8,9,11,16,36,51,-15,38
St Mirren,9816,9,8,10,18,41,54,-13,34
Ayr,9816,10,7,11,18,31,63,-32,32
Hibernian,9817,1,18,14,4,54,26,28,68
Morton,9817,2,17,12,7,50,35,15,63
Falkirk,9817,3,17,10,9,59,39,20,61
Dumbarton,9817,4,12,12,12,53,53,0,48
Dunfermline,9817,5,12,11,13,45,46,-1,47
Queen of S't,9817,6,12,9,15,52,55,-3,45
Dundee Utd,9817,7,12,8,16,44,50,-6,44
St Mirren,9817,8,9,10,17,39,54,-15,37
Raith,9817,9,9,10,17,34,50,-16,37
Ayr,9817,10,8,12,16,31,53,-22,36
Hibernian,9818,1,18,12,6,55,29,26,66
Morton,9818,2,17,11,8,51,37,14,62
Dundee Utd,9818,3,17,10,9,47,36,11,61
Falkirk,9818,4,15,10,11,56,44,12,55
Ayr,9818,5,12,11,13,41,50,-9,47
Queen of S't,9818,6,12,9,15,45,49,-4,45
Dumbarton,9818,7,10,12,14,47,53,-6,42
Raith,9818,8,10,10,16,37,52,-15,40
Dunfermline,9818,9,9,11,16,42,51,-9,38
St Mirren,9818,10,6,12,18,35,55,-20,30
Hibernian,9819,1,19,11,6,56,28,28,68
Falkirk,9819,2,18,11,7,63,38,25,65
Morton,9819,3,17,13,6,52,35,17,64
Dundee Utd,9819,4,14,11,11,45,39,6,53
Queen of S't,9819,5,11,9,16,45,54,-9,42
Ayr,9819,6,10,12,14,35,53,-18,42
Dunfermline,9819,7,9,14,13,43,46,-3,41
Raith,9819,8,9,10,17,33,49,-16,37
St Mirren,9819,9,9,9,18,45,60,-15,36
Dumbarton,9819,10,8,12,16,42,57,-15,36
Hibernian,9820,1,18,14,4,55,25,30,68
Morton,9820,2,18,12,6,57,34,23,66
Falkirk,9820,3,17,10,9,60,43,17,61
Dundee Utd,9820,4,15,12,9,51,37,14,57
Queen of S't,9820,5,12,11,13,52,53,-1,47
Dumbarton,9820,6,9,13,14,46,54,-8,40
Dunfermline,9820,7,9,12,15,45,54,-9,39
Ayr,9820,8,8,14,14,34,54,-20,38
Raith,9820,9,8,10,18,33,55,-22,34
St Mirren,9820,10,6,12,18,34,58,-24,30
Hibernian,9821,1,17,13,6,57,29,28,64
Falkirk,9821,2,15,13,8,52,35,17,58
Morton,9821,3,15,12,9,46,42,4,57
Dundee Utd,9821,4,16,8,12,47,42,5,56
Dunfermline,9821,5,12,13,11,49,45,4,49
Queen of S't,9821,6,12,12,12,49,46,3,48
Raith,9821,7,11,11,14,34,44,-10,44
Dumbarton,9821,8,8,13,15,46,59,-13,37
St Mirren,9821,9,9,10,17,44,57,-13,37
Ayr,9821,10,6,13,17,31,56,-25,31
Hibernian,9822,1,19,12,5,53,27,26,69
Morton,9822,2,16,13,7,49,39,10,61
Falkirk,9822,3,14,11,11,59,46,13,53
Dundee Utd,9822,4,13,12,11,50,45,5,51
Dunfermline,9822,5,12,13,11,47,41,6,49
Queen of S't,9822,6,12,9,15,42,47,-5,45
Dumbarton,9822,7,10,12,14,48,54,-6,42
Ayr,9822,8,9,14,13,35,52,-17,41
Raith,9822,9,10,9,17,35,48,-13,39
St Mirren,9822,10,8,9,19,41,60,-19,33
Hibernian,9823,1,21,12,3,58,22,36,75
Morton,9823,2,17,13,6,53,37,16,64
Falkirk,9823,3,16,9,11,57,43,14,57
Dundee Utd,9823,4,15,11,10,47,38,9,56
Queen of S't,9823,5,11,10,15,43,47,-4,43
Dunfermline,9823,6,10,13,13,50,55,-5,43
Dumbarton,9823,7,9,12,15,52,60,-8,39
Ayr,9823,8,9,12,15,33,53,-20,39
Raith,9823,9,8,10,18,36,55,-19,34
St Mirren,9823,10,7,12,17,40,59,-19,33
Morton,9824,1,18,10,8,55,35,20,64
Hibernian,9824,2,17,12,7,54,29,25,63
Dundee Utd,9824,3,17,9,10,51,38,13,60
Falkirk,9824,4,14,15,7,60,39,21,57
Raith,9824,5,12,9,15,36,46,-10,45
Dunfermline,9824,6,10,13,13,41,47,-6,43
Queen of S't,9824,7,10,11,15,43,51,-8,41
St Mirren,9824,8,10,9,17,44,61,-17,39
Dumbarton,9824,9,9,11,16,44,56,-12,38
Ayr,9824,10,8,11,17,33,59,-26,35
Hibernian,9825,1,22,11,3,65,25,40,77
Morton,9825,2,19,11,6,56,34,22,68
Falkirk,9825,3,16,11,9,59,43,16,59
Dundee Utd,9825,4,16,9,11,49,39,10,57
Queen of S't,9825,5,11,10,15,43,51,-8,43
Raith,9825,6,10,10,16,36,48,-12,40
Dunfermline,9825,7,8,12,16,43,52,-9,36
St Mirren,9825,8,8,12,16,38,54,-16,36
Dumbarton,9825,9,8,12,16,45,62,-17,36
Ayr,9825,10,7,12,17,34,60,-26,33
Hibernian,9826,1,19,13,4,56,24,32,70
Dundee Utd,9826,2,18,9,9,56,36,20,63
Morton,9826,3,17,11,8,54,35,19,62
Falkirk,9826,4,16,10,10,56,45,11,58
Queen of S't,9826,5,12,9,15,45,52,-7,45
Dunfermline,9826,6,10,12,14,47,50,-3,42
Dumbarton,9826,7,9,13,14,49,61,-12,40
Raith,9826,8,10,10,16,33,46,-13,40
St Mirren,9826,9,9,10,17,40,56,-16,37
Ayr,9826,10,6,11,19,29,60,-31,29
Morton,9827,1,19,10,7,56,39,17,67
Hibernian,9827,2,17,15,4,50,23,27,66
Falkirk,9827,3,17,11,8,65,41,24,62
Dundee Utd,9827,4,14,11,11,48,43,5,53
Queen of S't,9827,5,11,11,14,45,48,-3,44
Dunfermline,9827,6,10,12,14,45,47,-2,42
St Mirren,9827,7,10,10,16,47,56,-9,40
Raith,9827,8,9,10,17,31,49,-18,37
Ayr,9827,9,8,13,15,30,52,-22,37
Dumbarton,9827,10,8,11,17,45,64,-19,35
Falkirk,9828,1,17,11,8,58,39,19,62
Hibernian,9828,2,16,13,7,49,28,21,61
Morton,9828,3,16,13,7,52,39,13,61
Dundee Utd,9828,4,16,10,10,50,39,11,58
Raith,9828,5,11,10,15,37,48,-11,43
Queen of S't,9828,6,11,9,16,45,49,-4,42
Dunfermline,9828,7,9,14,13,48,55,-7,41
Ayr,9828,8,10,10,16,39,55,-16,40
Dumbarton,9828,9,9,12,15,50,60,-10,39
St Mirren,9828,10,9,10,17,41,57,-16,37
Hibernian,9829,1,18,12,6,53,27,26,66
Falkirk,9829,2,19,9,8,60,37,23,66
Morton,9829,3,15,11,10,47,40,7,56
Dundee Utd,9829,4,14,11,11,48,41,7,53
Queen of S't,9829,5,13,10,13,47,47,0,49
St Mirren,9829,6,11,10,15,48,50,-2,43
Dunfermline,9829,7,9,14,13,47,51,-4,41
Dumbarton,9829,8,10,11,15,51,62,-11,41
Raith,9829,9,9,10,17,31,50,-19,37
Ayr,9829,10,6,14,16,28,55,-27,32
Hibernian,9830,1,19,13,4,58,26,32,70
Dundee Utd,9830,2,17,10,9,51,38,13,61
Morton,9830,3,16,11,9,47,37,10,59
Falkirk,9830,4,14,12,10,55,43,12,54
Dunfermline,9830,5,11,13,12,52,50,2,46
Queen of S't,9830,6,11,11,14,47,50,-3,44
Raith,9830,7,10,10,16,37,49,-12,40
Ayr,9830,8,9,13,14,37,50,-13,40
St Mirren,9830,9,8,11,17,38,59,-21,35
Dumbarton,9830,10,7,12,17,45,65,-20,33
Hibernian,9831,1,19,12,5,56,29,27,69
Morton,9831,2,17,13,6,51,34,17,64
Dundee Utd,9831,3,16,10,10,48,39,9,58
Falkirk,9831,4,15,12,9,57,38,19,57
Queen of S't,9831,5,12,10,14,41,46,-5,46
Raith,9831,6,10,12,14,34,45,-11,42
Dunfermline,9831,7,9,12,15,42,47,-5,39
Dumbarton,9831,8,9,12,15,46,58,-12,39
Ayr,9831,9,8,12,16,35,54,-19,36
St Mirren,9831,10,7,11,18,36,56,-20,32
Hibernian,9832,1,18,12,6,56,29,27,66
Falkirk,9832,2,17,9,10,61,40,21,60
Morton,9832,3,16,12,8,47,37,10,60
Dundee Utd,9832,4,16,10,10,50,41,9,58
Queen of S't,9832,5,13,9,14,45,51,-6,48
Dunfermline,9832,6,10,12,14,48,55,-7,42
Dumbarton,9832,7,10,11,15,55,56,-1,41
Ayr,9832,8,8,14,14,32,53,-21,38
Raith,9832,9,8,12,16,36,52,-16,36
St Mirren,9832,10,8,11,17,44,60,-16,35
Hibernian,9833,1,20,12,4,58,25,33,72
Dundee Utd,9833,2,16,11,9,51,39,12,59
Morton,9833,3,15,13,8,55,44,11,58
Falkirk,9833,4,15,12,9,57,40,17,57
Dunfermline,9833,5,12,12,12,49,47,2,48
Dumbarton,9833,6,10,11,15,46,56,-10,41
Raith,9833,7,10,11,15,38,49,-11,41
Queen of S't,9833,8,10,10,16,44,55,-11,40
Ayr,9833,9,7,13,16,35,57,-22,34
St Mirren,9833,10,8,9,19,37,58,-21,33
Hibernian,9834,1,17,15,4,52,28,24,66
Morton,9834,2,17,13,6,48,30,18,64
Dundee Utd,9834,3,16,9,11,48,43,5,57
Falkirk,9834,4,14,10,12,54,46,8,52
Dunfermline,9834,5,10,14,12,48,49,-1,44
Queen of S't,9834,6,11,11,14,45,48,-3,44
Ayr,9834,7,10,11,15,38,50,-12,41
Raith,9834,8,11,8,17,35,49,-14,41
Dumbarton,9834,9,9,13,14,48,55,-7,40
St Mirren,9834,10,8,10,18,40,58,-18,34
Hibernian,9835,1,18,14,4,56,27,29,68
Morton,9835,2,16,11,9,52,42,10,59
Dundee Utd,9835,3,14,11,11,50,45,5,53
Falkirk,9835,4,13,11,12,53,45,8,50
Queen of S't,9835,5,12,11,13,47,52,-5,47
Dunfermline,9835,6,10,13,13,50,48,2,43
St Mirren,9835,7,11,10,15,43,52,-9,43
Raith,9835,8,11,10,15,39,51,-12,43
Dumbarton,9835,9,10,11,15,53,60,-7,41
Ayr,9835,10,8,12,16,33,54,-21,36
Hibernian,9836,1,19,12,5,55,25,30,69
Morton,9836,2,18,13,5,58,31,27,67
Falkirk,9836,3,15,13,8,58,40,18,58
Dundee Utd,9836,4,15,10,11,47,37,10,55
Queen of S't,9836,5,12,9,15,42,47,-5,45
Dunfermline,9836,6,9,14,13,44,57,-13,41
St Mirren,9836,7,10,10,16,41,56,-15,40
Raith,9836,8,9,10,17,32,49,-17,37
Ayr,9836,9,7,14,15,29,50,-21,35
Dumbarton,9836,10,7,13,16,46,60,-14,34
Hibernian,9837,1,18,13,5,53,26,27,67
Morton,9837,2,18,10,8,52,36,16,64
Dundee Utd,9837,3,17,10,9,54,39,15,61
Falkirk,9837,4,15,13,8,68,45,23,58
Queen of S't,9837,5,13,8,15,50,54,-4,47
Raith,9837,6,12,9,15,38,50,-12,45
Dumbarton,9837,7,9,11,16,52,68,-16,38
Dunfermline,9837,8,8,12,16,46,59,-13,36
St Mirren,9837,9,8,12,16,45,58,-13,36
Ayr,9837,10,7,12,17,35,58,-23,33
Hibernian,9838,1,21,12,3,58,21,37,75
Falkirk,9838,2,16,11,9,55,38,17,59
Dundee Utd,9838,3,16,10,10,48,39,9,58
Morton,9838,4,14,14,8,48,39,9,56
Queen of S't,9838,5,11,10,15,44,50,-6,43
Dumbarton,9838,6,9,14,13,48,55,-7,41
Dunfermline,9838,7,8,16,12,41,44,-3,40
Raith,9838,8,10,9,17,34,49,-15,39
Ayr,9838,9,9,12,15,36,56,-20,39
St Mirren,9838,10,7,10,19,38,59,-21,31
Hibernian,9839,1,19,11,6,52,24,28,68
Falkirk,9839,2,16,13,7,60,40,20,61
Dundee Utd,9839,3,16,11,9,48,39,9,59
Morton,9839,4,15,13,8,51,36,15,58
Raith,9839,5,11,12,13,36,44,-8,45
Dumbarton,9839,6,10,11,15,49,58,-9,41
Dunfermline,9839,7,9,13,14,43,47,-4,40
Queen of S't,9839,8,10,10,16,44,54,-10,40
St Mirren,9839,9,8,11,17,41,62,-21,35
Ayr,9839,10,7,13,16,37,57,-20,34
Hibernian,9840,1,19,12,5,51,24,27,69
Morton,9840,2,18,11,7,48,32,16,65
Dundee Utd,9840,3,16,11,9,49,38,11,59
Falkirk,9840,4,15,11,10,57,44,13,56
Raith,9840,5,12,9,15,40,46,-6,45
Dunfermline,9840,6,10,13,13,47,47,0,43
Queen of S't,9840,7,11,9,16,44,53,-9,42
Dumbarton,9840,8,8,13,15,46,59,-13,37
Ayr,9840,9,8,11,17,35,55,-20,35
St Mirren,9840,10,7,12,17,40,59,-19,33
Morton,9841,1,21,10,5,52,28,24,73
Hibernian,9841,2,19,11,6,57,26,31,68
Dundee Utd,9841,3,18,9,9,52,37,15,63
Falkirk,9841,4,15,11,10,59,43,16,56
Queen of S't,9841,5,13,9,14,44,46,-2,48
Raith,9841,6,9,10,17,33,57,-24,37
Dunfermline,9841,7,8,12,16,44,51,-7,36
St Mirren,9841,8,9,9,18,46,63,-17,36
Dumbarton,9841,9,8,11,17,47,62,-15,35
Ayr,9841,10,7,14,15,33,54,-21,35
Hibernian,9842,1,19,13,4,55,26,29,70
Falkirk,9842,2,17,10,9,59,38,21,61
Dundee Utd,9842,3,15,12,9,52,43,9,57
Morton,9842,4,15,11,10,47,42,5,56
Ayr,9842,5,11,11,14,45,57,-12,44
Queen of S't,9842,6,11,9,16,44,57,-13,42
Raith,9842,7,10,10,16,41,52,-11,40
Dumbarton,9842,8,10,10,16,45,57,-12,40
Dunfermline,9842,9,8,15,13,44,47,-3,39
St Mirren,9842,10,8,11,17,44,57,-13,35
Hibernian,9843,1,19,13,4,57,25,32,70
Morton,9843,2,18,13,5,58,37,21,67
Falkirk,9843,3,17,9,10,58,39,19,60
Dundee Utd,9843,4,17,9,10,48,37,11,60
Queen of S't,9843,5,13,8,15,48,51,-3,47
Raith,9843,6,10,9,17,33,49,-16,39
Dumbarton,9843,7,9,11,16,48,59,-11,38
Dunfermline,9843,8,8,13,15,45,54,-9,37
Ayr,9843,9,8,11,17,34,59,-25,35
St Mirren,9843,10,8,10,18,37,56,-19,34
Morton,9844,1,20,9,7,57,34,23,69
Hibernian,9844,2,18,11,7,57,30,27,65
Falkirk,9844,3,17,11,8,62,41,21,62
Dundee Utd,9844,4,17,10,9,55,42,13,61
Dunfermline,9844,5,10,13,13,49,53,-4,43
Raith,9844,6,11,10,15,37,52,-15,43
Queen of S't,9844,7,10,8,18,44,56,-12,38
Ayr,9844,8,9,11,16,34,57,-23,38
St Mirren,9844,9,9,10,17,40,52,-12,37
Dumbarton,9844,10,7,11,18,42,60,-18,32
Hibernian,9845,1,21,11,4,61,25,36,74
Morton,9845,2,17,11,8,48,34,14,62
Dundee Utd,9845,3,17,9,10,53,37,16,60
Falkirk,9845,4,15,11,10,52,39,13,56
Dunfermline,9845,5,10,14,12,43,44,-1,44
Queen of S't,9845,6,11,11,14,45,52,-7,44
Raith,9845,7,10,10,16,34,51,-17,40
St Mirren,9845,8,9,10,17,41,58,-17,37
Dumbarton,9845,9,8,11,17,46,60,-14,35
Ayr,9845,10,8,10,18,32,55,-23,34
Hibernian,9846,1,20,12,4,59,26,33,72
Falkirk,9846,2,17,10,9,62,43,19,61
Morton,9846,3,16,13,7,55,42,13,61
Dundee Utd,9846,4,16,10,10,55,44,11,58
Dunfermline,9846,5,11,14,11,52,49,3,47
Queen of S't,9846,6,12,9,15,48,53,-5,45
St Mirren,9846,7,9,10,17,43,54,-11,37
Dumbarton,9846,8,8,12,16,46,61,-15,36
Raith,9846,9,8,10,18,31,52,-21,34
Ayr,9846,10,7,12,17,33,60,-27,33
Hibernian,9847,1,21,11,4,57,23,34,74
Dundee Utd,9847,2,16,11,9,53,35,18,59
Morton,9847,3,16,9,11,50,45,5,57
Falkirk,9847,4,14,12,10,55,45,10,54
Dunfermline,9847,5,12,12,12,52,44,8,48
Raith,9847,6,12,10,14,40,47,-7,46
Queen of S't,9847,7,12,9,15,47,50,-3,45
St Mirren,9847,8,9,10,17,38,59,-21,37
Ayr,9847,9,8,11,17,32,55,-23,35
Dumbarton,9847,10,7,11,18,44,65,-21,32
Hibernian,9848,1,20,12,4,58,26,32,72
Morton,9848,2,17,13,6,51,35,16,64
Dundee Utd,9848,3,17,10,9,55,44,11,61
Falkirk,9848,4,14,11,11,55,42,13,53
Raith,9848,5,11,11,14,42,52,-10,44
Queen of S't,9848,6,10,12,14,48,55,-7,42
Dumbarton,9848,7,9,14,13,51,57,-6,41
Dunfermline,9848,8,9,12,15,47,51,-4,39
St Mirren,9848,9,7,12,17,38,58,-20,33
Ayr,9848,10,7,11,18,32,57,-25,32
Hibernian,9849,1,16,16,4,53,30,23,64
Morton,9849,2,16,13,7,55,37,18,61
Falkirk,9849,3,16,11,9,58,41,17,59
Dunfermline,9849,4,11,14,11,49,45,4,47
Dundee Utd,9849,5,13,8,15,46,46,0,47
Queen of S't,9849,6,12,11,13,45,48,-3,47
Dumbarton,9849,7,10,11,15,48,58,-10,41
Ayr,9849,8,10,11,15,37,54,-17,41
St Mirren,9849,9,9,12,15,39,52,-13,39
Raith,9849,10,8,11,17,31,50,-19,35
Hibernian,9850,1,18,13,5,54,23,31,67
Morton,9850,2,16,11,9,49,33,16,59
Dundee Utd,9850,3,17,8,11,52,39,13,59
Falkirk,9850,4,15,12,9,57,39,18,57
Queen of S't,9850,5,12,10,14,45,50,-5,46
Dumbarton,9850,6,11,11,14,48,56,-8,44
Dunfermline,9850,7,10,13,13,44,50,-6,43
Raith,9850,8,11,9,16,37,53,-16,42
Ayr,9850,9,9,11,16,35,55,-20,38
St Mirren,9850,10,6,12,18,35,58,-23,30
Hibernian,9851,1,19,12,5,55,25,30,69
Morton,9851,2,17,12,7,50,36,14,63
Falkirk,9851,3,16,9,11,60,44,16,57
Dundee Utd,9851,4,15,9,12,49,41,8,54
Dumbarton,9851,5,13,11,12,52,52,0,50
Queen of S't,9851,6,11,10,15,43,49,-6,43
Dunfermline,9851,7,10,12,14,45,50,-5,42
St Mirren,9851,8,10,9,17,44,58,-14,39
Raith,9851,9,10,8,18,36,53,-17,38
Ayr,9851,10,7,12,17,33,59,-26,33
Hibernian,9852,1,17,15,4,61,32,29,66
Morton,9852,2,16,12,8,53,38,15,60
Falkirk,9852,3,16,10,10,61,42,19,58
Dundee Utd,9852,4,14,10,12,46,47,-1,52
Queen of S't,9852,5,13,10,13,49,47,2,49
Dumbarton,9852,6,10,12,14,51,56,-5,42
Raith,9852,7,10,12,14,35,47,-12,42
Dunfermline,9852,8,8,16,12,45,48,-3,40
St Mirren,9852,9,8,12,16,40,55,-15,36
Ayr,9852,10,8,11,17,35,64,-29,35
Hibernian,9853,1,18,14,4,53,24,29,68
Morton,9853,2,17,11,8,47,35,12,62
Falkirk,9853,3,16,12,8,52,35,17,60
Dundee Utd,9853,4,16,10,10,51,40,11,58
Queen of S't,9853,5,13,9,14,50,49,1,48
Dunfermline,9853,6,10,12,14,46,48,-2,42
Raith,9853,7,10,9,17,34,48,-14,39
Ayr,9853,8,8,13,15,34,57,-23,37
Dumbarton,9853,9,7,14,15,44,57,-13,35
St Mirren,9853,10,7,12,17,35,53,-18,33
Hibernian,9854,1,20,12,4,58,22,36,72
Dundee Utd,9854,2,16,10,10,52,41,11,58
Falkirk,9854,3,16,9,11,56,44,12,57
Morton,9854,4,14,13,9,50,40,10,55
Queen of S't,9854,5,12,11,13,46,48,-2,47
Raith,9854,6,12,8,16,36,48,-12,44
Dumbarton,9854,7,10,12,14,50,59,-9,42
Dunfermline,9854,8,8,13,15,45,56,-11,37
St Mirren,9854,9,8,12,16,40,54,-14,36
Ayr,9854,10,8,12,16,34,55,-21,36
Hibernian,9855,1,19,11,6,60,28,32,68
Morton,9855,2,17,10,9,51,39,12,61
Falkirk,9855,3,16,11,9,59,40,19,59
Dundee Utd,9855,4,15,12,9,51,40,11,57
Dunfermline,9855,5,12,12,12,46,46,0,48
Queen of S't,9855,6,13,9,14,45,49,-4,48
Raith,9855,7,10,10,16,34,49,-15,40
Ayr,9855,8,8,12,16,34,55,-21,36
St Mirren,9855,9,8,11,17,37,54,-17,35
Dumbarton,9855,10,8,10,18,48,65,-17,34
Hibernian,9856,1,19,12,5,52,25,27,69
Falkirk,9856,2,17,10,9,62,39,23,61
Morton,9856,3,16,12,8,47,33,14,60
Dundee Utd,9856,4,15,9,12,51,45,6,54
Dunfermline,9856,5,11,12,13,48,50,-2,45
Queen of S't,9856,6,11,10,15,48,52,-4,43
Raith,9856,7,11,10,15,39,51,-12,43
Dumbarton,9856,8,10,10,16,44,57,-13,40
St Mirren,9856,9,9,10,17,37,55,-18,37
Ayr,9856,10,7,13,16,34,55,-21,34
Hibernian,9857,1,20,11,5,59,28,31,71
Morton,9857,2,18,10,8,54,36,18,64
Dundee Utd,9857,3,17,8,11,56,43,13,59
Falkirk,9857,4,15,10,11,53,40,13,55
Dunfermline,9857,5,11,12,13,50,47,3,45
Queen of S't,9857,6,11,10,15,45,54,-9,43
St Mirren,9857,7,9,12,15,45,56,-11,39
Dumbarton,9857,8,8,14,14,46,55,-9,38
Raith,9857,9,10,8,18,32,57,-25,38
Ayr,9857,10,7,13,16,35,59,-24,34
Hibernian,9858,1,20,12,4,52,23,29,72
Falkirk,9858,2,18,10,8,62,37,25,64
Morton,9858,3,17,12,7,51,35,16,63
Dundee Utd,9858,4,15,10,11,50,42,8,55
Queen of S't,9858,5,12,8,16,43,51,-8,44
Dunfermline,9858,6,9,14,13,41,46,-5,41
Ayr,9858,7,9,12,15,32,53,-21,39
St Mirren,9858,8,9,10,17,46,55,-9,37
Raith,9858,9,9,9,18,35,51,-16,36
Dumbarton,9858,10,7,13,16,44,63,-19,34
Hibernian,9859,1,19,11,6,52,24,28,68
Morton,9859,2,17,11,8,50,38,12,62
Dundee Utd,9859,3,17,10,9,52,37,15,61
Falkirk,9859,4,14,12,10,56,48,8,54
Dunfermline,9859,5,11,11,14,50,50,0,44
Queen of S't,9859,6,10,13,13,46,49,-3,43
Raith,9859,7,11,10,15,40,51,-11,43
Ayr,9859,8,9,11,16,37,56,-19,38
Dumbarton,9859,9,8,12,16,48,62,-14,36
St Mirren,9859,10,8,11,17,41,57,-16,35
Hibernian,9860,1,19,11,6,52,27,25,68
Falkirk,9860,2,17,9,10,60,40,20,60
Morton,9860,3,16,11,9,49,37,12,59
Dundee Utd,9860,4,15,10,11,49,43,6,55
Queen of S't,9860,5,13,9,14,53,51,2,48
Dunfermline,9860,6,10,13,13,42,45,-3,43
St Mirren,9860,7,11,10,15,44,55,-11,43
Dumbarton,9860,8,10,12,14,50,56,-6,42
Raith,9860,9,10,8,18,34,54,-20,38
Ayr,9860,10,7,11,18,36,61,-25,32
Hibernian,9861,1,21,11,4,58,27,31,74
Dundee Utd,9861,2,15,11,10,46,41,5,56
Falkirk,9861,3,15,10,11,59,44,15,55
Morton,9861,4,13,14,9,46,40,6,53
Dunfermline,9861,5,12,13,11,49,46,3,49
Queen of S't,9861,6,13,8,15,47,51,-4,47
Dumbarton,9861,7,9,13,14,51,60,-9,40
Raith,9861,8,10,10,16,38,48,-10,40
St Mirren,9861,9,8,12,16,42,56,-14,36
Ayr,9861,10,7,12,17,33,56,-23,33
Hibernian,9862,1,21,11,4,56,24,32,74
Morton,9862,2,16,14,6,51,37,14,62
Falkirk,9862,3,17,9,10,58,37,21,60
Dundee Utd,9862,4,15,11,10,47,38,9,56
Dunfermline,9862,5,11,12,13,46,47,-1,45
Dumbarton,9862,6,9,14,13,50,55,-5,41
Queen of S't,9862,7,10,10,16,40,50,-10,40
St Mirren,9862,8,8,12,16,44,54,-10,36
Raith,9862,9,9,9,18,35,60,-25,36
Ayr,9862,10,7,12,17,32,57,-25,33
Hibernian,9863,1,19,13,4,59,25,34,70
Falkirk,9863,2,16,11,9,57,42,15,59
Morton,9863,3,15,12,9,47,36,11,57
Dundee Utd,9863,4,15,11,10,49,41,8,56
Queen of S't,9863,5,12,10,14,48,52,-4,46
Dunfermline,9863,6,10,12,14,44,52,-8,42
Raith,9863,6,10,12,14,44,52,-8,42
St Mirren,9863,8,9,12,15,42,54,-12,39
Ayr,9863,9,7,14,15,31,55,-24,35
Dumbarton,9863,10,7,13,16,45,57,-12,34
Hibernian,9864,1,19,11,6,59,28,31,68
Dundee Utd,9864,2,18,9,9,58,40,18,63
Falkirk,9864,3,16,10,10,58,41,17,58
Morton,9864,4,15,11,10,47,41,6,56
Raith,9864,5,11,10,15,36,47,-11,43
Dunfermline,9864,6,9,14,13,43,51,-8,41
Queen of S't,9864,7,10,11,15,43,53,-10,41
Ayr,9864,8,10,11,15,35,53,-18,41
Dumbarton,9864,9,9,12,15,50,59,-9,39
St Mirren,9864,10,7,13,16,44,60,-16,34
Hibernian,9865,1,21,11,4,60,26,34,74
Falkirk,9865,2,19,9,8,68,39,29,66
Morton,9865,3,18,11,7,53,34,19,65
Dundee Utd,9865,4,13,11,12,45,43,2,50
Queen of S't,9865,5,12,10,14,47,53,-6,46
Dunfermline,9865,6,10,13,13,47,48,-1,43
St Mirren,9865,7,9,11,16,38,54,-16,38
Ayr,9865,8,9,11,16,33,54,-21,38
Raith,9865,9,9,8,19,34,57,-23,35
Dumbarton,9865,10,7,11,18,43,60,-17,32
Hibernian,9866,1,19,13,4,54,25,29,70
Morton,9866,2,17,11,8,52,33,19,62
Dundee Utd,9866,3,16,9,11,50,40,10,57
Falkirk,9866,4,15,11,10,54,39,15,56
Dumbarton,9866,5,12,10,14,49,53,-4,46
Queen of S't,9866,6,11,10,15,42,51,-9,43
Dunfermline,9866,7,10,12,14,46,50,-4,42
Raith,9866,8,10,10,16,35,51,-16,40
Ayr,9866,9,8,13,15,34,55,-21,37
St Mirren,9866,10,8,9,19,41,60,-19,33
Hibernian,9867,1,20,12,4,59,24,35,72
Morton,9867,2,18,10,8,47,35,12,64
Falkirk,9867,3,16,11,9,57,41,16,59
Dundee Utd,9867,4,15,10,11,45,37,8,55
Queen of S't,9867,5,11,10,15,42,47,-5,43
Dumbarton,9867,6,10,11,15,45,55,-10,41
Raith,9867,7,11,8,17,36,48,-12,41
Dunfermline,9867,8,9,13,14,41,46,-5,40
St Mirren,9867,9,9,10,17,39,55,-16,37
Ayr,9867,10,8,11,17,31,54,-23,35
Hibernian,9868,1,18,14,4,52,24,28,68
Morton,9868,2,15,14,7,47,35,12,59
Dundee Utd,9868,3,17,8,11,53,42,11,59
Falkirk,9868,4,16,10,10,62,43,19,58
Queen of S't,9868,5,14,8,14,48,47,1,50
Ayr,9868,6,10,13,13,36,49,-13,43
Dumbarton,9868,7,9,10,17,49,63,-14,37
St Mirren,9868,8,9,10,17,41,56,-15,37
Raith,9868,9,9,10,17,31,51,-20,37
Dunfermline,9868,10,7,15,14,41,50,-9,36
Hibernian,9869,1,20,10,6,55,25,30,70
Dundee Utd,9869,2,16,11,9,54,40,14,59
Morton,9869,3,15,12,9,52,40,12,57
Falkirk,9869,4,14,13,9,56,41,15,55
Queen of S't,9869,5,13,10,13,52,48,4,49
Raith,9869,6,11,12,13,39,48,-9,45
Dunfermline,9869,7,10,13,13,51,54,-3,43
Dumbarton,9869,8,9,12,15,50,62,-12,39
Ayr,9869,9,7,12,17,32,62,-30,33
St Mirren,9869,10,7,11,18,37,58,-21,32
Hibernian,9870,1,20,12,4,58,23,35,72
Falkirk,9870,2,17,11,8,63,39,24,62
Morton,9870,3,16,11,9,46,35,11,59
Dundee Utd,9870,4,14,12,10,44,36,8,54
Queen of S't,9870,5,12,8,16,41,50,-9,44
Raith,9870,6,11,9,16,33,50,-17,42
Dunfermline,9870,7,10,11,15,43,49,-6,41
Dumbarton,9870,8,10,11,15,52,60,-8,41
St Mirren,9870,9,8,12,16,43,55,-12,36
Ayr,9870,10,7,13,16,29,55,-26,34
Morton,9871,1,19,11,6,52,35,17,68
Hibernian,9871,2,16,14,6,51,29,22,62
Falkirk,9871,3,16,12,8,56,37,19,60
Dundee Utd,9871,4,15,9,12,48,41,7,54
Queen of S't,9871,5,11,11,14,44,50,-6,44
Dunfermline,9871,6,10,13,13,49,48,1,43
Dumbarton,9871,7,10,13,13,49,55,-6,43
Ayr,9871,8,8,13,15,33,52,-19,37
St Mirren,9871,9,8,11,17,36,53,-17,35
Raith,9871,10,8,11,17,31,49,-18,35
Hibernian,9872,1,19,13,4,59,24,35,70
Dundee Utd,9872,2,17,9,10,52,43,9,60
Falkirk,9872,3,16,10,10,54,43,11,58
Morton,9872,4,15,11,10,49,39,10,56
Queen of S't,9872,5,13,8,15,47,51,-4,47
Dunfermline,9872,6,11,12,13,45,46,-1,45
Dumbarton,9872,7,9,12,15,46,56,-10,39
Ayr,9872,8,9,12,15,33,50,-17,39
Raith,9872,9,9,11,16,32,48,-16,38
St Mirren,9872,10,8,10,18,42,59,-17,34
Hibernian,9873,1,20,13,3,59,23,36,73
Falkirk,9873,2,19,9,8,64,40,24,66
Morton,9873,3,18,11,7,53,36,17,65
Dundee Utd,9873,4,15,10,11,54,47,7,55
Queen of S't,9873,5,12,9,15,45,52,-7,45
Raith,9873,6,11,10,15,38,48,-10,43
Dumbarton,9873,7,8,12,16,46,57,-11,36
Ayr,9873,8,8,12,16,33,56,-23,36
Dunfermline,9873,9,7,14,15,42,52,-10,35
St Mirren,9873,10,6,12,18,34,57,-23,30
Hibernian,9874,1,19,11,6,58,26,32,68
Morton,9874,2,18,12,6,52,35,17,66
Falkirk,9874,3,15,11,10,59,45,14,56
Dundee Utd,9874,4,14,12,10,48,42,6,54
Queen of S't,9874,5,11,11,14,49,54,-5,44
Raith,9874,6,11,9,16,37,48,-11,42
Dunfermline,9874,7,9,14,13,45,49,-4,41
Dumbarton,9874,8,10,11,15,48,59,-11,41
St Mirren,9874,9,10,9,17,44,56,-12,39
Ayr,9874,10,7,12,17,32,58,-26,33
Hibernian,9875,1,17,15,4,56,31,25,66
Dundee Utd,9875,2,18,8,10,57,41,16,62
Morton,9875,3,16,11,9,53,39,14,59
Falkirk,9875,4,15,10,11,59,43,16,55
Queen of S't,9875,5,13,9,14,48,52,-4,48
Dunfermline,9875,6,10,13,13,46,49,-3,43
Ayr,9875,7,10,10,16,36,56,-20,40
Raith,9875,8,10,9,17,36,53,-17,39
St Mirren,9875,9,9,11,16,40,53,-13,38
Dumbarton,9875,10,9,10,17,45,59,-14,37
Hibernian,9876,1,21,11,4,59,23,36,74
Morton,9876,2,19,10,7,53,36,17,67
Falkirk,9876,3,16,12,8,56,37,19,60
Dundee Utd,9876,4,16,10,10,53,41,12,58
Dumbarton,9876,5,10,12,14,50,61,-11,42
Queen of S't,9876,6,11,8,17,47,55,-8,41
Dunfermline,9876,7,9,13,14,48,53,-5,40
Raith,9876,8,9,9,18,34,51,-17,36
Ayr,9876,9,8,12,16,32,53,-21,36
St Mirren,9876,10,7,11,18,35,57,-22,32
Hibernian,9877,1,19,14,3,55,24,31,71
Morton,9877,2,18,10,8,52,36,16,64
Falkirk,9877,3,17,10,9,56,39,17,61
Dundee Utd,9877,4,14,12,10,50,42,8,54
Dumbarton,9877,5,11,10,15,50,62,-12,43
Dunfermline,9877,6,9,13,14,47,52,-5,40
Queen of S't,9877,7,10,10,16,40,49,-9,40
Ayr,9877,8,9,13,14,34,51,-17,40
Raith,9877,9,10,9,17,35,48,-13,39
St Mirren,9877,10,7,11,18,40,56,-16,32
Hibernian,9878,1,19,13,4,63,27,36,70
Falkirk,9878,2,19,10,7,64,36,28,67
Dundee Utd,9878,3,18,10,8,54,37,17,64
Morton,9878,4,17,12,7,51,37,14,63
Queen of S't,9878,5,10,9,17,47,61,-14,39
Raith,9878,6,9,11,16,35,50,-15,38
Dunfermline,9878,7,8,13,15,44,56,-12,37
Dumbarton,9878,8,8,12,16,45,59,-14,36
St Mirren,9878,9,8,12,16,40,54,-14,36
Ayr,9878,10,7,12,17,34,60,-26,33
Hibernian,9879,1,21,10,5,64,26,38,73
Morton,9879,2,16,12,8,48,36,12,60
Dundee Utd,9879,3,16,11,9,48,34,14,59
Falkirk,9879,4,14,11,11,54,42,12,53
Dunfermline,9879,5,11,13,12,41,42,-1,46
Raith,9879,6,11,9,16,35,47,-12,42
Dumbarton,9879,7,9,12,15,49,62,-13,39
Queen of S't,9879,8,10,9,17,40,55,-15,39
Ayr,9879,9,9,12,15,40,57,-17,39
St Mirren,9879,10,9,9,18,40,58,-18,36
Hibernian,9880,1,19,11,6,59,29,30,68
Morton,9880,2,18,11,7,59,36,23,65
Falkirk,9880,3,16,11,9,59,44,15,59
Dundee Utd,9880,4,16,10,10,48,39,9,58
Raith,9880,5,12,10,14,38,46,-8,46
Queen of S't,9880,6,11,9,16,43,52,-9,42
Dumbarton,9880,7,10,11,15,51,59,-8,41
Dunfermline,9880,8,8,14,14,47,54,-7,38
Ayr,9880,9,8,11,17,33,61,-28,35
St Mirren,9880,10,8,10,18,42,59,-17,34
Hibernian,9881,1,22,10,4,63,26,37,76
Morton,9881,2,17,10,9,47,39,8,61
Dundee Utd,9881,3,17,9,10,61,36,25,60
Falkirk,9881,4,15,9,12,54,47,7,54
Queen of S't,9881,5,13,9,14,48,48,0,48
Raith,9881,6,11,10,15,39,45,-6,43
Dunfermline,9881,7,10,12,14,43,49,-6,42
Dumbarton,9881,8,9,11,16,45,62,-17,38
St Mirren,9881,9,9,9,18,44,58,-14,36
Ayr,9881,10,6,13,17,32,66,-34,31
Hibernian,9882,1,22,10,4,57,21,36,76
Dundee Utd,9882,2,18,9,9,55,41,14,63
Morton,9882,3,17,11,8,51,38,13,62
Falkirk,9882,4,15,10,11,55,42,13,55
Dunfermline,9882,5,10,12,14,48,56,-8,42
Queen of S't,9882,6,10,11,15,48,53,-5,41
Dumbarton,9882,7,9,12,15,48,57,-9,39
St Mirren,9882,8,9,10,17,41,54,-13,37
Ayr,9882,9,8,12,16,32,52,-20,36
Raith,9882,10,9,9,18,35,56,-21,36
Hibernian,9883,1,18,12,6,52,26,26,66
Dundee Utd,9883,2,18,10,8,59,38,21,64
Morton,9883,3,16,12,8,46,39,7,60
Falkirk,9883,4,15,10,11,56,39,17,55
Dunfermline,9883,5,10,13,13,47,48,-1,43
Queen of S't,9883,6,10,12,14,46,52,-6,42
Dumbarton,9883,7,10,12,14,46,55,-9,42
St Mirren,9883,8,8,12,16,39,56,-17,36
Ayr,9883,9,7,15,14,32,51,-19,36
Raith,9883,9,8,12,16,32,51,-19,36
Hibernian,9884,1,19,12,5,51,23,28,69
Morton,9884,2,17,12,7,51,33,18,63
Dundee Utd,9884,3,18,8,10,53,39,14,62
Falkirk,9884,4,16,10,10,55,42,13,58
Dumbarton,9884,5,12,10,14,53,53,0,46
Queen of S't,9884,6,11,9,16,44,56,-12,42
St Mirren,9884,7,10,10,16,40,52,-12,40
Dunfermline,9884,8,9,12,15,42,51,-9,39
Raith,9884,9,10,8,18,35,49,-14,38
Ayr,9884,10,7,11,18,31,57,-26,32
Hibernian,9885,1,19,13,4,55,23,32,70
Falkirk,9885,2,16,12,8,59,40,19,60
Dundee Utd,9885,3,15,10,11,48,39,9,55
Morton,9885,4,14,12,10,43,42,1,54
Raith,9885,5,12,11,13,40,46,-6,47
Queen of S't,9885,6,11,10,15,43,51,-8,43
Dunfermline,9885,7,9,15,12,46,45,1,42
Dumbarton,9885,8,9,13,14,49,60,-11,40
St Mirren,9885,9,9,10,17,43,56,-13,37
Ayr,9885,10,8,10,18,33,57,-24,34
Hibernian,9886,1,21,11,4,57,24,33,74
Morton,9886,2,17,12,7,51,36,15,63
Falkirk,9886,3,17,9,10,60,42,18,60
Dundee Utd,9886,4,15,9,12,56,47,9,54
Dumbarton,9886,5,11,11,14,51,57,-6,44
Dunfermline,9886,6,11,11,14,47,53,-6,44
Queen of S't,9886,7,11,10,15,49,54,-5,43
Raith,9886,8,9,10,17,37,50,-13,37
St Mirren,9886,9,8,10,18,39,60,-21,34
Ayr,9886,10,7,13,16,33,57,-24,34
Hibernian,9887,1,18,13,5,51,26,25,67
Morton,9887,2,17,12,7,49,32,17,63
Dundee Utd,9887,3,17,9,10,52,38,14,60
Falkirk,9887,4,16,11,9,59,40,19,59
Queen of S't,9887,5,13,8,15,47,53,-6,47
Raith,9887,6,10,10,16,34,47,-13,40
Dunfermline,9887,7,9,12,15,41,47,-6,39
Dumbarton,9887,8,8,14,14,49,61,-12,38
St Mirren,9887,9,7,13,16,37,53,-16,34
Ayr,9887,10,6,16,14,33,55,-22,34
Hibernian,9888,1,20,11,5,58,25,33,71
Dundee Utd,9888,2,17,10,9,51,39,12,61
Morton,9888,3,15,11,10,48,40,8,56
Falkirk,9888,4,15,10,11,61,47,14,55
Queen of S't,9888,5,14,9,13,52,50,2,51
Dunfermline,9888,6,12,13,11,51,46,5,49
Raith,9888,7,10,9,17,35,55,-20,39
Dumbarton,9888,8,8,12,16,44,59,-15,36
St Mirren,9888,9,9,9,18,41,59,-18,36
Ayr,9888,10,8,10,18,35,56,-21,34
Hibernian,9889,1,18,13,5,56,25,31,67
Morton,9889,2,17,12,7,52,36,16,63
Falkirk,9889,3,15,10,11,56,47,9,55
Dundee Utd,9889,4,15,9,12,53,43,10,54
Queen of S't,9889,5,13,9,14,47,48,-1,48
Ayr,9889,6,11,11,14,40,57,-17,44
Dumbarton,9889,7,10,11,15,46,57,-11,41
Raith,9889,8,10,10,16,34,46,-12,40
Dunfermline,9889,9,8,15,13,42,47,-5,39
St Mirren,9889,10,7,12,17,36,56,-20,33
Hibernian,9890,1,19,13,4,55,24,31,70
Falkirk,9890,2,17,11,8,62,40,22,62
Dundee Utd,9890,3,16,11,9,52,40,12,59
Morton,9890,4,15,12,9,46,41,5,57
Queen of S't,9890,5,12,9,15,51,49,2,45
Dunfermline,9890,6,10,13,13,47,45,2,43
Raith,9890,7,10,11,15,38,48,-10,41
Dumbarton,9890,8,9,11,16,46,65,-19,38
Ayr,9890,9,8,11,17,32,60,-28,35
St Mirren,9890,10,8,10,18,44,61,-17,34
Hibernian,9891,1,19,12,5,59,28,31,69
Morton,9891,2,19,12,5,53,28,25,69
Dundee Utd,9891,3,17,10,9,53,38,15,61
Falkirk,9891,4,16,11,9,57,41,16,59
Queen of S't,9891,5,11,9,16,48,57,-9,42
Dumbarton,9891,6,9,11,16,45,57,-12,38
Raith,9891,7,10,8,18,35,53,-18,38
Ayr,9891,8,9,11,16,35,54,-19,38
Dunfermline,9891,9,8,12,16,38,52,-14,36
St Mirren,9891,10,8,12,16,40,55,-15,36
Hibernian,9892,1,17,13,6,48,26,22,64
Morton,9892,2,17,10,9,51,33,18,61
Falkirk,9892,3,14,13,9,53,37,16,55
Dundee Utd,9892,4,15,8,13,44,40,4,53
Queen of S't,9892,5,13,9,14,48,47,1,48
Dunfermline,9892,6,11,13,12,44,46,-2,46
Ayr,9892,7,12,10,14,38,50,-12,46
Raith,9892,8,11,10,15,31,45,-14,43
Dumbarton,9892,9,8,11,17,44,60,-16,35
St Mirren,9892,10,8,11,17,38,55,-17,35
Morton,9893,1,18,12,6,54,35,19,66
Hibernian,9893,2,17,14,5,54,25,29,65
Dundee Utd,9893,3,17,9,10,53,41,12,60
Falkirk,9893,4,16,11,9,62,39,23,59
Raith,9893,5,12,9,15,40,49,-9,45
Dunfermline,9893,6,10,13,13,46,46,0,43
St Mirren,9893,7,10,9,17,42,57,-15,39
Queen of S't,9893,8,9,10,17,41,60,-19,37
Ayr,9893,9,8,13,15,33,53,-20,37
Dumbarton,9893,10,8,10,18,47,67,-20,34
Morton,9894,1,21,9,6,54,32,22,72
Hibernian,9894,2,19,10,7,60,30,30,67
Dundee Utd,9894,3,16,10,10,53,43,10,58
Falkirk,9894,4,14,10,12,54,44,10,52
Dunfermline,9894,5,12,12,12,49,46,3,48
Queen of S't,9894,6,11,10,15,44,53,-9,43
St Mirren,9894,7,10,9,17,40,56,-16,39
Dumbarton,9894,8,9,11,16,46,56,-10,38
Raith,9894,9,8,12,16,30,49,-19,36
Ayr,9894,10,8,11,17,34,55,-21,35
Hibernian,9895,1,18,12,6,51,28,23,66
Morton,9895,2,17,12,7,55,38,17,63
Dundee Utd,9895,3,18,9,9,54,38,16,63
Falkirk,9895,4,17,9,10,61,39,22,60
Queen of S't,9895,5,12,9,15,46,52,-6,45
Dunfermline,9895,6,10,14,12,48,49,-1,44
Raith,9895,7,11,9,16,38,47,-9,42
Dumbarton,9895,8,10,10,16,47,57,-10,40
St Mirren,9895,9,8,11,17,39,58,-19,35
Ayr,9895,10,6,11,19,34,67,-33,29
Hibernian,9896,1,23,10,3,65,20,45,79
Falkirk,9896,2,16,10,10,60,40,20,58
Morton,9896,3,15,12,9,47,36,11,57
Dundee Utd,9896,4,15,10,11,49,45,4,55
Queen of S't,9896,5,10,13,13,44,52,-8,43
Dunfermline,9896,6,10,12,14,47,52,-5,42
Dumbarton,9896,7,9,13,14,47,55,-8,40
St Mirren,9896,8,10,10,16,40,54,-14,40
Raith,9896,9,10,9,17,34,54,-20,39
Ayr,9896,10,7,11,18,35,60,-25,32
Hibernian,9897,1,20,13,3,58,23,35,73
Morton,9897,2,18,10,8,53,34,19,64
Falkirk,9897,3,15,10,11,59,45,14,55
Dundee Utd,9897,4,15,10,11,51,43,8,55
Queen of S't,9897,5,12,11,13,47,50,-3,47
Dunfermline,9897,6,10,13,13,50,47,3,43
St Mirren,9897,7,10,9,17,41,57,-16,39
Ayr,9897,8,8,14,14,33,54,-21,38
Raith,9897,9,9,9,18,30,55,-25,36
Dumbarton,9897,10,8,11,17,43,57,-14,35
Hibernian,9898,1,20,12,4,59,26,33,72
Morton,9898,2,18,12,6,55,35,20,66
Dundee Utd,9898,3,17,9,10,48,35,13,60
Falkirk,9898,4,15,12,9,56,39,17,57
Queen of S't,9898,5,12,9,15,45,54,-9,45
Ayr,9898,6,10,12,14,35,50,-15,42
Dunfermline,9898,7,9,12,15,44,55,-11,39
St Mirren,9898,8,8,11,17,40,56,-16,35
Raith,9898,9,8,11,17,33,50,-17,35
Dumbarton,9898,10,7,12,17,46,61,-15,33
Hibernian,9899,1,19,11,6,55,28,27,68
Falkirk,9899,2,18,11,7,62,36,26,65
Morton,9899,3,17,12,7,49,33,16,63
Dundee Utd,9899,4,14,11,11,46,43,3,53
Dumbarton,9899,5,11,13,12,52,52,0,46
Raith,9899,6,11,9,16,34,48,-14,42
Queen of S't,9899,7,10,9,17,43,52,-9,39
Dunfermline,9899,8,9,12,15,45,55,-10,39
Ayr,9899,9,7,14,15,33,56,-23,35
St Mirren,9899,10,8,10,18,38,54,-16,34
Morton,9900,1,18,12,6,50,34,16,66
Hibernian,9900,2,16,13,7,52,29,23,61
Falkirk,9900,3,16,10,10,56,39,17,58
Dundee Utd,9900,4,15,10,11,48,39,9,55
Queen of S't,9900,5,14,8,14,50,49,1,50
Dunfermline,9900,6,9,16,11,44,46,-2,43
Dumbarton,9900,7,9,13,14,46,56,-10,40
Ayr,9900,8,9,12,15,36,54,-18,39
St Mirren,9900,9,8,11,17,40,58,-18,35
Raith,9900,10,8,11,17,34,52,-18,35
Hibernian,9901,1,17,14,5,55,28,27,65
Falkirk,9901,2,16,11,9,57,39,18,59
Dundee Utd,9901,3,15,11,10,51,39,12,56
Morton,9901,4,15,11,10,48,40,8,56
Dunfermline,9901,5,12,12,12,49,46,3,48
Queen of S't,9901,6,11,9,16,42,50,-8,42
Dumbarton,9901,7,10,11,15,48,62,-14,41
Ayr,9901,8,10,11,15,42,58,-16,41
Raith,9901,9,10,10,16,35,48,-13,40
St Mirren,9901,10,7,14,15,38,55,-17,35
Hibernian,9902,1,19,13,4,56,24,32,70
Dundee Utd,9902,2,16,11,9,57,43,14,59
Morton,9902,3,15,14,7,48,37,11,59
Falkirk,9902,4,15,11,10,55,43,12,56
Raith,9902,5,11,11,14,34,42,-8,44
Queen of S't,9902,6,11,10,15,46,51,-5,43
Dunfermline,9902,7,9,13,14,46,51,-5,40
Dumbarton,9902,8,9,12,15,48,59,-11,39
St Mirren,9902,9,9,10,17,42,58,-16,37
Ayr,9902,10,7,13,16,32,56,-24,34
Hibernian,9903,1,20,13,3,57,23,34,73
Falkirk,9903,2,17,11,8,58,36,22,62
Morton,9903,3,16,9,11,49,43,6,57
Dundee Utd,9903,4,15,11,10,53,41,12,56
Queen of S't,9903,5,11,11,14,45,48,-3,44
Dunfermline,9903,6,10,12,14,46,51,-5,42
Ayr,9903,7,9,12,15,37,59,-22,39
St Mirren,9903,8,9,11,16,44,57,-13,38
Dumbarton,9903,9,9,11,16,52,66,-14,38
Raith,9903,10,8,11,17,33,50,-17,35
Hibernian,9904,1,19,11,6,55,30,25,68
Falkirk,9904,2,16,11,9,57,40,17,59
Morton,9904,3,15,13,8,44,34,10,58
Dundee Utd,9904,4,16,9,11,49,40,9,57
Raith,9904,5,12,10,14,39,44,-5,46
Dunfermline,9904,6,11,12,13,46,45,1,45
Queen of S't,9904,7,12,8,16,51,55,-4,44
Dumbarton,9904,8,10,11,15,49,58,-9,41
Ayr,9904,9,9,10,17,33,54,-21,37
St Mirren,9904,10,7,11,18,32,55,-23,32
Hibernian,9905,1,19,13,4,62,25,37,70
Morton,9905,2,18,10,8,53,35,18,64
Dundee Utd,9905,3,17,9,10,55,43,12,60
Falkirk,9905,4,15,10,11,55,44,11,55
Queen of S't,9905,5,13,9,14,47,47,0,48
Dunfermline,9905,6,10,12,14,44,48,-4,42
Raith,9905,7,11,9,16,35,51,-16,42
Dumbarton,9905,8,10,11,15,50,59,-9,41
Ayr,9905,9,7,14,15,34,57,-23,35
St Mirren,9905,10,6,11,19,39,65,-26,29
Hibernian,9906,1,18,12,6,53,27,26,66
Morton,9906,2,17,11,8,49,35,14,62
Falkirk,9906,3,14,12,10,58,45,13,54
Dundee Utd,9906,4,14,8,14,48,45,3,50
Dumbarton,9906,5,12,11,13,56,56,0,47
Queen of S't,9906,6,12,9,15,47,54,-7,45
Raith,9906,7,11,10,15,37,46,-9,43
Dunfermline,9906,8,9,15,12,43,45,-2,42
St Mirren,9906,9,9,11,16,42,55,-13,38
Ayr,9906,10,9,11,16,34,59,-25,38
Hibernian,9907,1,16,15,5,48,24,24,63
Morton,9907,2,17,12,7,49,33,16,63
Falkirk,9907,3,16,11,9,58,42,16,59
Dundee Utd,9907,4,15,9,12,50,42,8,54
Dunfermline,9907,5,11,14,11,44,42,2,47
Raith,9907,6,12,10,14,36,45,-9,46
Queen of S't,9907,7,11,11,14,46,50,-4,44
St Mirren,9907,8,8,13,15,43,56,-13,37
Dumbarton,9907,9,8,10,18,49,66,-17,34
Ayr,9907,10,7,13,16,35,58,-23,34
Hibernian,9908,1,17,13,6,52,28,24,64
Falkirk,9908,2,17,12,7,61,35,26,63
Morton,9908,3,17,11,8,52,40,12,62
Dunfermline,9908,4,12,13,11,53,46,7,49
Dundee Utd,9908,5,13,9,14,42,51,-9,48
Raith,9908,6,12,8,16,35,46,-11,44
Queen of S't,9908,7,11,8,17,43,50,-7,41
Ayr,9908,8,10,11,15,39,53,-14,41
Dumbarton,9908,9,8,13,15,49,61,-12,37
St Mirren,9908,10,9,10,17,42,58,-16,37
Hibernian,9909,1,19,13,4,54,24,30,70
Dundee Utd,9909,2,18,9,9,54,40,14,63
Falkirk,9909,3,16,9,11,57,42,15,57
Morton,9909,4,14,14,8,50,43,7,56
Dunfermline,9909,5,12,11,13,52,48,4,47
Queen of S't,9909,6,12,11,13,45,47,-2,47
St Mirren,9909,7,10,10,16,40,54,-14,40
Raith,9909,8,9,12,15,37,51,-14,39
Dumbarton,9909,9,8,12,16,44,57,-13,36
Ayr,9909,10,6,11,19,34,61,-27,29
Hibernian,9910,1,22,11,3,58,22,36,77
Falkirk,9910,2,16,12,8,59,39,20,60
Dundee Utd,9910,3,15,12,9,45,36,9,57
Morton,9910,4,15,11,10,51,40,11,56
Queen of S't,9910,5,13,8,15,43,49,-6,47
Dunfermline,9910,6,10,11,15,46,50,-4,41
Ayr,9910,7,9,13,14,30,48,-18,40
St Mirren,9910,8,9,11,16,38,53,-15,38
Raith,9910,9,9,10,17,36,53,-17,37
Dumbarton,9910,10,7,11,18,44,60,-16,32
Hibernian,9911,1,19,13,4,57,27,30,70
Morton,9911,2,16,13,7,53,36,17,61
Falkirk,9911,3,16,12,8,57,40,17,60
Dundee Utd,9911,4,16,10,10,45,36,9,58
Dunfermline,9911,5,9,15,12,45,49,-4,42
Dumbarton,9911,6,10,12,14,50,56,-6,42
Raith,9911,7,10,11,15,36,47,-11,41
Queen of S't,9911,8,10,9,17,39,51,-12,39
Ayr,9911,9,8,12,16,33,54,-21,36
St Mirren,9911,10,7,11,18,38,57,-19,32
Hibernian,9912,1,21,12,3,57,23,34,75
Morton,9912,2,17,10,9,49,38,11,61
Falkirk,9912,3,16,11,9,55,39,16,59
Dundee Utd,9912,4,15,10,11,52,44,8,55
Queen of S't,9912,5,12,10,14,50,50,0,46
Dumbarton,9912,6,11,12,13,53,55,-2,45
Dunfermline,9912,7,10,11,15,45,49,-4,41
Ayr,9912,8,8,13,15,35,54,-19,37
St Mirren,9912,9,8,10,18,39,57,-18,34
Raith,9912,10,8,9,19,29,55,-26,33
Hibernian,9913,1,17,13,6,51,26,25,64
Morton,9913,2,17,13,6,61,41,20,64
Dundee Utd,9913,3,16,11,9,51,36,15,59
Falkirk,9913,4,15,9,12,58,42,16,54
Queen of S't,9913,5,13,10,13,43,48,-5,49
Dunfermline,9913,6,10,13,13,45,47,-2,43
Dumbarton,9913,7,9,12,15,52,64,-12,39
Raith,9913,8,9,12,15,31,48,-17,39
Ayr,9913,9,8,13,15,39,57,-18,37
St Mirren,9913,10,7,12,17,38,60,-22,33
Morton,9914,1,18,11,7,53,36,17,65
Hibernian,9914,2,17,13,6,56,33,23,64
Falkirk,9914,3,18,10,8,61,41,20,64
Dundee Utd,9914,4,16,10,10,54,43,11,58
Dumbarton,9914,5,12,10,14,52,56,-4,46
Queen of S't,9914,6,12,8,16,47,53,-6,44
Dunfermline,9914,7,10,12,14,47,51,-4,42
Raith,9914,8,9,10,17,36,51,-15,37
Ayr,9914,9,7,14,15,33,54,-21,35
St Mirren,9914,10,7,10,19,37,58,-21,31
Hibernian,9915,1,19,11,6,55,29,26,68
Morton,9915,2,17,13,6,53,35,18,64
Falkirk,9915,3,14,12,10,59,44,15,54
Dundee Utd,9915,4,14,12,10,48,42,6,54
Queen of S't,9915,5,12,10,14,49,50,-1,46
Raith,9915,6,10,11,15,37,52,-15,41
St Mirren,9915,7,10,11,15,42,58,-16,41
Dumbarton,9915,8,9,13,14,53,56,-3,40
Dunfermline,9915,9,8,14,14,49,56,-7,38
Ayr,9915,10,6,15,15,32,55,-23,33
Hibernian,9916,1,18,14,4,49,22,27,68
Falkirk,9916,2,18,10,8,62,42,20,64
Dundee Utd,9916,3,18,9,9,57,35,22,63
Morton,9916,4,16,12,8,52,36,16,60
Dunfermline,9916,5,10,14,12,46,46,0,44
Raith,9916,6,11,11,14,39,49,-10,44
Queen of S't,9916,7,11,10,15,43,50,-7,43
Dumbarton,9916,8,7,12,17,47,66,-19,33
St Mirren,9916,9,7,11,18,38,58,-20,32
Ayr,9916,10,6,13,17,28,57,-29,31
Hibernian,9917,1,20,11,5,63,31,32,71
Morton,9917,2,17,11,8,48,33,15,62
Falkirk,9917,3,15,11,10,60,45,15,56
Dundee Utd,9917,4,14,10,12,47,42,5,52
Dunfermline,9917,5,13,12,11,50,45,5,51
Queen of S't,9917,6,13,10,13,52,53,-1,49
Raith,9917,7,9,12,15,34,48,-14,39
Dumbarton,9917,8,8,12,16,46,57,-11,36
St Mirren,9917,9,8,11,17,40,60,-20,35
Ayr,9917,10,7,12,17,33,59,-26,33
Hibernian,9918,1,19,12,5,52,24,28,69
Dundee Utd,9918,2,15,11,10,49,42,7,56
Morton,9918,3,15,11,10,46,41,5,56
Falkirk,9918,4,15,10,11,56,45,11,55
Dunfermline,9918,5,11,14,11,49,43,6,47
Queen of S't,9918,6,12,10,14,45,46,-1,46
St Mirren,9918,7,10,11,15,43,53,-10,41
Ayr,9918,8,9,12,15,35,54,-19,39
Dumbarton,9918,9,9,11,16,50,61,-11,38
Raith,9918,10,10,8,18,36,52,-16,38
Hibernian,9919,1,20,11,5,59,27,32,71
Falkirk,9919,2,16,10,10,59,40,19,58
Dundee Utd,9919,3,15,13,8,46,34,12,58
Morton,9919,4,15,12,9,44,38,6,57
Queen of S't,9919,5,13,10,13,49,46,3,49
Raith,9919,6,11,11,14,37,47,-10,44
Dunfermline,9919,7,9,13,14,42,53,-11,40
St Mirren,9919,8,9,11,16,40,53,-13,38
Dumbarton,9919,9,8,10,18,45,61,-16,34
Ayr,9919,10,7,13,16,29,51,-22,34
Hibernian,9920,1,19,12,5,53,25,28,69
Morton,9920,2,17,13,6,57,41,16,64
Falkirk,9920,3,17,9,10,64,43,21,60
Dundee Utd,9920,4,15,11,10,51,39,12,56
Dunfermline,9920,5,8,17,11,47,48,-1,41
Queen of S't,9920,6,10,11,15,43,52,-9,41
Raith,9920,7,10,11,15,33,47,-14,41
Dumbarton,9920,8,9,12,15,46,58,-12,39
Ayr,9920,9,7,14,15,32,57,-25,35
St Mirren,9920,10,8,10,18,39,55,-16,34
Hibernian,9921,1,20,11,5,58,28,30,71
Dundee Utd,9921,2,18,9,9,57,37,20,63
Morton,9921,3,17,11,8,56,44,12,62
Falkirk,9921,4,17,10,9,54,40,14,61
Queen of S't,9921,5,13,9,14,47,48,-1,48
Dumbarton,9921,6,10,14,12,51,55,-4,44
Raith,9921,7,10,10,16,33,47,-14,40
Dunfermline,9921,8,8,12,16,41,51,-10,36
Ayr,9921,9,8,10,18,32,54,-22,34
St Mirren,9921,10,6,10,20,36,61,-25,28
Hibernian,9922,1,20,10,6,60,26,34,70
Morton,9922,2,20,9,7,57,37,20,69
Falkirk,9922,3,16,11,9,59,40,19,59
Dundee Utd,9922,4,14,9,13,46,42,4,51
Queen of S't,9922,5,12,10,14,46,51,-5,46
Dunfermline,9922,6,11,12,13,48,48,0,45
Ayr,9922,7,10,11,15,39,56,-17,41
Raith,9922,8,9,11,16,31,45,-14,38
Dumbarton,9922,9,8,11,17,43,61,-18,35
St Mirren,9922,10,7,12,17,36,59,-23,33
Hibernian,9923,1,19,12,5,54,28,26,69
Falkirk,9923,2,17,12,7,59,36,23,63
Dundee Utd,9923,3,18,9,9,56,40,16,63
Morton,9923,4,13,13,10,45,41,4,52
Dunfermline,9923,5,10,13,13,44,46,-2,43
Raith,9923,6,11,10,15,42,50,-8,43
Dumbarton,9923,7,10,11,15,48,55,-7,41
St Mirren,9923,8,9,11,16,41,56,-15,38
Queen of S't,9923,9,9,10,17,41,54,-13,37
Ayr,9923,10,7,13,16,32,56,-24,34
Hibernian,9924,1,20,11,5,59,22,37,71
Falkirk,9924,2,18,10,8,62,36,26,64
Morton,9924,3,16,13,7,53,39,14,61
Dundee Utd,9924,4,17,9,10,48,36,12,60
Queen of S't,9924,5,12,8,16,49,60,-11,44
St Mirren,9924,6,10,11,15,42,55,-13,41
Raith,9924,7,10,10,16,36,52,-16,40
Ayr,9924,8,8,13,15,36,55,-19,37
Dumbarton,9924,9,8,11,17,49,65,-16,35
Dunfermline,9924,10,7,12,17,42,56,-14,33
Hibernian,9925,1,20,11,5,59,25,34,71
Dundee Utd,9925,2,18,10,8,54,37,17,64
Morton,9925,3,16,12,8,47,38,9,60
Falkirk,9925,4,15,10,11,53,43,10,55
Queen of S't,9925,5,12,10,14,46,47,-1,46
Dunfermline,9925,6,10,12,14,44,49,-5,42
Dumbarton,9925,7,10,12,14,52,60,-8,42
Raith,9925,8,10,9,17,38,54,-16,39
Ayr,9925,9,8,11,17,34,57,-23,35
St Mirren,9925,10,7,11,18,40,57,-17,32
Hibernian,9926,1,19,11,6,59,27,32,68
Falkirk,9926,2,17,10,9,58,38,20,61
Morton,9926,3,16,12,8,47,36,11,60
Dundee Utd,9926,4,15,11,10,50,36,14,56
Queen of S't,9926,5,14,8,14,46,48,-2,50
Dunfermline,9926,6,10,13,13,42,48,-6,43
Dumbarton,9926,7,9,12,15,44,57,-13,39
Raith,9926,8,10,8,18,36,52,-16,38
St Mirren,9926,9,9,10,17,38,54,-16,37
Ayr,9926,10,7,13,16,31,55,-24,34
Hibernian,9927,1,21,11,4,57,22,35,74
Falkirk,9927,2,16,12,8,59,41,18,60
Dundee Utd,9927,3,16,11,9,54,37,17,59
Morton,9927,4,16,10,10,49,36,13,58
Dunfermline,9927,5,10,12,14,41,48,-7,42
St Mirren,9927,6,10,10,16,45,58,-13,40
Dumbarton,9927,7,9,12,15,50,58,-8,39
Queen of S't,9927,8,9,12,15,42,51,-9,39
Raith,9927,9,10,9,17,33,49,-16,39
Ayr,9927,10,8,11,17,30,60,-30,35
Hibernian,9928,1,17,13,6,54,26,28,64
Dundee Utd,9928,2,18,9,9,50,37,13,63
Morton,9928,3,17,11,8,51,37,14,62
Falkirk,9928,4,16,11,9,59,42,17,59
Dunfermline,9928,5,10,15,11,45,44,1,45
St Mirren,9928,6,10,10,16,42,55,-13,40
Queen of S't,9928,7,9,11,16,41,52,-11,38
Raith,9928,8,9,11,16,37,53,-16,38
Ayr,9928,9,9,11,16,36,57,-21,38
Dumbarton,9928,10,8,12,16,46,58,-12,36
Hibernian,9929,1,19,11,6,52,26,26,68
Falkirk,9929,2,18,11,7,63,41,22,65
Morton,9929,3,17,10,9,48,33,15,61
Dundee Utd,9929,4,17,9,10,58,42,16,60
Raith,9929,5,11,11,14,39,47,-8,44
Dunfermline,9929,6,10,13,13,48,51,-3,43
Dumbarton,9929,7,9,12,15,47,60,-13,39
Queen of S't,9929,8,9,11,16,43,53,-10,38
Ayr,9929,9,8,13,15,33,54,-21,37
St Mirren,9929,10,7,9,20,38,62,-24,30
Hibernian,9930,1,20,13,3,56,23,33,73
Morton,9930,2,16,14,6,50,35,15,62
Falkirk,9930,3,17,9,10,66,41,25,60
Dundee Utd,9930,4,17,8,11,50,37,13,59
Dumbarton,9930,5,11,12,13,55,58,-3,45
Queen of S't,9930,6,11,9,16,41,58,-17,42
Dunfermline,9930,7,9,14,13,45,47,-2,41
Raith,9930,8,10,10,16,38,50,-12,40
St Mirren,9930,9,8,9,19,39,66,-27,33
Ayr,9930,10,7,10,19,32,57,-25,31
Hibernian,9931,1,19,12,5,57,27,30,69
Morton,9931,2,19,11,6,54,31,23,68
Falkirk,9931,3,18,9,9,58,41,17,63
Dundee Utd,9931,4,18,8,10,54,36,18,62
Dunfermline,9931,5,9,14,13,45,53,-8,41
Raith,9931,6,10,10,16,35,48,-13,40
Queen of S't,9931,7,10,9,17,39,52,-13,39
Ayr,9931,8,9,11,16,34,53,-19,38
Dumbarton,9931,9,8,10,18,43,59,-16,34
St Mirren,9931,10,8,10,18,37,56,-19,34
Morton,9932,1,19,10,7,57,35,22,67
Falkirk,9932,2,17,10,9,64,42,22,61
Hibernian,9932,3,17,10,9,54,35,19,61
Dundee Utd,9932,4,16,11,9,54,40,14,59
Queen of S't,9932,5,12,11,13,49,53,-4,47
Dunfermline,9932,6,10,12,14,50,54,-4,42
Raith,9932,7,11,9,16,37,50,-13,42
Dumbarton,9932,8,8,12,16,46,62,-16,36
Ayr,9932,9,8,12,16,38,60,-22,36
St Mirren,9932,10,8,11,17,40,58,-18,35
Hibernian,9933,1,21,12,3,55,22,33,75
Morton,9933,2,17,12,7,49,34,15,63
Falkirk,9933,3,16,11,9,59,41,18,59
Dundee Utd,9933,4,15,9,12,49,42,7,54
Dunfermline,9933,5,10,14,12,46,46,0,44
Raith,9933,6,10,11,15,34,48,-14,41
Queen of S't,9933,7,10,10,16,41,49,-8,40
St Mirren,9933,8,10,9,17,40,52,-12,39
Ayr,9933,9,8,11,17,30,55,-25,35
Dumbarton,9933,10,7,13,16,46,60,-14,34
Hibernian,9934,1,20,11,5,59,29,30,71
Morton,9934,2,17,11,8,48,37,11,62
Dundee Utd,9934,3,16,10,10,48,38,10,58
Falkirk,9934,4,14,10,12,54,42,12,52
Queen of S't,9934,5,12,11,13,44,46,-2,47
Dunfermline,9934,6,10,14,12,45,45,0,44
Raith,9934,7,11,11,14,39,47,-8,44
St Mirren,9934,8,10,9,17,43,57,-14,39
Ayr,9934,9,8,11,17,34,55,-21,35
Dumbarton,9934,10,8,10,18,44,62,-18,34
Hibernian,9935,1,16,15,5,51,27,24,63
Morton,9935,2,15,14,7,48,35,13,59
Falkirk,9935,3,15,11,10,61,44,17,56
Dundee Utd,9935,4,15,11,10,48,40,8,56
Dunfermline,9935,5,11,14,11,48,47,1,47
Queen of S't,9935,6,10,13,13,43,47,-4,43
Raith,9935,7,10,10,16,37,48,-11,40
Dumbarton,9935,8,9,12,15,45,54,-9,39
St Mirren,9935,9,9,12,15,41,57,-16,39
Ayr,9935,10,8,12,16,31,54,-23,36
Hibernian,9936,1,19,13,4,55,26,29,70
Falkirk,9936,2,17,10,9,62,41,21,61
Morton,9936,3,15,10,11,51,41,10,55
Dundee Utd,9936,4,15,10,11,47,41,6,55
Queen of S't,9936,5,12,9,15,44,52,-8,45
Ayr,9936,6,11,12,13,39,52,-13,45
Dunfermline,9936,7,9,14,13,47,50,-3,41
St Mirren,9936,8,9,12,15,42,54,-12,39
Raith,9936,9,9,12,15,36,49,-13,39
Dumbarton,9936,10,8,10,18,50,67,-17,34
Hibernian,9937,1,18,14,4,53,26,27,68
Dundee Utd,9937,2,16,11,9,50,41,9,59
Morton,9937,3,15,11,10,47,37,10,56
Falkirk,9937,4,14,11,11,61,46,15,53
Queen of S't,9937,5,14,8,14,49,48,1,50
Dunfermline,9937,6,11,14,11,47,43,4,47
Raith,9937,7,11,9,16,38,51,-13,42
Dumbarton,9937,8,9,12,15,46,56,-10,39
St Mirren,9937,9,8,11,17,42,61,-19,35
Ayr,9937,10,8,11,17,37,61,-24,35
Hibernian,9938,1,20,10,6,54,28,26,70
Morton,9938,2,16,11,9,50,37,13,59
Falkirk,9938,3,15,11,10,54,40,14,56
Dundee Utd,9938,4,15,11,10,50,38,12,56
Queen of S't,9938,5,12,10,14,49,51,-2,46
Raith,9938,6,11,9,16,37,47,-10,42
Ayr,9938,7,9,14,13,38,55,-17,41
Dumbarton,9938,8,9,12,15,46,57,-11,39
Dunfermline,9938,9,9,12,15,43,55,-12,39
St Mirren,9938,10,8,12,16,41,54,-13,36
Hibernian,9939,1,20,12,4,60,26,34,72
Dundee Utd,9939,2,16,12,8,51,36,15,60
Morton,9939,3,15,13,8,47,36,11,58
Falkirk,9939,4,15,11,10,57,46,11,56
Queen of S't,9939,5,12,10,14,46,49,-3,46
Ayr,9939,6,11,12,13,39,49,-10,45
Dunfermline,9939,7,9,12,15,42,49,-7,39
Raith,9939,8,9,11,16,33,49,-16,38
St Mirren,9939,9,7,13,16,40,59,-19,34
Dumbarton,9939,10,7,12,17,43,59,-16,33
Hibernian,9940,1,19,12,5,58,25,33,69
Morton,9940,2,16,14,6,50,34,16,62
Falkirk,9940,3,15,11,10,56,45,11,56
Dundee Utd,9940,4,14,11,11,49,44,5,53
Dunfermline,9940,5,12,13,11,48,47,1,49
Queen of S't,9940,6,12,10,14,47,50,-3,46
Raith,9940,7,10,11,15,35,48,-13,41
St Mirren,9940,8,9,10,17,44,57,-13,37
Dumbarton,9940,9,8,11,17,45,63,-18,35
Ayr,9940,10,8,11,17,37,56,-19,35
Hibernian,9941,1,19,12,5,58,28,30,69
Morton,9941,2,18,10,8,55,36,19,64
Falkirk,9941,3,17,10,9,60,40,20,61
Dundee Utd,9941,4,16,11,9,55,40,15,59
Queen of S't,9941,5,12,9,15,42,48,-6,45
Dunfermline,9941,6,9,14,13,45,49,-4,41
Raith,9941,7,10,9,17,33,53,-20,39
St Mirren,9941,8,9,11,16,41,57,-16,38
Dumbarton,9941,9,8,12,16,46,59,-13,36
Ayr,9941,10,6,14,16,33,58,-25,32
Hibernian,9942,1,19,12,5,54,24,30,69
Falkirk,9942,2,17,10,9,59,39,20,61
Morton,9942,3,16,10,10,51,41,10,58
Dunfermline,9942,4,15,11,10,57,47,10,56
Dundee Utd,9942,5,15,9,12,47,38,9,54
Dumbarton,9942,6,10,10,16,49,60,-11,40
St Mirren,9942,7,9,11,16,48,58,-10,38
Queen of S't,9942,8,9,11,16,38,49,-11,38
Raith,9942,9,9,10,17,36,55,-19,37
Ayr,9942,10,9,10,17,34,62,-28,37
Hibernian,9943,1,20,12,4,59,25,34,72
Falkirk,9943,2,16,11,9,56,39,17,59
Morton,9943,3,14,15,7,50,40,10,57
Dundee Utd,9943,4,14,8,14,46,45,1,50
Queen of S't,9943,5,13,10,13,48,47,1,49
Dunfermline,9943,6,10,15,11,49,47,2,45
St Mirren,9943,7,10,10,16,42,53,-11,40
Dumbarton,9943,8,9,12,15,46,59,-13,39
Raith,9943,9,9,11,16,32,47,-15,38
Ayr,9943,10,7,12,17,31,57,-26,33
Hibernian,9944,1,20,12,4,61,23,38,72
Morton,9944,2,17,12,7,50,35,15,63
Dundee Utd,9944,3,17,10,9,56,34,22,61
Falkirk,9944,4,15,13,8,56,38,18,58
Ayr,9944,5,10,12,14,33,55,-22,42
Dunfermline,9944,6,9,13,14,46,52,-6,40
Dumbarton,9944,7,9,13,14,45,56,-11,40
Raith,9944,8,9,11,16,37,50,-13,38
Queen of S't,9944,9,9,9,18,41,60,-19,36
St Mirren,9944,10,8,9,19,40,62,-22,33
Hibernian,9945,1,20,12,4,56,27,29,72
Morton,9945,2,18,12,6,52,36,16,66
Dundee Utd,9945,3,18,8,10,55,38,17,62
Falkirk,9945,4,15,12,9,60,41,19,57
Queen of S't,9945,5,12,11,13,45,48,-3,47
Dunfermline,9945,6,9,13,14,50,54,-4,40
Raith,9945,7,10,10,16,38,53,-15,40
St Mirren,9945,8,9,10,17,41,54,-13,37
Ayr,9945,9,7,12,17,31,58,-27,33
Dumbarton,9945,10,7,10,19,45,64,-19,31
Hibernian,9946,1,19,12,5,59,27,32,69
Falkirk,9946,2,17,11,8,58,41,17,62
Morton,9946,3,15,13,8,51,39,12,58
Dundee Utd,9946,4,15,11,10,51,39,12,56
Raith,9946,5,12,9,15,38,47,-9,45
Dunfermline,9946,6,10,14,12,48,45,3,44
Queen of S't,9946,7,11,8,17,41,55,-14,41
Dumbarton,9946,8,9,13,14,46,54,-8,40
Ayr,9946,9,8,12,16,37,59,-22,36
St Mirren,9946,10,7,11,18,35,58,-23,32
Hibernian,9947,1,20,11,5,63,26,37,71
Falkirk,9947,2,18,11,7,70,41,29,65
Morton,9947,3,16,11,9,50,42,8,59
Dundee Utd,9947,4,15,10,11,50,43,7,55
Queen of S't,9947,5,11,9,16,44,59,-15,42
Dunfermline,9947,6,9,14,13,45,49,-4,41
Raith,9947,7,11,8,17,39,55,-16,41
Dumbarton,9947,8,9,11,16,50,62,-12,38
Ayr,9947,9,9,11,16,36,56,-20,38
St Mirren,9947,10,9,10,17,45,59,-14,37
Hibernian,9948,1,19,13,4,59,26,33,70
Dundee Utd,9948,2,16,10,10,51,43,8,58
Falkirk,9948,3,16,9,11,59,46,13,57
Morton,9948,4,15,12,9,54,42,12,57
Queen of S't,9948,5,13,9,14,45,49,-4,48
St Mirren,9948,6,10,11,15,43,52,-9,41
Dunfermline,9948,7,9,13,14,49,56,-7,40
Dumbarton,9948,8,10,10,16,48,60,-12,40
Raith,9948,9,10,9,17,37,52,-15,39
Ayr,9948,10,8,12,16,35,54,-19,36
Hibernian,9949,1,21,12,3,65,24,41,75
Falkirk,9949,2,17,11,8,60,39,21,62
Morton,9949,3,17,10,9,48,36,12,61
Dundee Utd,9949,4,15,10,11,46,38,8,55
Queen of S't,9949,5,12,10,14,47,51,-4,46
Dumbarton,9949,6,10,12,14,48,57,-9,42
Raith,9949,7,10,8,18,33,57,-24,38
Dunfermline,9949,8,8,13,15,42,49,-7,37
St Mirren,9949,9,8,13,15,42,54,-12,37
Ayr,9949,10,6,13,17,30,56,-26,31
Hibernian,9950,1,18,14,4,57,27,30,68
Morton,9950,2,16,12,8,47,35,12,60
Dundee Utd,9950,3,15,13,8,56,41,15,58
Falkirk,9950,4,13,13,10,54,42,12,52
Queen of S't,9950,5,11,11,14,45,50,-5,44
Raith,9950,6,11,11,14,32,43,-11,44
Dumbarton,9950,7,10,13,13,52,58,-6,43
Dunfermline,9950,8,8,13,15,39,50,-11,37
Ayr,9950,9,8,13,15,36,55,-19,37
St Mirren,9950,10,8,11,17,41,58,-17,35
Hibernian,9951,1,19,13,4,58,25,33,70
Morton,9951,2,16,14,6,52,37,15,62
Falkirk,9951,3,16,12,8,55,37,18,60
Dundee Utd,9951,4,16,11,9,51,38,13,59
Dumbarton,9951,5,10,13,13,51,59,-8,43
Dunfermline,9951,6,9,13,14,46,51,-5,40
Queen of S't,9951,7,10,9,17,43,54,-11,39
Raith,9951,8,9,12,15,33,47,-14,39
Ayr,9951,9,7,13,16,31,54,-23,34
St Mirren,9951,10,7,12,17,38,56,-18,33
Morton,9952,1,19,10,7,54,32,22,67
Hibernian,9952,2,17,13,6,52,30,22,64
Falkirk,9952,3,16,10,10,58,43,15,58
Dundee Utd,9952,4,16,8,12,51,43,8,56
Dunfermline,9952,5,12,13,11,50,47,3,49
Queen of S't,9952,6,10,11,15,43,52,-9,41
Dumbarton,9952,7,9,12,15,47,57,-10,39
Raith,9952,8,10,9,17,33,50,-17,39
Ayr,9952,9,8,13,15,37,59,-22,37
St Mirren,9952,10,9,9,18,43,55,-12,36
Hibernian,9953,1,22,11,3,60,25,35,77
Morton,9953,2,16,13,7,51,39,12,61
Falkirk,9953,3,16,10,10,58,40,18,58
Dundee Utd,9953,4,14,13,9,52,42,10,55
Queen of S't,9953,5,12,8,16,45,50,-5,44
Dunfermline,9953,6,10,13,13,44,50,-6,43
Raith,9953,7,10,8,18,33,49,-16,38
Dumbarton,9953,8,8,13,15,46,58,-12,37
Ayr,9953,9,8,12,16,35,53,-18,36
St Mirren,9953,10,8,11,17,40,58,-18,35
Hibernian,9954,1,17,13,6,56,31,25,64
Morton,9954,2,17,13,6,50,35,15,64
Falkirk,9954,3,17,9,10,62,43,19,60
Dundee Utd,9954,4,15,11,10,50,42,8,56
Dunfermline,9954,5,11,14,11,49,45,4,47
Queen of S't,9954,6,12,11,13,46,50,-4,47
St Mirren,9954,7,9,11,16,42,57,-15,38
Dumbarton,9954,8,8,12,16,47,59,-12,36
Ayr,9954,9,7,14,15,34,51,-17,35
Raith,9954,10,8,10,18,35,58,-23,34
Hibernian,9955,1,18,12,6,53,29,24,66
Morton,9955,2,17,13,6,52,37,15,64
Falkirk,9955,3,14,10,12,57,45,12,52
Dundee Utd,9955,4,14,10,12,49,41,8,52
Queen of S't,9955,5,13,8,15,53,54,-1,47
Dunfermline,9955,6,10,12,14,44,49,-5,42
Raith,9955,7,11,9,16,39,51,-12,42
Dumbarton,9955,8,10,11,15,53,64,-11,41
St Mirren,9955,9,10,11,15,48,60,-12,41
Ayr,9955,10,8,14,14,35,53,-18,38
Hibernian,9956,1,20,10,6,55,27,28,70
Morton,9956,2,17,11,8,53,38,15,62
Falkirk,9956,3,17,10,9,63,43,20,61
Dundee Utd,9956,4,17,8,11,56,41,15,59
Queen of S't,9956,5,13,8,15,48,50,-2,47
Dunfermline,9956,6,10,12,14,49,56,-7,42
Dumbarton,9956,7,9,12,15,44,57,-13,39
St Mirren,9956,8,10,9,17,41,58,-17,39
Raith,9956,9,9,9,18,33,50,-17,36
Ayr,9956,10,8,11,17,35,57,-22,35
Hibernian,9957,1,19,13,4,59,29,30,70
Morton,9957,2,17,11,8,52,41,11,62
Dundee Utd,9957,3,16,9,11,49,39,10,57
Falkirk,9957,4,15,11,10,54,38,16,56
Dunfermline,9957,5,12,13,11,50,46,4,49
Queen of S't,9957,6,9,13,14,41,49,-8,40
Raith,9957,7,9,12,15,32,45,-13,39
Ayr,9957,8,8,14,14,37,55,-18,38
Dumbarton,9957,9,8,13,15,48,58,-10,37
St Mirren,9957,10,7,11,18,38,60,-22,32
Hibernian,9958,1,21,11,4,57,23,34,74
Falkirk,9958,2,17,10,9,58,37,21,61
Morton,9958,3,16,11,9,52,42,10,59
Dundee Utd,9958,4,16,10,10,53,40,13,58
Dunfermline,9958,5,11,13,12,49,49,0,46
Raith,9958,6,11,9,16,37,47,-10,42
Queen of S't,9958,7,10,9,17,40,52,-12,39
Dumbarton,9958,8,8,13,15,46,58,-12,37
Ayr,9958,9,8,13,15,33,55,-22,37
St Mirren,9958,10,7,11,18,36,58,-22,32
Hibernian,9959,1,17,12,7,51,31,20,63
Morton,9959,2,16,11,9,47,35,12,59
Dundee Utd,9959,3,16,10,10,52,43,9,58
Falkirk,9959,4,15,12,9,59,41,18,57
Queen of S't,9959,5,12,12,12,42,44,-2,48
Dunfermline,9959,6,9,16,11,48,46,2,43
Dumbarton,9959,7,10,12,14,50,64,-14,42
St Mirren,9959,8,10,11,15,47,53,-6,41
Raith,9959,9,10,11,15,33,45,-12,41
Ayr,9959,10,6,11,19,30,57,-27,29
Hibernian,9960,1,19,11,6,54,30,24,68
Morton,9960,2,18,12,6,55,35,20,66
Dundee Utd,9960,3,15,12,9,47,38,9,57
Falkirk,9960,4,14,12,10,57,43,14,54
Queen of S't,9960,5,12,10,14,46,49,-3,46
Dunfermline,9960,6,9,15,12,49,49,0,42
Raith,9960,7,11,9,16,37,50,-13,42
St Mirren,9960,8,9,10,17,46,59,-13,37
Dumbarton,9960,9,8,12,16,47,63,-16,36
Ayr,9960,10,8,11,17,33,55,-22,35
Hibernian,9961,1,20,13,3,55,22,33,73
Dundee Utd,9961,2,17,10,9,54,42,12,61
Morton,9961,3,15,14,7,54,39,15,59
Falkirk,9961,4,15,11,10,57,41,16,56
Queen of S't,9961,5,11,12,13,45,48,-3,45
Dumbarton,9961,6,9,12,15,45,61,-16,39
Dunfermline,9961,7,7,16,13,41,46,-5,37
St Mirren,9961,8,9,10,17,43,54,-11,37
Raith,9961,9,9,10,17,33,56,-23,37
Ayr,9961,10,8,12,16,38,56,-18,36
Hibernian,9962,1,19,11,6,51,25,26,68
Falkirk,9962,2,18,9,9,69,43,26,63
Morton,9962,3,16,13,7,49,36,13,61
Dundee Utd,9962,4,15,11,10,48,39,9,56
Queen of S't,9962,5,13,8,15,45,49,-4,47
Dunfermline,9962,6,9,13,14,46,51,-5,40
Raith,9962,7,10,10,16,34,48,-14,40
Ayr,9962,8,10,10,16,34,51,-17,40
St Mirren,9962,9,9,10,17,40,59,-19,37
Dumbarton,9962,10,8,11,17,46,61,-15,35
Hibernian,9963,1,19,12,5,62,30,32,69
Falkirk,9963,2,17,10,9,59,41,18,61
Morton,9963,3,16,12,8,56,40,16,60
Dundee Utd,9963,4,16,10,10,49,41,8,58
Dunfermline,9963,5,11,12,13,48,49,-1,45
Queen of S't,9963,6,11,10,15,47,52,-5,43
Raith,9963,7,11,9,16,36,48,-12,42
Dumbarton,9963,8,8,14,14,45,57,-12,38
Ayr,9963,9,8,13,15,35,56,-21,37
St Mirren,9963,10,7,10,19,38,61,-23,31
Hibernian,9964,1,17,13,6,52,28,24,64
Falkirk,9964,2,18,9,9,67,39,28,63
Morton,9964,3,17,10,9,55,40,15,61
Dundee Utd,9964,4,14,9,13,47,44,3,51
Dunfermline,9964,5,12,11,13,48,47,1,47
Dumbarton,9964,6,10,11,15,52,63,-11,41
St Mirren,9964,7,10,11,15,43,54,-11,41
Queen of S't,9964,8,10,11,15,42,53,-11,41
Raith,9964,9,10,9,17,33,50,-17,39
Ayr,9964,10,9,12,15,36,57,-21,39
Hibernian,9965,1,18,12,6,57,32,25,66
Morton,9965,2,16,12,8,51,38,13,60
Falkirk,9965,3,16,11,9,57,39,18,59
Dundee Utd,9965,4,16,8,12,50,40,10,56
Dunfermline,9965,5,11,12,13,44,44,0,45
Raith,9965,6,12,9,15,36,46,-10,45
Dumbarton,9965,7,11,10,15,48,57,-9,43
Queen of S't,9965,8,11,9,16,47,53,-6,42
Ayr,9965,9,9,11,16,33,54,-21,38
St Mirren,9965,10,8,10,18,38,58,-20,34
Hibernian,9966,1,17,13,6,51,26,25,64
Morton,9966,2,16,10,10,48,44,4,58
Falkirk,9966,3,15,11,10,54,43,11,56
Dundee Utd,9966,4,15,10,11,51,42,9,55
Dunfermline,9966,5,13,13,10,53,44,9,52
Queen of S't,9966,6,11,9,16,45,50,-5,42
Raith,9966,7,11,9,16,37,48,-11,42
Dumbarton,9966,8,10,11,15,47,58,-11,41
Ayr,9966,9,9,13,14,38,52,-14,40
St Mirren,9966,10,8,11,17,36,53,-17,35
Hibernian,9967,1,19,12,5,56,28,28,69
Dundee Utd,9967,2,17,10,9,52,37,15,61
Falkirk,9967,3,16,10,10,63,44,19,58
Morton,9967,4,15,12,9,50,41,9,57
Queen of S't,9967,5,13,10,13,46,47,-1,49
Dunfermline,9967,6,11,14,11,54,47,7,47
Raith,9967,7,10,9,17,37,55,-18,39
Dumbarton,9967,8,9,10,17,46,63,-17,37
St Mirren,9967,9,8,10,18,42,62,-20,34
Ayr,9967,10,7,13,16,34,56,-22,34
Hibernian,9968,1,21,10,5,54,24,30,73
Falkirk,9968,2,16,11,9,55,37,18,59
Morton,9968,3,15,12,9,49,40,9,57
Dundee Utd,9968,4,15,10,11,48,42,6,55
Queen of S't,9968,5,12,8,16,45,49,-4,44
Raith,9968,6,11,9,16,37,52,-15,42
Ayr,9968,7,10,11,15,39,55,-16,41
St Mirren,9968,8,10,10,16,44,53,-9,40
Dumbarton,9968,9,9,12,15,50,61,-11,39
Dunfermline,9968,10,8,13,15,43,51,-8,37
Hibernian,9969,1,22,10,4,60,24,36,76
Falkirk,9969,2,19,10,7,63,36,27,67
Morton,9969,3,16,10,10,50,40,10,58
Dundee Utd,9969,4,15,10,11,50,41,9,55
Queen of S't,9969,5,12,8,16,46,53,-7,44
Dunfermline,9969,6,8,15,13,43,51,-8,39
Dumbarton,9969,7,9,12,15,46,55,-9,39
St Mirren,9969,8,9,11,16,38,51,-13,38
Raith,9969,9,9,9,18,33,54,-21,36
Ayr,9969,10,8,11,17,33,57,-24,35
Hibernian,9970,1,20,11,5,51,24,27,71
Falkirk,9970,2,16,12,8,57,38,19,60
Morton,9970,3,16,11,9,48,37,11,59
Dundee Utd,9970,4,16,9,11,51,42,9,57
Queen of S't,9970,5,12,8,16,45,48,-3,44
Dumbarton,9970,6,11,11,14,52,57,-5,44
Dunfermline,9970,7,10,13,13,44,48,-4,43
Raith,9970,8,10,9,17,32,50,-18,39
St Mirren,9970,9,9,10,17,43,55,-12,37
Ayr,9970,10,8,10,18,33,57,-24,34
Hibernian,9971,1,19,13,4,56,25,31,70
Morton,9971,2,17,11,8,54,39,15,62
Falkirk,9971,3,16,11,9,58,39,19,59
Dundee Utd,9971,4,14,10,12,52,47,5,52
Raith,9971,5,11,10,15,39,48,-9,43
Queen of S't,9971,6,11,10,15,42,53,-11,43
Ayr,9971,7,10,12,14,42,51,-9,42
Dumbarton,9971,8,10,11,15,52,62,-10,41
Dunfermline,9971,9,8,15,13,45,54,-9,39
St Mirren,9971,10,7,11,18,39,61,-22,32
Morton,9972,1,18,11,7,54,34,20,65
Hibernian,9972,2,16,13,7,50,28,22,61
Dundee Utd,9972,3,16,10,10,57,43,14,58
Falkirk,9972,4,15,11,10,55,41,14,56
Queen of S't,9972,5,13,9,14,44,51,-7,48
Dunfermline,9972,6,11,12,13,48,48,0,45
Ayr,9972,7,9,12,15,34,52,-18,39
Raith,9972,8,10,9,17,33,53,-20,39
Dumbarton,9972,9,8,14,14,47,56,-9,38
St Mirren,9972,10,8,11,17,43,59,-16,35
Hibernian,9973,1,19,13,4,55,25,30,70
Falkirk,9973,2,17,11,8,63,38,25,62
Morton,9973,3,15,13,8,48,39,9,58
Dundee Utd,9973,4,15,12,9,50,39,11,57
Dunfermline,9973,5,11,13,12,49,47,2,46
Queen of S't,9973,6,11,11,14,44,52,-8,44
Raith,9973,7,9,11,16,35,50,-15,38
Ayr,9973,8,8,14,14,34,53,-19,38
Dumbarton,9973,9,8,12,16,45,56,-11,36
St Mirren,9973,10,7,10,19,35,59,-24,31
Hibernian,9974,1,20,11,5,61,31,30,71
Falkirk,9974,2,18,9,9,64,44,20,63
Dundee Utd,9974,3,16,10,10,55,42,13,58
Morton,9974,4,15,12,9,50,41,9,57
Dunfermline,9974,5,12,12,12,54,51,3,48
Queen of S't,9974,6,12,9,15,46,54,-8,45
St Mirren,9974,7,9,10,17,43,54,-11,37
Raith,9974,8,9,10,17,38,58,-20,37
Ayr,9974,9,8,12,16,34,56,-22,36
Dumbarton,9974,10,7,13,16,47,61,-14,34
Hibernian,9975,1,18,12,6,51,25,26,66
Morton,9975,2,18,11,7,57,41,16,65
Falkirk,9975,3,16,10,10,57,39,18,58
Dundee Utd,9975,4,14,9,13,45,42,3,51
Queen of S't,9975,5,14,8,14,49,47,2,50
Dumbarton,9975,6,11,12,13,47,52,-5,45
Dunfermline,9975,7,9,12,15,44,52,-8,39
Raith,9975,8,10,9,17,34,51,-17,39
Ayr,9975,9,9,12,15,34,53,-19,39
St Mirren,9975,10,8,11,17,42,58,-16,35
Hibernian,9976,1,19,12,5,55,27,28,69
Falkirk,9976,2,18,9,9,63,39,24,63
Dundee Utd,9976,3,16,10,10,52,42,10,58
Morton,9976,4,16,10,10,45,40,5,58
Dumbarton,9976,5,11,11,14,51,60,-9,44
Queen of S't,9976,6,11,9,16,45,53,-8,42
Raith,9976,7,10,11,15,37,48,-11,41
Ayr,9976,8,9,11,16,38,55,-17,38
Dunfermline,9976,9,8,13,15,46,56,-10,37
St Mirren,9976,10,9,10,17,46,58,-12,37
Hibernian,9977,1,19,14,3,60,26,34,71
Falkirk,9977,2,16,10,10,60,43,17,58
Morton,9977,3,15,12,9,46,38,8,57
Dundee Utd,9977,4,14,11,11,51,42,9,53
Queen of S't,9977,5,13,10,13,49,45,4,49
Dumbarton,9977,6,12,10,14,50,53,-3,46
Dunfermline,9977,7,10,13,13,47,50,-3,43
Raith,9977,8,10,9,17,33,56,-23,39
Ayr,9977,9,8,13,15,34,56,-22,37
St Mirren,9977,10,7,10,19,36,57,-21,31
Hibernian,9978,1,20,12,4,59,28,31,72
Falkirk,9978,2,17,11,8,60,37,23,62
Morton,9978,3,15,11,10,49,41,8,56
Dundee Utd,9978,4,14,11,11,46,40,6,53
Dunfermline,9978,5,12,12,12,49,46,3,48
Raith,9978,6,11,9,16,32,47,-15,42
Queen of S't,9978,7,11,8,17,42,55,-13,41
Ayr,9978,8,9,12,15,37,52,-15,39
St Mirren,9978,9,9,10,17,41,53,-12,37
Dumbarton,9978,10,9,10,17,46,62,-16,37
Hibernian,9979,1,22,11,3,60,23,37,77
Morton,9979,2,16,10,10,50,36,14,58
Dundee Utd,9979,3,16,10,10,51,40,11,58
Falkirk,9979,4,15,11,10,57,43,14,56
Queen of S't,9979,5,11,10,15,42,49,-7,43
Raith,9979,6,10,11,15,37,51,-14,41
St Mirren,9979,7,10,10,16,39,54,-15,40
Dumbarton,9979,8,9,12,15,46,57,-11,39
Dunfermline,9979,9,8,14,14,49,52,-3,38
Ayr,9979,10,8,11,17,31,57,-26,35
Hibernian,9980,1,16,15,5,52,28,24,63
Falkirk,9980,2,15,12,9,61,40,21,57
Dundee Utd,9980,3,16,9,11,53,41,12,57
Morton,9980,4,14,12,10,47,42,5,54
Queen of S't,9980,5,13,9,14,46,48,-2,48
Ayr,9980,6,12,11,13,40,50,-10,47
Raith,9980,7,11,11,14,36,47,-11,44
St Mirren,9980,8,10,10,16,44,56,-12,40
Dunfermline,9980,9,8,14,14,44,53,-9,38
Dumbarton,9980,10,8,11,17,45,63,-18,35
Falkirk,9981,1,19,9,8,62,34,28,66
Hibernian,9981,2,18,12,6,49,24,25,66
Morton,9981,3,17,10,9,47,34,13,61
Dundee Utd,9981,4,16,11,9,49,39,10,59
Dunfermline,9981,5,12,11,13,49,47,2,47
Queen of S't,9981,6,11,10,15,44,52,-8,43
Raith,9981,7,10,10,16,35,51,-16,40
Ayr,9981,8,8,14,14,32,50,-18,38
St Mirren,9981,9,7,12,17,39,58,-19,33
Dumbarton,9981,10,7,11,18,44,61,-17,32
Hibernian,9982,1,18,13,5,57,28,29,67
Falkirk,9982,2,18,9,9,65,41,24,63
Morton,9982,3,16,11,9,45,38,7,59
Dundee Utd,9982,4,16,9,11,49,40,9,57
Dunfermline,9982,5,12,13,11,50,48,2,49
Queen of S't,9982,6,11,10,15,41,50,-9,43
Ayr,9982,7,9,12,15,36,53,-17,39
Raith,9982,8,10,8,18,35,53,-18,38
St Mirren,9982,9,9,10,17,39,53,-14,37
Dumbarton,9982,10,8,11,17,48,61,-13,35
Hibernian,9983,1,21,12,3,59,25,34,75
Morton,9983,2,18,10,8,51,38,13,64
Falkirk,9983,3,16,10,10,58,47,11,58
Dundee Utd,9983,4,15,11,10,54,43,11,56
Queen of S't,9983,5,13,8,15,51,52,-1,47
Dumbarton,9983,6,9,13,14,52,61,-9,40
Dunfermline,9983,7,8,13,15,44,52,-8,37
Raith,9983,8,9,10,17,36,51,-15,37
St Mirren,9983,9,9,9,18,43,56,-13,36
Ayr,9983,10,7,14,15,36,59,-23,35
Hibernian,9984,1,19,11,6,55,29,26,68
Dundee Utd,9984,2,19,8,9,54,39,15,65
Morton,9984,3,17,10,9,51,36,15,61
Falkirk,9984,4,14,10,12,52,44,8,52
Dunfermline,9984,5,11,12,13,51,50,1,45
Queen of S't,9984,6,12,9,15,46,53,-7,45
Raith,9984,7,11,8,17,37,49,-12,41
St Mirren,9984,8,10,10,16,42,51,-9,40
Ayr,9984,9,9,11,16,33,55,-22,38
Dumbarton,9984,10,7,13,16,45,60,-15,34
Hibernian,9985,1,19,11,6,58,29,29,68
Falkirk,9985,2,18,9,9,64,41,23,63
Morton,9985,3,16,13,7,50,37,13,61
Dundee Utd,9985,4,15,10,11,56,49,7,55
Queen of S't,9985,5,13,9,14,48,46,2,48
Raith,9985,6,10,10,16,35,49,-14,40
Dunfermline,9985,7,8,15,13,44,54,-10,39
Dumbarton,9985,8,9,12,15,49,60,-11,39
Ayr,9985,9,9,12,15,34,53,-19,39
St Mirren,9985,10,7,11,18,37,57,-20,32
Hibernian,9986,1,20,11,5,59,25,34,71
Falkirk,9986,2,18,10,8,63,39,24,64
Dundee Utd,9986,3,16,10,10,49,37,12,58
Morton,9986,4,14,10,12,47,46,1,52
Dunfermline,9986,5,11,12,13,46,48,-2,45
Queen of S't,9986,6,11,11,14,44,53,-9,44
St Mirren,9986,7,10,10,16,41,58,-17,40
Dumbarton,9986,8,9,12,15,49,58,-9,39
Raith,9986,9,10,9,17,38,50,-12,39
Ayr,9986,10,7,13,16,35,57,-22,34
Hibernian,9987,1,19,12,5,55,29,26,69
Falkirk,9987,2,16,9,11,57,41,16,57
Morton,9987,3,14,12,10,49,42,7,54
Dundee Utd,9987,4,15,9,12,48,41,7,54
Dunfermline,9987,5,13,11,12,55,46,9,50
Dumbarton,9987,6,11,11,14,47,54,-7,44
Queen of S't,9987,7,12,8,16,45,54,-9,44
Ayr,9987,8,10,11,15,36,55,-19,41
Raith,9987,9,10,9,17,37,51,-14,39
St Mirren,9987,10,8,12,16,44,60,-16,36
Morton,9988,1,17,12,7,49,32,17,63
Hibernian,9988,2,17,11,8,49,29,20,62
Falkirk,9988,3,16,12,8,59,37,22,60
Dundee Utd,9988,4,15,12,9,50,40,10,57
Queen of S't,9988,5,12,10,14,45,49,-4,46
Dunfermline,9988,6,10,13,13,44,47,-3,43
Ayr,9988,7,9,12,15,36,55,-19,39
Dumbarton,9988,8,9,11,16,50,63,-13,38
St Mirren,9988,9,9,11,16,41,55,-14,38
Raith,9988,10,9,10,17,32,48,-16,37
Hibernian,9989,1,18,14,4,56,26,30,68
Dundee Utd,9989,2,16,10,10,56,41,15,58
Falkirk,9989,3,16,9,11,59,44,15,57
Morton,9989,4,15,12,9,45,38,7,57
Queen of S't,9989,5,13,10,13,45,49,-4,49
Dunfermline,9989,6,11,12,13,49,47,2,45
Dumbarton,9989,7,10,10,16,44,56,-12,40
St Mirren,9989,8,10,9,17,44,60,-16,39
Ayr,9989,9,9,12,15,36,57,-21,39
Raith,9989,10,9,8,19,35,51,-16,35
Hibernian,9990,1,18,13,5,53,26,27,67
Falkirk,9990,2,17,10,9,62,40,22,61
Dundee Utd,9990,3,16,9,11,49,39,10,57
Morton,9990,4,15,12,9,48,40,8,57
Dunfermline,9990,5,12,13,11,51,52,-1,49
Raith,9990,6,12,9,15,35,45,-10,45
Queen of S't,9990,7,11,10,15,45,52,-7,43
Ayr,9990,8,8,13,15,33,51,-18,37
Dumbarton,9990,9,8,12,16,52,63,-11,36
St Mirren,9990,10,8,9,19,37,57,-20,33
Hibernian,9991,1,20,11,5,57,25,32,71
Morton,9991,2,17,11,8,50,36,14,62
Dundee Utd,9991,3,16,9,11,49,41,8,57
Falkirk,9991,4,13,12,11,58,47,11,51
Queen of S't,9991,5,13,9,14,45,49,-4,48
Raith,9991,6,12,9,15,40,50,-10,45
Dumbarton,9991,7,11,10,15,49,55,-6,43
Dunfermline,9991,8,10,11,15,47,54,-7,41
Ayr,9991,9,8,12,16,33,54,-21,36
St Mirren,9991,10,8,10,18,39,56,-17,34
Hibernian,9992,1,21,10,5,56,24,32,73
Morton,9992,2,15,12,9,50,41,9,57
Falkirk,9992,3,14,11,11,55,42,13,53
Dundee Utd,9992,4,14,11,11,50,44,6,53
Dunfermline,9992,5,12,12,12,49,47,2,48
Raith,9992,6,12,8,16,36,48,-12,44
St Mirren,9992,7,10,12,14,42,53,-11,42
Queen of S't,9992,8,10,10,16,44,55,-11,40
Dumbarton,9992,9,8,14,14,48,57,-9,38
Ayr,9992,10,7,14,15,35,54,-19,35
Hibernian,9993,1,19,14,3,62,27,35,71
Morton,9993,2,17,11,8,53,42,11,62
Falkirk,9993,3,15,10,11,57,43,14,55
Dundee Utd,9993,4,14,10,12,48,43,5,52
Dunfermline,9993,5,11,14,11,49,46,3,47
Dumbarton,9993,6,11,11,14,48,53,-5,44
Queen of S't,9993,7,11,8,17,45,54,-9,41
St Mirren,9993,8,10,10,16,42,52,-10,40
Ayr,9993,9,9,11,16,31,53,-22,38
Raith,9993,10,9,9,18,35,57,-22,36
Hibernian,9994,1,19,13,4,55,24,31,70
Morton,9994,2,16,11,9,48,36,12,59
Falkirk,9994,3,16,10,10,60,44,16,58
Dundee Utd,9994,4,16,8,12,49,45,4,56
Dunfermline,9994,5,11,12,13,45,47,-2,45
Queen of S't,9994,5,12,9,15,45,47,-2,45
Raith,9994,7,11,9,16,36,50,-14,42
St Mirren,9994,8,10,10,16,50,52,-2,40
Dumbarton,9994,9,10,10,16,48,63,-15,40
Ayr,9994,10,8,10,18,35,63,-28,34
Hibernian,9995,1,19,13,4,56,27,29,70
Morton,9995,2,16,13,7,51,38,13,61
Falkirk,9995,3,16,10,10,53,37,16,58
Dundee Utd,9995,4,15,10,11,50,39,11,55
Queen of S't,9995,5,11,10,15,41,48,-7,43
Raith,9995,6,11,8,17,38,50,-12,41
Dunfermline,9995,7,9,13,14,45,49,-4,40
Dumbarton,9995,8,9,13,14,48,56,-8,40
St Mirren,9995,9,10,9,17,43,57,-14,39
Ayr,9995,10,8,13,15,35,59,-24,37
Morton,9996,1,20,10,6,61,32,29,70
Hibernian,9996,2,18,10,8,55,31,24,64
Falkirk,9996,3,17,11,8,61,38,23,62
Dundee Utd,9996,4,16,9,11,49,40,9,57
Dunfermline,9996,5,10,12,14,45,50,-5,42
Dumbarton,9996,6,9,14,13,50,56,-6,41
Raith,9996,7,10,9,17,39,57,-18,39
St Mirren,9996,8,9,11,16,42,61,-19,38
Queen of S't,9996,9,9,10,17,39,51,-12,37
Ayr,9996,10,8,12,16,35,60,-25,36
Morton,9997,1,19,9,8,52,36,16,66
Hibernian,9997,2,18,11,7,47,25,22,65
Falkirk,9997,3,15,12,9,55,40,15,57
Dundee Utd,9997,4,15,10,11,51,45,6,55
Queen of S't,9997,5,12,10,14,51,51,0,46
Dunfermline,9997,6,10,14,12,52,50,2,44
Raith,9997,7,11,8,17,36,49,-13,41
Ayr,9997,8,9,13,14,36,52,-16,40
Dumbarton,9997,9,9,11,16,47,62,-15,38
St Mirren,9997,10,8,10,18,37,54,-17,34
Hibernian,9998,1,19,13,4,58,27,31,70
Dundee Utd,9998,2,18,10,8,49,35,14,64
Falkirk,9998,3,17,11,8,59,38,21,62
Morton,9998,4,16,12,8,51,36,15,60
Queen of S't,9998,5,11,10,15,46,53,-7,43
Dunfermline,9998,6,10,12,14,45,50,-5,42
Dumbarton,9998,7,9,11,16,47,57,-10,38
Ayr,9998,8,8,12,16,35,56,-21,36
St Mirren,9998,9,8,11,17,37,55,-18,35
Raith,9998,10,9,8,19,34,54,-20,35
Hibernian,9999,1,18,12,6,55,29,26,66
Morton,9999,2,17,11,8,52,39,13,62
Falkirk,9999,3,17,9,10,58,41,17,60
Dundee Utd,9999,4,14,10,12,48,44,4,52
Queen of S't,9999,5,11,10,15,46,54,-8,43
Raith,9999,6,10,11,15,39,48,-9,41
Ayr,9999,7,10,11,15,37,53,-16,41
St Mirren,9999,8,10,10,16,42,51,-9,40
Dumbarton,9999,9,9,13,14,47,59,-12,40
Dunfermline,9999,10,8,15,13,43,49,-6,39
